id,files,locs added,locs removed,locs total,hunks,commit time,author time
4b825dc642cb6eb9a060e54bf8d69288fbee4904...e73188b5512c82290a4070af4afddac20d0b981e,30,2163,0,2163,26,2007-10-19 23:35:48,2007-10-19 23:35:48
e73188b5512c82290a4070af4afddac20d0b981e...9e1541367984bcc5fd9a8c709b311ef309af3954,4,3,3,6,3,2007-10-28 16:37:24,2007-10-28 16:37:24
9e1541367984bcc5fd9a8c709b311ef309af3954...5380b6e5911e50f2e89bdc0226e5526f58f6cab2,7,87,46,133,14,2007-10-28 18:42:59,2007-10-28 18:42:59
9e1541367984bcc5fd9a8c709b311ef309af3954...ab2aeb51325f4f9a82988bbdbb0cff0a8035e136,1,1,1,2,1,2007-10-28 17:34:02,2007-10-28 17:34:02
ab2aeb51325f4f9a82988bbdbb0cff0a8035e136...5f3d8873d8836778bf538a0f82a92666bfa70438,1,1,1,2,1,2007-10-28 17:34:27,2007-10-28 17:34:27
5f3d8873d8836778bf538a0f82a92666bfa70438...42df7e447816f9a5c63d6e6018437d0f92911c39,1,1,1,2,1,2007-10-28 17:34:36,2007-10-28 17:34:36
4faabfaa27893f17304da9f36924c2252031ba40...33ed8aa6844e046e9e80c11c8d1c6b1098da8100,5,27,13,40,14,2007-10-28 20:38:06,2007-10-28 20:38:06
4faabfaa27893f17304da9f36924c2252031ba40...2b30a00c8da5ccaf7843dc350db21d246dfcbb29,2,1,0,1,1,2007-10-28 20:36:37,2007-10-28 20:36:37
ff135fb94309de0c25a64309b40841eb7aa73729...f291a4513ad988539f8d4df88655c508b824c5c2,5,225,12,237,15,2007-10-29 00:43:04,2007-10-29 00:43:04
f291a4513ad988539f8d4df88655c508b824c5c2...f5a7b08f5e5e3df78587558bdc785c51c39a6eba,4,31,19,50,10,2007-10-29 02:20:57,2007-10-29 02:20:57
f5a7b08f5e5e3df78587558bdc785c51c39a6eba...1e7d144631b797be819dd3006bdff1c32afbbc45,9,420,125,545,72,2007-10-30 09:50:14,2007-10-30 09:50:14
1e7d144631b797be819dd3006bdff1c32afbbc45...fc316ba2be028181eb745f3a0effe9988a55b588,7,238,142,380,51,2007-10-30 15:35:17,2007-10-30 15:35:17
f5a7b08f5e5e3df78587558bdc785c51c39a6eba...5640683c67c325d9c93fe1efadd44b5c696b0d1e,2,7,2,9,3,2007-10-29 03:04:25,2007-10-29 03:04:25
5640683c67c325d9c93fe1efadd44b5c696b0d1e...b623ea8c7f9f15ad1dee8bf0a74a0322171ed4a8,1,1,0,1,1,2007-10-29 03:06:25,2007-10-29 03:06:25
23b122d8cae833405529c79c7521f61ecc6307e9...b8792b062126ab6cca78709798b342c5ef5f4cdf,3,5,4,9,4,2007-10-30 17:35:02,2007-10-30 17:35:02
b8792b062126ab6cca78709798b342c5ef5f4cdf...357a80d99efc13fe62e4995f820eafae2c72fb35,2,2,0,2,2,2007-10-30 17:43:44,2007-10-30 17:43:44
357a80d99efc13fe62e4995f820eafae2c72fb35...79562d368decb274d7ba69a47d685a5fe13b0345,1,2,2,4,1,2007-10-30 19:35:58,2007-10-30 19:35:58
79562d368decb274d7ba69a47d685a5fe13b0345...e5e38f99fc4bea342bddbf7ca5f22b9d47c30830,2,2,2,4,3,2007-10-31 01:16:35,2007-10-31 01:16:35
e5e38f99fc4bea342bddbf7ca5f22b9d47c30830...c7a92a191c46f0480b4388d7595e6bbde6640be4,1,1,1,2,1,2007-11-01 21:44:26,2007-11-01 21:44:26
c7a92a191c46f0480b4388d7595e6bbde6640be4...e9a5075a9bb710233ac1bec8980055c63ccd3b99,8,174,47,221,44,2007-11-02 02:34:44,2007-11-02 02:34:44
e9a5075a9bb710233ac1bec8980055c63ccd3b99...b15cad60e96c17e39cd68b821e6766b6c6b0ca34,1,1,3,4,1,2007-11-02 15:38:48,2007-11-02 15:38:48
b15cad60e96c17e39cd68b821e6766b6c6b0ca34...c017641fc540e8672e771d7268dbf5f18d9d3b46,5,39,16,55,14,2007-11-03 01:30:40,2007-11-03 01:30:40
c017641fc540e8672e771d7268dbf5f18d9d3b46...8843896e83fc1981a7e49194ac02a93561ce2251,1,2,2,4,2,2007-11-06 04:55:28,2007-11-06 04:55:28
c017641fc540e8672e771d7268dbf5f18d9d3b46...dbaa9645dbe858c4d0f6cfc2ee086983775450ad,56,33603,9,33612,64,2007-11-04 18:11:38,2007-11-04 18:11:38
dbaa9645dbe858c4d0f6cfc2ee086983775450ad...50e3afabbb873965fea624dd50594a347afb5ace,2,16,11,27,2,2007-11-04 18:14:02,2007-11-04 18:14:02
50e3afabbb873965fea624dd50594a347afb5ace...78bba217225dda2092a0f74754e102f02dad3f64,3,71,8,79,15,2007-11-04 19:39:27,2007-11-04 19:39:27
8cac7770bffd1e62dfd372ab94c8bfb0fd2dc073...77d3be849f490129e8d9ed855e195624de6fa789,1,3,2,5,2,2007-11-06 14:37:00,2007-11-06 14:37:00
78bba217225dda2092a0f74754e102f02dad3f64...80403c140f3b3154badd3c336dff1f904e3fb7ea,1,6,0,6,1,2007-11-04 21:42:34,2007-11-04 21:42:34
78bba217225dda2092a0f74754e102f02dad3f64...94b2fe996faacf21996f3fbf0bcccc40e9a9ff35,5,147,34,181,21,2007-11-04 21:17:44,2007-11-04 21:17:44
94b2fe996faacf21996f3fbf0bcccc40e9a9ff35...426ea61db2255dca8b2800503b5d973cb1f5da69,3,46,1,47,6,2007-11-04 21:35:08,2007-11-04 21:35:08
426ea61db2255dca8b2800503b5d973cb1f5da69...86e112ae8f8f638279b6343f1da733376e7460e7,4,55,1,56,12,2007-11-05 00:17:42,2007-11-05 00:17:42
86e112ae8f8f638279b6343f1da733376e7460e7...91237743715c5aea39f2bcaefc821273e94fefe1,6,88,5,93,9,2007-11-05 01:47:12,2007-11-05 01:47:12
91237743715c5aea39f2bcaefc821273e94fefe1...5c82a67f35083385f29ca8bc9794d623abd5d990,6,126,35,161,22,2007-11-05 03:34:37,2007-11-05 03:34:37
8e65cff82d996c2fbce11f837a7ae37dd5c1bfa5...e32bccf860cb8a0064907f7a1a3131eddd6682e7,7,116,24,140,24,2007-11-09 19:06:07,2007-11-09 19:06:07
e32bccf860cb8a0064907f7a1a3131eddd6682e7...cac61b267471cbf502a669bf09a0ba510defe2fc,9,309,133,442,27,2007-11-10 21:46:30,2007-11-10 21:46:30
cac61b267471cbf502a669bf09a0ba510defe2fc...5d77507008d17aea23f09f9707c8e6da6e9e8726,11,276,111,387,40,2007-11-11 19:21:02,2007-11-11 19:21:02
5d77507008d17aea23f09f9707c8e6da6e9e8726...2f735ca81633147d08262fc3e32dccd58810f991,3,50,13,63,5,2007-11-11 23:28:33,2007-11-11 23:28:33
2f735ca81633147d08262fc3e32dccd58810f991...ddc39462df919ec0802c18f57e6ffa9708a2e644,2,11,3,14,6,2007-11-12 15:10:43,2007-11-12 15:10:43
5c82a67f35083385f29ca8bc9794d623abd5d990...8f932515bfc74003794481e619131c908b16bf79,3,23,6,29,11,2007-11-05 16:29:12,2007-11-05 16:29:12
8f932515bfc74003794481e619131c908b16bf79...0a78810ea015a231bf29dd55522e67003d4da826,1,4,2,6,2,2007-11-05 16:55:03,2007-11-05 16:55:03
0a78810ea015a231bf29dd55522e67003d4da826...931e633836ec72a0e20f3c1c57036e6a73ba4766,3787,663014,4,663018,3787,2007-11-05 19:44:26,2007-11-05 19:44:26
931e633836ec72a0e20f3c1c57036e6a73ba4766...282d3ba529a415e980cbe4c8680ef35c393c0531,3,29,9,38,11,2007-11-05 20:12:45,2007-11-05 20:12:45
ddc39462df919ec0802c18f57e6ffa9708a2e644...7e45e93ad4e6a32c194f493ea1e0ddc61442d886,1,1,1,2,1,2007-11-12 16:01:43,2007-11-12 16:01:43
ba7c2b7c6c9298f646b6cdfa4d97b4050fe7dae8...cf0cfecc9b8aef61c373decaf3725fff4c8c780b,2,6,2,8,3,2007-11-12 15:33:41,2007-11-12 15:33:41
282d3ba529a415e980cbe4c8680ef35c393c0531...25d2dafa8a2c0aaf45a4be4f481c6beec129abeb,1,1,1,2,1,2007-11-05 20:31:57,2007-11-05 20:31:57
25d2dafa8a2c0aaf45a4be4f481c6beec129abeb...9f917d21b4d7cb62afba3da60400f9c1285fe44d,3,47,10,57,13,2007-11-06 02:43:49,2007-11-06 02:43:49
9f917d21b4d7cb62afba3da60400f9c1285fe44d...52b78a3d75a74c768e08c28c82fe176065894933,7,227,31,258,32,2007-11-09 02:42:50,2007-11-09 02:42:50
52b78a3d75a74c768e08c28c82fe176065894933...895aac4e1f34e108d4b8c8c73ebc0e05880f452f,3,356,0,356,3,2007-11-09 02:43:31,2007-11-09 02:43:31
688e853578e88235a6ed0d046d8a805cc45568a3...19745b65d233c13d4856efd60748f07a99bafc55,6,61,24,85,31,2007-11-13 00:22:33,2007-11-13 00:22:33
19745b65d233c13d4856efd60748f07a99bafc55...a1e51472252fc1ef7d6b9c7e74490cd953f43968,7,58,28,86,35,2007-11-13 21:44:01,2007-11-13 21:44:01
a1e51472252fc1ef7d6b9c7e74490cd953f43968...ab654fb9eda000661cde7f3273dac59fcd47caf8,15,917,139,1056,71,2007-11-18 02:10:00,2007-11-18 02:10:00
a1e51472252fc1ef7d6b9c7e74490cd953f43968...3418a3cd9d76794db74fc61ab34b9b4174c88bb0,1,1,1,2,1,2007-11-14 02:32:29,2007-11-14 02:32:29
cc1b83cf5c01455a83603ed745988e17b99d2328...ee3f6e3c3cdef6d3bf14b1315c60f7137fa09f22,1,1,1,2,1,2007-11-18 04:27:55,2007-11-18 04:27:55
ee3f6e3c3cdef6d3bf14b1315c60f7137fa09f22...a07fb60cd482a217a57ab72fc7c52f8732273efd,7,162,66,228,68,2007-11-18 18:33:00,2007-11-18 18:33:00
a07fb60cd482a217a57ab72fc7c52f8732273efd...e3c947f118a40c6136d6f355736814b043090dda,3,20,13,33,12,2007-11-18 19:05:28,2007-11-18 19:05:28
e3c947f118a40c6136d6f355736814b043090dda...4f17681bdb24460f39cb13aad9600a2625bf1b22,1,6,2,8,1,2007-11-18 22:05:04,2007-11-18 22:05:04
4f17681bdb24460f39cb13aad9600a2625bf1b22...01986ab502a5cd48405a8d558bf6f4288f29526b,1,15,0,15,2,2007-11-19 00:15:36,2007-11-19 00:15:36
01986ab502a5cd48405a8d558bf6f4288f29526b...76fafc9ad02bf33818713d5bf5e3560249719cae,6,134,67,201,49,2007-11-19 14:41:28,2007-11-19 14:41:28
76fafc9ad02bf33818713d5bf5e3560249719cae...ab4b8012baceabec67b8e90eb3772c2e6f65d7bd,6,95,17,112,20,2007-11-20 03:24:17,2007-11-20 03:24:17
ab4b8012baceabec67b8e90eb3772c2e6f65d7bd...282dbd74b00e9fc82620be587740bf5aee14afb3,1,2,1,3,2,2007-11-20 19:00:27,2007-11-20 19:00:27
282dbd74b00e9fc82620be587740bf5aee14afb3...31311aeb8160ae2711d1256627390d833c09ee4d,6,191,30,221,41,2007-11-22 02:44:57,2007-11-22 02:44:57
31311aeb8160ae2711d1256627390d833c09ee4d...ace493f36fbd61eec4bf6536ae59d4de5f3e2c47,5,40,11,51,15,2007-11-24 21:15:09,2007-11-24 21:15:09
ace493f36fbd61eec4bf6536ae59d4de5f3e2c47...fb83febbafa8e93ac616e7c7bcb532c54541ea9e,3,46,1,47,5,2007-11-25 23:20:54,2007-11-25 23:20:54
ace493f36fbd61eec4bf6536ae59d4de5f3e2c47...4cacd150d30d2e1c9cef2c2c6dbf51d4a5fb784a,3,10,0,10,3,2007-11-25 07:18:39,2007-11-25 07:18:39
399ed104f747611f351a89287f2cf646d514a61f...1b272bdfaf82da8fa0099898f4ed5ce36eea4942,3,4,2,6,4,2007-11-26 16:31:48,2007-11-26 16:31:48
1b272bdfaf82da8fa0099898f4ed5ce36eea4942...178091b0ad390bf5171d1702e5ab87062440df5f,5,148,40,188,40,2007-11-26 21:19:50,2007-11-26 21:19:50
178091b0ad390bf5171d1702e5ab87062440df5f...eb4ffe30f868fae9bb87353148cbc1d5a9c780ee,3,2,2,4,3,2007-11-26 21:43:28,2007-11-26 21:43:28
eb4ffe30f868fae9bb87353148cbc1d5a9c780ee...cbf7e7db0435641b05851059aeef752ad4a6bbb5,7,36,15,51,13,2007-11-27 00:38:14,2007-11-27 00:38:14
cbf7e7db0435641b05851059aeef752ad4a6bbb5...fd2993de59d52619f1a3e5cc0141222fa0fa9b2d,2,7,0,7,3,2007-11-27 18:40:08,2007-11-27 18:40:08
fd2993de59d52619f1a3e5cc0141222fa0fa9b2d...9714868b90fdf711a059d63f61ab771b9c1da6b0,1,4,2,6,3,2007-11-27 20:32:02,2007-11-27 20:32:02
fd2993de59d52619f1a3e5cc0141222fa0fa9b2d...80bfe67a34aa0e5e1ab101efcc04eda180cc3303,4,29,9,38,12,2007-11-27 20:30:51,2007-11-27 20:30:51
80bfe67a34aa0e5e1ab101efcc04eda180cc3303...ea2189232ed169e332b666f3897f188004c27954,1,1,1,2,1,2007-11-27 20:35:01,2007-11-27 20:35:01
4c9055445a8cce84bc103e3ad47ba297c965cf61...999569a50de7d9c78a9a5fc63238762aa285bd2c,1,3,3,6,2,2007-12-01 03:04:04,2007-12-01 03:04:04
4c9055445a8cce84bc103e3ad47ba297c965cf61...3199971604dd99a4414b90588996c08bfbedcf37,3,33,2,35,4,2007-11-27 21:18:56,2007-11-27 21:18:56
3199971604dd99a4414b90588996c08bfbedcf37...6b0f00c2928585c49147303d9a0762c787774af2,14,350,176,526,135,2007-12-01 02:30:24,2007-12-01 02:30:24
6b0f00c2928585c49147303d9a0762c787774af2...6deca13fc051d6ed1718e195122bc136146baf42,1,6,0,6,1,2007-12-01 04:02:41,2007-12-01 04:02:41
652bfc115a1a49c9820e5f14dd8e5ac3ab8783f6...fb7d5b718c7f7732c26847be377ff14635150ef4,8,34,25,59,29,2007-12-01 16:44:42,2007-12-01 16:44:42
fb7d5b718c7f7732c26847be377ff14635150ef4...bed046ec8fb6c1624b3e83f8cd0e0fb0bf069850,1,3,1,4,1,2007-12-01 19:07:05,2007-12-01 19:07:05
bed046ec8fb6c1624b3e83f8cd0e0fb0bf069850...bcfc3b7b2253a8f881a8d43cebac4eacef2da0c0,1,1,0,1,1,2007-12-02 03:49:55,2007-12-02 03:49:55
bcfc3b7b2253a8f881a8d43cebac4eacef2da0c0...0df2998769cbfc6b16a39285e033bee528f20a51,6,134,24,158,31,2007-12-02 16:33:59,2007-12-02 16:33:59
0df2998769cbfc6b16a39285e033bee528f20a51...ce4d2eb1323bcc414d3aea156fb529b3fee2da8b,4,32,24,56,16,2007-12-03 16:52:46,2007-12-03 16:52:46
ce4d2eb1323bcc414d3aea156fb529b3fee2da8b...4e149351ff26ddd6292d777ba1a28b1fb58d69f4,6,250,45,295,68,2007-12-06 22:04:20,2007-12-06 22:04:20
4e149351ff26ddd6292d777ba1a28b1fb58d69f4...b6fc851dbfce796a79350a3f6580350cd9c92810,4,55,46,101,25,2007-12-07 00:03:23,2007-12-07 00:03:23
b6fc851dbfce796a79350a3f6580350cd9c92810...5ab9ae9d47df7fb32e6dd95b404e783020281218,11,287,244,531,86,2007-12-08 20:50:47,2007-12-08 20:50:47
5ab9ae9d47df7fb32e6dd95b404e783020281218...2bb8928c97111c9c56310f4084a534ef8c326d3f,1,1,1,2,1,2007-12-08 20:56:25,2007-12-08 20:56:25
2bb8928c97111c9c56310f4084a534ef8c326d3f...88705075205e9ddf5eb3029a45121c1f5f62489e,1,39,21,60,2,2007-12-09 15:21:40,2007-12-09 15:21:40
88705075205e9ddf5eb3029a45121c1f5f62489e...6c86ae32789384895ad049a570b8779bf5f69643,1,1,1,2,1,2007-12-12 15:32:34,2007-12-12 15:32:34
6c86ae32789384895ad049a570b8779bf5f69643...aea1f83b06bdae7cefe6777397dd72a9849da6a6,1,1,1,2,1,2007-12-12 22:37:19,2007-12-12 22:37:19
aea1f83b06bdae7cefe6777397dd72a9849da6a6...d8b8718a67e816799b295a9fe1a2191bad98b30c,2,19,3,22,6,2007-12-13 18:09:15,2007-12-13 18:09:15
d8b8718a67e816799b295a9fe1a2191bad98b30c...30094cdb68a1672c020aa8f07539c249e5362f46,3,30,11,41,9,2007-12-13 20:36:56,2007-12-13 20:36:56
30094cdb68a1672c020aa8f07539c249e5362f46...a7b7184f09a17cc2b58442e2e5a60aa0a9c911ea,1,1,2,3,2,2007-12-13 20:46:14,2007-12-13 20:46:14
a7b7184f09a17cc2b58442e2e5a60aa0a9c911ea...f94a9d3fa5dba41ea99092c1c30f1a9ccfa271dd,4,25,4,29,9,2007-12-14 17:48:47,2007-12-14 17:48:47
f94a9d3fa5dba41ea99092c1c30f1a9ccfa271dd...be773e7817387d52f012db11288e04ceadbb7134,4,70,5,75,14,2007-12-17 01:45:25,2007-12-17 01:45:25
be773e7817387d52f012db11288e04ceadbb7134...400d30b9c209c724d6e99bea8cd4d5f5ce006e61,1,14,0,14,2,2007-12-17 04:40:03,2007-12-17 04:40:03
400d30b9c209c724d6e99bea8cd4d5f5ce006e61...248195057f9d4d8ad15b12e11921b6dbf7e0fc1d,3,66,23,89,24,2007-12-17 17:51:54,2007-12-17 17:51:54
248195057f9d4d8ad15b12e11921b6dbf7e0fc1d...f4f88f93f4f425cb3ce6d24e9789798205f34b1a,4,198,79,277,36,2007-12-25 01:59:58,2007-12-25 01:59:58
f4f88f93f4f425cb3ce6d24e9789798205f34b1a...a186665dd792aabe3f2cba60880e2d8f1b5017fb,11,392,90,482,93,2008-01-20 22:42:26,2008-01-20 22:42:26
a186665dd792aabe3f2cba60880e2d8f1b5017fb...da8ecf472130fa901330d34e38270d0e84779170,1,0,1,1,1,2008-01-21 02:24:39,2008-01-21 02:24:39
da8ecf472130fa901330d34e38270d0e84779170...9f35516beb3b2df345022a9e97b163d7934ac635,1,7,1,8,2,2008-01-26 18:12:38,2008-01-26 18:12:38
da8ecf472130fa901330d34e38270d0e84779170...e20c9d2b0df280bf3742af2b5b671a008c108436,2,9,2,11,3,2008-01-25 00:41:01,2008-01-25 00:41:01
da8ecf472130fa901330d34e38270d0e84779170...573b11ecd4c9592f4199f9c6f416a372e540765e,4,21,0,21,7,2008-01-24 16:09:24,2008-01-24 16:09:24
b9c78504dbd7d05cf93b02f2bd28d3176184e35e...a3d1609506773c9c67cc2950371dd149d7f0ca4b,1,9,3,12,1,2008-01-25 00:47:57,2008-01-25 00:47:57
9e1d56bdd0c45deede6f1aeddfe40ee7817b50cb...eef739da55fbab471e5adc76c1c7d5af0409499c,4,89,20,109,18,2008-01-27 19:51:47,2008-01-27 19:51:47
eef739da55fbab471e5adc76c1c7d5af0409499c...a518f23a2b8b2a4499113b20057c76824ed5d1ac,1,1,1,2,1,2008-01-31 17:10:21,2008-01-31 17:10:21
a518f23a2b8b2a4499113b20057c76824ed5d1ac...6065088721dd691302785b783179f2ee527d8ec6,3,38,28,66,8,2008-02-01 00:10:52,2008-02-01 00:10:52
6065088721dd691302785b783179f2ee527d8ec6...da99b9c4cf8af1f264549fc8577af00463b1b7a8,3,29,5,34,6,2008-02-01 18:56:41,2008-02-01 18:56:41
da99b9c4cf8af1f264549fc8577af00463b1b7a8...43c52c96ad105efbe329b62ab7e54b0cb5e9f811,1,3,2,5,3,2008-02-01 19:07:55,2008-02-01 19:07:55
a3d1609506773c9c67cc2950371dd149d7f0ca4b...5795cee2f7b12d5da89f0ec565409dbaed30a5af,2,82,4,86,16,2008-01-26 19:20:29,2008-01-26 19:20:29
43c52c96ad105efbe329b62ab7e54b0cb5e9f811...329020083a639d04c052a1a46d8c25d908d74d06,9,181,64,245,32,2008-02-10 21:28:48,2008-02-10 21:28:48
43c52c96ad105efbe329b62ab7e54b0cb5e9f811...4df9632b6a9a8147e4354f5bd586c211d332b7ff,1,5,0,5,2,2008-02-05 20:50:42,2008-02-05 20:50:42
4df9632b6a9a8147e4354f5bd586c211d332b7ff...02c5ac320629639a03ff23844b13453152a9d7b9,2,5,0,5,2,2008-02-05 22:32:44,2008-02-05 22:32:44
02c5ac320629639a03ff23844b13453152a9d7b9...7ab80ff396295a102c85083ebcf38518fdfa3d50,1,2,1,3,2,2008-02-05 22:33:35,2008-02-05 22:33:35
7ab80ff396295a102c85083ebcf38518fdfa3d50...dfd1aaafb8709c416783916200d51fcaea6a7564,1,0,1,1,1,2008-02-05 22:33:52,2008-02-05 22:33:52
32ae4e1d1268f8a754d3495e6564103d618b5b71...ab8490242865014b2ad50e4db50d830e0faf4b62,1,9,1,10,1,2008-02-11 02:34:17,2008-02-11 02:34:17
ab8490242865014b2ad50e4db50d830e0faf4b62...e91eda24151567047219e9c925f3960fdc318dd7,2,70,18,88,8,2008-02-11 16:23:02,2008-02-11 16:23:02
e91eda24151567047219e9c925f3960fdc318dd7...d58f6303583762c74c9d90576d63ce818f1516b2,3,30,0,30,4,2008-02-11 16:37:11,2008-02-11 16:37:11
d58f6303583762c74c9d90576d63ce818f1516b2...4669f5d10b89fbf59ce3d051c376ba19addf2446,1,4,2,6,2,2008-02-11 17:36:51,2008-02-11 17:36:51
4669f5d10b89fbf59ce3d051c376ba19addf2446...f6c30d15f08d567b2f5ae6111443825edc04f1e4,4,19,3,22,6,2008-02-12 04:38:10,2008-02-12 04:38:10
f6c30d15f08d567b2f5ae6111443825edc04f1e4...33b635ea54e5485a8144ba45d3459298fe671208,4,53,7,60,12,2008-02-12 15:12:07,2008-02-12 15:12:07
33b635ea54e5485a8144ba45d3459298fe671208...5b0458b68ed87a0aa12b050694b161e5487ebc4c,1,2,2,4,2,2008-02-13 05:07:01,2008-02-13 05:07:01
5b0458b68ed87a0aa12b050694b161e5487ebc4c...803b7e32d9669807260c8a6549fcf7fe54ab0859,1,2,2,4,1,2008-02-13 05:18:35,2008-02-13 05:18:35
33b635ea54e5485a8144ba45d3459298fe671208...4f4c54fcbbf19207429e58d18f333957756874bc,3,41,14,55,13,2008-02-13 04:59:34,2008-02-13 04:59:34
4f4c54fcbbf19207429e58d18f333957756874bc...b59d9b5f65cd819c528282cafbeaab95d0775efb,4,31,1,32,5,2008-02-13 05:26:39,2008-02-13 05:26:39
031790ba190cb677a89b4a6c75c1905c1c85bc1e...8b6fb113853726ba7b5e1f47900c3a2069826174,1,20,2,22,5,2008-02-14 05:19:21,2008-02-14 05:19:21
8b6fb113853726ba7b5e1f47900c3a2069826174...e895ee68441ba121708bc468974dd94a5d0f8794,6,105,54,159,40,2008-02-14 17:50:13,2008-02-14 17:50:13
e895ee68441ba121708bc468974dd94a5d0f8794...6d1d189d79afe4c4b5f49bb33a44a0708a773b93,1,4,4,8,3,2008-02-14 17:59:10,2008-02-14 17:59:10
6d1d189d79afe4c4b5f49bb33a44a0708a773b93...9eb797ca4dba77225ce700d25007b39e37663e10,1,9,3,12,1,2008-02-17 16:27:41,2008-02-17 16:27:41
9eb797ca4dba77225ce700d25007b39e37663e10...175cfcc70b03ab99411cfae9d8bffc3b7740bebf,1,9,6,15,3,2008-02-17 16:27:57,2008-02-17 16:27:57
6d1d189d79afe4c4b5f49bb33a44a0708a773b93...40aa7d63b949c02315b399cd711bf97e6ca84800,2,20,6,26,5,2008-02-17 03:23:37,2008-02-17 03:23:37
40aa7d63b949c02315b399cd711bf97e6ca84800...1ebb06ede3d50f5018e6dd81009e8f16e8fc2ded,1,16,10,26,7,2008-02-21 04:01:45,2008-02-21 04:01:45
1ebb06ede3d50f5018e6dd81009e8f16e8fc2ded...661156fd1addb479af105f89cc19f54f7874a407,4,18,8,26,5,2008-02-24 16:29:42,2008-02-24 16:29:42
661156fd1addb479af105f89cc19f54f7874a407...0fafc08113b9929320e4689d700c455907ec987f,3,4,4,8,4,2008-02-24 19:15:36,2008-02-24 19:15:36
0fafc08113b9929320e4689d700c455907ec987f...13e6a66d0897a41c31bc0b49dac4c41b74fb14e8,3,29,8,37,8,2008-02-24 19:59:03,2008-02-24 19:59:03
13e6a66d0897a41c31bc0b49dac4c41b74fb14e8...9cb73f240f808d89b9a394286dcae464c1016e6e,4,73,14,87,11,2008-02-25 01:16:36,2008-02-25 01:16:36
9cb73f240f808d89b9a394286dcae464c1016e6e...3fc3a61fdabc5eb663348b2d1dc5080bbdde6823,2,9,1,10,3,2008-02-25 02:45:03,2008-02-25 02:45:03
3fc3a61fdabc5eb663348b2d1dc5080bbdde6823...dce3cb2a9e6b01044af0edd7b1b5bfbfddddcc04,4,67,10,77,18,2008-02-25 23:22:10,2008-02-25 23:22:10
dce3cb2a9e6b01044af0edd7b1b5bfbfddddcc04...880049d39e7bbf5aa496e2e5ee673721fc44e1b4,3,32,16,48,8,2008-02-26 00:13:30,2008-02-26 00:13:30
880049d39e7bbf5aa496e2e5ee673721fc44e1b4...7dc85fae2cf1a4dc178c0a530a9822f955ec9885,6,172,53,225,29,2008-02-26 21:50:29,2008-02-26 21:50:29
7dc85fae2cf1a4dc178c0a530a9822f955ec9885...158889dccdf44fad5ecf066df727ee6006b719e1,11,125,47,172,42,2008-02-27 23:17:48,2008-02-27 23:17:48
158889dccdf44fad5ecf066df727ee6006b719e1...ed155a7fdbe3f85a3909d238b5777838915bbea4,1,1,0,1,1,2008-02-27 23:36:26,2008-02-27 23:36:26
ed155a7fdbe3f85a3909d238b5777838915bbea4...a00a904aa7f3f87a1cc6bd7d9c8a9d6b4d2e3cbb,1,1,1,2,1,2008-02-27 23:56:42,2008-02-27 23:56:42
a00a904aa7f3f87a1cc6bd7d9c8a9d6b4d2e3cbb...8a66ac7a48e608c2939817d826af355e698a880c,1,12,4,16,2,2008-02-28 18:38:56,2008-02-28 18:38:56
8a66ac7a48e608c2939817d826af355e698a880c...225d58f88ee2233ef868ef570228bcbe52735dd1,1,30,41,71,10,2008-02-28 21:29:31,2008-02-28 21:29:31
225d58f88ee2233ef868ef570228bcbe52735dd1...9620db309dcebfc7ee45b1cfca36d3380aabb20f,1,4,5,9,1,2008-02-29 13:08:40,2008-02-29 13:08:40
9620db309dcebfc7ee45b1cfca36d3380aabb20f...00b50ed6eb5ef3f4eb80695ea4cbb0df98fdd510,1,15,11,26,2,2008-02-29 16:11:54,2008-02-29 16:11:54
00b50ed6eb5ef3f4eb80695ea4cbb0df98fdd510...782ceb6f3b96dd4147691416ab616f3cf9a44b33,5,69,8,77,18,2008-02-29 17:00:17,2008-02-29 17:00:17
782ceb6f3b96dd4147691416ab616f3cf9a44b33...5b4f184fcc018e89e7dcb74c7c8c41e14ea2e279,1,7,6,13,5,2008-02-29 17:03:03,2008-02-29 17:03:03
5b4f184fcc018e89e7dcb74c7c8c41e14ea2e279...c2e932245f2e4fb00f1abbb94fa0b4a4a69636df,1,1,1,2,1,2008-02-29 17:09:28,2008-02-29 17:09:28
64cf047baf3ebc7532d1d21c77cbddcda0059723...79552ed639dbedc017809a401e39b360abdf8212,5,24,21,45,8,2008-03-05 21:51:27,2008-03-05 21:51:27
79552ed639dbedc017809a401e39b360abdf8212...98623f14105afcec4e2ee8b9ed5abac00ceb4294,1,1,1,2,2,2008-03-06 02:11:18,2008-03-06 02:11:18
98623f14105afcec4e2ee8b9ed5abac00ceb4294...cb778b072b9daf5c9ceb348fbe9578afe6b312b4,2,27,6,33,2,2008-03-06 20:03:12,2008-03-06 20:03:12
cb778b072b9daf5c9ceb348fbe9578afe6b312b4...d6f4757d2ed8ebf0eee31755d250c5ac701cba5e,1,19,15,34,4,2008-03-06 23:06:06,2008-03-06 23:06:06
c2e932245f2e4fb00f1abbb94fa0b4a4a69636df...5e68964e9e5e938b4f4ea7581e79c7cd5a4ecd83,9,241,51,292,43,2008-03-09 04:16:41,2008-03-09 04:16:41
c2e932245f2e4fb00f1abbb94fa0b4a4a69636df...67f1992ff03992235b50cb2f4ca7d226919651b2,1,12,3,15,1,2008-02-29 18:07:28,2008-02-29 18:07:28
45b79abf1fa298f0bb5f9d424b754b1168417ef3...00008aa0d65b88dc0db93bfb1ee12cf34286403d,5,34,17,51,17,2008-03-09 13:40:34,2008-03-09 13:40:34
00008aa0d65b88dc0db93bfb1ee12cf34286403d...d496242919cbf453af193295633c30e6157178b0,5,42,25,67,13,2008-03-09 15:05:25,2008-03-09 15:05:25
d496242919cbf453af193295633c30e6157178b0...fba714c58325b4670f9fd3ca76db0268d55d7f0f,10,207,141,348,80,2008-03-13 19:39:09,2008-03-13 19:39:09
fba714c58325b4670f9fd3ca76db0268d55d7f0f...5453076375d0af3c6bf9995b6feacbba332792b3,5,225,9,234,10,2008-03-14 22:24:48,2008-03-14 22:24:48
5453076375d0af3c6bf9995b6feacbba332792b3...a9f83f3cb0a9fda8c09eb3819839a7b38598e785,4,10,2,12,5,2008-03-15 01:35:59,2008-03-15 01:35:59
a9f83f3cb0a9fda8c09eb3819839a7b38598e785...1d325d343e6fad0a0fa2fb3688246465801d002a,1,5,0,5,1,2008-03-15 02:36:00,2008-03-15 02:36:00
1d325d343e6fad0a0fa2fb3688246465801d002a...345bd373dbfad04d9504b897205b7118095cf534,2,27,2,29,8,2008-03-15 02:36:07,2008-03-15 02:36:07
345bd373dbfad04d9504b897205b7118095cf534...44e0674aa043ed8691d9b789f6048a7ef26f4777,1,10,1,11,3,2008-03-15 03:28:14,2008-03-15 03:28:14
44e0674aa043ed8691d9b789f6048a7ef26f4777...bdacd93bb86f41213bd52ad032eedfb48605bcd2,9,120,64,184,62,2008-03-17 00:59:19,2008-03-17 00:59:19
bdacd93bb86f41213bd52ad032eedfb48605bcd2...a184e0c0810e08b506b9ab423e45ef1653ba2a45,2,62,1,63,7,2008-03-17 16:00:02,2008-03-17 16:00:02
bdacd93bb86f41213bd52ad032eedfb48605bcd2...bc24557b01a34b7f1bad61215b12fd1bb9c5b799,3,13,3,16,5,2008-03-17 15:59:34,2008-03-17 15:59:34
8bc45889bc1d6f01c6c17f4ff4e79337aeb9add6...b4fb182be31c9211572e4b7bf0ebb44082e410d6,10,377,323,700,10,2008-03-18 15:22:06,2008-03-18 15:22:06
b4fb182be31c9211572e4b7bf0ebb44082e410d6...d78703a4a65d8faf790460df9cccfed1e011d519,1,7,7,14,7,2008-03-18 17:53:31,2008-03-18 17:53:31
d78703a4a65d8faf790460df9cccfed1e011d519...b89cecfcdb362978af1e56fd9c216660fb74628d,4,14,8,22,9,2008-03-18 18:04:57,2008-03-18 18:04:57
b89cecfcdb362978af1e56fd9c216660fb74628d...254b2cf6bb7ac202278574cf3a4f262d78f32ec5,2,67,15,82,14,2008-03-18 19:18:15,2008-03-18 19:18:15
254b2cf6bb7ac202278574cf3a4f262d78f32ec5...d57a80c13e77ae67da3639151e2be124bd8a90b2,4,52,10,62,20,2008-03-18 20:40:27,2008-03-18 20:40:27
254b2cf6bb7ac202278574cf3a4f262d78f32ec5...442b5a3cd2378d1a5a5205cedde0853f4bfc0716,1,6,0,6,1,2008-03-18 20:19:10,2008-03-18 20:19:10
442b5a3cd2378d1a5a5205cedde0853f4bfc0716...c4e8445b1b06ceb1788a0cf3690b92bc382868e8,1,4,4,8,4,2008-03-18 20:40:10,2008-03-18 20:40:10
39219eb53e2358cd25aeae3a1206fe3e84e162e9...68e580e5d97ec5de1c698c4adfa2eb164bcc9179,1,2,1,3,1,2008-03-18 21:06:49,2008-03-18 21:06:49
39219eb53e2358cd25aeae3a1206fe3e84e162e9...462460c3ae16fc84a07c7d9534573078146556fe,3,11,17,28,10,2008-03-18 20:46:06,2008-03-18 20:46:06
462460c3ae16fc84a07c7d9534573078146556fe...34b7a23e12566a573276c9f0c8d99416503bce76,2,24,2,26,14,2008-03-18 21:30:34,2008-03-18 21:30:34
cc36e06ec9ff47ab7e234f644567c588067f4e24...67362c66041eda298494411d278fa8337df7b20b,1,13,12,25,4,2008-03-18 21:56:53,2008-03-18 21:56:53
67362c66041eda298494411d278fa8337df7b20b...83bc6fed8b3c0b37e4468605f64401377a0e4ff9,2,6,3,9,4,2008-03-18 22:05:22,2008-03-18 22:05:22
83bc6fed8b3c0b37e4468605f64401377a0e4ff9...b6103b157689153ac382e78710cf309b4302c741,2,14,8,22,9,2008-03-18 22:22:04,2008-03-18 22:22:04
b6103b157689153ac382e78710cf309b4302c741...7fd658e32933f963ce698380e4bd63366b7c28c9,5,14,12,26,10,2008-03-19 00:47:51,2008-03-19 00:47:51
7fd658e32933f963ce698380e4bd63366b7c28c9...9eac8e13011cd1345b60833dd0b018a1969875e6,1,1,0,1,1,2008-03-19 21:06:41,2008-03-19 21:06:41
9eac8e13011cd1345b60833dd0b018a1969875e6...5ed74a7959bf3c6284a876d56ead79a20b1db293,1,6,2,8,2,2008-03-20 00:56:35,2008-03-20 00:56:35
5ed74a7959bf3c6284a876d56ead79a20b1db293...ea8b9b6552edc4e8a8d7d14c0bd7a9444112b07d,2,487,450,937,2,2008-03-20 00:56:45,2008-03-20 00:56:45
ea8b9b6552edc4e8a8d7d14c0bd7a9444112b07d...b2f5b8ede76bd31e5c2945f1cc8d6e6cf2ab7d08,3,9,8,17,10,2008-03-20 17:03:10,2008-03-20 17:03:10
ea8b9b6552edc4e8a8d7d14c0bd7a9444112b07d...c151c09edde81e0f2aee79e71a5e1178e64d7c24,1,3,3,6,2,2008-03-20 16:56:55,2008-03-20 16:56:55
c151c09edde81e0f2aee79e71a5e1178e64d7c24...0c1a9d5440aa13327d0fe48a985a18a7541cb3b8,2,22,11,33,9,2008-03-20 17:01:45,2008-03-20 17:01:45
d51bf8ed1cfc4b9824e4a0091a4b5ac1c4a7d978...7f8f49696ae2dead3ea98c07e6bbfe00d491cc24,2,5,3,8,3,2008-03-20 17:45:45,2008-03-20 17:45:45
7f8f49696ae2dead3ea98c07e6bbfe00d491cc24...51e9159c2b66e65b78e611f13d5c452995164a4a,1,9,0,9,1,2008-03-20 17:53:18,2008-03-20 17:53:18
51e9159c2b66e65b78e611f13d5c452995164a4a...f8a960b7a05edee7bf5652e164ea96f976b7d340,1,4,2,6,1,2008-03-20 20:28:26,2008-03-20 20:28:26
f8a960b7a05edee7bf5652e164ea96f976b7d340...cf6cd6c60b2e604eb0acb68c96b2a027ccdeafe8,10,110,70,180,37,2008-03-21 22:21:22,2008-03-21 22:21:22
cf6cd6c60b2e604eb0acb68c96b2a027ccdeafe8...f3fd7c2b7aa11913988714b7220894d1edaa7997,4,38,6,44,7,2008-03-22 00:01:49,2008-03-22 00:01:49
f3fd7c2b7aa11913988714b7220894d1edaa7997...e74876b16f4ba30953664c9be1b6e96c77eeacc9,3,111,79,190,48,2008-03-23 09:06:02,2008-03-23 09:06:02
e74876b16f4ba30953664c9be1b6e96c77eeacc9...c316b49774669ba42d28aa7319741a8400ebc8a1,5,24,0,24,1,2008-03-24 16:11:07,2008-03-24 16:11:07
c316b49774669ba42d28aa7319741a8400ebc8a1...8cdedebc9c653bfced237db6c46dfe6453b35114,7,133,10,143,16,2008-03-24 22:04:22,2008-03-24 22:04:22
8cdedebc9c653bfced237db6c46dfe6453b35114...a46965e0103759e1a8afe818dd3d8ad093fbe8ae,4,6,7,13,5,2008-03-26 18:51:47,2008-03-26 18:51:47
8cdedebc9c653bfced237db6c46dfe6453b35114...2674c112b4083db761d7d86f66dbe476cb319dd8,1,2,2,4,2,2008-03-26 14:02:59,2008-03-26 14:02:59
2674c112b4083db761d7d86f66dbe476cb319dd8...ac374d9a814234ec9fb279f13e8866d4cb6f714e,2,9,1,10,2,2008-03-26 14:11:29,2008-03-26 14:11:29
ac374d9a814234ec9fb279f13e8866d4cb6f714e...5a72f148c8ea29f42ba8f30010b108dc852583ba,1,10,0,10,1,2008-03-26 14:16:39,2008-03-26 14:16:39
0625b5ae6b025da8a4078375499dd796542491a1...8000d4ee4fdc28d4d77706d6ed922bd70e4cfc1a,2,3,3,6,3,2008-03-26 20:22:16,2008-03-26 20:22:16
8000d4ee4fdc28d4d77706d6ed922bd70e4cfc1a...bcc3195cdff266cb3abc508e0ff655ada612a429,1,16,0,16,2,2008-03-26 17:38:44,2008-03-26 17:38:44
bcc3195cdff266cb3abc508e0ff655ada612a429...3ab88c6cad2893788c4f5bf2d134a431e493dd1c,1,0,7,7,1,2008-03-26 17:39:41,2008-03-26 17:39:41
3ab88c6cad2893788c4f5bf2d134a431e493dd1c...653391be436668936e4f4cdaf6bfbd90c43f2661,4,20,18,38,18,2008-03-26 21:50:18,2008-03-26 21:50:18
653391be436668936e4f4cdaf6bfbd90c43f2661...61986187e9ccb4b5e914065a67bb0b937cb20a38,1,32,22,54,7,2008-03-27 01:11:37,2008-03-27 01:11:37
61986187e9ccb4b5e914065a67bb0b937cb20a38...5fab4bb711f6983c9db4daacee1dcbd474d2123a,1,1,1,2,1,2008-03-27 13:37:37,2008-03-27 13:37:37
5fab4bb711f6983c9db4daacee1dcbd474d2123a...add70a7068f0c70e1d022e5ab7d90085f394a1f3,1,81,81,162,1,2008-03-27 14:16:24,2008-03-27 14:16:24
add70a7068f0c70e1d022e5ab7d90085f394a1f3...56df95be7831ad7e74cb7e84df0d2eed59a65993,1,81,81,162,1,2008-03-27 14:20:08,2008-03-27 14:20:08
56df95be7831ad7e74cb7e84df0d2eed59a65993...48de06f6e975c57b99f3682098896c33eeb9251e,5,73,13,86,18,2008-03-27 21:48:07,2008-03-27 21:48:07
48de06f6e975c57b99f3682098896c33eeb9251e...29c2b615c22794f383ea88b6b8c3c465a9f2ac9a,2,24,5,29,7,2008-03-28 15:38:23,2008-03-28 15:38:23
29c2b615c22794f383ea88b6b8c3c465a9f2ac9a...fc7ab45ea01ac6bb089798da085a0e8335b6f087,1,4,4,8,4,2008-03-28 22:40:35,2008-03-28 22:40:35
fc7ab45ea01ac6bb089798da085a0e8335b6f087...11e09542d43b06f09f40e6c13f2f11d5bde067e3,1,2,6,8,3,2008-03-29 15:07:18,2008-03-29 15:07:18
11e09542d43b06f09f40e6c13f2f11d5bde067e3...37095424598dc1431e633097cca1d6875201a9c4,1,3,2,5,2,2008-03-29 21:32:42,2008-03-29 21:32:42
37095424598dc1431e633097cca1d6875201a9c4...a34ad50532c0dcf0c8de0f8f02592692dd0337fa,2,5,2,7,5,2008-03-29 21:49:13,2008-03-29 21:49:13
a34ad50532c0dcf0c8de0f8f02592692dd0337fa...93b8ffe1830891f093dd466d55625043e1ad2abb,6,196,12,208,14,2008-03-30 03:30:44,2008-03-30 03:30:44
93b8ffe1830891f093dd466d55625043e1ad2abb...b9666b4db13c2abeb1414b5f730f3baf166b42eb,2,6,1,7,2,2008-03-31 12:35:28,2008-03-31 12:35:28
b9666b4db13c2abeb1414b5f730f3baf166b42eb...e21dfab42e71b4f12351f3a455da8e9f23fe7666,3,4,4,8,3,2008-03-31 13:39:43,2008-03-31 13:39:43
e21dfab42e71b4f12351f3a455da8e9f23fe7666...985d443af0c39a46e3c0257a981595f36cbb7665,1,6,2,8,1,2008-03-31 15:00:26,2008-03-31 15:00:26
985d443af0c39a46e3c0257a981595f36cbb7665...49a9019ec686a968d9ee44ce329d7c5a62a7411e,1,31,1,32,3,2008-03-31 16:02:04,2008-03-31 16:02:04
985d443af0c39a46e3c0257a981595f36cbb7665...74e521644223c1502a6c7408bd55b5a4cc199850,1,5,3,8,4,2008-03-31 15:50:45,2008-03-31 15:50:45
f51fd34f916470ad59bd562ffb5b39171e65087e...cd788a2a0eab200a34acf6ac167fc2fc7f3e3c77,1,18,18,36,4,2008-03-31 16:07:18,2008-03-31 16:07:18
cd788a2a0eab200a34acf6ac167fc2fc7f3e3c77...5241d1f3adb9e23061caffab6d948fdee730e657,1,17,10,27,3,2008-03-31 16:59:03,2008-03-31 16:59:03
5241d1f3adb9e23061caffab6d948fdee730e657...042da8c2ab15dfc6886846a90150ea8a9ecfc8bb,1,34,11,45,5,2008-03-31 19:06:58,2008-03-31 19:06:58
042da8c2ab15dfc6886846a90150ea8a9ecfc8bb...de0a31a3f02ab58adce174be27ba6d6b126b5726,3,7,1,8,5,2008-04-01 21:58:33,2008-04-01 21:58:33
de0a31a3f02ab58adce174be27ba6d6b126b5726...754bf29e56ee4292c6a3e6fd1cad69ccb56a502f,1,6,0,6,1,2008-04-07 15:22:40,2008-04-07 15:22:40
754bf29e56ee4292c6a3e6fd1cad69ccb56a502f...f26b090d41d18be8ffc0d85ede21cc134ccdc95a,3,13,4,17,5,2008-04-07 17:08:28,2008-04-07 17:08:28
f26b090d41d18be8ffc0d85ede21cc134ccdc95a...993e4fd96751ce1e0b409dbc56bde39109a9bddb,2,10,10,20,2,2008-04-07 17:35:58,2008-04-07 17:35:58
993e4fd96751ce1e0b409dbc56bde39109a9bddb...a3f3a664a8dd83399c72021233c96a9ad4735a3d,4,12,4,16,6,2008-04-08 19:42:14,2008-04-08 19:42:14
a3f3a664a8dd83399c72021233c96a9ad4735a3d...84fd0d5390c5432eebfe27ea1c17556af02fcd87,2,3,1,4,2,2008-04-17 14:12:25,2008-04-17 14:12:25
a3f3a664a8dd83399c72021233c96a9ad4735a3d...9c2a3c7c3240f25b3c4a60d131c1888a11dc3452,1,1,1,2,1,2008-04-12 23:26:14,2008-04-12 23:26:14
9c2a3c7c3240f25b3c4a60d131c1888a11dc3452...f3a45cf3a1d29530bf5ccb7d6181a2e1e7c4a667,2,7,0,7,3,2008-04-13 16:32:37,2008-04-13 16:32:37
eb204a454cfc4c9ae427b48cfd01fe2a4921a59e...8210548d7f4ca320def5567eed98aacec254bfad,9,84,17,101,33,2008-04-25 21:24:27,2008-04-25 21:24:27
8210548d7f4ca320def5567eed98aacec254bfad...50f7e4dc7a192e879e6d3cc9515428d3efb39aef,1,1,1,2,1,2008-04-28 16:36:36,2008-04-28 16:36:36
50f7e4dc7a192e879e6d3cc9515428d3efb39aef...c6c693fdcc1bf49b8cc8065d7a5b2cfac6f27e6d,1,24,2,26,4,2008-04-30 12:47:31,2008-04-30 12:47:31
50f7e4dc7a192e879e6d3cc9515428d3efb39aef...a8339eedf68b1a7b483840c2c8236aea98970347,1,16,5,21,4,2008-04-28 19:19:53,2008-04-28 19:19:53
a8339eedf68b1a7b483840c2c8236aea98970347...9b01407c9fd32d3c208346857499e745b2f5c6e8,1,11,2,13,1,2008-04-29 19:34:11,2008-04-29 19:34:11
b740de9c3b583cad95dfff3160dc525653392a13...bd7abd981b6a034bfa664df1fea3275b17b1e5cc,1,17,25,42,5,2008-04-30 13:02:15,2008-04-30 13:02:15
bd7abd981b6a034bfa664df1fea3275b17b1e5cc...29962eaf8166dfa7271667a8434c3e99017e11a4,1,4,2,6,1,2008-04-30 13:13:19,2008-04-30 13:13:19
9b01407c9fd32d3c208346857499e745b2f5c6e8...d67a202c1401bef19321db91b7ccc8bb69ccaf39,3,17,5,22,5,2008-04-30 23:31:54,2008-04-30 23:31:54
def9b1ba010e14929da493fe55d0bce586023e46...548adc2678223e2f5f31f9819ebd3e1111026395,3,25,10,35,10,2008-05-01 14:22:05,2008-05-01 14:22:05
548adc2678223e2f5f31f9819ebd3e1111026395...90e1b8955fa3782f61d8cdd1e8a1cf54a8e865f7,1,6,0,6,6,2008-05-01 14:43:13,2008-05-01 14:43:13
90e1b8955fa3782f61d8cdd1e8a1cf54a8e865f7...a48c6c2fa6993a63b42d3411393caf0f5f25f073,1,1,1,2,1,2008-05-01 14:55:18,2008-05-01 14:55:18
a48c6c2fa6993a63b42d3411393caf0f5f25f073...6cc05ab96e8a22c26ae50b99cb8d57ce35bb9cbe,2,26,3,29,6,2008-05-02 21:42:19,2008-05-02 21:42:19
6cc05ab96e8a22c26ae50b99cb8d57ce35bb9cbe...86f689d3ac4124f74872eff9e1143bd826987327,1,2,1,3,2,2008-05-08 03:25:04,2008-05-08 03:25:04
86f689d3ac4124f74872eff9e1143bd826987327...36435d4e78fc839dafceb46a342b8c1c6b3abe22,2,13,4,17,8,2008-05-16 20:42:37,2008-05-16 20:42:37
36435d4e78fc839dafceb46a342b8c1c6b3abe22...9fba70e49f1ee1fb5be8c0fa02124784520d79d4,6,421,381,802,19,2008-06-03 00:27:45,2008-06-03 00:27:45
9fba70e49f1ee1fb5be8c0fa02124784520d79d4...1c6210915469d1b4fb3e843e604f3d7ab87c1f9b,3,84,9,93,9,2008-06-03 02:33:42,2008-06-03 02:33:42
1c6210915469d1b4fb3e843e604f3d7ab87c1f9b...4cd64845186ceecdd196a38ee1778b3f99f4e5ea,2,6,4,10,4,2008-06-03 03:08:55,2008-06-03 03:08:55
4cd64845186ceecdd196a38ee1778b3f99f4e5ea...68fc2216b0034b01d12c5fcb0603430f3c351d1a,3,48,7,55,15,2008-06-06 12:39:04,2008-06-06 12:39:04
68fc2216b0034b01d12c5fcb0603430f3c351d1a...ed259a42e88befe6da414d95736e6562c615a32a,1,7,1,8,2,2008-06-06 13:33:20,2008-06-06 13:33:20
ed259a42e88befe6da414d95736e6562c615a32a...877b72efcdd55f9fc9b271c707d4b489e551793d,7,135,56,191,65,2008-06-06 13:38:22,2008-06-06 13:38:22
877b72efcdd55f9fc9b271c707d4b489e551793d...3051b961cac30f9bf81ac72b816ddb5e8e3c2ee9,37,8785,8785,17570,42,2008-06-06 13:43:15,2008-06-06 13:43:15
3051b961cac30f9bf81ac72b816ddb5e8e3c2ee9...1625885eb7d094d819eb30e706c5f881cb8bc901,1,16,12,28,8,2008-06-06 14:17:58,2008-06-06 14:17:58
1625885eb7d094d819eb30e706c5f881cb8bc901...6ba343cdf2aac0f7205abe3216fec6b19854370c,2,6,5,11,5,2008-06-06 14:47:39,2008-06-06 14:47:39
6ba343cdf2aac0f7205abe3216fec6b19854370c...92d2e867b764c9f43df2a9b510044d64b7c682a4,1,3,2,5,2,2008-06-07 13:19:49,2008-06-07 13:19:49
92d2e867b764c9f43df2a9b510044d64b7c682a4...343ce211106066bbf695982c1fbb04df6fffc6d5,2,19,6,25,7,2008-06-08 16:11:50,2008-06-08 16:11:50
343ce211106066bbf695982c1fbb04df6fffc6d5...800f84ed59825b1cfa08864bec18998177fa13a0,1,2,2,4,2,2008-06-08 20:41:43,2008-06-08 20:41:43
800f84ed59825b1cfa08864bec18998177fa13a0...485fb3efc4c0bcf32b8231dbc6aba15dfe3e1366,1,1,1,2,1,2008-06-08 20:43:12,2008-06-08 20:43:12
6ba343cdf2aac0f7205abe3216fec6b19854370c...3ac43db818cff02d923383f13e07e4b4029b4d8a,5,148,171,319,25,2008-06-06 18:59:58,2008-06-06 18:59:58
3ac43db818cff02d923383f13e07e4b4029b4d8a...5080d260b01f51dbf083245729763fedc9f5e8b8,5,89,99,188,30,2008-06-08 14:58:19,2008-06-08 14:58:19
5080d260b01f51dbf083245729763fedc9f5e8b8...4690479e3494686003317b6d98f0a4b705794a14,4,11,6,17,5,2008-06-09 19:05:00,2008-06-09 19:05:00
4690479e3494686003317b6d98f0a4b705794a14...1aeaa4f34d9778b391f287542c0acb40daa21456,3,7,4,11,6,2008-06-10 17:13:05,2008-06-10 17:13:05
94cb05e36a01ef7317795c8f06a378e75005ef3f...bb7e499d705f6f10dd0a727e0d81c59dcbc85aa5,4,9,368,377,7,2008-06-10 20:57:25,2008-06-10 20:57:25
bb7e499d705f6f10dd0a727e0d81c59dcbc85aa5...4bda2a91c6241d9fe7891cb6f3c168373c08169d,1,1,3,4,2,2008-06-10 21:20:15,2008-06-10 21:20:15
4bda2a91c6241d9fe7891cb6f3c168373c08169d...1d8c3e37b32a11d2e2b64fee019782f5efdd19c6,11,58,30,88,29,2008-06-11 20:58:34,2008-06-11 20:58:34
1d8c3e37b32a11d2e2b64fee019782f5efdd19c6...652faabd1854bac70edc5b7976065ea0a2af4f22,3,35,6,41,6,2008-06-17 20:57:12,2008-06-17 20:57:12
1d8c3e37b32a11d2e2b64fee019782f5efdd19c6...c79a5e1753d25f261a059b33a172ea3534fd67f3,2,9,4,13,4,2008-06-12 15:56:40,2008-06-12 15:56:40
c79a5e1753d25f261a059b33a172ea3534fd67f3...e0ac9757ac5c71187eea331f88d16e5bb1df2b90,2,8,6,14,4,2008-06-12 20:19:29,2008-06-12 20:19:29
e0ac9757ac5c71187eea331f88d16e5bb1df2b90...683671d4bbd039d88144d01061e9f37a58262cf4,1,15,8,23,4,2008-06-13 18:28:43,2008-06-13 18:28:43
f5947576e2079076698bfeedc97ef65c581dca26...f1b1ff1f7938fdcc662f4e1612aaf3f54415d5b7,1,1,1,2,1,2008-06-17 21:02:29,2008-06-17 21:02:29
f1b1ff1f7938fdcc662f4e1612aaf3f54415d5b7...5d2cdfbad07ca56bef939b44eea3599cbd043835,2,25,3,28,12,2008-06-18 21:34:14,2008-06-18 21:34:14
5d2cdfbad07ca56bef939b44eea3599cbd043835...cb18407a0d3dccfb910aa4ef9afb1aabb627bcc9,4,31,7,38,9,2008-06-23 20:28:25,2008-06-23 20:28:25
cb18407a0d3dccfb910aa4ef9afb1aabb627bcc9...26dea1fcd61c67d30f596b68f746659ddb98d3a0,8,146,72,218,53,2008-06-24 21:31:51,2008-06-24 21:31:51
26dea1fcd61c67d30f596b68f746659ddb98d3a0...fd39a9c15b046d2db924926fd11192a02fea1114,1,1,1,2,1,2008-06-25 14:46:33,2008-06-25 14:46:33
26dea1fcd61c67d30f596b68f746659ddb98d3a0...240c50cee394684f99aaa2a85b0df952598af045,1,8,2,10,3,2008-06-25 13:00:42,2008-06-25 13:00:42
24d5031c9b35ffea4601860f0320388b7b516324...dc3966299474e8bf468c48027b0f161c1364f8aa,2,4,7,11,4,2008-06-25 17:08:51,2008-06-25 17:08:51
dc3966299474e8bf468c48027b0f161c1364f8aa...4bab168e0f3fe3162a636ac780af1675e2dda11e,4,49,31,80,11,2008-06-25 18:25:34,2008-06-25 18:25:34
240c50cee394684f99aaa2a85b0df952598af045...17b7872504ca6e960daca6b4d3957b8fd80ca3fa,1,2,2,4,2,2008-06-25 21:03:08,2008-06-25 21:03:08
4bab168e0f3fe3162a636ac780af1675e2dda11e...2fc57c4159cc081d6aa38883e1db0a68be79e3af,7,100,64,164,30,2008-06-25 21:13:40,2008-06-25 21:13:40
0c1fd901afa04a142d35870bd007a68b0870d472...3d428ce45949adf03d9478d4223db55238f08197,2,34,21,55,4,2008-06-25 22:58:04,2008-06-25 22:58:04
3d428ce45949adf03d9478d4223db55238f08197...59a93423a940c65256efc544ca83d3e4616c31c2,2,34,1,35,8,2008-06-25 23:41:30,2008-06-25 23:41:30
59a93423a940c65256efc544ca83d3e4616c31c2...1f433f935d3e6dd63eeec0ad9e1ea6d161545ab6,4,25,8,33,7,2008-06-26 13:09:19,2008-06-26 13:09:19
1f433f935d3e6dd63eeec0ad9e1ea6d161545ab6...15dfe43b34d93b772203074e4f83dfe4601d523b,2,49,22,71,17,2008-06-26 14:33:06,2008-06-26 14:33:06
15dfe43b34d93b772203074e4f83dfe4601d523b...1620d7ebdf78eb171fffbd6f66401b475c8791ad,1,16,3,19,2,2008-06-26 14:39:32,2008-06-26 14:39:32
1620d7ebdf78eb171fffbd6f66401b475c8791ad...9dbbf6065e0e1305388fc7eb2a9822ccea3ec7e4,2,34,7,41,9,2008-06-26 19:05:14,2008-06-26 19:05:14
9dbbf6065e0e1305388fc7eb2a9822ccea3ec7e4...58d84f51f2ecf26d3926bb648b88b4e97d410244,3,29,6,35,13,2008-06-26 19:30:54,2008-06-26 19:30:54
58d84f51f2ecf26d3926bb648b88b4e97d410244...0c4751cb7856a849963841e59784d5058557e9a0,3,41,6,47,16,2008-06-26 23:11:19,2008-06-26 23:11:19
0c4751cb7856a849963841e59784d5058557e9a0...d3e3876751b6becc9084b5508fd0a48178f30b1b,6,28,2,30,6,2008-06-27 18:35:05,2008-06-27 18:35:05
d3e3876751b6becc9084b5508fd0a48178f30b1b...b1a480423bb8136f69a573413dcc097a900342a4,9,125,13,138,18,2008-06-27 22:35:03,2008-06-27 22:35:03
b1a480423bb8136f69a573413dcc097a900342a4...d85e75b674f5ea45e936ca3a5409b54d937f361a,2,15,4,19,5,2008-06-28 17:46:59,2008-06-28 17:46:59
d85e75b674f5ea45e936ca3a5409b54d937f361a...0bc5be592deca0fa4fa869931fd340035295d5c7,5,53,18,71,14,2008-06-30 02:33:59,2008-06-30 02:33:59
0bc5be592deca0fa4fa869931fd340035295d5c7...f05e5000552cb6beaaaa996933cd63d19ca4414a,1,1,1,2,1,2008-06-30 13:40:39,2008-06-30 13:40:39
f05e5000552cb6beaaaa996933cd63d19ca4414a...89b2164a18f1a5f08d401b58deabe860e49834b1,8,102,44,146,41,2008-07-01 01:08:31,2008-07-01 01:08:31
89b2164a18f1a5f08d401b58deabe860e49834b1...fc0e91f68eed24a29f621604004dece18ee54875,2,19,3,22,9,2008-07-01 17:13:41,2008-07-01 17:13:41
fc0e91f68eed24a29f621604004dece18ee54875...b3f5a1f27fa034302efe813fc9f650ae875728b8,2,19,1,20,6,2008-07-02 00:01:28,2008-07-02 00:01:28
b3f5a1f27fa034302efe813fc9f650ae875728b8...1bf45a0843ae3f28977f3a26a637c478ac557371,8,84,27,111,27,2008-07-07 22:57:04,2008-07-07 22:57:04
1bf45a0843ae3f28977f3a26a637c478ac557371...ee68a8e252224d3d771bc08c17078fb50e12d885,10,70,20,90,16,2008-07-09 16:32:11,2008-07-09 16:32:11
1bf45a0843ae3f28977f3a26a637c478ac557371...23b34b4c94bcf7bd36b64f3a10abf3c407db4f87,1,6,6,12,1,2008-07-09 15:24:45,2008-07-09 15:24:45
7bb172c2af1c71c174c04d10feb30155667d506c...017d3126bc6d701ef8662e806b8a0015e6f8b777,6,37,19,56,10,2008-07-09 20:29:58,2008-07-09 20:29:58
017d3126bc6d701ef8662e806b8a0015e6f8b777...45d933fc4aaff74dd5091991e5dd54b8ecfc2889,2,4,2,6,2,2008-07-09 20:34:45,2008-07-09 20:34:45
45d933fc4aaff74dd5091991e5dd54b8ecfc2889...86fd5369aa675b0f0aa2ed46877c32e3a73b9521,1,18,9,27,10,2008-07-10 13:35:30,2008-07-10 13:35:30
86fd5369aa675b0f0aa2ed46877c32e3a73b9521...51bb240a58e2f80c338a8295f837711dad1a713b,7,81,78,159,27,2008-07-11 16:27:23,2008-07-11 16:27:23
51bb240a58e2f80c338a8295f837711dad1a713b...09da292c09789605ba469662e7775d6779475dbf,4,73,37,110,22,2008-07-11 20:47:02,2008-07-11 20:47:02
09da292c09789605ba469662e7775d6779475dbf...61621194a37dfd1a10f9af4af3d26c2abb4b9715,1,1,0,1,1,2008-07-26 18:28:20,2008-07-26 18:28:20
09da292c09789605ba469662e7775d6779475dbf...7748534935430097eaaaa9d8a2eff03c96d959bf,1,2,2,4,1,2008-07-15 17:56:51,2008-07-15 17:56:51
7748534935430097eaaaa9d8a2eff03c96d959bf...b927502bca904aa070459ccfcc13094fba1b891b,1,4,3,7,2,2008-07-15 21:30:18,2008-07-15 21:30:18
b927502bca904aa070459ccfcc13094fba1b891b...b9631268a2a469ff916c3901d913dd1ebb68a1d5,1,6,1,7,1,2008-07-15 22:51:17,2008-07-15 22:51:17
b9631268a2a469ff916c3901d913dd1ebb68a1d5...5abe19bb16b8dde6acb9e4e7554969e88abc10fc,1,1,1,2,1,2008-07-15 22:56:48,2008-07-15 22:56:48
5abe19bb16b8dde6acb9e4e7554969e88abc10fc...db271db1910e885e59e4539d2b207253b8486151,1,5,1,6,1,2008-07-15 23:53:13,2008-07-15 23:53:13
db271db1910e885e59e4539d2b207253b8486151...78050af53b4fee614b1f59fddb0f85b740def6a3,1,1,0,1,1,2008-07-16 00:53:40,2008-07-16 00:53:40
78050af53b4fee614b1f59fddb0f85b740def6a3...f164a412fc23988857ff9f00c9ad23e5f9a580e9,1,3,3,6,1,2008-07-16 01:20:32,2008-07-16 01:20:32
f164a412fc23988857ff9f00c9ad23e5f9a580e9...4bfd28fa4839dfc98aef7c3e7ee0567eefd36b5c,5,46,33,79,13,2008-07-16 18:36:10,2008-07-16 18:36:10
4bfd28fa4839dfc98aef7c3e7ee0567eefd36b5c...7d5c131193f1740e4efe1750b58e1e4c3471b6e7,3,12,20,32,5,2008-07-16 21:21:47,2008-07-16 21:21:47
7d5c131193f1740e4efe1750b58e1e4c3471b6e7...940273d63503299472c55d4dece05472a9fcd417,2,9,4,13,4,2008-07-16 21:38:46,2008-07-16 21:38:46
940273d63503299472c55d4dece05472a9fcd417...b9410e381fa4accda1b3a763926f0b573b94fa8f,4,35,13,48,16,2008-07-16 23:18:04,2008-07-16 23:18:04
b9410e381fa4accda1b3a763926f0b573b94fa8f...d195086cb879b0251d2203ea75d0250a8a878024,6,16,8,24,9,2008-07-17 13:26:42,2008-07-17 13:26:42
d195086cb879b0251d2203ea75d0250a8a878024...2612fa547b8c7a83d96d252e2db4cc36f93b7fd8,6,8,16,24,9,2008-07-17 17:23:26,2008-07-17 17:23:26
2612fa547b8c7a83d96d252e2db4cc36f93b7fd8...c3adb4946fd99ff8a76fc1abb0fabbbae2254c80,3,21,4,25,4,2008-07-17 17:42:20,2008-07-17 17:42:20
3fbf00615f92dfa37b48b7f0f97b561c97874929...e011494cbc7fce55f1690f4e7ebf30a3ed8a5e0d,14,365,24,389,28,2008-07-27 22:36:47,2008-07-27 22:36:47
e011494cbc7fce55f1690f4e7ebf30a3ed8a5e0d...9249a94423da8621e03aa5385df67a84c661de6b,1,12,11,23,5,2008-07-27 22:44:10,2008-07-27 22:44:10
9249a94423da8621e03aa5385df67a84c661de6b...3363fe311c4d2b4638b234ef58a96659e0e3266f,14,236,22,258,33,2008-07-28 17:51:39,2008-07-28 17:51:39
3363fe311c4d2b4638b234ef58a96659e0e3266f...a0d1c47ff79a0b2276a8d2088f3308746b03105c,6,180,35,215,39,2008-07-28 21:52:44,2008-07-28 21:52:44
a0d1c47ff79a0b2276a8d2088f3308746b03105c...227f63072906b4e38740c83a8f39b74b550d5af3,9,255,53,308,55,2008-07-29 21:54:54,2008-07-29 21:54:54
227f63072906b4e38740c83a8f39b74b550d5af3...6e1f782d16cf64c752ec81079b48c3045b47dfee,9,73,171,244,43,2008-07-30 18:07:02,2008-07-30 18:07:02
6e1f782d16cf64c752ec81079b48c3045b47dfee...cf2d786015008dd07ce58e7781714bbc08532f23,2,135,1,136,2,2008-07-30 18:08:54,2008-07-30 18:08:54
c3adb4946fd99ff8a76fc1abb0fabbbae2254c80...08bbcb55f286b76a56af94119f850e2385c96acd,3,119,79,198,33,2008-07-17 20:43:58,2008-07-17 20:43:58
c3adb4946fd99ff8a76fc1abb0fabbbae2254c80...1c54c09a288834822dedd4b42fbc807f3c620240,1,8,1,9,1,2008-07-17 20:02:32,2008-07-17 20:02:32
cf2d786015008dd07ce58e7781714bbc08532f23...37acacbe0783849f69040194fa527ee9585e39eb,5,28,25,53,9,2008-07-31 13:58:08,2008-07-31 13:58:08
cf2d786015008dd07ce58e7781714bbc08532f23...22285ede9a09fcef5259c3facb511cbd9f203cf2,1,2,1,3,1,2008-07-31 12:01:51,2008-07-31 12:01:51
f0eb45a2b6b8ebb4b79ff269201303b10cb82132...258be59a7963ca172094a4c672032d7d3a03d690,2,60,30,90,7,2008-07-17 23:34:47,2008-07-17 23:34:47
74337a4d3c01b93623049a2766532bb0b5e29e79...234844724cfeb7635073d08e5229bcb521d961e2,4,46,11,57,14,2008-07-31 17:37:32,2008-07-31 17:37:32
258be59a7963ca172094a4c672032d7d3a03d690...91786ac5db1d47b6686d79270e85d0d96e3c79b0,1,661,0,661,1,2008-07-22 13:45:40,2008-07-22 13:45:40
258be59a7963ca172094a4c672032d7d3a03d690...608769fd03cdaeea5647cd2e730e54fd76b57336,44,3808,14,3822,58,2008-07-20 21:33:02,2008-07-20 21:33:02
608769fd03cdaeea5647cd2e730e54fd76b57336...383a862ad32f8731e8eab608465a48873a078e81,44,14,3808,3822,55,2008-07-20 21:34:22,2008-07-20 21:34:22
383a862ad32f8731e8eab608465a48873a078e81...50e8a1a3f5203ab26e6cc4fa2636333629f97ba2,44,704,14,718,55,2008-07-20 21:37:33,2008-07-20 21:37:33
50e8a1a3f5203ab26e6cc4fa2636333629f97ba2...431d1aaae7937282728b48645131d3ab49b8738c,1,1,1,2,1,2008-07-21 15:07:19,2008-07-21 15:07:19
234844724cfeb7635073d08e5229bcb521d961e2...236575ca95fb7bddcd9ff142618fdd4db261530e,12,14,27,41,14,2008-08-11 18:53:08,2008-08-11 18:53:08
234844724cfeb7635073d08e5229bcb521d961e2...9d5178583fdfedfb0b20c552688393493190fd72,2,5,2,7,5,2008-08-01 02:21:32,2008-08-01 02:21:32
9d5178583fdfedfb0b20c552688393493190fd72...bc24777c118e6d84f14c71a9f5e310623e7551fa,9,432,405,837,37,2008-08-02 18:58:15,2008-08-02 18:58:15
bc24777c118e6d84f14c71a9f5e310623e7551fa...112b19a5d9f7682a869a66c5c6da333f8bdb7c94,4,13,14,27,12,2008-08-02 21:02:41,2008-08-02 21:02:41
431d1aaae7937282728b48645131d3ab49b8738c...b4103f3a334d9259eb66922f8b4a1d196a4454e5,1,33,0,33,1,2008-07-22 13:54:25,2008-07-22 13:54:25
776387ea1bf641d43a22f17e2e23e7d0e8780f87...39310ed11380ff892fac7cab8690de60bf371f3d,5,15,9,24,10,2008-08-11 21:02:32,2008-08-11 21:02:32
112b19a5d9f7682a869a66c5c6da333f8bdb7c94...187156c2801da232aa01464a61e6926b44fa208b,2,38,31,69,3,2008-08-04 11:00:48,2008-08-04 11:00:48
112b19a5d9f7682a869a66c5c6da333f8bdb7c94...278e8ad04a642077ecb642a57bd590c85074890e,1,18,2,20,3,2008-08-04 02:04:33,2008-08-04 02:04:33
895b52380830d636c5b43f1d811b90ee87fcae31...8b12f068fd147dc6869a37500881b486b75b0ec9,1,5,0,5,1,2008-07-22 13:56:45,2008-07-22 13:56:45
8b12f068fd147dc6869a37500881b486b75b0ec9...27cbdfdc8c320bcf5cb08f5277fc1d77167cc134,2,0,65,65,1,2008-07-22 14:01:30,2008-07-22 14:01:30
27cbdfdc8c320bcf5cb08f5277fc1d77167cc134...38dbc34d454f692c1583a797790ef639cbc12a8c,3,39,16,55,6,2008-07-22 22:12:32,2008-07-22 22:12:32
38dbc34d454f692c1583a797790ef639cbc12a8c...5f9bdedf081e33b43b616214e9dc1a45ae2fa9e6,4,7,6,13,6,2008-07-23 19:30:24,2008-07-23 19:30:24
5f9bdedf081e33b43b616214e9dc1a45ae2fa9e6...fa1bbbc78a382dd57f476f82c9f4ee7e83c7d531,3,3,1,4,3,2008-07-23 22:09:53,2008-07-23 22:09:53
39310ed11380ff892fac7cab8690de60bf371f3d...f4f3aacad74eb230934fc7f9a0888fd0b27bc42e,5,49,22,71,13,2008-08-12 14:30:27,2008-08-12 14:30:27
39310ed11380ff892fac7cab8690de60bf371f3d...b867771881e8cec812962ac5b1df6c70aa103935,1,3,4,7,2,2008-08-12 12:27:56,2008-08-12 12:27:56
50d596bcfdcd4617e20174bbbfe76892e4367898...f27d9a58613a1a100eafcbe6cf23057cb68b6e5e,4,2502,0,2502,4,2008-08-12 22:51:47,2008-08-12 22:51:47
50d596bcfdcd4617e20174bbbfe76892e4367898...39030722e571658111c3583b61736d1e22524913,5,82,52,134,27,2008-08-11 18:07:30,2008-08-11 18:07:30
fa1bbbc78a382dd57f476f82c9f4ee7e83c7d531...24fdaa1ed9952cc3d875e652242ff9432be753a3,8,143,39,182,31,2008-07-24 20:07:18,2008-07-24 20:07:18
fa1bbbc78a382dd57f476f82c9f4ee7e83c7d531...517956ab6056e0a378b4f33e82d62ee018bfef79,1,13,2,15,3,2008-07-24 18:09:18,2008-07-24 18:09:18
9db9bdba5a6d5f5ad52d1e846072a13484f3469c...edcee6aaa89618642f3be46f552abc3b6e8e938f,11,265,170,435,44,2008-08-13 16:17:18,2008-08-13 16:17:18
3f5d084a14ac6c81b2e8e6bbaad473e5101325af...b58e00ba123e29a13a4d5f5ac9dd5e3f70cc0bc7,2,0,1721,1721,2,2008-08-12 23:03:56,2008-08-12 23:03:56
b58e00ba123e29a13a4d5f5ac9dd5e3f70cc0bc7...30612d8b4a71b41a074623ea777413cf3d4ad755,2,0,781,781,2,2008-08-12 23:42:47,2008-08-12 23:42:47
30612d8b4a71b41a074623ea777413cf3d4ad755...ab279caaaa857225614c01d4f5541e17d10bf92c,2,313,0,313,2,2008-08-12 23:49:39,2008-08-12 23:49:39
20c7cf953ad19a04e128c39730df22371050b68f...1a5d90cc9d0c3c42dd5396e7ecdaae1d7c22d293,1,6,3,9,2,2008-07-24 20:47:24,2008-07-24 20:47:24
ff3269f36563a20491c8e8597865082e7ffd6f3e...b957496acc6e2ca6627e6e7f97d816b0d656294c,2,37,21,58,13,2008-08-13 19:35:28,2008-08-13 19:35:28
b957496acc6e2ca6627e6e7f97d816b0d656294c...88c0900a4d606cb6c94f694b14e611cfff4a297c,1,2,1,3,1,2008-08-15 15:02:59,2008-08-15 15:02:59
88c0900a4d606cb6c94f694b14e611cfff4a297c...6d4e9c19bf8920c1a7820ae5f9ae688c7dd98e70,2,64,22,86,12,2008-08-15 17:59:22,2008-08-15 17:59:22
6d4e9c19bf8920c1a7820ae5f9ae688c7dd98e70...8f13ff6f1ac385554c397bd743d0abfc8bbc9972,1,19,12,31,1,2008-08-15 19:23:42,2008-08-15 19:23:42
8f13ff6f1ac385554c397bd743d0abfc8bbc9972...03229b8fa9c97fb62988e12d83e209583e30e1db,2,8,1,9,3,2008-08-18 01:32:37,2008-08-18 01:32:37
03229b8fa9c97fb62988e12d83e209583e30e1db...c0867d2c3f9cc19f16ea859f254a955ca646aea8,4,66,30,96,26,2008-08-18 22:00:17,2008-08-18 22:00:17
c0867d2c3f9cc19f16ea859f254a955ca646aea8...4e922d955bf8975059bf8fc39010027aa9f0882e,8,141,91,232,20,2008-08-19 18:39:44,2008-08-19 18:39:44
4e922d955bf8975059bf8fc39010027aa9f0882e...bfb61b7795d1fbef980a41889021078f00fd2fa2,4,8,12,20,11,2008-08-19 20:12:13,2008-08-19 20:12:13
bfb61b7795d1fbef980a41889021078f00fd2fa2...53c3f540b648880fc43a8b28bd2459a8f1868463,4,34,1,35,7,2008-08-19 21:13:20,2008-08-19 21:13:20
53c3f540b648880fc43a8b28bd2459a8f1868463...d3099f01ab45dd8a91e57238695ca98f4659543e,3,51,4,55,10,2008-08-19 21:57:05,2008-08-19 21:57:05
d3099f01ab45dd8a91e57238695ca98f4659543e...02bc370b37c695b4c78622d0ba9699d343b00a38,4,168,69,237,23,2008-08-21 22:05:13,2008-08-21 22:05:13
02bc370b37c695b4c78622d0ba9699d343b00a38...f7acdf8f135e431522d3e0d577a4efa302b22d47,4,0,0,0,0,2008-08-24 23:21:35,2008-08-24 23:21:35
02bc370b37c695b4c78622d0ba9699d343b00a38...b4d9b391a3c60915128ee544dba83d94925b5ad9,1,8,2,10,1,2008-08-22 19:06:24,2008-08-22 19:06:24
b4d9b391a3c60915128ee544dba83d94925b5ad9...5599f9ec699d64f1dc4c5813ec25f77c1b31c1ce,1,16,7,23,4,2008-08-23 10:58:38,2008-08-23 10:58:38
247764becc200dd4e4318e98fd67b4461d638205...94f9bdee473f53837e5ec052526f40d857eb9d1e,2,55,51,106,8,2008-08-25 00:43:48,2008-08-25 00:43:48
94f9bdee473f53837e5ec052526f40d857eb9d1e...26d42343623aea234c12a46a23204a40eed09747,3,7,3,10,3,2008-08-25 20:53:19,2008-08-25 20:53:19
94f9bdee473f53837e5ec052526f40d857eb9d1e...ca08e48791b87cfb248ed3cf10c1852d788ae029,7,35,17,52,22,2008-08-25 20:46:39,2008-08-25 20:46:39
8d00ee0321bb4b74e9cab129014dbcdfebe5755c...43529c43cfc9c95f95501f1797b81bbb7106240e,4,19,6,25,10,2008-08-26 17:34:34,2008-08-26 17:34:34
43529c43cfc9c95f95501f1797b81bbb7106240e...10d993452beda41f4b3cef765e2c2222f474de0f,5,383,349,732,11,2008-08-28 00:33:47,2008-08-28 00:33:47
43529c43cfc9c95f95501f1797b81bbb7106240e...fa9c4b0b5f5dc8600afa4c5413621f3dd2e99eb3,1,1,1,2,1,2008-08-27 00:24:08,2008-08-27 00:24:08
6591d77bd9020d918081d22d6ca1356ce7285385...d43479670490bc7e29efc6dd73b3fe9e2f04a485,2,12,0,12,3,2008-08-28 13:54:46,2008-08-28 13:54:46
d43479670490bc7e29efc6dd73b3fe9e2f04a485...5bd0db4c4c9ec3a8b9bc0c14d2157f5ffc013b3f,4,27,9,36,8,2008-08-28 21:05:15,2008-08-28 21:05:15
5bd0db4c4c9ec3a8b9bc0c14d2157f5ffc013b3f...fd876a27f769b22bfe6cd48f45cf3c4e3704c9b7,1,1,1,2,1,2008-08-29 00:34:44,2008-08-29 00:34:44
fd876a27f769b22bfe6cd48f45cf3c4e3704c9b7...8cac7e4dc4c1102b69598ba6b1e60df8d8e1dcdd,13,243,169,412,48,2008-09-03 20:43:00,2008-09-03 20:43:00
8cac7e4dc4c1102b69598ba6b1e60df8d8e1dcdd...5deec924696d34505ba1bb75cebfab4a66ddec33,11,94,42,136,48,2008-09-04 14:33:56,2008-09-04 14:33:56
5deec924696d34505ba1bb75cebfab4a66ddec33...5f9d52a2f5fc4e85691ec32a4199c5dfd16b04d2,6,27,12,39,11,2008-09-04 22:24:03,2008-09-04 22:24:03
5f9d52a2f5fc4e85691ec32a4199c5dfd16b04d2...5727d1b85310b878ad49130290e240512389328a,6,46,18,64,24,2008-09-05 14:40:00,2008-09-05 14:40:00
5727d1b85310b878ad49130290e240512389328a...8dd8937576635dbe8da2ea4cce90854ab79aeb19,2,19,11,30,12,2008-09-05 22:04:29,2008-09-05 22:04:29
8dd8937576635dbe8da2ea4cce90854ab79aeb19...98d4a02dcbb943961c0c30e3b556bd4150f62c4c,6,30,473,503,19,2008-09-09 14:19:31,2008-09-09 14:19:31
8dd8937576635dbe8da2ea4cce90854ab79aeb19...4af0da7918b1794e85751ae3a67f1759f39182fd,5,479,446,925,9,2008-09-09 00:37:59,2008-09-09 00:37:59
90d088511674f59227b964a91630008861fb1d02...7f490a85c26817218d8a742d82ea12884982ffc1,1,7,5,12,4,2008-09-10 15:38:51,2008-09-10 15:38:51
90d088511674f59227b964a91630008861fb1d02...84e3a515b49873423d08db609a50099235361164,1,1,1,2,1,2008-09-10 01:51:27,2008-09-10 01:51:27
0756afd8e2b55d5124b36569e1cd118fcdb6baca...f2bee299e426865e92b03c49dc16ff997bd88fd0,3,122,28,150,10,2008-09-10 19:31:05,2008-09-10 19:31:05
f2bee299e426865e92b03c49dc16ff997bd88fd0...5fa38bdeadc90f7733497be9ade32d85b16e69c8,1,5,0,5,1,2008-09-14 16:38:48,2008-09-14 16:38:48
5fa38bdeadc90f7733497be9ade32d85b16e69c8...54668a9afecd39d21d77003bcc20991bddee2090,5,49,12,61,17,2008-09-14 16:39:49,2008-09-14 16:39:49
54668a9afecd39d21d77003bcc20991bddee2090...31eff8fb7cfa94783fcfb47622199a0ed27a0a53,5,35,8,43,14,2008-09-14 17:16:50,2008-09-14 17:16:50
f2bee299e426865e92b03c49dc16ff997bd88fd0...5f163f72b8a9bf3924092af1bb695c7606ae7eb8,7,397,2,399,16,2008-09-11 13:15:34,2008-09-11 13:15:34
5f163f72b8a9bf3924092af1bb695c7606ae7eb8...1d4379a5d203135ba457f5a992c3aa261d8876ad,6,101,17,118,19,2008-09-11 14:45:57,2008-09-11 14:45:57
1d4379a5d203135ba457f5a992c3aa261d8876ad...2b67b580854063516ed3892a52287239cc1bd706,6,53,27,80,19,2008-09-11 17:04:30,2008-09-11 17:04:30
2b67b580854063516ed3892a52287239cc1bd706...87ba097b356b8cde41a7f6b4c44505fe564209a4,1,4,1,5,3,2008-09-11 17:48:30,2008-09-11 17:48:30
87ba097b356b8cde41a7f6b4c44505fe564209a4...f56113d7367535eaf7994d7954bdfb5e8fc93dcb,7,118,48,166,52,2008-09-11 19:13:47,2008-09-11 19:13:47
f56113d7367535eaf7994d7954bdfb5e8fc93dcb...e9370576adf9d8e023988dacb37a6d291b0d14f4,3,48,7,55,13,2008-09-11 20:25:16,2008-09-11 20:25:16
e9370576adf9d8e023988dacb37a6d291b0d14f4...18e7e1fa40da60fe6670123c86e6eedc8bdc1dfb,3,24,15,39,6,2008-09-12 15:26:51,2008-09-12 15:26:51
18e7e1fa40da60fe6670123c86e6eedc8bdc1dfb...3332989338a5815c30a039213bf2e4581759e8c8,8,121,24,145,31,2008-09-12 19:00:20,2008-09-12 19:00:20
3332989338a5815c30a039213bf2e4581759e8c8...75418800a25dd351c0223ff5fa3ea3679bd0585b,3,59,0,59,3,2008-09-15 13:14:42,2008-09-15 13:14:42
3332989338a5815c30a039213bf2e4581759e8c8...e783239b3f9284d0dfe0161b8f8effc41d33aa57,6,82,24,106,18,2008-09-15 02:49:30,2008-09-15 02:49:30
2a8679c8014f33c55193f75e7f11983a30e95af2...0eb21f59f9632c053714b9f059e332f530d3bf47,1,3,1,4,1,2008-09-15 13:50:39,2008-09-15 13:50:39
f9fd02c198553a587cffbcb4a61d774d93998b38...379a7562629ff0803cfb30e0abfcddcbee046a19,7,92,24,116,26,2008-09-15 19:30:53,2008-09-15 19:30:53
0627621e0076a3ced12aa02554d023fc84cac509...db91183962d36d596157837a928217c411b84a7e,1,28,22,50,6,2008-09-15 15:02:13,2008-09-15 15:02:13
6f3628d022ec6406d1aa5cea3bba10ce118891ab...a280883fee6452257dcf42ed78c81d10a49621d2,2,25,23,48,16,2008-09-19 21:56:31,2008-09-19 21:56:31
6f3628d022ec6406d1aa5cea3bba10ce118891ab...3507a09bfb6fe5931c43fa070a062ce4e4ae2b5e,1,5,1,6,1,2008-09-18 00:46:16,2008-09-18 00:46:16
3507a09bfb6fe5931c43fa070a062ce4e4ae2b5e...8216dc63c56cce87126d2a228a38fad2cddf3d44,1,42,9,51,15,2008-09-18 13:39:14,2008-09-18 13:38:59
8216dc63c56cce87126d2a228a38fad2cddf3d44...9ea5237869da33080b61af69442c780b997319b7,1,9,5,14,4,2008-09-18 13:42:14,2008-09-18 13:42:14
5e62e2d3010a9ae0cfc9f6cb521fbea24b76aed0...362fc87a72e873833192ed658532559ebad093eb,3,218,4,222,32,2008-09-23 14:56:33,2008-09-23 14:56:33
5e62e2d3010a9ae0cfc9f6cb521fbea24b76aed0...d27e5f560de88d7b123f47d57e1954beae9e5d8b,1,2,0,2,1,2008-09-22 17:15:19,2008-09-22 17:15:19
8336f47b60e044d628c2933b9cb848f945d0383e...efe9d8be2059edbb8b45c91f1560cd9545ac0814,9,219,69,288,13,2008-09-29 22:00:53,2008-09-29 22:00:53
efe9d8be2059edbb8b45c91f1560cd9545ac0814...7123dd1454b6d0a93ae334ecdee7e8e5a250b69f,5,69,13,82,19,2008-09-29 22:32:39,2008-09-29 22:32:39
7123dd1454b6d0a93ae334ecdee7e8e5a250b69f...b4a23ec99b42810b9ff687db0231f9a74e19f0f9,1,3,2,5,2,2008-09-29 23:35:40,2008-09-29 23:35:40
b4a23ec99b42810b9ff687db0231f9a74e19f0f9...ab00e9875b064f965f8070eb428e925e884aa6b0,3,18,6,24,4,2008-10-02 21:25:57,2008-10-02 21:25:57
ab00e9875b064f965f8070eb428e925e884aa6b0...2391b9083c86adfe6922d7fb062e2582aefe876a,3,17,8,25,3,2008-10-08 23:04:44,2008-10-08 23:04:44
ab00e9875b064f965f8070eb428e925e884aa6b0...3028627f01ce095b3ba493744b824ba8a03899a6,1,84,79,163,2,2008-10-04 23:42:18,2008-10-04 23:42:18
3028627f01ce095b3ba493744b824ba8a03899a6...2f9c588ef69ebffc9b0d3f724095025d5fc62720,1,8,4,12,2,2008-10-05 02:28:49,2008-10-05 02:28:49
1007d70adfcc3e5300756378e9db2e4931566605...f9b2cfb7f0aeade4356f19f44c6126a269258579,1,6,4,10,2,2008-10-09 00:42:27,2008-10-09 00:42:27
2f9c588ef69ebffc9b0d3f724095025d5fc62720...4f23bf199f36a0c25dd5d6abd5620a68935a5f66,2,20,22,42,5,2008-10-08 22:20:02,2008-10-08 22:20:02
2f9c588ef69ebffc9b0d3f724095025d5fc62720...98823b6ca4399d2bda300caae3055ec398262b9d,1,4,0,4,1,2008-10-07 12:18:19,2008-10-07 12:18:19
f9b2cfb7f0aeade4356f19f44c6126a269258579...875e674cb0a350b4e5c0d9b702c041a57161ef8a,1,10,1,11,4,2008-10-10 14:57:04,2008-10-10 14:57:04
f9b2cfb7f0aeade4356f19f44c6126a269258579...d7781cda232c7b8aba200c773bdebd341a409447,1,16,13,29,4,2008-10-09 21:06:56,2008-10-09 21:06:56
d7781cda232c7b8aba200c773bdebd341a409447...732e1371190186799ace0d01cd3bf5930c401995,2,1,2,3,2,2008-10-09 21:29:04,2008-10-09 21:29:04
732e1371190186799ace0d01cd3bf5930c401995...6ff1bb8bf193aa973781b205af1d73cc60782e90,3,14,1,15,5,2008-10-10 15:10:21,2008-10-10 15:10:21
74de3ee5faec883497b280b2775d15770dc5a028...084303afb7cfe05e864cde8df3ee3eb37910cd25,2,15,0,15,4,2008-10-10 15:21:41,2008-10-10 15:21:41
084303afb7cfe05e864cde8df3ee3eb37910cd25...887b437b9c3acc031e4e44d09dde1fe69ae25c5a,1,15,6,21,6,2008-10-10 17:55:02,2008-10-10 17:55:02
887b437b9c3acc031e4e44d09dde1fe69ae25c5a...b696111e643227a49260caaff107e6c727c356a6,3,10,4,14,6,2008-10-10 20:55:21,2008-10-10 20:55:21
b696111e643227a49260caaff107e6c727c356a6...edb03141fb9255cc44a11d51fbafe619166bd26f,1,4,2,6,2,2008-10-11 21:32:33,2008-10-11 21:32:33
edb03141fb9255cc44a11d51fbafe619166bd26f...2a9c303a5a492664d22b2ae305a0ec9a76d7bc75,7,70,35,105,25,2008-10-13 01:09:59,2008-10-13 01:09:59
2a9c303a5a492664d22b2ae305a0ec9a76d7bc75...1c26815d9fed9b912ffa6b650b6d933710866636,1,2,2,4,1,2008-10-13 02:26:08,2008-10-13 02:26:08
1c26815d9fed9b912ffa6b650b6d933710866636...7af92d70d6736cbb5c90a907e7b94a3b04646957,2,5,3,8,3,2008-10-13 13:28:53,2008-10-13 13:28:53
7af92d70d6736cbb5c90a907e7b94a3b04646957...e7931c2ad603a2d1ce597b69cfb4f6d14c08276f,6,35,20,55,20,2008-10-13 19:55:38,2008-10-13 19:55:38
e7931c2ad603a2d1ce597b69cfb4f6d14c08276f...1bef26dcc0f98e628a7c2f15b1b445c419810fe4,3,15,2,17,4,2008-10-13 20:19:39,2008-10-13 20:19:39
1bef26dcc0f98e628a7c2f15b1b445c419810fe4...cdc9ae445c94ccea86940df6c84f94c669796569,5,117,9,126,14,2008-10-13 21:58:51,2008-10-13 21:58:51
cdc9ae445c94ccea86940df6c84f94c669796569...87d0ed26c42d0f6da68bad6dccd2aae8d8e33516,8,64,11,75,12,2008-10-14 18:02:43,2008-10-14 18:02:43
87d0ed26c42d0f6da68bad6dccd2aae8d8e33516...1dfa84d13269d9948e7dfd5e033d83832474a1e9,7,536,455,991,24,2008-10-19 14:02:37,2008-10-19 14:02:37
1dfa84d13269d9948e7dfd5e033d83832474a1e9...74624cebd8f7369b9cb6550ab037fecd06080d37,5,134,6,140,12,2008-10-19 16:17:25,2008-10-19 16:17:25
74624cebd8f7369b9cb6550ab037fecd06080d37...64769580b1c63706e0e923322d49728bd065aa53,4,113,46,159,37,2008-10-19 17:48:04,2008-10-19 17:48:04
64769580b1c63706e0e923322d49728bd065aa53...f91cff53a095d9b92cfde329350afc7f3d31841c,13,1109,987,2096,32,2008-10-19 22:46:53,2008-10-19 22:46:53
87d0ed26c42d0f6da68bad6dccd2aae8d8e33516...6ed8c54cde486a4fe780de489308683f35ea9c7e,1,1,1,2,1,2008-10-15 01:05:55,2008-10-15 01:05:55
e7ca864e925d3d4d2c40997294d48d15b23506ac...1a5e1791a371cf7838a8dd77d14245a4eba7a743,1,1,1,2,1,2008-10-20 00:23:38,2008-10-20 00:23:38
6ed8c54cde486a4fe780de489308683f35ea9c7e...50cc27e15468cdd5646c735190bb902df3b3381e,1,1,1,2,1,2008-10-15 01:07:09,2008-10-15 01:07:09
d9efe9931f176416ce95a7c323b25c05335a6395...b6a466b6194e07e5d5fe8df422fd0ceeaa1e7726,1,2,2,4,1,2008-10-21 17:09:44,2008-10-21 17:09:44
b6a466b6194e07e5d5fe8df422fd0ceeaa1e7726...0aef80f8cc9607db79fbc491d46b054f7504e205,33,536,513,1049,424,2008-10-21 20:13:48,2008-10-21 20:13:48
0aef80f8cc9607db79fbc491d46b054f7504e205...13480027d90f8b2da17e099cadaeaa22c04a3be1,15,1901,1743,3644,31,2008-10-22 20:56:39,2008-10-22 20:56:39
13480027d90f8b2da17e099cadaeaa22c04a3be1...1875ee8151c15677c7396b15a715be99b8f1ee62,13,367,123,490,50,2008-10-24 21:51:28,2008-10-24 21:51:28
1875ee8151c15677c7396b15a715be99b8f1ee62...9bc872695d6bd2875e4e7b050780ee074691981b,15,1513,1339,2852,23,2008-10-29 21:48:03,2008-10-29 21:48:03
9bc872695d6bd2875e4e7b050780ee074691981b...ac9bd9ce6020142548432b006d500dc70f8cfee2,1,12,5,17,1,2008-10-29 22:26:06,2008-10-29 22:26:06
ac9bd9ce6020142548432b006d500dc70f8cfee2...a4968427e2eeec59f60c6f72a82d15ddd521347c,10,1029,989,2018,19,2008-11-04 01:42:59,2008-11-04 01:42:59
ac9bd9ce6020142548432b006d500dc70f8cfee2...45d9d8db480c712d562900de3358788a8b12beff,9,65,55,120,17,2008-11-01 00:17:54,2008-11-01 00:17:54
c8315736840386d64e1e42ceb32b595446355618...8beba2346ec0e4d917e64fa7a5ab32cb51a773f2,15,1096,1034,2130,32,2008-11-09 22:49:37,2008-11-09 22:49:37
8beba2346ec0e4d917e64fa7a5ab32cb51a773f2...1575950af6636a48aaa3c9b993b51f1e7b84d16c,1,1,1,2,1,2008-11-09 22:54:20,2008-11-09 22:54:20
c8315736840386d64e1e42ceb32b595446355618...2a46ef9acdfc6f824260f862a2802c8a93c29191,4,20,4,24,6,2008-11-04 20:05:01,2008-11-04 20:05:01
baede1ed853fe96459b0087a27c1ae1407ffd52c...a89d6b94f7f60334c5e9d831625e9504093ffff9,3,20,3,23,7,2008-11-10 16:20:30,2008-11-10 16:20:30
a89d6b94f7f60334c5e9d831625e9504093ffff9...890048958b5d1d9987c9e1dd81b804c655fa3bcd,2,35,9,44,7,2008-11-10 22:45:39,2008-11-10 22:45:39
890048958b5d1d9987c9e1dd81b804c655fa3bcd...d7798312c64ffb3212572419a2b0ae88484efd20,1,3,2,5,2,2008-11-11 22:27:26,2008-11-11 22:27:26
d7798312c64ffb3212572419a2b0ae88484efd20...5c02aabbc82cf0120fcd74324241dd205d3d7b1a,7,430,392,822,17,2008-11-13 20:52:20,2008-11-13 20:52:20
5c02aabbc82cf0120fcd74324241dd205d3d7b1a...48a432d4ad582768101aa91971b2467291c8e485,2,367,358,725,2,2008-11-14 02:59:56,2008-11-14 02:59:56
48a432d4ad582768101aa91971b2467291c8e485...2c7fca7647f5ed2c8b4ce77b631d27c1e80faadb,1,1,1,2,1,2008-11-14 03:29:25,2008-11-14 03:29:25
2c7fca7647f5ed2c8b4ce77b631d27c1e80faadb...4e6f1c1f0e7ede156d3f68c7c122c7f1d7b28212,3,18,3,21,5,2008-11-14 16:20:23,2008-11-14 16:20:23
4e6f1c1f0e7ede156d3f68c7c122c7f1d7b28212...2d95d8889989594d66045d2bc76d6247a774962f,5,972,2110,3082,5,2008-11-14 18:51:33,2008-11-14 18:51:33
2d95d8889989594d66045d2bc76d6247a774962f...8c4778e59fb1911ee5fc2df7c88d71c28b3fb259,6,192,43,235,18,2008-11-14 21:19:47,2008-11-14 21:19:47
8c4778e59fb1911ee5fc2df7c88d71c28b3fb259...b1a5b9ed527a6188a5c211866d03e02247eb2882,4,990,989,1979,9,2008-11-16 00:04:01,2008-11-16 00:04:01
b1a5b9ed527a6188a5c211866d03e02247eb2882...cb1081beeda7d7297902467884aa9221ec3c5ced,2,4,1,5,2,2008-11-17 00:11:21,2008-11-17 00:11:21
cb1081beeda7d7297902467884aa9221ec3c5ced...e227ff9bacc1beeb1a026b61c104e92d4cc2872b,1,3,1,4,1,2008-11-17 01:56:43,2008-11-17 01:56:43
e227ff9bacc1beeb1a026b61c104e92d4cc2872b...3e53cfe1d7f31ad7fbae481d380110c9a041129c,3,5,5,10,5,2008-11-17 02:00:22,2008-11-17 02:00:22
3e53cfe1d7f31ad7fbae481d380110c9a041129c...7ce45ce381a4e6078a4700a978645a52f53adc78,6,64,10,74,15,2008-11-17 20:39:03,2008-11-17 20:39:03
7ce45ce381a4e6078a4700a978645a52f53adc78...20c1d67ee97199dea32960dbe1c5b610baa90a36,2,24,22,46,4,2008-11-17 21:22:01,2008-11-17 21:22:01
20c1d67ee97199dea32960dbe1c5b610baa90a36...342cd60ae95cc47b11a4019e1ea148a674734d2b,1,1,1,2,1,2008-11-17 21:29:50,2008-11-17 21:29:50
342cd60ae95cc47b11a4019e1ea148a674734d2b...261d46c2f2f3f1ddbe021c9d66f25630e8de5e28,1,1,0,1,1,2008-11-17 21:38:41,2008-11-17 21:38:41
261d46c2f2f3f1ddbe021c9d66f25630e8de5e28...805b9b23adea7205a168408fe284f8859147b2c2,1,2,0,2,1,2008-11-17 22:03:17,2008-11-17 22:03:17
805b9b23adea7205a168408fe284f8859147b2c2...580369978b122f677c63d698d594f655d9c84d48,3,13,9,22,9,2008-11-18 14:30:31,2008-11-18 14:30:31
580369978b122f677c63d698d594f655d9c84d48...ede1f1e2ba3faaacfa1d315c089aee1210bbc7dd,12,1350,1255,2605,72,2008-11-18 20:47:37,2008-11-18 20:47:37
ede1f1e2ba3faaacfa1d315c089aee1210bbc7dd...a9ada55c2e29ca3110a29b6f630d912b14629715,1,1,1,2,1,2008-11-18 21:09:58,2008-11-18 21:09:58
a9ada55c2e29ca3110a29b6f630d912b14629715...458de60cf02e49f5cdf5b7dfceeb62d36e2f12ac,2,20,13,33,9,2008-11-19 22:29:06,2008-11-19 22:29:06
458de60cf02e49f5cdf5b7dfceeb62d36e2f12ac...6c1d07af9b8bbd59b6bbf019f73cc2a873cf6e85,3,24,10,34,11,2008-11-20 23:03:41,2008-11-20 23:03:41
6c1d07af9b8bbd59b6bbf019f73cc2a873cf6e85...ccd67f3bf32952f289f4171fa58316476d3b90e0,3,31,6,37,8,2008-11-21 17:08:11,2008-11-21 17:08:11
ccd67f3bf32952f289f4171fa58316476d3b90e0...6f9636903b855c708271f2dc5c59a4c42d223642,1,16,6,22,5,2008-11-21 19:14:40,2008-11-21 19:14:40
6f9636903b855c708271f2dc5c59a4c42d223642...cc1c365abd74c4b04bbb466e71a744b37af26682,1,13,3,16,3,2008-11-24 19:23:19,2008-11-24 19:23:19
cc1c365abd74c4b04bbb466e71a744b37af26682...d78b9d0f7de36b86df082eaa63d5c9124cb7b4f1,2,4,2,6,3,2008-12-01 15:59:53,2008-12-01 15:59:53
cc1c365abd74c4b04bbb466e71a744b37af26682...dfb8f562ae762d1096205c14464dc41f87643732,7,1213,986,2199,8,2008-11-30 01:01:58,2008-11-30 01:01:58
dfb8f562ae762d1096205c14464dc41f87643732...07216811d0e61b92540e2af35b17b08df6504a98,1,1,1,2,1,2008-11-30 01:04:40,2008-11-30 01:04:40
07216811d0e61b92540e2af35b17b08df6504a98...5ca796e0ddbaaa34658f96025c3aaf1dbbd09449,5,44,3,47,9,2008-12-01 02:00:54,2008-12-01 02:00:54
d68ca4cc2399031f105e5a9d09c8c69630408563...d4504325ee75a08d45fde7b90b9a6a787982a537,1,16,5,21,9,2008-12-01 18:23:20,2008-12-01 18:23:20
d4504325ee75a08d45fde7b90b9a6a787982a537...182651744c082cb31ab051b2137c0934917f62ac,4,61,31,92,18,2008-12-01 19:55:36,2008-12-01 19:55:36
d4504325ee75a08d45fde7b90b9a6a787982a537...54642dbd15ee3017ad1c9d92ce73da00923e7382,1,1,0,1,1,2008-12-01 19:27:56,2008-12-01 19:27:56
54642dbd15ee3017ad1c9d92ce73da00923e7382...70d8917627b778bc10551e9dc148992f0049d719,1,0,1,1,1,2008-12-01 19:32:45,2008-12-01 19:32:45
aa8d238b0f9cbd586cf15af5bfaafc06678165cd...60b769a8cb1eb0dbb4e210ef6cdc5e0bb17fb91e,38,1457,1241,2698,120,2008-12-02 19:24:45,2008-12-02 19:24:45
aa8d238b0f9cbd586cf15af5bfaafc06678165cd...165a783a1de8a54c5085fd68d3aa95a69a4b4177,1,6,16,22,5,2008-12-01 22:48:05,2008-12-01 22:48:05
1c2e0672dde11f8171326b2db2848e7d8124814e...eff1694cd74dc31b6754c5f3a13f228f7b2a7d03,4,20,2,22,5,2008-12-02 20:51:00,2008-12-02 20:51:00
eff1694cd74dc31b6754c5f3a13f228f7b2a7d03...d390114bb2f78229ec35c5ca78e91527d4745054,2,2,2,4,2,2008-12-03 01:02:00,2008-12-03 01:02:00
165a783a1de8a54c5085fd68d3aa95a69a4b4177...f2097285ac0533fb3428baebcc1d53977424bb14,2,2,2,4,2,2008-12-02 17:50:19,2008-12-02 17:50:19
f2097285ac0533fb3428baebcc1d53977424bb14...482b00b01e23deff0f9e76f31e351eef0bfe1694,5,674,0,674,5,2008-12-02 17:53:05,2008-12-02 17:53:05
482b00b01e23deff0f9e76f31e351eef0bfe1694...6c5b0b5cfb1ca381bb16086775ec3e51855984f6,2,18,355,373,17,2008-12-02 17:54:32,2008-12-02 17:54:32
6c5b0b5cfb1ca381bb16086775ec3e51855984f6...ffc4cd87af8a29a56ac384760ae48108f62ce71b,2,0,16,16,5,2008-12-03 01:27:22,2008-12-03 01:27:22
58fd04ab3888ae4ff97a5b9d0ff8c6f21eabe07d...2b1b3eabff76b818876d2596fc916ab73effa9d8,1,3,2,5,3,2008-12-03 15:15:16,2008-12-03 15:15:16
58fd04ab3888ae4ff97a5b9d0ff8c6f21eabe07d...e98dbf5acde279049113f1b278c0ab9b0033da2e,4,7,1,8,4,2008-12-03 15:12:27,2008-12-03 15:12:27
e98dbf5acde279049113f1b278c0ab9b0033da2e...466bd00a2baf4ace3005f699913de26d91d992e5,1,37,3,40,5,2008-12-03 18:25:06,2008-12-03 18:25:06
ea3e1d083078458f0669ee57ebf8ca56a32c9d18...fa3ec70ca3b8ac0e4b5b2d5a643418ad6a5652f1,1,1,1,2,1,2008-12-03 18:31:44,2008-12-03 18:31:44
fa3ec70ca3b8ac0e4b5b2d5a643418ad6a5652f1...0caf3b7529e0b7ee94b805786025060147229b32,1,31,0,31,1,2008-12-04 13:18:07,2008-12-04 13:18:07
fa3ec70ca3b8ac0e4b5b2d5a643418ad6a5652f1...e0727dc6580dc8d9e53a7047fe9ce3cd6a62cca9,7,49,26,75,29,2008-12-03 23:27:32,2008-12-03 23:27:32
30573a6d913eb33db89ccafd6e1dbb34e901583d...0fe5e50be0deb6790dc6789a027c821ea8eb6a81,5,64,14,78,22,2008-12-04 19:33:18,2008-12-04 19:33:18
0fe5e50be0deb6790dc6789a027c821ea8eb6a81...9fadd09ac6356a6fdac62eb638ee7b92afb8e7c5,6,87,14,101,16,2008-12-04 23:11:25,2008-12-04 23:11:25
9fadd09ac6356a6fdac62eb638ee7b92afb8e7c5...1a95c75d0ffa5dfb865ac40f8fafecd2732bc4ca,8,47,41,88,34,2008-12-05 15:09:16,2008-12-05 15:09:16
1a95c75d0ffa5dfb865ac40f8fafecd2732bc4ca...4b161903e40da7e8f73531b6b6efde4017360e74,3,26,1,27,3,2008-12-05 16:06:51,2008-12-05 16:06:51
4b161903e40da7e8f73531b6b6efde4017360e74...932e7a3295b944012fcd1249ade935057041c97c,5,118,6,124,11,2008-12-05 17:10:03,2008-12-05 17:10:03
932e7a3295b944012fcd1249ade935057041c97c...74f630aacc5cfc958e4a0ac54d86ae65d17e64c9,7,191,76,267,32,2008-12-05 21:45:10,2008-12-05 21:45:10
932e7a3295b944012fcd1249ade935057041c97c...243a3e6b2fa23771aab03bafcd0496c7388bb08f,11,334,6,340,16,2008-12-05 21:03:35,2008-12-05 21:03:35
243a3e6b2fa23771aab03bafcd0496c7388bb08f...2bbe7adce34646b650af0b121818671a5548bd3d,1,2,1,3,1,2008-12-05 21:13:21,2008-12-05 21:13:21
2bbe7adce34646b650af0b121818671a5548bd3d...ef4988edc45f0835bed36f5ab0f0759f8acd490d,1,1,0,1,1,2008-12-05 22:18:27,2008-12-05 22:18:27
40f34f65082b63c1b514b3b7c4cb24a4d492002b...8e600e8f1b9b7ba25f6079393fffa00abec81eba,10,1055,1047,2102,14,2008-12-06 19:49:27,2008-12-06 19:49:27
8e600e8f1b9b7ba25f6079393fffa00abec81eba...155ac2b7c2f40043d4f7699e46edefb3d2bea8ba,5,467,441,908,13,2008-12-08 01:58:20,2008-12-08 01:58:20
155ac2b7c2f40043d4f7699e46edefb3d2bea8ba...f5f533a36fea995571cd9aaccdb22576f40de655,7,157,111,268,59,2008-12-09 14:54:51,2008-12-09 14:54:51
155ac2b7c2f40043d4f7699e46edefb3d2bea8ba...a43b0755ad19c6d4e0b9de30c86b67491b569a9f,2,15,2,17,6,2008-12-08 16:21:00,2008-12-08 16:21:00
a43b0755ad19c6d4e0b9de30c86b67491b569a9f...974db2cac92d6928795cf2cd32d7000bd43c13d4,1,0,1,1,1,2008-12-08 19:23:28,2008-12-08 19:23:28
974db2cac92d6928795cf2cd32d7000bd43c13d4...40dd1bd6e4b988c5f7533daa0e960fc2142f4446,2,2,2,4,2,2008-12-08 19:41:38,2008-12-08 19:41:38
7d9d477e68646d41e66f9b01f0aed410be1c988f...4c027f3cad2385e102de3c11ef03e5212b459953,3,15,6,21,11,2008-12-09 19:42:47,2008-12-09 19:42:47
4c027f3cad2385e102de3c11ef03e5212b459953...980db0d0e6e588cb6ace59e25ad20f85f790c553,3,28,18,46,17,2008-12-10 16:32:56,2008-12-10 16:32:56
4c027f3cad2385e102de3c11ef03e5212b459953...2cf251148e8f4420fdc71a1ca9d8afc4520ed1c0,1,4,1,5,1,2008-12-10 15:46:57,2008-12-10 15:46:57
2cf251148e8f4420fdc71a1ca9d8afc4520ed1c0...91c62b9ed6701ced039ac59a0a8fc60343a3f138,2,30,19,49,11,2008-12-10 16:14:48,2008-12-10 16:14:48
a79b0b918c8a2b94ef0622f1c4717054ff7f6881...b971c4ab83bbc02b0fa840cd811cdfedc03cb5f9,3,3,7,10,5,2008-12-10 16:39:13,2008-12-10 16:39:13
b971c4ab83bbc02b0fa840cd811cdfedc03cb5f9...2c6a08b7de0685deab902ac542a0341f2eea6cb4,2,32,16,48,5,2008-12-10 20:24:07,2008-12-10 20:24:07
b971c4ab83bbc02b0fa840cd811cdfedc03cb5f9...8b8522c4e61e4e5274335603409f30ead429cca6,3,43,27,70,13,2008-12-10 18:07:18,2008-12-10 18:07:18
8b8522c4e61e4e5274335603409f30ead429cca6...c552d12742f8016284ac77304d8721829177004c,1,1,4,5,1,2008-12-10 18:21:22,2008-12-10 18:21:22
9a439fabdd8997740ec76fd85c3cf75f50a428b7...b393202f9716a55490025540502f5d77e251c04c,5,30,19,49,17,2008-12-10 21:52:25,2008-12-10 21:52:25
b393202f9716a55490025540502f5d77e251c04c...0e32c98bf37c8b24ebac4b5e8fc0b0d98c215b16,9,159,107,266,40,2008-12-11 15:27:05,2008-12-11 15:27:05
b393202f9716a55490025540502f5d77e251c04c...4a5d9e567c05b7b81c326fbec2f66acb9e81c4e3,4,109,84,193,24,2008-12-11 14:48:14,2008-12-11 14:48:14
4a5d9e567c05b7b81c326fbec2f66acb9e81c4e3...182bc135ada53ac3943c09799497a5102d71c2fa,1,266,22,288,15,2008-12-11 15:27:44,2008-12-11 15:27:44
ec92451ee597d4a66726b2c51829368d5ce7e880...fe7767635ae0acb3502c4106d969b851bd740654,2,77,61,138,11,2008-12-11 23:51:49,2008-12-11 23:51:49
182bc135ada53ac3943c09799497a5102d71c2fa...1387cb6763be791021e2081ad3138433a8a228f5,1,132,222,354,10,2008-12-11 15:49:52,2008-12-11 15:49:52
f9c2fa46469274ceec065530bd838d965e061c88...fa51bdc1f148658a91b025915265ca50657b3d53,1,1,1,2,1,2008-12-12 00:09:21,2008-12-12 00:09:21
d312a4482eb161ae709b6bf7d9ae7882fefb90ab...fab7190f3aa700d86ea69590599df94fc43eff34,4,42,1,43,4,2008-12-11 16:07:05,2008-12-11 16:07:05
fab7190f3aa700d86ea69590599df94fc43eff34...31a4d14dd4d63be0ca05760f93c355fd1d90be14,1,46,46,92,4,2008-12-11 16:08:28,2008-12-11 16:08:28
31a4d14dd4d63be0ca05760f93c355fd1d90be14...3ec2ba4d9d74c41a3ebd8e114ed12ce3d0706575,7,175,19,194,16,2008-12-11 20:20:28,2008-12-11 20:20:28
3ec2ba4d9d74c41a3ebd8e114ed12ce3d0706575...7bb4001e9a74ae057bc9ccba1db7a7cf5583730f,3,22,22,44,13,2008-12-11 20:27:51,2008-12-11 20:27:51
7bb4001e9a74ae057bc9ccba1db7a7cf5583730f...b3d2c2ebd813af9999998eec6444f73beaa40ca8,2,145,42,187,23,2008-12-11 22:35:11,2008-12-11 22:35:11
90603c4d288bd33c58d6d4698a323b43db05df6a...a16c235dad4f45a7ae49ee67759036f9b08b44e4,1,7,0,7,2,2008-12-12 00:55:43,2008-12-12 00:55:43
b3d2c2ebd813af9999998eec6444f73beaa40ca8...e85055ec41bc897fb4df5d56ceac29968abb683d,2,109,0,109,1,2008-12-12 00:16:06,2008-12-12 00:16:06
e85055ec41bc897fb4df5d56ceac29968abb683d...ac39edd52c99082c5db7af84d464d05fbc50a7ea,7,31,16,47,13,2008-12-12 00:16:25,2008-12-12 00:16:25
a16c235dad4f45a7ae49ee67759036f9b08b44e4...fc7da15c54ea5a4270f57d859b29cf4facb852a8,6,8,8,16,7,2008-12-12 19:19:49,2008-12-12 19:19:49
a16c235dad4f45a7ae49ee67759036f9b08b44e4...410c4e03ff552a423b9cd0e8cf71b30c76b5b0ab,3,20,6,26,10,2008-12-12 19:18:27,2008-12-12 19:18:27
fc7da15c54ea5a4270f57d859b29cf4facb852a8...4d8c3fe3aca25dd4ce2d23ed693354c8d14ed7cc,1,1,0,1,1,2008-12-12 19:22:29,2008-12-12 19:22:29
8738cdc2c211eecbca819fb961b53108a89fa6f1...38edd39c7ffb38ff5e0af1070bb7250d5e174964,4,94,26,120,22,2008-12-12 21:00:55,2008-12-12 21:00:55
38edd39c7ffb38ff5e0af1070bb7250d5e174964...75a45c346f91176995cf9d523cb9ce23c0a6bb29,10,222,73,295,43,2008-12-16 15:20:24,2008-12-16 15:20:24
38edd39c7ffb38ff5e0af1070bb7250d5e174964...e4cb74cc1c98b7903c402bbd3398eb9299ae2151,1,12,2,14,2,2008-12-15 14:45:51,2008-12-15 14:45:51
e4cb74cc1c98b7903c402bbd3398eb9299ae2151...e6e8900f73e085697d688e0c4db494b0dfaf908b,6,241,73,314,38,2008-12-15 22:23:54,2008-12-15 22:23:54
e6e8900f73e085697d688e0c4db494b0dfaf908b...e02a96f48a4e2944391b34bb10ef0ca1ad43e36a,1,10,1,11,3,2008-12-15 23:00:10,2008-12-15 23:00:10
e72a96636fc64a98599bb62eb8eadfd3ffeec241...92a5ab8180d374a779cb96ef1bf55d5f11a9c398,1,2,2,4,1,2008-12-16 17:10:15,2008-12-16 17:10:15
92a5ab8180d374a779cb96ef1bf55d5f11a9c398...6215e1901476e2aeda398acd668189ca390c22d3,1,4,2,6,1,2008-12-16 17:18:02,2008-12-16 17:18:02
e02a96f48a4e2944391b34bb10ef0ca1ad43e36a...b63867ab3ce1a596f6f15e2dfae6fa073c38bb46,3791,1406,664391,665797,3798,2008-12-16 22:48:48,2008-12-16 22:48:48
e02a96f48a4e2944391b34bb10ef0ca1ad43e36a...47f50f5ab0d07df47645eab99caa6c107ab6331d,2,5,2,7,2,2008-12-15 23:22:13,2008-12-15 23:22:13
6215e1901476e2aeda398acd668189ca390c22d3...99bf277c1811252df9da3c19b5308ce2d55f0413,4,6,5,11,5,2008-12-16 23:12:25,2008-12-16 23:12:25
ac51aadd92ced2ea5992bc19541adfa532bca468...78900205066f6a6d9bcfa9da3511eaa76e7eb814,3,8,3,11,6,2008-12-16 23:25:56,2008-12-16 23:25:56
24d149cd28826f238dcb2be528933d65edde9b7f...b473e85b925b37fbee17aa7b6c4fdce13d45e250,13,10,18,28,16,2008-12-17 19:09:37,2008-12-17 19:09:37
1c29b8aae48c16600141242f8c2754a5475070c3...1d8082574af3844607a882b8d953cd1843235509,1,2,7,9,2,2008-12-17 17:23:06,2008-12-17 17:23:06
d0eaef50205cbf025dbd81b77ac8589e9d1a7b41...9dfa96663b9d74cb2de31b4d4f2e755d9992a71f,1,4,0,4,2,2008-12-17 21:27:53,2008-12-17 21:27:53
9dfa96663b9d74cb2de31b4d4f2e755d9992a71f...f0a215a44c9ecd3316edea02cf84a41bb484d682,1,2,2,4,1,2008-12-17 22:39:18,2008-12-17 22:39:18
1d8082574af3844607a882b8d953cd1843235509...752dbb0f45fc6e8e67ceca2626dfc0d2508f73e7,7,36,8,44,16,2008-12-17 20:47:25,2008-12-17 20:47:25
f0a215a44c9ecd3316edea02cf84a41bb484d682...6ae140a2df71604d0c3f22e942a830b14edcc6e1,9,286,205,491,44,2008-12-18 17:02:12,2008-12-18 17:02:12
6ae140a2df71604d0c3f22e942a830b14edcc6e1...3371fa5f54bc8464b1415ed9eba94d4371dfe7ef,2,4,4,8,3,2008-12-18 18:32:06,2008-12-18 18:32:06
3371fa5f54bc8464b1415ed9eba94d4371dfe7ef...e416c1f119864e7dab136804b99199fcb6310e6a,7,64,30,94,19,2008-12-18 18:32:47,2008-12-18 18:32:47
e416c1f119864e7dab136804b99199fcb6310e6a...bbb41b29c8ed6a060590864f826628a7b277fa64,1,76,2,78,6,2008-12-18 18:51:59,2008-12-18 18:51:59
ebe9df6d59e96cc01d7c3d0aa7e3d03460eed401...0ffc82172d60bd002b917efc67ba1790c3abec5d,7,416,40,456,53,2008-12-22 17:38:12,2008-12-22 17:38:12
2e8e9f6b86a34fc51182da4731e83f70f50e78a2...e86ec7a376219d6bfe61eea9f2db17ffed439026,1,1,1,2,2,2008-12-18 20:25:19,2008-12-18 20:25:19
e86ec7a376219d6bfe61eea9f2db17ffed439026...1d6104fce111b0cec17e3f53d487677b2850bbae,3,5,4,9,5,2008-12-19 14:52:54,2008-12-19 14:52:54
1d6104fce111b0cec17e3f53d487677b2850bbae...41ced12a207ace8db14d1fd9d515fab305209313,1,0,5,5,1,2008-12-19 15:55:52,2008-12-19 15:55:52
41ced12a207ace8db14d1fd9d515fab305209313...62253080eb744d0b668f2b1175a28b429ef3169e,1,1,1,2,1,2008-12-19 16:00:47,2008-12-19 16:00:47
62253080eb744d0b668f2b1175a28b429ef3169e...81b17c9344d56bbc73f18ac910f0ae405fea8718,1,3,1,4,1,2008-12-19 16:19:35,2008-12-19 16:19:35
81b17c9344d56bbc73f18ac910f0ae405fea8718...6fab836a35b5a19091eed236fc020b5f43338cbb,1,1,1,2,1,2008-12-19 18:41:53,2008-12-19 18:41:53
6fab836a35b5a19091eed236fc020b5f43338cbb...11f58f18826c9971e1248239d9e7200ca64a654a,7,62,42,104,31,2008-12-19 23:12:59,2008-12-19 23:12:59
11f58f18826c9971e1248239d9e7200ca64a654a...74fc8f3b3166319723e74a6144876198b53723da,1,3,0,3,3,2008-12-19 23:17:56,2008-12-19 23:17:56
74fc8f3b3166319723e74a6144876198b53723da...351c50c7a476698bf146f62eb6d1145c8f1d7d42,1,2,2,4,2,2008-12-22 18:14:22,2008-12-22 18:14:22
0611369ae8c195b044990fb275938738c4582a9f...7e5802c7aeb395878a6897ecc6871426b1685053,1,4,2,6,1,2008-12-22 18:19:51,2008-12-22 18:19:51
7e5802c7aeb395878a6897ecc6871426b1685053...3148da81f2aad7832a960140d3c15a60b4cab266,5,166,13,179,20,2008-12-24 18:57:30,2008-12-24 18:57:30
7e5802c7aeb395878a6897ecc6871426b1685053...10825ba77dc2691b9a22ffe2b0899293f052a707,4,38,11,49,15,2008-12-24 16:11:10,2008-12-24 16:11:10
2df571a8bb134fd5ce157c82e7491178d067997b...e00864a8b66173afc133fc5c1b190ad876bd36b5,1,2,1,3,1,2008-12-24 22:21:26,2008-12-24 22:21:26
10825ba77dc2691b9a22ffe2b0899293f052a707...679d0aa0c36613b6713f340f6e3225dbfa20a7cf,1,5,1,6,1,2008-12-24 19:11:14,2008-12-24 19:11:14
ee7678e5452d28832aa36d8642b578765d2d9ebf...73ad3f145472419cf32a7f719c340d353494fdb9,3,36,20,56,10,2008-12-26 01:05:31,2008-12-26 01:05:31
73ad3f145472419cf32a7f719c340d353494fdb9...96f476c3c51654e03dc94a592839c07879b2edcd,1,1,1,2,1,2008-12-26 01:22:24,2008-12-26 01:22:24
96f476c3c51654e03dc94a592839c07879b2edcd...6e6f6ea89513816320d6122affbb75569008302f,2,22,12,34,7,2008-12-26 01:51:32,2008-12-26 01:51:32
6e6f6ea89513816320d6122affbb75569008302f...12e8be2b6266df2f4201940319771e80166666ad,1,1,1,2,1,2008-12-26 02:22:27,2008-12-26 02:22:27
12e8be2b6266df2f4201940319771e80166666ad...ac2ab910d53e21afc92ef0c47d113710d3c69223,2,28,25,53,10,2008-12-27 03:06:48,2008-12-27 03:06:48
ac2ab910d53e21afc92ef0c47d113710d3c69223...d3d8cb55d1bf1a93a8f4ee21e3e5a59272d19dd9,2,3,3,6,2,2008-12-27 16:05:04,2008-12-27 16:05:04
d3d8cb55d1bf1a93a8f4ee21e3e5a59272d19dd9...4148938303cc3ab6e352584d1db3d742eceda874,5,46,15,61,17,2008-12-27 17:07:20,2008-12-27 17:07:20
4148938303cc3ab6e352584d1db3d742eceda874...b53f593e1bc3d13fc831089541f23116fcc1803a,1,3,3,6,2,2008-12-28 20:32:12,2008-12-28 20:32:12
b53f593e1bc3d13fc831089541f23116fcc1803a...b7cbd301124045fccab665f939a68d703e70629b,91,11126,10426,21552,1998,2008-12-29 01:28:49,2008-12-29 01:28:49
b7cbd301124045fccab665f939a68d703e70629b...c9429bb044dbf27bae1a938cd7ec1c5f4d2d15a9,4,109,70,179,27,2008-12-29 03:01:18,2008-12-29 03:01:18
c9429bb044dbf27bae1a938cd7ec1c5f4d2d15a9...bacf992d45f751a10b3116caeaffbb259d090915,1,1,0,1,1,2008-12-29 19:07:20,2008-12-29 19:07:20
c9429bb044dbf27bae1a938cd7ec1c5f4d2d15a9...03ac7c04be92619acf0bc08756a9ed383a5652b8,1,1,1,2,1,2008-12-29 03:16:58,2008-12-29 03:16:58
03ac7c04be92619acf0bc08756a9ed383a5652b8...b8c9daf883e66f81cb447ce0bed27cea05991077,1,8,0,8,1,2008-12-29 04:11:09,2008-12-29 04:11:09
b8c9daf883e66f81cb447ce0bed27cea05991077...4c7d7b9f355d481d37a9a46dc7ccbf5c4961f44d,1,1,1,2,1,2008-12-29 13:30:56,2008-12-29 13:30:56
4c7d7b9f355d481d37a9a46dc7ccbf5c4961f44d...06e85597d4e40ee9ee947abd4afe8941060a1371,2,2,2,4,2,2008-12-29 13:32:59,2008-12-29 13:32:59
06e85597d4e40ee9ee947abd4afe8941060a1371...53f89950af2a54c007ea8de2828d33fb045e8eb3,1,13,10,23,11,2008-12-29 13:43:26,2008-12-29 13:43:26
53f89950af2a54c007ea8de2828d33fb045e8eb3...1912155761e78742034db2c6f086db2ed4f6704d,1,2,0,2,2,2008-12-29 14:59:26,2008-12-29 14:59:26
1912155761e78742034db2c6f086db2ed4f6704d...f6613cc644420e2e6ac46ca50616cdfd9ee5c742,4,49,7,56,7,2008-12-29 16:56:13,2008-12-29 16:56:13
1912155761e78742034db2c6f086db2ed4f6704d...a9bbd5681b2d7290c714e12967aa6e7753722617,7,26,14,40,16,2008-12-29 16:47:20,2008-12-29 16:47:20
3211918f046a8cd7b0dcf3865f66279e7a49734b...59c6f232248829827200affee37a6faa7ace333f,5,52,19,71,6,2008-12-29 18:24:24,2008-12-29 18:24:24
59c6f232248829827200affee37a6faa7ace333f...4e01f4fc842967d69a81cd68c7d11b3fd99ef3b5,2,37,22,59,19,2008-12-29 19:22:36,2008-12-29 19:22:36
59c6f232248829827200affee37a6faa7ace333f...689962e86dc253c411d7305133d5ffec379aba30,5,12,12,24,5,2008-12-29 19:07:21,2008-12-29 19:07:21
d0112b7569915aa70cec9f03db4e22f652e81b50...da9a8dcac0ba53dfb8b9472df84e0f7ea8d70421,2,9,1,10,2,2009-01-09 03:05:51,2009-01-09 03:05:51
da9a8dcac0ba53dfb8b9472df84e0f7ea8d70421...96d4406eceb386582a89f93f85a660fdfd0fba1a,9,46,51,97,18,2009-01-09 16:20:16,2009-01-09 16:20:16
a6169c8e8855a5959191270bf102cd996eb3193f...6e639c392de52160ad53fa3594cf1175c4fbfd3d,1,2,2,4,1,2008-12-29 19:36:41,2008-12-29 19:36:41
6e639c392de52160ad53fa3594cf1175c4fbfd3d...09b50bacc69fa00bbe9945a72dfb2111bada8403,1,2,3,5,2,2008-12-29 20:06:39,2008-12-29 20:06:39
96d4406eceb386582a89f93f85a660fdfd0fba1a...e586e5220a4f14b87311c1161313db5c1a4e1681,4,52,0,52,7,2009-01-09 23:15:30,2009-01-09 23:15:30
96d4406eceb386582a89f93f85a660fdfd0fba1a...3c0d26731e82f317506e9c8b35bf97f65cf812b8,1,12,4,16,4,2009-01-09 17:16:32,2009-01-09 17:16:32
3c0d26731e82f317506e9c8b35bf97f65cf812b8...e597c95ace60b7d5bfdfd41922e6abc86d54b61b,1,19,0,19,1,2009-01-09 17:33:47,2009-01-09 17:33:47
e597c95ace60b7d5bfdfd41922e6abc86d54b61b...bdaae591ba5b006798c1273a7c87fef36e77726d,1,2,1,3,2,2009-01-09 20:20:09,2009-01-09 20:20:09
bdaae591ba5b006798c1273a7c87fef36e77726d...d5d18f9a94741fb8a02d662758e33ccd3d898ec0,1,4,0,4,2,2009-01-09 20:54:50,2009-01-09 20:54:50
d5d18f9a94741fb8a02d662758e33ccd3d898ec0...0698f06a131259d1a4f9ca5d40fb70e1547c1267,1,4,0,4,1,2009-01-09 22:06:14,2009-01-09 22:06:14
0698f06a131259d1a4f9ca5d40fb70e1547c1267...f0074a5e3d4d62015c8a65ec18ce8662fcb8d711,1,6,4,10,3,2009-01-09 22:07:24,2009-01-09 22:07:24
09b50bacc69fa00bbe9945a72dfb2111bada8403...d5d630022a39a3a00a28ae6642b5819c0ca5c151,3,377,1,378,10,2008-12-30 16:16:14,2008-12-30 16:16:14
09b50bacc69fa00bbe9945a72dfb2111bada8403...87cf98d3671d5ec74a0794a75698fd99235eb45e,1,3,0,3,1,2008-12-29 22:52:05,2008-12-29 22:52:05
87cf98d3671d5ec74a0794a75698fd99235eb45e...875ea007ef8e0c388ad06afca9f2faa194634a34,1,3,0,3,1,2008-12-29 22:52:23,2008-12-29 22:52:23
875ea007ef8e0c388ad06afca9f2faa194634a34...53b68d1b60b1b5ca1cc40f8b35d4f5ea88dc7092,2,162,2,164,4,2008-12-29 22:52:45,2008-12-29 22:52:45
53b68d1b60b1b5ca1cc40f8b35d4f5ea88dc7092...f867ea1a11c3eeffe3e6e85cba92479db2ffe463,2,3,3,6,2,2008-12-29 22:59:44,2008-12-29 22:59:44
f867ea1a11c3eeffe3e6e85cba92479db2ffe463...505021f882dce770c9f4d2dca7b9820badf17d10,3,16,7,23,6,2008-12-30 14:43:13,2008-12-30 14:43:13
505021f882dce770c9f4d2dca7b9820badf17d10...9ff3564c67f365c7ac30398a90e0d213382dc6ad,1,1,0,1,1,2008-12-30 14:47:04,2008-12-30 14:47:04
4927faac52021a2065d24d5afd5ff516cc325511...5867ae239dbdb8ca396200f4d0b45a05208abfa6,1,19,3,22,5,2009-01-10 23:26:02,2009-01-10 23:26:02
4927faac52021a2065d24d5afd5ff516cc325511...6184c2086bf28d850d323ff4cd06b9fbc7c25c2f,2,1,1,2,1,2009-01-10 18:22:18,2009-01-10 18:22:18
93c8c75db7077dc8c0b271b5e1443ca8e53ca1e8...cb023c8bb5d98a56b5150a83a9e3785a8c463e46,3,40,20,60,18,2008-12-30 22:05:15,2008-12-30 22:05:15
cb023c8bb5d98a56b5150a83a9e3785a8c463e46...5c9b3f8d30f996f3b5a731850731b13c947360b2,3,20,3,23,7,2008-12-30 22:16:39,2008-12-30 22:16:39
5c9b3f8d30f996f3b5a731850731b13c947360b2...6b9b6ffa775d202a75a68a0388a32822176e190f,3,78,50,128,33,2008-12-30 22:47:36,2008-12-30 22:47:36
6b9b6ffa775d202a75a68a0388a32822176e190f...e598a0ceddc69ba576c9e4cc9086ab320bd42fe2,2,22,4,26,6,2008-12-30 23:20:57,2008-12-30 23:20:57
9ff3564c67f365c7ac30398a90e0d213382dc6ad...42a807d3eeec1576351f4d7c1b9d96ebbcc4fd35,3,4,4,8,4,2008-12-31 15:01:55,2008-12-31 15:01:55
9ff3564c67f365c7ac30398a90e0d213382dc6ad...c38ac0015edc8964ee027b3f2d0b67ba93c79a9e,1,9,1,10,1,2008-12-30 17:39:18,2008-12-30 17:39:18
23a76df868ee3fb548e56bccb54c22b30deb551f...3b40382a0d6b1e69f9c2d0fc2852366023c8c513,3,67,35,102,38,2008-12-31 00:04:40,2008-12-31 00:04:40
e1a8364867269f7af9db80c7e466977a72192400...c203d091669ad8adab63334e55c6e5b0d51fa471,1,1,1,2,1,2008-12-31 15:03:30,2008-12-31 15:03:30
990ef522c210654d0452979fcb086dc3fbd3113a...4709e5b91ae0d97dfa133ced6b7eb68ed16c117d,1,23,0,23,1,2009-01-10 23:32:19,2009-01-10 23:32:19
4709e5b91ae0d97dfa133ced6b7eb68ed16c117d...eacf1795ee51384edfc6062a37179dd9335c3595,1,17,0,17,1,2009-01-10 23:33:16,2009-01-10 23:33:16
eacf1795ee51384edfc6062a37179dd9335c3595...d5b3d3bdecc31473a10decbb13a70e52dbd69d1a,1,2,0,2,1,2009-01-10 23:35:37,2009-01-10 23:35:37
d5b3d3bdecc31473a10decbb13a70e52dbd69d1a...52cee4898d05861a34648f6bf8a62d34dce46dfd,1,0,0,0,0,2009-01-10 23:35:56,2009-01-10 23:35:56
52cee4898d05861a34648f6bf8a62d34dce46dfd...345b5e78b6bc303e1b11fe3055b1cdf443d720d4,1,2,0,2,1,2009-01-11 00:52:34,2009-01-11 00:52:34
345b5e78b6bc303e1b11fe3055b1cdf443d720d4...86c16c1b9e52b46d647feaa815a97c63c228375b,1,8,0,8,2,2009-01-12 01:22:17,2009-01-12 01:22:17
86c16c1b9e52b46d647feaa815a97c63c228375b...06d8ca3b509307880b6ab488542a9f3215c0877b,1,1,1,2,1,2009-01-12 01:22:38,2009-01-12 01:22:38
06d8ca3b509307880b6ab488542a9f3215c0877b...491559d8c5b0e386f6eeb3b3af60dccfe67e74ab,2,12,1,13,5,2009-01-12 01:23:58,2009-01-12 01:23:58
491559d8c5b0e386f6eeb3b3af60dccfe67e74ab...27ef7c544dd0cdaf3f530d9bf4aed68fd2259e52,2,154,1,155,3,2009-01-12 04:02:19,2009-01-12 04:02:19
27ef7c544dd0cdaf3f530d9bf4aed68fd2259e52...9e3d798e37da1138036a410e70163f8ed9d7bdb5,3,12,12,24,10,2009-01-12 14:38:11,2009-01-12 14:38:11
9e3d798e37da1138036a410e70163f8ed9d7bdb5...3e5965e2c988e7da3d29205adf169891cca2433c,1,1,1,2,1,2009-01-12 14:58:30,2009-01-12 14:58:30
3e5965e2c988e7da3d29205adf169891cca2433c...efe3736b9453fd34c32b3f5f36c2a97b1f085666,2,16,5,21,8,2009-01-12 15:22:58,2009-01-12 15:22:58
efe3736b9453fd34c32b3f5f36c2a97b1f085666...4b040c0cebf10a96b77ae619128afd2d02ab9ae6,1,1,1,2,1,2009-01-12 15:27:43,2009-01-12 15:27:43
4b040c0cebf10a96b77ae619128afd2d02ab9ae6...67419db7d1dc6947ae2a647ea9674eaf3738d93c,1,4,2,6,2,2009-01-12 15:30:04,2009-01-12 15:30:04
67419db7d1dc6947ae2a647ea9674eaf3738d93c...451116c121405a9e25a01326c61f13b697acd37e,1,8,1,9,4,2009-01-12 15:34:12,2009-01-12 15:34:12
3b40382a0d6b1e69f9c2d0fc2852366023c8c513...50f1c263062b718d4e9013cc9bf66a34ba2fecf9,1,2,0,2,1,2008-12-31 13:40:04,2008-12-31 13:40:04
3b40382a0d6b1e69f9c2d0fc2852366023c8c513...6993396fedc14755f644b7a261f02a5e0e97b777,1,7,1,8,2,2008-12-31 02:48:42,2008-12-31 02:48:42
6993396fedc14755f644b7a261f02a5e0e97b777...9dde507fa75d8aeced86f979cb60da866d16c15d,3,29,7,36,5,2008-12-31 02:58:36,2008-12-31 02:58:36
517ac6fcc6d856f33afdcac02dd718aeb0e32f0a...44351d87725c4c9562bfab981613ff1e244fc5b9,1,1,1,2,1,2008-12-31 18:58:06,2008-12-31 18:58:06
517ac6fcc6d856f33afdcac02dd718aeb0e32f0a...f5a9c70a19efa460244f46e74f94badd2d9d2285,1,1,1,2,1,2008-12-31 16:59:03,2008-12-31 16:59:03
f5a9c70a19efa460244f46e74f94badd2d9d2285...e5aa3e5e0bc385e149486159e10d01f5b25c3e41,3,45,10,55,4,2008-12-31 16:59:28,2008-12-31 16:59:28
e5aa3e5e0bc385e149486159e10d01f5b25c3e41...c89f0e9df98e51abb5fc4a3f738c9a4456f7af03,1,14,1,15,2,2008-12-31 16:59:41,2008-12-31 16:59:41
c89f0e9df98e51abb5fc4a3f738c9a4456f7af03...5c22ff7d852be2c413dc806da4f512e2d170dc6d,2,42,2,44,4,2008-12-31 19:58:42,2008-12-31 19:58:42
5c22ff7d852be2c413dc806da4f512e2d170dc6d...a164be1e431acf3c01f1080ccc94fe5be5d973b1,1,74,15,89,14,2008-12-31 20:07:01,2008-12-31 20:07:01
a164be1e431acf3c01f1080ccc94fe5be5d973b1...babed9805003410eee2d3202dea7d1d5eb446ec1,2,9,4,13,4,2009-01-02 15:39:59,2009-01-02 15:39:59
451116c121405a9e25a01326c61f13b697acd37e...aca6d9c59f84d67af112201f7ca7522b113fe9fc,1,1,0,1,1,2009-01-12 20:27:37,2009-01-12 20:27:37
aca6d9c59f84d67af112201f7ca7522b113fe9fc...1aece262913919e350a076ef058ec690bf983245,1,63,0,63,1,2009-01-12 20:27:46,2009-01-12 20:27:46
1aece262913919e350a076ef058ec690bf983245...a9be70b77f4c380cfb2f53d4e96b7a85eabe7e0a,1,31,0,31,2,2009-01-12 20:27:55,2009-01-12 20:27:55
451116c121405a9e25a01326c61f13b697acd37e...49043c49d6dafb70fccb79706f8cb7c2259f0be2,2,23,8,31,5,2009-01-12 16:51:20,2009-01-12 16:51:20
6d99f4019c3b72f5d872c3f571d8b249c037ac1c...9778190a26e0eed342a04b44f902e366dc3d6f43,1,52,1,53,2,2008-12-31 14:17:30,2008-12-31 14:17:30
ff2f3e9784a1c9f376ac5ceb3dd6644a84a956cc...86c13991dfed9d9abff8345516292a196ec71e8a,1,10,6,16,2,2009-01-02 15:52:43,2009-01-02 15:52:43
86c13991dfed9d9abff8345516292a196ec71e8a...f0b6cf77b59478d4f47f866ffe0d5929e39b7624,2,1,17,18,3,2009-01-02 15:57:33,2009-01-02 15:57:33
f0b6cf77b59478d4f47f866ffe0d5929e39b7624...7dde0887210b36e1690157e7028c95aa1c81b5cc,1,0,5,5,2,2009-01-02 15:58:40,2009-01-02 15:58:40
7dde0887210b36e1690157e7028c95aa1c81b5cc...ce95083dc263d4588cbf4ebe5fdd9f3b651aa42b,5,49,42,91,5,2009-01-02 21:41:13,2009-01-02 21:41:13
ce95083dc263d4588cbf4ebe5fdd9f3b651aa42b...5c98086691a91d2d6a7f293ff6a07616a0d2cc7c,1,6,4,10,3,2009-01-02 21:43:14,2009-01-02 21:43:14
5c98086691a91d2d6a7f293ff6a07616a0d2cc7c...bac68f8e58c2c76367c6e0978d51b9686d1a76e7,1,48,0,48,1,2009-01-03 16:28:21,2009-01-03 16:28:21
bac68f8e58c2c76367c6e0978d51b9686d1a76e7...fdb7b856d32a0d2742eefb5ad430c3a5c50b0063,1,3,0,3,1,2009-01-03 16:31:01,2009-01-03 16:31:01
fdb7b856d32a0d2742eefb5ad430c3a5c50b0063...8c35ccfba6d1b68770613322046e4724b54d83ab,1,4,2,6,4,2009-01-03 18:01:29,2009-01-03 18:01:29
8c35ccfba6d1b68770613322046e4724b54d83ab...b557e3ad74718feca785638f3ba87164d93e034e,1,43,6,49,6,2009-01-03 19:01:59,2009-01-03 19:01:59
b557e3ad74718feca785638f3ba87164d93e034e...f9eff469702f2058ce6874f738ded53f14b03dbc,1,8,2,10,3,2009-01-03 19:13:16,2009-01-03 19:13:16
e11b2d8379f96df01985da15154c9e06507a5748...390d949b6dd1ce8c07282dc775707cb8bde79f24,2,8,0,8,4,2009-01-13 14:15:47,2009-01-13 14:15:47
390d949b6dd1ce8c07282dc775707cb8bde79f24...ea90934bda4f66cb1359b9c156f8616a01cd2bd2,3,11,3,14,5,2009-01-13 14:56:18,2009-01-13 14:56:18
49043c49d6dafb70fccb79706f8cb7c2259f0be2...d0299a39d1fe43c1c9c70c735fb0214ae1647f71,2,113,68,181,36,2009-01-13 15:28:42,2009-01-13 15:28:42
d0299a39d1fe43c1c9c70c735fb0214ae1647f71...c794c1e681bc3259b9adc27ddc47a632fc0df320,2,239,44,283,29,2009-01-13 15:30:01,2009-01-13 15:30:01
c794c1e681bc3259b9adc27ddc47a632fc0df320...c561ec35136376f6d6204985640e0796881022d1,1,3,3,6,2,2009-01-13 15:30:52,2009-01-13 15:30:52
c561ec35136376f6d6204985640e0796881022d1...509c2de55bf7d107e0396c395a23b334ed759cd8,1,10,7,17,7,2009-01-13 15:31:56,2009-01-13 15:31:56
509c2de55bf7d107e0396c395a23b334ed759cd8...6cf747653f94d4a83996259e1ca23909b973ec12,2,167,14,181,13,2009-01-13 15:32:34,2009-01-13 15:32:34
6cf747653f94d4a83996259e1ca23909b973ec12...51276a86b1f0c9c5c4cba779e9d0e942549acc0b,4,12,7,19,9,2009-01-13 15:34:18,2009-01-13 15:34:18
51276a86b1f0c9c5c4cba779e9d0e942549acc0b...303ad60dcfafceb91753d4dfdf0807f4d6bcc435,1,14,4,18,2,2009-01-13 15:34:36,2009-01-13 15:34:36
303ad60dcfafceb91753d4dfdf0807f4d6bcc435...1b33b3f76d67af948add8caf6e4112e39a847fa4,4,420,3,423,7,2009-01-13 15:36:06,2009-01-13 15:36:06
1b33b3f76d67af948add8caf6e4112e39a847fa4...2cebe27624679a5887e58a6a314a3556dfd55c1d,1,2,2,4,2,2009-01-13 15:36:27,2009-01-13 15:36:27
2cebe27624679a5887e58a6a314a3556dfd55c1d...5ca7768c1e2347211bc3c2bf7375aaf747aa10a4,1,8,0,8,3,2009-01-13 15:36:48,2009-01-13 15:36:48
9778190a26e0eed342a04b44f902e366dc3d6f43...6a4de72765cce4ba59b26396c1ecd387f706026a,3,48,10,58,8,2008-12-31 16:33:41,2008-12-31 16:33:41
f9eff469702f2058ce6874f738ded53f14b03dbc...a4c7aae14c910a0c8785fce6d771d0d2475e81d7,1,18,0,18,1,2009-01-04 18:58:05,2009-01-04 18:58:05
a4c7aae14c910a0c8785fce6d771d0d2475e81d7...b726cbeed57f1242defe4780b4a7c21159916986,1,28,9,37,7,2009-01-04 19:13:51,2009-01-04 19:13:51
b726cbeed57f1242defe4780b4a7c21159916986...ffc3bb2216da756a77c18065a52c3cc1bb694cd3,5,23,14,37,15,2009-01-05 01:09:31,2009-01-05 01:09:31
c13705ef669b280fc570a1cbd84e5255b5c47a98...f2bbe896668df9757a6598cce3cfa9cb15af0d80,3,64,29,93,24,2009-01-13 19:27:59,2009-01-13 19:27:59
c13705ef669b280fc570a1cbd84e5255b5c47a98...adcb736a7a6a497fbdf1eae5d3169bcc23b074a0,1,1,1,2,1,2009-01-13 16:10:45,2009-01-13 16:10:45
adcb736a7a6a497fbdf1eae5d3169bcc23b074a0...4e60ec0df1ef54a02bea0d5300e89e51efe7a58d,6,26,1,27,8,2009-01-13 17:53:00,2009-01-13 17:53:00
ffc3bb2216da756a77c18065a52c3cc1bb694cd3...8428e6cbda95390bc28717b3aafaee3803f80b60,6,293,20,313,17,2009-01-10 23:17:23,2009-01-10 23:17:23
ffc3bb2216da756a77c18065a52c3cc1bb694cd3...2e35206b4781ee72378ddddc4c2f99a1c290ab58,9,173,29,202,22,2009-01-05 20:30:07,2009-01-05 20:30:07
ffc3bb2216da756a77c18065a52c3cc1bb694cd3...390fc85eb95a65f339d5cd7642750b088f3290f4,1,1,1,2,1,2009-01-05 19:47:41,2009-01-05 19:47:41
390fc85eb95a65f339d5cd7642750b088f3290f4...037e2ae555e741fbe12da7b63a8cbfb016fa834c,1,4,0,4,1,2009-01-05 19:47:51,2009-01-05 19:47:51
037e2ae555e741fbe12da7b63a8cbfb016fa834c...33e11bc991a4b3181b9da3eb3b490f3e9a089878,2,39,1,40,3,2009-01-05 19:48:04,2009-01-05 19:48:04
33e11bc991a4b3181b9da3eb3b490f3e9a089878...27b5f64de9c9f7f07fcb8fed03006281d8546eba,1,3,2,5,1,2009-01-05 21:12:25,2009-01-05 21:12:25
27b5f64de9c9f7f07fcb8fed03006281d8546eba...5bc0c4a04e0678555a4bcfcb4bc0201db9a326d4,1,33,10,43,9,2009-01-05 21:12:44,2009-01-05 21:12:44
29bf72030f21f43ee3142e71bdf20f9eace527f7...72a4d77e23e90da4267fc6cc00b64d876c6a5fe4,1,3,1,4,1,2009-01-13 19:57:21,2009-01-13 19:57:21
4e60ec0df1ef54a02bea0d5300e89e51efe7a58d...f9a9cda30e0c8f6964c011264eab7e4401c24097,2,89,5,94,11,2009-01-13 19:32:36,2009-01-13 19:32:36
2e35206b4781ee72378ddddc4c2f99a1c290ab58...b7b8bed9f7596791481ef7cf58c82dd61b081c16,6,75,33,108,25,2009-01-06 15:48:09,2009-01-06 15:48:09
2a899ee01e7ddffbea503ba977f2f822268d22e8...306d8634fdaeb546ece02a88b14a9c73cf2032f3,1,40,0,40,1,2009-01-05 23:19:56,2009-01-05 23:19:56
306d8634fdaeb546ece02a88b14a9c73cf2032f3...5cfe811560549d061f41770de3f00860aff8e406,1,18,0,18,2,2009-01-05 23:53:46,2009-01-05 23:53:46
72a4d77e23e90da4267fc6cc00b64d876c6a5fe4...21a13b1336826972a0c029995e2382e17561572a,14,209,169,378,135,2009-01-14 18:56:52,2009-01-14 18:56:52
7714fb892492c4ff85e949b9645e1cea41bc5883...0565401c2e5311249c79d35488998bf752966fe1,2,4,4,8,4,2009-01-13 20:19:50,2009-01-13 20:19:50
bed528742b81f92442eb25a42fa51518432061b5...1ca30aed27ed605a00c46655bd9c41860daa03b0,1,1,1,2,1,2009-01-06 15:50:01,2009-01-06 15:50:01
64cc93ac221aa63f5b961f598eb1b5a14a8bb685...023535d844a43627d1f2c934ffd349f4355ed4c2,1,0,9,9,1,2009-01-14 19:52:26,2009-01-14 19:52:26
023535d844a43627d1f2c934ffd349f4355ed4c2...ad1f6b3cbdd1183eedc04f98fa813e63ce68a408,97,535,25,560,271,2009-01-14 22:09:51,2009-01-14 22:09:51
ad1f6b3cbdd1183eedc04f98fa813e63ce68a408...248a6dd8deab804423944ad1d0bdf234200fef84,47,2443,2312,4755,438,2009-01-14 22:17:24,2009-01-14 22:17:24
248a6dd8deab804423944ad1d0bdf234200fef84...e5db6b0d3994030924cb9cc06c1717dfe5cfecaf,2,6,2,8,2,2009-01-14 23:40:19,2009-01-14 23:40:19
e5db6b0d3994030924cb9cc06c1717dfe5cfecaf...938c2c07a8032259527b8e9cbb6d0d12c7e8867a,5,48,11,59,13,2009-01-15 15:08:20,2009-01-15 15:08:20
7a7f4fd1efe62d163516690c3f2af2b7e1461130...b457502b26238b787827c77a054e8f09ac9156ac,1,4,2,6,4,2009-01-13 20:20:28,2009-01-13 20:20:28
b457502b26238b787827c77a054e8f09ac9156ac...6d7a16678bd0e0e7ca6b603433958e739fb6329c,2,81,1,82,2,2009-01-13 20:45:49,2009-01-13 20:45:49
6d7a16678bd0e0e7ca6b603433958e739fb6329c...b1bd045a9ae515ea65c7d770e2c5f6ae78588668,1,3,2,5,3,2009-01-13 21:08:01,2009-01-13 21:08:01
b1bd045a9ae515ea65c7d770e2c5f6ae78588668...57eeff38ecb13d5e241e55e95070289c81ebe8db,3,45,2,47,5,2009-01-13 21:08:07,2009-01-13 21:08:07
57eeff38ecb13d5e241e55e95070289c81ebe8db...bf7edfbae5e1fcad13ddb58cf1c15ccef4341afa,3,77,0,77,5,2009-01-14 14:40:54,2009-01-14 14:40:54
1ca30aed27ed605a00c46655bd9c41860daa03b0...1cc123561a34d39ba65c4969792def2fe598fd69,6,77,64,141,15,2009-01-06 23:25:38,2009-01-06 23:25:38
1ca30aed27ed605a00c46655bd9c41860daa03b0...dacc872ba2a3cc22c412c052b285d72453a4f369,11,906,74,980,45,2009-01-06 18:02:09,2009-01-06 18:02:09
dacc872ba2a3cc22c412c052b285d72453a4f369...e43158ea544643bc5b9d674b98e336e4dde04ecc,1,21,12,33,2,2009-01-06 18:08:25,2009-01-06 18:08:25
e43158ea544643bc5b9d674b98e336e4dde04ecc...79f6f769af0dda7541baca27564dee10dbb279fb,1,1,1,2,1,2009-01-06 18:12:47,2009-01-06 18:12:47
79f6f769af0dda7541baca27564dee10dbb279fb...9c4278f3ff97aa1d84cabd62364ccd49a5b62be7,3,44,14,58,8,2009-01-06 18:54:19,2009-01-06 18:54:19
9c4278f3ff97aa1d84cabd62364ccd49a5b62be7...dcb974a59ff55333b38f7ae93b84855db2289250,1,14,0,14,2,2009-01-06 19:03:52,2009-01-06 19:03:52
dcb974a59ff55333b38f7ae93b84855db2289250...d91a66e744b1761ad26cbc5d7e33ba43e4277765,2,7,6,13,6,2009-01-06 19:27:05,2009-01-06 19:27:05
938c2c07a8032259527b8e9cbb6d0d12c7e8867a...85157dfb02e4135716f5efe476c0b95968885ada,1,312,0,312,1,2009-01-15 16:33:59,2009-01-15 16:33:59
938c2c07a8032259527b8e9cbb6d0d12c7e8867a...90d45238aa5fccb6dbdf0b40dfcf5823695d4643,97,17486,17486,34972,2129,2009-01-15 15:17:11,2009-01-15 15:17:11
90d45238aa5fccb6dbdf0b40dfcf5823695d4643...261a467aa50cf6c733c89d2e299a8dd63b569750,41,360,367,727,256,2009-01-15 16:26:38,2009-01-15 16:26:38
bf7edfbae5e1fcad13ddb58cf1c15ccef4341afa...20dc205b17d0569c75a830d7bb4acfe09f050890,2,10,3,13,3,2009-01-14 15:11:51,2009-01-14 15:11:51
bf7edfbae5e1fcad13ddb58cf1c15ccef4341afa...a7862f55270ec89828ab4fdbc575781c97ca467b,2,6,0,6,2,2009-01-14 14:57:53,2009-01-14 14:57:53
11c43967f982afb930078b173a7dfcf3b9c314a6...6e9a533d67ba43a2d3d40e3e4c74f671470a660e,4,10,6,16,5,2009-01-06 23:57:01,2009-01-06 23:57:01
db0b2adb69ee5ba41d830c0cbfd2d8a73d661c11...2dcdaa494afcc99a888d41a3e1702dadddbd480e,1,14,17,31,12,2009-01-15 16:38:32,2009-01-15 16:38:32
261a467aa50cf6c733c89d2e299a8dd63b569750...7c7bd85c6d04fff1d22958ee44560ef1c0974ae1,6,78,11,89,14,2009-01-15 18:04:25,2009-01-15 18:04:25
a7862f55270ec89828ab4fdbc575781c97ca467b...36a89782b76b75ef7ac547dfbb6c7d4fc91db07e,1,12,0,12,1,2009-01-14 15:40:09,2009-01-14 15:40:09
36a89782b76b75ef7ac547dfbb6c7d4fc91db07e...cc4797431299a1d69f3e9a46283129bcc475a7ab,3,65,1,66,3,2009-01-14 15:40:15,2009-01-14 15:40:15
6e9a533d67ba43a2d3d40e3e4c74f671470a660e...db20305fa1ce82b3d00b2b8b293eec2d17e28fc3,7,694,3,697,13,2009-01-07 18:31:16,2009-01-07 18:31:16
6e9a533d67ba43a2d3d40e3e4c74f671470a660e...601be4dd4f44a1988798e3474b10dbcfa29a9e93,9,152,125,277,41,2009-01-07 15:08:12,2009-01-07 15:08:12
601be4dd4f44a1988798e3474b10dbcfa29a9e93...6f1813327761b1c3dbcd66ed840b27de2e60be20,1,23,22,45,5,2009-01-07 15:32:44,2009-01-07 15:32:44
6f1813327761b1c3dbcd66ed840b27de2e60be20...df3e0eb4864965bc0800e36dbb99dc25de743283,1,9,0,9,2,2009-01-07 15:35:17,2009-01-07 15:35:17
df3e0eb4864965bc0800e36dbb99dc25de743283...b9bedaa2231339fc3b02afd97f29ba2f352fe27d,1,9,2,11,6,2009-01-07 18:27:01,2009-01-07 18:27:01
2dcdaa494afcc99a888d41a3e1702dadddbd480e...528bceb2d25d88102b7c2033154e919824fc71e2,2,53,28,81,10,2009-01-15 22:40:43,2009-01-15 22:40:43
3d034b2882816712d44bac93bffb52b32f874741...e1f97b30c45cadbd4d7d754c6d932103154ee9b7,4,58,97,155,24,2009-01-16 14:55:36,2009-01-16 14:55:36
44b7b2cf1b14797c71fa9f471843c4d3effc2075...3c7205be4ae997623a808aad200654edf5773ca3,2,6,3,9,2,2009-01-14 15:44:25,2009-01-14 15:44:25
3c7205be4ae997623a808aad200654edf5773ca3...47e463f0cec847a679f8efc822a787239ba86ce5,1,15,1,16,2,2009-01-14 15:58:32,2009-01-14 15:58:32
47e463f0cec847a679f8efc822a787239ba86ce5...9ecc007b5b7a4e367d1f2183d62f4d31ee131ff9,4,13,14,27,5,2009-01-14 18:00:07,2009-01-14 18:00:07
1f737827b0e16929165543ae3f44561587c7494a...3310cb228057f6be16b669ebb642d32f29f0e68c,5,56,12,68,8,2009-01-07 23:47:11,2009-01-07 23:47:11
b9bedaa2231339fc3b02afd97f29ba2f352fe27d...dd3f38b2a24ad58e2778433c2af3149599f68175,1,11,0,11,1,2009-01-07 20:51:42,2009-01-07 20:51:42
dd3f38b2a24ad58e2778433c2af3149599f68175...abd3ab38a66e3c8d0f9f846e89e98ca09c6ddf0c,1,1,1,2,1,2009-01-07 21:48:47,2009-01-07 21:48:47
528bceb2d25d88102b7c2033154e919824fc71e2...e87560d553ff1963244ba46dcebb62ca49e2e778,3,82,40,122,27,2009-01-16 15:44:56,2009-01-16 15:44:56
f9054d860bb690d09b4c9dfb6d1911689b738935...3a533a94324d710c0df78ffdad78148601c7b54c,2,19,0,19,2,2009-01-16 15:21:23,2009-01-16 15:21:23
4f0237bcda5762646488d2c184e681b5d0a91402...4d456a183308bfee7bae5bc1b97e9ca4c500b58e,1,18,0,18,1,2009-01-08 14:37:18,2009-01-08 14:37:18
4d456a183308bfee7bae5bc1b97e9ca4c500b58e...524c369f055ed32366304e56ca31e7c295e3108d,1,2,2,4,2,2009-01-08 14:52:51,2009-01-08 14:52:51
524c369f055ed32366304e56ca31e7c295e3108d...5830f2872dfcfd635ba9ab20f3b7d9ef7bc742c2,1,20,3,23,1,2009-01-08 14:53:46,2009-01-08 14:53:46
5830f2872dfcfd635ba9ab20f3b7d9ef7bc742c2...965c03a203815e2f659b35951a298817ca7ad128,10,54,9,63,10,2009-01-08 19:18:27,2009-01-08 19:18:27
965c03a203815e2f659b35951a298817ca7ad128...6626d2d9a9b19f869af8adf4eb01ef292340bc51,1,3,3,6,2,2009-01-08 19:28:10,2009-01-08 19:28:10
abd3ab38a66e3c8d0f9f846e89e98ca09c6ddf0c...cea2dd0ed3d845f4a52e7f6e85c76058e2dee9a0,1,15,7,22,7,2009-01-07 23:05:22,2009-01-07 23:05:22
abd3ab38a66e3c8d0f9f846e89e98ca09c6ddf0c...7d68edbe93288821fd50099af59d25e56e9b0eff,1,0,6,6,1,2009-01-07 22:03:16,2009-01-07 22:03:16
9ae07259eb3e5ad7dafa5257cc2e23d14a9c6915...31a8c7c0b2a0877b2a14aa459eb3db3d9411bf71,1,4,2,6,1,2009-01-16 15:48:21,2009-01-16 15:48:21
6626d2d9a9b19f869af8adf4eb01ef292340bc51...d61abc7489d4848bca53489a3a121e358f7513a6,1,13,4,17,3,2009-01-08 21:23:59,2009-01-08 21:23:59
6626d2d9a9b19f869af8adf4eb01ef292340bc51...f1a538c7c80c027cd02bc7f85b070963e34235c3,2,76,22,98,12,2009-01-08 20:21:16,2009-01-08 20:21:16
7d68edbe93288821fd50099af59d25e56e9b0eff...959598db78689b501a84abdb93b9ff477713cb1e,1,1,1,2,1,2009-01-07 23:21:03,2009-01-07 23:21:03
31a8c7c0b2a0877b2a14aa459eb3db3d9411bf71...61b0b78d75ff8db5e96e11be1b5de4fd5409ed51,1,2,2,4,2,2009-01-16 16:13:18,2009-01-16 16:13:18
ca65f70e08c2d6d689e9378e2d7019b83b8ddc97...1524c3e44b59db7036893946403369891ce55b5e,4,294,47,341,29,2009-01-16 20:13:46,2009-01-16 20:13:46
cd9d750a93f40a91c198c3226f284c7502723fdb...ab581691b5c445496b6832c67eb5840769a20dba,2,9,0,9,2,2009-01-08 22:08:43,2009-01-08 22:08:43
61b0b78d75ff8db5e96e11be1b5de4fd5409ed51...004db2d6feff04a2f32819dfac86309db82f5247,3,41,3,44,7,2009-01-16 19:21:46,2009-01-16 19:21:46
1c2b23bb0f8c0f2f4a401c06bb4724824b07e94d...2a368b1ef4471bd7fd357bc3dcd7d8ab25481b8c,1,1,0,1,1,2009-01-16 20:52:17,2009-01-16 20:52:17
2a368b1ef4471bd7fd357bc3dcd7d8ab25481b8c...980ce5a3964187c94ad3624950fa71442016f8b9,2,46,0,46,3,2009-01-16 21:40:46,2009-01-16 21:40:46
980ce5a3964187c94ad3624950fa71442016f8b9...4dd2a1765ffbcb1e092666c4a7ffd6f8cd3702ca,1,0,2,2,1,2009-01-16 21:42:00,2009-01-16 21:42:00
4dd2a1765ffbcb1e092666c4a7ffd6f8cd3702ca...cd8f3155388cc7eadaf3c0a4b5faac8dfffa8810,1,1,1,2,1,2009-01-16 21:51:06,2009-01-16 21:51:06
cd8f3155388cc7eadaf3c0a4b5faac8dfffa8810...b99376f893b75633f246e626a4ae037bef0b4e9f,1,133,0,133,7,2009-01-16 22:12:56,2009-01-16 22:12:56
b99376f893b75633f246e626a4ae037bef0b4e9f...b36a643a54b1e51b96fee8e15c40db27ab847b5f,1,19,17,36,2,2009-01-16 22:36:48,2009-01-16 22:36:48
b36a643a54b1e51b96fee8e15c40db27ab847b5f...204da5d094b5066b1faedf17a1d92ce14a31772f,7,885,853,1738,16,2009-01-17 13:57:27,2009-01-17 13:57:27
b36a643a54b1e51b96fee8e15c40db27ab847b5f...ff99799a0c1d1ae6017a4cf7334b0f7c3005ff1b,2,30,23,53,8,2009-01-17 05:19:43,2009-01-17 05:19:43
ff99799a0c1d1ae6017a4cf7334b0f7c3005ff1b...1f27383fc2c08d7efd7f3085c2bb2c8888846050,3,35,3,38,9,2009-01-17 05:20:47,2009-01-17 05:20:47
9114640a56e05037966252b4f8250c3418d16596...4097bfec55e8ed7aa6683344feadb2933adc2439,1,27,1,28,3,2009-01-17 14:22:55,2009-01-17 14:22:55
4097bfec55e8ed7aa6683344feadb2933adc2439...57b78fd14478a5b1567fede1e9f2de8a712d8d04,1,12,4,16,5,2009-01-17 15:25:56,2009-01-17 15:25:56
57b78fd14478a5b1567fede1e9f2de8a712d8d04...be8eec73d15ab67afee7bb428f822048184de2fd,1,1,1,2,1,2009-01-17 15:33:43,2009-01-17 15:33:43
be8eec73d15ab67afee7bb428f822048184de2fd...7ab5c92da29a203cc9f851a9ec6bb67702b79c40,1,1,1,2,1,2009-01-18 15:23:57,2009-01-18 15:23:57
7ab5c92da29a203cc9f851a9ec6bb67702b79c40...aadb25173167daaf6afc4677f0b6b6ddba29e36e,3,121,4,125,13,2009-01-18 18:11:43,2009-01-18 18:11:43
aadb25173167daaf6afc4677f0b6b6ddba29e36e...75c6ef332d47767d119d51e29a5db0b09238628d,1,11,4,15,4,2009-01-18 18:15:44,2009-01-18 18:15:44
7ab5c92da29a203cc9f851a9ec6bb67702b79c40...adfc20de09db9ec3576e103fd2b1f6bcc800a8ee,1,1,1,2,1,2009-01-18 16:10:01,2009-01-18 16:10:01
adfc20de09db9ec3576e103fd2b1f6bcc800a8ee...f412f99beef85a1485d66a8347cf46aa694d5762,7,1896,1859,3755,15,2009-01-18 16:53:33,2009-01-18 16:53:33
f412f99beef85a1485d66a8347cf46aa694d5762...644af22b4d351ec5164f7ba63bb868bd13dabf6d,1,4,3,7,2,2009-01-18 17:05:17,2009-01-18 17:05:17
644af22b4d351ec5164f7ba63bb868bd13dabf6d...f7dcfc6a2c7c1650079bdbbb08d3343449c0692c,2,9,3,12,5,2009-01-18 17:19:26,2009-01-18 17:19:26
45b5c44f419fab1b94b1a632288ff4fc44501e6c...e0fa0d2947006935adbafc4280c83eb4de95cdd7,1,2,2,4,4,2009-01-19 14:51:38,2009-01-19 14:51:38
e0fa0d2947006935adbafc4280c83eb4de95cdd7...4bcce9cea6b9b98b3572704fc56b1b0cbc62ac72,1,8,0,8,2,2009-01-19 15:20:31,2009-01-19 15:20:31
4bcce9cea6b9b98b3572704fc56b1b0cbc62ac72...0f937ba9c990682628d2a22c8c23aa01aefad3a7,1,1,1,2,1,2009-01-19 15:54:02,2009-01-19 15:54:02
0f937ba9c990682628d2a22c8c23aa01aefad3a7...1eee5b454cd4c263c87f680cbc3ac834e5eee871,1,1,0,1,1,2009-01-19 16:59:42,2009-01-19 16:59:42
1eee5b454cd4c263c87f680cbc3ac834e5eee871...0279a79e5a574cf0ccdc92298d34c7f93668ed59,1,12,1,13,3,2009-01-19 18:02:41,2009-01-19 18:02:41
0279a79e5a574cf0ccdc92298d34c7f93668ed59...40ae4513165f140e588de732a9fbf5c3647c5e5f,1,1,1,2,1,2009-01-19 19:25:50,2009-01-19 19:25:50
f7dcfc6a2c7c1650079bdbbb08d3343449c0692c...e1021ee8abbe5f2f9dde593d171df4995ba8a79b,20,1787,1517,3304,62,2009-01-18 22:48:44,2009-01-18 22:48:44
f7dcfc6a2c7c1650079bdbbb08d3343449c0692c...8db6d69f003159da24c8d426d63e0fda0f9b004d,1,22,1,23,2,2009-01-18 20:32:00,2009-01-18 20:32:00
40ae4513165f140e588de732a9fbf5c3647c5e5f...26b4acb5b9d0c7174bf48a0262a5bfc9473a9a4b,3,10,0,10,5,2009-01-20 16:05:53,2009-01-20 16:05:53
40ae4513165f140e588de732a9fbf5c3647c5e5f...4c4bfebbc913c7fa7b0d007be963f355d59c0776,1,16,2,18,5,2009-01-20 15:22:09,2009-01-20 15:22:09
1ee8d1f93e4813e6a20c53bb16308eb788739507...500168288cc8a82783410d895a63eb62874dc8b1,2,4,2,6,3,2009-01-19 00:01:51,2009-01-19 00:01:51
4c4bfebbc913c7fa7b0d007be963f355d59c0776...337f3ca3cf694a43f085b262a852ffe5802f6ce1,1,2,2,4,2,2009-01-20 16:19:09,2009-01-20 16:19:09
500168288cc8a82783410d895a63eb62874dc8b1...e4b9bfcf5d872bd73aa759998c22164c5712238a,1,3,3,6,3,2009-01-19 00:40:25,2009-01-19 00:40:25
500168288cc8a82783410d895a63eb62874dc8b1...c0961eb637c18a1344fbf67a716e660518a397f7,6,1616,1612,3228,7,2009-01-19 00:13:12,2009-01-19 00:13:12
12c600c9b5ab8b4266fd45b33024446fc3584b3c...50ad828ec11a53cb7d4a614ee28af8667e9b87b5,1,8,5,13,4,2009-01-20 18:04:18,2009-01-20 18:04:18
337f3ca3cf694a43f085b262a852ffe5802f6ce1...bbb67447989f045df01c05c4e9564d410f0592e4,2,32,0,32,2,2009-01-20 16:38:12,2009-01-20 16:38:12
337f3ca3cf694a43f085b262a852ffe5802f6ce1...fbb8eb10ec7210479b5c9156ac493640ca0fc7d1,3,43,25,68,17,2009-01-20 16:37:15,2009-01-20 16:37:15
c0961eb637c18a1344fbf67a716e660518a397f7...cb90806ce18d7b3793295c633dd346c4395480aa,12,266,193,459,43,2009-01-19 01:31:33,2009-01-19 01:31:33
fb962ebc9cfc81e75eddcbc18b51bfbcb16e4b62...201734cfa742034676c6f3aaf32ae3c00201aae9,8,101,15,116,21,2009-01-20 20:44:40,2009-01-20 20:44:40
201734cfa742034676c6f3aaf32ae3c00201aae9...c777160f0ffb463a76b139c897bbb91c8428eb63,12,150,16,166,21,2009-01-20 21:54:57,2009-01-20 21:54:57
43b39dc755037a97582441efe3385fee52273925...3e7985c5d6f076df8b84e04a396b9dac836cf947,14,70,49,119,46,2009-01-20 19:30:59,2009-01-20 19:30:59
60c4c06bf3d6455aa52d578f71f8aa5b9e16abb9...15b3d3600cb97e3ca94a01bd8705e4057d1c96d3,1,1,0,1,1,2009-01-19 01:37:17,2009-01-19 01:37:17
cea25bf0807c6d44c235ed92d26a74a296ae3c02...da79a09df9dcb292b23430e01fe0cc5cb0c306b4,1,3,0,3,1,2009-01-20 22:21:47,2009-01-20 22:21:47
2af86d3d5eb1ebb0e85e96aede5c04fd492785a4...0f586a5a11e1d5fd8f5b23523736bf095752ec7e,1,12,0,12,2,2009-01-21 15:58:53,2009-01-21 15:58:53
0f586a5a11e1d5fd8f5b23523736bf095752ec7e...bc695f0f7ed69a27b3a50168792a9f97146b670a,1,1,0,1,1,2009-01-21 16:01:45,2009-01-21 16:01:45
bc695f0f7ed69a27b3a50168792a9f97146b670a...e6f024873ddcb8fcc6ca8d34ac269d04bd3f0842,1,5,0,5,2,2009-01-21 16:06:53,2009-01-21 16:06:53
e6f024873ddcb8fcc6ca8d34ac269d04bd3f0842...92368e6f00cbc130d6adb472a34cfbc39e83ccda,1,5,8,13,1,2009-01-21 16:14:35,2009-01-21 16:14:35
92368e6f00cbc130d6adb472a34cfbc39e83ccda...f6e8243d9630a60ca7612285db3a278b4ec1e218,1,4,0,4,1,2009-01-21 16:44:40,2009-01-21 16:44:40
da79a09df9dcb292b23430e01fe0cc5cb0c306b4...a816e54816717683bc81ec7fe5fe8aa46f3d3d67,4,84,5,89,10,2009-01-21 15:36:40,2009-01-21 15:36:40
f6e8243d9630a60ca7612285db3a278b4ec1e218...b97b97c3eb16edaacc02353ecbc71ce81420f11e,3,15,16,31,14,2009-01-21 20:06:13,2009-01-21 20:06:13
f6e8243d9630a60ca7612285db3a278b4ec1e218...6bb5ca74b84ec83f2046fa7b90135448940a222b,2,3,3,6,2,2009-01-21 19:40:15,2009-01-21 19:40:15
2e3589760e186ce6e7d79e6990ae4436172132b6...92d7e087d3d250788a164d54326347c42e798f19,1,15,2,17,2,2009-01-21 20:31:14,2009-01-21 20:31:14
6bb5ca74b84ec83f2046fa7b90135448940a222b...9a36738d0c62e7a6d5950d0495e30f8c41f23e96,2,6,2,8,3,2009-01-21 20:32:58,2009-01-21 20:32:58
9a36738d0c62e7a6d5950d0495e30f8c41f23e96...046e7f9acf00f96c77fc92dc37efc1a5fcd2652a,6,52,1,53,7,2009-01-21 20:50:49,2009-01-21 20:50:49
92d7e087d3d250788a164d54326347c42e798f19...0f9f3648b064641860d40a8b9da01c013bef2d75,4,32,7,39,10,2009-01-21 22:26:16,2009-01-21 22:26:16
273b3f8b38e48999c480fab02b12c600023d4035...ef08378ffed97d0708d4baece5777696455c4387,1,1,0,1,1,2009-01-21 22:51:53,2009-01-21 22:51:53
ef08378ffed97d0708d4baece5777696455c4387...c14ac3ac0e6d9830b902a268b13656d264d28ddc,3,16,13,29,4,2009-01-21 23:58:03,2009-01-21 23:58:03
ef08378ffed97d0708d4baece5777696455c4387...821f43a26853a32f7aacc4068d0bfebfa2881b0e,1,9,0,9,2,2009-01-21 23:48:37,2009-01-21 23:48:37
821f43a26853a32f7aacc4068d0bfebfa2881b0e...6728b807fa91330ded4893480d91f63334a2cf88,1,4,1,5,3,2009-01-21 23:50:32,2009-01-21 23:50:32
7e7fe8c153c09b58d8b652219d71991fc6d332fe...559e0057f00b444043ae0127b50e449c725c2a45,1,16,3,19,7,2009-01-22 14:12:58,2009-01-22 14:12:58
559e0057f00b444043ae0127b50e449c725c2a45...c1b8c2669bad2e0065324d515fbe538f76f0364a,2,15,1,16,3,2009-01-22 21:38:02,2009-01-22 21:38:02
c1b8c2669bad2e0065324d515fbe538f76f0364a...e591c7dcc5330d2165e4f7a7e9e6d5a0194ea4a1,2,34,3,37,6,2009-01-23 15:10:21,2009-01-23 15:10:21
e591c7dcc5330d2165e4f7a7e9e6d5a0194ea4a1...9d3019ba30f1faf42f21bc8f4e77d31a48e32b1c,2,26,0,26,5,2009-01-23 15:11:11,2009-01-23 15:11:11
9d3019ba30f1faf42f21bc8f4e77d31a48e32b1c...2722c2f472ab811e124c45833072e5a2cd48a37c,4,7,7,14,7,2009-01-23 15:15:36,2009-01-23 15:15:36
2722c2f472ab811e124c45833072e5a2cd48a37c...7a567fb59bcfbc737861d860442b6df9afdd1ee0,1,1,1,2,1,2009-01-23 15:16:36,2009-01-23 15:16:36
7a567fb59bcfbc737861d860442b6df9afdd1ee0...a3f927ffedd5a38d22d07c1a445f485298edaed4,9,404,73,477,14,2009-01-23 15:17:29,2009-01-23 15:17:29
559e0057f00b444043ae0127b50e449c725c2a45...1d0fe75a92683796cd8069ba041a11a91b9013d9,1,6,2,8,6,2009-01-22 15:14:03,2009-01-22 15:14:03
1d0fe75a92683796cd8069ba041a11a91b9013d9...64e1027072edd883fe29892b550bb5c7c0a7c265,6,24,8,32,12,2009-01-22 16:15:51,2009-01-22 16:15:51
64e1027072edd883fe29892b550bb5c7c0a7c265...2e6f4fc3dad6c89d302876478ab9ad0340fd2747,1,6,10,16,4,2009-01-22 23:37:41,2009-01-22 23:37:41
29c383ae2016c1c9e453031c9b1e5566c150a557...1944722861f846cdcb949a954f0f6572183d9b1d,1,1,1,2,1,2009-01-23 15:28:07,2009-01-23 15:28:07
1944722861f846cdcb949a954f0f6572183d9b1d...6d409197043f3e90f648fdd80ac8ea4133554b23,1,1,1,2,1,2009-01-23 15:30:15,2009-01-23 15:30:15
6d409197043f3e90f648fdd80ac8ea4133554b23...4fd8be64c83375ee7d0f8d53b878c0a22af9179f,8,115,52,167,15,2009-01-23 16:28:29,2009-01-23 16:28:29
2e6f4fc3dad6c89d302876478ab9ad0340fd2747...39ab3422b011c32b9798a097c88eded5236d96cc,2,5,3,8,3,2009-01-23 16:35:22,2009-01-23 16:35:22
4fd8be64c83375ee7d0f8d53b878c0a22af9179f...7487c762832b12c26504dd9ac05f3b822f38c6a7,1,0,5,5,2,2009-01-23 16:33:26,2009-01-23 16:33:26
7487c762832b12c26504dd9ac05f3b822f38c6a7...4b240b485adaa02e2e206f2a87163fc4bc31924a,1,0,2,2,1,2009-01-23 16:38:26,2009-01-23 16:38:26
4b240b485adaa02e2e206f2a87163fc4bc31924a...0aeff762e7bd0338a33b277f35ee0d5f13b7901f,1,1,2,3,1,2009-01-23 16:52:31,2009-01-23 16:52:31
ed4ce395ad6a61710502ea3f220dc9e8173007cd...3f0a199b79332ac457050d82470383ecdefd69e9,1,1,1,2,2,2009-01-23 19:25:16,2009-01-23 19:25:16
ed4ce395ad6a61710502ea3f220dc9e8173007cd...015ebd1407f22dec035dc26d4a05a774810011e4,1,2,2,4,1,2009-01-23 18:37:41,2009-01-23 18:37:41
015ebd1407f22dec035dc26d4a05a774810011e4...e880817e268709ba159af7b081024d548b636a08,1,0,25,25,1,2009-01-23 19:01:43,2009-01-23 19:01:43
cdeec1f8811594139e3a950309a1dc477b27a278...dc35137964bec1fd4bb49f27e0d5dc22190511ef,1,3,3,6,3,2009-01-23 19:55:23,2009-01-23 19:55:23
dc35137964bec1fd4bb49f27e0d5dc22190511ef...cebc62161ed28be54f1939790d5259dbbd502d53,1,4,4,8,2,2009-01-23 20:15:07,2009-01-23 20:15:07
dc35137964bec1fd4bb49f27e0d5dc22190511ef...8b89b9f7753d18941394b8a08bc45ec2aa916abb,2,7,2,9,3,2009-01-23 20:14:12,2009-01-23 20:14:12
8b89b9f7753d18941394b8a08bc45ec2aa916abb...d87674906308dad63f4b54f8e90d9b2c02d167db,1,31,1,32,3,2009-01-23 20:14:27,2009-01-23 20:14:27
acac27c87a7566fdf08e3efaa20df656254b5a8c...cc62027aee9959a3b0402c0563fe9f8fb856fa51,8,89,34,123,33,2009-01-23 23:24:15,2009-01-23 23:24:15
acac27c87a7566fdf08e3efaa20df656254b5a8c...9ffb858f5a2182314537f226d08508a58489da2d,1,161,22,183,28,2009-01-23 22:49:44,2009-01-23 22:49:44
acac27c87a7566fdf08e3efaa20df656254b5a8c...17a8a84af9731cd9852e89861b25f4a0050bf407,1,1,1,2,1,2009-01-23 20:52:53,2009-01-23 20:52:53
17a8a84af9731cd9852e89861b25f4a0050bf407...fa4ccdb845a438490837353367cd20b262e1f97d,1,1,1,2,1,2009-01-23 21:47:53,2009-01-23 21:47:53
8ba217407665aa982e88671091847dab3518c3e2...5aad452d03586eb9b7d3ed8508f32b6ee581b84a,1,18,9,27,4,2009-01-25 15:01:43,2009-01-25 15:01:43
8ba217407665aa982e88671091847dab3518c3e2...ec434bd7c18aa767e4e43ea141adf79693f3a243,1,21,8,29,5,2009-01-24 21:05:12,2009-01-24 21:05:12
ec434bd7c18aa767e4e43ea141adf79693f3a243...797fda0125bbfe516c41862e911a78dd4f6d7d21,1,29,11,40,14,2009-01-24 21:31:36,2009-01-24 21:31:36
797fda0125bbfe516c41862e911a78dd4f6d7d21...4b534c7de4af04340b5811714f687478bda2d6a9,1,13,1,14,2,2009-01-24 22:35:25,2009-01-24 22:35:25
4b534c7de4af04340b5811714f687478bda2d6a9...84138952eb6aa800854c6143edf2921584f2b842,2,68,29,97,14,2009-01-24 22:36:39,2009-01-24 22:36:39
84138952eb6aa800854c6143edf2921584f2b842...76b6aac917ea8280b5af3a2107a31061666c19eb,5,45,19,64,17,2009-01-25 02:25:55,2009-01-25 02:25:55
9830683828101ce75a7b6a523cc0435cff22ca7c...1cffce1077c594f30ab9df75b53e29385bce1cce,4,10,8,18,8,2009-01-25 17:40:11,2009-01-25 17:40:11
1cffce1077c594f30ab9df75b53e29385bce1cce...6745ae9693746a5ce90b2c4f3d085bdd711fb607,3,3,3,6,3,2009-01-25 21:25:36,2009-01-25 21:25:36
6745ae9693746a5ce90b2c4f3d085bdd711fb607...7aba6a0e0f44f0b423609133b9047bb23fc83ac1,5,46,23,69,23,2009-01-26 00:53:51,2009-01-26 00:53:51
7aba6a0e0f44f0b423609133b9047bb23fc83ac1...55f06f722dcae69ea16beb45a5af6f185625d7e7,2,5,0,5,2,2009-01-26 00:56:44,2009-01-26 00:56:44
55f06f722dcae69ea16beb45a5af6f185625d7e7...5bd2b8bb72702d108e0122fa911e0cde333e016f,1,3,1,4,2,2009-01-26 03:25:01,2009-01-26 03:25:01
5bd2b8bb72702d108e0122fa911e0cde333e016f...f49dba41b6a0c44e1186ae9afba51a0c403b0c90,1,15,0,15,2,2009-01-26 12:29:33,2009-01-26 12:29:33
f49dba41b6a0c44e1186ae9afba51a0c403b0c90...050600e04bad9755138470329c448df046d5a38a,1,0,15,15,2,2009-01-26 12:41:47,2009-01-26 12:41:47
050600e04bad9755138470329c448df046d5a38a...75189ad04aa231b14fac94e82ce47ac3f3b5378f,4,1897,1888,3785,5,2009-01-26 14:33:20,2009-01-26 14:33:20
050600e04bad9755138470329c448df046d5a38a...2955d1d01c78776d966d37bb78578c98fbfa6d83,2,6,0,6,2,2009-01-26 14:18:41,2009-01-26 14:18:41
8276eb75b71e8aeb4a2eeada25757661c2ad7708...0bc6ab4a0d23adfbb1de32c92f8ca71d1bec9e5f,1,2,0,2,1,2009-01-26 14:48:13,2009-01-26 14:48:13
0bc6ab4a0d23adfbb1de32c92f8ca71d1bec9e5f...a84942a4854aec833c8e34b2f6594f07f63f23cc,1,1,0,1,1,2009-01-26 16:44:34,2009-01-26 16:44:34
a84942a4854aec833c8e34b2f6594f07f63f23cc...63aea0a67c9f5c42399841af0bcdea362aaf1e5c,1,5,1,6,3,2009-01-26 20:44:48,2009-01-26 20:44:48
63aea0a67c9f5c42399841af0bcdea362aaf1e5c...92e897a62a6baa0ff25749831fbb94ef563eab41,1,8,5,13,4,2009-01-26 21:29:19,2009-01-26 21:29:19
92e897a62a6baa0ff25749831fbb94ef563eab41...58e403b1a591e3bfac6d61450531301dfe24a8d3,1,56,58,114,46,2009-01-26 22:23:50,2009-01-26 22:23:50
92e897a62a6baa0ff25749831fbb94ef563eab41...c85b113c662b084330dd8d9ca8d15ba96f09f53c,8,192,63,255,41,2009-01-26 22:23:45,2009-01-26 22:23:45
c99370c34e64c0c96508df1e048f663c7b614bfa...01e241ae5fa2068feb11024194f35dd2246fe9ab,1,1,1,2,1,2009-01-26 22:33:37,2009-01-26 22:33:37
c85b113c662b084330dd8d9ca8d15ba96f09f53c...35227776c68f33d70d5d06425a5f9fe9893bc4b9,1,29,0,29,1,2009-01-26 23:33:20,2009-01-26 23:33:20
a23a3ec1ff1fc6e64d7b9562b119d8dff458f9d6...b29806e4a1821c32fc567c4208059cf1bf4a3552,3,55,42,97,11,2009-01-27 02:15:08,2009-01-27 02:15:08
b29806e4a1821c32fc567c4208059cf1bf4a3552...4ffda5ea25020b5b6e18392900ed52e20e7cb6e3,13,2400,3,2403,26,2009-01-27 03:19:15,2009-01-27 03:19:15
4ffda5ea25020b5b6e18392900ed52e20e7cb6e3...2314b0b011cadaf13cbdb4fc8442f3bbd7dccf25,1,1,0,1,1,2009-01-27 03:54:22,2009-01-27 03:54:22
2314b0b011cadaf13cbdb4fc8442f3bbd7dccf25...f235a0f1b1a8ad6fbbce046205d4b78e60bc1df8,1,1,0,1,1,2009-01-27 03:58:43,2009-01-27 03:58:43
f235a0f1b1a8ad6fbbce046205d4b78e60bc1df8...bc38646deb39f5d5af3cd33e34f49b596e837401,46,1323,0,1323,46,2009-01-27 04:28:26,2009-01-27 04:28:26
bc38646deb39f5d5af3cd33e34f49b596e837401...53687d90681a17e0dc1de8db0d8755d9c34d5f06,1,1,1,2,1,2009-01-27 04:30:22,2009-01-27 04:30:22
53687d90681a17e0dc1de8db0d8755d9c34d5f06...6f60d40e6d4ed9a50f3f54552cc2f50eeb71931b,1,8,3,11,3,2009-01-27 04:35:26,2009-01-27 04:35:26
6f60d40e6d4ed9a50f3f54552cc2f50eeb71931b...8ef61c729aead4e125cdf7b8fb6bff7863ea3316,1,1,1,2,1,2009-01-27 13:57:15,2009-01-27 13:57:15
8ef61c729aead4e125cdf7b8fb6bff7863ea3316...511a6d236e4bf244194070fceec7f30c78f11836,2,18,11,29,10,2009-01-27 14:26:15,2009-01-27 14:26:15
511a6d236e4bf244194070fceec7f30c78f11836...f6f9412d001e1e8d5dc50be4dcbc63d5228742c4,1,3,5,8,2,2009-01-27 14:37:33,2009-01-27 14:37:33
f6f9412d001e1e8d5dc50be4dcbc63d5228742c4...76deb4703a96a6010e493ddf6ffe4958dbb96748,1,2,2,4,2,2009-01-27 14:54:20,2009-01-27 14:54:20
f6f9412d001e1e8d5dc50be4dcbc63d5228742c4...d66047eb8d91720954809b6fe9a69d61f45d2ae6,1,4,38,42,11,2009-01-27 14:51:02,2009-01-27 14:51:02
66c21930e1397a3df6451fa05f957e0b840788cb...1fa2f5a2374fb6f252d246677417f87bc7ac1894,2,35,7,42,6,2009-01-27 16:27:34,2009-01-27 16:27:34
1fa2f5a2374fb6f252d246677417f87bc7ac1894...90d1f24c2be02b179cfca1db323ca8225c8bf7ea,1,8,2,10,4,2009-01-27 16:38:41,2009-01-27 16:38:41
1fa2f5a2374fb6f252d246677417f87bc7ac1894...f4ff93369fc53666ad6e2e17386169190fa4613f,1,1,1,2,1,2009-01-27 16:35:11,2009-01-27 16:35:11
b5149886c523ea650d0ff4bcd740e9bd24c430cf...8b42f2ad0aeff24c84a9ff92b209ba501a94871a,1,1,1,2,1,2009-01-27 16:40:29,2009-01-27 16:40:29
8b42f2ad0aeff24c84a9ff92b209ba501a94871a...d969b31abd8ea088667ec4ff790e22806363c5cd,1,1,1,2,1,2009-01-27 16:41:23,2009-01-27 16:41:23
d969b31abd8ea088667ec4ff790e22806363c5cd...103aa3058e5714c7f49cf0481bd52242cc8f11c4,1,3,0,3,2,2009-01-27 17:30:50,2009-01-27 17:30:50
d969b31abd8ea088667ec4ff790e22806363c5cd...6ffc4ecfa74deeefef776c512ea1fc575a6218dd,1,1,1,2,2,2009-01-27 16:52:52,2009-01-27 16:52:52
7a43906136fe515105c6bb53f09ea1c6ae6ba6e9...502a5e6e86d22e381526d910e4744375a788a573,1,1,1,2,1,2009-01-27 18:08:07,2009-01-27 18:08:07
502a5e6e86d22e381526d910e4744375a788a573...df7c7536404ea531b8253541fedb4f51098d7bb1,2,30,0,30,4,2009-01-27 18:08:44,2009-01-27 18:08:44
6ffc4ecfa74deeefef776c512ea1fc575a6218dd...881ca5de94d5cddaa35e951c24dcf73185ad6117,1,29,13,42,7,2009-01-27 18:19:35,2009-01-27 18:19:35
df7c7536404ea531b8253541fedb4f51098d7bb1...83c1dbb1c275f05eff2f611cb47624897c00de3e,7,105,65,170,36,2009-01-27 20:35:28,2009-01-27 20:35:28
2fdd4eb9feb182c2dd69d4fd581c4c8d3c880965...11b98dc426a7e4396580b663ddd498f63540231c,3,19,2,21,5,2009-01-27 18:59:41,2009-01-27 18:59:41
11b98dc426a7e4396580b663ddd498f63540231c...db445449db1a4526891684e42bd5543a3dac3cb0,1,2,0,2,2,2009-01-27 19:01:13,2009-01-27 19:01:13
db445449db1a4526891684e42bd5543a3dac3cb0...5622e758fa9adb8d677f4048db9d170c91ca098f,1,1,0,1,1,2009-01-27 19:06:51,2009-01-27 19:06:51
3bb7761cc6d612cccb1a07a0801803166fa0d13a...91f427d761ee1f993cda8fc9f1f26b356888e97c,1,5,2,7,2,2009-01-27 22:29:03,2009-01-27 22:29:03
5622e758fa9adb8d677f4048db9d170c91ca098f...0c15cfb0cee960fd76a974aafc869aca2a2ea9af,1,12,0,12,1,2009-01-27 19:27:41,2009-01-27 19:27:41
5622e758fa9adb8d677f4048db9d170c91ca098f...66768ae3f7e286b697205bfc1ba8c947bbb1871b,4,165,0,165,4,2009-01-27 19:18:33,2009-01-27 19:18:33
2184a87bd6906a287b68a79d0feaf6fdbaf9a7fe...d4540e157334a8fe09937e04f32b056650fd40ac,1,3,1,4,2,2009-01-27 23:16:37,2009-01-27 23:16:37
d4540e157334a8fe09937e04f32b056650fd40ac...ba0da242618cbbae88c3371c0a35659a3dcb669e,3,89,125,214,13,2009-01-28 02:37:56,2009-01-28 02:37:56
ba0da242618cbbae88c3371c0a35659a3dcb669e...81d41617fd01c2852cd80e583e73dd234e2204aa,1,20,3,23,2,2009-01-28 11:41:31,2009-01-28 11:41:31
81d41617fd01c2852cd80e583e73dd234e2204aa...98874fe4fb32d40de3d394a561913be963588f2e,1,1,1,2,1,2009-01-28 13:14:23,2009-01-28 13:14:23
98874fe4fb32d40de3d394a561913be963588f2e...0222a3cae80b09a324159d2b27eea66b3d67d52a,1,8,0,8,2,2009-01-28 14:13:55,2009-01-28 14:13:55
32d9139936d367a491443b7fec33ca9924dfdbdb...d71cb1d7d2c33430bf57d3ca93e684cb39914435,4,191,124,315,15,2009-01-27 20:16:09,2009-01-27 20:16:09
32d9139936d367a491443b7fec33ca9924dfdbdb...9436315b03885ce6a93d8ca1922ed2be92e3341f,1,78,0,78,1,2009-01-27 19:31:40,2009-01-27 19:31:40
0222a3cae80b09a324159d2b27eea66b3d67d52a...dc53d04ddd221f2538d46dbf47d2980ebcfe39f7,1,16,2,18,5,2009-01-28 16:56:29,2009-01-28 16:56:29
0222a3cae80b09a324159d2b27eea66b3d67d52a...19208c3ae1c319352c83df283f66e5d6d840a558,1,6,0,6,1,2009-01-28 14:58:54,2009-01-28 14:58:54
19208c3ae1c319352c83df283f66e5d6d840a558...d3e776d48b4d9f86fa8d18118a82a43020bc03df,2,47,4,51,9,2009-01-28 15:25:16,2009-01-28 15:25:16
9436315b03885ce6a93d8ca1922ed2be92e3341f...cfb9ffa0ec39a0cb8869ceb90514da2a1adb0f1f,4,9,2,11,7,2009-01-27 21:16:53,2009-01-27 21:16:53
d3e776d48b4d9f86fa8d18118a82a43020bc03df...639c73405cdd45e87a4d59bd3174953b57e2321a,6,34,20,54,17,2009-01-28 20:24:52,2009-01-28 20:24:52
d3e776d48b4d9f86fa8d18118a82a43020bc03df...f02ed9427776a8f435407ccdf3d92424a377ee72,1,10,0,10,1,2009-01-28 16:16:25,2009-01-28 16:16:25
8e0c10cf9342ae509bcaaaf18d3ccf97b7deb122...f3634828db21c5e01cc7d5d0f9e6b0119dfc722d,2,13,8,21,3,2009-01-28 20:34:33,2009-01-28 20:34:33
f02ed9427776a8f435407ccdf3d92424a377ee72...7814aef457da876945c755d3c372e3a9eff14ed2,1,13,0,13,2,2009-01-28 16:53:55,2009-01-28 16:53:55
f3634828db21c5e01cc7d5d0f9e6b0119dfc722d...8c926dd74dbc8e8a47f2b815c550a028013b757f,7,204,4,208,12,2009-01-29 16:46:29,2009-01-29 16:46:29
8c926dd74dbc8e8a47f2b815c550a028013b757f...44ad0f3b20c0233c727d27dbd6d65d900edcada8,3,74,0,74,4,2009-01-29 16:46:45,2009-01-29 16:46:45
44ad0f3b20c0233c727d27dbd6d65d900edcada8...7878de219b4c09eaa157378aca41fbb567144ab9,1,246,0,246,5,2009-01-29 16:47:02,2009-01-29 16:47:02
f3634828db21c5e01cc7d5d0f9e6b0119dfc722d...ca9969293bd44ea734eac183163922bf0be3c61f,6,103,12,115,23,2009-01-28 23:08:02,2009-01-28 23:08:02
f3634828db21c5e01cc7d5d0f9e6b0119dfc722d...dde34ebb779ea7cb7795ca1cf76100fb4f6037c6,1,42,7,49,13,2009-01-28 22:27:12,2009-01-28 22:27:12
dfbacf162d6c87175b4822fd7e4d9d0d335966b7...604bfa82a17b2182d51fdf08968974c72dd599a2,1,2,1,3,1,2009-01-29 16:55:41,2009-01-29 16:55:41
604bfa82a17b2182d51fdf08968974c72dd599a2...9da1dea3fb71035c075efa0d19abc2714aa33c8a,1,1,2,3,2,2009-01-29 16:58:47,2009-01-29 16:58:47
441557b1affce81dced83a2f9dfd6610877a21e8...99d2d6d077543b41a0fc7f91c624f6c0a1bd1d34,1,65,0,65,1,2009-01-29 14:23:58,2009-01-29 14:23:58
dde34ebb779ea7cb7795ca1cf76100fb4f6037c6...85cb837685a266e1bdf24a712816230566b46870,1,1,1,2,1,2009-01-29 02:19:27,2009-01-29 02:19:27
85cb837685a266e1bdf24a712816230566b46870...14e3b3c7140aa4dc135064df700379cfb6ad72f8,2,43,3,46,7,2009-01-29 12:46:43,2009-01-29 12:46:43
dde34ebb779ea7cb7795ca1cf76100fb4f6037c6...1c0424c78dfcd7d8171feaa8a3d49f0e5c9d765b,1,1,1,2,1,2009-01-28 23:04:08,2009-01-28 23:04:08
ef0e276f1a78fd91aaad79f2552a4752987508ab...04e53d2dc0e9d7f475907fa432627409f4c4b93e,1,1,1,2,1,2009-01-29 17:02:32,2009-01-29 17:02:32
b090c3e75d7733fc9b01af1402e82ee348f79a76...e5c2c1b3b613b1253e5538cc1b70034a2f752cdf,1,5,1,6,1,2009-01-29 14:27:45,2009-01-29 14:27:45
1c0424c78dfcd7d8171feaa8a3d49f0e5c9d765b...d5f45b0d52cc621d77620a582ba911311bd047df,1,21,21,42,21,2009-01-29 13:57:02,2009-01-29 13:57:02
d5f45b0d52cc621d77620a582ba911311bd047df...b4fdd9d0e8c504d303c7c3ec22b55c57ef1ac16f,2,31,1,32,5,2009-01-29 14:05:46,2009-01-29 14:05:46
b4fdd9d0e8c504d303c7c3ec22b55c57ef1ac16f...5b68fbcfd271ec3d1379e74907c4c8e864318ac2,1,13,5,18,5,2009-01-29 14:19:51,2009-01-29 14:19:51
04e53d2dc0e9d7f475907fa432627409f4c4b93e...4bd8218f96845951613782f79e073f61ed383f74,2,0,0,0,0,2009-01-29 18:40:51,2009-01-29 18:40:51
04e53d2dc0e9d7f475907fa432627409f4c4b93e...011cd2af7d8aedb56cc6c48807c46b90dd0ce746,1,3,0,3,2,2009-01-29 17:21:58,2009-01-29 17:21:58
011cd2af7d8aedb56cc6c48807c46b90dd0ce746...b4871eea7019e5bca1f5f7fccddfbd12cb344f6d,1,1,0,1,1,2009-01-29 18:00:57,2009-01-29 18:00:57
b4871eea7019e5bca1f5f7fccddfbd12cb344f6d...59fd962a7f91b48642514cb7c56fcf52c1fbaa9a,1,14,1,15,2,2009-01-29 18:01:29,2009-01-29 18:01:29
59fd962a7f91b48642514cb7c56fcf52c1fbaa9a...d4c82212f8fe2a724f717dce00d13ce064ddc46c,4,119,3,122,6,2009-01-29 18:01:45,2009-01-29 18:01:45
584d2d36f286c253c565a47d116e213164129a0e...026bd860c8c7942ad3a1cbca818b67424bfca55f,5,58,0,58,6,2009-01-29 15:30:25,2009-01-29 15:30:25
d4c82212f8fe2a724f717dce00d13ce064ddc46c...5e64eb609a75082e98cba551d2c24912528485a8,1,26,26,52,8,2009-01-29 18:51:42,2009-01-29 18:51:42
c55e976c0d57356bab76ef163b97b585cb3b9d4e...d02aa49e35c94f23c8fac0215f6bad7ff2ff4afd,4,6,7,13,6,2009-01-29 16:56:44,2009-01-29 16:56:44
0bfebe34319c190d072c17d9bb0b07a1ff26e7de...fc4ce49781404735fe4d04575fe91aaeee88b6e9,1,1,2,3,2,2009-01-29 18:53:19,2009-01-29 18:53:19
fc4ce49781404735fe4d04575fe91aaeee88b6e9...bf904dc9ecd28674cd4d90ad9a1c7e239724c4a1,1,18,0,18,1,2009-01-29 18:57:40,2009-01-29 18:57:40
bf904dc9ecd28674cd4d90ad9a1c7e239724c4a1...ee7c4694ecf32f4b1418f164173b7eff9b539169,1,2,2,4,2,2009-01-29 21:31:58,2009-01-29 21:31:58
bf904dc9ecd28674cd4d90ad9a1c7e239724c4a1...4a01d610adee3412673a8326c4fbe5261e85db2b,3,10,4,14,4,2009-01-29 20:58:54,2009-01-29 20:58:54
c00066302a1814d37ba24ba1a283972d50d09f4b...1fe268276ddff6486d3b2fc485c32301de5a6eee,4,5,5,10,6,2009-01-29 22:26:07,2009-01-29 22:26:07
4a01d610adee3412673a8326c4fbe5261e85db2b...8e9938c9c61ca52fdd24ddc6d6caf829516424a8,1,2,2,4,1,2009-01-29 21:55:10,2009-01-29 21:55:10
4a01d610adee3412673a8326c4fbe5261e85db2b...3366714892e48e3843237934401ecd90cdb77d4d,4,32,4,36,10,2009-01-29 21:06:22,2009-01-29 21:06:22
1211514a190a20bf733805f4eb54c5a52c5240d3...a0a79507ea4169f763944460613fc5ba4c0120d4,1,0,1,1,1,2009-01-30 01:41:05,2009-01-30 01:41:05
1211514a190a20bf733805f4eb54c5a52c5240d3...01f5ce5434f06f70ff51c5722d249489f516fb83,2,40,2,42,6,2009-01-29 23:58:47,2009-01-29 23:58:47
4feafa8a50149a865b17a966952ca9b0482aaeea...9406c59f8037773ce3494cf45dfd88f74f83000f,4,218,168,386,5,2009-01-29 22:22:59,2009-01-29 22:22:59
afed8f4eedc40ee427da99f2ed4238fd3ae05569...c18f2e4927d1a091a9a491317f46b804e3b6e62a,3,9,15,24,6,2009-01-30 03:21:33,2009-01-30 03:21:33
c18f2e4927d1a091a9a491317f46b804e3b6e62a...22e5d9e94fc4b562bf456e522ca0b6192b84be0a,4,0,118,118,4,2009-01-30 03:22:04,2009-01-30 03:22:04
22e5d9e94fc4b562bf456e522ca0b6192b84be0a...df2b701b0fbcd0f76619776036a525dfb24c954a,2,62,1,63,3,2009-01-30 03:31:13,2009-01-30 03:31:13
ce975361673845d9591384a43b4efc1a985588da...ea34ff4ba56f44d4352aa1958cd01e124f248c71,2,43,34,77,8,2009-01-30 15:07:07,2009-01-30 15:07:07
9406c59f8037773ce3494cf45dfd88f74f83000f...dcf90d4def6aa68082c1ec95f2699dfbbc8a1d2d,11,112,51,163,50,2009-01-29 23:38:35,2009-01-29 23:38:35
df2b701b0fbcd0f76619776036a525dfb24c954a...d76e24438a58ffa269c4bd8af0a286119d52fe6e,1,3,3,6,3,2009-01-30 03:51:50,2009-01-30 03:51:50
df2b701b0fbcd0f76619776036a525dfb24c954a...23f8b7f7679ca827daac3ed3fffdeb135d695537,1,15,0,15,3,2009-01-30 03:42:12,2009-01-30 03:42:12
a3f1dbb32a83bac6eaf903c6377339454ab6a9d5...ecbb89bfc880cc65ff5cd51692b7233e8b29256a,1,2,1,3,1,2009-01-30 17:00:51,2009-01-30 17:00:51
c349b157877d77cecc4c3d92d356f8d63e382bef...fba31720a86f6cbd94cc328f9a033a3410644fbe,1,2,0,2,1,2009-01-30 14:23:06,2009-01-30 14:23:06
fba31720a86f6cbd94cc328f9a033a3410644fbe...5056bf516fb103a4d56c4eef68cd6e44c0a7efdc,1,16,0,16,1,2009-01-30 14:23:35,2009-01-30 14:23:35
5056bf516fb103a4d56c4eef68cd6e44c0a7efdc...223f315b1b0eb6b8730f053870c992a758b92d17,1,4,0,4,1,2009-01-30 14:46:25,2009-01-30 14:46:25
223f315b1b0eb6b8730f053870c992a758b92d17...33c50a60a34f3d545512db32facba0e70a0ffee9,1,1,1,2,1,2009-01-30 14:47:01,2009-01-30 14:47:01
33c50a60a34f3d545512db32facba0e70a0ffee9...6a70dab62b90b80c58cf4d85efbcff895c47474a,1,7,0,7,1,2009-01-30 15:05:07,2009-01-30 15:05:07
2b4e2fec38202f9064ee498e5d66b3eda5f76971...e5d97f404af44b2e74820ae34d711daa9b49739c,1,26,14,40,6,2009-01-30 18:00:47,2009-01-30 18:00:47
2b4e2fec38202f9064ee498e5d66b3eda5f76971...2d3e9424373fd916bb9f43ac5060c84f34a24c5d,4,28,1,29,4,2009-01-30 17:32:58,2009-01-30 17:32:58
2d3e9424373fd916bb9f43ac5060c84f34a24c5d...1ec09421ed305dbf247fd68f248f69aaf1d1351e,4,45,8,53,7,2009-01-30 17:46:49,2009-01-30 17:46:49
86137c54f2061f0dfaa2465328cc2aaa0924d8b0...d4ac72577d1b2ae928339e85aee6e6d37e6e748a,3,19,3,22,5,2009-01-30 17:37:46,2009-01-30 17:37:46
d4ac72577d1b2ae928339e85aee6e6d37e6e748a...898a1f66c25f934e1ceaa910e0b9e764edeb5b85,2,11,3,14,5,2009-01-30 19:51:31,2009-01-30 19:51:31
898a1f66c25f934e1ceaa910e0b9e764edeb5b85...4b1a2ca99952bdabc152384d6903cd872804bfaf,1,99,0,99,1,2009-01-30 19:51:54,2009-01-30 19:51:54
4b1a2ca99952bdabc152384d6903cd872804bfaf...2ecf386ce66a2fb8ad8583f88e7d2076495f2b0e,1,3,6,9,4,2009-01-30 19:57:01,2009-01-30 19:57:01
2ecf386ce66a2fb8ad8583f88e7d2076495f2b0e...7fa1cf29da60c930771e16654de6b0ae055253f4,1,156,0,156,3,2009-01-30 19:57:17,2009-01-30 19:57:17
6a70dab62b90b80c58cf4d85efbcff895c47474a...fbac7df0bf3ee1b533e5c7f3536e8cb8b8c9e555,1,16,3,19,6,2009-01-30 15:29:07,2009-01-30 15:29:07
1ec09421ed305dbf247fd68f248f69aaf1d1351e...6e4efe880ac5457dc7d252e1d0b31f35e794c336,6,52,29,81,16,2009-01-30 18:13:49,2009-01-30 18:13:49
02e22ec1c206b13025cd2ce7a4cb9797ae0178d5...3613577677268a8c69fe1cf50de99e2ac434d025,1,19,3,22,2,2009-01-30 20:15:48,2009-01-30 20:15:48
78de019b0379ffce76c4d8dd025897f466fed6a6...5ef85d1919ede08100f9a0c8878b5f9b102b5bb3,3,22,1,23,6,2009-01-30 19:18:26,2009-01-30 19:18:26
78de019b0379ffce76c4d8dd025897f466fed6a6...596572dc89b716169715c041a9c9a9fd8c25fd53,2,34,1,35,8,2009-01-30 18:55:22,2009-01-30 18:55:22
596572dc89b716169715c041a9c9a9fd8c25fd53...79672145185b1011e0b4df5ed2b3f8c74be8d992,1,1,1,2,1,2009-01-30 18:56:12,2009-01-30 18:56:12
f94aeeea445de1e2d1acf4cc23a94ccb4956d835...120f8597044a6dec720e7120d208dffb15b64fd2,4,9,8,17,8,2009-01-30 20:06:12,2009-01-30 20:06:12
120f8597044a6dec720e7120d208dffb15b64fd2...a53d5c7c1cebb9081f492b3ebd3d39873477da40,1,65,0,65,4,2009-01-30 20:06:33,2009-01-30 20:06:33
c0c7d99027577c2e85a5128fe8034d016e8b59a6...790ef16736310bc6d5d43644e37b376d0c34447b,3,41,5,46,7,2009-01-30 19:40:19,2009-01-30 19:40:19
790ef16736310bc6d5d43644e37b376d0c34447b...d3aa125d87944940080d9fe8816cd4a289d3e3a0,3,20,12,32,11,2009-01-30 19:49:28,2009-01-30 19:49:28
84dfe85701102b3ade9ad68adb63abd4b835aad7...fcb6834a60aeda616c3d5f341e0aa0e3e8484f19,5,112,24,136,21,2009-01-30 23:18:38,2009-01-30 23:18:38
a53d5c7c1cebb9081f492b3ebd3d39873477da40...e9fc9ce95078cc2d96f87d8b11c94d9898567b35,4,98,2,100,7,2009-01-30 20:58:44,2009-01-30 20:58:44
d3aa125d87944940080d9fe8816cd4a289d3e3a0...643b12e0ce506bdd6d247d143c595cf89380985b,4,38,4,42,10,2009-01-30 20:09:38,2009-01-30 20:09:38
d3aa125d87944940080d9fe8816cd4a289d3e3a0...bc0133da89a0610538b4bc6e1e5a5fb704366495,1,6,0,6,1,2009-01-30 20:05:18,2009-01-30 20:05:18
bc0133da89a0610538b4bc6e1e5a5fb704366495...c3d792be346f89de07437cb8a4c60c6ab7c690cf,2,20,1,21,3,2009-01-30 20:05:28,2009-01-30 20:05:28
4ca681d9fc16cbd44a851d9b14625d480c8a66b1...8fda3788a36888c10f2566b4a3a5eb5477d0121a,1,103,45,148,59,2009-01-30 23:51:09,2009-01-30 23:51:09
4ca681d9fc16cbd44a851d9b14625d480c8a66b1...33cb18a736da4fe2112bb170a69f775e6491c30d,1,12,7,19,6,2009-01-30 23:43:13,2009-01-30 23:43:13
33cb18a736da4fe2112bb170a69f775e6491c30d...d664266681be6e30f643b3e454919c05e079b65b,1,6,6,12,6,2009-01-30 23:44:40,2009-01-30 23:44:40
7a4d0b89cf89dbfb52c6e526e6f99461bbba3d1c...c6acd530d409da11e304e77d2e506b36017256a7,2,7,3,10,4,2009-01-30 21:14:04,2009-01-30 21:14:04
c6acd530d409da11e304e77d2e506b36017256a7...6bb4abc017b8806e351474fe8ae21f1562050a14,2,3,7,10,4,2009-01-30 21:21:30,2009-01-30 21:21:30
6bb4abc017b8806e351474fe8ae21f1562050a14...97aab58d4bfab781cdd7bcefff1daf0316026a46,4,2,98,100,7,2009-01-30 21:21:39,2009-01-30 21:21:39
97aab58d4bfab781cdd7bcefff1daf0316026a46...09bbd0e6c24a789650c02b6dd04f8d0b06d6cac7,1,2,2,4,2,2009-01-30 22:00:05,2009-01-30 22:00:05
9fe4dc3ba14bc2c7c3704379ab37ae00a594bfc2...e09468c51a5a1a06ffb8278af057a606fac0c257,1,13,10,23,3,2009-01-30 20:35:46,2009-01-30 20:35:46
d664266681be6e30f643b3e454919c05e079b65b...387103f95562ea7655bf33c7ddfe83ffd08afdba,1,4,2,6,1,2009-01-31 03:19:12,2009-01-31 03:19:12
09bbd0e6c24a789650c02b6dd04f8d0b06d6cac7...b67533238a3c908ff1760e1a0fe8b6885cedb727,50,6,56,62,55,2009-01-31 22:22:22,2009-01-31 22:22:22
09bbd0e6c24a789650c02b6dd04f8d0b06d6cac7...5eb1e40259cfe9ace594b63a977f6bd96d52f632,1,1,1,2,1,2009-01-30 22:28:01,2009-01-30 22:28:01
5eb1e40259cfe9ace594b63a977f6bd96d52f632...89749798130cbe9be2f7b4133efc8388f16d9cb4,6,66,49,115,19,2009-02-02 14:52:14,2009-02-02 14:52:14
89749798130cbe9be2f7b4133efc8388f16d9cb4...384514998c0b38799e1f40392c8427f3de5eee03,3,64,65,129,25,2009-02-02 14:53:01,2009-02-02 14:53:01
384514998c0b38799e1f40392c8427f3de5eee03...4c8dd6e18fdc53d3c509a64d5c4909bb8b224437,1,5,1,6,2,2009-02-02 14:53:14,2009-02-02 14:53:14
4c8dd6e18fdc53d3c509a64d5c4909bb8b224437...7b75df44c5229c85546d610327195e61bde37fa1,1,42,0,42,1,2009-02-02 14:54:00,2009-02-02 14:54:00
7b75df44c5229c85546d610327195e61bde37fa1...9047444610050d5ba1a588e21f2933c1922e7fa8,1,208,0,208,8,2009-02-02 14:54:13,2009-02-02 14:54:13
d1dda486efc7a4f909c477b0dab27c8468a78024...9e9eb0cec78ebf31ccaf5fd077ff68bf77d4a622,10,103,52,155,52,2009-01-31 22:27:25,2009-01-31 22:27:25
d1dda486efc7a4f909c477b0dab27c8468a78024...855890b0a733aa8509cc8c543a248a27d740af42,1,1,1,2,1,2009-01-31 22:07:14,2009-01-31 22:07:14
d1dda486efc7a4f909c477b0dab27c8468a78024...51ae7207985b70bae2afddbd02012d76871d0041,1,2,2,4,2,2009-01-31 21:39:45,2009-01-31 21:39:45
51ae7207985b70bae2afddbd02012d76871d0041...c4e874bed77f3f9100a2b32e5199996d35fe258c,1,3,0,3,1,2009-01-31 21:46:47,2009-01-31 21:46:47
c684aab51f823b1c2b0ecff4981d9201a7a1176d...bf700c804013c7df06e7c8f2d79d604e6e209cf6,4,46,20,66,14,2009-02-02 16:15:24,2009-02-02 16:15:24
bf700c804013c7df06e7c8f2d79d604e6e209cf6...e6fd26110019e559b8f5ce4b80f54b68a27d6303,1,2,1,3,1,2009-02-02 16:16:30,2009-02-02 16:16:30
e6fd26110019e559b8f5ce4b80f54b68a27d6303...d27cf8b8b374cabec586d282c9929737d2e714db,1,34,0,34,1,2009-02-02 16:17:18,2009-02-02 16:17:18
d27cf8b8b374cabec586d282c9929737d2e714db...5757e2aeb040c08097d3586f993383904da9afd3,1,123,543,666,12,2009-02-02 16:19:27,2009-02-02 16:19:27
5757e2aeb040c08097d3586f993383904da9afd3...720527c105f26f495f902ec32ff504d81a3b6399,1,3,3,6,2,2009-02-02 16:26:57,2009-02-02 16:26:57
4949ec5d2b8743738b53a6774f01c71b3647fd64...c3d40664c62967db4f868c80837e7c0d4b4682d2,1,1,1,2,1,2009-02-01 14:06:40,2009-02-01 14:06:40
c3d40664c62967db4f868c80837e7c0d4b4682d2...7cea2101dec59a481c5e5bc98c2aa515c336bf80,1,23,12,35,7,2009-02-01 14:06:49,2009-02-01 14:06:49
4949ec5d2b8743738b53a6774f01c71b3647fd64...b8447bfcad2841e2d73e08960fd5606f6fe24eb8,5,45,9,54,8,2009-02-01 00:09:46,2009-02-01 00:09:46
4949ec5d2b8743738b53a6774f01c71b3647fd64...a85951a5355af5f70866596ed043133cb1e5b3cc,4,29,16,45,13,2009-01-31 23:06:10,2009-01-31 23:06:10
720527c105f26f495f902ec32ff504d81a3b6399...030c280fec258e6251990b0abe6e786e31854663,1,1,1,2,1,2009-02-02 16:46:30,2009-02-02 16:46:30
720527c105f26f495f902ec32ff504d81a3b6399...7ef418ddf86f984cc4baf124a05ff1c4f6a682ac,1,1,0,1,1,2009-02-02 16:44:56,2009-02-02 16:44:56
29c37d8713c94ccd7687e620849b63cf0be7b2cc...ae35a81525e32f73e4496c1a2f4fd6e1fd4a70cd,1,0,5,5,1,2009-02-01 20:35:55,2009-02-01 20:35:55
ae35a81525e32f73e4496c1a2f4fd6e1fd4a70cd...f4bbbd253d356be3b7aa722f4168ab455d5cc852,1,2,3,5,1,2009-02-01 20:38:02,2009-02-01 20:38:02
de76420f5a49c5efd1325b003a86ecdc71a657cf...bf147471c274861d0d5ae0d48e907686e470999d,2,10,9,19,9,2009-02-01 02:25:40,2009-02-01 02:25:40
bf147471c274861d0d5ae0d48e907686e470999d...394405a3395a1b1896b1cd6545e65accd765e0c0,1,5,0,5,2,2009-02-01 05:11:34,2009-02-01 05:11:34
ce75d6fd879c2b1711d9cea00f67176ac4f34f36...99ad2eac7686e4ac5dc91fdf3e190694086ccf51,2,10,11,21,5,2009-02-02 21:18:44,2009-02-02 21:18:44
ce75d6fd879c2b1711d9cea00f67176ac4f34f36...d83e46829f0ee0f8f85772312d62baac6b12502d,1,2,0,2,1,2009-02-02 17:16:29,2009-02-02 17:16:29
d83e46829f0ee0f8f85772312d62baac6b12502d...7d8e3c7296367e552213bc575081eec91115e619,1,2,0,2,1,2009-02-02 17:16:59,2009-02-02 17:16:59
7d8e3c7296367e552213bc575081eec91115e619...7442bdf4e414c2e43b4391cf48752c43187acbac,3,114,0,114,4,2009-02-02 17:17:20,2009-02-02 17:17:20
172223db06d132523a27b845cd39576742b231c7...f11aee1bbc317b1d582ec9357a0b280a7426159c,1,21,4,25,5,2009-02-01 22:51:00,2009-02-01 22:51:00
f11aee1bbc317b1d582ec9357a0b280a7426159c...834be43b5d0fb447038c9d7ffe105916832af8bb,1,3,1,4,2,2009-02-01 23:26:18,2009-02-01 23:26:18
834be43b5d0fb447038c9d7ffe105916832af8bb...12c28b40c1f067091091452a1933d0632a54b762,1,13,2,15,2,2009-02-01 23:27:04,2009-02-01 23:27:04
12c28b40c1f067091091452a1933d0632a54b762...22b2a6b07714fb5d09ae4465fba0f0ddae7bc1c6,1,9,4,13,4,2009-02-01 23:38:33,2009-02-01 23:38:33
22b2a6b07714fb5d09ae4465fba0f0ddae7bc1c6...5d0a8c18b4b9f3b12ab231c70f080dc90fab9b7f,1,11,10,21,7,2009-02-01 23:41:25,2009-02-01 23:41:25
5d0a8c18b4b9f3b12ab231c70f080dc90fab9b7f...90878cd7c1ddccfd759d2a84fefa77dc3a5f7018,2,8,7,15,4,2009-02-02 00:11:45,2009-02-02 00:11:45
90878cd7c1ddccfd759d2a84fefa77dc3a5f7018...5c50c59ab942004d1cc6fceba125112297fbd92f,1,5,0,5,1,2009-02-02 00:13:12,2009-02-02 00:13:12
5c50c59ab942004d1cc6fceba125112297fbd92f...7cf0e208241e336c56ee212542f7151b18b12d26,1,5,9,14,5,2009-02-02 00:49:02,2009-02-02 00:49:02
7cf0e208241e336c56ee212542f7151b18b12d26...f248e745f0fbd29d5925485aeee7a36d72923554,1,8,5,13,3,2009-02-02 03:11:26,2009-02-02 03:11:26
f248e745f0fbd29d5925485aeee7a36d72923554...9bcacf16c03bde350933962e0739dcd81a714802,15,38,31,69,34,2009-02-02 03:21:32,2009-02-02 03:21:32
9bcacf16c03bde350933962e0739dcd81a714802...c8acc4ac0a0d6dba77435768fbc61cc40f55e8c9,1,1,1,2,1,2009-02-02 03:26:26,2009-02-02 03:26:26
394405a3395a1b1896b1cd6545e65accd765e0c0...5e5765f9b4c8f9dd4700946e4ef52be21fa298dd,7,148,10,158,13,2009-02-01 19:53:54,2009-02-01 19:53:54
394405a3395a1b1896b1cd6545e65accd765e0c0...9dc2d9aed84f48450742e37edea184d00cb3ee93,1,1,1,2,1,2009-02-01 13:40:01,2009-02-01 13:40:01
7442bdf4e414c2e43b4391cf48752c43187acbac...c905877e40dedb0f6fd6c51d63d306444326b7bb,1,14,1,15,3,2009-02-02 22:12:42,2009-02-02 22:12:42
c905877e40dedb0f6fd6c51d63d306444326b7bb...36ba844fe6a7b56c47f0d27be6096cbd8a1dc777,2,3,3,6,3,2009-02-02 22:12:56,2009-02-02 22:12:56
c8acc4ac0a0d6dba77435768fbc61cc40f55e8c9...d1ba9dfb497031952f774c7972fdeea4d2992189,17,1263,1008,2271,206,2009-02-02 23:18:22,2009-02-02 23:18:22
c8acc4ac0a0d6dba77435768fbc61cc40f55e8c9...ff7573c65af86445e64eea657baeed6720e4d238,1,10,0,10,3,2009-02-02 14:28:43,2009-02-02 14:28:43
ff7573c65af86445e64eea657baeed6720e4d238...165a4618aebf123395db5f93ce9d5e1df5c4bcda,2,35,8,43,6,2009-02-02 14:36:01,2009-02-02 14:36:01
165a4618aebf123395db5f93ce9d5e1df5c4bcda...940fb66363146ba746ee2056d2addbb6273f03a1,1,2,2,4,2,2009-02-02 14:40:43,2009-02-02 14:40:43
940fb66363146ba746ee2056d2addbb6273f03a1...ffe0da1e00aeafbdb9dd35f3637b285dfa424807,1,1,1,2,1,2009-02-02 14:54:11,2009-02-02 14:54:11
c42f51576144159ffb1dac587f4340c01ddccaec...134cd0506c24959003a8b592df4beb58c3f40f00,1,64,49,113,19,2009-02-01 22:39:07,2009-02-01 22:39:07
04430b44cc2d71ad12250b63a7e904c6716d5bf7...3bba95ecee83f5edaf0b3e1f16ed1e533517ddf6,2,4,1,5,4,2009-02-02 22:13:38,2009-02-02 22:13:38
3bba95ecee83f5edaf0b3e1f16ed1e533517ddf6...288d83370d59ed8fade6d7c641ed07c038608a9c,3,370,0,370,3,2009-02-02 22:19:55,2009-02-02 22:19:55
288d83370d59ed8fade6d7c641ed07c038608a9c...84a10094d0317fce4572e2aa1adb219c7a621a70,1,3,1,4,1,2009-02-02 22:54:03,2009-02-02 22:54:03
86fa7463e92b290280f21e834b088edc303fa690...c6e4f305909c18ff2efca138c070e501d89c9cc9,1,2,2,4,2,2009-02-03 02:39:54,2009-02-03 02:39:54
c6e4f305909c18ff2efca138c070e501d89c9cc9...e20f07a46eeae8d2769604bb2bec09d8e7ddfb4e,2,9,0,9,2,2009-02-03 03:16:39,2009-02-03 03:16:39
e20f07a46eeae8d2769604bb2bec09d8e7ddfb4e...8098043bb8975db1e41a50f9d4a51014eb2d7b87,3,36,11,47,9,2009-02-03 03:16:46,2009-02-03 03:16:46
8098043bb8975db1e41a50f9d4a51014eb2d7b87...5398a8bce6517b8a7ca4ad013df3f84fd1e81082,1,5,1,6,1,2009-02-03 09:31:38,2009-02-03 09:31:38
5398a8bce6517b8a7ca4ad013df3f84fd1e81082...9f368285f654d71e700ed03e4f886cf089e6cb16,1,1,1,2,1,2009-02-03 12:06:43,2009-02-03 12:06:43
8098043bb8975db1e41a50f9d4a51014eb2d7b87...b8c8de3f25306a2a84e9a303bef75b5894cea09e,4,11,7,18,7,2009-02-03 04:42:34,2009-02-03 04:42:34
b8c8de3f25306a2a84e9a303bef75b5894cea09e...51bf919b12de97e6b4f25c52b98737546227d38e,2,1,6,7,2,2009-02-03 04:47:14,2009-02-03 04:47:14
51bf919b12de97e6b4f25c52b98737546227d38e...7b1d71bf25dc7ed38ef36bebe718c35a20ad9884,4,15,9,24,9,2009-02-03 05:05:49,2009-02-03 05:05:49
7b1d71bf25dc7ed38ef36bebe718c35a20ad9884...1a695024db1e1031dda56692876fbb86865c895a,1,9,1,10,1,2009-02-03 05:13:42,2009-02-03 05:13:42
1a695024db1e1031dda56692876fbb86865c895a...bca407086918fc7dfc0e456704c5c374fd84b600,1,44,0,44,1,2009-02-03 05:14:14,2009-02-03 05:14:14
9f368285f654d71e700ed03e4f886cf089e6cb16...dc0093fbaaaff3380357c55f7028033b73478b7c,1,4,0,4,2,2009-02-03 15:25:27,2009-02-03 15:25:27
9f368285f654d71e700ed03e4f886cf089e6cb16...687c1f237eda732e75fd49c2f5ab4ff82b14f325,1,4,26,30,4,2009-02-03 15:12:01,2009-02-03 15:12:01
687c1f237eda732e75fd49c2f5ab4ff82b14f325...8e5a1a3edfdde53b495455c0192de111436fcb24,2,5,1,6,3,2009-02-03 16:04:54,2009-02-03 16:04:54
8e5a1a3edfdde53b495455c0192de111436fcb24...d0f2dd9169aabfd4faa062becddf70e6eea93c73,1,4,3,7,4,2009-02-03 16:05:16,2009-02-03 16:05:16
cce337de6172dfc06185a79a74f3e87cb97eaf13...7f1dd750860441dfe0122304c539f971e1d60223,3,15,9,24,6,2009-02-03 15:37:06,2009-02-03 15:37:06
a5a16917163a3a1d89a10b2595b2ac3de928cf82...f7294fdddf95a152d905006ad3ab59fb7932d12b,2,6,1,7,4,2009-02-03 17:02:22,2009-02-03 17:02:22
7f1dd750860441dfe0122304c539f971e1d60223...c68bc1589b2e55c5546864f9d344adfd98b056f7,2,9,5,14,4,2009-02-03 16:50:30,2009-02-03 16:50:30
bae0ed9100cfcd21577907802783d7f6e27378b4...0e2df92fbc456b9edcfd9851af3ee0b48e5b44a4,2,12,12,24,7,2009-02-03 16:54:51,2009-02-03 16:54:51
17ec3b562a83c4321786c16bedea81c6dd09cd9e...8f373bf1d47c4f0e3ba005e9c38a4383bfc176dc,5,19,13,32,11,2009-02-03 19:22:48,2009-02-03 19:22:48
8f373bf1d47c4f0e3ba005e9c38a4383bfc176dc...fac2ee626fa9a0e766716ed9200c8132115ede96,4,8,5,13,4,2009-02-03 19:42:53,2009-02-03 19:42:53
fac2ee626fa9a0e766716ed9200c8132115ede96...6d48156c2393e191a5a99cecd983bef774f5db3d,2,6,1,7,3,2009-02-03 21:48:12,2009-02-03 21:48:12
0e2df92fbc456b9edcfd9851af3ee0b48e5b44a4...ec93b8d7d0697db369e2db2d76aa78fa84d51407,1,3,1,4,1,2009-02-03 17:07:53,2009-02-03 17:07:53
341c3e49e2f1d56bf9a0710b626c34e0ef7275f6...57dac9f774f668742bf289c84ce9548cfe627065,1,4,1,5,1,2009-02-03 22:19:00,2009-02-03 22:19:00
ec93b8d7d0697db369e2db2d76aa78fa84d51407...f4d6c7fec1d0b0e0688d07ac384b31fe2a1ed2c6,2,1,16,17,4,2009-02-03 18:19:45,2009-02-03 18:19:45
f4d6c7fec1d0b0e0688d07ac384b31fe2a1ed2c6...b47b8b68292e5b5d6cc74bba4e9f7fb9892b979d,1,14,2,16,3,2009-02-03 18:27:46,2009-02-03 18:27:46
ec93b8d7d0697db369e2db2d76aa78fa84d51407...6097055ca5bf619c18f7306fe40159ed5d444428,3,9,8,17,8,2009-02-03 18:15:54,2009-02-03 18:15:54
57dac9f774f668742bf289c84ce9548cfe627065...8d4c4436dc13bc05be148207b1f979a04e15515f,1,12,4,16,3,2009-02-03 23:08:38,2009-02-03 23:08:38
57dac9f774f668742bf289c84ce9548cfe627065...aca3431dbf4830c4164ca5e9e01819ecf174671a,6,16,12,28,15,2009-02-03 22:39:44,2009-02-03 22:39:44
6097055ca5bf619c18f7306fe40159ed5d444428...3aa74384aef02f5652c815b1414a1bd143415121,14,14,14,28,13,2009-02-03 18:30:28,2009-02-03 18:30:28
695439cd0bdcebaed1299003bab749e9b1cd046e...e45d0f3cc9e82356e8c312b0911afc3238a8e9d9,1,6,6,12,6,2009-02-04 14:17:15,2009-02-04 14:17:15
aca3431dbf4830c4164ca5e9e01819ecf174671a...c17fcf847ca4377d8e8b423ff60cc518bce1b302,1,9,9,18,7,2009-02-03 23:24:55,2009-02-03 23:24:55
b4976fcb194d2ba5cbea9b5959ea448eea374607...48cfea2b1afd3fcc2ec5d0f423c9d952bae1f71c,5,59,19,78,23,2009-02-04 00:13:27,2009-02-04 00:13:27
48cfea2b1afd3fcc2ec5d0f423c9d952bae1f71c...cf4e99b9ee306355e4687cc563ab2248273f7b75,6,155,37,192,27,2009-02-04 03:34:51,2009-02-04 03:34:51
cf4e99b9ee306355e4687cc563ab2248273f7b75...d9fe088ac9725c4d15bb74d531e3268c4fdcd7d1,1,2,9,11,4,2009-02-04 15:58:55,2009-02-04 15:58:55
b4976fcb194d2ba5cbea9b5959ea448eea374607...6897624bc598e56187cab52abc1174f54cc139a5,7,109,91,200,45,2009-02-03 22:10:44,2009-02-03 22:10:44
50a795edcfff27a0e1d97e0271f0a33ebf283987...474529b74d6438ecc87d3e7bf7e4c08cf3ec0c0a,1,12,8,20,3,2009-02-04 14:21:39,2009-02-04 14:21:39
474529b74d6438ecc87d3e7bf7e4c08cf3ec0c0a...08f398a53291358eb5b51de5963267f3d694b2e0,1,5,4,9,3,2009-02-04 14:41:52,2009-02-04 14:41:52
f54e9bef2a824337be5f525bcc4c3d914f45687c...60fb155c50daaf06319e4d9541fc9585f37e621c,1,10,9,19,11,2009-02-03 23:28:21,2009-02-03 23:28:21
57dc491b4b6447e24e41d60f75516e4b443d2363...83915a68783c30d7054ece53f8b67340da01278a,2,15,8,23,2,2009-02-04 18:09:00,2009-02-04 18:09:00
08f398a53291358eb5b51de5963267f3d694b2e0...0f724cd5fd9af6473bd4c6777dfb5302f404e3bc,5,23,14,37,14,2009-02-04 15:47:36,2009-02-04 15:47:36
08f398a53291358eb5b51de5963267f3d694b2e0...aa8d5928992e8653b0250611c14cc487a0bea778,1,4,6,10,2,2009-02-04 14:49:57,2009-02-04 14:49:57
60fb155c50daaf06319e4d9541fc9585f37e621c...92a8365c7d4c7b8af65b3d7fb7a6b1427df26215,1,0,1,1,1,2009-02-04 14:48:23,2009-02-04 14:48:23
60fb155c50daaf06319e4d9541fc9585f37e621c...eb4b70d16e2c3a679de3036260c02ae17483a7b1,1,2,1,3,1,2009-02-04 02:00:05,2009-02-04 02:00:05
eb4b70d16e2c3a679de3036260c02ae17483a7b1...1156b79bf9a2c7fd2d000b04c4fa789e3155cdb5,5,4,4,8,4,2009-02-04 02:45:27,2009-02-04 02:45:27
dce936422bb1a17c0198d7c9977559e861d0327e...0b3d1f1a152e09465e69f57fc959d9fa13fe779e,1,1,1,2,1,2009-02-04 18:18:33,2009-02-04 18:18:33
8fb04792e0e3857441a1b75a38a4ed85a0a02274...88daf0c1c83ed4ffa249deeb52b411d7997f9f4c,1,2,2,4,1,2009-02-04 16:18:29,2009-02-04 16:18:29
aa8d5928992e8653b0250611c14cc487a0bea778...2c3e7fd11f451517854e4266e57f3ae7da7dfbed,1,2,0,2,1,2009-02-04 15:55:22,2009-02-04 15:55:22
f570edca68b342e389e154dd7efd2f68001da8eb...c01b4a773a45d7b7562db2334218cd64944b7396,4,38,8,46,17,2009-02-04 16:26:51,2009-02-04 16:26:51
d6cfa79e01a49f8c0ada8fa8f11ec640374ee2ee...e2e9efa98a7aa107713b05c71a4d324da7a60282,1,19,4,23,3,2009-02-04 18:43:54,2009-02-04 18:43:54
e2e9efa98a7aa107713b05c71a4d324da7a60282...1290733ed9428de5b707b4f5607222c6ba0b04c3,3,12,0,12,9,2009-02-04 18:53:08,2009-02-04 18:53:08
1290733ed9428de5b707b4f5607222c6ba0b04c3...e0030050ee8dd97a67ef5c23c72918c3900353cd,1,20,4,24,4,2009-02-04 19:46:17,2009-02-04 19:46:17
e0030050ee8dd97a67ef5c23c72918c3900353cd...4dc5d0b907a0b644615f12cc846cdefc3d026c45,4,4,4,8,4,2009-02-04 19:49:24,2009-02-04 19:49:24
4dc5d0b907a0b644615f12cc846cdefc3d026c45...c6aa27afd577d599453947615375952922026623,1,5,2,7,3,2009-02-04 20:00:31,2009-02-04 20:00:31
c6aa27afd577d599453947615375952922026623...62ec296ec21a6d184344ca4c65524a02dc900a41,1,1,1,2,1,2009-02-04 20:07:32,2009-02-04 20:07:32
57af77dccf1399524876d3f6e98fb838255534c7...5dd84d06387a16a0ec0bcb66478b3eeea6e03dd9,9,54,34,88,35,2009-02-04 18:22:02,2009-02-04 18:22:02
27de408d95a24e7bfd4548322ebb15e88669e0c4...74b38f22923d725634a2168259eb58b7c0318b80,1,2,1,3,2,2009-02-04 16:12:21,2009-02-04 16:12:21
62ec296ec21a6d184344ca4c65524a02dc900a41...48d90936437bad9c14f8f8bf1bdc92de6af557c5,2,158,171,329,30,2009-02-04 21:15:22,2009-02-04 21:15:22
62ec296ec21a6d184344ca4c65524a02dc900a41...a188aa9c04dba3ce1764187dc3de375633dcea03,1,11,1,12,2,2009-02-04 20:08:55,2009-02-04 20:08:55
218987d617053386eebff97d00efd6e05d74d20d...875d81cdd1559cf4ea50be051a1af15a4977305c,1,1,1,2,1,2009-02-04 22:10:48,2009-02-04 22:10:48
875d81cdd1559cf4ea50be051a1af15a4977305c...5cb34b0b80f5a4ab64f1f346f7712403fd81b6de,5,32,19,51,15,2009-02-04 22:24:15,2009-02-04 22:24:15
5cb34b0b80f5a4ab64f1f346f7712403fd81b6de...082cd621d3e5606b8e1d2562174f39e6c7d1e89d,3,19,1,20,4,2009-02-04 23:33:59,2009-02-04 23:33:59
082cd621d3e5606b8e1d2562174f39e6c7d1e89d...a7a8433fae4b7a60c543357fefabc17ec20d1378,2,8,0,8,3,2009-02-04 23:43:03,2009-02-04 23:43:03
a7a8433fae4b7a60c543357fefabc17ec20d1378...04c18a8576079fe93be1374af315f701b17cc175,1,1,1,2,1,2009-02-05 01:08:43,2009-02-05 01:08:43
04c18a8576079fe93be1374af315f701b17cc175...9b7f4d830d90459b918e78e9ca9e58c33b4919f0,2,34,5,39,7,2009-02-05 15:10:53,2009-02-05 15:10:53
9b7f4d830d90459b918e78e9ca9e58c33b4919f0...50538e88c3f2ff00c22c2dbf6b4129826b0b69c5,1,62,0,62,2,2009-02-05 20:41:34,2009-02-05 20:41:34
9b7f4d830d90459b918e78e9ca9e58c33b4919f0...6b88cdc56ccccf207437d67bb65e8db5946aea69,4,142,35,177,12,2009-02-05 16:51:51,2009-02-05 16:51:51
9b7f4d830d90459b918e78e9ca9e58c33b4919f0...1dc3449c02726f1884565324e8fb8a4c9d9b4dcc,3,27,14,41,19,2009-02-05 16:50:27,2009-02-05 16:50:27
db083196d6523bca6f80ac484286d3abcdeea304...0c2e6bc6e9feea754e624f52732d89f88cf87b5d,2,65,1,66,3,2009-02-05 21:05:06,2009-02-05 21:05:06
0c2e6bc6e9feea754e624f52732d89f88cf87b5d...75712322a1efbdfdf873e4a4bb26ac1111b04899,4,12,4,16,5,2009-02-05 21:17:46,2009-02-05 21:17:46
7f07a5a71e8baf5aad4ff01167ead12916fa329c...f6dfa61f25e19c56f77d3416a34468db08bd629b,3,14,3,17,5,2009-02-05 18:03:26,2009-02-05 18:03:26
7f07a5a71e8baf5aad4ff01167ead12916fa329c...5a35a0f71df7bafd82e1ca305d8520069fe4efc9,1,6,2,8,3,2009-02-05 17:28:51,2009-02-05 17:28:51
5a35a0f71df7bafd82e1ca305d8520069fe4efc9...288f208e83e701dd74e88479f882cc15345faa17,1,6,4,10,5,2009-02-05 17:42:35,2009-02-05 17:42:35
75712322a1efbdfdf873e4a4bb26ac1111b04899...94f125e8552d580b4f3038153b52f3e2ec1025d0,13,188,135,323,39,2009-02-06 18:29:57,2009-02-06 18:29:57
94f125e8552d580b4f3038153b52f3e2ec1025d0...52eb04828c79bccccb9dcf7cc76d2b61635a02b3,1,139,0,139,1,2009-02-06 18:30:19,2009-02-06 18:30:19
6e6f8c49bdc39740e27619904959e6ffa76042b4...422efe3aeaf6a43bbe2ec90f99cc88180474f1b2,1,1,1,2,1,2009-02-05 18:07:31,2009-02-05 18:07:31
9e237c3871d56f14d6b302d1205bb9b8a9eaa834...3afb4cbb8c845b92c86befa8c95e341294bf8dfe,2,18,14,32,13,2009-02-06 19:06:38,2009-02-06 19:06:38
cdeb2165cec16626f0879460cc42ece6c4c672d6...c9496a4ec5abf1a830e9d4762b06b02f77e0f30f,1,1,4,5,1,2009-02-06 03:14:35,2009-02-06 03:14:35
c9496a4ec5abf1a830e9d4762b06b02f77e0f30f...839e0cb2f1ab45303a51475a41a1d67a8c0a2400,1,0,2,2,1,2009-02-06 03:15:02,2009-02-06 03:15:02
839e0cb2f1ab45303a51475a41a1d67a8c0a2400...2e6ce5ef12d61b65406fb5260720f74e1406acf3,1,2,0,2,1,2009-02-06 03:25:52,2009-02-06 03:25:52
2e6ce5ef12d61b65406fb5260720f74e1406acf3...be3cb87ba37db68fef6e1940aa5261d706ebcbe9,2,6,1,7,2,2009-02-06 03:43:52,2009-02-06 03:43:52
be3cb87ba37db68fef6e1940aa5261d706ebcbe9...3706946ff55e47b332f71a380202dce3a8932f5e,1,1,1,2,1,2009-02-06 03:59:31,2009-02-06 03:59:31
422efe3aeaf6a43bbe2ec90f99cc88180474f1b2...21fc86c4575fa6017cb40d788d175ba80f92ab03,4,78,54,132,39,2009-02-05 21:45:58,2009-02-05 21:45:58
422efe3aeaf6a43bbe2ec90f99cc88180474f1b2...fa450b1423dad3ca492d2ac1b1e0eabd44a5df6c,2,81,45,126,7,2009-02-05 19:11:40,2009-02-05 19:11:40
9bf2bf30259de17bf897457bcc7b04dfc22f76ea...b2f203cba2fe822b7517c33c62df5a211c8c0569,3,8,3,11,5,2009-02-06 19:25:06,2009-02-06 19:25:06
3706946ff55e47b332f71a380202dce3a8932f5e...6e66009dc09384ffacab9f0b886dd3866fbed3d5,1,4,0,4,1,2009-02-06 17:44:50,2009-02-06 17:44:50
6e66009dc09384ffacab9f0b886dd3866fbed3d5...cf8e9b31b4609599a25b49649b91527dc0409ca2,5,46,21,67,20,2009-02-06 17:45:05,2009-02-06 17:45:05
cf8e9b31b4609599a25b49649b91527dc0409ca2...3792032a1de07a4930783962d2a07a24fc2112bd,1,2,2,4,2,2009-02-06 18:26:12,2009-02-06 18:26:12
3792032a1de07a4930783962d2a07a24fc2112bd...abf7cc678d081eb0fab1cec31a6f7c6dcafaac39,3,5,6,11,6,2009-02-06 18:26:29,2009-02-06 18:26:29
abf7cc678d081eb0fab1cec31a6f7c6dcafaac39...e62fefd18cbe7a76e2e0a54ac2067e7ff8b2a79a,1,4,0,4,1,2009-02-06 18:49:33,2009-02-06 18:49:33
e62fefd18cbe7a76e2e0a54ac2067e7ff8b2a79a...f7df5b28de839576a4a2b993f47d5f63c6361bc6,3,38,4,42,6,2009-02-06 19:26:56,2009-02-06 19:26:56
3706946ff55e47b332f71a380202dce3a8932f5e...c9bc5b0baa195154c6d4e4eba9dbcf16e0bc4bab,1,24,19,43,12,2009-02-06 15:48:39,2009-02-06 15:48:39
c9bc5b0baa195154c6d4e4eba9dbcf16e0bc4bab...d2801728edf7ddc045075c3a5c3abcac3decab3a,2,4,3,7,4,2009-02-06 17:31:24,2009-02-06 17:31:24
b2f203cba2fe822b7517c33c62df5a211c8c0569...f06e57b98867aa9586843b5eeffb411e06c066e0,1,8,0,8,1,2009-02-06 19:47:38,2009-02-06 19:47:38
b2f203cba2fe822b7517c33c62df5a211c8c0569...0b210bfa0e3864c72f3cd280d57893c444401469,3,7,2,9,6,2009-02-06 19:33:26,2009-02-06 19:33:26
d2801728edf7ddc045075c3a5c3abcac3decab3a...93ae19c91f8adbf756526c5f6f1462f01bed5551,1,0,2,2,1,2009-02-06 18:51:42,2009-02-06 18:51:42
93ae19c91f8adbf756526c5f6f1462f01bed5551...c06e0dacf706d3820c4286cc369598db398e731e,1,2,1,3,1,2009-02-06 19:10:53,2009-02-06 19:10:53
c06e0dacf706d3820c4286cc369598db398e731e...ee9960b5824097e8590102b08cc3f17b20a12ca7,1,2,0,2,1,2009-02-06 19:11:02,2009-02-06 19:11:02
ee9960b5824097e8590102b08cc3f17b20a12ca7...06c3ca96e7a86251e4650f581d4fac879c8bdfa4,5,152,80,232,13,2009-02-06 19:11:31,2009-02-06 19:11:31
0b210bfa0e3864c72f3cd280d57893c444401469...8ceb5627e546ffa0ffa0f86005dea2052d40d1de,6,438,9,447,51,2009-02-06 20:29:02,2009-02-06 20:29:02
7fddf991099e37c9b7ba8b8289215482fd1bd839...0ff2c94721ac0ddb20ff86a66b60fcff3424919d,2,2,2,4,2,2009-02-06 20:12:45,2009-02-06 20:12:45
7fddf991099e37c9b7ba8b8289215482fd1bd839...62cab8c32008df9ac567e44f0f65a44a7435c5c8,2,0,3,3,2,2009-02-06 20:08:53,2009-02-06 20:08:53
62cab8c32008df9ac567e44f0f65a44a7435c5c8...ef80bbf86cbe3e4741dc59fed4d23471e18ed21d,1,128,128,256,5,2009-02-06 20:09:16,2009-02-06 20:09:16
e19fd7ac0cc6f6a444310b9d48c9e6275927de95...ee6c8943a598d8f53bf617308865ff8864395f80,1,8,0,8,1,2009-02-06 20:43:47,2009-02-06 20:43:47
ee6c8943a598d8f53bf617308865ff8864395f80...83174a1a088a493a26986caf1e503bd9c1890b6d,7,125,71,196,38,2009-02-06 20:44:21,2009-02-06 20:44:21
83174a1a088a493a26986caf1e503bd9c1890b6d...d725521f6db5813c8ea64f16ac324b1f17dbc854,1,44,1,45,3,2009-02-06 21:25:14,2009-02-06 21:25:14
83174a1a088a493a26986caf1e503bd9c1890b6d...176c9a1e255115f5abdaf8a39c9b084b3560dc6a,1,1,0,1,1,2009-02-06 20:56:36,2009-02-06 20:56:36
176c9a1e255115f5abdaf8a39c9b084b3560dc6a...4d5f0e9a78922cc90edb3ea585949210db0ef1fe,3,14,5,19,5,2009-02-06 21:21:49,2009-02-06 21:21:49
0759ee54b4fc10cb4125748d7f35e0b773d9bc8a...7d593671fec6aa3a449b895c1220a2e4c6fc42e7,6,31,12,43,13,2009-02-06 21:56:14,2009-02-06 21:56:14
0759ee54b4fc10cb4125748d7f35e0b773d9bc8a...45a10439cf001e51b9cd24ab65d581171decffd7,1,23,2,25,3,2009-02-06 21:43:00,2009-02-06 21:43:00
58d7ca3c1d42bcb631f27e6e65a787cec572c189...21e105d3a2a3d203cfff6a675a62167b4d36552a,1,20,0,20,1,2009-02-06 21:58:46,2009-02-06 21:58:46
45a10439cf001e51b9cd24ab65d581171decffd7...e5b0aa464ac705b5f402d557792e2872613b0665,1,2,1,3,2,2009-02-06 21:51:14,2009-02-06 21:51:14
45a10439cf001e51b9cd24ab65d581171decffd7...fc89a866de2e795ad0a475c0cffc9bb0485d5a95,1,1,1,2,1,2009-02-06 21:50:08,2009-02-06 21:50:08
c2cde252670d4d35d15ac7a7f6d8bc82a749264a...9590e60f21a474ef7b99a0ce65ff3d5fbe70f3c6,4,55,17,72,16,2009-02-07 14:21:29,2009-02-07 14:21:29
9590e60f21a474ef7b99a0ce65ff3d5fbe70f3c6...5b8a108923fa9b706bc062b35f558121f672d0e3,2,11,1,12,4,2009-02-07 15:27:22,2009-02-07 15:27:22
5b8a108923fa9b706bc062b35f558121f672d0e3...82f5e84538949870819c3c19b95c41332de7332c,2,8,1,9,2,2009-02-07 15:35:57,2009-02-07 15:35:57
82f5e84538949870819c3c19b95c41332de7332c...a68f8be302388fce43b3995725f34462f710b244,5,8,8,16,8,2009-02-08 00:14:28,2009-02-08 00:14:28
a68f8be302388fce43b3995725f34462f710b244...76001e45e3876f57a9e81d3a7fb265033d3ba1ae,1,1,4,5,2,2009-02-08 00:20:15,2009-02-08 00:20:15
76001e45e3876f57a9e81d3a7fb265033d3ba1ae...9e9aed15d3f69205b6aa9a1759674c932ae81f0a,2,15,4,19,11,2009-02-08 15:37:39,2009-02-08 15:37:39
9e9aed15d3f69205b6aa9a1759674c932ae81f0a...1d26ef15cea31d33d955dc2db8166380d792537c,1,2,5,7,1,2009-02-08 15:42:10,2009-02-08 15:42:10
480fd2b5f50a5c7d660a4d393352ecf319343d17...c39b5290c5cb83f967ca962dc537dd284aec415f,1,1,0,1,1,2009-02-06 21:53:08,2009-02-06 21:53:08
fc89a866de2e795ad0a475c0cffc9bb0485d5a95...3ecc0eb11416613e353635c209dc565c0d47e629,1,2,2,4,1,2009-02-06 22:05:11,2009-02-06 22:05:11
3ecc0eb11416613e353635c209dc565c0d47e629...3504f3249c62d205d66aab2f714d1bc06b4a0934,2,1,4,5,2,2009-02-06 22:16:28,2009-02-06 22:16:28
1d26ef15cea31d33d955dc2db8166380d792537c...61e3d021f2f21b09d99d6570f2a6e3539cc052b0,1,4,1,5,1,2009-02-08 19:58:52,2009-02-08 19:58:52
1d26ef15cea31d33d955dc2db8166380d792537c...c154c784692bc4a3c65152fb3d761c66cfd25e63,2,10,5,15,4,2009-02-08 19:35:34,2009-02-08 19:35:34
c154c784692bc4a3c65152fb3d761c66cfd25e63...7892e1771526827ba2d447e111eab181c11da5fc,9,47,98,145,39,2009-02-08 19:36:01,2009-02-08 19:36:01
7892e1771526827ba2d447e111eab181c11da5fc...d45688ce1d0440c4b40bcf51e98f5338d15b4a9d,3,17,4,21,7,2009-02-08 21:02:48,2009-02-08 21:02:48
111528c3f6bd646931dc04ceb6185c6cf4d75e7f...595328d2aff14ab8b279d12cf8132edacf273c0e,2,36,2,38,5,2009-02-08 22:55:17,2009-02-08 22:55:17
595328d2aff14ab8b279d12cf8132edacf273c0e...ea099937096eb3b2a7682c87a947b99f8f1a1bb6,4,42,4,46,9,2009-02-08 22:55:33,2009-02-08 22:55:33
ea099937096eb3b2a7682c87a947b99f8f1a1bb6...c780a112c52a9926d292456b7940c5ba4b4dc9e3,1,0,0,0,0,2009-02-08 23:03:55,2009-02-08 23:03:55
c780a112c52a9926d292456b7940c5ba4b4dc9e3...cf65d861310dcca50c0d6bd8d26187d33f4a4cb1,2,7,3,10,6,2009-02-09 02:00:26,2009-02-09 02:00:26
cf65d861310dcca50c0d6bd8d26187d33f4a4cb1...bc55e5a63b37563f23faa0aa9bee3c6127d2c743,1,2,0,2,1,2009-02-09 02:18:38,2009-02-09 02:18:38
bc55e5a63b37563f23faa0aa9bee3c6127d2c743...6f78b4ae5e26ba742fb68e272d823327fb602dcf,1,1,6,7,2,2009-02-09 15:55:59,2009-02-09 15:55:59
6f78b4ae5e26ba742fb68e272d823327fb602dcf...657c78a08f83125a9d8c4d113b15ce74a9394d06,1,14,6,20,8,2009-02-09 16:42:39,2009-02-09 16:42:39
6f78b4ae5e26ba742fb68e272d823327fb602dcf...992fc7d84cffc897fea3155f63b92ec5f86c8740,2,7,7,14,6,2009-02-09 16:24:21,2009-02-09 16:24:21
1f7c7ff9d0f99b4f299a33ed90db7c1d627135d5...a01b4063b908f91dc64ef3b2e3edef962296f227,2,35,7,42,23,2009-02-09 17:52:47,2009-02-09 17:52:47
1f7c7ff9d0f99b4f299a33ed90db7c1d627135d5...31df4e48b2339255890079f3e446c9c785b27d34,1,2,0,2,1,2009-02-09 17:46:40,2009-02-09 17:46:40
10d5a55c357c9190b85576fc77bee8a71bb4d05e...147948c7b33d4542a99352dd02ec3cb88f401a7c,27,147,124,271,120,2009-02-09 18:04:32,2009-02-09 18:04:32
147948c7b33d4542a99352dd02ec3cb88f401a7c...8cb17548c27a6599641fb7319f838e1f489745a2,13,64,44,108,36,2009-02-09 20:38:26,2009-02-09 20:38:26
147948c7b33d4542a99352dd02ec3cb88f401a7c...c245e7066cbc6b7e31505faaea0491c467405329,1,9,1,10,1,2009-02-09 18:05:36,2009-02-09 18:05:36
c245e7066cbc6b7e31505faaea0491c467405329...e9f163e06fa2eb06969464d5f8289859469cedf3,4,27,27,54,20,2009-02-09 18:34:40,2009-02-09 18:34:40
e9f163e06fa2eb06969464d5f8289859469cedf3...8356bec0709c3bad561c18344f3e866dc216f3cc,1,13,2,15,5,2009-02-09 19:30:45,2009-02-09 19:30:45
fadc7ef3bbd7a96346211cc4c1ac2d58104e8427...52ac9edf310f747e1ac3a14c741c4e07821fb876,5,43,34,77,9,2009-02-09 21:24:47,2009-02-09 21:24:47
8356bec0709c3bad561c18344f3e866dc216f3cc...166716bb25aefc6887939a0c35b9df36b8bc01f4,7,131,4,135,12,2009-02-09 20:57:30,2009-02-09 20:57:30
5390dbc920d050bb59787c5c9bc1bdba03d25191...a071a573c3353e0b3d10e5f92f135592e9c77368,1,2,2,4,2,2009-02-09 21:33:07,2009-02-09 21:33:07
a071a573c3353e0b3d10e5f92f135592e9c77368...3b5cb47a1fd9250e4adce246f6606647e489bb6c,3,47,15,62,14,2009-02-09 22:17:40,2009-02-09 22:17:40
a071a573c3353e0b3d10e5f92f135592e9c77368...e0843d7476d8390ac165d86bca826b844a7134ad,1,2,2,4,1,2009-02-09 21:57:07,2009-02-09 21:57:07
e0843d7476d8390ac165d86bca826b844a7134ad...8476a12040ac53ad70388d00aabc32a4a1ea21c0,1,1,3,4,3,2009-02-09 22:00:13,2009-02-09 22:00:13
a9136628d5dd18cb3219f8bb41163d36c5cd09b5...192c4e57080d122d4c7b161deb021a103a7e3b29,2,8,4,12,3,2009-02-09 22:40:45,2009-02-09 22:40:45
8476a12040ac53ad70388d00aabc32a4a1ea21c0...16652466ec7aeb9e17060ea95644eaf3e98bc78c,4,19,26,45,7,2009-02-09 22:14:18,2009-02-09 22:14:18
16652466ec7aeb9e17060ea95644eaf3e98bc78c...886ccd62755c8778ae7586bcb5286917e63f56c8,1,8,0,8,1,2009-02-09 22:19:54,2009-02-09 22:19:54
886ccd62755c8778ae7586bcb5286917e63f56c8...d4124e690953dd3d3169d6f553363ac1e61d630e,1,2,0,2,2,2009-02-09 22:20:02,2009-02-09 22:20:02
d4124e690953dd3d3169d6f553363ac1e61d630e...ac5b3fee3fed1e5d8a89eb86c593ace148bea3f5,1,3,0,3,1,2009-02-09 22:22:26,2009-02-09 22:22:26
a52fc9a5a95c726badc61e1d899ccd3e65b8bfcb...c8fb50b3f1a1a2a9fcd3d4d0f1c533ac30e8ffd8,1,1,1,2,1,2009-02-10 17:35:30,2009-02-10 17:35:30
a52fc9a5a95c726badc61e1d899ccd3e65b8bfcb...465dac0b1425c66db80641b2b9aed20a552520f5,1,19,3,22,6,2009-02-10 15:07:18,2009-02-10 15:07:18
465dac0b1425c66db80641b2b9aed20a552520f5...853736071cc020d6ac81fec2059f4373c75ae6a4,2,9,0,9,3,2009-02-10 15:48:41,2009-02-10 15:48:41
853736071cc020d6ac81fec2059f4373c75ae6a4...d56a95aa037ed50ce59baf2330fe8ad9b48f700b,1,20,12,32,9,2009-02-10 15:48:52,2009-02-10 15:48:52
d56a95aa037ed50ce59baf2330fe8ad9b48f700b...a86d713f233c8f629517acac0668ff99a9c8bb70,1,1,1,2,1,2009-02-10 15:54:43,2009-02-10 15:54:43
dea7bbe86d92ee383601b6514fce1161b7d0696c...ea431a83dc8d09ec585feee94e1b2f5b62cce1fe,3,158,11,169,22,2009-02-10 16:21:13,2009-02-10 16:21:13
4ab67f0e7ec75ac20c574b8cb986b18abe305e56...3f143e4e64d0d5adedd77b0af6a59d3338e8430b,3,2,3,5,3,2009-02-10 17:40:17,2009-02-10 17:40:17
3f143e4e64d0d5adedd77b0af6a59d3338e8430b...27729042be22fa69d130dc26f267f33c556ab74b,2,2,2,4,2,2009-02-10 17:52:41,2009-02-10 17:52:41
27729042be22fa69d130dc26f267f33c556ab74b...015bbe731619fcf55032af37df98d39dd24ef686,2,2,2,4,2,2009-02-10 17:57:06,2009-02-10 17:57:06
ae69ee27a3d85e26f667eba22e5e17f3e4d90a08...e66877f86a845c25379d28c36d26ad50459e00f8,1,0,2,2,1,2009-02-10 16:24:10,2009-02-10 16:24:10
e66877f86a845c25379d28c36d26ad50459e00f8...72d5a652fb9e785f66834b3db74426b32aa1cf23,1,1,1,2,1,2009-02-10 17:01:32,2009-02-10 17:01:32
015bbe731619fcf55032af37df98d39dd24ef686...75d201f000377a99df231c2b18ac21eed0cf8c09,2,18,0,18,4,2009-02-10 19:22:50,2009-02-10 19:22:50
015bbe731619fcf55032af37df98d39dd24ef686...1b6151f37bac33e50869ebaab67ba625be29cc49,3,51,10,61,14,2009-02-10 18:45:30,2009-02-10 18:45:30
015bbe731619fcf55032af37df98d39dd24ef686...72eb0d50728c70eac638ddbe0689a8cfa7662607,2,0,2,2,2,2009-02-10 18:16:34,2009-02-10 18:16:34
693a5607646976a25834fe36e521ff2147d9cc61...2b96bea8d08a1f2426fd46a3a782bd408da9ea53,2,1,3,4,3,2009-02-10 20:39:47,2009-02-10 20:39:47
693a5607646976a25834fe36e521ff2147d9cc61...12a608a3abac9ff29172c44afdea131d14805810,1,10,3,13,2,2009-02-10 20:12:15,2009-02-10 20:12:15
12a608a3abac9ff29172c44afdea131d14805810...014d06f1100a75a7aeb674303359f5f39bd114e8,1,1,1,2,1,2009-02-10 20:38:20,2009-02-10 20:38:20
14fca8423880a48c83742c1e0b550e6cf167d872...d71851a4140e03331f8c1c4bdee896dfd7e3c7d0,1,1,1,2,1,2009-02-10 18:49:51,2009-02-10 18:49:51
72eb0d50728c70eac638ddbe0689a8cfa7662607...2c1662cc83c582cdb14e847dd7e96110bc13b704,1,20,0,20,1,2009-02-17 16:11:13,2009-02-17 16:11:13
72eb0d50728c70eac638ddbe0689a8cfa7662607...565d3742839561836424443f95c951005a6030d8,6,15,7,22,9,2009-02-10 19:04:03,2009-02-10 19:04:03
6c62dd105dc8c397b4e36dececa2062b4c8a8c8e...9cc79db5518123e239e3de3b8d82cab960b0d603,2,5,2,7,2,2009-02-10 22:42:31,2009-02-10 22:42:31
9cc79db5518123e239e3de3b8d82cab960b0d603...cb5a1e178210ea639dc1755ab930de91229380d2,1,27,3,30,7,2009-02-11 02:37:18,2009-02-11 02:37:18
cb5a1e178210ea639dc1755ab930de91229380d2...4ffe0fe3ad601a4a14fa2e0aa600c3f0cf356c3e,1,1,0,1,1,2009-02-11 03:11:51,2009-02-11 03:11:51
4ffe0fe3ad601a4a14fa2e0aa600c3f0cf356c3e...be9ed914f65a1adbae8f21a56a8934b43497a54b,4,869,0,869,4,2009-02-11 11:39:00,2009-02-11 11:39:00
be9ed914f65a1adbae8f21a56a8934b43497a54b...b0a92ccc83de907dabcc0e9242fc3c9982712927,1,3,0,3,1,2009-02-11 14:00:52,2009-02-11 14:00:52
b0a92ccc83de907dabcc0e9242fc3c9982712927...c68d42e36c5516fab7e975f6b6bd422c4779509f,1,10,2,12,3,2009-02-11 14:15:06,2009-02-11 14:15:06
c68d42e36c5516fab7e975f6b6bd422c4779509f...1515ab7f6bb227520e81f8eed88821af1fc9c2b4,1,3,1,4,2,2009-02-11 14:15:34,2009-02-11 14:15:34
1515ab7f6bb227520e81f8eed88821af1fc9c2b4...8154c0af5e2d528e25ea5b30ee3639362ff491a7,1,7,0,7,2,2009-02-11 14:34:00,2009-02-11 14:34:00
1515ab7f6bb227520e81f8eed88821af1fc9c2b4...f694f826dd45bf1be2fe940ff311c4fbb61171c2,1,19,8,27,3,2009-02-11 14:27:21,2009-02-11 14:27:21
09a0dea6cb29de855922e575021113f8cddc5320...d34770ba43c770dac979ce0d4573648c784cc9f6,1,1,1,2,1,2009-02-17 17:18:13,2009-02-17 17:18:13
d34770ba43c770dac979ce0d4573648c784cc9f6...4931a44ac97beb5b3c0627021055aa5080bc73df,1,6,1,7,2,2009-02-17 17:24:47,2009-02-17 17:24:47
6a7ce4dd637686f3ce446c0f4051795bba91313e...85298ec174b059bf2ebd2c1048cc5dd99d85689f,2,6,3,9,4,2009-02-11 14:58:01,2009-02-11 14:58:01
f694f826dd45bf1be2fe940ff311c4fbb61171c2...3ae8e9440c991bd4642a2074db83b05129a3e966,1,13,8,21,2,2009-02-11 14:35:08,2009-02-11 14:35:08
4931a44ac97beb5b3c0627021055aa5080bc73df...73c8977fabc3c33416221546654f8539ee882b39,5,218,17,235,18,2009-02-17 19:41:31,2009-02-17 19:41:31
73c8977fabc3c33416221546654f8539ee882b39...e74408dc7a462cbccc86899d6fa7f023dfc6cde3,4,72,14,86,20,2009-02-17 20:34:52,2009-02-17 20:34:52
7de1d97a9375adfe3a0c9e52f3065e91de105d0d...86b5efcd1efcbac87829aea341078c5cd38a5127,1,1,1,2,2,2009-02-11 15:24:32,2009-02-11 15:24:32
bdc7d90b852ec294995f16afcc48c0238db789aa...ba8b57c15881ac8de4348aa35e375bc5394ce0b3,2,8,2,10,4,2009-02-11 15:37:04,2009-02-11 15:37:04
e74408dc7a462cbccc86899d6fa7f023dfc6cde3...2ea18eb703ac3932c91cbac55a2dcff2aa8a0f32,1,6,6,12,4,2009-02-18 04:29:28,2009-02-18 04:29:28
e74408dc7a462cbccc86899d6fa7f023dfc6cde3...fb656c60d2dbc8412d339a47446def0b4c2c6f25,1,6,7,13,4,2009-02-17 22:11:40,2009-02-17 22:11:40
a44c5128525342232ff6bf192022725e85fe6568...1da901f2bf700dfbbdf25778f9b55730c18ddbec,2,6,9,15,5,2009-02-17 23:40:27,2009-02-17 23:40:27
86b5efcd1efcbac87829aea341078c5cd38a5127...6224cd9f293635ee9a505080ef8bf2c36116ff8d,6,584,18,602,16,2009-02-11 18:17:52,2009-02-11 18:17:52
86b5efcd1efcbac87829aea341078c5cd38a5127...9f5fe79f2f30ff4a9cfb4b5a528d40ae2a199641,5,23,2,25,6,2009-02-11 16:28:49,2009-02-11 16:28:49
095a9565758ec7af3d9b83c66e85265bd6717e10...827e76b7793e7969c4c41aa6a130c7324fadb391,1,49,2,51,4,2009-02-11 15:37:27,2009-02-11 15:37:27
827e76b7793e7969c4c41aa6a130c7324fadb391...bafd4aad058f846acee018dcfac30a8a014b1d17,1,2,2,4,2,2009-02-11 15:53:51,2009-02-11 15:53:51
bafd4aad058f846acee018dcfac30a8a014b1d17...b12f410c1800ddb52dba10492b4774a37f1a8a2a,1,1,1,2,1,2009-02-11 16:26:28,2009-02-11 16:26:28
54b560c635618a14c957b415e581faf891f46179...8f65a14db172570a9dfbaec9e0eda8a1b224c613,4,185,21,206,32,2009-02-18 04:31:27,2009-02-18 04:31:27
fb656c60d2dbc8412d339a47446def0b4c2c6f25...384c4881a12855c1c1e41e9f4a80b4c80649ded3,1,4,3,7,3,2009-02-17 23:39:52,2009-02-17 23:39:52
f4a3b464ec038b3c9ae71f4c8a270558df51a8f2...22085b0540fbfd240be55876587028955348a6a4,4,8,1,9,4,2009-02-18 00:21:01,2009-02-18 00:21:01
bd3b8ec5e1aa0def4d6aa586312d6da0d254e225...878cffc529ec5987deacfc15b9dd919e79ae8248,1,1,0,1,1,2009-02-11 19:30:46,2009-02-11 19:30:46
878cffc529ec5987deacfc15b9dd919e79ae8248...c326d4a5086dfb2610c960cdedfe8735adc68376,4,30,9,39,9,2009-02-11 20:37:51,2009-02-11 20:37:51
bd3b8ec5e1aa0def4d6aa586312d6da0d254e225...d3b02bde345a7ec13f78679f19804695b1956623,1,10,10,20,10,2009-02-11 18:52:28,2009-02-11 18:52:28
d3b02bde345a7ec13f78679f19804695b1956623...fc618d71653a3938d76dff54b23a1e12d92ee15d,1,1,1,2,1,2009-02-11 18:52:51,2009-02-11 18:52:51
d063654ff5757f1dbe2c315e0f14c6a54b4130a6...8a569e8bc07dbb103e2b061fff948c85d73559ed,1,17,13,30,15,2009-02-11 16:36:51,2009-02-11 16:36:51
8a569e8bc07dbb103e2b061fff948c85d73559ed...020b6035b4fb1e306272f621762c20eb70e1e5f9,1,1,1,2,1,2009-02-11 16:38:39,2009-02-11 16:38:39
020b6035b4fb1e306272f621762c20eb70e1e5f9...4dfbeda3db80a1e66b0c3e948151c8f2147c3feb,1,8,3,11,1,2009-02-11 17:13:08,2009-02-11 17:13:08
4dfbeda3db80a1e66b0c3e948151c8f2147c3feb...d11d75e7ef92673a7a04bdd02c7a6b200203a45e,2,3,1,4,3,2009-02-11 17:25:28,2009-02-11 17:25:28
8f65a14db172570a9dfbaec9e0eda8a1b224c613...8e203da1d22b70cf0e624825fc90b01bd492484d,6,103,83,186,20,2009-02-18 15:10:39,2009-02-18 15:10:39
8f65a14db172570a9dfbaec9e0eda8a1b224c613...9bd71ee2400bec4f49ce9e16873d172f404c3444,1,3,0,3,1,2009-02-18 14:13:03,2009-02-18 14:13:03
9bd71ee2400bec4f49ce9e16873d172f404c3444...90f39126fc9438f7b8d161b14de1879d788197ec,2,16,6,22,5,2009-02-18 14:45:49,2009-02-18 14:45:49
3e9fc2895be39f9f751cee9bf5f30eb6098a811e...1c978eaace3ee0a76fdd34396975bf28788e317d,1,1,1,2,1,2009-02-18 00:46:37,2009-02-18 00:46:37
1c978eaace3ee0a76fdd34396975bf28788e317d...247d3e69a433354f4c8297f171a5ca182a6f4982,3,151,42,193,11,2009-02-18 01:57:36,2009-02-18 01:57:36
247d3e69a433354f4c8297f171a5ca182a6f4982...b30b8b329974cbd4e807df3ff512877c18b719da,2,9,3,12,3,2009-02-18 04:09:37,2009-02-18 04:09:37
7e7722ea068f3e989e950829400b454a37f0980c...42de9931490cbae0a45db6da9b369a087a0e30c4,3,217,7,224,11,2009-02-18 00:39:35,2009-02-18 00:39:35
ea6ef5295e145f39d53d134a3ce8325f3103f765...fe8ed2defa425037755fb79ef20edef658a4b78f,1,3,1,4,1,2009-02-11 20:50:27,2009-02-11 20:50:27
fe8ed2defa425037755fb79ef20edef658a4b78f...6dda29d6ef627b9173b051bccad0a4b4475c7b68,1,24,16,40,7,2009-02-12 02:05:28,2009-02-12 02:05:28
6dda29d6ef627b9173b051bccad0a4b4475c7b68...7be50081c450afda626e1687ded5e8af5cf14d85,1,0,5,5,1,2009-02-12 02:05:45,2009-02-12 02:05:45
7be50081c450afda626e1687ded5e8af5cf14d85...25be6f87a22fdd6af6f47396d7f51e6fcb6c6396,1,2,2,4,2,2009-02-12 02:15:54,2009-02-12 02:15:54
25be6f87a22fdd6af6f47396d7f51e6fcb6c6396...774eeb8cb33b8438ce8130109ba40ce64730ca0e,1,2,0,2,1,2009-02-12 02:16:08,2009-02-12 02:16:08
774eeb8cb33b8438ce8130109ba40ce64730ca0e...c8dacdb3974b40e58ea076d94b5a2af645f8820f,1,2,1,3,2,2009-02-12 02:54:20,2009-02-12 02:54:20
c8dacdb3974b40e58ea076d94b5a2af645f8820f...f0476381d35be5366fbd9773bad01778e9558f1a,1,2,2,4,3,2009-02-12 03:18:30,2009-02-12 03:18:30
f0476381d35be5366fbd9773bad01778e9558f1a...e7f10be927e14ab3af0f2637e5d9d7683fa80c22,1,5,1,6,1,2009-02-12 04:16:29,2009-02-12 04:16:29
e7f10be927e14ab3af0f2637e5d9d7683fa80c22...15563d1aec2fe339435ce3b1423ba54088091268,1,1,1,2,1,2009-02-12 14:10:11,2009-02-12 14:10:11
15563d1aec2fe339435ce3b1423ba54088091268...bb137426635a0c79cd7ee4407ea9316908114e9c,1,1,1,2,1,2009-02-12 14:20:26,2009-02-12 14:20:26
56ec25062873d49eb2c775000b8a8f225b6327e4...163bd066bd8a7644a4f9655cda6778e6ab5a8b04,4,74,52,126,12,2009-02-18 15:59:13,2009-02-18 15:59:13
163bd066bd8a7644a4f9655cda6778e6ab5a8b04...7bca09b9f9303258418c5add1401b85d027a44e4,3,33,20,53,17,2009-02-18 16:26:30,2009-02-18 16:26:30
7bca09b9f9303258418c5add1401b85d027a44e4...00f58bd87ac5d43182883a65f681bbd478a02569,1,0,2,2,1,2009-02-18 16:27:07,2009-02-18 16:27:07
00f58bd87ac5d43182883a65f681bbd478a02569...b6699b50b31a16e5f82579da1fb79b160eb0332a,1,4,1,5,2,2009-02-18 16:29:04,2009-02-18 16:29:04
b6699b50b31a16e5f82579da1fb79b160eb0332a...7412a333fc1365438f25bd6e83fb1c2e6545fbdb,3,16,4,20,5,2009-02-18 18:11:22,2009-02-18 18:11:22
bb137426635a0c79cd7ee4407ea9316908114e9c...667c004013ab0f14569083433677f56b13a15624,3,40,35,75,6,2009-02-14 01:04:13,2009-02-14 01:04:13
bb137426635a0c79cd7ee4407ea9316908114e9c...cd2a54233766f21d1965442bfd99eab5078a9d85,2,8,9,17,2,2009-02-12 15:11:02,2009-02-12 15:11:02
cd2a54233766f21d1965442bfd99eab5078a9d85...f15c472da8772f03b595452924c22ae306b4248e,1,2,0,2,1,2009-02-12 15:13:18,2009-02-12 15:13:18
f15c472da8772f03b595452924c22ae306b4248e...84231c69193f7fcc1d75cfdf7b19d3a7bea7c936,2,23,20,43,5,2009-02-12 16:37:30,2009-02-12 16:37:30
7412a333fc1365438f25bd6e83fb1c2e6545fbdb...593bf1f12683fb79b428ebded1dbacd4df0a4ac3,24,46,5,51,31,2009-02-18 18:42:32,2009-02-18 18:42:32
7412a333fc1365438f25bd6e83fb1c2e6545fbdb...94b79023909ee2d5858cfff5d71c991858e30039,1,1,5,6,1,2009-02-18 18:24:43,2009-02-18 18:24:43
84231c69193f7fcc1d75cfdf7b19d3a7bea7c936...3279dfa644c08a9eca7b2d4e0501a472be4e6784,1,12,0,12,5,2009-02-12 18:11:31,2009-02-12 18:11:31
84231c69193f7fcc1d75cfdf7b19d3a7bea7c936...4c03dc15ed419d60b3df6068730f307ee8a33e01,1,2,2,4,2,2009-02-12 17:19:00,2009-02-12 17:19:00
f05bd0a7be34c811740e4b4f62ca0adff030e0d4...8635a2e713814fb6c2dccb61f04111f73c998b2e,1,1,1,2,1,2009-02-18 18:45:43,2009-02-18 18:45:43
94b79023909ee2d5858cfff5d71c991858e30039...e0762fd1bae16b89abea290b31b2869b3e1dadb2,1,12,0,12,1,2009-02-18 18:54:08,2009-02-18 18:54:08
e0762fd1bae16b89abea290b31b2869b3e1dadb2...bd5a5943336d90bd2e381a28cbbf9ecac93aa6f1,4,82,10,92,11,2009-02-18 18:54:22,2009-02-18 18:54:22
23f65c7e871a1edc1014b697c57ad1ad9a6c24a6...c12c7851f97c53ab6b9df30d7aa4b3079ab027c2,2,71,28,99,12,2009-02-12 21:52:34,2009-02-12 21:52:34
23f65c7e871a1edc1014b697c57ad1ad9a6c24a6...e13f1df0a1c8b2854082c6059c264aa3414ea402,1,18,3,21,1,2009-02-12 18:47:43,2009-02-12 18:47:43
e13f1df0a1c8b2854082c6059c264aa3414ea402...6e345fc61d91172091a27f070753e87124d730d4,2,20,0,20,2,2009-02-12 19:30:45,2009-02-12 19:30:45
4c03dc15ed419d60b3df6068730f307ee8a33e01...459d62347b450d14d5f5a337411498782d9761eb,10,81,66,147,34,2009-02-12 20:03:38,2009-02-12 20:03:38
8635a2e713814fb6c2dccb61f04111f73c998b2e...b251990286603a5ce7587475024f22f7f1935689,4,124,7,131,13,2009-02-18 20:25:50,2009-02-18 20:25:50
be6e778aa124b0c97f49bab4d0d753e7bf233144...e4c179c1805c55941117464fbe7a7077f9175183,1,9,7,16,7,2009-02-13 15:44:35,2009-02-13 15:44:35
0cc39932111aa428f1a96883f5a7a0ac033625f9...c67eca8a2f7404956e46c9c6136c25ddc4af604a,4,52,1,53,5,2009-02-12 23:20:52,2009-02-12 23:20:52
2ad191b266c34289a944ca24dc63c24f44d7bcb6...610fcd7c7458975f310f85a93f25a40acac1d326,1,2,2,4,2,2009-02-18 20:28:45,2009-02-18 20:28:45
610fcd7c7458975f310f85a93f25a40acac1d326...eb373366f6e0d54b00d27883f70726e81c1606b7,1,51,5,56,7,2009-02-18 21:24:08,2009-02-18 21:24:08
eb373366f6e0d54b00d27883f70726e81c1606b7...d655991b1b0726a5630ccb87204e2a6163d2867f,1,0,3,3,1,2009-02-18 21:43:14,2009-02-18 21:43:14
d655991b1b0726a5630ccb87204e2a6163d2867f...9d9869484a135e430c0d41b6c43e0282620b58c4,1,27,0,27,1,2009-02-18 21:44:56,2009-02-18 21:44:56
9d9869484a135e430c0d41b6c43e0282620b58c4...e02e8e1e1e2e1001cc0d9626ea2667b81ea81dee,1,4,0,4,1,2009-02-18 21:55:19,2009-02-18 21:55:19
e02e8e1e1e2e1001cc0d9626ea2667b81ea81dee...3e45526a18757a218088a841bc98b0cd88705dd7,1,8,3,11,5,2009-02-18 22:10:51,2009-02-18 22:10:51
ebc0e5d2f297e478f0f550804f3570ea4bf91e1f...8fc2c86e0afc8e12421e245b95a16b5f3d7d4bbf,8,74,54,128,36,2009-02-13 17:01:37,2009-02-13 17:01:37
e49d7f38a6e85131a7605f9a698d20e37e2d50ad...9c286b438fde6c6857dc3558a47a06a60ef9142d,7,73,28,101,24,2009-02-13 16:25:52,2009-02-13 16:25:52
e49d7f38a6e85131a7605f9a698d20e37e2d50ad...32d7cb1c17a6ee9cdb609aba6bbaed420ba84bd0,7,8,28,36,10,2009-02-13 02:03:46,2009-02-13 02:03:46
32d7cb1c17a6ee9cdb609aba6bbaed420ba84bd0...b859ae916306509aca6d4135e7826b15008ccf02,8,134,194,328,14,2009-02-13 02:09:06,2009-02-13 02:09:06
b859ae916306509aca6d4135e7826b15008ccf02...a835ed1af58ec5f4a7b74b9f27079f0cad6c2bc7,12,2,2,4,1,2009-02-13 14:22:04,2009-02-13 14:22:04
a835ed1af58ec5f4a7b74b9f27079f0cad6c2bc7...197dc2b66dee5e0569595993468e89bc7028f855,1,25,20,45,5,2009-02-13 14:28:23,2009-02-13 14:28:23
197dc2b66dee5e0569595993468e89bc7028f855...65687c9303f9ffaab5e8997dd26ec246b1311b86,3,22,1,23,7,2009-02-13 14:44:07,2009-02-13 14:44:07
65687c9303f9ffaab5e8997dd26ec246b1311b86...13a8310e5990edd08ac4eaa8486f7f3edf09b22b,1,1,0,1,1,2009-02-13 14:44:37,2009-02-13 14:44:37
13a8310e5990edd08ac4eaa8486f7f3edf09b22b...640d9fc0acdaca026bdb60b30893f163455ae5d9,2,6,1,7,3,2009-02-13 15:01:31,2009-02-13 15:01:31
640d9fc0acdaca026bdb60b30893f163455ae5d9...fe4892bbf8431f7fd9111e74b7df526cc7e38764,2,16,10,26,5,2009-02-13 15:01:59,2009-02-13 15:01:59
fe4892bbf8431f7fd9111e74b7df526cc7e38764...471618efe14be1383fe96ed888ddc170241510d7,1,10,5,15,3,2009-02-13 15:06:56,2009-02-13 15:06:56
3e45526a18757a218088a841bc98b0cd88705dd7...b1d90324479d0aaae561728bef68ff02f57d043d,4,11,21,32,11,2009-02-19 03:17:30,2009-02-19 03:17:30
b1d90324479d0aaae561728bef68ff02f57d043d...c8f5a1963c2c68c4d9583c5894d831942af19186,3,173,45,218,30,2009-02-19 15:01:20,2009-02-19 15:01:20
3e45526a18757a218088a841bc98b0cd88705dd7...0c99b79e0bfa78fb8e07610c0c46e3bb67411581,1,1,1,2,1,2009-02-19 00:34:46,2009-02-19 00:34:46
1fe2b0cdb3d7a9d5cbecbd7bdec51347c2b2ce47...851b91a4d3b76b096134a5ce6d62453b8a3b6bf4,1,19,11,30,7,2009-02-13 19:35:03,2009-02-13 19:35:03
80e95f860aca14ac06b0e756ad838c4d98282cc4...da5345003668deb3cacfb58c6ff03e1a44cb1622,7,87,27,114,30,2009-02-13 17:58:05,2009-02-13 17:58:05
e8223681088d0d3722147d7238eb3b4f82112abe...fd756add64f2c94635589434bab350deb29eac2f,2,15,10,25,4,2009-02-19 15:26:46,2009-02-19 15:26:46
0c99b79e0bfa78fb8e07610c0c46e3bb67411581...b2bee8d64eb64a3074b86a42b7bed3e9a108a60e,1,9,2,11,2,2009-02-19 15:14:18,2009-02-19 15:14:18
41a0f8c4cf4ad11909d835586a40f65a0c1876a5...3422d92adffca7b526882c1931370d648fde4315,1,8,3,11,3,2009-02-13 21:17:52,2009-02-13 21:17:52
fd756add64f2c94635589434bab350deb29eac2f...6df7d02ce89ec5d5e5a2679c31541a7f766b5082,6,36,10,46,9,2009-02-19 17:03:15,2009-02-19 17:03:15
0aacf07db842724de6c952f808db97ab464fe024...7c018a08c37e4449dbf8a8d1777d106e98609031,1,7,0,7,1,2009-02-19 16:33:03,2009-02-19 16:33:03
7c018a08c37e4449dbf8a8d1777d106e98609031...f23cb88f234074df82933c9199cb5a42c9dc418d,1,5,1,6,1,2009-02-19 16:33:15,2009-02-19 16:33:15
5b92b4f336efeef8abfd15ae54d17deaafde8da3...c949969fa2fba13c938a25be3c2fb34a023e42a5,2,87,0,87,2,2009-02-13 21:18:14,2009-02-13 21:18:14
c949969fa2fba13c938a25be3c2fb34a023e42a5...343076f3464522c6942bc8b67ae07ab1acb289df,3,198,0,198,3,2009-02-13 21:18:57,2009-02-13 21:18:57
343076f3464522c6942bc8b67ae07ab1acb289df...5883a1d1a9b564f933555c6c8d6cc8a665840655,1,52,12,64,6,2009-02-13 21:43:49,2009-02-13 21:43:49
5883a1d1a9b564f933555c6c8d6cc8a665840655...ec5c8cf8e4c7f7119613eae6422f302c8bfd8223,1,1,1,2,1,2009-02-13 21:53:32,2009-02-13 21:53:32
b035e4f92f60a0bb41d588c15c3abadb7320fc05...4fca3ad77a8c1f6c0c869a2bc7b937a94b67eaff,2,25,6,31,9,2009-02-19 17:43:46,2009-02-19 17:43:46
33d9b928fcf98b13d3f75428cd253d563cc3b47d...07cdf7632927e3d0b955930b642813583612c6ad,10,237,30,267,36,2009-02-19 17:55:01,2009-02-19 17:55:01
ec5c8cf8e4c7f7119613eae6422f302c8bfd8223...fb8957c743027e9155ad9876bddf9651d181fa54,5,5,11,16,6,2009-02-14 14:15:05,2009-02-14 14:15:05
ec5c8cf8e4c7f7119613eae6422f302c8bfd8223...cea77767c851500d89353c67684b446ddbcb2b87,1,1,1,2,1,2009-02-13 21:59:32,2009-02-13 21:59:32
cea77767c851500d89353c67684b446ddbcb2b87...e4e3997402e6201f6992453189873f8ebc3a35c2,1,45,6,51,9,2009-02-13 22:42:27,2009-02-13 22:42:27
4fca3ad77a8c1f6c0c869a2bc7b937a94b67eaff...250e0fd490c94f3898f4dbfc22abeb9ef178f1ea,3,82,10,92,18,2009-02-19 18:58:22,2009-02-19 18:58:22
524e8fd53cbde680c033c7ee3f0dff211224615d...a55abd3fa2e443d62d4ed473df48468c6ea89e1c,10,66,29,95,28,2009-02-19 18:26:25,2009-02-19 18:26:25
a11da1eaa7decb5722fc21fb7999a20c4c3a5c77...0e38bc5a8fbb78cfd7897be34f0a9adf3746e4fc,9,119,7,126,16,2009-02-17 20:53:19,2009-02-17 20:53:19
a11da1eaa7decb5722fc21fb7999a20c4c3a5c77...2e7a5d8bdaddc2bfc154de28379aae54c6d3c687,2,10,8,18,6,2009-02-14 14:41:52,2009-02-14 14:41:52
2e7a5d8bdaddc2bfc154de28379aae54c6d3c687...9c1bb934625daa648e03f1400742b0d0ab4724fd,1,1,0,1,1,2009-02-14 14:42:05,2009-02-14 14:42:05
9c1bb934625daa648e03f1400742b0d0ab4724fd...b4a918ff94d8828240fd89e4f82bfe493f932374,1,16,5,21,2,2009-02-14 14:42:18,2009-02-14 14:42:18
b4a918ff94d8828240fd89e4f82bfe493f932374...566af4dc73e74e2f0b5a566455d82319ec312537,14,21,36,57,8,2009-02-15 21:12:54,2009-02-15 21:12:54
566af4dc73e74e2f0b5a566455d82319ec312537...873ab5b6664aef749e827428f47e779da1f9aad8,2,61,60,121,2,2009-02-17 14:38:03,2009-02-17 14:38:03
873ab5b6664aef749e827428f47e779da1f9aad8...d74b746c310dc7be375ab36e56a808057e5c6ffc,1,6,2,8,2,2009-02-17 15:05:35,2009-02-17 15:05:35
d74b746c310dc7be375ab36e56a808057e5c6ffc...1a4ad3f91576e23a00d3f58ed385c0c6416d2263,2,58,8,66,5,2009-02-17 15:06:02,2009-02-17 15:06:02
1a4ad3f91576e23a00d3f58ed385c0c6416d2263...2aae06ec8b643284d7aad11d554c44fb29d62f74,2,25,11,36,6,2009-02-17 15:25:35,2009-02-17 15:25:35
2aae06ec8b643284d7aad11d554c44fb29d62f74...7e17d07e529b98f516d1611716536f851ef246f8,1,2,6,8,2,2009-02-17 15:26:15,2009-02-17 15:26:15
7e17d07e529b98f516d1611716536f851ef246f8...64027ed89779b2cd30174edaba1a557e41836870,2,54,1,55,2,2009-02-17 15:47:28,2009-02-17 15:47:28
06684825995ad9c6d4b9c03b4773bd925530a48d...9d8876a09b5c97e135807bdd5e5d1f8aebe9de52,1,4,1,5,2,2009-02-19 19:14:34,2009-02-19 19:14:34
9d8876a09b5c97e135807bdd5e5d1f8aebe9de52...d1475ffba2399cab543d8eb4c1ce94ba649ab283,2,10,10,20,10,2009-02-19 19:23:07,2009-02-19 19:23:07
d1475ffba2399cab543d8eb4c1ce94ba649ab283...3f61af1a47ee2aa54cfac08f9146028925a20c95,3,23,0,23,8,2009-02-19 20:04:10,2009-02-19 20:04:10
3f61af1a47ee2aa54cfac08f9146028925a20c95...4753a81753a6e0dc1af35c974fa3b17be0ec7c49,1,3,3,6,2,2009-02-19 20:07:56,2009-02-19 20:07:56
4753a81753a6e0dc1af35c974fa3b17be0ec7c49...0d08c1ea2e20b08d992dcbfba1c064a25c5fbd2c,1,12,5,17,1,2009-02-19 20:14:31,2009-02-19 20:14:31
0d08c1ea2e20b08d992dcbfba1c064a25c5fbd2c...89a58c46ad0ea49449e6b6bbe3fb2428509a56ca,1,2,2,4,1,2009-02-19 20:16:36,2009-02-19 20:16:36
89a58c46ad0ea49449e6b6bbe3fb2428509a56ca...b405fea8d15c28e7dea0d86fbc6d1c062f807757,1,22,0,22,5,2009-02-19 20:35:30,2009-02-19 20:35:30
a55abd3fa2e443d62d4ed473df48468c6ea89e1c...5ade1a8b3de5981729d0a6941368dd75a885ee5e,6,85,21,106,14,2009-02-19 22:32:19,2009-02-19 22:32:19
64027ed89779b2cd30174edaba1a557e41836870...ea976ed9fac6a79c1c4deca12f1ce717f4707c18,5,29,14,43,12,2009-02-17 16:41:34,2009-02-17 16:41:34
64027ed89779b2cd30174edaba1a557e41836870...b4a6a35ccff4cc71ef9299a2d66d1ae858ac75b3,1,24,0,24,1,2009-02-17 16:11:15,2009-02-17 16:11:15
b911ce8b250e3df57e8dd6e72cabd212972ef808...3f5102bf27fd120b696c78d16668c4ba2a5f0475,6,200,0,200,7,2009-02-20 14:34:25,2009-02-20 14:34:25
3f5102bf27fd120b696c78d16668c4ba2a5f0475...0ead2b56162fd456d7d6055f6c7c99c6941c6511,1,5,1,6,3,2009-02-20 14:52:25,2009-02-20 14:52:25
3f5102bf27fd120b696c78d16668c4ba2a5f0475...c759ddf5ccb4f3adbaae0cc9736128d07746aa46,1,189,0,189,1,2009-02-20 14:52:13,2009-02-20 14:52:13
406442dec4ee513d5f68971e22d2e9acfd0c56a2...6f25a72ec32be1dd6602e7fa5394ce9706c0242e,5,29,43,72,15,2009-02-20 15:48:32,2009-02-20 15:48:32
406442dec4ee513d5f68971e22d2e9acfd0c56a2...30f3acd4459cd4c13608a8be81624ba8574582da,2,18,4,22,4,2009-02-20 15:46:23,2009-02-20 15:46:23
30f3acd4459cd4c13608a8be81624ba8574582da...5f6aa4f67d9bf3bd6a4345db2af9c76647b677d2,10,143,19,162,17,2009-02-20 15:46:42,2009-02-20 15:46:42
7939f06889f5354943f274d2ece0a94d072138d9...db0f38e88bf5e3d7391c233a9b4dec418355faaa,7,292,69,361,88,2009-02-20 16:08:22,2009-02-20 16:08:22
5f6aa4f67d9bf3bd6a4345db2af9c76647b677d2...77ccdaa8e557887ebe18351f3699b3b76c477df2,4,60,25,85,5,2009-02-20 15:54:28,2009-02-20 15:54:28
cf2a7284d18231af6e58f75b3849ecd43b99a30d...7d0d3c52936cf04e0645f09d4b72dc03f5ef9862,3,28,12,40,9,2009-02-20 17:24:20,2009-02-20 17:24:20
cf2a7284d18231af6e58f75b3849ecd43b99a30d...d36c0d30c325e168b3ca253140c380ea902243b9,1,2,0,2,1,2009-02-20 17:17:15,2009-02-20 17:17:15
f786707c5505713e54704e752e4cb87d77f2ec45...a4fc389f6be6cd97382774ff4873deac79c84601,3,76,8,84,12,2009-02-20 20:19:41,2009-02-20 20:19:41
f786707c5505713e54704e752e4cb87d77f2ec45...206b92fce3033c17d1f8ae0ae8ebfb520454e07a,6,112,12,124,17,2009-02-20 17:47:59,2009-02-20 17:47:59
206b92fce3033c17d1f8ae0ae8ebfb520454e07a...54ea6742127e75346b7b1bec5faf803342bfcebb,1,7,0,7,1,2009-02-20 18:46:43,2009-02-20 18:46:43
54ea6742127e75346b7b1bec5faf803342bfcebb...c97ed5184ba394d911f03fdf00856c029a3b6ba0,7,88,20,108,27,2009-02-20 18:46:57,2009-02-20 18:46:57
c97ed5184ba394d911f03fdf00856c029a3b6ba0...e470130a5e00f0b4a5ebf995af12cf5322b4ab3a,2,9,2,11,4,2009-02-20 20:07:52,2009-02-20 20:07:52
e470130a5e00f0b4a5ebf995af12cf5322b4ab3a...2c6dd718c8c622db4a07daa5b7956ab2da01ac60,1,6,6,12,5,2009-02-20 20:07:59,2009-02-20 20:07:59
2c6dd718c8c622db4a07daa5b7956ab2da01ac60...c9556de9ab9e268b965309aef53945acef6cd51b,3,14,2,16,5,2009-02-20 20:23:14,2009-02-20 20:23:14
98d67c5b0ed3c57e751cfff25034c252a60ea3f2...93ac1411b948fe47eaa472f9138ff28d7f14168d,2,12,12,24,7,2009-02-20 20:37:24,2009-02-20 20:37:24
93ac1411b948fe47eaa472f9138ff28d7f14168d...3c33cbe8e7e0853a75e9f6e9f040a9e3f3ec1b4b,1,1,1,2,1,2009-02-20 20:56:24,2009-02-20 20:56:24
3c33cbe8e7e0853a75e9f6e9f040a9e3f3ec1b4b...27841a536354808d56544467519d3f241a0623c0,1,1,1,2,1,2009-02-20 21:12:22,2009-02-20 21:12:22
27841a536354808d56544467519d3f241a0623c0...592edec271e09307f55b8d908e7c3758d5e052e0,1,1,1,2,1,2009-02-20 21:17:34,2009-02-20 21:17:34
592edec271e09307f55b8d908e7c3758d5e052e0...e663625021eedd7effe3f93af441fda3fb591866,6,534,80,614,16,2009-02-23 14:50:31,2009-02-23 14:50:31
592edec271e09307f55b8d908e7c3758d5e052e0...a2d079b4e81b6cdff346f7e3fdd6c8572cca6bb0,2,38,2,40,5,2009-02-20 21:39:55,2009-02-20 21:39:55
a2d079b4e81b6cdff346f7e3fdd6c8572cca6bb0...b66242c027c7392ae4201357afa0aa23b2057ecd,1,1,1,2,1,2009-02-20 21:40:03,2009-02-20 21:40:03
b66242c027c7392ae4201357afa0aa23b2057ecd...441e5585b604ea7ceac5b72c48b26de2f20cdc68,1,4,0,4,1,2009-02-22 04:39:32,2009-02-22 04:39:32
441e5585b604ea7ceac5b72c48b26de2f20cdc68...00eb714709dcb980259c5d659f9c4108c6af1570,9,115,41,156,20,2009-02-22 04:39:41,2009-02-22 04:39:41
00eb714709dcb980259c5d659f9c4108c6af1570...b23ec0964ce255c638001ae14e0096a7a917f0fb,4,15,0,15,4,2009-02-23 14:50:45,2009-02-23 14:50:45
8cb20c2548152487b74fd688a8dd2581cbc72dc0...4311f257efa7e47d985eb79ceb1883bc7e7b634a,2,31,28,59,9,2009-02-23 16:11:00,2009-02-23 16:11:00
4311f257efa7e47d985eb79ceb1883bc7e7b634a...4c491e5b9e87d636514194a4ebfc40ff05624143,1,4,0,4,2,2009-02-23 16:16:33,2009-02-23 16:16:33
4c491e5b9e87d636514194a4ebfc40ff05624143...e5e195ee39dd5e1231c0229bcdf6d74a6ecbb27c,3,33,18,51,4,2009-02-23 18:56:54,2009-02-23 18:56:54
e5e195ee39dd5e1231c0229bcdf6d74a6ecbb27c...3111e5411e3860c4d5918e4b21ad7588462a5ca5,6,24,5,29,8,2009-02-23 23:05:38,2009-02-23 23:05:38
e5e195ee39dd5e1231c0229bcdf6d74a6ecbb27c...8dd621160832b55225f3ab366250a86e2fe348b3,1,3,4,7,3,2009-02-23 19:14:03,2009-02-23 19:14:03
8dd621160832b55225f3ab366250a86e2fe348b3...de62cf49bce8f5306d41913208a0a0e59864c9bb,2,36,2,38,2,2009-02-23 19:31:52,2009-02-23 19:31:52
de62cf49bce8f5306d41913208a0a0e59864c9bb...f447474a7acc19c6bf6df2fcf1248d6188a19aea,1,4,1,5,3,2009-02-23 19:32:00,2009-02-23 19:32:00
7012955860027a6302ae30112a8095566ab130a8...86c4c87be6863f596c890e431d9fe68b831760b0,9,224,98,322,81,2009-02-24 15:27:07,2009-02-24 15:27:07
7012955860027a6302ae30112a8095566ab130a8...8a87e7123b56b3e0d313732c475ceae3e9d5e023,3,38,12,50,12,2009-02-24 02:47:25,2009-02-24 02:47:25
8a87e7123b56b3e0d313732c475ceae3e9d5e023...6198d911e50d0805bab33f9910822d0926afb2f3,4,60,19,79,9,2009-02-24 03:55:58,2009-02-24 03:55:58
6198d911e50d0805bab33f9910822d0926afb2f3...c5fc4e291975c0711a5990e9e1250d6b67bdba2b,3,3,3,6,3,2009-02-24 15:21:03,2009-02-24 15:21:03
f447474a7acc19c6bf6df2fcf1248d6188a19aea...13b0d2c1cf2b33898205dd5ca6b62ced9db6c5dc,4,24,10,34,8,2009-02-23 22:26:36,2009-02-23 22:26:36
f447474a7acc19c6bf6df2fcf1248d6188a19aea...1d87ecfb110bbf306ca6fe4fcce970e08cd5d2de,1,1,1,2,1,2009-02-23 22:08:34,2009-02-23 22:08:34
010236b9c2493d5fadb10489f56093b928e61363...4fcdc84977644db761783a889c411e275e104493,5,104,22,126,19,2009-02-24 16:59:43,2009-02-24 16:59:43
4fcdc84977644db761783a889c411e275e104493...36676878dcfc9299b7874ceac65a890aea0c8b9d,4,92,12,104,11,2009-02-24 18:28:24,2009-02-24 18:28:24
010236b9c2493d5fadb10489f56093b928e61363...a7eb50116c525a9cc46afacc38c43988fe9c4b63,6,572,388,960,55,2009-02-24 16:49:55,2009-02-24 16:49:55
a7eb50116c525a9cc46afacc38c43988fe9c4b63...2bdd6b2d34c478e658f9418fd953348f5a3c9699,1,66,0,66,2,2009-02-24 17:16:07,2009-02-24 17:16:07
2bdd6b2d34c478e658f9418fd953348f5a3c9699...4e549f1f3ceaade6872a809eebd691336679a72d,2,25,0,25,3,2009-02-24 19:15:17,2009-02-24 19:15:17
c5fc4e291975c0711a5990e9e1250d6b67bdba2b...d654aa6788245d7b69c678206a1add7bd0ab850a,1,14,5,19,3,2009-02-24 18:14:08,2009-02-24 18:14:08
d654aa6788245d7b69c678206a1add7bd0ab850a...72b52650eaa627d568c837217db6c14eb32afbe0,2,10,3,13,3,2009-02-24 18:46:21,2009-02-24 18:46:21
72b52650eaa627d568c837217db6c14eb32afbe0...98c86766944dc14a8cf4b8305df1e467ddea05ef,4,158,38,196,20,2009-02-24 18:52:34,2009-02-24 18:52:34
4e7e04d59cd4d46c81380db7bea9afed6ff014bb...743665fc93543ce484a68796f4f7d7adf07bbccf,6,25,108,133,10,2009-02-23 22:55:13,2009-02-23 22:55:13
1d87ecfb110bbf306ca6fe4fcce970e08cd5d2de...c11f5249154730cde63823b1f1d52ed20895869c,1,28,3,31,8,2009-02-23 22:32:47,2009-02-23 22:32:47
c969a3c4b444f5b0496001edc3d7d25a87cef74d...a0920c525c23571618c4ba6e4a5d6619e4f90b37,1,4,2,6,3,2009-02-24 19:09:12,2009-02-24 19:09:12
a0920c525c23571618c4ba6e4a5d6619e4f90b37...500f01c9a53c7db9a2ee3b0ba9989f8379f1afe2,5,229,175,404,6,2009-02-24 19:14:45,2009-02-24 19:14:45
b257287672a19d2a9f56a6840f56f481ac3ec02d...72f2a51747d29bc28f9407ebbab11b75256c305a,6,97,124,221,32,2009-02-24 19:38:03,2009-02-24 19:38:03
72f2a51747d29bc28f9407ebbab11b75256c305a...7bfc826646013b47973d92c228d40be207f1609e,5,0,515,515,12,2009-02-24 19:41:53,2009-02-24 19:41:53
27a8e218f854f4553580bee9bc1fd922df998e40...009c4af29877bf27e1e6c2838628fe6cb7467f9a,3,2,3,5,4,2009-02-24 21:39:08,2009-02-24 21:39:08
6bf2c76169d81bb51a81262fba6df685b4c62631...a744fbf06f69d7ad9449b9a7142ffd90c2e05215,3,31,0,31,4,2009-02-24 18:36:37,2009-02-24 18:36:37
3c09f99293eb8f4fa1824e301b3352348626312a...9b3b8d33e147b17425afc6ceba563db7b9169cef,4,72,5,77,10,2009-02-23 22:43:55,2009-02-23 22:43:55
500f01c9a53c7db9a2ee3b0ba9989f8379f1afe2...1b028db7ab74733ba64c9eabca299852208d49dd,2,15,6,21,10,2009-02-24 19:22:08,2009-02-24 19:22:08
46bba3277bbde0ec4d08c11e87c5b2736f121a63...139eb1c3d8a71a833d5ec94cea5ba316e41feea8,1,0,2,2,1,2009-02-24 19:43:03,2009-02-24 19:43:03
139eb1c3d8a71a833d5ec94cea5ba316e41feea8...ca97770395b50515fab061f0fe6e8b6df72e3072,1,18,0,18,2,2009-02-24 19:51:36,2009-02-24 19:51:36
ca97770395b50515fab061f0fe6e8b6df72e3072...1517e4ede360e3f234e9b894b0bcd6e16604dc46,3,71,1,72,6,2009-02-24 20:20:29,2009-02-24 20:20:29
1517e4ede360e3f234e9b894b0bcd6e16604dc46...e3bf4578ec6fb13105f7105581797dad351c2997,1,0,2,2,1,2009-02-24 20:30:16,2009-02-24 20:30:16
e3bf4578ec6fb13105f7105581797dad351c2997...4a4b0fe4828a33f8fe8423bb533f943007f17169,3,11,4,15,8,2009-02-24 20:45:18,2009-02-24 20:45:18
4a4b0fe4828a33f8fe8423bb533f943007f17169...17b7897f1948c1fd0e9dc98a001e66ecaa4733dc,7,128,6,134,20,2009-02-24 22:48:06,2009-02-24 22:48:06
cef0228f0aa265ee4a713c2de2e4b6ce78809d38...9a6224cf76aed1c00bae3eadd7f27f64d9c7beda,2,8,0,8,2,2009-02-24 21:43:52,2009-02-24 21:43:52
9a6224cf76aed1c00bae3eadd7f27f64d9c7beda...70ad274d41d72e5eb3c36f9c22afcb2f5161f305,1,28,18,46,3,2009-02-24 21:55:56,2009-02-24 21:55:56
1b028db7ab74733ba64c9eabca299852208d49dd...900a7f315f53459ade96c1e312594afc49fcda72,1,0,39,39,1,2009-02-24 21:02:57,2009-02-24 21:02:57
900a7f315f53459ade96c1e312594afc49fcda72...630e468d615843df4f829988e6ccb9bb4965e5d4,1,3,0,3,1,2009-02-24 21:09:22,2009-02-24 21:09:22
0d8dded1c334e8738a3010fdf80a4407bf520a88...b1341cf0007d2a2aa398a9f76c32b9b00ecb8484,4,10,3,13,10,2009-02-24 23:23:11,2009-02-24 23:23:11
b1341cf0007d2a2aa398a9f76c32b9b00ecb8484...1f671740665515b09a863e436ca4d4f9b88077e8,2,12,2,14,3,2009-02-24 23:32:08,2009-02-24 23:32:08
1f671740665515b09a863e436ca4d4f9b88077e8...dee1ff96b96c6014aacee8a9c4e6576e038d042e,2,2,2,4,2,2009-02-24 23:37:42,2009-02-24 23:37:42
dee1ff96b96c6014aacee8a9c4e6576e038d042e...9722627a0246bddcb08d3bb32b63503d3538a95e,2,7,13,20,3,2009-02-25 15:06:56,2009-02-25 15:06:56
9722627a0246bddcb08d3bb32b63503d3538a95e...222ea643ad4d8484957bd4e91ae9ca996a73bba3,4,101,18,119,24,2009-02-25 15:48:41,2009-02-25 15:48:41
70ad274d41d72e5eb3c36f9c22afcb2f5161f305...06ec54c285a2e1772cbedcdd918cc9654f718622,1,20,15,35,9,2009-02-24 22:44:56,2009-02-24 22:44:56
630e468d615843df4f829988e6ccb9bb4965e5d4...d18d71b1693569bd564cfd7918655101b7eb5c0e,1,3,0,3,1,2009-02-24 22:09:21,2009-02-24 22:09:21
d18d71b1693569bd564cfd7918655101b7eb5c0e...46987b29784a7a21916ff5d26db4254f1ba714dc,2,39,0,39,2,2009-02-24 22:09:46,2009-02-24 22:09:46
f28536cc201d7b29fdc3819fdf502c460dd82078...bedaec41423385f9cd68d8cdd8d875cd240a0eba,2,7,8,15,5,2009-02-25 16:06:03,2009-02-25 16:06:03
7a5490d2bde1d5fa0469d32f1c093291a3b5d52b...28d9cdb43b7d23fbf6a14654844941c35e440cf2,2,17,10,27,7,2009-02-24 23:53:34,2009-02-24 23:53:34
28d9cdb43b7d23fbf6a14654844941c35e440cf2...585c669cbf21caae51496f83fe4c6aa858e500b4,1,1,1,2,1,2009-02-25 05:05:23,2009-02-25 05:05:23
585c669cbf21caae51496f83fe4c6aa858e500b4...dbbbdf47877886a65c5428f1a9f7578129687076,4,54,8,62,13,2009-02-25 05:40:38,2009-02-25 05:40:38
dbbbdf47877886a65c5428f1a9f7578129687076...7b815a4a9801dfd7a6ff6ecbb4163160f8bee8fd,5,331,293,624,7,2009-02-25 05:57:31,2009-02-25 05:57:31
7b815a4a9801dfd7a6ff6ecbb4163160f8bee8fd...4c98640678f0e92ef60a621ec843aa7d296d1060,3,67,8,75,13,2009-02-25 06:23:58,2009-02-25 06:23:58
4c98640678f0e92ef60a621ec843aa7d296d1060...792a3434f590a3ffb5ece355705df16d8fe97baa,1,2,1,3,1,2009-02-25 12:55:52,2009-02-25 12:55:52
ec09c3973909d360319907ddee29a817d9ce9e69...2e7fe8df5d30b1f7b173c0a35c281f4c5ea1aa17,2,104,2,106,4,2009-02-24 22:14:11,2009-02-24 22:14:11
2e7fe8df5d30b1f7b173c0a35c281f4c5ea1aa17...b6423ebb27a1c9b3b537961e6f9cb2dfd8796625,1,4,2,6,3,2009-02-24 22:15:38,2009-02-24 22:15:38
f026c6825d3e9edf7f944c54d3936a60747e7cd1...df4bf72f3d3bb419bdeaaf3dfe90491cb7349d2b,3,32,0,32,6,2009-02-25 16:33:03,2009-02-25 16:33:03
792a3434f590a3ffb5ece355705df16d8fe97baa...5bfb5fc082b31e3e59a7829f34593274abbc7599,1,6,0,6,1,2009-02-25 15:52:11,2009-02-25 15:52:11
df4bf72f3d3bb419bdeaaf3dfe90491cb7349d2b...445b4d915a6f67f10610d57cd1143a0fec93bc55,1,1,1,2,1,2009-02-25 17:35:45,2009-02-25 17:35:45
df4bf72f3d3bb419bdeaaf3dfe90491cb7349d2b...adeeae1f2f6d92266b5bdb73774ec076477ce935,2,105,219,324,13,2009-02-25 17:25:01,2009-02-25 17:25:01
adeeae1f2f6d92266b5bdb73774ec076477ce935...2338122f64b65e52c94e0b9a468ae6253ecb63ae,1,6,6,12,3,2009-02-25 17:37:15,2009-02-25 17:37:15
5bfb5fc082b31e3e59a7829f34593274abbc7599...cb7c871fbadb8d4f6bf1ae44e8079da7da3ea715,1,2,1,3,2,2009-02-25 19:15:00,2009-02-25 19:15:00
cb7c871fbadb8d4f6bf1ae44e8079da7da3ea715...b8dac08cff7c1484f2176112d8d8e268ce169732,1,17,2,19,5,2009-02-25 19:18:06,2009-02-25 19:18:06
b8dac08cff7c1484f2176112d8d8e268ce169732...c32fcc486262b8c157650fb08d68feecf49bcacc,1,1,1,2,1,2009-02-25 19:20:54,2009-02-25 19:20:54
78972d9bd9eb670e24d40da3b834ddb3b8399f85...f3e80befb654f7555238671a1623e042231c951e,2,62,6,68,3,2009-02-25 19:32:26,2009-02-25 19:32:26
f3e80befb654f7555238671a1623e042231c951e...7325450ff2b45b43d18acc91cb624daf10a88207,3,52,23,75,6,2009-02-25 20:01:07,2009-02-25 20:01:07
7325450ff2b45b43d18acc91cb624daf10a88207...e6ed67e5fd647f32c544d7bfc8c48addf2b68106,2,4,66,70,6,2009-02-25 20:11:58,2009-02-25 20:11:58
e6ed67e5fd647f32c544d7bfc8c48addf2b68106...6a5484ad3e3b3547fb190a35edcbff367e4bfc6c,1,1,1,2,1,2009-02-25 20:31:31,2009-02-25 20:31:31
6a5484ad3e3b3547fb190a35edcbff367e4bfc6c...bcb1b24bd6b544c4dc0cfee8ab4a4274b7a56a62,6,11,289,300,14,2009-02-25 20:31:38,2009-02-25 20:31:38
bcb1b24bd6b544c4dc0cfee8ab4a4274b7a56a62...181a20030966a1c0e21d816a1a3e7d65e1b11b6f,2,15,1,16,4,2009-02-25 20:59:01,2009-02-25 20:59:01
181a20030966a1c0e21d816a1a3e7d65e1b11b6f...c7cc5c6b4ba6a9b05094e66cbdd364c847b86e39,3,9,9,18,9,2009-02-25 21:03:09,2009-02-25 21:03:09
78972d9bd9eb670e24d40da3b834ddb3b8399f85...92713cef1c1177b6cb80ef1c4809b8a2cba32c54,1,0,1,1,1,2009-02-25 18:34:36,2009-02-25 18:34:36
60f443b9b181828f192f95ca0cc614b09bbc0a85...b38abe6dc35e42fa97f3efc0886db533346823fc,5,34,24,58,24,2009-02-25 19:23:53,2009-02-25 19:23:53
b38abe6dc35e42fa97f3efc0886db533346823fc...8e1a768685c5ff26bb202abfa37396a51a5ea887,3,6,1,7,3,2009-02-25 20:56:15,2009-02-25 20:56:15
a1775e941a356054306d234f0b52d64e5de64aec...707b932df4262b85226ac22e6105d1e975d833f4,1,48,0,48,2,2009-02-25 21:37:12,2009-02-25 21:37:12
8e1a768685c5ff26bb202abfa37396a51a5ea887...f95bfb7a5ba6979a85dab2a1a37517d16565d280,2,10,11,21,12,2009-02-25 21:19:56,2009-02-25 21:19:56
b4b3c9ba61984244bdc839abc5ebcc41264f3c5e...5656a475dbb94ad4de1b00634602fdfe40846d94,5,91,17,108,24,2009-02-26 00:22:54,2009-02-26 00:22:54
f95bfb7a5ba6979a85dab2a1a37517d16565d280...5c74c8df81b6b0becee138b41389f33311009a9d,4,42,34,76,25,2009-02-25 21:46:10,2009-02-25 21:46:10
adcf71c3c35315bc8ea38cbcccfa585b0aa16e06...ddbda7bd76e8db38c3439a5be8f6882ea06c81ca,3,21,10,31,8,2009-02-26 16:31:08,2009-02-26 16:31:08
adcf71c3c35315bc8ea38cbcccfa585b0aa16e06...481f0339645c771be1cc9a5fe63dac1b424d2612,2,27,24,51,6,2009-02-26 15:28:27,2009-02-26 15:28:27
481f0339645c771be1cc9a5fe63dac1b424d2612...851e5545a1da9dbcca0b7e8273655760190d779b,2,18,16,34,10,2009-02-26 15:44:19,2009-02-26 15:44:19
adcf71c3c35315bc8ea38cbcccfa585b0aa16e06...a49b8578874a1269f6f4f0337f5a170977850afa,3,14,15,29,9,2009-02-26 14:47:25,2009-02-26 14:47:25
a49b8578874a1269f6f4f0337f5a170977850afa...2212fb89743f0294a6704ae68220164352971771,2,4,3,7,3,2009-02-26 15:14:50,2009-02-26 15:14:50
2212fb89743f0294a6704ae68220164352971771...47d36c761ea2306ea7595e48ea99fe6eb3e0e4fa,12,179,232,411,70,2009-02-26 17:01:24,2009-02-26 17:01:24
7575ede757aa661730c4aa3eb20c6c6fc981b627...27b8b36c9900eb29e70ca3f24a071c91514bc4af,4,34,28,62,21,2009-02-26 17:02:43,2009-02-26 17:02:43
851e5545a1da9dbcca0b7e8273655760190d779b...f1ad2c2875f410af07070083fd03317c662a50f6,3,8,5,13,5,2009-02-26 16:08:23,2009-02-26 16:08:23
f1ad2c2875f410af07070083fd03317c662a50f6...ddb69bda2eb74fd0aa94ea8b727897590a15703e,3,32,6,38,9,2009-02-26 16:13:36,2009-02-26 16:13:36
ddb69bda2eb74fd0aa94ea8b727897590a15703e...8ccde5ae02bd3b3afd3db0db39ffc66e08d8ef5a,2,13,2,15,4,2009-02-26 16:20:19,2009-02-26 16:20:19
8ccde5ae02bd3b3afd3db0db39ffc66e08d8ef5a...4eae90b0a6fc1b1e59fcd1c2de7afde2d85fb328,4,13,8,21,9,2009-02-26 16:33:23,2009-02-26 16:33:23
a828c99d8799936bc7a7e0be2b592bca3b285d5a...c7496cc9bfdd12324d5cfed21f58ddd9e9ffa1c2,1,2,2,4,2,2009-02-26 17:12:25,2009-02-26 17:12:25
c7496cc9bfdd12324d5cfed21f58ddd9e9ffa1c2...e910263ed246b5964d57e5b45119463ac9b3b67f,1,1,1,2,1,2009-02-26 17:16:48,2009-02-26 17:16:48
7225f8d37b8e8f8d8175c2b1ba135e9f0d1e61f6...5a261ed67851ad71cb36c8208e8a7325854064fc,6,503,76,579,45,2009-02-27 16:04:36,2009-02-27 16:04:36
e910263ed246b5964d57e5b45119463ac9b3b67f...76304fd05772345e7c57bb855c9b8a24f5cb1614,2,46,12,58,4,2009-02-26 20:02:18,2009-02-26 20:02:18
e910263ed246b5964d57e5b45119463ac9b3b67f...09bfd068ba334d5143ec0ad878fe5bae8eab2861,3,13,0,13,3,2009-02-26 19:55:53,2009-02-26 19:55:53
ad725ff5c2e1f4271a401d64b30034e5b637aaf9...46f957313cca4894a61be81c9165fbb98fc5352a,1,6,4,10,3,2009-02-27 16:14:05,2009-02-27 16:14:05
347c6a862fe24b04f97039a7b4d3e7dda302bd76...d8661d9b0825df64aae0714274440ab06fb6a802,2,46,0,46,4,2009-02-26 20:21:47,2009-02-26 20:21:47
09bfd068ba334d5143ec0ad878fe5bae8eab2861...4d3100a66d881093cb1d7ae1a1af481845585012,2,10,1,11,8,2009-02-26 20:09:44,2009-02-26 20:09:44
650a4f9e7cee9965ac96974d87ad248a110c496e...2f54ed92c1f09a6a7f6233ddf20078f88bb15ef5,1,0,2,2,1,2009-02-27 16:48:12,2009-02-27 16:48:12
2f54ed92c1f09a6a7f6233ddf20078f88bb15ef5...9ba067542d2cbad8fe8f940556cecfe13154dc31,2,10,0,10,9,2009-02-27 16:48:39,2009-02-27 16:48:39
9ba067542d2cbad8fe8f940556cecfe13154dc31...6b73f79c2178b877735b80287ca3665fd76870c0,1,28,24,52,17,2009-02-27 17:18:34,2009-02-27 17:18:34
ce06c18f4c144b3cdb119e631d60f51453ed85e7...3722075618f2cfd20a5bd1251895610989df8669,3,37,4,41,5,2009-02-26 20:55:00,2009-02-26 20:55:00
87967c1ba2f4448208819bbf163d38c2ef1a845c...eb18afd65367cf5ebdd908cf1922c1972186b959,3,34,20,54,10,2009-02-26 20:53:33,2009-02-26 20:53:33
6b73f79c2178b877735b80287ca3665fd76870c0...4427a23bc7ac9f3be4c2bcaac14db1df53f4513d,2,19,0,19,4,2009-02-27 19:04:19,2009-02-27 19:04:19
18c7965db4c67ff00eb8ac9d93db078c59aee22e...81f394da6130757fc048a2e669338ee0ba8c3496,1,16,2,18,7,2009-02-26 22:01:56,2009-02-26 22:01:56
81f394da6130757fc048a2e669338ee0ba8c3496...c61536f8c239639be25088935b4a534caa155704,1,70,0,70,1,2009-02-26 22:32:52,2009-02-26 22:32:52
c61536f8c239639be25088935b4a534caa155704...0dc0ff0541b9e85e0533456c6169d1130503dd07,5,5,5,10,5,2009-02-27 15:37:13,2009-02-27 15:37:13
f262a6da7402405bcef3e25b37ad295c51bc9e22...cedd4f00088955c435479bfe8783b113974111a9,3,16,4,20,8,2009-02-27 19:23:52,2009-02-27 19:23:52
cedd4f00088955c435479bfe8783b113974111a9...6399e12c728a2bb1278e08c2369101412f4ae999,1,5,5,10,4,2009-02-27 19:24:01,2009-02-27 19:24:01
6399e12c728a2bb1278e08c2369101412f4ae999...63e5764fe20724a81b041f29333bcbb558094862,10,189,27,216,30,2009-02-27 22:18:56,2009-02-27 22:18:56
63e5764fe20724a81b041f29333bcbb558094862...2075fa77f1fe9794363dd1a0359938e96d0aeb36,2,10,10,20,7,2009-02-27 22:29:24,2009-02-27 22:29:24
2075fa77f1fe9794363dd1a0359938e96d0aeb36...5c38fa8e4c4f0adc7ff2fc7c29472208ad956add,1,1,1,2,1,2009-02-27 22:32:27,2009-02-27 22:32:27
5c38fa8e4c4f0adc7ff2fc7c29472208ad956add...9d792eb0c5a9d15e3c2cbd2520236588a69c520c,8,37,55,92,29,2009-02-27 23:14:45,2009-02-27 23:14:45
0dc0ff0541b9e85e0533456c6169d1130503dd07...dfe0cff3084d638892f30d7a880c4fc9947d5f9f,2,24,9,33,11,2009-02-27 17:51:49,2009-02-27 17:51:49
0dc0ff0541b9e85e0533456c6169d1130503dd07...81a684ee5f4035a5fe09dc116b5fc2880ef39c65,1,1,1,2,1,2009-02-27 15:48:22,2009-02-27 15:48:22
9d792eb0c5a9d15e3c2cbd2520236588a69c520c...c6a4f25e169c017317c55f336d7c92f8406e20bc,3,23,1,24,5,2009-02-28 23:44:31,2009-02-28 23:44:31
9d792eb0c5a9d15e3c2cbd2520236588a69c520c...d9ceecba23e7ac6d1b14caadd01bcbf9365277e3,2,8,4,12,6,2009-02-28 14:38:41,2009-02-28 14:38:41
81a684ee5f4035a5fe09dc116b5fc2880ef39c65...4487004dac25a0477c6d540089d27b498da943ec,3,57,11,68,17,2009-02-27 16:22:12,2009-02-27 16:22:12
46ec32bacd07440ddf124d4dcb07a4ab0b5d407c...b1a1e98294eb806e1e3e45a787ee2ccda361843e,4,49,14,63,5,2009-02-28 23:55:04,2009-02-28 23:55:04
b1a1e98294eb806e1e3e45a787ee2ccda361843e...c1207fddd58efbd938c5c58bf711554049f3d6f9,4,10,10,20,10,2009-03-02 04:43:00,2009-03-02 04:43:00
c1207fddd58efbd938c5c58bf711554049f3d6f9...13b828f59247baa73f9389f3975cd6203ed36bc1,3,162,0,162,3,2009-03-02 14:13:20,2009-03-02 14:13:20
13b828f59247baa73f9389f3975cd6203ed36bc1...1cc5eff3e54c8197fae21825f032341f7a87bbdb,1,1,1,2,1,2009-03-02 14:14:56,2009-03-02 14:14:56
1cc5eff3e54c8197fae21825f032341f7a87bbdb...8a711dc649631d0e57db46cddc4ed3b6d69ff486,2,16,0,16,3,2009-03-02 14:57:22,2009-03-02 14:57:22
8a711dc649631d0e57db46cddc4ed3b6d69ff486...f7f6348d2fc22761450d4bf40f72057de44b2d9e,2,50,17,67,20,2009-03-02 14:57:43,2009-03-02 14:57:43
f7f6348d2fc22761450d4bf40f72057de44b2d9e...253a49d2a135d6542d89750586635000016d468f,8,30,16,46,17,2009-03-02 15:41:36,2009-03-02 15:41:36
253a49d2a135d6542d89750586635000016d468f...dad75855e8ff7509559c10efe1fd5d1cbb52655e,7,60,42,102,35,2009-03-02 16:31:13,2009-03-02 16:31:13
dad75855e8ff7509559c10efe1fd5d1cbb52655e...e6980f2e83fafe0695636698aaa00a5385b30499,1,2,1,3,2,2009-03-02 18:18:47,2009-03-02 18:18:47
e6980f2e83fafe0695636698aaa00a5385b30499...b5d11b9350a26fb579dd64f082e4c436b6c5ad6e,5,89,48,137,42,2009-03-02 18:42:31,2009-03-02 18:42:31
f7f6348d2fc22761450d4bf40f72057de44b2d9e...61e7c9660a6aad460fd761d3239a5831af19f13e,1,10,0,10,1,2009-03-02 15:32:01,2009-03-02 15:32:01
61e7c9660a6aad460fd761d3239a5831af19f13e...cc95f740660b9acb51b1204f1e334c16ca7f840c,1,26,31,57,13,2009-03-02 15:32:29,2009-03-02 15:32:29
cc95f740660b9acb51b1204f1e334c16ca7f840c...474d2c0d2465a686c01ed8a9f22deb485281563f,4,80,48,128,11,2009-03-02 18:35:34,2009-03-02 18:35:34
67d39935dc11443690091ec246a3d6329fbe2aa0...f5e4fe8cd62fbd65927112e8e6cfa98af2520bd7,5,51,40,91,14,2009-03-02 21:03:48,2009-03-02 21:03:48
474d2c0d2465a686c01ed8a9f22deb485281563f...e7b0796b51bedf155afe89bc2645de4a86ba0ed3,2,15,11,26,11,2009-03-02 21:49:16,2009-03-02 21:49:16
474d2c0d2465a686c01ed8a9f22deb485281563f...062213eaef50f266771c8dd622b9cd0d9ef68cfe,1,29,12,41,5,2009-03-02 21:27:35,2009-03-02 21:27:35
062213eaef50f266771c8dd622b9cd0d9ef68cfe...e5d3feefbed6aa07e73578d5a84016e59b682ec3,1,2,0,2,1,2009-03-02 21:49:05,2009-03-02 21:49:05
c8c7ae441e2c097d1989c3e683b611823b1054be...d41ad266353999417d5a3c96c9ff5a9bc45ccefd,3,4,10,14,7,2009-03-02 22:12:02,2009-03-02 22:12:02
d41ad266353999417d5a3c96c9ff5a9bc45ccefd...930f169fd74b473ab841f7a17f66302f630fc443,2,29,5,34,6,2009-03-02 23:16:27,2009-03-02 23:16:27
930f169fd74b473ab841f7a17f66302f630fc443...d33b631a6d00e6e362254ec3c1b8337d8c369669,1,2,5,7,2,2009-03-02 23:32:12,2009-03-02 23:32:12
d33b631a6d00e6e362254ec3c1b8337d8c369669...70263570bb4068171468c05fe68b6b5c38c1dd14,1,0,3,3,2,2009-03-02 23:33:03,2009-03-02 23:33:03
70263570bb4068171468c05fe68b6b5c38c1dd14...5ca50873ab4b20bcaec6fcbe4800f9f0d469e387,1,1,1,2,1,2009-03-02 23:39:10,2009-03-02 23:39:10
5ca50873ab4b20bcaec6fcbe4800f9f0d469e387...4c40455a5c88f953996b6ee13f3578c7571e1cc3,1,9,1,10,1,2009-03-03 17:46:31,2009-03-03 17:46:31
4c40455a5c88f953996b6ee13f3578c7571e1cc3...56dacac4d7a9ec9180cf946512aeed81c799c2b8,1,1,1,2,1,2009-03-03 19:02:06,2009-03-03 19:02:06
56dacac4d7a9ec9180cf946512aeed81c799c2b8...dbaa985014311d07587bb282cc1944265b94d97d,4,20,6,26,8,2009-03-03 20:27:22,2009-03-03 20:27:22
dbaa985014311d07587bb282cc1944265b94d97d...c606e654779f97858617a450c4525a6687455875,1,1,1,2,1,2009-03-03 20:28:15,2009-03-03 20:28:15
c606e654779f97858617a450c4525a6687455875...e641c778442a253be83f18f4cc5aaf7a819a0610,3,6,4,10,4,2009-03-03 20:32:51,2009-03-03 20:32:51
e641c778442a253be83f18f4cc5aaf7a819a0610...bab49f4951b709dc98c60cbb1661863b12f3b556,1,2,0,2,1,2009-03-03 20:37:54,2009-03-03 20:37:54
bab49f4951b709dc98c60cbb1661863b12f3b556...1839efb94dfae22334e1db57fb098d2a722334c3,4,17,8,25,7,2009-03-03 21:10:42,2009-03-03 21:10:42
bab49f4951b709dc98c60cbb1661863b12f3b556...a039cf7ec785f55e59429ba67747e999eec14f9e,2,18,6,24,5,2009-03-03 21:06:57,2009-03-03 21:06:57
72a7d08cd4031ace833b693ad41f1a8c88ab6868...2ba030abe039dadc3f2c4bebfcb671fcab950d03,8,43,48,91,20,2009-03-03 22:30:26,2009-03-03 22:30:26
2ba030abe039dadc3f2c4bebfcb671fcab950d03...3362ca0cc4e3b7874e8383f85aee630d7894d9cc,1,0,1,1,1,2009-03-03 22:31:23,2009-03-03 22:31:23
3362ca0cc4e3b7874e8383f85aee630d7894d9cc...69f25ba1fd6059ccbf3763ebe08930b29fa54e00,1,1,1,2,1,2009-03-03 23:09:03,2009-03-03 23:09:03
69f25ba1fd6059ccbf3763ebe08930b29fa54e00...54160011dec1379485165ec410827521f4510f47,1,5,1,6,1,2009-03-04 13:18:50,2009-03-04 13:18:50
54160011dec1379485165ec410827521f4510f47...ae7864878173cd9274abf8a97414317bb7b8ce20,7,128,22,150,26,2009-03-04 20:57:35,2009-03-04 20:57:35
ae7864878173cd9274abf8a97414317bb7b8ce20...151383de17f5db1ed3e3930d8c18f7ff3e11abf4,1,29,0,29,1,2009-03-04 20:57:59,2009-03-04 20:57:59
151383de17f5db1ed3e3930d8c18f7ff3e11abf4...9be10a4f9844d669f6ccdc46b844d9f9a7283900,1,18,3,21,3,2009-03-04 21:55:24,2009-03-04 21:55:24
9be10a4f9844d669f6ccdc46b844d9f9a7283900...46e6c6b4752f376af1439260750fc1ce578e2ab5,3,112,90,202,13,2009-03-05 05:07:09,2009-03-05 05:07:09
46e6c6b4752f376af1439260750fc1ce578e2ab5...0a291f69580e26a9796135fd6906c9acaa409fd8,4,108,13,121,12,2009-03-05 21:06:11,2009-03-05 21:06:11
0a291f69580e26a9796135fd6906c9acaa409fd8...324e716f2f680542e8693eec70b475278eee2c1a,2,37,5,42,12,2009-03-05 23:19:43,2009-03-05 23:19:43
324e716f2f680542e8693eec70b475278eee2c1a...bb5caefeecc861587d89820a3699f0212567ce28,1,22,0,22,1,2009-03-05 23:49:40,2009-03-05 23:49:40
bb5caefeecc861587d89820a3699f0212567ce28...abf2d9af37e56d9a37bd7ffb6d33efdf8ad7c018,2,6,3,9,5,2009-03-05 23:53:04,2009-03-05 23:53:04
abf2d9af37e56d9a37bd7ffb6d33efdf8ad7c018...bf123c29251e1691f3c451adae3c7cb84c4b1130,1,0,1,1,1,2009-03-05 23:55:09,2009-03-05 23:55:09
bf123c29251e1691f3c451adae3c7cb84c4b1130...feb63537e1725fa2bae95fa4501575b08aaba298,3,28,12,40,12,2009-03-06 00:58:07,2009-03-06 00:58:07
54160011dec1379485165ec410827521f4510f47...5ca0a571e577ad20c9047c0882311d3a2f9b11f1,2,5,5,10,5,2009-03-04 18:54:56,2009-03-04 18:54:56
9a993fcb2e312a35a4fc1cc5e389dfa9e596acae...c15844c52e8e671f859b85f3cb2cb4bbd214dd51,1,2,2,4,2,2009-03-06 15:02:27,2009-03-06 15:02:27
c15844c52e8e671f859b85f3cb2cb4bbd214dd51...da1da8d5478c86e56975d6562ad196875f656a0a,1,3,3,6,3,2009-03-06 15:05:15,2009-03-06 15:05:15
5ca0a571e577ad20c9047c0882311d3a2f9b11f1...8431f60b10b16aaca1dd406c5c7013a74525e02e,3,78,19,97,12,2009-03-06 18:12:00,2009-03-06 18:12:00
da1da8d5478c86e56975d6562ad196875f656a0a...316f47d1a500e357e9610d033b602335826250a2,2,8,2,10,5,2009-03-06 15:26:01,2009-03-06 15:26:01
da1da8d5478c86e56975d6562ad196875f656a0a...d563bf486b8dbf5724b569bd9e6bfcdad16bdd10,1,1,0,1,1,2009-03-06 15:22:32,2009-03-06 15:22:32
cbf2332fdaeeef0b5c9621f4b80efeaa71125059...981753596860191eff001af1afd24d64c2717012,4,35,13,48,14,2009-03-06 15:45:35,2009-03-06 15:45:35
981753596860191eff001af1afd24d64c2717012...20e6ea6b8e7f1c43853b1929cb9aad1578e8e7c9,3,19,3,22,6,2009-03-06 16:08:30,2009-03-06 16:08:30
20e6ea6b8e7f1c43853b1929cb9aad1578e8e7c9...eb683286201fde971a249f43ecfd1b33f21ff63d,5,65,13,78,19,2009-03-06 16:51:44,2009-03-06 16:51:44
eb683286201fde971a249f43ecfd1b33f21ff63d...0e663e18c1ae52df56c72504de76a479cc4134d9,1,13,0,13,2,2009-03-06 18:13:07,2009-03-06 18:13:07
0e663e18c1ae52df56c72504de76a479cc4134d9...384864c5b945beee8a30b1fa1c98af59d4cfabeb,1,1,1,2,1,2009-03-06 18:18:22,2009-03-06 18:18:22
7dbee8a1520c6247991ca7f68cf942fd50272e9a...0f3069a4a5fcc713af60eaaa4983909285df8ac8,1,20,0,20,1,2009-03-06 21:44:16,2009-03-06 21:44:16
0f3069a4a5fcc713af60eaaa4983909285df8ac8...74ab32161ee71e2051570337d129e06f77146b3e,1,7,3,10,4,2009-03-09 20:06:19,2009-03-09 20:06:19
384864c5b945beee8a30b1fa1c98af59d4cfabeb...8730dc9d0206e4b588333411bd2a3c4e44b79bb9,2,2,2,4,2,2009-03-06 18:42:52,2009-03-06 18:42:52
8730dc9d0206e4b588333411bd2a3c4e44b79bb9...9b3af26cbe066e80d9bc591ca9efd7bede750c49,1,2,0,2,1,2009-03-06 18:44:38,2009-03-06 18:44:38
9b3af26cbe066e80d9bc591ca9efd7bede750c49...fd722b71e0bf0dfca6618e5e9f9225cb8ec5c983,1,1,1,2,1,2009-03-06 18:47:02,2009-03-06 18:47:02
b4ff0befae79396e0bc37b46a15bd987229a5dfb...56e81849a0c92bd9249dbd504a0978a94dd68aba,5,32,5,37,9,2009-03-10 00:02:02,2009-03-10 00:02:02
fd722b71e0bf0dfca6618e5e9f9225cb8ec5c983...db9a5968f26261fcea20ee3e80df2f07ab2fee8f,1,213,35,248,24,2009-03-09 22:33:56,2009-03-09 22:33:56
56e81849a0c92bd9249dbd504a0978a94dd68aba...7e2bb88e77fd54d2dc926d94eff9a1ad0285e6a5,1,1,20,21,3,2009-03-10 14:18:40,2009-03-10 14:18:40
7e2bb88e77fd54d2dc926d94eff9a1ad0285e6a5...1374665894bf44e40d9afb3f96044162b3fd6c08,3,9,2,11,5,2009-03-10 14:54:00,2009-03-10 14:54:00
56e81849a0c92bd9249dbd504a0978a94dd68aba...3931f7efcbc207d91b28cbf74c8cbd4e9cf4df9f,5,5,32,37,9,2009-03-10 14:14:37,2009-03-10 14:14:37
1374665894bf44e40d9afb3f96044162b3fd6c08...d3dfec4799b2b979f133806c9167f7f79ac7d589,1,5,2,7,1,2009-03-10 17:08:27,2009-03-10 17:08:27
b5a5e6f756c1dafcd9b1c10a704dc3985c0623c5...dc197ff71a24cc4a8725643605fddb2ace55e0bf,2,64,16,80,11,2009-03-10 19:06:47,2009-03-10 19:06:47
dc197ff71a24cc4a8725643605fddb2ace55e0bf...5a77cd187b9b6543aa4c927490944e34fb842639,1,10,1,11,2,2009-03-10 19:26:26,2009-03-10 19:26:26
5a77cd187b9b6543aa4c927490944e34fb842639...7d842995d98c06a289d3ceda87f7eef2658bdd12,1,3,0,3,1,2009-03-10 19:32:59,2009-03-10 19:32:59
7d842995d98c06a289d3ceda87f7eef2658bdd12...d4fad81da14cf89587592f0188ca0cdfb5d4d38c,3,63,4,67,12,2009-03-10 20:49:17,2009-03-10 20:49:17
d4fad81da14cf89587592f0188ca0cdfb5d4d38c...99dd91cddc123b123bccc6ea974af21c132c9d4c,2,22,1,23,4,2009-03-11 15:58:26,2009-03-11 15:58:26
99dd91cddc123b123bccc6ea974af21c132c9d4c...712673263b1bc0d3f9397c0ffc675f26219a860c,2,12,4,16,4,2009-03-11 17:49:54,2009-03-11 17:49:54
712673263b1bc0d3f9397c0ffc675f26219a860c...f1ca868a269b78db93c314d4ba07f4fc4f590bff,1,5,5,10,5,2009-03-11 18:10:20,2009-03-11 18:10:20
d4fad81da14cf89587592f0188ca0cdfb5d4d38c...502e20f1cc89500d36119bf9c8656ee37ae28240,3,125,17,142,20,2009-03-11 14:31:47,2009-03-11 14:31:47
502e20f1cc89500d36119bf9c8656ee37ae28240...93ac9027cd8842abda55d26fd276983932deeb25,3,23,10,33,9,2009-03-11 21:37:25,2009-03-11 21:37:25
f1ca868a269b78db93c314d4ba07f4fc4f590bff...c02272c31d14fda3bc5863f6e50ac48f3c611be4,7,209,28,237,27,2009-03-13 15:56:28,2009-03-13 15:56:28
f1ca868a269b78db93c314d4ba07f4fc4f590bff...3055ab6d1de96207c9e372d0808ae8d75a7cd2b3,5,87,62,149,27,2009-03-11 21:05:50,2009-03-11 21:05:50
3055ab6d1de96207c9e372d0808ae8d75a7cd2b3...1bf6caeb4cd8ef05c14759a7dad9315ed3acda46,1,43,0,43,2,2009-03-11 21:19:08,2009-03-11 21:19:08
f1ca868a269b78db93c314d4ba07f4fc4f590bff...d4aad4434615b35164f56a5b430a0cdf5990e86b,1,6,0,6,1,2009-03-11 21:02:34,2009-03-11 21:02:34
d4aad4434615b35164f56a5b430a0cdf5990e86b...300485189de6f093c81de53b5bb43368648a7dea,1,1,1,2,1,2009-03-11 21:02:57,2009-03-11 21:02:57
300485189de6f093c81de53b5bb43368648a7dea...a58e2ce7bd475a3cc86c8955c6600fca716a94dd,1,2,1,3,1,2009-03-11 21:03:05,2009-03-11 21:03:05
a58e2ce7bd475a3cc86c8955c6600fca716a94dd...d02951083c18df6a2d9bcce0e40621ba0603a6ff,3,190,1,191,4,2009-03-11 21:28:49,2009-03-11 21:28:49
2f5201c7e78fbff4240c7d7077f6775a02b362ca...26be29395e34ade6c62dba4024c4dbcb7f39b59f,4,75,33,108,21,2009-03-11 22:47:16,2009-03-11 22:47:16
c5df475456bc5a9d6a10dc846075bd3f515852b1...812cc0edd2cf190d4d4ec2d5435d3a01114c5f85,2,11,19,30,9,2009-03-13 19:23:38,2009-03-13 19:23:38
26be29395e34ade6c62dba4024c4dbcb7f39b59f...04e03fccc31753184db1a4cde15b16b50ee89272,1,13,5,18,5,2009-03-12 15:01:52,2009-03-12 15:01:52
26be29395e34ade6c62dba4024c4dbcb7f39b59f...503fec523d155d8111ea933579ff0e4466a39aaf,1,3,1,4,2,2009-03-12 13:30:14,2009-03-12 13:30:14
503fec523d155d8111ea933579ff0e4466a39aaf...e2d87d8b1fbbdee7f77b9f7d6cecbf853e47d1de,1,6,2,8,3,2009-03-12 13:54:21,2009-03-12 13:54:21
00440593d5335f7322210de5e5e4e48b2ea1b8b1...3a1c70f6621faeaadad21ed3809d1f303f1e0061,1,3,0,3,1,2009-03-16 20:02:16,2009-03-16 20:02:16
3a1c70f6621faeaadad21ed3809d1f303f1e0061...5cd0f0e376ad4645f0741427cf50306ae80374ff,6,39,2,41,8,2009-03-17 14:22:26,2009-03-17 14:22:26
e75153655b986fc45046b845e339f5588bfffd92...49582758e55523db44d443495e67a0cef8d5ccf7,1,71,12,83,5,2009-03-13 16:18:33,2009-03-13 14:12:52
49582758e55523db44d443495e67a0cef8d5ccf7...f5ec84548ad2364cd01b038ef7667c68c746855c,1,2,0,2,1,2009-03-13 18:32:38,2009-03-13 18:32:38
23fff1638596737e6fe3da1c8dfcece34ce9eb04...22ff73a20f1d2190fccc51c782b2539a6545edde,1,12,2,14,4,2009-03-12 15:53:50,2009-03-12 15:53:50
22ff73a20f1d2190fccc51c782b2539a6545edde...6299748ad41ccf8c0c59593ad936c96d3495c64b,1,10,5,15,5,2009-03-12 16:21:07,2009-03-12 16:21:07
6299748ad41ccf8c0c59593ad936c96d3495c64b...f6dad13a8f8e82ee7a54060f00251a231c8a72c8,4,187,148,335,7,2009-03-12 17:08:16,2009-03-12 17:08:16
f6dad13a8f8e82ee7a54060f00251a231c8a72c8...abc5ac640e52285c881f1e34f82a7a013301eba6,1,40,10,50,5,2009-03-12 17:35:18,2009-03-12 17:35:18
5cd0f0e376ad4645f0741427cf50306ae80374ff...7165d7369e6b6e61f1c495ebcfdc5d92a5f2af13,13,97,6,103,18,2009-03-17 21:02:21,2009-03-17 21:02:21
5cd0f0e376ad4645f0741427cf50306ae80374ff...bc725bc85120fe1ef7305b498751543c95042cd4,1,1,1,2,1,2009-03-17 19:48:46,2009-03-17 19:48:46
5cd0f0e376ad4645f0741427cf50306ae80374ff...9f5ae81ed46170783f77744cacf7e05b962ffc18,4,60,16,76,15,2009-03-17 17:18:54,2009-03-17 17:18:54
9f5ae81ed46170783f77744cacf7e05b962ffc18...f1b3732e1d68298da6607a52abe720484d247126,1,1,12,13,2,2009-03-17 17:36:06,2009-03-17 17:36:06
f1b3732e1d68298da6607a52abe720484d247126...8ffaa3e2d9fbf731021cf3fe760d0a7cf42f8d76,6,2,53,55,12,2009-03-17 17:48:40,2009-03-17 17:48:40
abc5ac640e52285c881f1e34f82a7a013301eba6...81e4767bd1d2c98101d9df9129c008da5fb79b93,1,8,2,10,5,2009-03-12 21:36:46,2009-03-12 21:36:46
abc5ac640e52285c881f1e34f82a7a013301eba6...2a1c3b149234931c23c72403e8cfdc351a9b9310,2,1,9,10,2,2009-03-12 21:12:24,2009-03-12 21:12:24
7ec7f7c9cb3f6485c5eab15b85009a6290b7f202...df4a8dbf555457979277d651bc1e5a6dece5c149,2,6,0,6,2,2009-03-17 21:24:38,2009-03-17 21:24:38
df4a8dbf555457979277d651bc1e5a6dece5c149...affd92783f20699fd80839933f0a27f11435ce47,5,137,5,142,12,2009-03-17 21:25:10,2009-03-17 21:25:10
8ffaa3e2d9fbf731021cf3fe760d0a7cf42f8d76...0a578392a6c9f766b4f18cf0f8df8e034e6198cb,6,76,56,132,24,2009-03-17 21:20:08,2009-03-17 21:20:08
7f428f070175d4c9e97f06a0a0376bd951a286a6...741b17f3ea04de287223dfb740f78057c448e77f,1,69,12,81,5,2009-03-13 00:01:02,2009-03-13 00:01:02
741b17f3ea04de287223dfb740f78057c448e77f...1cfbae59f7765e4971e9426a70e1c2dba795aab0,1,12,69,81,5,2009-03-13 02:46:28,2009-03-13 02:46:28
1cfbae59f7765e4971e9426a70e1c2dba795aab0...239cbc236695e9952e1aedfacda5af5e3b98fd96,1,71,12,83,5,2009-03-13 14:12:52,2009-03-13 14:12:52
239cbc236695e9952e1aedfacda5af5e3b98fd96...0936bf99e38c2a05f3b88a10421237e5fdaf04c8,1,12,71,83,5,2009-03-13 15:47:02,2009-03-13 15:47:02
0936bf99e38c2a05f3b88a10421237e5fdaf04c8...851358de698898bc7c62b68d2b0772bcea1247b5,1,1,0,1,1,2009-03-13 15:49:59,2009-03-13 15:49:59
f694f98ad2ea06f5a83f705521feafb57b136722...57114172300cdfb74e5e9b076db4574070b507d7,3,40,2,42,5,2009-03-17 22:22:17,2009-03-17 22:22:17
851358de698898bc7c62b68d2b0772bcea1247b5...b936cb2c97d3c024e243c089ecb3190e4ff68f4c,4,8,5,13,6,2009-03-13 16:07:00,2009-03-13 16:07:00
60218a745bb3783572cc8a2f2aedb4c581f5e194...def6d6e476ade068dbc3e3f11bcb5c023d8adffe,1,1,1,2,1,2009-03-17 22:30:42,2009-03-17 22:30:42
def6d6e476ade068dbc3e3f11bcb5c023d8adffe...49ab99a19fd41af865b39949eeaa2f6a924ffe45,2,94,0,94,3,2009-03-17 23:02:21,2009-03-17 23:02:21
49ab99a19fd41af865b39949eeaa2f6a924ffe45...c13f00e195c38599566f0c8d096c883ac7c8d004,1,2,2,4,1,2009-03-18 02:42:35,2009-03-18 02:42:35
c13f00e195c38599566f0c8d096c883ac7c8d004...ef94f514b702c11c0d9d6d3faf7b16c6526732f8,5,104,31,135,13,2009-03-18 17:45:32,2009-03-18 17:45:32
c13f00e195c38599566f0c8d096c883ac7c8d004...002155dcbb6ac600ef1fca5db584b92b2cde45dd,1,14,0,14,1,2009-03-18 14:50:49,2009-03-18 14:50:49
002155dcbb6ac600ef1fca5db584b92b2cde45dd...5b4285aa5565eb8efdc7646b7bff1b1f06a33ac1,3,18,2,20,4,2009-03-18 14:51:04,2009-03-18 14:51:04
6a148e1a88b45829a1139c9b56258ca842201585...4c52e5e6dd1d637e045b7fb28c8cf5cd249cf7f5,5,17,4,21,10,2009-03-18 18:15:52,2009-03-18 18:15:52
4c52e5e6dd1d637e045b7fb28c8cf5cd249cf7f5...0c4fd06e0efd1b6310bb31a0e757d80c102f11ba,1,7,0,7,1,2009-03-18 18:26:27,2009-03-18 18:26:27
0c4fd06e0efd1b6310bb31a0e757d80c102f11ba...cd0f6ef44e792bc1e4dff0d337d8623248d257f2,2,4,4,8,4,2009-03-18 18:29:14,2009-03-18 18:29:14
cd0f6ef44e792bc1e4dff0d337d8623248d257f2...6d10afbd497ae98a72a5b0b784e54b09f4d5d4df,9,76,34,110,27,2009-03-18 21:24:10,2009-03-18 21:24:10
6d10afbd497ae98a72a5b0b784e54b09f4d5d4df...cc83107966aff6c7ea9e5fe32eb28f41bf43e0e4,3,21,2,23,4,2009-03-18 21:50:45,2009-03-18 21:50:45
cc83107966aff6c7ea9e5fe32eb28f41bf43e0e4...bf1d5f4282ffa2160d4177b08a0758b6b4a434ea,4,250,50,300,30,2009-03-18 22:06:37,2009-03-18 22:06:37
bf1d5f4282ffa2160d4177b08a0758b6b4a434ea...e55e945fcad1eaaee48095195e78b0b2c2592553,1,53,0,53,2,2009-03-18 22:23:42,2009-03-18 22:23:42
e55e945fcad1eaaee48095195e78b0b2c2592553...3a63d74903cb229b582f7dc8d7f41f409efb8654,1,0,2,2,1,2009-03-18 22:28:08,2009-03-18 22:28:08
3a63d74903cb229b582f7dc8d7f41f409efb8654...d330916d1a75b1db49285dbd45db8fdd00768fc1,1,5,7,12,5,2009-03-19 16:11:46,2009-03-19 16:11:46
d330916d1a75b1db49285dbd45db8fdd00768fc1...cf5c7589019cb4f25b89198f06c4a717f4d03c37,1,22,13,35,14,2009-03-19 17:15:59,2009-03-19 17:15:59
cf5c7589019cb4f25b89198f06c4a717f4d03c37...909fbbe1b2f51f6939001dc70c16e3df140b80b7,2,24,29,53,20,2009-03-19 17:41:20,2009-03-19 17:41:20
909fbbe1b2f51f6939001dc70c16e3df140b80b7...d28cae618792042dfeeda2dff13b31eb2247c4b1,1,8,53,61,10,2009-03-19 17:48:57,2009-03-19 17:48:57
d28cae618792042dfeeda2dff13b31eb2247c4b1...dba5a1e0365bdf02f6209f38767ff8f8f62a03a7,1,7,5,12,6,2009-03-19 17:53:52,2009-03-19 17:53:52
dba5a1e0365bdf02f6209f38767ff8f8f62a03a7...2ee0e271e123e9e8e09eefb1c6a449e3faef7de8,1,2,3,5,2,2009-03-19 18:44:28,2009-03-19 18:44:28
2ee0e271e123e9e8e09eefb1c6a449e3faef7de8...fdde87047f33a31a35636de71a02a98bb673ad5b,1,2,1,3,2,2009-03-19 18:50:40,2009-03-19 18:50:40
fdde87047f33a31a35636de71a02a98bb673ad5b...5a276ef621d94465c474e95dde8b457f878b2bb0,38,171,185,356,141,2009-03-19 20:23:04,2009-03-19 20:23:04
3a63d74903cb229b582f7dc8d7f41f409efb8654...46dddab48a45e1f7108dade6887b3c31a41d0772,1,8,4,12,1,2009-03-19 12:36:24,2009-03-19 12:36:24
3c2196420e0918937ca38df21e92144ac0bb5456...f0e25020b2695c7fbc6dda138b7f90e71a923157,1,28,13,41,7,2009-03-20 18:30:56,2009-03-20 18:30:56
3c2196420e0918937ca38df21e92144ac0bb5456...554cc099045b9d68b641a2f9b5ca58da1b900494,3,7,3,10,4,2009-03-20 16:19:21,2009-03-20 16:19:21
46dddab48a45e1f7108dade6887b3c31a41d0772...1d19eef516b95302dbca64ef450e1257fdd48042,1,1,0,1,1,2009-03-19 14:32:04,2009-03-19 14:32:04
46dddab48a45e1f7108dade6887b3c31a41d0772...37159f8c02fa68fa472faad26fe63d7f0d20d577,1,1,1,2,1,2009-03-19 12:51:04,2009-03-19 12:51:04
55ff5a5ec758deae0d4c8b1f16f28c9eac51bdc9...87fc8adf10d81dcb2432885bd143e52ab37e3023,1,0,1,1,1,2009-03-20 18:50:11,2009-03-20 18:50:11
87fc8adf10d81dcb2432885bd143e52ab37e3023...7dd5dd50afe937fcf540dadea880fd37a6857bfb,1,0,10,10,1,2009-03-20 18:57:04,2009-03-20 18:57:04
554cc099045b9d68b641a2f9b5ca58da1b900494...c88389e558e02454e03052530d76fb21a55b97f3,8,48,33,81,30,2009-03-20 19:39:22,2009-03-20 19:39:22
37159f8c02fa68fa472faad26fe63d7f0d20d577...86ce9e5d41b2da649572d25f2c9b6c945f3b0e32,5,15,3,18,5,2009-03-19 14:33:35,2009-03-19 14:33:35
7dd5dd50afe937fcf540dadea880fd37a6857bfb...b66a9b168d12f32d1a1a025f88bcf61a02971d4d,1,0,6,6,1,2009-03-20 20:06:43,2009-03-20 20:06:43
b66a9b168d12f32d1a1a025f88bcf61a02971d4d...d654edbef4553bd354850b10863631323db92660,2,24,15,39,11,2009-03-20 20:07:05,2009-03-20 20:07:05
d654edbef4553bd354850b10863631323db92660...2570f4824cbc278c2b0991ee54a20ddddd34aadc,4,8,8,16,8,2009-03-20 20:20:46,2009-03-20 20:20:46
5f1ddde3ad6d3138e54f254b2f22f50225ca6a85...3a5aef675691bbc3003776d8e32fcdcc0808a229,3,13,42,55,9,2009-03-19 15:17:16,2009-03-19 15:17:16
3a5aef675691bbc3003776d8e32fcdcc0808a229...19125066b35c11cbf6c501289e43191d5ed570dc,1,11,11,22,9,2009-03-19 17:29:27,2009-03-19 17:29:27
19125066b35c11cbf6c501289e43191d5ed570dc...e35ffd32ddf0d5b0481563016eabee3b47602abb,3,54,30,84,13,2009-03-19 19:38:49,2009-03-19 19:38:49
06d933ecbef59835138202662efa60ba9111d7bf...4fbc099c100d475b0cad11d2a30079c3b0777a13,1,2,2,4,1,2009-03-20 20:29:38,2009-03-20 20:29:38
4fbc099c100d475b0cad11d2a30079c3b0777a13...4d8acb31fef7b53584d7a9721d65ab2ce1e0d3e0,1,1,0,1,1,2009-03-20 20:53:03,2009-03-20 20:53:03
4d8acb31fef7b53584d7a9721d65ab2ce1e0d3e0...4e04ab5bac6d857d05f0b6d72ada93278494f39f,1,21,17,38,12,2009-03-20 21:08:38,2009-03-20 21:08:38
4e04ab5bac6d857d05f0b6d72ada93278494f39f...5ac057bd50d7b47e77d524faa80dd2af1b5a7db9,1,5,1,6,2,2009-03-23 15:32:30,2009-03-23 15:32:30
4e04ab5bac6d857d05f0b6d72ada93278494f39f...ff54da9dde84c09e858321311e961e86f471aa8b,3,97,4,101,7,2009-03-23 15:14:48,2009-03-23 15:14:48
ff54da9dde84c09e858321311e961e86f471aa8b...a1a76f96bf44955e8f5bb5cc0a698ba624aa7ba3,1,28,0,28,1,2009-03-23 15:38:22,2009-03-23 15:38:22
bc5da3a496251f8be349fee0a04d6d3d318e8296...8ca46fb7c5d05d22aff7813262af9b05fa7b1ab7,1,1,0,1,1,2009-03-23 21:04:32,2009-03-23 21:04:32
bc5da3a496251f8be349fee0a04d6d3d318e8296...3426f0e8c7eedd67b14f2742172e615fead8f9c4,3,9,1,10,9,2009-03-23 17:12:47,2009-03-23 17:12:47
ea44d9886c354ae8bce9d24a5b5e6d948b3b7992...6b9abc614427f682ee0cf9eacb070b50085784ed,2,147,31,178,14,2009-03-23 22:21:07,2009-03-23 22:21:07
6b9abc614427f682ee0cf9eacb070b50085784ed...7e86cd69f3bcf7ba262880090e5aa843285c9ff6,4,227,159,386,8,2009-03-23 22:32:05,2009-03-23 22:32:05
7e86cd69f3bcf7ba262880090e5aa843285c9ff6...a6f3402e0d65a303880b27c7514b8af3343ab2c0,2,35,18,53,7,2009-03-23 22:55:32,2009-03-23 22:55:32
a6f3402e0d65a303880b27c7514b8af3343ab2c0...a6c9d60843f2aac9d6704316425dfc3c9622ba5c,3,108,48,156,9,2009-03-24 15:34:09,2009-03-24 15:34:09
a6c9d60843f2aac9d6704316425dfc3c9622ba5c...55a170aaa5e6b277d751bac3f7aed7cb0ab487d7,2,15,13,28,14,2009-03-24 18:33:36,2009-03-24 18:33:36
3426f0e8c7eedd67b14f2742172e615fead8f9c4...ea2df3020580a0ae8cec9e0845acf78e9683366c,2,75,51,126,32,2009-03-23 20:25:03,2009-03-23 20:25:03
3426f0e8c7eedd67b14f2742172e615fead8f9c4...d3340fb7aedf267e84ce3cba26cab1e8625fb576,1,3,0,3,1,2009-03-23 18:11:53,2009-03-23 18:11:53
d7fdc782cbd023e859713fd7a249dabdf732b3cf...bf9976cf6832cd29e6dc7106b35d85d59dbafb40,3,48,18,66,19,2009-03-24 19:16:44,2009-03-24 19:16:44
bf9976cf6832cd29e6dc7106b35d85d59dbafb40...63a8d2d1731d5e07e09a5a1495a70967d47bba24,3,20,14,34,7,2009-03-24 19:42:35,2009-03-24 19:42:35
63a8d2d1731d5e07e09a5a1495a70967d47bba24...a265385f1074e624c5acad98b1b3d59a4d704b41,2,26,10,36,8,2009-03-24 22:15:47,2009-03-24 22:15:47
cd7831f6c436bc5369ee364162f4d0d3b9dbb208...8a54574b76b081437e796cb06ddcaf9581d89c6e,1,2,2,4,2,2009-03-24 15:42:21,2009-03-24 15:42:21
8a54574b76b081437e796cb06ddcaf9581d89c6e...ca46791a7b1cf57286c2440de8265b24c908eba0,1,6,2,8,1,2009-03-24 15:46:55,2009-03-24 15:46:55
ca46791a7b1cf57286c2440de8265b24c908eba0...c27e290116a355836952006681676c35f01f0f58,6,21,21,42,19,2009-03-24 16:12:04,2009-03-24 16:12:04
2ebf2a487454f5c6a27c7a67740a0f20c0cb31db...64ed02b27d62e9b9c38bfca78a0ec76bda8ba5e0,6,79,6,85,12,2009-03-24 16:53:13,2009-03-24 16:53:13
d3340fb7aedf267e84ce3cba26cab1e8625fb576...648633218d5cde9cceba0bdd27042481c9038d5a,1,6,7,13,7,2009-03-23 20:42:18,2009-03-23 20:42:18
b850675fa9126ef25c89640b12685109517ea1cd...47340a0a9b7ee5787dd22392837a37cd2e9f652a,2,66,4,70,6,2009-03-24 22:42:51,2009-03-24 22:42:51
47340a0a9b7ee5787dd22392837a37cd2e9f652a...835506af0aeec1d42f840d4d02a0b35314a34498,1,40,0,40,2,2009-03-25 14:34:32,2009-03-25 14:34:32
835506af0aeec1d42f840d4d02a0b35314a34498...7ba4140d5c29823adeb1f5ea3cea1a94b65252af,5,38,1,39,7,2009-03-25 18:47:04,2009-03-25 18:47:04
7ba4140d5c29823adeb1f5ea3cea1a94b65252af...4b7f917bf5ec34d64e9612d178d9f9600ccc6de3,2,47,1,48,5,2009-03-25 19:17:30,2009-03-25 19:17:30
4b7f917bf5ec34d64e9612d178d9f9600ccc6de3...547a455b5bf0392fcae35081b65298d85265d255,2,68,32,100,12,2009-03-25 20:40:52,2009-03-25 20:40:52
547a455b5bf0392fcae35081b65298d85265d255...2506307e4306bf679b707c32b184d7e551679494,1,3,5,8,2,2009-03-25 21:12:27,2009-03-25 21:12:27
2506307e4306bf679b707c32b184d7e551679494...e5a43008fd7d030d7ca97d427de8a731228a2aa8,3,54,8,62,13,2009-03-25 22:24:22,2009-03-25 22:24:22
e5a43008fd7d030d7ca97d427de8a731228a2aa8...8c6865b911ecbfa8c8e606f16044a5f014100733,2,43,8,51,11,2009-03-25 22:47:03,2009-03-25 22:47:03
c27e290116a355836952006681676c35f01f0f58...18680997e8a67fd0b0989ddc2e9c745931c8272d,2,9,1,10,3,2009-03-24 18:32:13,2009-03-24 18:32:13
2724428604a23c1add69ff64c20ecb2e32167a59...db14f056f902f9bc7690cda01b80003046439250,2,6,10,16,7,2009-03-24 18:19:03,2009-03-24 18:19:03
0dc74b1fe058413c23104eb41cab1e406d443e03...1e224bab7688def593388a62bf5d48b3d3728310,1,1,1,2,1,2009-03-26 14:14:50,2009-03-26 14:14:50
1e224bab7688def593388a62bf5d48b3d3728310...01658a1b95717a3e6dce56434ff471c8546b1601,2,34,27,61,15,2009-03-26 15:06:45,2009-03-26 15:06:45
f4e1f60ecd07103711fad8331cd3323c25cec63b...d0520ccafb1a68f2c441163bdbffc2e7f0a16936,5,101,91,192,88,2009-03-24 20:58:33,2009-03-24 20:58:33
d0520ccafb1a68f2c441163bdbffc2e7f0a16936...cc6f3c9a259bcabf3ffd6153ced0cfe04785b289,1,28,2,30,6,2009-03-24 21:35:50,2009-03-24 21:35:50
db14f056f902f9bc7690cda01b80003046439250...b2b5506629cb733392197d6c9f6d07ac463ec7e4,3,11,5,16,6,2009-03-25 21:30:30,2009-03-25 21:30:30
8f676a2d98dcf3f5f573b5e908d1472d98fa36f5...f490f01f1c37e7f91427908e94e4509e3b87b865,7,117,30,147,23,2009-03-26 17:45:29,2009-03-26 17:45:29
f490f01f1c37e7f91427908e94e4509e3b87b865...625b063d7ba9454d75e3396ca2f37d7f36dcf888,1,6,1,7,2,2009-03-26 17:47:35,2009-03-26 17:47:35
625b063d7ba9454d75e3396ca2f37d7f36dcf888...c77a66ec8b29a109ffa14b6b575985b1728df945,3,20,1,21,4,2009-03-26 17:57:46,2009-03-26 17:57:46
cc6f3c9a259bcabf3ffd6153ced0cfe04785b289...fa86d4bba9d3496a5c17e9c955517b2babb4859e,2,78,0,78,3,2009-03-25 19:29:20,2009-03-25 19:29:20
cc6f3c9a259bcabf3ffd6153ced0cfe04785b289...c585ac8b400e6e6e376fe5a73251d2807f3dd91a,1,5,0,5,3,2009-03-25 17:22:09,2009-03-25 17:22:09
c585ac8b400e6e6e376fe5a73251d2807f3dd91a...e91ed0e8548a6444da914794d26574f1f6620b7d,2,14,1,15,5,2009-03-25 21:08:36,2009-03-25 21:08:36
bd9185a9cae4bdfc5770c5c3457c4bb932748bf1...71ed202b2275aada2031f66a4bd780954006e7e6,2,18,18,36,13,2009-03-26 18:25:49,2009-03-26 18:25:49
bd9185a9cae4bdfc5770c5c3457c4bb932748bf1...0195f478e5ad2e80c4514c83049887abc81fe364,1,1,1,2,1,2009-03-26 13:42:03,2009-03-26 13:42:03
0195f478e5ad2e80c4514c83049887abc81fe364...1942ea0df5fbbbc63b522fb0b10db4be900f642d,1,1,1,2,1,2009-03-26 14:08:16,2009-03-26 14:08:16
f76864ae04ecc17b6faa743579175cb5f4967de8...c0fbc1a93e51c573f2a7c23dff45ea930e772e9e,3,8,9,17,8,2009-03-26 20:11:23,2009-03-26 20:11:23
c0fbc1a93e51c573f2a7c23dff45ea930e772e9e...874dd19dfb543b9ee2b8d0351e3992f13447480c,1,1,4,5,2,2009-03-26 20:59:38,2009-03-26 20:59:38
66216810279b56de9f817a3f1087741ef4eb7bc4...265436b22df4830b711227c7cf9f441c7f7dc4dd,1,3,3,6,2,2009-03-25 21:28:54,2009-03-25 21:28:54
589e953333202103e4f6ba2fd74e99871fc1b30b...6b1613adb6348cd9a99a199a9258839188d80717,2,14,5,19,8,2009-03-26 19:12:47,2009-03-26 19:12:47
1942ea0df5fbbbc63b522fb0b10db4be900f642d...9fc0c8c3f1225f81379a28b84fcfe122113ec0cf,2,3,3,6,3,2009-03-26 18:55:00,2009-03-26 18:55:00
bd99770027cc35725fa56249ba95c164de181df8...c3e08b28a5bb133d009889dd6501bf5c4b9bf756,2,10,1,11,3,2009-03-26 21:34:19,2009-03-26 21:34:19
c3e08b28a5bb133d009889dd6501bf5c4b9bf756...c7606faf90ec34619a0a44153143104363ce8f8c,2,21,1,22,4,2009-03-26 21:51:57,2009-03-26 21:51:57
265436b22df4830b711227c7cf9f441c7f7dc4dd...26ad67b9c795173d01b6405ccd1fe768051f4963,5,49,3,52,10,2009-03-25 21:35:38,2009-03-25 21:35:38
dc224ae3c08ac906b6d44be27c01b0b0e717370b...fd9c26a74c1a7a79a1fc55855beeef53fc4ac727,1,2,2,4,2,2009-03-26 19:14:24,2009-03-26 19:14:24
07dfc6bb3a13f7bd9d7369d6bc6de224930d6990...20c8556b9c67e4b6e4154aec14b5bca39c715d4f,2,29,0,29,6,2009-03-27 14:36:59,2009-03-27 14:36:59
711ff204f2c1341fb0373ffc1368c22f7b707b80...c4c2b2559a94d4fe0859c6a25aea5c994b39e6f2,1,6,2,8,5,2009-03-26 20:16:53,2009-03-26 20:16:53
c4c2b2559a94d4fe0859c6a25aea5c994b39e6f2...6b97b0e88b5d3bb168c34f8b5c6235439be2cfa7,1,10,0,10,2,2009-03-26 20:17:08,2009-03-26 20:17:08
5ad67c509f00db00b00abecd02f7a8cfc554e43f...790b17c6a637cb660a21e660ad1825ddb6128328,4,88,2,90,7,2009-03-27 15:53:47,2009-03-27 15:53:47
790b17c6a637cb660a21e660ad1825ddb6128328...8cd20d5ebbf21f9dffe82a803157d9dab84423f4,3,12,1,13,5,2009-03-27 17:31:13,2009-03-27 17:31:13
8cd20d5ebbf21f9dffe82a803157d9dab84423f4...7d3acbdc3addedb1fd7f7b139841e8d15356c17c,1,4,2,6,3,2009-03-27 17:45:48,2009-03-27 17:45:48
7d3acbdc3addedb1fd7f7b139841e8d15356c17c...d4ab183cf6f6acd6e8baafb21e94b1c37df2b817,2,33,2,35,4,2009-03-27 19:33:22,2009-03-27 19:33:22
d4ab183cf6f6acd6e8baafb21e94b1c37df2b817...158de5297e88ac9ddddb99123bdc129fac68ec17,1,48,0,48,2,2009-03-27 19:51:26,2009-03-27 19:51:26
6b97b0e88b5d3bb168c34f8b5c6235439be2cfa7...1b13a418fa2840717cfeb0bb567a0990cef53162,1,1,0,1,1,2009-03-26 21:28:16,2009-03-26 21:28:16
1b13a418fa2840717cfeb0bb567a0990cef53162...199110c11672ba25cfbfe93ef39529248dbe6de3,1,1,1,2,1,2009-03-26 21:28:33,2009-03-26 21:28:33
199110c11672ba25cfbfe93ef39529248dbe6de3...d58828ebb08a22fa70cb617d4f274a141a6910d4,2,14,3,17,4,2009-03-26 21:32:25,2009-03-26 21:32:25
d58828ebb08a22fa70cb617d4f274a141a6910d4...d417bc0802cded247072ed05fb6b73b998aa7ef0,2,3,3,6,3,2009-03-26 21:33:30,2009-03-26 21:33:30
158de5297e88ac9ddddb99123bdc129fac68ec17...074740013f8b676f7925da7966333db6ee6611bb,1,16,9,25,1,2009-03-27 20:27:35,2009-03-27 20:27:35
d417bc0802cded247072ed05fb6b73b998aa7ef0...59670e6b7d7358c1c497435488be274a3fac71bf,1,1,1,2,1,2009-03-27 21:46:46,2009-03-27 21:46:46
d417bc0802cded247072ed05fb6b73b998aa7ef0...38e49cc11dcdae6a1a84d0453ca65d2fe41a81ba,2,3,3,6,3,2009-03-27 13:59:18,2009-03-27 13:59:18
743e44eed2c9f3495af86aa59bbf901df392500b...3dc656ce79afd353c045dcb82a54504e0d5affa8,2,117,12,129,10,2009-03-27 21:49:00,2009-03-27 21:49:00
702c807230326b9d9a48fb39b1b0b249b6304b81...7af502f1c6349042c151aacf2482b4e44f1026e4,5,111,15,126,27,2009-03-27 20:55:26,2009-03-27 20:55:26
7af502f1c6349042c151aacf2482b4e44f1026e4...81ac2be48a972514498403e842c3c56a30580892,1,7,1,8,1,2009-03-27 20:55:33,2009-03-27 20:55:33
702c807230326b9d9a48fb39b1b0b249b6304b81...317ea6d5834d750917a5705b39b3ced3695288eb,3,20,2,22,6,2009-03-27 20:27:35,2009-03-27 20:27:35
38e49cc11dcdae6a1a84d0453ca65d2fe41a81ba...9e20569d70cb07d7733f79fe1c3ff7b901e942d7,1,8,8,16,6,2009-03-27 20:11:57,2009-03-27 20:11:57
9e20569d70cb07d7733f79fe1c3ff7b901e942d7...83158d34d5917de3b341f83380bb8d88c7b49413,1,2,2,4,2,2009-03-27 20:12:06,2009-03-27 20:12:06
53ffe3a4652a0e7c918e6186b278d5fc94234947...1ffe11547593ef532050d80d508b685d6151772c,1,17,1,18,8,2009-03-29 05:09:24,2009-03-29 05:09:24
1ffe11547593ef532050d80d508b685d6151772c...82b0f9daefd9debf8a4bafcb9565ebb772d4c684,1,7,7,14,6,2009-03-29 13:14:38,2009-03-29 13:14:38
82b0f9daefd9debf8a4bafcb9565ebb772d4c684...93a3c98bf061279e8448147d41a66a5d197f3c81,1,1,1,2,1,2009-03-29 13:42:44,2009-03-29 13:42:44
93a3c98bf061279e8448147d41a66a5d197f3c81...6fa7b75c6aa1187c91379c1319d54497f3f06356,2,9,2,11,3,2009-03-30 01:24:16,2009-03-30 01:24:16
6fa7b75c6aa1187c91379c1319d54497f3f06356...601bc1d86671bde827d03345bc67bfb4798d1113,1,1,0,1,1,2009-03-30 02:52:17,2009-03-30 02:52:17
601bc1d86671bde827d03345bc67bfb4798d1113...b32c181aac4d111d3571f103eb746741f1498b29,2,7,5,12,5,2009-03-30 13:47:58,2009-03-30 13:47:58
b32c181aac4d111d3571f103eb746741f1498b29...1914c3933d7935ee8ae00faa66b430664349f7fd,1,1,1,2,1,2009-03-30 13:48:15,2009-03-30 13:48:15
1914c3933d7935ee8ae00faa66b430664349f7fd...e6c4c94d6988e0e72db57ec9501dcc0ff0956424,1,5,2,7,2,2009-03-30 15:09:51,2009-03-30 15:09:51
1914c3933d7935ee8ae00faa66b430664349f7fd...22cd9cc2e537487899c467117f10039b8a25604e,3,28,5,33,11,2009-03-30 14:50:10,2009-03-30 14:50:10
34e89bfef97713a4c6e0aecb0674db5a3f6dce2c...40eab1308ea0848e43b0015d12a10fbae5baea50,1,3,0,3,1,2009-03-30 15:16:41,2009-03-30 15:16:41
40eab1308ea0848e43b0015d12a10fbae5baea50...e347e27606a6a749d3d04f00e7880bc489a030a0,4,41,8,49,13,2009-03-30 18:07:04,2009-03-30 18:07:04
e347e27606a6a749d3d04f00e7880bc489a030a0...8ccb9de83bf1ce0875dbf9b325c6d3a342c5352c,1,2,5,7,3,2009-03-30 18:31:31,2009-03-30 18:31:31
8ccb9de83bf1ce0875dbf9b325c6d3a342c5352c...529780f2504fc837f24bdf3b19d064e0199078f8,1,7,7,14,3,2009-03-30 20:28:52,2009-03-30 20:28:52
40eab1308ea0848e43b0015d12a10fbae5baea50...fe27fdc75a6a0bdf9f8884f60d3c720125ee3e0b,1,3,1,4,2,2009-03-30 17:25:58,2009-03-30 17:25:58
fe27fdc75a6a0bdf9f8884f60d3c720125ee3e0b...745cfbff47a94ccfbfea737d1b239aef3a875512,4,24,0,24,5,2009-03-30 17:28:49,2009-03-30 17:28:49
745cfbff47a94ccfbfea737d1b239aef3a875512...160d0b72013ec72ae0e00a95d6b21c5f5a014bb1,4,61,12,73,14,2009-03-30 18:33:40,2009-03-30 18:33:40
529780f2504fc837f24bdf3b19d064e0199078f8...d9dff04bbd47d9af598817de36ab078996fdb1c6,1,0,51,51,2,2009-03-30 21:08:06,2009-03-30 21:08:06
d9dff04bbd47d9af598817de36ab078996fdb1c6...d74b108dd4aac7a9a62bdd6afd5f406c950fecf9,1,8,9,17,3,2009-03-31 14:23:05,2009-03-31 14:23:05
d74b108dd4aac7a9a62bdd6afd5f406c950fecf9...a1706a3d1b7134cf18203ca917ce6228b66df966,2,47,21,68,8,2009-03-31 15:44:35,2009-03-31 15:44:35
a1706a3d1b7134cf18203ca917ce6228b66df966...4e971ca6092a1c395413e8c76640d3f62cdc6ab6,1,0,1,1,1,2009-03-31 15:49:19,2009-03-31 15:49:19
71091897746eb0732fe307e31bdba5da07e9eced...d1427f7232d97e31a565c2c267df2f7c780b15f8,1,6,1,7,2,2009-03-30 21:12:50,2009-03-30 21:12:50
d1427f7232d97e31a565c2c267df2f7c780b15f8...fac9fcc1a132e220d50edfb2a071da682e460624,6,122,17,139,16,2009-03-30 21:13:55,2009-03-30 21:13:55
fede7ca1d9262675804a5469d870e57f211849c6...c54883ff61ef2726b6e7a11cf1f52851828c3675,2,5,7,12,5,2009-03-31 16:09:55,2009-03-31 16:09:55
c54883ff61ef2726b6e7a11cf1f52851828c3675...cec6d1af97b81d906b31edefda8a2c16b4bb32d7,3,65,2,67,8,2009-03-31 18:05:20,2009-03-31 18:05:20
cec6d1af97b81d906b31edefda8a2c16b4bb32d7...2821a57dcb27dc6ad1a23dd61b8c81f94670cdb2,2,4,0,4,2,2009-03-31 18:59:58,2009-03-31 18:59:58
2821a57dcb27dc6ad1a23dd61b8c81f94670cdb2...8e694fdc33de269f4bea6f5b6d4079eb40e7ebd4,1,2,0,2,1,2009-03-31 19:59:14,2009-03-31 19:59:14
8e694fdc33de269f4bea6f5b6d4079eb40e7ebd4...bda8a014615f7ad6c9e78384e50df3c8a6b6a760,1,3,1,4,1,2009-03-31 20:00:37,2009-03-31 20:00:37
bda8a014615f7ad6c9e78384e50df3c8a6b6a760...dcdcd309ddf19f31b7abc1063fb0f11228ae5bd2,1,1,1,2,1,2009-03-31 20:46:26,2009-03-31 20:46:26
fac9fcc1a132e220d50edfb2a071da682e460624...853f187bdd3ff01064158089e23ff718ec0dd588,1,53,16,69,5,2009-03-31 21:29:30,2009-03-31 21:29:30
a79a45de10e65e7dbb759db52b4fe27ecb0585e4...0a6ae943845cc86d2ed6cd2e45c47b3df458050f,1,1,1,2,1,2009-03-31 21:38:51,2009-03-31 21:38:51
0a6ae943845cc86d2ed6cd2e45c47b3df458050f...1b46ce67495488e617594569f4d99cead25e6845,1,5,8,13,2,2009-03-31 21:43:06,2009-03-31 21:43:06
1b46ce67495488e617594569f4d99cead25e6845...57ce5cf1ef7309dd801896b2e1ef4d60a547f8c1,1,2,2,4,1,2009-03-31 21:51:16,2009-03-31 21:51:16
57ce5cf1ef7309dd801896b2e1ef4d60a547f8c1...86d6f70c83a73ee1e8481cff5edbc4ed818c9f4c,1,4,3,7,3,2009-04-01 02:08:55,2009-04-01 02:08:55
57ce5cf1ef7309dd801896b2e1ef4d60a547f8c1...c3ba79f829b29c254e29b55c05d83b767f24868d,1,4,4,8,3,2009-04-01 02:05:53,2009-04-01 02:05:53
1f476f2524833546a92255210ffea8feb6d7b504...7bd3a9060c54f28d2b8692327c38f80dda9b1a1a,2,12,5,17,3,2009-04-01 14:05:30,2009-04-01 14:05:30
7bd3a9060c54f28d2b8692327c38f80dda9b1a1a...5b9e58768ecf7c4d698bb38f2c3f99474f6d3925,1,1,1,2,1,2009-04-01 14:38:39,2009-04-01 14:38:39
5b9e58768ecf7c4d698bb38f2c3f99474f6d3925...892296218a32ec6218a14b0caf5cd7848b28006a,1,2,1,3,1,2009-04-01 14:50:31,2009-04-01 14:50:31
892296218a32ec6218a14b0caf5cd7848b28006a...59d34a2832c4ff3ec2df8ad790f2769c3d302057,1,2,1,3,1,2009-04-01 14:51:55,2009-04-01 14:51:55
59d34a2832c4ff3ec2df8ad790f2769c3d302057...9cc0f42431bbe80e6d9c77f89d1b43ee5f9c561b,1,1,0,1,1,2009-04-01 14:55:50,2009-04-01 14:55:50
9cc0f42431bbe80e6d9c77f89d1b43ee5f9c561b...f1293c60c3ad680109148fdaa2ab3e543619c65d,1,2,1,3,2,2009-04-01 15:10:36,2009-04-01 15:10:36
f1293c60c3ad680109148fdaa2ab3e543619c65d...d39de1e40758bc0201fd332ce3761529c7a952d2,10,10,1,11,10,2009-04-01 15:33:56,2009-04-01 15:33:56
d39de1e40758bc0201fd332ce3761529c7a952d2...ed35b0874ccd6462dd9b24d57c3657ade812a1d9,10,56,13,69,25,2009-04-01 16:26:31,2009-04-01 16:26:31
ed35b0874ccd6462dd9b24d57c3657ade812a1d9...8ad34d618694f5bdb19b16847b1879087a97f3c2,1,4,0,4,1,2009-04-01 17:36:39,2009-04-01 17:36:39
8ad34d618694f5bdb19b16847b1879087a97f3c2...99a96884938cd1eee623f3f7b9da8cacc73b4439,2,9,3,12,4,2009-04-01 17:48:02,2009-04-01 17:48:02
99a96884938cd1eee623f3f7b9da8cacc73b4439...62f1aab6accba0e098f967a413d938b94a9911ea,1,3,0,3,1,2009-04-01 18:10:21,2009-04-01 18:10:21
62f1aab6accba0e098f967a413d938b94a9911ea...d291a9ef73525de1b9e2770e012f947669af6ec8,1,3,1,4,2,2009-04-01 18:13:08,2009-04-01 18:13:08
d291a9ef73525de1b9e2770e012f947669af6ec8...a05f92f518ef69feb5fd2872c0d036f604cc8181,10,13,10,23,23,2009-04-01 18:17:24,2009-04-01 18:17:24
a05f92f518ef69feb5fd2872c0d036f604cc8181...df91e7d5b13fdee873f821bb4eebe736ffa64c94,2,16,27,43,15,2009-04-01 20:00:56,2009-04-01 20:00:56
df91e7d5b13fdee873f821bb4eebe736ffa64c94...1fe31cb6018c4272d027ba09fbbeead35f03388d,2,40,8,48,10,2009-04-01 21:25:47,2009-04-01 21:25:47
1fe31cb6018c4272d027ba09fbbeead35f03388d...af4bf8e62b703852ce3c7c06b71959881a5369ca,10,73,78,151,55,2009-04-01 22:21:07,2009-04-01 22:21:07
af4bf8e62b703852ce3c7c06b71959881a5369ca...3dc9982e6577fceab24163d61107f1624d3805dc,11,28,23,51,25,2009-04-01 23:51:41,2009-04-01 23:51:41
af4bf8e62b703852ce3c7c06b71959881a5369ca...eb22bc435bf14eadcc2d753afeaa3787d4a45244,1,6,0,6,1,2009-04-01 23:13:47,2009-04-01 23:13:47
0f6ca6451fc1d0e8abad3561764df155a54ebb80...7d97641828dea95cc21d40b11cc2e847987406d8,1,1,0,1,1,2009-04-02 15:13:20,2009-04-02 15:13:20
7d97641828dea95cc21d40b11cc2e847987406d8...633bb0f06e3a69371a7d5f738c90294148ebd7db,1,9,1,10,2,2009-04-02 15:36:02,2009-04-02 15:36:02
633bb0f06e3a69371a7d5f738c90294148ebd7db...662776e8320214d78a1887a6021c17b0aed2c09a,1,9,1,10,4,2009-04-02 16:02:46,2009-04-02 16:02:46
662776e8320214d78a1887a6021c17b0aed2c09a...1f2bab33e83e23f34630654c4d701a2ad21cb1fb,1,1,1,2,1,2009-04-02 19:43:53,2009-04-02 19:43:53
662776e8320214d78a1887a6021c17b0aed2c09a...3bca999156cb68ad2022bf52145a470d288529c1,4,107,0,107,5,2009-04-02 19:10:52,2009-04-02 19:10:52
3bca999156cb68ad2022bf52145a470d288529c1...8780ff947f07b0cf934b393eff84e5f21749a238,1,2,0,2,1,2009-04-02 19:48:18,2009-04-02 19:48:18
fd69be43c99b92a9243fc3d89cecb31bed0d06a6...c04804725863ce6b8c0e4034a64f738c327fb5a5,1,12,0,12,1,2009-04-02 20:56:39,2009-04-02 20:56:39
c04804725863ce6b8c0e4034a64f738c327fb5a5...d20f1d0f627c4ddf7a78fffe17ad096981c55b51,1,4,0,4,2,2009-04-02 21:06:01,2009-04-02 21:06:01
d20f1d0f627c4ddf7a78fffe17ad096981c55b51...ec376d5781723ec3737a7f4d46ee8a2fd1a63cdc,1,0,1,1,1,2009-04-02 21:26:36,2009-04-02 21:26:36
ec376d5781723ec3737a7f4d46ee8a2fd1a63cdc...d3fa52ec795e1ac7b22d06b17823753917ed037f,1,2,2,4,2,2009-04-02 21:26:49,2009-04-02 21:26:49
c04804725863ce6b8c0e4034a64f738c327fb5a5...27653d55a0f29fa64177ea88e4cecdcc6523838e,1,91,81,172,6,2009-04-02 21:04:05,2009-04-02 21:04:05
27653d55a0f29fa64177ea88e4cecdcc6523838e...3c439e5fde5cd6ca40dac3fc48d550e6f4d03238,2,75,1,76,3,2009-04-02 21:29:51,2009-04-02 21:29:51
ca6604980864488a64618fff3dca1c7c2e9234f8...4dd56647881f3d16600e5e69a37c440f7ea001f4,1,2,0,2,1,2009-04-02 21:32:11,2009-04-02 21:32:11
4dd56647881f3d16600e5e69a37c440f7ea001f4...9c2ce6c85581e4b3a8271b65cd5be9c0d59f2e4c,1,7,1,8,4,2009-04-02 21:58:09,2009-04-02 21:58:09
9c2ce6c85581e4b3a8271b65cd5be9c0d59f2e4c...b372835b9183f3ea8cf2d0103c82805e52a497a1,1,2,1,3,1,2009-04-02 21:58:18,2009-04-02 21:58:18
b372835b9183f3ea8cf2d0103c82805e52a497a1...1866fed9c62ae0acd16c5c0a1059db31de009ddb,11,43,43,86,27,2009-04-02 22:20:57,2009-04-02 22:20:57
1866fed9c62ae0acd16c5c0a1059db31de009ddb...652dac2449a317c7824a20c12456b1f668c71db7,2,14,8,22,12,2009-04-03 14:44:30,2009-04-03 14:44:30
1866fed9c62ae0acd16c5c0a1059db31de009ddb...39337b56449540034c1b46898b747dfc0132ebbd,1,11,9,20,2,2009-04-03 13:30:10,2009-04-03 13:30:10
39337b56449540034c1b46898b747dfc0132ebbd...ab9d016282cf75884fd627b519fea200175c66da,1,8,7,15,4,2009-04-03 14:29:01,2009-04-03 14:29:01
3369fd5b762caa2f93bae7387fd8eccdc56fecff...c0089eeae791aa5860c36802a94a871b804af264,1,8,6,14,3,2009-04-03 15:08:32,2009-04-03 15:08:32
3369fd5b762caa2f93bae7387fd8eccdc56fecff...4f5a8d52f47507a70b6c625dfb5dbfc87ba5656a,2,125,125,250,80,2009-04-03 14:48:26,2009-04-03 14:48:26
0c5cd4969b94faed67b449a106400261656dbbd4...8cd7cde9258e28c4954eb0c023718ace9dac5e6b,1,10,10,20,6,2009-04-03 15:20:45,2009-04-03 15:20:45
8cd7cde9258e28c4954eb0c023718ace9dac5e6b...05a8521a684e8554a4c1f3531ee1fc0132f00d63,1,3,1,4,1,2009-04-03 15:20:57,2009-04-03 15:20:57
05a8521a684e8554a4c1f3531ee1fc0132f00d63...0dd264adb5a5bba6dbc2a8145aa0918bee756a12,1,1,0,1,1,2009-04-03 15:27:48,2009-04-03 15:27:48
0dd264adb5a5bba6dbc2a8145aa0918bee756a12...83a1aded10fcbe7c42228e1fd1ebe27866b8c0aa,1,4,4,8,4,2009-04-03 15:32:47,2009-04-03 15:32:47
83a1aded10fcbe7c42228e1fd1ebe27866b8c0aa...80de3918c38cee1935a6779e7b91561d3b823007,1,8,3,11,3,2009-04-03 15:43:27,2009-04-03 15:43:27
80de3918c38cee1935a6779e7b91561d3b823007...38e53ec2ff0991ab7c69719da33f39c312ae169d,1,2,2,4,2,2009-04-03 15:55:24,2009-04-03 15:55:24
38e53ec2ff0991ab7c69719da33f39c312ae169d...006c1404e9ba891b5d51a20bf6ac44444bb8613b,1,1,1,2,1,2009-04-03 16:53:09,2009-04-03 16:53:09
006c1404e9ba891b5d51a20bf6ac44444bb8613b...28a140ee8cf327cc69b3e9427cd4c2bb1527c5ad,2,91,1,92,2,2009-04-03 18:24:05,2009-04-03 18:24:05
006c1404e9ba891b5d51a20bf6ac44444bb8613b...5d81abc69044aa62241524fa3e7ee3c9aed2fbb1,3,57,47,104,4,2009-04-03 17:52:06,2009-04-03 17:52:06
3fbb785b96333b8ba9a6371cda4dc339859a54d4...ec5991e872043e7cefe65062e1a40847e0306ebf,1,24,2,26,4,2009-04-03 18:38:04,2009-04-03 18:38:04
5d81abc69044aa62241524fa3e7ee3c9aed2fbb1...7b8881ffab8905f6f5ee46bea7d05b1ea09d8615,4,22,10,32,7,2009-04-03 18:21:00,2009-04-03 18:21:00
15abe0c3887c77d780ee6d9bae0731c04ab8bbb0...ebaf4292d6a78eb84ef027380beedb829b278082,1,74,0,74,1,2009-04-03 19:06:08,2009-04-03 19:06:08
ebaf4292d6a78eb84ef027380beedb829b278082...80c3078d1a15c5e9aeddcff198defada836a3fc6,1,6,5,11,1,2009-04-03 19:34:44,2009-04-03 19:34:44
80c3078d1a15c5e9aeddcff198defada836a3fc6...6a8c1177555606f66861a9847d53abd0713385c7,1,1,1,2,1,2009-04-03 19:36:18,2009-04-03 19:36:18
6a8c1177555606f66861a9847d53abd0713385c7...fd780da9b6ca5185fcbcd4dd484446883978220f,2,4,3,7,4,2009-04-03 19:59:13,2009-04-03 19:59:13
fd780da9b6ca5185fcbcd4dd484446883978220f...5f837c7ed238d641cdab121342673239705369e3,1,67,2,69,3,2009-04-03 20:29:12,2009-04-03 20:29:12
5f837c7ed238d641cdab121342673239705369e3...2c72807a42bd87af94e372ed55fc271b96abe04b,1,5,1,6,2,2009-04-03 20:35:12,2009-04-03 20:35:12
2c72807a42bd87af94e372ed55fc271b96abe04b...1896a06093abe6176c0c9f6b77fa4b4549c70eb0,1,1,1,2,1,2009-04-03 21:50:52,2009-04-03 21:50:52
2c72807a42bd87af94e372ed55fc271b96abe04b...74bb4f6029007cce3146b42f02801148b9dd8e12,1,30,1,31,2,2009-04-03 20:46:48,2009-04-03 20:46:48
e079f2c3f3aec6cd28a9479ccd868578164e0598...e09106351e4bbe9d89156fce156d34c8607c95eb,6,70,13,83,20,2009-04-06 15:27:43,2009-04-06 15:27:43
e09106351e4bbe9d89156fce156d34c8607c95eb...0b73b8d3253547d1ae4937020a8ae196b040b770,2,18,1,19,3,2009-04-06 17:41:47,2009-04-06 17:41:47
0b73b8d3253547d1ae4937020a8ae196b040b770...bf07afef73f75c126c86bc185008eff62e981d38,7,58,50,108,26,2009-04-06 18:11:32,2009-04-06 18:11:32
bf07afef73f75c126c86bc185008eff62e981d38...795ad3a7c654a45a2a6a7be2974eaea3729ba1e2,1,34,0,34,1,2009-04-06 18:11:51,2009-04-06 18:11:51
795ad3a7c654a45a2a6a7be2974eaea3729ba1e2...e39393b34062e253de5dc4795cf7e9a2f908e8d6,1,9,5,14,4,2009-04-06 18:24:19,2009-04-06 18:24:19
e39393b34062e253de5dc4795cf7e9a2f908e8d6...36d3433d4c29ef07667e65266c08c6d442db5ac2,1,4,6,10,7,2009-04-06 18:59:07,2009-04-06 18:59:07
36d3433d4c29ef07667e65266c08c6d442db5ac2...09a327160b3a08c4c1fcbe45dcf43fbbb74be787,1,24,0,24,1,2009-04-06 19:07:20,2009-04-06 19:07:20
09a327160b3a08c4c1fcbe45dcf43fbbb74be787...57288fe0b21ec4c788627417181ebdeadaca0065,1,1,1,2,1,2009-04-06 19:19:30,2009-04-06 19:19:30
57288fe0b21ec4c788627417181ebdeadaca0065...53e63fd6461d652a1eec98371950aeaa757d86c5,1,44,0,44,2,2009-04-06 19:39:52,2009-04-06 19:39:52
53e63fd6461d652a1eec98371950aeaa757d86c5...88293bd3049880818d3a9ec59ad05018787b831f,3,59,56,115,6,2009-04-06 20:10:31,2009-04-06 20:10:31
53e63fd6461d652a1eec98371950aeaa757d86c5...6b49e60fe5d272df63eafa44cc99886bf10d82af,2,179,23,202,11,2009-04-06 19:57:17,2009-04-06 19:57:17
e3f1f1b2bfb0fa81eff66e01f883ff1435a5697a...aa5309a68bf3fb6c1ef4a4c7459a047df097cac2,3,4,2,6,4,2009-04-06 20:21:56,2009-04-06 20:21:56
6b49e60fe5d272df63eafa44cc99886bf10d82af...c30e80145ef04cc9d4cffca06f1b168746f1633e,2,40,24,64,8,2009-04-06 20:31:09,2009-04-06 20:31:09
aa5309a68bf3fb6c1ef4a4c7459a047df097cac2...0af6ebeea2e641001ebf855ddf23f89bbb92c63d,1,1,1,2,1,2009-04-06 20:33:34,2009-04-06 20:33:34
0875581b5e67530e6d6e567968906d2553dcb4aa...71d9c7af735c2d67138f8e50623e7c1838e09dd0,3,12,2,14,9,2009-04-06 21:34:29,2009-04-06 21:34:29
0875581b5e67530e6d6e567968906d2553dcb4aa...91c4607f7697ee2d5e7c10d65e8ba340aaf5478c,3,12,5,17,5,2009-04-06 21:32:40,2009-04-06 21:32:40
91c4607f7697ee2d5e7c10d65e8ba340aaf5478c...4a86a27b60bef87cc3cc1f9878a039bac05ba4a6,1,30,18,48,12,2009-04-06 21:33:19,2009-04-06 21:33:19
2b97f73722337274031faaa35b577cce74eb8fd2...6458658240d0829103052cf38d045c6ca18881eb,1,10,0,10,2,2009-04-06 21:45:29,2009-04-06 21:45:29
6458658240d0829103052cf38d045c6ca18881eb...4e79d2b48fda11823f8ba705b4b4899a33eb4c27,9,34,34,68,11,2009-04-06 21:57:16,2009-04-06 21:57:16
4e79d2b48fda11823f8ba705b4b4899a33eb4c27...450ca3e29dafe3fa0c0c65e4a458751584b5bba6,1,1,1,2,1,2009-04-07 00:09:30,2009-04-07 00:09:30
450ca3e29dafe3fa0c0c65e4a458751584b5bba6...2708ec75ffc9e9832953bcd315a8033eff7b52e3,1,15,0,15,1,2009-04-07 16:18:40,2009-04-07 16:18:40
450ca3e29dafe3fa0c0c65e4a458751584b5bba6...1ebca51c7466f37c87225bfd491143828703fd68,1,16,2,18,3,2009-04-07 14:32:11,2009-04-07 14:32:11
1ebca51c7466f37c87225bfd491143828703fd68...497e8231b0fedf45146a2c495ce4e08e9b9ab623,1,1,0,1,1,2009-04-07 14:33:11,2009-04-07 14:33:11
497e8231b0fedf45146a2c495ce4e08e9b9ab623...69756316c1df83d8ecd543da0ec187bff59e98a8,6,52,52,104,25,2009-04-07 14:40:10,2009-04-07 14:40:10
69756316c1df83d8ecd543da0ec187bff59e98a8...f86715cb8516064ad17f8adede763c207fdde39a,1,1,7,8,3,2009-04-07 14:42:58,2009-04-07 14:42:58
f86715cb8516064ad17f8adede763c207fdde39a...56f86969097441d91300a0328d7f7e4ffd80c375,2,18,1,19,3,2009-04-07 15:02:29,2009-04-07 15:02:29
56f86969097441d91300a0328d7f7e4ffd80c375...e93fe3d251ba880446962223e82763e8be4475a5,1,2,0,2,1,2009-04-07 15:26:36,2009-04-07 15:26:36
f93d932d0a28b97fb9b89b61a3f2e824e368f500...d3d1c28411b5d7d583256be66544f2304aa9237d,1,15,15,30,3,2009-04-07 17:22:12,2009-04-07 17:22:12
e93fe3d251ba880446962223e82763e8be4475a5...d99513a7e23619667d5040914a9f83f1a56afd5e,1,8,9,17,8,2009-04-07 16:39:51,2009-04-07 16:39:51
97942c07765f62df4bb278df7d92b33ea62af7c9...e046f05737454c549a261546057b0b7373f3eb20,1,49,44,93,3,2009-04-07 18:21:21,2009-04-07 18:21:21
e046f05737454c549a261546057b0b7373f3eb20...211da8fadab21f1077630f71ad24efa1a38dc379,3,54,46,100,6,2009-04-07 18:24:16,2009-04-07 18:24:16
211da8fadab21f1077630f71ad24efa1a38dc379...ae7a3ccbb7297e70baa541c56d9aed5ae9dbe095,1,2,1,3,1,2009-04-07 18:26:55,2009-04-07 18:26:55
97942c07765f62df4bb278df7d92b33ea62af7c9...53a4ba07d78c2ab0f3da5c7f806da120b36fc111,1,13,2,15,3,2009-04-07 17:35:53,2009-04-07 17:35:53
6fc952d02e96b5f05d530d1c992b568a0a8ce6de...98f4fc65706cd4c0f0ce189dc8e4664a0b722e20,1,2,1,3,1,2009-04-07 17:10:00,2009-04-07 17:10:00
f35a7f595ecec587bf519cbee358449deb0c3e52...3f647deaf23ad990547bcc57c1f7f748dfb35ef7,2,51,1,52,3,2009-04-07 19:10:30,2009-04-07 19:10:30
53a4ba07d78c2ab0f3da5c7f806da120b36fc111...52dbf5b3e120ab1751782794c2c9fe67ab08e7d9,6,75,12,87,14,2009-04-07 19:19:27,2009-04-07 19:19:27
3f647deaf23ad990547bcc57c1f7f748dfb35ef7...c1ae28ca0d028981600887319fc2057f130d9f01,1,0,1,1,1,2009-04-07 19:27:00,2009-04-07 19:27:00
5ebb9a77b59b98f4d0f0f6d5b73ed28dbe2880bf...d1e0b286b05786aafcdadc6047121823116a45bf,1,1,1,2,1,2009-04-07 21:39:53,2009-04-07 21:39:53
25cbcbcba6178588e050deacd06f1568166e45ec...5f9d2b6aa5ed0ac05bf42e93bcb608ad7aa2c01d,3,114,0,114,4,2009-04-07 20:42:06,2009-04-07 20:42:06
5f9d2b6aa5ed0ac05bf42e93bcb608ad7aa2c01d...5b1411841303f486f1acc117fca294fa3b443e70,2,44,2,46,4,2009-04-07 21:58:25,2009-04-07 21:58:25
1bb5121b5e99a5abbfa12efab931b17562baf3e9...94e12ec06b6e784f319a23e77921cd3ce28918f9,1,15,0,15,2,2009-04-08 14:45:51,2009-04-08 14:45:51
94e12ec06b6e784f319a23e77921cd3ce28918f9...78625e7616ee39b19bbde08744a7550c8a424d07,3,31,2,33,5,2009-04-08 16:11:34,2009-04-08 16:11:34
78625e7616ee39b19bbde08744a7550c8a424d07...b671ee788b6ec7761b3e3a03d7c82babc2960260,1,60,0,60,2,2009-04-08 17:41:38,2009-04-08 17:41:38
b671ee788b6ec7761b3e3a03d7c82babc2960260...495eaa80933a10cb19c79fce5435eabb4be0dd67,2,17,0,17,3,2009-04-08 18:01:48,2009-04-08 18:01:48
495eaa80933a10cb19c79fce5435eabb4be0dd67...0477604065e143df1df13da1afe3497230a6c21a,2,3,3,6,3,2009-04-08 18:36:30,2009-04-08 18:36:30
0477604065e143df1df13da1afe3497230a6c21a...26bddf1ef82c09f09258061379b7ef1d6e45804c,6,38,24,62,13,2009-04-09 17:30:28,2009-04-09 17:30:28
26bddf1ef82c09f09258061379b7ef1d6e45804c...66a1e6d1ed48c4375e9057a260d7adffb2738d18,1,2,2,4,2,2009-04-09 17:37:52,2009-04-09 17:37:52
66a1e6d1ed48c4375e9057a260d7adffb2738d18...8b0ad1c0f49c772ba7262ce85fe4f3dbb119e5c3,1,2,0,2,1,2009-04-10 14:41:35,2009-04-10 14:41:35
8b0ad1c0f49c772ba7262ce85fe4f3dbb119e5c3...bf54782a07d150a151fcc088046f24a36160c9a6,1,45,0,45,1,2009-04-10 14:41:41,2009-04-10 14:41:41
66a1e6d1ed48c4375e9057a260d7adffb2738d18...d685743a1acb70b50f20682d89de5a2a8e9cd16b,3,10,5,15,10,2009-04-10 14:30:57,2009-04-10 14:30:57
66a1e6d1ed48c4375e9057a260d7adffb2738d18...278bf65f61d99ea80edd47544ed50e69c664aa9d,3,4,3,7,4,2009-04-09 22:49:45,2009-04-09 22:49:45
278bf65f61d99ea80edd47544ed50e69c664aa9d...f5b887069c2245a5339b914f0a3bde4c1192cca8,5,241,14,255,25,2009-04-09 22:50:29,2009-04-09 22:50:29
e78f1f372cde2bd6da2ce1a099d524d072a344d6...a41146009d214fd39212b2ca5c2183514c1aac84,1,1,1,2,1,2009-04-10 16:39:50,2009-04-10 16:39:50
d685743a1acb70b50f20682d89de5a2a8e9cd16b...a7e92bcd8e37780375176ad9048984bb1d059f7b,1,1,1,2,1,2009-04-10 14:47:48,2009-04-10 14:47:48
5832dc6ffe49b6faa8e1aecbbaa612132d2422cd...8ac9b466f769de69ab68135d605e652874c2c154,1,1,1,2,1,2009-04-10 15:53:47,2009-04-10 15:53:47
669fe38b23216933c24795ba89ab1d7079deb8e4...0a242467dd648935e06e4bee4eecac64375da778,1,2,0,2,1,2009-04-11 14:27:45,2009-04-11 14:27:45
0a242467dd648935e06e4bee4eecac64375da778...16068bcc88c4d1ba2740fe5511e356c551d714a9,1,7,3,10,2,2009-04-12 01:19:29,2009-04-12 01:19:29
16068bcc88c4d1ba2740fe5511e356c551d714a9...0daa0c9cc86da472a1e8f9dfd545ec430d1fe739,1,10,0,10,2,2009-04-12 20:05:03,2009-04-12 20:05:03
0daa0c9cc86da472a1e8f9dfd545ec430d1fe739...391f2f01b60d71f0532a2e3bfa9900a8109a22cb,2,7,2,9,2,2009-04-13 02:19:04,2009-04-13 02:19:04
391f2f01b60d71f0532a2e3bfa9900a8109a22cb...7d9eebe9830196475ae2034621ae1fb72a0bbbad,4,41,17,58,19,2009-04-13 02:19:41,2009-04-13 02:19:41
8ac9b466f769de69ab68135d605e652874c2c154...ce755ac54e5f7ad071198a09b53a0e1a2268e4eb,2,7,8,15,8,2009-04-10 18:44:52,2009-04-10 18:44:52
ce755ac54e5f7ad071198a09b53a0e1a2268e4eb...285103740e46c5e3af8bc328bbcbf8e55d8bbf90,1,1,0,1,1,2009-04-10 18:46:02,2009-04-10 18:46:02
42dc27e4e9ba78d858723770c7e5ae85edc59a21...969a20b4f60f5daadd13684b7ce09447c4e5ac9e,4,21,11,32,13,2009-04-10 19:24:11,2009-04-10 19:24:11
969a20b4f60f5daadd13684b7ce09447c4e5ac9e...ea5b205666766a7128806e6be489154ef0ed0c49,2,46,38,84,12,2009-04-10 21:03:45,2009-04-10 21:03:45
ea5b205666766a7128806e6be489154ef0ed0c49...0747a712ff033b9383044dc744d5601d2b007e04,1,43,30,73,8,2009-04-10 21:21:06,2009-04-10 21:21:06
0747a712ff033b9383044dc744d5601d2b007e04...0f9c165ad0c084e21be6bcd4c9f63de4698577c4,1,1,3,4,3,2009-04-10 21:55:55,2009-04-10 21:55:55
0f9c165ad0c084e21be6bcd4c9f63de4698577c4...f660a763693f96a39bcda496df29a609e0c42c33,3,93,47,140,31,2009-04-16 15:36:06,2009-04-16 15:36:06
7d9eebe9830196475ae2034621ae1fb72a0bbbad...53a54c825e2193085848361ba72d555a92b34f54,1,4,0,4,1,2009-04-13 15:40:17,2009-04-13 15:40:17
53a54c825e2193085848361ba72d555a92b34f54...de3b76ff4508ccc13f8548f05e02042e94a1e3dc,1,14,0,14,2,2009-04-13 15:40:31,2009-04-13 15:40:31
7d9eebe9830196475ae2034621ae1fb72a0bbbad...a2479cdf80af76ecf0941482861412c74e06b6c6,2,7,1,8,4,2009-04-13 14:47:42,2009-04-13 14:47:42
a2479cdf80af76ecf0941482861412c74e06b6c6...4000e64db84863ff6e219319bfd1283601a16171,2,4,2,6,3,2009-04-13 14:47:55,2009-04-13 14:47:55
66d11a15cd4772c8378c7e34f3f676c95085a361...8c52cd090333b7a66123c75d8f8eb3e73aaac3a9,1,1,1,2,1,2009-04-13 21:37:35,2009-04-13 21:37:35
66d11a15cd4772c8378c7e34f3f676c95085a361...5cfc62999c106433a3e20293d7d5cc8877ecfb3b,1,16,1,17,1,2009-04-13 20:39:41,2009-04-13 20:39:41
5cfc62999c106433a3e20293d7d5cc8877ecfb3b...ce293a0452f1cc914c0a888c255867aabaa42fcc,4,60,29,89,13,2009-04-13 20:40:30,2009-04-13 20:40:30
ce293a0452f1cc914c0a888c255867aabaa42fcc...b7b1ef32cbc7dcd877c1ad062f3ac2058d604325,2,23,30,53,4,2009-04-13 20:45:19,2009-04-13 20:45:19
6bf3d9d12465cfc7fe3b1d12300ca63608b312b6...47067f6b4e9342400624816eee298117f793e4e9,1,1,1,2,1,2009-04-17 14:37:42,2009-04-17 14:37:42
47067f6b4e9342400624816eee298117f793e4e9...3a834f87d4e330987a1717331dec7d7e6827a9e6,3,22,33,55,13,2009-04-17 14:38:11,2009-04-17 14:38:11
b7b1ef32cbc7dcd877c1ad062f3ac2058d604325...5654bed9443fba7e6651f5ea28c3c49b738e60ac,1,14,0,14,2,2009-04-13 21:47:10,2009-04-13 21:47:10
83f963d222235af1cb6cf4a44a3e6821094fd449...bf656b52ffcd61345445b54ca261d8e81f0ef077,4,74,36,110,19,2009-04-17 17:21:50,2009-04-17 17:21:50
bf656b52ffcd61345445b54ca261d8e81f0ef077...a0952834f92a2bc062f340c8bcb5a319aa7dcf06,1,113,0,113,1,2009-04-17 17:23:41,2009-04-17 17:23:41
a0952834f92a2bc062f340c8bcb5a319aa7dcf06...4a3631017bdb1819ad399a50af5112d3b49cc8de,4,263,26,289,33,2009-04-22 14:52:32,2009-04-22 14:52:32
4a3631017bdb1819ad399a50af5112d3b49cc8de...12d259e8a54192daa30f99d69a6a2bf60d5cad92,2,3,13,16,10,2009-04-22 15:57:45,2009-04-22 15:57:45
12d259e8a54192daa30f99d69a6a2bf60d5cad92...0eb64ee34272963b59f437922f09275043e6b996,2,26,71,97,17,2009-04-22 17:53:35,2009-04-22 17:53:35
e95e6b4ced8ba2e3b7f5e71be6452f16c5949faf...2e539cbdfece9020725f6ea07cdf08825a5fe627,2,5,1,6,3,2009-04-13 21:59:39,2009-04-13 21:59:39
2e539cbdfece9020725f6ea07cdf08825a5fe627...488fc3ae57f448fea5aa9d51391ad1af70400e09,1,1,0,1,1,2009-04-13 22:39:28,2009-04-13 22:39:28
488fc3ae57f448fea5aa9d51391ad1af70400e09...0a16c4f76288b401b5f26f64270a571816e2f632,2,7,13,20,6,2009-04-13 22:45:58,2009-04-13 22:45:58
0a16c4f76288b401b5f26f64270a571816e2f632...5f8ae454761b048c2ad825903922f90e0f44b689,5,74,3,77,12,2009-04-13 23:07:10,2009-04-13 23:07:10
5f8ae454761b048c2ad825903922f90e0f44b689...ae6ea342423e7bc73f1d4632d51a0f261f24600e,1,22,22,44,1,2009-04-13 23:08:33,2009-04-13 23:08:33
e54bfd896a22dec016302ca3b49ddb974661487b...efd6a1ec927355e50086c2fc01773262545553ac,2,3,6,9,3,2009-04-22 19:57:26,2009-04-22 19:57:26
efd6a1ec927355e50086c2fc01773262545553ac...047b1fb5890151a83c89acfd982a6b6d58872ad5,1,3,8,11,3,2009-04-22 20:25:53,2009-04-22 20:25:53
047b1fb5890151a83c89acfd982a6b6d58872ad5...86bfe9dbdf1d24224f60b43937daee04dbd59081,3,82,95,177,13,2009-04-22 21:44:23,2009-04-22 21:44:23
86bfe9dbdf1d24224f60b43937daee04dbd59081...429ea669d75d35123a48317b217db3c1422a3b34,1,1,1,2,2,2009-04-22 21:45:43,2009-04-22 21:45:43
429ea669d75d35123a48317b217db3c1422a3b34...855b26d008b4e60bc06ced5e2c5442dbb07d9bb2,1,1,34,35,33,2009-04-22 21:52:33,2009-04-22 21:52:33
855b26d008b4e60bc06ced5e2c5442dbb07d9bb2...b049e7def3c92a4bb92aba8647a17cc95e1ad585,3,25,2,27,10,2009-04-22 22:35:45,2009-04-22 22:35:45
b049e7def3c92a4bb92aba8647a17cc95e1ad585...20214fdded856aa569256208f950c0b3f0dec98a,1,5,3,8,4,2009-04-22 23:10:23,2009-04-22 23:10:23
ae6ea342423e7bc73f1d4632d51a0f261f24600e...0033bd91dfd8846e7f53e4a58c91714fa5b6d99e,12,237,60,297,33,2009-04-15 15:58:38,2009-04-15 15:58:38
0033bd91dfd8846e7f53e4a58c91714fa5b6d99e...5d9cb326056703acd0ce2e430b0afc0f3c8799f3,4,65,38,103,20,2009-04-15 18:57:37,2009-04-15 18:57:37
5d9cb326056703acd0ce2e430b0afc0f3c8799f3...c511cb61394bbfcebf72a1e8b7e03261acd3be80,1,2,2,4,2,2009-04-15 19:00:15,2009-04-15 19:00:15
c511cb61394bbfcebf72a1e8b7e03261acd3be80...a233875fbb5265e1e6cb7b41be32b72b7f9acc5d,1,2,0,2,2,2009-04-15 19:12:37,2009-04-15 19:12:37
ae6ea342423e7bc73f1d4632d51a0f261f24600e...60bede9dc2f620016b76fdce15c6f3c86cb70915,1,16,2,18,5,2009-04-15 14:45:15,2009-04-15 14:45:15
ae6ea342423e7bc73f1d4632d51a0f261f24600e...7eed0b9400b819a645c5acdd65e342c2195554ed,5,9,5,14,6,2009-04-15 14:29:17,2009-04-15 14:29:17
7eed0b9400b819a645c5acdd65e342c2195554ed...036ffaa817c5762893430c924bfa880d3c25cc07,2,2,2,4,2,2009-04-15 14:39:57,2009-04-15 14:39:57
b912d5ffda8cb0187cf70338cf623d1b142f425e...a7a3ee41fcca5d5972fffa1e6d64a17f8b5145ed,4,40,23,63,22,2009-04-23 15:27:52,2009-04-23 15:27:52
b912d5ffda8cb0187cf70338cf623d1b142f425e...64c5d55c59fac341a33bd69c4ac9a28aa71553cf,1,4,0,4,1,2009-04-23 15:16:54,2009-04-23 15:16:54
ebcd7f91576a1dcffb2ae1adaed4e082550fafb0...5dde63de12c1671f3908e2bd331ff2d0ae4e56e1,1,2,2,4,2,2009-04-15 19:23:47,2009-04-15 19:23:47
5dde63de12c1671f3908e2bd331ff2d0ae4e56e1...170106ace9ec42ac217ae9765558ffed3d8984c9,1,1,0,1,1,2009-04-15 19:28:04,2009-04-15 19:28:04
170106ace9ec42ac217ae9765558ffed3d8984c9...ae473981f58a97f52a6c86f5421b05f28d63371d,1,0,1,1,1,2009-04-15 19:39:15,2009-04-15 19:39:15
ae473981f58a97f52a6c86f5421b05f28d63371d...836e92e7ddc2bdd090e7cffa3ab039c9f9c0bc50,1,2,2,4,2,2009-04-15 19:39:28,2009-04-15 19:39:28
836e92e7ddc2bdd090e7cffa3ab039c9f9c0bc50...9ccebf3f4c00543809d8951b803ae2dd93b9db35,1,2,2,4,2,2009-04-15 19:39:49,2009-04-15 19:39:49
9ccebf3f4c00543809d8951b803ae2dd93b9db35...668cf57c520596bb44909027787e4ab9436dd456,4,38,65,103,20,2009-04-15 19:39:57,2009-04-15 19:39:57
668cf57c520596bb44909027787e4ab9436dd456...40bbf305b5465e3f8563e65c07173e9abda6018f,1,0,2,2,1,2009-04-15 19:40:05,2009-04-15 19:40:05
40bbf305b5465e3f8563e65c07173e9abda6018f...e577a2c64e6892be4a3112b7a18add934c82ed06,12,60,237,297,33,2009-04-15 19:40:16,2009-04-15 19:40:16
e577a2c64e6892be4a3112b7a18add934c82ed06...7cb2b1e84d929aca81c6592323d7ef3ea0760540,1,0,2,2,2,2009-04-15 19:58:43,2009-04-15 19:58:43
7cb2b1e84d929aca81c6592323d7ef3ea0760540...d8fbc8817d21dd2e60f878a88d3d32b633140520,1,2,0,2,2,2009-04-15 20:10:13,2009-04-15 20:10:13
d8fbc8817d21dd2e60f878a88d3d32b633140520...c99883578c8f21cc9dac00f100ebc22310291bbb,12,237,60,297,33,2009-04-15 20:10:21,2009-04-15 20:10:21
c99883578c8f21cc9dac00f100ebc22310291bbb...89884a1811f30f4bff4156d5ba6ecc3f3b17167f,1,2,0,2,1,2009-04-15 20:10:28,2009-04-15 20:10:28
89884a1811f30f4bff4156d5ba6ecc3f3b17167f...e8c1ce4dc12a841a8e64b3f748c07fc3354ebe01,4,65,38,103,20,2009-04-15 20:10:34,2009-04-15 20:10:34
e8c1ce4dc12a841a8e64b3f748c07fc3354ebe01...9e6d8a769d9e13259f6e2c77db13423e87d758a9,1,2,2,4,2,2009-04-15 20:10:41,2009-04-15 20:10:41
9e6d8a769d9e13259f6e2c77db13423e87d758a9...a8abf5e6efce5c30bab12b7f00dc7d06fb849024,1,2,2,4,2,2009-04-15 20:10:48,2009-04-15 20:10:48
a8abf5e6efce5c30bab12b7f00dc7d06fb849024...ab078d2e96039564880538ced95c4075820455c9,1,1,0,1,1,2009-04-15 20:10:54,2009-04-15 20:10:54
ab078d2e96039564880538ced95c4075820455c9...f86d33372d25eea44c0a0fb60cd25b52c6cde080,9,13,10,23,10,2009-04-15 20:11:54,2009-04-15 20:11:54
f86d33372d25eea44c0a0fb60cd25b52c6cde080...405b490672a6a3da5153aa023930e82942896825,1,0,1,1,1,2009-04-15 20:13:59,2009-04-15 20:13:59
405b490672a6a3da5153aa023930e82942896825...a6d9ca7aca28b529da964f2e94d94ac62c6d0181,1,6,2,8,3,2009-04-15 20:52:39,2009-04-15 20:52:39
a6d9ca7aca28b529da964f2e94d94ac62c6d0181...94b1babc4a3aac1d8613665858bf3203b1674aa3,1,1,1,2,1,2009-04-15 21:53:01,2009-04-15 21:53:01
94b1babc4a3aac1d8613665858bf3203b1674aa3...db0cf082ecff3d3b8cff1f05bd7ff7cf5cf03998,1,1,1,2,1,2009-04-16 02:16:09,2009-04-16 02:16:09
db0cf082ecff3d3b8cff1f05bd7ff7cf5cf03998...23286dd9fcd1648c91166a319949729fe38efa76,1,1,11,12,1,2009-04-16 02:22:40,2009-04-16 02:22:40
23286dd9fcd1648c91166a319949729fe38efa76...d7b7217349f7e5bb0711f28202b4be39659a1ae6,2,22,1,23,3,2009-04-16 02:26:19,2009-04-16 02:26:19
d7b7217349f7e5bb0711f28202b4be39659a1ae6...016013f7560f650c7c6e1dd01e0b735edc7ca3d7,2,6,8,14,4,2009-04-16 02:36:33,2009-04-16 02:36:33
036ffaa817c5762893430c924bfa880d3c25cc07...17af5d737f51de99dc1ae5c676f707ad45ab18cc,1,1,1,2,1,2009-04-16 13:02:53,2009-04-16 13:02:53
036ffaa817c5762893430c924bfa880d3c25cc07...643ceabc75d8fa94fc0a26ca990f6cf3cf9eb0c6,1,2,0,2,1,2009-04-15 17:49:06,2009-04-15 17:49:06
88c85138e1fffb86efdc176dd6ed8c2dfc878844...1f696e21431279aba23f702ff12c03022a4be52b,11,140,77,217,57,2009-04-23 18:28:22,2009-04-23 18:28:22
64c5d55c59fac341a33bd69c4ac9a28aa71553cf...8bf9e88cf1136c9385e56d02f165da998082b6c1,3,47,4,51,10,2009-04-23 16:16:18,2009-04-23 16:16:18
8bf9e88cf1136c9385e56d02f165da998082b6c1...1250efc54c27ae05ded73a020dd4cfbab49ed9df,1,2,2,4,2,2009-04-23 16:18:44,2009-04-23 16:18:44
1250efc54c27ae05ded73a020dd4cfbab49ed9df...b3cfede1e8999482e805037788bbac79024143d1,1,3,0,3,1,2009-04-23 17:05:03,2009-04-23 17:05:03
382527d44d5ff92c08f66441d9a59a5735d6cf46...3fce2036d848c8f678893ba40707be489dbaae28,1,1,1,2,1,2009-04-16 13:16:43,2009-04-16 13:16:43
310804303c7798a941f4cf5dcba84e8efceaeaa8...c434bed746c421da2073900b3408edafa4973cda,5,20,16,36,11,2009-04-23 20:39:41,2009-04-23 20:39:41
310804303c7798a941f4cf5dcba84e8efceaeaa8...ed0065fff2feeda2a6c943a6d6a63ab13de0ccaf,5,14,7,21,6,2009-04-23 18:31:40,2009-04-23 18:31:40
ed0065fff2feeda2a6c943a6d6a63ab13de0ccaf...9a3a7f3c8874c5c46133e0fbd0c9032f2285d820,1,23,5,28,8,2009-04-23 19:40:00,2009-04-23 19:40:00
993aed6f2b9a2e5350821a44c3c928ec167014ea...c303686482e6726392c3733ed35851a317d198e6,14,12,52,64,17,2009-04-23 17:55:07,2009-04-23 17:55:07
fd5f1ecb09fb30e26272a9c68b8227fc576b7127...7596bf2e980d508cbb14b02d21fa3dc3104c3c4c,2,6,3,9,2,2009-04-24 02:28:11,2009-04-24 02:28:11
7596bf2e980d508cbb14b02d21fa3dc3104c3c4c...9c88c32b04003636e7036233f2f69ad93ee3ca5a,4,40,11,51,7,2009-04-24 02:44:19,2009-04-24 02:44:19
9c88c32b04003636e7036233f2f69ad93ee3ca5a...8a5b5607e0da4b5f4c09de1b7622a83a31bb9c05,2,103,6,109,8,2009-04-24 03:52:47,2009-04-24 03:52:47
3fce2036d848c8f678893ba40707be489dbaae28...f9a42555bb768343ff82cedc52223a24b0bd2234,5,88,2,90,12,2009-04-16 14:19:52,2009-04-16 14:19:52
3fce2036d848c8f678893ba40707be489dbaae28...94217c0d662f97775bddb9926aa8e8e536e0dd7d,1,1,0,1,1,2009-04-16 14:18:09,2009-04-16 14:18:09
4c1b9f511a018d579d6dc5674f5837cbd183f8f4...2cd10ab9c24c419f4f86561d30fff4eaad23bc85,5,42,38,80,19,2009-04-23 20:51:51,2009-04-23 20:51:51
c303686482e6726392c3733ed35851a317d198e6...c9bf4e85279d7d172aea4a4d964fe1aabfcffc98,2,38,25,63,22,2009-04-23 18:44:05,2009-04-23 18:44:05
c9bf4e85279d7d172aea4a4d964fe1aabfcffc98...be64ebd0adcb38c765e8af0c83669f071fac5e78,1,34,12,46,8,2009-04-23 19:00:40,2009-04-23 19:00:40
be64ebd0adcb38c765e8af0c83669f071fac5e78...35ad91359620d3148a19f814a2f2260692e314d6,2,95,17,112,12,2009-04-23 20:00:57,2009-04-23 20:00:57
35ad91359620d3148a19f814a2f2260692e314d6...63cc171bbba2b0e0ac97d3b6563bfeb2150bea78,7,171,186,357,16,2009-04-23 22:01:24,2009-04-23 22:01:24
63cc171bbba2b0e0ac97d3b6563bfeb2150bea78...7088413cf36d47c24816c6d00d615f342e5d9356,1,99,0,99,1,2009-04-23 22:02:51,2009-04-23 22:02:51
7088413cf36d47c24816c6d00d615f342e5d9356...97bbbb35cd633af1f71d04fbfc28d35ceaba4826,2,21,0,21,7,2009-04-23 22:26:42,2009-04-23 22:26:42
97bbbb35cd633af1f71d04fbfc28d35ceaba4826...c710e7b01a0bb8748a31757315f371487ea43fb8,3,110,21,131,21,2009-04-24 15:14:29,2009-04-24 15:14:29
c710e7b01a0bb8748a31757315f371487ea43fb8...bd078cd876c93ba78ac7a756c3b78b8503abbbe5,4,36,35,71,24,2009-04-24 15:36:42,2009-04-24 15:36:42
bd078cd876c93ba78ac7a756c3b78b8503abbbe5...10c0670c52a56cc454c15a063fd50fdb1fe10881,6,56,34,90,35,2009-04-24 18:35:13,2009-04-24 18:35:13
10c0670c52a56cc454c15a063fd50fdb1fe10881...a074f284b5e65989fee97007efbf553952753379,1,0,1,1,1,2009-04-24 19:05:08,2009-04-24 19:05:08
8a5b5607e0da4b5f4c09de1b7622a83a31bb9c05...3ca02da7e3d97257a7c914f5f2fc20cd8055c36b,3,18,2,20,7,2009-04-28 12:47:56,2009-04-28 12:47:56
94217c0d662f97775bddb9926aa8e8e536e0dd7d...56e2e866bd6ef3b15acead8bf0ca65a97feec24d,4,9,4,13,8,2009-04-16 14:33:21,2009-04-16 14:33:21
9157bb33bafc8e6b607ba45f8a1983addd59df4a...c01f13417ef23c8821e0f06ce8e6f4570835815c,1,45,0,45,1,2009-04-16 21:35:26,2009-04-16 21:35:26
2cd10ab9c24c419f4f86561d30fff4eaad23bc85...1a265e0fba8e0755dc567cec6fd1e2096ac2c30d,2,138,3,141,8,2009-04-23 21:40:43,2009-04-23 21:40:43
2cd10ab9c24c419f4f86561d30fff4eaad23bc85...3a0fb41feccea00096d9b53a09ead8dbde1fd68a,1,48,48,96,27,2009-04-23 21:17:11,2009-04-23 21:17:11
3a0fb41feccea00096d9b53a09ead8dbde1fd68a...fe648d0feab1624ad0fc03beddeabe11f21d8d5b,1,1,1,2,1,2009-04-23 21:17:30,2009-04-23 21:17:30
fe648d0feab1624ad0fc03beddeabe11f21d8d5b...872194083c2fe9eeac58527dc2700fdbea9f8576,1,2,1,3,1,2009-04-23 21:27:12,2009-04-23 21:27:12
e1b1d3d321bc39e0b0eaa642c87d88ce2537a520...d03996bf9881c44082a2ff13aa4123d2c66785f2,1,1,1,2,1,2009-04-24 19:15:52,2009-04-24 19:15:52
52fcb7b101d0ef57f76b6ba66764f0184048ef74...c4cbebd356302a495ada960f4fd98f95b67f2cb0,1,5,0,5,2,2009-04-16 15:14:06,2009-04-16 15:14:06
c4cbebd356302a495ada960f4fd98f95b67f2cb0...ee6ef61ca43670127cd8c5d3bc56cc7a9f83221b,2,43,2,45,5,2009-04-16 15:27:10,2009-04-16 15:27:10
c01f13417ef23c8821e0f06ce8e6f4570835815c...12fee00fbb2b4308d3484a0a3f01d4d59c61d4e2,1,5,1,6,3,2009-04-17 17:33:44,2009-04-17 17:33:44
12fee00fbb2b4308d3484a0a3f01d4d59c61d4e2...8a95771e25246984f0307c5dc5de0d4ef79ee9eb,1,1,1,2,1,2009-04-17 20:23:01,2009-04-17 20:23:01
8a95771e25246984f0307c5dc5de0d4ef79ee9eb...425f6eef498c35783e638298f87bfd417c94ddcf,1,57,0,57,1,2009-04-17 21:07:04,2009-04-17 21:07:04
425f6eef498c35783e638298f87bfd417c94ddcf...5da75cb8f4e75a14c5ae8476767587842b49dc87,5,144,4,148,19,2009-04-17 21:11:32,2009-04-17 21:11:32
5da75cb8f4e75a14c5ae8476767587842b49dc87...20cfef650c47676009388ce77d3e194fcc5fbb95,1,1,1,2,1,2009-04-17 21:39:31,2009-04-17 21:39:31
20cfef650c47676009388ce77d3e194fcc5fbb95...98522371c4f6a53e90bda30fabcd941f3675b24d,1,1,1,2,1,2009-04-17 21:41:07,2009-04-17 21:41:07
98522371c4f6a53e90bda30fabcd941f3675b24d...4a53d4665312c6dad801bb9b3652b56c8da3a3a4,4,37,9,46,10,2009-04-19 01:55:34,2009-04-19 01:55:34
4a53d4665312c6dad801bb9b3652b56c8da3a3a4...2a64bca3e2632aa964885e5938cf60780f88f88e,1,1,1,2,1,2009-04-20 13:16:47,2009-04-20 13:16:47
2a64bca3e2632aa964885e5938cf60780f88f88e...9b2f190ab99996d5b8cd872e37496c729122d523,2,31,15,46,9,2009-04-20 14:29:26,2009-04-20 14:29:26
9b2f190ab99996d5b8cd872e37496c729122d523...c34ef0f68d7f0dd493bdd2e50798f2c0211a71a7,1,19,16,35,7,2009-04-20 16:38:36,2009-04-20 16:38:36
c34ef0f68d7f0dd493bdd2e50798f2c0211a71a7...80847b561c5851fa763866af06bb021af893f31a,8,111,18,129,23,2009-04-20 17:51:54,2009-04-20 17:51:54
d03996bf9881c44082a2ff13aa4123d2c66785f2...6fffb6fae32d80ed7895af75f0b0b59d8cfe5ff6,1,4,2,6,3,2009-04-24 22:10:12,2009-04-24 22:10:12
6fffb6fae32d80ed7895af75f0b0b59d8cfe5ff6...8d72ed78c31c3d3387517da2d0b5aa11b3659dcc,1,11,7,18,1,2009-04-24 22:14:35,2009-04-24 22:14:35
8d72ed78c31c3d3387517da2d0b5aa11b3659dcc...470731bd4cc67c66653431f18ce5662e13d1f05a,1,9,3,12,4,2009-04-24 22:16:10,2009-04-24 22:16:10
470731bd4cc67c66653431f18ce5662e13d1f05a...f72be5279f15ff7820ef4c8c330fe233be3cf0ac,2,9,2,11,4,2009-04-24 22:16:26,2009-04-24 22:16:26
f72be5279f15ff7820ef4c8c330fe233be3cf0ac...7f6d4af0882c46704fb8f9e7cb64f25fc15cb903,1,1,1,2,1,2009-04-24 22:19:40,2009-04-24 22:19:40
d03996bf9881c44082a2ff13aa4123d2c66785f2...530c1f2e7bf6a73733d5bc7cf148d902def4a2a0,1,0,1,1,1,2009-04-24 19:56:53,2009-04-24 19:56:53
530c1f2e7bf6a73733d5bc7cf148d902def4a2a0...4fcbdf301edcace83950c7045fbac35bad61e4a9,5,55,17,72,12,2009-04-24 20:41:40,2009-04-24 20:41:40
4fcbdf301edcace83950c7045fbac35bad61e4a9...62026b4bb54f329364698e071a99567c16ac7a07,1,15,1,16,3,2009-04-24 21:19:24,2009-04-24 21:19:24
fd0bcbfdb382700833bbbad0ccbda3ba72abc48f...75a4ef93ab2bb4cec54063ce2f845189c86a4a6e,1,1,1,2,1,2009-04-28 20:44:17,2009-04-28 20:44:17
ee6ef61ca43670127cd8c5d3bc56cc7a9f83221b...d59d81f130a3c07d125eef2a2e9b9ec7d026505c,1,9,1,10,1,2009-04-16 17:40:53,2009-04-16 17:40:53
80847b561c5851fa763866af06bb021af893f31a...458617399d4aa29e03d734ac47af0e683b67c663,1,3,0,3,3,2009-04-20 18:45:45,2009-04-20 18:45:45
80847b561c5851fa763866af06bb021af893f31a...716a7b49bf62e2e98690fe91b4901e8fb9b9ccd4,5,25,6,31,7,2009-04-20 18:23:42,2009-04-20 18:23:42
716a7b49bf62e2e98690fe91b4901e8fb9b9ccd4...33711227a342ddafbe81a27163fbfac86f7651f0,1,1,1,2,1,2009-04-20 18:32:41,2009-04-20 18:32:41
eca721e96d220bc37166b3d38e053dc224dee1f5...3856fb69b6d457b18935d62ad38cf5d3984fae61,1,0,1,1,1,2009-04-25 01:16:15,2009-04-25 01:16:15
3856fb69b6d457b18935d62ad38cf5d3984fae61...38aac595899ac09d1334047cd7265ae54d46f27b,1,1,1,2,1,2009-04-25 01:27:25,2009-04-25 01:27:25
38aac595899ac09d1334047cd7265ae54d46f27b...45131a620e831e548c9bcfad78ab4831a0f310bf,1,1,1,2,1,2009-04-26 12:14:37,2009-04-26 12:14:37
e043de519d110099eb3e061c5ff81c37e277a762...7bde5793bd15a404e037e33c859fecce1319f44a,2,83,26,109,12,2009-04-29 14:16:39,2009-04-29 14:16:39
7bde5793bd15a404e037e33c859fecce1319f44a...6e3122086ef8a76c5f91e65e081dfd719d9f6f88,2,18,9,27,11,2009-04-29 14:29:56,2009-04-29 14:29:56
6e3122086ef8a76c5f91e65e081dfd719d9f6f88...b927e1bade37267afdc3a2beaa1791f20244b0f9,2,35,13,48,11,2009-04-29 15:12:35,2009-04-29 15:12:35
33711227a342ddafbe81a27163fbfac86f7651f0...52e64ed0aa705bae998b06d08600ac176d2cce2b,1,17,3,20,7,2009-04-20 19:02:11,2009-04-20 19:02:11
52e64ed0aa705bae998b06d08600ac176d2cce2b...f90383a93a2a60e65361c495123dd6d80acf9828,1,24,1,25,2,2009-04-20 20:00:28,2009-04-20 20:00:28
45131a620e831e548c9bcfad78ab4831a0f310bf...b2a3fc9fb84f8234f423ca0c36440fe47c617c4d,2,8,1,9,2,2009-04-27 15:20:47,2009-04-27 15:20:47
45131a620e831e548c9bcfad78ab4831a0f310bf...8305e4cd77f3e8483405b70781f5d9bf26d9c1c4,3,15,17,32,8,2009-04-27 14:31:32,2009-04-27 14:31:32
b927e1bade37267afdc3a2beaa1791f20244b0f9...161ac0f769d6d4c6f3df369493ee6a139b3175fc,2,39,8,47,10,2009-04-29 19:45:11,2009-04-29 19:45:11
b927e1bade37267afdc3a2beaa1791f20244b0f9...7d720f1f330b6b4e076e59cb1f850fac21432b50,9,25,10,35,16,2009-04-29 18:14:51,2009-04-29 18:14:51
e3f3172ef95f6ff92804b7646d61e6f9d0a70c0d...a3e5b256bd2cd6ebcf70d941893b4a66dae9bdf7,1,1,0,1,1,2009-04-20 20:06:02,2009-04-20 20:06:02
8305e4cd77f3e8483405b70781f5d9bf26d9c1c4...6a2329b040c58f23c214179503a9718895fdef0b,6,111,24,135,26,2009-04-27 18:43:05,2009-04-27 18:43:05
6a2329b040c58f23c214179503a9718895fdef0b...c8069bb2e6fc4de550b9a794c2afb77fcdbd4436,1,1,1,2,1,2009-04-27 18:56:15,2009-04-27 18:56:15
7d720f1f330b6b4e076e59cb1f850fac21432b50...e38ca49cb1723029cc86eaf7a93bbe2aa16875f6,5,103,224,327,49,2009-04-29 20:27:01,2009-04-29 20:27:01
a3e5b256bd2cd6ebcf70d941893b4a66dae9bdf7...9ddf2d4c1fc9fa4199297e61430b04d7fac726c7,1,12,0,12,1,2009-04-20 21:41:27,2009-04-20 21:41:27
9ddf2d4c1fc9fa4199297e61430b04d7fac726c7...71727701e5d0c31978c9c1a6db6d64e191bbcfcf,5,130,4,134,11,2009-04-20 21:42:01,2009-04-20 21:42:01
71727701e5d0c31978c9c1a6db6d64e191bbcfcf...170e654bd2ecb8044aeec5ae41d50d98d6315fc5,2,4,2,6,2,2009-04-21 01:50:43,2009-04-21 01:50:43
170e654bd2ecb8044aeec5ae41d50d98d6315fc5...f6e6428436dc6024a788a52fe49488dee2436097,1,7,0,7,3,2009-04-21 03:31:26,2009-04-21 03:31:26
f6e6428436dc6024a788a52fe49488dee2436097...112d60819a900b2313b177d7fe90c1c7d5783b9f,1,1,0,1,1,2009-04-21 10:35:33,2009-04-21 10:35:33
112d60819a900b2313b177d7fe90c1c7d5783b9f...995555b64a9656289de6ef61c89729ac7064dcf0,1,3,4,7,3,2009-04-21 10:57:38,2009-04-21 10:57:38
995555b64a9656289de6ef61c89729ac7064dcf0...03089a911be314d64a38d5a324e4b5f07a2c63c2,1,18,0,18,1,2009-04-21 11:35:00,2009-04-21 11:35:00
03089a911be314d64a38d5a324e4b5f07a2c63c2...db0f57ba0e0919751711b592246cc42f95a1791c,1,4,6,10,2,2009-04-21 11:35:11,2009-04-21 11:35:11
db0f57ba0e0919751711b592246cc42f95a1791c...cb29d69eefd04dae3f813d126d3dcadeda9bd253,1,2,1,3,1,2009-04-21 13:48:34,2009-04-21 13:48:34
cb29d69eefd04dae3f813d126d3dcadeda9bd253...b999749360dcbf19e628ba6052715c0921463f3e,3,25,7,32,4,2009-04-21 14:10:30,2009-04-21 14:10:30
a3e5b256bd2cd6ebcf70d941893b4a66dae9bdf7...d4ede794a9be1b9c7cfa38d37478056ef9ac457f,1,2,0,2,1,2009-04-20 20:18:47,2009-04-20 20:18:47
d4ede794a9be1b9c7cfa38d37478056ef9ac457f...7d85516931e598348d61b86ec1a256ba388234ce,2,14,1,15,4,2009-04-20 22:17:52,2009-04-20 22:17:52
7d85516931e598348d61b86ec1a256ba388234ce...b1cc3f6223bb2a1f12dbd8c2712267ae01cb511b,8,47,34,81,30,2009-04-20 22:40:38,2009-04-20 22:40:38
b1cc3f6223bb2a1f12dbd8c2712267ae01cb511b...fd407c04f26e37844eca53688740f2fbb2e6d404,1,16,22,38,19,2009-04-20 22:54:01,2009-04-20 22:54:01
fd407c04f26e37844eca53688740f2fbb2e6d404...ecc651ea43c1cfb2e4ca7aae68c533419e7fcb0f,3,12,6,18,7,2009-04-21 00:17:39,2009-04-21 00:17:39
ecc651ea43c1cfb2e4ca7aae68c533419e7fcb0f...ca7227f3d50d43ebf399a51e54aa059923b7ae20,2,14,14,28,14,2009-04-21 19:10:13,2009-04-21 19:10:13
ca7227f3d50d43ebf399a51e54aa059923b7ae20...eb5fa5c7d89b6bb435dba8a26cd10be9fe90c075,9,87,68,155,23,2009-04-21 19:42:22,2009-04-21 19:42:22
b23bd52c8a01e8b6ff77989979857c7b4ca30877...992bb3f069ce6afd278f41e95f4ff6c649bff8a2,1,2,4,6,3,2009-04-27 19:11:43,2009-04-27 19:11:43
992bb3f069ce6afd278f41e95f4ff6c649bff8a2...7560c29dc26013de1bd81678d85645dcfc385910,2,27,7,34,7,2009-04-27 19:30:17,2009-04-27 19:30:17
7560c29dc26013de1bd81678d85645dcfc385910...e501658529652d8c792431b31f6cb1ad72112008,1,2,2,4,2,2009-04-27 19:32:27,2009-04-27 19:32:27
e501658529652d8c792431b31f6cb1ad72112008...8083500f7ce3d44e471078d08688e437a95261b1,1,1,1,2,1,2009-04-27 20:10:21,2009-04-27 20:10:21
8083500f7ce3d44e471078d08688e437a95261b1...ed8bf452025dd3bc2797d4a33cdc40de19eddbb9,1,28,8,36,9,2009-04-27 21:24:07,2009-04-27 21:24:07
ed8bf452025dd3bc2797d4a33cdc40de19eddbb9...cc3887c8647f963d66f1fbcf7ba4b67acb43b03b,6,13,13,26,7,2009-04-27 23:12:32,2009-04-27 23:12:32
cc3887c8647f963d66f1fbcf7ba4b67acb43b03b...ce91c67c40e24c817214e1d71bb486d7831035da,6,13,13,26,7,2009-04-27 23:51:35,2009-04-27 23:51:35
408105e6eed952d9072a043a15e9e7203674df1e...0e7abe0740bdd61b25eb11e03ef352e8b71b7fb0,2,36,2,38,4,2009-04-29 20:55:16,2009-04-29 20:55:16
0e7abe0740bdd61b25eb11e03ef352e8b71b7fb0...2abdb949a1bcf5e603c67b5e4893aad2f1e485c5,1,1,1,2,1,2009-04-29 21:02:50,2009-04-29 21:02:50
2abdb949a1bcf5e603c67b5e4893aad2f1e485c5...947c18dea107def9c9650e23182ef9eecada7b7d,1,3,3,6,2,2009-04-29 21:28:14,2009-04-29 21:28:14
947c18dea107def9c9650e23182ef9eecada7b7d...b3bb71348ebc2227ffa031985433992e23cad16e,3,3,2,5,3,2009-04-30 13:09:12,2009-04-30 13:09:12
b3bb71348ebc2227ffa031985433992e23cad16e...6914eeb2c8fe218303cb06c7f2c615a2209de0c0,2,51,18,69,10,2009-04-30 14:40:33,2009-04-30 14:40:33
6914eeb2c8fe218303cb06c7f2c615a2209de0c0...e366fb43aca02ceb864813656b99d08e6f47109e,4,10,1,11,4,2009-04-30 14:51:54,2009-04-30 14:51:54
e366fb43aca02ceb864813656b99d08e6f47109e...d4e08f8a5ce60f5aeb05b030b2f2797ab0003674,1,1,0,1,1,2009-04-30 15:27:00,2009-04-30 15:27:00
d4e08f8a5ce60f5aeb05b030b2f2797ab0003674...de01cc8c1aedadb1acfff8d6eb575e28aaf89a86,1,7,0,7,3,2009-04-30 16:02:56,2009-04-30 16:02:56
de01cc8c1aedadb1acfff8d6eb575e28aaf89a86...af59c4ea9e47fdc77a2ae19e625971fa7245424b,8,265,135,400,51,2009-04-30 20:25:36,2009-04-30 20:25:36
af59c4ea9e47fdc77a2ae19e625971fa7245424b...a229845cebafd65dba93e88427c0ffe3e0e1f884,5,100,38,138,16,2009-04-30 21:36:25,2009-04-30 21:36:25
a229845cebafd65dba93e88427c0ffe3e0e1f884...3beb7b4170c8cde4c91a3425f96f6f12b4d7e4ad,1,38,0,38,1,2009-04-30 21:36:44,2009-04-30 21:36:44
b999749360dcbf19e628ba6052715c0921463f3e...77c6ea6148bccc82fba4ead329f1f2428d0577f0,1,3,3,6,2,2009-04-21 18:31:30,2009-04-21 18:31:30
b999749360dcbf19e628ba6052715c0921463f3e...966f30d3583859b4d6ff31ed08d89eee8b0aa7c0,1,14,0,14,1,2009-04-21 17:55:35,2009-04-21 17:55:35
ce91c67c40e24c817214e1d71bb486d7831035da...532e36902404871a9e56b42a69af12796e5c38e9,6,13,13,26,7,2009-04-28 14:11:39,2009-04-28 14:11:39
532e36902404871a9e56b42a69af12796e5c38e9...3b6b5df7d664908d8dde0899985d675e3c6ca392,1,61,0,61,1,2009-04-28 14:11:55,2009-04-28 14:11:55
3b6b5df7d664908d8dde0899985d675e3c6ca392...12e5d79ff0991bb518a48354da3433a8a60dee1e,1,1,1,2,1,2009-04-28 14:24:11,2009-04-28 14:24:11
3beb7b4170c8cde4c91a3425f96f6f12b4d7e4ad...5530e63caa8407a9082131dc957ec70dec8ff9f7,1,8,6,14,1,2009-05-01 14:41:49,2009-05-01 14:41:49
3beb7b4170c8cde4c91a3425f96f6f12b4d7e4ad...d3c480ac3f3854e763eb49cdf8a24d19457ac7fb,1,2,0,2,1,2009-05-01 14:40:42,2009-05-01 14:40:42
b28510fb184f8ded3c1b3ee50adc62048122809c...f43721ad572fb33e5cac8ff9b0b88f6e1a955c96,1,71,71,142,65,2009-04-21 19:08:20,2009-04-21 19:08:20
f43721ad572fb33e5cac8ff9b0b88f6e1a955c96...904088e1310ee96afdecd8ffd72dc2db6a89f55d,1,2,0,2,2,2009-04-21 19:11:29,2009-04-21 19:11:29
302bc3a3b0c9b10941cb228bf350d97ffcc7f0b4...a4ec6988476e2586a27d116b460ba0dbeaa95d0b,1,4,0,4,1,2009-04-21 20:22:54,2009-04-21 20:22:54
a4ec6988476e2586a27d116b460ba0dbeaa95d0b...5ec618c55418c4ff77e549d6ff9a4daca3373abe,1,1,0,1,1,2009-04-21 20:30:29,2009-04-21 20:30:29
5ec618c55418c4ff77e549d6ff9a4daca3373abe...54f806da952c610357a6649cf6f8169e1f19fee0,3,64,51,115,5,2009-04-21 21:01:33,2009-04-21 21:01:33
54f806da952c610357a6649cf6f8169e1f19fee0...61ed53b9af350deb3794c00a576dae276d051b5f,1,1,1,2,1,2009-04-21 21:38:34,2009-04-21 21:38:34
61ed53b9af350deb3794c00a576dae276d051b5f...e9b4457aa70294239aecf4b22d64d5dca69ac9e3,1,4,3,7,4,2009-04-21 21:52:11,2009-04-21 21:52:11
e9b4457aa70294239aecf4b22d64d5dca69ac9e3...c40ad9f56ea8e78a393b641a023441cdbf8b70cc,1,1,1,2,1,2009-04-22 00:12:41,2009-04-22 00:12:41
c40ad9f56ea8e78a393b641a023441cdbf8b70cc...5113d30da5e2a3610af2d741836c37052c27a83d,1,2,2,4,2,2009-04-22 00:12:58,2009-04-22 00:12:58
12e5d79ff0991bb518a48354da3433a8a60dee1e...02a7e7c9b80872691aced8cd3513662541853087,2,140,65,205,6,2009-04-28 17:54:19,2009-04-28 17:54:19
02a7e7c9b80872691aced8cd3513662541853087...e19818604f5b57ff6413531747e12c5ef09f25bf,1,2,2,4,2,2009-04-28 17:56:58,2009-04-28 17:56:58
e19818604f5b57ff6413531747e12c5ef09f25bf...feb797fabfbdf3d782b702e36880fb81882f8ee8,2,41,14,55,9,2009-04-28 19:33:56,2009-04-28 19:33:56
feb797fabfbdf3d782b702e36880fb81882f8ee8...13dafd02811e3ffbbe30aeb65ab97eace71306a8,1,4,0,4,3,2009-04-28 19:39:07,2009-04-28 19:39:07
13dafd02811e3ffbbe30aeb65ab97eace71306a8...187145090c947b09032e7c6882a8dbe0e892a7a5,1,15,11,26,11,2009-04-28 19:42:44,2009-04-28 19:42:44
187145090c947b09032e7c6882a8dbe0e892a7a5...47a00e54adaff6bb292114143f9c4ce93ada9353,1,48,9,57,8,2009-04-28 21:54:04,2009-04-28 21:54:04
47a00e54adaff6bb292114143f9c4ce93ada9353...d3717506023b82928a95e6f030bc1a827846ae93,3,100,182,282,34,2009-04-28 21:54:25,2009-04-28 21:54:25
d3717506023b82928a95e6f030bc1a827846ae93...d7485c23efeacc048b704497a4f8d1ec9fad7476,1,1,0,1,1,2009-04-28 21:58:56,2009-04-28 21:58:56
95ba86d74eb7acb7a5835d80c2d3be821a012a3e...871476dbb5d5110b847d4a8943ca1d4dd2fbd1e6,3,7,1,8,4,2009-05-01 18:34:44,2009-05-01 18:34:44
d3c480ac3f3854e763eb49cdf8a24d19457ac7fb...f928dbaffd34905d88ce2326aadc19852982b388,1,2,2,4,1,2009-05-01 14:44:15,2009-05-01 14:44:15
904088e1310ee96afdecd8ffd72dc2db6a89f55d...388de13f0d447a2c100836a1d3a57e4d37e55d92,1,46,34,80,34,2009-04-22 15:12:13,2009-04-22 15:12:13
904088e1310ee96afdecd8ffd72dc2db6a89f55d...e0fd1d4c26db0cc3c2032382cac9ebb0d88ee21d,2,9,1,10,2,2009-04-21 19:56:45,2009-04-21 19:56:45
5113d30da5e2a3610af2d741836c37052c27a83d...e0eafa5694b32672ffa8ce4204ecaf0d342aac0e,1,40,0,40,1,2009-04-22 14:53:28,2009-04-22 14:53:28
5113d30da5e2a3610af2d741836c37052c27a83d...9afc7f05f8d7f1a728ab33b5581471170097001a,1,1,1,2,1,2009-04-22 00:52:49,2009-04-22 00:52:49
7e4d9974decfd861bf923ea743c6df681569b726...a5d4d15090a1d8ee348e72f22f1a1c2acc2fd08e,2,7,1,8,3,2009-05-01 18:35:42,2009-05-01 18:35:42
a5d4d15090a1d8ee348e72f22f1a1c2acc2fd08e...e1070d84f786f0ebcc75911ea25324af8fc23bbf,1,3,0,3,1,2009-05-02 01:24:10,2009-05-02 01:24:10
e1070d84f786f0ebcc75911ea25324af8fc23bbf...e175182229328698c2b95fa880c56756285d97cd,2,134,11,145,20,2009-05-02 01:25:26,2009-05-02 01:25:26
e175182229328698c2b95fa880c56756285d97cd...21845dafb44734d7830638835f6d8a1e4613f8b5,1,41,11,52,10,2009-05-04 02:40:36,2009-05-04 02:40:36
21845dafb44734d7830638835f6d8a1e4613f8b5...bea1c15eba4743ebac2fbb7f5bda05a6662793c6,1,7,1,8,2,2009-05-04 02:40:55,2009-05-04 02:40:55
ff7474a50b975ce2709c31300da243d42c297976...b4c4d549d73bd4299e7f83301bf54868452fb092,1,6,2,8,2,2009-05-01 15:43:01,2009-05-01 15:43:01
b4c4d549d73bd4299e7f83301bf54868452fb092...09938a03510bb9bbc7f5d37d410c1ae85f0742c1,2,19,8,27,4,2009-05-01 16:18:17,2009-05-01 16:18:17
09938a03510bb9bbc7f5d37d410c1ae85f0742c1...aa8e5659c91916082d76e0e0ac10f0cef18eda0b,1,2,2,4,2,2009-05-01 17:14:37,2009-05-01 17:14:37
381918f9096e63ef57cf380e3c395b5c2fb8ed7e...314a79f82c5438cf173314d55c9ab9ecedf5e634,1,1,0,1,1,2009-04-22 15:15:22,2009-04-22 15:15:22
e0eafa5694b32672ffa8ce4204ecaf0d342aac0e...2c55aa388db8f8412a81d27e39e75ace0b748254,1,1,0,1,1,2009-04-22 16:58:39,2009-04-22 16:58:39
bea1c15eba4743ebac2fbb7f5bda05a6662793c6...1a739255bd51b87c23d75ae185c4bcc5a1463311,5,122,14,136,18,2009-05-04 20:49:05,2009-05-04 20:49:05
bea1c15eba4743ebac2fbb7f5bda05a6662793c6...ab5797713f427138fb6412daca7ec74f763b296c,1,20,4,24,5,2009-05-04 14:01:13,2009-05-04 14:01:13
ab5797713f427138fb6412daca7ec74f763b296c...5ddf162f3e5ca18b7ba728a8e347bc67ba38ebd0,1,1,0,1,1,2009-05-04 14:36:15,2009-05-04 14:36:15
5ddf162f3e5ca18b7ba728a8e347bc67ba38ebd0...84fe465a528aa907f165ece12d08db1b8ff6d02e,1,8,0,8,2,2009-05-04 14:48:57,2009-05-04 14:48:57
84fe465a528aa907f165ece12d08db1b8ff6d02e...661bce250bb230e6344d5441cd28d1b24ca70746,1,1,1,2,1,2009-05-04 15:17:26,2009-05-04 15:17:26
cb9e6153ddd0f5c2698f3506c80a5328fb441cb9...b9617339d4cab2dd7348b8e37fa99fc3523beb0a,3,40,21,61,10,2009-04-22 18:11:53,2009-04-22 18:11:53
cb9e6153ddd0f5c2698f3506c80a5328fb441cb9...1bb94684f5fd621c4ada69d2b2191bdf3bc71e7d,1,1,1,2,1,2009-04-22 17:36:29,2009-04-22 17:36:29
1bb94684f5fd621c4ada69d2b2191bdf3bc71e7d...b09d340d554a223d6661ef470b126f3914460b6d,1,1,1,2,1,2009-04-22 17:36:58,2009-04-22 17:36:58
ba5581e4546e4805b8314751933e3b10092b2bc2...e535ec014a896ea16bd67928602e90367e77683a,1,1,1,2,1,2009-05-04 20:55:40,2009-05-04 20:55:40
e535ec014a896ea16bd67928602e90367e77683a...4f8664a85ca47c68fc58ab370ccdde45cdcd948e,1,0,1,1,1,2009-05-04 21:00:37,2009-05-04 21:00:37
661bce250bb230e6344d5441cd28d1b24ca70746...1cc7ed2b075dabc90105d0f708dd39486830351f,2,6,4,10,6,2009-05-04 19:46:23,2009-05-04 19:46:23
1cc7ed2b075dabc90105d0f708dd39486830351f...2549b6ece20f2dcee77fdae50817244436bab78f,1,8,0,8,2,2009-05-04 20:00:28,2009-05-04 20:00:28
661bce250bb230e6344d5441cd28d1b24ca70746...187689b0cd24b96b8ca06b417c1a0674e5466af2,4,67,4,71,9,2009-05-04 15:49:18,2009-05-04 15:49:18
187689b0cd24b96b8ca06b417c1a0674e5466af2...57699cdd9c14957a5699434b794a5412aa4f8944,12,248,157,405,92,2009-05-04 21:37:02,2009-05-04 21:37:02
56959de5b052775137d410216ad40a52452af38c...c5cd549a5a14cc67410402cb95ee607178cbffee,1,54,3,57,3,2009-04-22 21:06:31,2009-04-22 21:06:31
56959de5b052775137d410216ad40a52452af38c...676fb4ea3cff94e5e24dddbef46113e04f452a02,2,9,7,16,6,2009-04-22 19:56:23,2009-04-22 19:56:23
676fb4ea3cff94e5e24dddbef46113e04f452a02...68b84b3f77213f5b857872aa84412305965e7ed2,5,145,14,159,6,2009-04-22 19:58:12,2009-04-22 19:58:12
a4cbf3072fb635af13fd21c99eaa2618c0371d81...2409174927c4d5b241a85eb70a65047f3a2e2872,3,70,53,123,23,2009-05-04 22:28:13,2009-05-04 22:28:13
2409174927c4d5b241a85eb70a65047f3a2e2872...2c2c2df90186dda704f851a9e2b996412f44f9fb,2,6,6,12,6,2009-05-04 22:45:32,2009-05-04 22:45:32
2409174927c4d5b241a85eb70a65047f3a2e2872...b8337bffa53c2fd64ab75b42a84169c0bbfdd75e,1,1,1,2,1,2009-05-04 22:41:38,2009-05-04 22:41:38
476820a13e393bb98f1fa14a006ecb8f41b5d33b...d5dc67eb3394d4a4f68d74bc242278e9967de27a,2,3,0,3,3,2009-05-06 23:02:48,2009-05-06 23:02:48
d5dc67eb3394d4a4f68d74bc242278e9967de27a...47ebf4cf08a1a3d9a4018eba8a5fc57d2c428ab2,2,48,8,56,11,2009-05-06 23:48:01,2009-05-06 23:48:01
47ebf4cf08a1a3d9a4018eba8a5fc57d2c428ab2...898b1feb1402a4bd915fed73a1d8abe235a8e36e,6,85,52,137,17,2009-05-07 00:24:01,2009-05-07 00:24:01
898b1feb1402a4bd915fed73a1d8abe235a8e36e...a4a9c6a3709a2c7573ac8f9b137dd1d80d1371ad,1,14,0,14,1,2009-05-07 00:24:37,2009-05-07 00:24:37
476820a13e393bb98f1fa14a006ecb8f41b5d33b...6f329f6694161aa21ad66fc252a63e01d8ddc809,1,10,4,14,2,2009-05-05 14:43:38,2009-05-05 14:43:38
6f329f6694161aa21ad66fc252a63e01d8ddc809...7c16a1476dd96b8fcfad49a8cd32e0a72f805cea,4,295,179,474,20,2009-05-05 14:43:54,2009-05-05 14:43:54
7c16a1476dd96b8fcfad49a8cd32e0a72f805cea...2cad033fc0fc581a8834a780969161a2aa5f95f6,2,9,8,17,4,2009-05-05 15:02:47,2009-05-05 15:02:47
2cad033fc0fc581a8834a780969161a2aa5f95f6...b9111a11f84dd7e977dee7597810be9912a90a47,1,4,1,5,2,2009-05-05 16:26:05,2009-05-05 16:26:05
2cad033fc0fc581a8834a780969161a2aa5f95f6...1ac991a0182779bdc7e7e2c87bf2f85a650b76e6,1,11,9,20,8,2009-05-05 16:09:45,2009-05-05 16:09:45
6969cfc8baf8d43f1acbd5325cc78ed1908bc488...a9e3f4912ff65aff10d52137b2731bc91f052ea2,1,0,3,3,1,2009-05-05 16:28:25,2009-05-05 16:28:25
1ac991a0182779bdc7e7e2c87bf2f85a650b76e6...7c0dc0bd621d72b05c21841c686658080d72e983,1,5,2,7,1,2009-05-05 16:52:53,2009-05-05 16:52:53
c866dcee7cfd28b7d33e6bb7aac3d258a2d9d17b...c6a6b880c9dbdade6c1203dd6ef34551df3bdf21,2,48,8,56,12,2009-05-11 14:44:27,2009-05-11 14:44:27
c6a6b880c9dbdade6c1203dd6ef34551df3bdf21...f0363bef0d019bbe8c437c6e3147ee82bc93ff67,3,18,11,29,5,2009-05-11 14:45:10,2009-05-11 14:45:10
f0363bef0d019bbe8c437c6e3147ee82bc93ff67...169f69aceea03f7b639426bc7a3be0b8e18ad80e,1,6,2,8,2,2009-05-11 14:46:19,2009-05-11 14:46:19
169f69aceea03f7b639426bc7a3be0b8e18ad80e...5a0f2e5501b25188ff5af5a511f340c1a601c847,3,29,8,37,8,2009-05-11 14:46:54,2009-05-11 14:46:54
5a0f2e5501b25188ff5af5a511f340c1a601c847...d24f8b9883e136603b0c48ab4f90eb47badbeae7,4,40,16,56,4,2009-05-11 14:48:08,2009-05-11 14:48:08
d24f8b9883e136603b0c48ab4f90eb47badbeae7...66a33c816232511bb5ba6e21049a0d318be2ba22,2,13,3,16,7,2009-05-11 14:49:11,2009-05-11 14:49:11
66a33c816232511bb5ba6e21049a0d318be2ba22...f077e9f75dd0afd541751650f53e0d1c91913c52,4,121,2,123,7,2009-05-11 14:49:30,2009-05-11 14:49:30
a9e3f4912ff65aff10d52137b2731bc91f052ea2...dac117fc10af511ac5a13a644c7f30550f770d2f,1,6,2,8,1,2009-05-05 17:48:56,2009-05-05 17:48:56
3001a8fdba5168924f32f5cfd40917673f811961...15a49a650ac08414ff2b5792c554bc6bd718174e,1,2,2,4,1,2009-05-05 17:35:46,2009-05-05 17:35:46
bafb23302e5a340af38b22c82d8bc488c3da484a...f290d9f0ec55f19505496049d761de25060b3a04,1,1,0,1,1,2009-05-11 14:51:05,2009-05-11 14:51:05
f290d9f0ec55f19505496049d761de25060b3a04...d4a976fd1a9a9fe3702cf552d0eefc76460cad05,1,2,2,4,4,2009-05-11 14:55:05,2009-05-11 14:55:05
d4a976fd1a9a9fe3702cf552d0eefc76460cad05...ff4aeec9565ab2747f8f903317995e8069ccef87,2,22,12,34,9,2009-05-11 15:01:47,2009-05-11 15:01:47
3c498f0b6a56a42609ee3209ca7d28ba63bf6698...e49beecc3a6c092d1fa55bf8f328f21a036c5132,1,2,0,2,1,2009-05-05 18:59:38,2009-05-05 18:59:38
e49beecc3a6c092d1fa55bf8f328f21a036c5132...77c36b8c3710a7e079a6db3639346fa00e01a313,4,28,11,39,7,2009-05-05 20:12:36,2009-05-05 20:12:36
77c36b8c3710a7e079a6db3639346fa00e01a313...c9d845038910f6ee04461289b71122e697d4a727,6,81,73,154,35,2009-05-05 21:28:24,2009-05-05 21:28:24
15a49a650ac08414ff2b5792c554bc6bd718174e...717da58e9c49e90391b76ba80b11ca64a53758fd,2,14,12,26,8,2009-05-05 21:44:46,2009-05-05 21:44:46
ff4aeec9565ab2747f8f903317995e8069ccef87...600206b125e06b5fe84d6ce48103e61855bcea47,2,5,3,8,5,2009-05-11 15:07:11,2009-05-11 15:07:11
600206b125e06b5fe84d6ce48103e61855bcea47...77aa3dd69059f917e199df3a604e6a343246bc43,1,1,1,2,1,2009-05-11 15:13:18,2009-05-11 15:13:18
ff4aeec9565ab2747f8f903317995e8069ccef87...5dc791b2d44ac9ae5996c53fb7dc117603ca9b54,1,1,1,2,1,2009-05-11 15:05:39,2009-05-11 15:05:39
fa8547cce60f8036d67d783c1ab965e5be70b1e9...c83226a08e470b6ba2f3d9bffa17393e1697076b,5,149,50,199,24,2009-05-06 15:00:22,2009-05-06 15:00:22
fa8547cce60f8036d67d783c1ab965e5be70b1e9...4e9edd6e7683961e1d10664a0efb9627b0128517,2,10,0,10,3,2009-05-06 14:19:11,2009-05-06 14:19:11
6fce297634ac283c49dee9b9d1cd7014a75b206e...a37863d5d75d12efc4bfd51921db0bedf1cbaa5a,1,1,0,1,1,2009-05-11 15:36:22,2009-05-11 15:36:22
6fce297634ac283c49dee9b9d1cd7014a75b206e...1276b9141a5f4390058e198d89f3682d0564885b,1,20,19,39,13,2009-05-11 15:23:43,2009-05-11 15:23:43
d907eb92a80e0d2cd583dc051d0b9762a246f03b...511f26f338bd0505d1d3a217673063420d76a9a9,3,71,9,80,8,2009-05-06 15:53:39,2009-05-06 15:53:39
4e9edd6e7683961e1d10664a0efb9627b0128517...6ea9c81aa34612d4625bf0d54d17ca24c4f44d22,7,38,19,57,22,2009-05-06 15:32:48,2009-05-06 15:32:48
7b54a8eb3cb1da593c898f7957b42565d9a7fd2c...70d64b047339b6e0aabe6484927515693e3b219a,2,29,6,35,9,2009-05-11 17:10:26,2009-05-11 17:10:26
70d64b047339b6e0aabe6484927515693e3b219a...39a974f354cf76a10bef1c5819179417bad008ae,1,14,1,15,3,2009-05-11 18:01:09,2009-05-11 18:01:09
1276b9141a5f4390058e198d89f3682d0564885b...83b3f358f116fed2a9fe31d039b17cda38fef40e,6,72,14,86,18,2009-05-11 16:41:49,2009-05-11 16:41:49
83b3f358f116fed2a9fe31d039b17cda38fef40e...d8fcd2f1af1fe2ebfb99e572c1e14b8535331ad1,1,14,1,15,2,2009-05-11 17:40:55,2009-05-11 17:40:55
d8fcd2f1af1fe2ebfb99e572c1e14b8535331ad1...eb6f7ca676c23a63d16d8fec5a72d56604704115,1,2,2,4,2,2009-05-11 18:05:56,2009-05-11 18:05:56
c295022581c00b1658eb6ab3c21d935746094484...1d90a0b5610f11592a54c6a2f8096ee39ef47643,1,0,4,4,3,2009-05-06 15:59:12,2009-05-06 15:59:12
1d90a0b5610f11592a54c6a2f8096ee39ef47643...2d128562849d76affd7d5d612ac68f2b3f455800,2,0,77,77,5,2009-05-06 16:34:22,2009-05-06 16:34:22
2d128562849d76affd7d5d612ac68f2b3f455800...7ebae06974477d346439cb1ed1a9e6741dc5357b,3,62,20,82,5,2009-05-06 16:48:19,2009-05-06 16:48:19
bbffab2d17089e2e3d69c750a2e9e3be80f13132...e8ea876e619ec628b22bd65f837cd1ba81436c3d,1,7,7,14,5,2009-05-06 17:17:07,2009-05-06 17:17:07
bbffab2d17089e2e3d69c750a2e9e3be80f13132...d94ae8d0f2dc6564caea8d66960fdc6a3d64491e,1,2,2,4,2,2009-05-06 15:43:28,2009-05-06 15:43:28
bbffab2d17089e2e3d69c750a2e9e3be80f13132...4cdfce21a9af0476bedc830b600100cb6fdfa0d0,1,2,2,4,2,2009-05-06 15:41:09,2009-05-06 15:41:09
39a974f354cf76a10bef1c5819179417bad008ae...48a4dab4dc3cda00a87821950a74028a8c248b1c,1,4,0,4,1,2009-05-11 18:10:15,2009-05-11 18:10:15
a1d3ebb0c44e4551d97c082f3ba3a644cb6d3e37...8e0ff9805a52736629c2bb205234c6dc1775568f,7,80,10,90,16,2009-05-06 19:30:05,2009-05-06 19:30:05
a1d3ebb0c44e4551d97c082f3ba3a644cb6d3e37...12941b58f32d018cba8355d754fa995b0a760fcc,1,5,5,10,5,2009-05-06 17:37:28,2009-05-06 17:37:28
12941b58f32d018cba8355d754fa995b0a760fcc...01899927546af8b2b3fd7bec55d3a3462989b83a,4,10,7,17,9,2009-05-06 17:56:01,2009-05-06 17:56:01
01899927546af8b2b3fd7bec55d3a3462989b83a...d42d6b340c2cfc45ab822049a0017e36400981c8,4,16,12,28,12,2009-05-06 18:02:44,2009-05-06 18:02:44
d42d6b340c2cfc45ab822049a0017e36400981c8...acd242b8f12c903ac1579365166db095c6860e0b,2,7,7,14,6,2009-05-06 18:06:43,2009-05-06 18:06:43
acd242b8f12c903ac1579365166db095c6860e0b...3e1660cc621c0e74ba47abeb158208c287c02567,2,3,2,5,2,2009-05-06 18:09:25,2009-05-06 18:09:25
3e1660cc621c0e74ba47abeb158208c287c02567...10c985419f8087031ad8364155dc35cd436554e8,2,11,11,22,9,2009-05-06 18:22:44,2009-05-06 18:22:44
10c985419f8087031ad8364155dc35cd436554e8...faf849ececd0fb15b230f80f1aa481b2283dc3e7,3,5,5,10,3,2009-05-06 18:41:30,2009-05-06 18:41:30
955c582b12b778fb1f45033b69b6d7a664f56944...13ac1f5ee496e0f791a8d131d12ac0d08367e1d9,5,42,32,74,24,2009-05-11 18:57:26,2009-05-11 18:57:26
13ac1f5ee496e0f791a8d131d12ac0d08367e1d9...691629143c8ac264815665f8e317cd8ce6a6756e,5,33,44,77,29,2009-05-11 19:09:30,2009-05-11 19:09:30
691629143c8ac264815665f8e317cd8ce6a6756e...8e36f60caa199876e9debd3dcdbbc631aa2948e1,1,0,1,1,1,2009-05-11 19:18:08,2009-05-11 19:18:08
76440fd5c554dda441cb6e821cdbcf5e4b11db97...c4c89013e66fdd494abd84e7099b564346baf94e,3,35,2,37,6,2009-05-06 20:01:41,2009-05-06 20:01:41
c4c89013e66fdd494abd84e7099b564346baf94e...db390f66c61106254ca6d40f25c152acaab3fcba,1,11,11,22,11,2009-05-06 20:27:34,2009-05-06 20:27:34
db390f66c61106254ca6d40f25c152acaab3fcba...038b2c4b5a16c5c63542b8a99eb0f9e4bc56d5cf,1,6,6,12,6,2009-05-06 20:32:21,2009-05-06 20:32:21
038b2c4b5a16c5c63542b8a99eb0f9e4bc56d5cf...123a48efc030e608a868bcad921076c692d51782,1,1,1,2,1,2009-05-06 20:41:34,2009-05-06 20:41:34
123a48efc030e608a868bcad921076c692d51782...1131d7d439da20250b6b39aeee28c46210a7d49d,3,28,5,33,5,2009-05-06 21:33:00,2009-05-06 21:33:00
1131d7d439da20250b6b39aeee28c46210a7d49d...f31e2284e3307084391f3147653248c7716375d5,1,2,2,4,2,2009-05-06 21:35:52,2009-05-06 21:35:52
f31e2284e3307084391f3147653248c7716375d5...7e634a51d46c78f8a70b3888bb5e10a61955e23e,3,40,7,47,7,2009-05-07 02:11:45,2009-05-07 02:11:45
7e634a51d46c78f8a70b3888bb5e10a61955e23e...6230f9576a0958bc4d89123b0504809c31ae1cf7,2,22,5,27,2,2009-05-07 02:26:32,2009-05-07 02:26:32
6230f9576a0958bc4d89123b0504809c31ae1cf7...9dca9a709318ed4c3f0a8ac7a4dc177747caebd7,1,1,1,2,1,2009-05-07 13:18:13,2009-05-07 13:18:13
9dca9a709318ed4c3f0a8ac7a4dc177747caebd7...ae3ce795b6715b69ca88b248e37b49d2e2cd741b,4,66,49,115,14,2009-05-07 14:52:57,2009-05-07 14:52:57
ae3ce795b6715b69ca88b248e37b49d2e2cd741b...26c4b0139f0a96891796c3c54fe821c819db4697,2,48,1,49,4,2009-05-07 16:49:50,2009-05-07 16:49:50
8e36f60caa199876e9debd3dcdbbc631aa2948e1...eb537e9f3d526513a5ecc187aaa618994f9f11c4,2,5,3,8,3,2009-05-12 19:49:40,2009-05-12 19:49:40
8e36f60caa199876e9debd3dcdbbc631aa2948e1...5e2a4b5c655136925395d3df429677c556b81a2c,1,1,1,2,1,2009-05-11 22:22:22,2009-05-11 22:22:22
8e36f60caa199876e9debd3dcdbbc631aa2948e1...60ea7cc443863e005ac4abd07cb6eaf0f309a40b,3,15,2,17,4,2009-05-11 20:38:15,2009-05-11 20:38:15
26c4b0139f0a96891796c3c54fe821c819db4697...1387d5cc850222aca15cba90745b133a789c9631,1,3,0,3,2,2009-05-07 19:08:26,2009-05-07 19:08:26
507232958afbe796364d9d25a9b37723b6351a3d...c00f10a45ca1af4b6e5a73b243f1973482c6e742,1,11,0,11,3,2009-05-13 15:07:00,2009-05-13 15:07:00
ca1eefa41a1a6b7e77297120b44f744d098bd47a...89efc0b51dc5b323ba2901cf562360906c514f88,4,18,5,23,10,2009-05-12 15:19:39,2009-05-12 15:19:39
89efc0b51dc5b323ba2901cf562360906c514f88...9b791d91a802959ca35818154ee7be31c42280c6,1,10,0,10,1,2009-05-12 15:20:05,2009-05-12 15:20:05
ca1eefa41a1a6b7e77297120b44f744d098bd47a...35240085b172af81caa9fbcfd9d7e569fbd24507,1,1,1,2,1,2009-05-12 12:07:09,2009-05-12 12:07:09
1387d5cc850222aca15cba90745b133a789c9631...5658b82b7d79642223bd44e4a94497f754224ec8,1,6,4,10,5,2009-05-08 13:15:56,2009-05-08 13:15:56
5658b82b7d79642223bd44e4a94497f754224ec8...d0470d437ce66ed2f49760e7182ef47988159f7e,5,82,10,92,16,2009-05-08 15:02:12,2009-05-08 15:02:12
275743285815c3fa56a4168458b44828018ae306...b9a2a828375d1585377027eee95be1958d7db771,4,9,28,37,21,2009-05-13 15:17:24,2009-05-13 15:17:24
b9a2a828375d1585377027eee95be1958d7db771...68b1edd0b0c258cb6945949b746ee4791d74922a,2,13,14,27,9,2009-05-13 15:27:47,2009-05-13 15:27:47
85470a98c56bf8fe51c8904293772f0520b61cdf...11cb5ef71aa78d0ac8bc0bd7ea6f1b74047ca219,1,5,1,6,2,2009-05-13 15:19:21,2009-05-13 15:19:21
915e4d09ef21aec46406a01faf2cf80179be20f5...a0cffeed61e08bd19daebe65d60e3a94624dd0ee,1,10,0,10,2,2009-05-12 16:12:00,2009-05-12 16:12:00
a0cffeed61e08bd19daebe65d60e3a94624dd0ee...7dd4ce550178558c3d32768f512dac9fb3b52eb9,1,7,3,10,3,2009-05-12 16:12:19,2009-05-12 16:12:19
7dd4ce550178558c3d32768f512dac9fb3b52eb9...9adf11088572542bb6e127be00a39c42b7093648,1,25,37,62,10,2009-05-12 16:18:43,2009-05-12 16:18:43
9adf11088572542bb6e127be00a39c42b7093648...28005f1d157a0d204233832ba656a38ff63344d0,1,1,2,3,2,2009-05-12 17:37:42,2009-05-12 17:37:42
28005f1d157a0d204233832ba656a38ff63344d0...7e0f926ab963a51d2003e96574f8f4527f4e5358,1,0,10,10,2,2009-05-12 17:38:05,2009-05-12 17:38:05
7e0f926ab963a51d2003e96574f8f4527f4e5358...f2b9332f97f079b0db44d2d7d026ad798a782e80,3,17,10,27,6,2009-05-12 17:38:33,2009-05-12 17:38:33
d0470d437ce66ed2f49760e7182ef47988159f7e...fb0746fda65ddf00536cd0b07c6c95ed86e521d9,3,16,0,16,4,2009-05-08 22:42:50,2009-05-08 22:42:50
d0470d437ce66ed2f49760e7182ef47988159f7e...5c96e81008d670213ccae1a80bfb6c6e62cd352f,1,13,2,15,2,2009-05-08 20:43:59,2009-05-08 20:43:59
5c96e81008d670213ccae1a80bfb6c6e62cd352f...d6f699c68784f5953015bd47fa4b3ce6b662481c,1,9,2,11,1,2009-05-08 20:57:41,2009-05-08 20:57:41
d6f699c68784f5953015bd47fa4b3ce6b662481c...b59cea1ce680f80a80345551b73503f67962b433,1,6,10,16,3,2009-05-08 20:57:51,2009-05-08 20:57:51
b59cea1ce680f80a80345551b73503f67962b433...a54e3885141a47a722cd983a7587c5fc92e37a8d,1,15,0,15,4,2009-05-08 21:02:32,2009-05-08 21:02:32
a54e3885141a47a722cd983a7587c5fc92e37a8d...d9a00a89e44282b73d9f2f78c90b1c1ba5c8d3f5,1,2,1,3,2,2009-05-08 21:04:07,2009-05-08 21:04:07
d9a00a89e44282b73d9f2f78c90b1c1ba5c8d3f5...439593bc60b9f030769cb83d3c00772d11d7a43f,1,1,1,2,2,2009-05-08 21:22:01,2009-05-08 21:22:01
1d94ab95c578c382f0f6a7d86c945270e396edd8...9d5bbc80904d3a589b871a40d8cc6d82bd2c271e,3,17,0,17,4,2009-05-13 15:42:48,2009-05-13 15:42:48
f2b9332f97f079b0db44d2d7d026ad798a782e80...0c65c4a3e2340a5c494eac625b939952541b5eac,1,2061,0,2061,1,2009-05-13 15:19:11,2009-05-13 15:19:11
f2b9332f97f079b0db44d2d7d026ad798a782e80...5895a4d5221cd551eca304388fe57cf88afd511e,5,22,12,34,8,2009-05-12 18:18:17,2009-05-12 18:18:17
5895a4d5221cd551eca304388fe57cf88afd511e...3278eccd23bd8a5f3382b710252576eadb682866,1,1,1,2,1,2009-05-12 18:22:09,2009-05-12 18:22:09
3278eccd23bd8a5f3382b710252576eadb682866...b7c67bbf4a8caafbf9fa655a85c3a799519e198a,1,8,5,13,3,2009-05-12 18:27:23,2009-05-12 18:27:23
b7c67bbf4a8caafbf9fa655a85c3a799519e198a...f5efaa92ea9d702646da16ad174548bb69cf4bd4,1,2,1,3,1,2009-05-12 19:06:12,2009-05-12 19:06:12
e3737f8bc8e705b2515cdd0db9116f9404c4f68b...6ebf10766c432d4b3640cf5ab51934fe95d1adfb,1,1,1,2,1,2009-05-08 22:54:26,2009-05-08 22:54:26
6ebf10766c432d4b3640cf5ab51934fe95d1adfb...80f97319bcb9ac199a2660a09304a13a864d1583,3,9,2,11,6,2009-05-08 23:43:22,2009-05-08 23:43:22
80f97319bcb9ac199a2660a09304a13a864d1583...1d5802d83333da00f116940548652c5793329551,2,2,2,4,3,2009-05-08 23:57:56,2009-05-08 23:57:56
1d5802d83333da00f116940548652c5793329551...f8010f7ea1f646b8dca171c1c3ead0a9483de346,2,5,0,5,3,2009-05-09 00:11:50,2009-05-09 00:11:50
f8010f7ea1f646b8dca171c1c3ead0a9483de346...a83e3bb41d67b64e43c166410f946df07ee36a32,2,1,5,6,4,2009-05-09 00:23:29,2009-05-09 00:23:29
a83e3bb41d67b64e43c166410f946df07ee36a32...0422e9a22489718b8be1e0e1d07e805018151df9,2,25,2,27,3,2009-05-09 14:23:44,2009-05-09 14:23:44
0422e9a22489718b8be1e0e1d07e805018151df9...f175443ac432c3c87e2692fba561f0cc4fd09dd6,5,46,14,60,15,2009-05-10 02:07:36,2009-05-10 02:07:36
f175443ac432c3c87e2692fba561f0cc4fd09dd6...11b301c8c31902b86cb1159cb7aa100a6c6f0319,1,5,5,10,1,2009-05-10 02:18:32,2009-05-10 02:18:32
11b301c8c31902b86cb1159cb7aa100a6c6f0319...426bfdfe08772bd7e25d81c24b98fe632bea2bff,1,28,8,36,10,2009-05-10 02:57:09,2009-05-10 02:57:09
426bfdfe08772bd7e25d81c24b98fe632bea2bff...781f2587997f73b6d9643930ca77eb3733c4b773,2,74,16,90,12,2009-05-10 13:24:54,2009-05-10 13:24:54
a03a948e7abd4fae9076d08c14ee44b3745b29da...a57430b39941c5a75872112b5b33606e2637bed5,2,40,4,44,6,2009-05-13 18:09:42,2009-05-13 18:09:42
f5efaa92ea9d702646da16ad174548bb69cf4bd4...69189750225ec95c4c941b60247a77ca1125fa73,1,1,1,2,1,2009-05-12 20:19:45,2009-05-12 20:19:45
f5efaa92ea9d702646da16ad174548bb69cf4bd4...d9129f8cb2fe5c5922c14196478b03e3dc55b235,8,77,75,152,74,2009-05-12 19:58:26,2009-05-12 19:58:26
d9129f8cb2fe5c5922c14196478b03e3dc55b235...b7182b610a7a4d28d543470a10142f078926d41e,16,25,14,39,17,2009-05-12 20:37:23,2009-05-12 20:37:23
f5efaa92ea9d702646da16ad174548bb69cf4bd4...78b57f297ebaf75eee1f8b5060d438791a50dd87,1,1,0,1,1,2009-05-12 19:09:25,2009-05-12 19:09:25
78b57f297ebaf75eee1f8b5060d438791a50dd87...92aa0ce095fafc14ddb9b37e27678ccce9eb214f,6,111,89,200,19,2009-05-13 15:58:24,2009-05-13 15:58:24
92aa0ce095fafc14ddb9b37e27678ccce9eb214f...f79e2e6b158780d715ac5ebeb5b63fb6b022610a,4,16,9,25,10,2009-05-13 16:28:59,2009-05-13 16:28:59
f79e2e6b158780d715ac5ebeb5b63fb6b022610a...13f2cc026f3591d287865c1afbffc01eff2a9138,6,83,99,182,16,2009-05-13 16:32:30,2009-05-13 16:32:30
20e085993984a32f9a41039740e8dfe3b0fdd4e2...4c8734ed847a027031beace13953a2f7eef11440,1,6,1,7,2,2009-05-13 18:33:33,2009-05-13 18:33:33
20e085993984a32f9a41039740e8dfe3b0fdd4e2...33097e058df70b2045f1989389b0fbbab51b892d,1,8,0,8,1,2009-05-13 18:20:20,2009-05-13 18:20:20
51bc5dc81b3e149c30d2b616748cd8f630c7bc06...a86e51d635280d6f54e530ae1153edf45efacfbe,1,2,2,4,2,2009-05-12 20:54:07,2009-05-12 20:54:07
a86e51d635280d6f54e530ae1153edf45efacfbe...dea1cb23623cc899148212cde5ea99c681e3320b,1,1,0,1,1,2009-05-12 22:43:06,2009-05-12 22:43:06
cd3aea1beaeca538e29e1c1805eae87c605fb960...18c01987a239bbc32496c82aa08d117a9f352674,5,73,86,159,32,2009-05-13 21:00:02,2009-05-13 21:00:02
18c01987a239bbc32496c82aa08d117a9f352674...4bf96beb17cdcb698a5711b87fde339a4a6efbe3,5,39,19,58,16,2009-05-13 21:27:45,2009-05-13 21:27:45
4bf96beb17cdcb698a5711b87fde339a4a6efbe3...85ac757f2f1c9e246ddd77f7d2f74ab2e9fa4cf1,1,3,3,6,3,2009-05-13 21:35:07,2009-05-13 21:35:07
85ac757f2f1c9e246ddd77f7d2f74ab2e9fa4cf1...7ce30a5699742cd7834dc5ba61451c84668fc005,2,62,2,64,6,2009-05-13 21:53:41,2009-05-13 21:53:41
7ce30a5699742cd7834dc5ba61451c84668fc005...67d9c8bbdea8a9c9b961159f327d2937eff76903,10,200,100,300,32,2009-05-14 03:15:59,2009-05-14 03:15:59
67d9c8bbdea8a9c9b961159f327d2937eff76903...39e627ab617eae98d1c6a5bff559ccb07e6193b8,1,6,2,8,1,2009-05-14 03:21:54,2009-05-14 03:21:54
39e627ab617eae98d1c6a5bff559ccb07e6193b8...f565f7be926110a779bb228feb22ecb6cb1f3125,1,8,8,16,8,2009-05-14 03:29:58,2009-05-14 03:29:58
f565f7be926110a779bb228feb22ecb6cb1f3125...abb74ac6fee0f4da92919031d13aa5fa527382f9,1,2,2,4,2,2009-05-14 14:30:22,2009-05-14 14:30:22
abb74ac6fee0f4da92919031d13aa5fa527382f9...6ed1a1e376d7028bb4ce4564bb568fce1f87293f,1,20,0,20,1,2009-05-14 14:45:55,2009-05-14 14:45:55
09441ee34dae801735fcb57ad97277035fa2e5d6...cf158ca29ae41ef3f77d38c617d827398f5867ee,2,7,3,10,4,2009-05-13 18:54:32,2009-05-13 18:54:32
cf158ca29ae41ef3f77d38c617d827398f5867ee...0941be442d2f15d384938fe5d3f5d3d79c082a64,2,5,2,7,3,2009-05-13 20:34:35,2009-05-13 20:34:35
0941be442d2f15d384938fe5d3f5d3d79c082a64...101f01c5911bb0f1d2613c4c4058bce8da6458e3,1,1,1,2,1,2009-05-13 21:02:15,2009-05-13 21:02:15
101f01c5911bb0f1d2613c4c4058bce8da6458e3...5700a5040d524d1a1930747b2940cef1d7562bcb,3,12,1,13,4,2009-05-13 22:09:25,2009-05-13 22:09:25
5700a5040d524d1a1930747b2940cef1d7562bcb...6e15b2b50d042cedaf12ce2c6c2648b4a614e731,2,3,3,6,2,2009-05-14 13:59:50,2009-05-14 13:59:50
6e15b2b50d042cedaf12ce2c6c2648b4a614e731...ec0b50ddbdb6cf4c6da77931c71e36b5967a39ba,1,5,1,6,1,2009-05-14 14:18:46,2009-05-14 14:18:46
ec0b50ddbdb6cf4c6da77931c71e36b5967a39ba...a23f4a3138dce2f71ca3f3f4529b64366e1cfce5,4,29,11,40,8,2009-05-14 15:30:13,2009-05-14 15:30:13
a23f4a3138dce2f71ca3f3f4529b64366e1cfce5...7f42e31739c50aa2c3e51d5ebd01d71c597dcdb0,1,2,0,2,1,2009-05-14 16:00:52,2009-05-14 16:00:52
7f42e31739c50aa2c3e51d5ebd01d71c597dcdb0...638ea7e69e1780d9317527690bb4c220f80fd004,2,24,13,37,11,2009-05-14 19:27:01,2009-05-14 19:27:01
638ea7e69e1780d9317527690bb4c220f80fd004...6b8c0c1555eddf8d86e05d37e19b0c7e789c00f1,2,15,3,18,5,2009-05-14 20:55:44,2009-05-14 20:55:44
dea1cb23623cc899148212cde5ea99c681e3320b...1b3534b26264d069dff14ee12e4c3ac15db16684,5,41,14,55,8,2009-05-13 15:10:29,2009-05-13 15:10:29
dea1cb23623cc899148212cde5ea99c681e3320b...1d59989c5e718e189ce9730bf34b4a49449bf63b,2,5,9,14,5,2009-05-13 14:52:52,2009-05-13 14:52:52
6ed1a1e376d7028bb4ce4564bb568fce1f87293f...01f3e49668fd845cd8e7887cf6d7b150c037510a,3,52,2,54,5,2009-05-14 14:58:28,2009-05-14 14:58:28
6ed1a1e376d7028bb4ce4564bb568fce1f87293f...7cff395f2ff4578512b1c8fec48b626878eb3693,2,16,0,16,2,2009-05-14 14:57:06,2009-05-14 14:57:06
6b8c0c1555eddf8d86e05d37e19b0c7e789c00f1...9338991874e14068e3f7d23ea035d83fbd640835,1,2,1,3,1,2009-05-15 22:40:42,2009-05-15 22:39:53
3200bd787241344914f4adde17d5fb81e5830296...397e5b13e841693d3e08d78c1b1e1e377dd2efa3,3,258,3,261,9,2009-05-14 15:42:52,2009-05-14 15:42:52
2db1e0ca72753543cbb468e95442396149169f08...d3303f4938f2697f00bbd73deb75d171ba75832d,1,1,1,2,1,2009-05-15 20:08:03,2009-05-15 20:08:03
2db1e0ca72753543cbb468e95442396149169f08...3c9ffd3e34d0680c7a6efb6352d6dd6cdd6d3694,2,6,6,12,3,2009-05-15 17:32:31,2009-05-15 17:32:31
3c9ffd3e34d0680c7a6efb6352d6dd6cdd6d3694...f555dd3f9384c4b25c964544395bbd2f1615b846,2,5,1,6,5,2009-05-15 17:40:10,2009-05-15 17:40:10
f555dd3f9384c4b25c964544395bbd2f1615b846...ae217d4c58d63f8eaa72c600f431626e2e79746d,2,153,149,302,3,2009-05-15 17:50:00,2009-05-15 17:50:00
ae217d4c58d63f8eaa72c600f431626e2e79746d...d0122e2e1ae74dfc4207b1c9ba8f77c3e86201e1,6,112,58,170,35,2009-05-15 18:55:18,2009-05-15 18:55:18
d0122e2e1ae74dfc4207b1c9ba8f77c3e86201e1...a5969ca86be3aa7ed2a1227e2b095c25e734faa6,3,162,133,295,5,2009-05-15 20:24:26,2009-05-15 20:24:26
a5969ca86be3aa7ed2a1227e2b095c25e734faa6...d1b49ff9bdee121a03a103d0c074eef88197d76e,6,8,145,153,11,2009-05-15 20:32:31,2009-05-15 20:32:31
397e5b13e841693d3e08d78c1b1e1e377dd2efa3...fe9e174bde90159d73db766d83703f8fdec0d5b5,1,8,0,8,1,2009-05-14 17:32:14,2009-05-14 17:32:14
397e5b13e841693d3e08d78c1b1e1e377dd2efa3...3e46a4507c8453071fce3cfcf5e9544f58dca0dc,1,2,0,2,1,2009-05-14 17:18:37,2009-05-14 17:18:37
3e46a4507c8453071fce3cfcf5e9544f58dca0dc...774f8ec70c106dd6720ea14cb0dc1c9776ae8fc9,1,8,0,8,1,2009-05-14 17:19:13,2009-05-14 17:19:13
774f8ec70c106dd6720ea14cb0dc1c9776ae8fc9...c232600f1690df788e97c7d5c79f8b2cb7afa976,2,10,0,10,6,2009-05-14 17:19:45,2009-05-14 17:19:45
c232600f1690df788e97c7d5c79f8b2cb7afa976...0edca05e158d6d9216f410c16e9b5b8dd7463a4f,3,95,10,105,6,2009-05-14 18:40:08,2009-05-14 18:40:08
cad430f71e12320bbf3b33f0863d1afa88243496...5819ee3315811bbaae8ed29166218d8bd0f483ef,1,7,0,7,4,2009-05-16 11:17:12,2009-05-16 11:17:12
5819ee3315811bbaae8ed29166218d8bd0f483ef...738607b8348b17261a8a14620948d3615a2fcf27,1,36,0,36,3,2009-05-17 01:01:56,2009-05-17 01:01:56
738607b8348b17261a8a14620948d3615a2fcf27...cf4ffb99b4526822ddad9510413bbaf484f6023b,1,1,1,2,1,2009-05-18 14:22:51,2009-05-18 14:22:51
cf4ffb99b4526822ddad9510413bbaf484f6023b...b773d2c965a3965fc470b0d1cac3f52346f80b3a,2,13,6,19,2,2009-05-18 15:18:16,2009-05-18 15:18:16
d979c4529de88f8509e7e767362b0a77c7a6e78a...df348ee06620439d677791a8ce795e1886a72b66,6,8,3,11,6,2009-05-15 21:27:31,2009-05-15 21:27:31
d1b49ff9bdee121a03a103d0c074eef88197d76e...c35a0d2b8768bba6da873ea8e454d73fdd8acd75,1,227,227,454,1,2009-05-15 22:47:54,2009-05-15 22:47:54
c3c8e9238e13b465b3aa28479d7882c3c4e695ed...4e781fbf5ef9c207437b97c81856986d00be11cc,1,30,0,30,2,2009-05-14 19:34:14,2009-05-14 19:34:14
4e781fbf5ef9c207437b97c81856986d00be11cc...a27d79d7a7c07056c7905c5104fc472770ad07f3,1,28,2,30,4,2009-05-14 19:48:53,2009-05-14 19:48:53
a27d79d7a7c07056c7905c5104fc472770ad07f3...60f76f524f5ca8014e9e38e648fff71cb690d83a,2,15,4,19,2,2009-05-14 20:11:01,2009-05-14 20:11:01
0edca05e158d6d9216f410c16e9b5b8dd7463a4f...285f0735f6e142388a43fd90b90b227ff0a98384,3,36,6,42,10,2009-05-14 19:55:33,2009-05-14 19:55:33
b773d2c965a3965fc470b0d1cac3f52346f80b3a...c60cf5c1c88fcc4b1942d8d3b72c7495daf2f906,1,3,2,5,3,2009-05-19 14:54:06,2009-05-19 14:54:06
b773d2c965a3965fc470b0d1cac3f52346f80b3a...e57cb387c4588b3ec9ff1cf04e60124237b32e95,3,92,0,92,4,2009-05-18 17:25:30,2009-05-18 17:25:30
4f8f716712933f6123b06025f35ed884385d7183...4236b9ca45dce0d0156406e7746b87f7dfcc617a,1,6,1,7,3,2009-05-14 20:23:19,2009-05-14 20:23:19
285f0735f6e142388a43fd90b90b227ff0a98384...6eb15b9f38257a59c3876d8e0671d9a37197b837,1,2,0,2,2,2009-05-14 20:14:01,2009-05-14 20:14:01
e57cb387c4588b3ec9ff1cf04e60124237b32e95...6c0692a9000df2b525b4d414005c5512d9df588e,1,1,1,2,1,2009-05-18 18:45:37,2009-05-18 18:45:37
e57cb387c4588b3ec9ff1cf04e60124237b32e95...9602cce53b180426c5a1d306a0c00e6f3352f7ae,2,24,0,24,3,2009-05-18 17:59:22,2009-05-18 17:59:22
2ada81b5232d4b56608e28e4213de954a5fcab0f...3247006c76379d26f490727fbea723a3583ba039,4,23,16,39,9,2009-05-14 20:35:43,2009-05-14 20:35:43
3247006c76379d26f490727fbea723a3583ba039...c6eaf9c5003f6e7a40bf622bb9e158d7a91285e4,1,1,1,2,1,2009-05-14 20:39:10,2009-05-14 20:39:10
c6eaf9c5003f6e7a40bf622bb9e158d7a91285e4...a1da020445c9235f2b5eadf04300942cb54af3a5,1,4,4,8,4,2009-05-14 20:39:36,2009-05-14 20:39:36
a1da020445c9235f2b5eadf04300942cb54af3a5...088f487c2a56c3ab39b499a2a58e63377f9041aa,3,10,3,13,4,2009-05-14 20:50:14,2009-05-14 20:50:14
088f487c2a56c3ab39b499a2a58e63377f9041aa...87cd9dac9f4281b7953bb76e48a6731b8e886840,1,5,0,5,1,2009-05-14 20:57:57,2009-05-14 20:57:57
c1df2f1a5f6acccab9ef952bdd2fec12ba471d9b...3a75b466c8fc5bd6719f842a2952cceb413b0197,1,12,1,13,1,2009-05-19 15:54:30,2009-05-19 15:54:30
c1df2f1a5f6acccab9ef952bdd2fec12ba471d9b...c19bc9f6868896a35ceed559852c112a66ce50ad,1,3,3,6,3,2009-05-19 15:03:30,2009-05-19 15:03:30
c19bc9f6868896a35ceed559852c112a66ce50ad...f61b2c0799db59e34d9d2d52dfae6ee3a375b0aa,2,4,2,6,4,2009-05-19 15:48:56,2009-05-19 15:48:56
6c0692a9000df2b525b4d414005c5512d9df588e...46275dbed5f923976c7495e7fb9b2fdb9776fc2f,2,38,14,52,9,2009-05-18 20:03:10,2009-05-18 20:03:10
46275dbed5f923976c7495e7fb9b2fdb9776fc2f...2117aef610a7dd4b8cbd06d29100fed44cd187ae,2,62,1,63,2,2009-05-18 20:25:17,2009-05-18 20:25:17
4dc76cb9f6fb59447d61b881c0e4456b87d9592a...afb9b899080b7af755f0abbadf6952d19247241b,1,45,23,68,15,2009-05-18 21:19:40,2009-05-18 21:19:40
87cd9dac9f4281b7953bb76e48a6731b8e886840...6a06a6cb3ca94f516180547c2f68e6ba75d4aa7e,4,26,6,32,10,2009-05-14 21:37:21,2009-05-14 21:37:21
87cd9dac9f4281b7953bb76e48a6731b8e886840...df9fe97f790d0a6ac654c17540048faf55104846,5,15,10,25,11,2009-05-14 21:32:07,2009-05-14 21:32:07
f61b2c0799db59e34d9d2d52dfae6ee3a375b0aa...46227a1f42df3d7cab2659920e372f10242fba6f,1,2,0,2,1,2009-05-19 17:10:56,2009-05-19 17:10:56
65afb6db81668ac5a9a588c55c9d6fc85f1bc906...b039c1f21954405b21a9b4687c9c713a26ed2f02,5,45,16,61,23,2009-05-18 22:17:27,2009-05-18 22:17:27
df9fe97f790d0a6ac654c17540048faf55104846...df41c66bb4aacc336ff0921bcb05911f0819d287,2,4,2,6,3,2009-05-14 22:12:58,2009-05-14 22:12:58
56629ccaad3e02ea5d6035f60c7a234f1fed6107...6173983255e301043694ffe53387669635a17287,1,9,5,14,3,2009-05-19 17:43:32,2009-05-19 17:43:32
6173983255e301043694ffe53387669635a17287...e3a697fbbf22db32f100bdca4020700cd38a2068,1,3,2,5,2,2009-05-19 18:02:14,2009-05-19 18:02:14
e3a697fbbf22db32f100bdca4020700cd38a2068...f9c896224b7c682582089b30c33bfe38603a0e75,6,98,46,144,20,2009-05-19 20:13:24,2009-05-19 20:13:24
f9c896224b7c682582089b30c33bfe38603a0e75...b8c6d85506d04c3b9d9b804fcf6d1e763b55f963,2,7,9,16,2,2009-05-19 21:30:11,2009-05-19 21:30:11
b039c1f21954405b21a9b4687c9c713a26ed2f02...206a330b50fbdce63551681c49c255b3df2e2322,5,5,128,133,12,2009-05-19 14:55:13,2009-05-19 14:55:13
92d59dce2d33c9fa8cd08a642298d1a51f3437b3...04546333b65eb7365ec4ea81bd17caddcd2a4d7b,1,0,2,2,2,2009-05-14 22:18:16,2009-05-14 22:18:16
04546333b65eb7365ec4ea81bd17caddcd2a4d7b...2aeddac9d778f60cfdd5152776578c92278d73eb,1,6,0,6,2,2009-05-15 12:30:08,2009-05-15 12:30:08
2aeddac9d778f60cfdd5152776578c92278d73eb...33e7a6538e618bcd5d9533553e1e00042f2d9c0a,4,110,7,117,13,2009-05-15 12:31:11,2009-05-15 12:31:11
33e7a6538e618bcd5d9533553e1e00042f2d9c0a...7b0777cb01ce83649126b5a0dd1d464f856b09f9,2,3,3,6,4,2009-05-15 13:19:13,2009-05-15 13:19:13
7b0777cb01ce83649126b5a0dd1d464f856b09f9...7a9f157a92a891d4c4f2b87aa00eafdcc53a018e,1,2,3,5,2,2009-05-15 14:42:57,2009-05-15 14:42:57
7a9f157a92a891d4c4f2b87aa00eafdcc53a018e...cb97e39f0f44e17178bc33ac6df641f174b296bb,4,6,8,14,5,2009-05-15 14:48:14,2009-05-15 14:48:14
cb97e39f0f44e17178bc33ac6df641f174b296bb...52cebee31b18a6da943981f3fab72ce7b1d9d5a9,3,3,3,6,3,2009-05-15 14:54:34,2009-05-15 14:54:34
52cebee31b18a6da943981f3fab72ce7b1d9d5a9...16d763737d467a90d9072705d343eaf58c47d56a,2,2,1,3,2,2009-05-15 15:07:43,2009-05-15 15:07:43
16d763737d467a90d9072705d343eaf58c47d56a...a3de62485bc1bba72f836dc0faf531dd6f387738,1,1,1,2,1,2009-05-15 17:02:49,2009-05-15 17:02:49
a3de62485bc1bba72f836dc0faf531dd6f387738...540f479a90273ec47248161086974edbc16ecd05,1,3,2,5,2,2009-05-15 17:03:03,2009-05-15 17:03:03
540f479a90273ec47248161086974edbc16ecd05...d21ef69f23b14d8b632eed698a98ca4aed89ef61,1,14,0,14,1,2009-05-15 17:06:57,2009-05-15 17:06:57
d21ef69f23b14d8b632eed698a98ca4aed89ef61...0516fad382e363191b627d18b0421bed9166cfd6,2,3,3,6,2,2009-05-15 17:07:14,2009-05-15 17:07:14
b8c6d85506d04c3b9d9b804fcf6d1e763b55f963...edee72dc444aa54c65e72bb8bd96f8864b8179c1,13,624,0,624,13,2009-05-27 14:06:07,2009-05-27 14:06:07
b8c6d85506d04c3b9d9b804fcf6d1e763b55f963...3cebde86be21d03bd74fbbd0dd069a714e16b6da,2,9,2,11,3,2009-05-20 18:50:33,2009-05-20 18:50:33
3cebde86be21d03bd74fbbd0dd069a714e16b6da...ce515d5e45cee514088e4ebfd44e7bc87d713f85,1,1,1,2,1,2009-05-20 18:51:08,2009-05-20 18:51:08
b8c6d85506d04c3b9d9b804fcf6d1e763b55f963...da7a9b3f71a151b17665d7033370adb5507bf3fd,12,52,48,100,26,2009-05-20 15:39:12,2009-05-20 15:39:12
b8c6d85506d04c3b9d9b804fcf6d1e763b55f963...f80d887a780449efb3a4425a0b7a1dd9510476d9,2,20,2,22,5,2009-05-20 14:54:23,2009-05-20 14:54:23
f80d887a780449efb3a4425a0b7a1dd9510476d9...1d091ef8b3cf8063b7e0a111f5ed92eb7536a6de,1,1,1,2,1,2009-05-20 14:55:03,2009-05-20 14:55:03
1d091ef8b3cf8063b7e0a111f5ed92eb7536a6de...6516e72042cd7e6ff88717b8a9bb5991f223c6c1,1,13,7,20,8,2009-05-20 15:28:55,2009-05-20 15:28:55
6516e72042cd7e6ff88717b8a9bb5991f223c6c1...04d6ddd42bbd0b3a1497b9e989f486e12d3edf42,1,1,1,2,1,2009-05-20 15:29:21,2009-05-20 15:29:21
04d6ddd42bbd0b3a1497b9e989f486e12d3edf42...b403a0c0f3b34e1e6f942c3a311972592afdcf31,3,47,0,47,5,2009-05-20 15:29:40,2009-05-20 15:29:40
b403a0c0f3b34e1e6f942c3a311972592afdcf31...226885b97c3960616af62076b72f1160b43ba7e2,1,1,1,2,1,2009-05-20 15:33:19,2009-05-20 15:33:19
7a78c2bece92c98c23e33b8918763bc0e21db21d...7fdb4f9e6e1655c3ef9c75570e5af844d68bf4b9,1,1,0,1,1,2009-05-27 14:41:57,2009-05-22 07:58:03
7fdb4f9e6e1655c3ef9c75570e5af844d68bf4b9...b8c3d4698621fadd61f6fabdb3a33468f7a11018,3,25,0,25,4,2009-05-27 14:44:45,2009-05-27 14:44:45
85c396b10c9519e72a17a1bd378a2af73a4fb14e...11ae38a6ff5aa95115c0d16f5e6983edcc1606b5,1,5,0,5,2,2009-05-20 16:15:26,2009-05-20 16:15:26
11ae38a6ff5aa95115c0d16f5e6983edcc1606b5...3aa95556bd50e2f3fb671c0720dce31ca74e28fd,1,4,2,6,1,2009-05-20 16:15:41,2009-05-20 16:15:41
3aa95556bd50e2f3fb671c0720dce31ca74e28fd...919bdb31ce848612896dbfc8dfac529652329a3a,1,30,13,43,12,2009-05-20 16:16:25,2009-05-20 16:16:25
919bdb31ce848612896dbfc8dfac529652329a3a...333dbae2725567a9111dc4e8f9b962d21f75d08b,1,2,2,4,1,2009-05-20 16:19:33,2009-05-20 16:19:33
333dbae2725567a9111dc4e8f9b962d21f75d08b...04a735fe263cd7afd02be3d8ff6047e857172bd9,1,1,3,4,2,2009-05-20 17:09:54,2009-05-20 17:09:54
04a735fe263cd7afd02be3d8ff6047e857172bd9...a0a9411bc3483ce2e5f59242f84a8739abfd529c,1,1,1,2,1,2009-05-20 17:39:46,2009-05-20 17:39:46
a0a9411bc3483ce2e5f59242f84a8739abfd529c...1f6b10d7b32b898a570a82ceaa81cd8e28c85077,1,1,1,2,1,2009-05-20 18:06:39,2009-05-20 18:06:39
1f6b10d7b32b898a570a82ceaa81cd8e28c85077...3b2ae5b7fb7bc9b869a5d799f6966250db0d40d9,1,27,4,31,3,2009-05-20 18:07:10,2009-05-20 18:07:10
3b2ae5b7fb7bc9b869a5d799f6966250db0d40d9...c5ffd65fb28fb6b201bb6027cb0ef0b52fefcf8c,1,17,12,29,5,2009-05-20 18:16:14,2009-05-20 18:16:14
b8c3d4698621fadd61f6fabdb3a33468f7a11018...8423cdf30f3dc88759fd2959a83541c2bee68e9d,1,23,5,28,5,2009-05-27 17:55:30,2009-05-27 17:55:30
b8c3d4698621fadd61f6fabdb3a33468f7a11018...f078c67ae949889059a1765675c71820c3d801e6,2,35,0,35,2,2009-05-27 17:52:17,2009-05-27 17:52:17
fe54a96b59fbf93b34716e5b94e1d73a237d779b...5fb086799747738cd0afb7239cbdcdaf66ae4664,14,43,41,84,29,2009-05-20 21:04:28,2009-05-20 21:04:28
fe54a96b59fbf93b34716e5b94e1d73a237d779b...7155f7aa558dd6241179a5d3aff6200d1836ec7f,3,22,7,29,7,2009-05-20 19:47:48,2009-05-20 19:47:48
c5ffd65fb28fb6b201bb6027cb0ef0b52fefcf8c...fc428a8885854733960d760d1c6f89c0477b78c4,1,1,1,2,1,2009-05-20 19:11:45,2009-05-20 19:11:45
f078c67ae949889059a1765675c71820c3d801e6...40cb12e59069b28331cff0da64343e7f7b51820d,1,2,2,4,2,2009-05-27 18:07:58,2009-05-27 18:07:58
f078c67ae949889059a1765675c71820c3d801e6...e1d6aae3e597c74113d4a512b8e55b98a0551e1f,1,1,1,2,1,2009-05-27 18:06:18,2009-05-27 18:06:18
8d50601341202112a7439533d37bfde56ccb91e4...f2920fa2a87ec8d11ee730faa3d0d47aec590b5e,3,22,96,118,13,2009-05-27 18:31:23,2009-05-27 18:31:23
f2920fa2a87ec8d11ee730faa3d0d47aec590b5e...6ba27c11337ff2e95d17e24b0a9342821cd03868,1,0,49,49,3,2009-05-27 18:50:41,2009-05-27 18:50:41
eb8b92ab103508a7083f9757ec6f20baf6ad4df1...0ca5213f8be25c2ac08ed44dccffbe859dd419c7,1,1,1,2,1,2009-05-21 13:55:08,2009-05-21 13:55:08
0ca5213f8be25c2ac08ed44dccffbe859dd419c7...ed74bbf25ae0cd85e1ffba3bf545ba29c6b23023,2,23,2,25,5,2009-05-21 14:05:26,2009-05-21 14:05:26
ed74bbf25ae0cd85e1ffba3bf545ba29c6b23023...303ac1bd039f07710d4efb5c1b42835dfbfdd59d,1,8,0,8,1,2009-05-21 14:09:38,2009-05-21 14:09:38
7155f7aa558dd6241179a5d3aff6200d1836ec7f...5e3dc7e518ce993ff504b1858eb9b92d523a350a,1,1,2,3,1,2009-05-20 20:47:02,2009-05-20 20:47:02
7155f7aa558dd6241179a5d3aff6200d1836ec7f...0bcbdbc3ec2b82a69255c91253f57a9b3544c5c7,2,21,1,22,6,2009-05-20 20:43:43,2009-05-20 20:43:43
3aa27c095b411dac0b55fdafe07bc5c0e6d21775...6eef7699740d71afd728e247bafb86b0fa031427,3,15,0,15,4,2009-05-27 19:20:09,2009-05-27 19:20:09
30aca5e606f3554ae65b13bcec95e0980811ba10...9d44b312f0ef018fcea8abbb639a776b24a9d066,4,13,13,26,11,2009-05-21 17:24:14,2009-05-21 17:24:14
9d44b312f0ef018fcea8abbb639a776b24a9d066...3d03daec09fb9635e8cca3cc9741224c3c8b52a2,1,8,7,15,9,2009-05-21 18:30:41,2009-05-21 18:30:41
3d03daec09fb9635e8cca3cc9741224c3c8b52a2...80502a3fdb0ea4127b1b04a468bbe23dbb1484aa,5,5,5,10,5,2009-05-21 22:20:07,2009-05-21 22:20:07
ff3d6747fa150ef287480af4df3729748dac4309...6bdab5fe2af2a22d1eed38b0342aaed580358075,2,13,0,13,3,2009-05-20 20:55:15,2009-05-20 20:55:15
6bdab5fe2af2a22d1eed38b0342aaed580358075...58fd314a8a6839878cf61f25670d2f17d5491af6,1,8,2,10,2,2009-05-20 20:57:59,2009-05-20 20:57:59
0bcbdbc3ec2b82a69255c91253f57a9b3544c5c7...e11f79c1f9fa0e2decb9eaa2decb30198666ebac,2,8,1,9,2,2009-05-20 20:54:11,2009-05-20 20:54:11
6eef7699740d71afd728e247bafb86b0fa031427...e7da7d51cb313a0636c5eea05b67c9de906bcbc0,1,32,0,32,4,2009-05-27 19:40:57,2009-05-27 19:40:57
6eef7699740d71afd728e247bafb86b0fa031427...11442277be388ef2c32726411717dd7f4b8ad3bc,1,3,1,4,1,2009-05-27 19:40:01,2009-05-27 19:40:01
11442277be388ef2c32726411717dd7f4b8ad3bc...cc15ffda91b81eeb55d178a0e73066831b12cd73,1,0,1,1,1,2009-05-27 19:40:50,2009-05-27 19:40:50
80502a3fdb0ea4127b1b04a468bbe23dbb1484aa...a8d140ae7985551b73ea3a2b660f517b1bfc7cc0,1,4,0,4,1,2009-05-22 14:47:45,2009-05-22 14:47:45
a8d140ae7985551b73ea3a2b660f517b1bfc7cc0...2eddff58bb98e81a7cb34d193a16354bf1e17eb3,2,74,6,80,9,2009-05-22 14:48:05,2009-05-22 14:48:05
80502a3fdb0ea4127b1b04a468bbe23dbb1484aa...d8e129c8ab3844903cd19ae565ab32faf0aadd59,3,29,14,43,5,2009-05-22 14:46:33,2009-05-22 14:46:33
f1ff2f1a57f466983b138024264b31ce6748be74...7552a7ccb5426515e3f0b3001fad8cd4ada3d126,6,42,8,50,10,2009-05-21 15:07:11,2009-05-21 15:07:11
0f5d151e8d77babc4dabdb1d663456006c62fe9f...5d113ff1d093af389113a6fbddfbc3c394cbb981,1,2,0,2,1,2009-05-27 19:43:26,2009-05-27 19:43:26
5d113ff1d093af389113a6fbddfbc3c394cbb981...3b2ecb5ff075f935c4cb3c6e731f0276ea747c55,2,22,2,24,4,2009-05-27 20:09:59,2009-05-27 20:09:59
cc15ffda91b81eeb55d178a0e73066831b12cd73...d556557091810b3b88d2dfbd026e1d4f0c3a8772,1,1,1,2,1,2009-05-27 20:23:33,2009-05-27 20:23:33
21d086887349e1520786b2b3f270c37e90097fcc...5eb08a4478427875598d6b93d96e07da3a38a9c4,3,9,5,14,5,2009-05-22 19:05:13,2009-05-22 19:05:13
21d086887349e1520786b2b3f270c37e90097fcc...5fe0babc7624c21f7bea0d8f8019683b5b8498f4,1,16,8,24,7,2009-05-22 17:40:32,2009-05-22 17:40:32
d8e129c8ab3844903cd19ae565ab32faf0aadd59...b69171ef5360e2c099805fea874def2654da09c0,1,5,2,7,3,2009-05-22 18:41:22,2009-05-22 18:41:22
3b2ecb5ff075f935c4cb3c6e731f0276ea747c55...83be71666f140e041406f869ac148d7dc4e2bb36,3,38,34,72,6,2009-05-27 21:23:47,2009-05-27 21:23:47
e8a92a31f47eed060d2e056a54b334a4e7423aa9...31c52cba69d122146c00d47a72a361d39412d775,2,21,2,23,3,2009-05-28 14:54:48,2009-05-28 14:54:48
851655fc9c7f9316c33912031a1aa4eecb1360c6...1cec8ff649dd6dfb2833b227e99945e93e773f9b,1,1,1,2,1,2009-05-22 19:29:38,2009-05-22 19:29:38
53ae7f47fe7be655ffc1806f0ea3d30b31c79180...0b9432e6b9ebbca4ad53496c0b94e0953ad66338,4,134,6,140,16,2009-05-26 20:04:07,2009-05-26 20:04:07
95ea6d105b795e764dc3d0e13529b62b529add90...5c51afc737b3d8d4ed91a99b764f35528497cb7e,1,1,1,2,1,2009-05-27 21:32:22,2009-05-27 21:32:22
5c51afc737b3d8d4ed91a99b764f35528497cb7e...c0ab52d5972d157aee93b883ab5071f2cd62a333,1,1,1,2,1,2009-05-27 21:37:59,2009-05-27 21:37:59
c0ab52d5972d157aee93b883ab5071f2cd62a333...e2120ef09f5e38f4bbb8dbe7998136271e92e3d2,1,3,2,5,2,2009-05-27 21:40:20,2009-05-27 21:40:20
e2120ef09f5e38f4bbb8dbe7998136271e92e3d2...266a5d97f81c9b10158b8647ff4e2e05eb1e2797,3,8,8,16,6,2009-05-27 22:42:37,2009-05-27 22:42:37
a63a8031601b319c4fee02fc894da41bfd4439a8...a9111e4fceebb696718a3e49d7bdc50219972159,1,2,2,4,2,2009-05-28 15:16:19,2009-05-28 15:16:19
1cec8ff649dd6dfb2833b227e99945e93e773f9b...87cdcfd1a36825701001fedeaf19ba3a11b6a21b,1,1,0,1,1,2009-05-22 20:20:45,2009-05-22 20:20:45
1cec8ff649dd6dfb2833b227e99945e93e773f9b...b3fda2ab25cd0cfb4d1f9a04134457b6fc88780a,1,0,7,7,1,2009-05-22 20:20:31,2009-05-22 20:20:31
9b622e6fc1db8d9bc7d8d076dcf062de6b104920...9333c5e06f6f749a04825f707bc5e6e14570ce6e,2,8,7,15,3,2009-05-26 22:33:25,2009-05-26 22:33:25
266a5d97f81c9b10158b8647ff4e2e05eb1e2797...c03a7186cf12a5d0831dad5ab4ae7710ba9b02fa,8,12,18,30,30,2009-05-28 16:59:27,2009-05-28 16:59:27
6b8ff9cb7b02a7e182845cd43f2b870fe40a52d0...17e01b215b7cc581605823ba001da4e5ed7d040c,1,5,15,20,5,2009-05-28 17:35:39,2009-05-28 17:35:39
6b8ff9cb7b02a7e182845cd43f2b870fe40a52d0...2df26bc7569b113eb9c6fa961e878493ec3ce3d1,1,4,0,4,1,2009-05-28 17:16:03,2009-05-28 17:16:03
6b8ff9cb7b02a7e182845cd43f2b870fe40a52d0...787dc49f9d9c7693c783a0976d2aa038820bbea2,3,27,29,56,13,2009-05-28 17:09:48,2009-05-28 17:09:48
c02bf90df9d1b2286add517a7001bcd2e9f2246f...f09cbb98af2f76e0bf521dcba3ec02bfe56966a4,1,1,1,2,1,2009-05-22 20:34:55,2009-05-22 20:34:55
f09cbb98af2f76e0bf521dcba3ec02bfe56966a4...833991e1316877849ea6459f3b10bad866f5851a,3,42,7,49,10,2009-05-24 01:10:37,2009-05-24 01:10:37
833991e1316877849ea6459f3b10bad866f5851a...ebc421aff3ea03b516ba511e5473b1afcdab12e6,1,0,1,1,1,2009-05-25 17:40:23,2009-05-25 17:40:23
ebc421aff3ea03b516ba511e5473b1afcdab12e6...f9e648decb9320090e4100e710d4eaf6eb978d0d,1,13,5,18,7,2009-05-25 21:58:02,2009-05-25 21:58:02
f9e648decb9320090e4100e710d4eaf6eb978d0d...bb78858156d4c4a46d7c62636721aa41679632a7,1,16,0,16,3,2009-05-26 16:05:06,2009-05-26 16:05:06
bb78858156d4c4a46d7c62636721aa41679632a7...c7c389007915217d14e3395e341dceb8c8d2808d,1,15,4,19,7,2009-05-26 16:05:29,2009-05-26 16:05:29
160e13e2e3743814d1b8984fc7441a49b575e82e...c1f913b0509416013f034a2c873d4ae721ae4539,1,4,3,7,1,2009-05-28 17:19:02,2009-05-28 17:19:02
c1f913b0509416013f034a2c873d4ae721ae4539...7c0ef7b21df0e8c90d12080b95be8d6d804656b3,1,1,1,2,1,2009-05-28 17:19:19,2009-05-28 17:19:19
787dc49f9d9c7693c783a0976d2aa038820bbea2...18285e76de6e275203aa26ff919c06ff8a8a7872,3,15,14,29,9,2009-05-28 17:16:23,2009-05-28 17:16:23
c7c389007915217d14e3395e341dceb8c8d2808d...c0fef5d2abdc049554f410bdfc5f87bd834dd771,2,46,4,50,10,2009-05-26 18:43:20,2009-05-26 18:43:20
c7c389007915217d14e3395e341dceb8c8d2808d...e7bc0e56d02ecbc321fec9038920289b0f8de06d,5,87,36,123,10,2009-05-26 18:01:33,2009-05-26 18:01:33
e7bc0e56d02ecbc321fec9038920289b0f8de06d...17167cade81188aa9fd06ce3bcf431360a4d20ee,2,9,1,10,3,2009-05-26 18:05:41,2009-05-26 18:05:41
086330fdea0f0d9469bdbb3c9bba5caab6b949cf...7f6c3e9ebe5c6d820351354bdc08e9498eb87e59,1,3,1,4,2,2009-05-28 19:08:03,2009-05-28 19:08:03
086330fdea0f0d9469bdbb3c9bba5caab6b949cf...a9645eda8a3478d5fbff03545de0368e23f09b91,1,3,3,6,3,2009-05-28 18:15:56,2009-05-28 18:15:56
a9645eda8a3478d5fbff03545de0368e23f09b91...0c2ab274ee2be1aadc0e616bb54a08545c3aa97e,1,1,1,2,1,2009-05-28 18:43:32,2009-05-28 18:43:32
c3a6bf36932a30fbc1105cdcd79642cf49d90ca3...583a6ab6275a34d5844254d249474cbfc79fa9f7,1,14,3,17,2,2009-05-28 17:54:47,2009-05-28 17:54:47
53547f73ae47b4db030aae6b737c52f9534af1ff...b05f9dc6591f7a5d7bf031df24331d2db1be9d89,2,10,3,13,8,2009-05-26 19:36:41,2009-05-26 19:36:41
17167cade81188aa9fd06ce3bcf431360a4d20ee...d22db6f05de9ef60bc69b5ddf1b4b2de389a55ce,4,36,5,41,8,2009-05-26 18:33:19,2009-05-26 18:33:19
d22db6f05de9ef60bc69b5ddf1b4b2de389a55ce...087e7c857e2a63727fd04ff113212bb9197b36ee,1,1,1,2,1,2009-05-26 19:58:22,2009-05-26 19:58:22
087e7c857e2a63727fd04ff113212bb9197b36ee...11baa3226f2a62bf8a229acaa408447701bb4ef7,2,18,18,36,8,2009-05-26 19:58:32,2009-05-26 19:58:32
f3916cb59963cc38a9c1351cc17796b1b6495172...3b8c1a8709c51d3d6881ab311f2c90ff8ff826b5,1,3,1,4,1,2009-05-28 21:07:40,2009-05-28 21:07:40
0c2ab274ee2be1aadc0e616bb54a08545c3aa97e...6a2a8d385f70db58e864b424aa43643822d04f84,13,29,4,33,20,2009-05-28 19:22:24,2009-05-28 19:22:24
6a2a8d385f70db58e864b424aa43643822d04f84...d0192b19eac228ac30da3ba3322995a6613aa8d9,1,1,1,2,1,2009-05-28 19:23:42,2009-05-28 19:23:42
d0192b19eac228ac30da3ba3322995a6613aa8d9...df4d7bc751049a6959ddd311b5903ef678e1d475,2,11,2,13,5,2009-05-28 19:37:45,2009-05-28 19:37:45
df4d7bc751049a6959ddd311b5903ef678e1d475...342deb14a9a76fb181860544ab90bae8d025c6ae,1,4,2,6,3,2009-05-28 20:11:56,2009-05-28 20:11:56
342deb14a9a76fb181860544ab90bae8d025c6ae...4397393a977625d0e271610b604f5b0e75404d47,1,1,1,2,1,2009-05-28 20:30:24,2009-05-28 20:30:24
b05f9dc6591f7a5d7bf031df24331d2db1be9d89...77dbf16bacf8e446ef62d8e712f67ee28d078dfa,1,9,0,9,1,2009-05-26 20:42:21,2009-05-26 20:42:21
5f4cb7b25c94af45e06c8d0f9d26ea7c5ff1d20b...0532b35568497fc4159764f8858007656965cb38,6,87,76,163,9,2009-05-26 21:18:34,2009-05-26 21:18:34
8b25e879afef19c9528edd1342b7b0e10c6255d2...5c5dbc5a53b3cefc81c2cd623a7298165e94dc42,1,1,1,2,1,2009-05-28 21:22:10,2009-05-28 21:22:10
4397393a977625d0e271610b604f5b0e75404d47...abd24eb7deee163120c7fc26dfa7e2bb4eda036d,1,42,0,42,3,2009-05-28 21:28:02,2009-05-28 21:28:02
df72be542f518e26e2e5caaec5da28be0cda2970...b59f70aab39e7ca54ab71a88849c25760f87e830,1,7,1,8,3,2009-05-26 21:34:05,2009-05-26 21:34:05
b59f70aab39e7ca54ab71a88849c25760f87e830...10e0456be3c973377bb6f5bdc8a2e03a649ade9c,2,12,0,12,2,2009-05-26 22:57:26,2009-05-26 22:57:26
10e0456be3c973377bb6f5bdc8a2e03a649ade9c...d0361b1434cc597dc225b9159e9437beef48f0ce,1,9,20,29,8,2009-05-27 13:21:22,2009-05-27 13:21:22
5c5dbc5a53b3cefc81c2cd623a7298165e94dc42...f3f213ad845693a63e0a60f330d19d367282c82f,1,6,2,8,1,2009-05-28 21:28:33,2009-05-28 21:28:33
9418d5f18ba7b1f5baf1fef5b4966b1a951701ec...67e827bfcf54434296b186af07a26799ce298eff,1,8,0,8,2,2009-05-28 21:45:28,2009-05-28 21:45:28
67e827bfcf54434296b186af07a26799ce298eff...f30eae51cef4fc8a4a5803daac50a57b81a26e00,2,3,1,4,2,2009-05-29 02:14:26,2009-05-29 02:14:26
f30eae51cef4fc8a4a5803daac50a57b81a26e00...5f160bb92edbc243569c06002bdc6bf618c82d7a,1,23,4,27,3,2009-05-29 02:35:26,2009-05-29 02:35:26
5f160bb92edbc243569c06002bdc6bf618c82d7a...921f11c93e842d970ef57bac89f9b652a6aa86f8,1,4,4,8,1,2009-05-30 13:19:47,2009-05-30 13:19:47
5f160bb92edbc243569c06002bdc6bf618c82d7a...e24e6f3cbec9fc057f02633dbae13a0640af53ee,1,3,7,10,4,2009-05-29 11:32:30,2009-05-29 11:32:30
e24e6f3cbec9fc057f02633dbae13a0640af53ee...7dbf34c67ed1933a0958007fcd17001955f6f70d,1,11,2,13,4,2009-05-29 14:21:43,2009-05-29 14:21:43
7dbf34c67ed1933a0958007fcd17001955f6f70d...107c1b979d3133c255e1fab227d7c629f3884367,1,1,1,2,1,2009-05-29 14:24:23,2009-05-29 14:24:23
01397d2c329134655b58f38310c9b21dfe83416e...f53f8553472bf350f5ca3986f9f50fe1e2d03e33,2,20,1,21,2,2009-06-02 12:31:07,2009-06-02 12:31:07
f53f8553472bf350f5ca3986f9f50fe1e2d03e33...64e3aab1e773125c15b500f42cb529a4e48a45a3,1,31,5,36,9,2009-06-03 15:10:23,2009-06-03 15:10:23
64e3aab1e773125c15b500f42cb529a4e48a45a3...b2defb1b7eaac078103dd4c3725c819a02835c48,7,143,4,147,15,2009-06-03 17:18:50,2009-06-03 17:18:50
b2defb1b7eaac078103dd4c3725c819a02835c48...4d77758502e0a8b5fceb2c1b3c58718e06377a2f,1,20,15,35,1,2009-06-03 18:30:11,2009-06-03 18:30:11
4d77758502e0a8b5fceb2c1b3c58718e06377a2f...e448d675b987015049f0a3c374a92f7f20c05d33,1,31,0,31,1,2009-06-03 20:15:58,2009-06-03 20:15:58
e448d675b987015049f0a3c374a92f7f20c05d33...f3c795db383b3681e000febffcd086fdcef11f4d,1,1,1,2,1,2009-06-03 21:04:43,2009-06-03 21:04:43
f3c795db383b3681e000febffcd086fdcef11f4d...7d9befe0e06a373a3212496993fa54f52948b4f1,1,1,1,2,1,2009-06-03 21:07:49,2009-06-03 21:07:49
107c1b979d3133c255e1fab227d7c629f3884367...c4f307c4858ef996ef62ebbeb2871faa4f4b7ff1,1,12,2,14,5,2009-05-29 17:36:42,2009-05-29 17:36:42
107c1b979d3133c255e1fab227d7c629f3884367...b363a5baa5a70380084f73553c7fbb353b7deac2,1,1,1,2,1,2009-05-29 16:09:40,2009-05-29 16:09:40
107c1b979d3133c255e1fab227d7c629f3884367...bc43e8c7938649d4d429b87e64bbda95ef0a5b48,1,1,1,2,1,2009-05-29 16:08:51,2009-05-29 16:08:51
7d9befe0e06a373a3212496993fa54f52948b4f1...c9c9dc5b03d78af082e8ba7da282261470e028bd,5,287,7,294,15,2009-06-04 12:55:33,2009-06-04 10:26:15
7d9befe0e06a373a3212496993fa54f52948b4f1...d7889fb311bdf7d174bbf2b9dc4bd5d1829c5c42,2,24,3,27,4,2009-06-04 12:49:06,2009-06-04 12:49:06
7d9befe0e06a373a3212496993fa54f52948b4f1...ad297c79c7e6fadd96729fa682834ce876295220,5,287,7,294,15,2009-06-04 10:26:15,2009-06-04 10:26:15
ad297c79c7e6fadd96729fa682834ce876295220...3224ad222a1439e5d70af1d18b46596ed80da437,24,819,432,1251,63,2009-06-04 11:25:58,2009-06-04 11:25:58
3224ad222a1439e5d70af1d18b46596ed80da437...6d446d4e6d7ad66d644901b488558f7b2a70d924,1,1,1,2,1,2009-06-04 21:58:08,2009-06-04 21:58:08
6a2edd12fd18cc9d149dd1bcc92d1aff99b30ce7...bff800e98a6eacb92566a49bdecec583d807e76d,1,9,1,10,1,2009-05-29 19:21:01,2009-05-29 19:21:01
bff800e98a6eacb92566a49bdecec583d807e76d...f490759af1a138ceae561bddcc9e51317795e428,1,1,1,2,1,2009-05-29 19:32:24,2009-05-29 19:32:24
c5ab7bc0ef47576ae85b1431e4f8f41035d106b4...21e7f9c42cea1cafc3d9d89486ced6325c458d90,1,6,1,7,3,2009-05-29 17:23:25,2009-05-29 17:23:25
06375b3b206c6c5c507ac6495085ea8be3a7c517...27f84df31f3253e83599aff115d40862bd41cec7,1,2,0,2,1,2009-06-04 12:56:51,2009-06-04 12:56:51
27f84df31f3253e83599aff115d40862bd41cec7...4c3e7dac6050c4f895d13338877e45bbec1f79ec,1,0,2,2,1,2009-06-04 13:03:09,2009-06-04 13:03:09
905f018510bd388c0f101d23806b974dd0faea52...c7c77aee1a66387d606f206db2db28e33d1e5bd7,2,8,0,8,2,2009-06-08 21:28:11,2009-06-08 21:28:11
c7c77aee1a66387d606f206db2db28e33d1e5bd7...0efc7afe282a86e34975d97fa3f847c32a12a4dd,1,1,1,2,1,2009-06-09 13:37:04,2009-06-09 13:37:04
0efc7afe282a86e34975d97fa3f847c32a12a4dd...a525339af5c8ea2cc670fada418f3ea0f255f4e0,1,1,1,2,1,2009-06-09 14:15:55,2009-06-09 14:15:55
a525339af5c8ea2cc670fada418f3ea0f255f4e0...00df88c21d12a230550dc250fb20fde0f1aedf26,18,74,80,154,72,2009-06-09 15:43:04,2009-06-09 15:43:04
00df88c21d12a230550dc250fb20fde0f1aedf26...6b1d43b3b193eeb4dc0434b14d5c14c31bc63331,7,9,9,18,9,2009-06-09 16:32:04,2009-06-09 16:32:04
6b1d43b3b193eeb4dc0434b14d5c14c31bc63331...4e4dd60185ba8f9b181cfacc4e218ea8d09da511,1,9,1,10,4,2009-06-09 19:17:50,2009-06-09 19:17:50
4e4dd60185ba8f9b181cfacc4e218ea8d09da511...62d7cb596135c14e5c4a4d2295928810c2c0c508,1,22,22,44,8,2009-06-09 19:24:09,2009-06-09 19:24:09
62d7cb596135c14e5c4a4d2295928810c2c0c508...d5088e4c9c05324d5115be2cb68de8a5e5c0aa14,1,4,0,4,1,2009-06-11 16:32:03,2009-06-11 16:32:03
d5088e4c9c05324d5115be2cb68de8a5e5c0aa14...dba174cb193de809ee927282f95a572c1680896c,1,2,1,3,1,2009-06-11 16:32:19,2009-06-11 16:32:19
dba174cb193de809ee927282f95a572c1680896c...688b0dc3a341a2e9cf73bd0726c13e62cd344461,1,3,0,3,1,2009-06-12 00:13:14,2009-06-12 00:13:14
688b0dc3a341a2e9cf73bd0726c13e62cd344461...6d12b8bc22fa16f02e1ee19aa81023c2c179bd82,1,2,0,2,1,2009-06-12 00:13:33,2009-06-12 00:13:33
6d12b8bc22fa16f02e1ee19aa81023c2c179bd82...7c8f6d5b1cd30bff45fa48df7027cd5edf6648fd,1,17,0,17,2,2009-06-12 00:15:01,2009-06-12 00:15:01
7c8f6d5b1cd30bff45fa48df7027cd5edf6648fd...8b6145546a99951e4b47ca45ed2c2cb23406da96,2,13,28,41,6,2009-06-12 00:15:31,2009-06-12 00:15:31
8b6145546a99951e4b47ca45ed2c2cb23406da96...a4a895e1f064b25512a9e1450f6866d1430512d7,2,7,2,9,2,2009-06-12 00:27:07,2009-06-12 00:27:07
a4a895e1f064b25512a9e1450f6866d1430512d7...004cd26deee50b7fdf060c06605bbce37bc09794,2,22,2,24,5,2009-06-14 03:30:03,2009-06-14 03:30:03
f490759af1a138ceae561bddcc9e51317795e428...8c107408f27930db95ae43bde40dd8418c466910,1,9,20,29,4,2009-05-29 19:56:45,2009-05-29 19:56:45
f490759af1a138ceae561bddcc9e51317795e428...ec8d64817af4560f1e5f8d233b7ce69a0017f1f2,22,4472,0,4472,22,2009-05-29 19:45:27,2009-05-29 15:43:59
ec8d64817af4560f1e5f8d233b7ce69a0017f1f2...ada453281694f4f5d971a8f9259541730bd979a4,1,54,0,54,1,2009-05-29 19:45:31,2009-05-29 19:23:09
4c3e7dac6050c4f895d13338877e45bbec1f79ec...56b2d01f365c8c4802cdcdd08f1fc95b0cdf6c08,4,29,14,43,16,2009-06-04 16:05:40,2009-06-04 16:05:40
4c3e7dac6050c4f895d13338877e45bbec1f79ec...2b18fa428c9033ef34a7910f09290fbc56eeaa2b,1,14,6,20,6,2009-06-04 15:44:30,2009-06-04 15:44:30
401223e71c6ff7f33d79da7d210ae9bd4cc558e1...b610cf77f46294edda509b210b3f93630e236fbc,1,4,2,6,3,2009-06-17 01:33:14,2009-06-13 21:58:21
b610cf77f46294edda509b210b3f93630e236fbc...b0dbe2735b168ccbde56fd6f5faab4cfbd17ab36,2,30,15,45,14,2009-06-17 01:33:28,2009-06-14 20:22:00
7351fbb17c5d70037c82e274590c004044f759c5...3cb12e98e7814b93b2c859522956c69dbfb0ff5d,1,2,0,2,1,2009-05-29 20:26:59,2009-05-29 20:26:59
9afdf7717425315f210b29ca8e4d61f2a16e3e6c...a9f4598e25dd0781b2dd822a471c71cfe24348d6,1,4,2,6,4,2009-06-04 18:55:41,2009-06-04 18:55:41
2b18fa428c9033ef34a7910f09290fbc56eeaa2b...ac0cebb3d0190dad28533eeda62cb8cf1c2ca8e0,1,1,0,1,1,2009-06-04 16:22:26,2009-06-04 16:22:26
b0dbe2735b168ccbde56fd6f5faab4cfbd17ab36...3940f862a41d00a9e598937b0ebb4ab2b126abd0,1,11,4,15,3,2009-07-07 14:22:29,2009-07-07 14:22:29
b0dbe2735b168ccbde56fd6f5faab4cfbd17ab36...7cb14f0951f499d86dbc8feabd851618af92f61c,1,6,4,10,1,2009-06-22 13:31:28,2009-06-22 13:31:28
b0dbe2735b168ccbde56fd6f5faab4cfbd17ab36...f136b4b850ae992b640e21daf3edb4f5a71d8de9,3,36,4,40,11,2009-06-18 17:30:49,2009-06-18 17:30:49
f136b4b850ae992b640e21daf3edb4f5a71d8de9...64e8052961075def22e2f6feacf4c462d358c099,2,32,0,32,2,2009-06-18 17:34:01,2009-06-18 17:34:01
3cb12e98e7814b93b2c859522956c69dbfb0ff5d...4a534aedd1d1b4874363c1e4683a3c8547ece4bf,3,16,13,29,7,2009-06-01 15:34:11,2009-06-01 15:34:11
3cb12e98e7814b93b2c859522956c69dbfb0ff5d...11aaed6a9ffd7e911dd4c1f8cb3f80512a5ce843,1,5,3,8,4,2009-06-01 15:28:03,2009-06-01 15:28:03
8740cf7259fd79939c164a6aabc1454e91747678...56b5ce222920e85f2d44b7635926c8009f5d68a0,1,19,0,19,1,2009-06-04 17:33:07,2009-06-04 17:33:07
56b5ce222920e85f2d44b7635926c8009f5d68a0...743b80882d79f9d9c27712fd26abbbca060587fc,1,2,1,3,1,2009-06-04 17:46:22,2009-06-04 17:46:22
743b80882d79f9d9c27712fd26abbbca060587fc...09ed6277bacbb0e4ad6320fb17445b595e6411d0,1,4,0,4,1,2009-06-04 17:52:27,2009-06-04 17:52:27
09ed6277bacbb0e4ad6320fb17445b595e6411d0...ef6a52d21f2fdfe7100f8b90ba40733469141a5e,1,1,1,2,1,2009-06-04 17:52:36,2009-06-04 17:52:36
51d0bcd38b4d0693623f84dc1e615611ec631bd8...d279230f12cf94d02a58408b89dfdec97e478d57,1,2,0,2,1,2009-06-22 17:56:27,2009-06-22 17:56:27
d279230f12cf94d02a58408b89dfdec97e478d57...4a71c33456902b60fb28bde667abf9c7d54c1575,3,22,0,22,4,2009-06-22 19:30:41,2009-06-22 19:30:41
4a71c33456902b60fb28bde667abf9c7d54c1575...9cbee3d81f889cc9233ce84e0041b72fe4ddc697,1,10,0,10,1,2009-06-22 19:32:33,2009-06-22 19:32:33
9cbee3d81f889cc9233ce84e0041b72fe4ddc697...d4570964455bbd57c52f753fbe6a0a0828022991,1,1,1,2,1,2009-06-23 17:41:23,2009-06-23 17:41:23
64e8052961075def22e2f6feacf4c462d358c099...eb95a15752edf7fd3d27b2427c2c58732be1c22e,1,140,140,280,132,2009-06-19 19:46:53,2009-06-19 19:46:53
64e8052961075def22e2f6feacf4c462d358c099...5b8ca64dbb02efe31cdc54b7870b5dc6965ef22a,2,47,62,109,16,2009-06-19 17:26:58,2009-06-19 17:26:58
812cf75ac12983c4f147287bc6fff4f2629c1007...d6811aaaaddb117e931702c22b4f1c02fa428020,2,46,3,49,8,2009-06-01 16:53:24,2009-06-01 16:53:24
d6811aaaaddb117e931702c22b4f1c02fa428020...e3a3919baa70bda2f183b613c2c61d2546a53a3d,2,14,2,16,3,2009-06-01 16:59:07,2009-06-01 16:59:07
8ecbcf05158a6788c86cb78f3dae3d5de6740dc6...e9d5faa697f7caeea1f96b54a26d3d3d332d6c15,1,1,1,2,1,2009-06-04 21:10:21,2009-06-04 21:10:21
ef6a52d21f2fdfe7100f8b90ba40733469141a5e...33181727d22f88e2c234082c826231b8d2f680c6,1,4,2,6,2,2009-06-04 21:01:56,2009-06-04 21:01:56
33181727d22f88e2c234082c826231b8d2f680c6...531425968d6ed6a78e345d0fb83296c02595b55b,2,3,1,4,2,2009-06-04 21:04:30,2009-06-04 21:04:30
27b701b0b24bfbed222d22f99d45897bf35a64a8...bc36e762d36ffc082c3cd08471d49dbd3fbcb4c5,1,20,2,22,5,2009-07-07 15:12:39,2009-07-07 15:12:39
d4570964455bbd57c52f753fbe6a0a0828022991...ea32d7806cd9b9948354e6be1f397b37db3f434f,2,37,2,39,5,2009-06-24 18:03:35,2009-06-24 18:03:35
d4570964455bbd57c52f753fbe6a0a0828022991...def2f4e546f170949a8bb7deba9e0d1a0b3c50c2,1,1,1,2,1,2009-06-24 06:59:38,2009-06-24 06:59:38
bf6a76184e25f13307d743fec17c7a748734fdff...2671b91d4847bcd1e32000555f979e540c37d621,1,4,0,4,1,2009-06-19 19:48:32,2009-06-19 19:48:32
5b8ca64dbb02efe31cdc54b7870b5dc6965ef22a...aaa1769381674b1ae8cf09005f5949f9a78c7141,4,22,51,73,14,2009-06-19 20:03:44,2009-06-19 20:03:44
e3a3919baa70bda2f183b613c2c61d2546a53a3d...4a64d52c9cd9865e7efa1cb5b037438a695017fd,3,26,6,32,3,2009-06-01 18:20:49,2009-06-01 18:20:49
e3a3919baa70bda2f183b613c2c61d2546a53a3d...48a68868f2f95fa44622d350f213c83ebbdc5eb7,3,12,3,15,5,2009-06-01 18:17:44,2009-06-01 18:17:44
e3a3919baa70bda2f183b613c2c61d2546a53a3d...4919bc092633254e4db084cbf5868b41511b2b63,10,263,7,270,10,2009-06-01 17:55:45,2009-06-01 17:55:45
4919bc092633254e4db084cbf5868b41511b2b63...eb02ffe19b079db803825738e97e8f77987552d5,1,7,2,9,3,2009-06-01 18:04:12,2009-06-01 18:04:12
e9d5faa697f7caeea1f96b54a26d3d3d332d6c15...573c3e419bfe9b082ae1c32b80fe5faececdf100,1,72,25,97,14,2009-06-05 21:12:49,2009-06-05 21:12:49
e9d5faa697f7caeea1f96b54a26d3d3d332d6c15...d2bbdd79413431c25eb482ba823717f00a70d365,5,89,4,93,11,2009-06-05 13:54:35,2009-06-05 13:54:35
d2bbdd79413431c25eb482ba823717f00a70d365...071e9c39a7097e2af157c267c6339da7f9cc6ee9,2,16,1,17,2,2009-06-05 14:05:33,2009-06-05 14:05:33
071e9c39a7097e2af157c267c6339da7f9cc6ee9...e5126fee80f8e5e801b613f7e95386e03893aec0,1,1,1,2,1,2009-06-05 14:34:50,2009-06-05 14:34:50
e5126fee80f8e5e801b613f7e95386e03893aec0...5514c49e39849671826d863ed23d49ef58968a8f,5,15,3,18,7,2009-06-05 14:35:04,2009-06-05 14:35:04
5514c49e39849671826d863ed23d49ef58968a8f...1fd840fd64b9147631262bd7ad09ede9b6f9fcbb,2,16,5,21,4,2009-06-05 16:13:49,2009-06-05 16:13:49
f4bf44a169da86074339f2361d4f3fd31247964c...b4f0a2c1fb2d4e45ffa996ec03807a8cd60da2c1,3,75,67,142,61,2009-07-07 18:12:53,2009-07-07 18:12:53
b4f0a2c1fb2d4e45ffa996ec03807a8cd60da2c1...d73d4587ed3f1a3044a47bab67696204a650fe71,1,1,8,9,3,2009-07-07 20:43:49,2009-07-07 20:43:49
d73d4587ed3f1a3044a47bab67696204a650fe71...61c0327ba54f44e7438346fd4df13c75b4e578c3,3,99,85,184,36,2009-07-07 21:38:47,2009-07-07 21:38:47
94266dbd04100982374a6e315509c47fb94cebba...643cfc0888835f9d5f780c1080ec5a3cc2984bb5,1,9,0,9,4,2009-06-24 18:49:50,2009-06-24 18:49:50
643cfc0888835f9d5f780c1080ec5a3cc2984bb5...3fc2ac79b59c58a8912bf95a6a4c29f82390b9bd,1,11,0,11,1,2009-06-24 18:50:59,2009-06-24 18:50:59
3fc2ac79b59c58a8912bf95a6a4c29f82390b9bd...f9e806bde0252b0548c9db5f8247adbd67efd151,1,2,0,2,1,2009-06-24 18:53:58,2009-06-24 18:53:58
6feb0b1fecbe4cd020b8850c04d77efb7481a506...0cd354e6760a9e1911d59282668b533a9b3ae725,1,3,3,6,3,2009-06-21 00:19:34,2009-06-21 00:19:34
0cd354e6760a9e1911d59282668b533a9b3ae725...285b43af2503e5ee81cf9d88cc8d40393295333f,1,7,0,7,1,2009-06-21 01:36:35,2009-06-21 01:36:35
285b43af2503e5ee81cf9d88cc8d40393295333f...7fdff9e044891bf09530579d3d8946b87dc29cb5,1,26,0,26,1,2009-06-21 01:38:45,2009-06-21 01:38:45
7fdff9e044891bf09530579d3d8946b87dc29cb5...d220c42a9908451e7b40e83c90256f22f8cda871,1,26,9,35,4,2009-06-21 03:15:31,2009-06-21 03:15:31
79ec2ab328b97ce106fb34f1c26d28ea76b37416...5fbb421a82717906edb344cbc6438f634de60db4,1,9,1,10,2,2009-06-01 18:50:59,2009-06-01 18:50:59
82c3423a640ea1781bde8496cd814108dba71dd1...786ab441431bee67b5e6e5649c092a72ebcc7f93,1,2,0,2,1,2009-06-07 02:47:53,2009-06-07 02:47:53
786ab441431bee67b5e6e5649c092a72ebcc7f93...5be38d339cac4b320814e554854b81e351abf493,1,12,0,12,1,2009-06-07 02:53:16,2009-06-07 02:53:16
5be38d339cac4b320814e554854b81e351abf493...fd40d6348de2b992885440728a74e1e0e49ef9f5,1,17,0,17,1,2009-06-07 02:53:43,2009-06-07 02:53:43
fd40d6348de2b992885440728a74e1e0e49ef9f5...a5bbcaa94b964ec578e6e27a798d0d2c54a63778,1,3,1,4,2,2009-06-08 14:53:50,2009-06-08 14:53:50
a5bbcaa94b964ec578e6e27a798d0d2c54a63778...b6e455fd69c2cb9d2bb12b39c8cc721f2e5c3f61,1,6,1,7,1,2009-06-08 14:54:08,2009-06-08 14:54:08
b6e455fd69c2cb9d2bb12b39c8cc721f2e5c3f61...d5122c9b90ef1f45585e09c45610488ff76894cf,5,126,18,144,14,2009-06-08 14:54:55,2009-06-08 14:54:55
d5122c9b90ef1f45585e09c45610488ff76894cf...2536e9eae0c4f863fa1c9449133023d205b38629,1,6,1,7,1,2009-06-08 14:56:27,2009-06-08 14:56:27
2536e9eae0c4f863fa1c9449133023d205b38629...f17f26a629100c8ab659cbf793c2478efc64be45,1,241,48,289,48,2009-06-08 14:57:35,2009-06-08 14:57:35
f17f26a629100c8ab659cbf793c2478efc64be45...a38d2d26952a2148263005795528aa8c4a059dd0,2,14,1,15,3,2009-06-08 15:20:30,2009-06-08 15:20:30
a38d2d26952a2148263005795528aa8c4a059dd0...ab05b87e83c2ca7eaf0c8a79a82e2c9d3499a17e,1,1,1,2,1,2009-06-08 16:51:48,2009-06-08 16:51:48
d0e9d4e828f830092c48a69408166eee7d74aa4f...b57918b3a468ba5882f226fc54e00321c20d7f0d,1,1,1,2,1,2009-07-08 17:25:25,2009-07-08 17:25:25
b57918b3a468ba5882f226fc54e00321c20d7f0d...1d461d26b3d3504328c4c4f6ed7781045caa5c6e,1,1,1,2,1,2009-07-08 18:05:30,2009-07-08 18:05:30
f9e806bde0252b0548c9db5f8247adbd67efd151...b5ca7040d8284c8924b0f21863e1d45abf780fe4,1,20,0,20,1,2009-06-25 17:53:13,2009-06-25 17:53:13
f9e806bde0252b0548c9db5f8247adbd67efd151...45133d2f2550882ba530046eb9b36d33b4b2df3d,1,56,56,112,30,2009-06-25 15:26:56,2009-06-25 15:26:56
45133d2f2550882ba530046eb9b36d33b4b2df3d...dc0681edad401331f24018cfa658a2b0f25086af,1,4,3,7,4,2009-06-25 15:56:39,2009-06-25 15:56:39
7db7e53afc50746802004d3bcd9cc915083e4f47...dbff105e9925cfeae712209381128c462cfe8ae6,1,4,2,6,1,2009-06-01 20:47:43,2009-06-01 20:47:43
7db7e53afc50746802004d3bcd9cc915083e4f47...3ef3489ad56aae6efc99f2a7ac7187609a3516e5,1,3,1,4,3,2009-06-01 20:09:16,2009-06-01 20:09:16
ab05b87e83c2ca7eaf0c8a79a82e2c9d3499a17e...adedfd4ff0bfa46e796a9b3a0104dce9b2c3a5f6,1,2,2,4,2,2009-06-16 16:14:34,2009-06-16 16:14:34
1d461d26b3d3504328c4c4f6ed7781045caa5c6e...ad841f9c4a02473be11cef7f3c31e516c9f7239e,2,44,8,52,13,2009-07-09 16:09:30,2009-07-09 16:09:30
1d461d26b3d3504328c4c4f6ed7781045caa5c6e...df86ebe2e6d85895c6ec7afe4af1873923cead60,1,49,49,98,29,2009-07-08 18:15:14,2009-07-08 18:15:14
df86ebe2e6d85895c6ec7afe4af1873923cead60...e67dbfbdb8018f0d3784f54832d33a04f2a01ec1,1,213,156,369,16,2009-07-08 19:26:45,2009-07-08 19:26:45
e67dbfbdb8018f0d3784f54832d33a04f2a01ec1...6e07befdd4b869d5f0d0dbf662b67aaaf9fab03d,1,11,7,18,6,2009-07-08 21:14:51,2009-07-08 21:14:51
6e07befdd4b869d5f0d0dbf662b67aaaf9fab03d...62dad5e7e4828d39e71b2b1d88a81b5c43a2aa81,1,17,3,20,4,2009-07-09 17:47:42,2009-07-09 17:47:42
62dad5e7e4828d39e71b2b1d88a81b5c43a2aa81...d8ce98eb36653b6497f94bdbdd68428476e9ace0,1,11,5,16,3,2009-07-09 17:59:28,2009-07-09 17:59:28
d8ce98eb36653b6497f94bdbdd68428476e9ace0...1661235d98c616091c80b43ec0cac5ae38637c7d,1,7,3,10,3,2009-07-09 18:52:05,2009-07-09 18:52:05
78cf591a96270c19162d2df2b3bf3b8a2c2c3634...efe8911ecce9328f278eda08ade4577c852b6dad,3,28,28,56,28,2009-06-25 20:11:38,2009-06-25 20:11:38
efe8911ecce9328f278eda08ade4577c852b6dad...c8c17ed3ebde1d5f46ee0c3924b3a60b4d91c7a4,3,16,3,19,5,2009-06-25 20:15:15,2009-06-25 20:15:15
c8c17ed3ebde1d5f46ee0c3924b3a60b4d91c7a4...97fe2a917776f30baf91c6068d72438cc117df9d,1,1,1,2,1,2009-06-25 20:17:42,2009-06-25 20:17:42
97fe2a917776f30baf91c6068d72438cc117df9d...39c11c8283871be0943dd4120a9fccef2483ca40,1,9,1,10,2,2009-06-25 20:40:39,2009-06-25 20:40:39
39c11c8283871be0943dd4120a9fccef2483ca40...6f2a2dda8c6b723844efdb2ef40704b06e9a86c1,1,2,8,10,3,2009-06-25 20:45:48,2009-06-25 20:45:48
6f2a2dda8c6b723844efdb2ef40704b06e9a86c1...93cb815b7010187568a715b089d9ab69a1f7cae9,1,1,1,2,1,2009-06-25 20:51:46,2009-06-25 20:51:46
93cb815b7010187568a715b089d9ab69a1f7cae9...1c099e789fab0ebd84a0fc137530dc0f391e166f,1,4,1,5,1,2009-06-29 03:26:34,2009-06-29 03:26:34
1c099e789fab0ebd84a0fc137530dc0f391e166f...5bf477863ee77383c01354414c0eb1fecc33938e,1,1,0,1,1,2009-06-29 17:09:30,2009-06-29 17:09:30
5bf477863ee77383c01354414c0eb1fecc33938e...908d30ebea01e5649d3513b1c14cce29537b2efc,1,38,0,38,1,2009-06-30 15:05:47,2009-06-30 15:05:47
908d30ebea01e5649d3513b1c14cce29537b2efc...f1de9d5913accf85bf1d01e476dd642bb627cb04,1,4,1,5,1,2009-06-30 17:45:55,2009-06-30 17:45:55
f1de9d5913accf85bf1d01e476dd642bb627cb04...bc7a53daf4f9a69f76a67784545b19ec06c23786,1,1,1,2,1,2009-06-30 17:46:12,2009-06-30 17:46:12
bc7a53daf4f9a69f76a67784545b19ec06c23786...8dbb39d2bceba549a1bb89b1c13dea13598088b9,1,10,0,10,1,2009-06-30 18:16:56,2009-06-30 18:16:56
8dbb39d2bceba549a1bb89b1c13dea13598088b9...8208dfe87f6937ad245d9c61bffedea015636297,1,13,0,13,2,2009-06-30 20:08:42,2009-06-30 20:08:42
8208dfe87f6937ad245d9c61bffedea015636297...ca4d567d793ab8377cf4a77e2797ed88c1acbbfd,1,1,1,2,1,2009-06-30 20:39:31,2009-06-30 20:39:31
ca4d567d793ab8377cf4a77e2797ed88c1acbbfd...e6df15134f7dfd78c3388a2a1abe93bb322000b2,1,1,1,2,1,2009-07-01 14:48:57,2009-07-01 14:48:57
e6df15134f7dfd78c3388a2a1abe93bb322000b2...45f99702597794de6f3375cdd00c696ff0563fea,1,4,1,5,1,2009-07-01 15:26:12,2009-07-01 15:26:12
45f99702597794de6f3375cdd00c696ff0563fea...0ed71a5c57db1b8d635187385fc3cfa426f3bd29,1,3,0,3,1,2009-07-01 15:26:21,2009-07-01 15:26:21
0ed71a5c57db1b8d635187385fc3cfa426f3bd29...63251bbe3410a59e74e6e943b59c1a5aa6873055,2,20,3,23,3,2009-07-01 15:39:51,2009-07-01 15:39:51
63251bbe3410a59e74e6e943b59c1a5aa6873055...9ea397a1314b3ad6dd96cebde7d21086f243a2c2,2,2,1,3,2,2009-07-01 15:59:43,2009-07-01 15:59:43
9ea397a1314b3ad6dd96cebde7d21086f243a2c2...482c31eb4bf5bbfe626373b52abcdd0387325787,1,19,0,19,1,2009-07-01 16:01:11,2009-07-01 16:01:11
482c31eb4bf5bbfe626373b52abcdd0387325787...3b446f2c2f72c3153959101a91ab73a76e57057c,1,19,0,19,1,2009-07-01 16:47:13,2009-07-01 16:47:13
c6e801d0dc11e8a303250ed50adc29c9a66c3231...0a4fb84bad5178b9318102fa9bf09abbedb12095,1,10,0,10,1,2009-06-01 21:28:13,2009-06-01 21:28:13
ad841f9c4a02473be11cef7f3c31e516c9f7239e...bd018f61d5b8d5b041ed9dcca73e73a83a8b2c68,9,30,26,56,25,2009-07-09 20:56:34,2009-07-09 20:56:34
bd018f61d5b8d5b041ed9dcca73e73a83a8b2c68...b47dcb9a825da437d1a72baad933a4a873858b54,1,1,1,2,1,2009-07-09 21:00:59,2009-07-09 21:00:59
f1b3333d24430fd6aaa4fc9e1ae75e41e58f104b...fe495a46150038d757c3cbc4b81a08f1cdf6700d,1,2,10,12,4,2009-07-09 18:59:23,2009-07-09 18:59:23
3b446f2c2f72c3153959101a91ab73a76e57057c...f0174d1b454760e1b2079720a334474e33f435c7,2,8,5,13,6,2009-07-01 21:09:20,2009-07-01 21:09:20
3b446f2c2f72c3153959101a91ab73a76e57057c...8d8ca5c0412be9c08713c849dde4c3e99482c24e,6,43,13,56,14,2009-07-01 18:55:52,2009-07-01 18:55:52
8d8ca5c0412be9c08713c849dde4c3e99482c24e...6435f5f7e09edd60bc5d59328e8a5cbab88149ad,2,14,1,15,2,2009-07-01 19:00:09,2009-07-01 19:00:09
6435f5f7e09edd60bc5d59328e8a5cbab88149ad...f4f1291e08dc15f1dacecc87d3fd3a4c78906673,3,10,4,14,3,2009-07-01 19:33:03,2009-07-01 19:33:03
f4f1291e08dc15f1dacecc87d3fd3a4c78906673...6c4567ca0993ef63d8ab3c029a6cb2e7a232ca61,1,1,1,2,1,2009-07-01 19:48:05,2009-07-01 19:48:05
b47dcb9a825da437d1a72baad933a4a873858b54...4eadeb645d77710d99c5e6cf1e8b709c01b65630,1,1,2,3,2,2009-07-13 15:45:09,2009-07-13 15:45:09
b47dcb9a825da437d1a72baad933a4a873858b54...59255f4192295303226ef7ead32a09d36bab7b21,1,1,1,2,1,2009-07-10 03:18:55,2009-07-10 03:18:55
59255f4192295303226ef7ead32a09d36bab7b21...e6aee429a9e77798d3e871112bcfaad11a3d7488,2,8,1,9,2,2009-07-10 14:50:00,2009-07-10 14:50:00
e6aee429a9e77798d3e871112bcfaad11a3d7488...9d928c0e7a4be91bc8754923cc27b4eb9a9157ce,1,8,2,10,1,2009-07-10 14:59:30,2009-07-10 14:59:30
3aba1c36fcd7b9ebdce0dea934d1c1cfffc7b761...c5e353874cb0a76373dafd6d2d2c89b6c90a5a21,1,5,1,6,1,2009-07-10 18:17:19,2009-07-10 18:17:19
447dc353644fc17b11f4bfef3951f61f1eb7271b...de4d56f0296dd9d08f4e088c69b2ce1c3e067e4a,1,55,46,101,9,2009-07-02 22:04:57,2009-07-02 22:04:57
447dc353644fc17b11f4bfef3951f61f1eb7271b...5df974d77b4929fb5cc26d368d2365bc3b765acf,1,13,0,13,1,2009-07-02 13:26:54,2009-07-02 13:26:54
5df974d77b4929fb5cc26d368d2365bc3b765acf...77a1a11579bbf1a463d3cef43b68c4f34fa96725,1,4,0,4,2,2009-07-02 13:27:03,2009-07-02 13:27:03
77a1a11579bbf1a463d3cef43b68c4f34fa96725...53f01c16bec5d4069c0493d9bf07073f1aa622fb,1,1,1,2,1,2009-07-02 13:35:25,2009-07-02 13:35:25
53f01c16bec5d4069c0493d9bf07073f1aa622fb...7d30c2efa68d6c32b4819434384da5acd4df722e,4,65,12,77,14,2009-07-02 18:05:36,2009-07-02 18:05:36
7d30c2efa68d6c32b4819434384da5acd4df722e...c3af933f23adcf476f1cebb4ae5c398e9d149d6d,1,1,1,2,1,2009-07-02 18:53:00,2009-07-02 18:53:00
c3af933f23adcf476f1cebb4ae5c398e9d149d6d...e4dcf3920c22337848e7b0af2c4bc9a0d14d3caf,1,1,0,1,1,2009-07-02 18:55:05,2009-07-02 18:55:05
e4dcf3920c22337848e7b0af2c4bc9a0d14d3caf...64927b36f4a2c7d305821400b0e8542a8b8de942,1,19,0,19,3,2009-07-02 20:27:20,2009-07-02 20:27:20
ebc64a4e785bfcb8c77585075d5614e02baaee0c...be9c371d56bf6d6c6fec07e6464e67cb0a2a886c,3,34,8,42,9,2009-07-15 20:55:06,2009-07-15 20:55:06
c5e353874cb0a76373dafd6d2d2c89b6c90a5a21...8db5cbbea8ce4c7a835417c89ef9c8f8733c6a52,5,24,1,25,6,2009-07-13 16:49:29,2009-07-13 16:49:29
c5e353874cb0a76373dafd6d2d2c89b6c90a5a21...fedd299a87675a4dc29f5458b953940bef9ff8f6,1,24,3,27,4,2009-07-10 19:40:48,2009-07-10 19:40:48
fedd299a87675a4dc29f5458b953940bef9ff8f6...86c5028dca3c2fee85ff26d0ed595e623d3f9ad2,1,5,4,9,4,2009-07-13 15:24:43,2009-07-13 15:24:43
126ee825ea5e9f3a869eb87187929c5a6e9e28f1...31193a14769a02b70b36b8e1dab0bff0cda644b6,4,20,22,42,18,2009-07-02 22:20:32,2009-07-02 22:20:32
31193a14769a02b70b36b8e1dab0bff0cda644b6...70fcf3776977097c61ab6fbee1108a7c223cc4cc,2,4,2,6,2,2009-07-03 00:18:39,2009-07-03 00:18:39
70fcf3776977097c61ab6fbee1108a7c223cc4cc...4d0a31a60dfbea35fd812f53fa302fa9bb6b2264,1,2,0,2,2,2009-07-03 00:28:36,2009-07-03 00:28:36
64927b36f4a2c7d305821400b0e8542a8b8de942...50b8c496ecf4ab6ce8dd7cd7861852e95c8b32dc,1,27,26,53,4,2009-07-02 21:13:42,2009-07-02 21:13:42
0280e2e8ebdf435eceb8fb942d44da1fb4540109...0bdf5ae60565bd771b0a759e189b49348df039a0,1,1,1,2,1,2009-07-20 15:23:12,2009-07-20 15:23:12
0280e2e8ebdf435eceb8fb942d44da1fb4540109...467d16be4ac5d2b9195eea5485394be6097448cb,1,1,1,2,1,2009-07-17 15:21:42,2009-07-17 15:21:42
bd30dd6bf02754721accbb41a70f3ea62f947496...8371ce3872d8baedd9330c07cae3fb2e80816ab9,1,1,1,2,1,2009-07-13 17:44:03,2009-07-13 17:44:03
8371ce3872d8baedd9330c07cae3fb2e80816ab9...b10cd34b95998a2592050878996bd15b3ae5ddec,1,2,2,4,2,2009-07-13 17:44:11,2009-07-13 17:44:11
b10cd34b95998a2592050878996bd15b3ae5ddec...b3303c0708be4e3b1c39cf538eb41da8b758a20a,1,2,2,4,2,2009-07-13 17:48:08,2009-07-13 17:48:08
b3303c0708be4e3b1c39cf538eb41da8b758a20a...3806a9dfff6fe9c4c7940d140af2eb2dbc9237e1,1,4,0,4,2,2009-07-13 18:09:43,2009-07-13 18:09:43
3806a9dfff6fe9c4c7940d140af2eb2dbc9237e1...d7551c292516b448d9139a4f0520054d24161c52,1,7,2,9,3,2009-07-13 18:10:16,2009-07-13 18:10:16
4d0a31a60dfbea35fd812f53fa302fa9bb6b2264...536f47c30b3b5536ece8162244821208b73de193,1,21,0,21,1,2009-07-05 15:51:33,2009-07-05 15:51:33
4783318084c01dff82abaf5e4f6a83ff0e16349e...7783c0b8fa1a115f296f52e0b535c0b37d638d7b,3,20,10,30,11,2009-07-20 16:42:06,2009-07-20 16:42:06
7783c0b8fa1a115f296f52e0b535c0b37d638d7b...d5445853edb1a1f14489d18ce57b3b504e12b8b9,1,0,0,0,0,2009-07-21 12:04:43,2009-07-21 12:04:43
e9ef23c72df9c7b1e4e510cbe3b3504eda281787...45f29d0123e15287f3c9176edaba2c8ef137ded0,7,220,5,225,13,2009-07-17 19:49:24,2009-07-17 19:49:24
45f29d0123e15287f3c9176edaba2c8ef137ded0...f6aebb421f94ea2f05af3c804a4726ef226231cc,1,4,4,8,4,2009-07-17 20:02:25,2009-07-17 20:02:25
d7551c292516b448d9139a4f0520054d24161c52...b75755ed689601e1fcf31ee2b219c450bbae773f,2,18,18,36,18,2009-07-13 20:33:03,2009-07-13 20:33:03
d7551c292516b448d9139a4f0520054d24161c52...252c621fc3170174a70840d0c9751601fd0e42d8,2,14,3,17,3,2009-07-13 20:32:17,2009-07-13 20:32:17
252c621fc3170174a70840d0c9751601fd0e42d8...f1253179cee72f47cf8697edf83fae967231346a,1,61,26,87,14,2009-07-13 20:37:36,2009-07-13 20:37:36
536f47c30b3b5536ece8162244821208b73de193...cbe807bd6ec091e2b04166bb6404fb8b8caab50f,0,0,0,0,0,2009-07-06 00:25:34,2009-07-06 00:25:34
d5445853edb1a1f14489d18ce57b3b504e12b8b9...ea02e20990de61f172b40c25e289afa610019f4e,1,36,12,48,7,2009-07-24 18:27:35,2009-07-24 18:27:35
ea02e20990de61f172b40c25e289afa610019f4e...6e3a37e594f6ba07d305c3b71d891c3d11497469,2,4,9,13,2,2009-07-24 18:28:05,2009-07-24 18:28:05
d5445853edb1a1f14489d18ce57b3b504e12b8b9...890a4d23f4ecfc336d373bdd21b1f22ef371df3b,1,1,1,2,1,2009-07-22 15:26:19,2009-07-22 15:26:19
d5445853edb1a1f14489d18ce57b3b504e12b8b9...c7b0dcfed332e15f61d60cebc3aad713be701336,1,19,19,38,19,2009-07-21 18:41:23,2009-07-21 18:41:23
c7b0dcfed332e15f61d60cebc3aad713be701336...3e637e9c7c12324b74d67fd86c2b449dea8bb0ba,3,49,5,54,8,2009-07-21 19:08:45,2009-07-21 19:08:45
3e637e9c7c12324b74d67fd86c2b449dea8bb0ba...bb334cfa6ffba20803f4e7bd6c17c7c98308dd29,1,3,3,6,3,2009-07-21 20:53:35,2009-07-21 20:53:35
7902501270a4b96a962b2b89a4de2de49d84b59d...6da11a3453dbcd8607a475a126bbadab116cf798,1,19,19,38,18,2009-07-13 20:39:02,2009-07-13 20:39:02
6da11a3453dbcd8607a475a126bbadab116cf798...c4147d409c5d1d06d325ff8c54e53cdc42515a31,1,36,28,64,6,2009-07-13 20:48:43,2009-07-13 20:48:43
c4147d409c5d1d06d325ff8c54e53cdc42515a31...5d3ba187a0544d96f7b5ced3981243f14475e677,3,9,8,17,5,2009-07-13 20:49:02,2009-07-13 20:49:02
5d3ba187a0544d96f7b5ced3981243f14475e677...342259d353d01b638abf3bfc5c497e3585b69ee1,1,2,2,4,2,2009-07-14 18:04:49,2009-07-14 18:04:49
342259d353d01b638abf3bfc5c497e3585b69ee1...2d8e4fd3a0846b985bb9da0cf546bc812426b7c7,1,14,0,14,2,2009-07-14 20:24:24,2009-07-14 20:24:24
2d8e4fd3a0846b985bb9da0cf546bc812426b7c7...294f9e48733c03d3ee7f5960dc363b341a0983e3,3,43,21,64,6,2009-07-15 15:41:23,2009-07-15 15:41:23
32e0fef68b7c2467235bffa3f500eac28fe90919...7bb37b3fd2dfdd3ff3c15634236b4ca487ceda62,3,29,7,36,8,2009-07-06 14:42:22,2009-07-06 14:42:22
7bb37b3fd2dfdd3ff3c15634236b4ca487ceda62...a96c97161eaff686449560e4f3f5029d91287656,2,4,1,5,2,2009-07-06 17:47:00,2009-07-06 17:47:00
a96c97161eaff686449560e4f3f5029d91287656...6b38f5ec17ac6eafd62893ee6d94597efd74bbee,1,3,5,8,3,2009-07-06 21:03:03,2009-07-06 21:03:03
a62f1b40ba338ff2f0e3e3b751f1d1599bd27bcc...2ebcfab1d3ba94d1acb8206b706fab7e831ac619,1,4,1,5,1,2009-07-24 18:55:42,2009-07-24 18:55:42
086ec004b63818692e5567e8a8ccbf7c22751d20...d6d3ee0e8dba39d523dcc3e2556e638df9e80c95,1,2,2,4,2,2009-07-22 20:03:50,2009-07-22 20:03:50
086ec004b63818692e5567e8a8ccbf7c22751d20...ba2dfa64415606d334245c7076cb368ab2910b8f,1,5,5,10,5,2009-07-22 17:42:21,2009-07-22 17:42:21
ba2dfa64415606d334245c7076cb368ab2910b8f...ef93107b5541ede349f9fa1c2e668b0d4468553f,1,2,0,2,1,2009-07-22 17:42:57,2009-07-22 17:42:57
ef93107b5541ede349f9fa1c2e668b0d4468553f...00b52c1add4ca75d184348350bbbfdf9a0930ff3,1,4,1,5,3,2009-07-22 17:56:51,2009-07-22 17:56:51
bb334cfa6ffba20803f4e7bd6c17c7c98308dd29...0352532fa4243c01c2217d047da54c6c0ef38f54,1,40,0,40,1,2009-07-23 01:37:23,2009-07-23 01:37:23
294f9e48733c03d3ee7f5960dc363b341a0983e3...1a600bd3b2185a9b92f8641621b07717028cfcce,3,95,9,104,13,2009-07-15 21:05:38,2009-07-15 21:05:38
1a600bd3b2185a9b92f8641621b07717028cfcce...3022ee8874214bfadfd7792bc7e69cc6253ad1b1,2,51,14,65,14,2009-07-21 21:53:19,2009-07-21 21:53:19
3022ee8874214bfadfd7792bc7e69cc6253ad1b1...9c44b1c8642dde6d5cb3513728bbfcd235ffe03f,1,2,0,2,1,2009-07-21 21:55:12,2009-07-21 21:55:12
9c44b1c8642dde6d5cb3513728bbfcd235ffe03f...c477ed3a158354c7f31d950bac6b3a373acc5d1d,5,150,24,174,24,2009-07-21 22:37:30,2009-07-21 22:37:30
c477ed3a158354c7f31d950bac6b3a373acc5d1d...e815b9181221f223551189fd43dde0baafaba081,1,17,2,19,2,2009-07-21 22:53:07,2009-07-21 22:53:07
e815b9181221f223551189fd43dde0baafaba081...e422bfe70d20aafa67bb5de6ba9cd6fdd009a612,1,4,0,4,1,2009-07-22 21:23:20,2009-07-22 21:23:20
294f9e48733c03d3ee7f5960dc363b341a0983e3...443c4013984826f080f5f2066034645d4e36d0a6,1,1,1,2,1,2009-07-15 20:45:23,2009-07-15 20:45:23
6b38f5ec17ac6eafd62893ee6d94597efd74bbee...85e8f71c1cf11524af71c1ba1c4cb6db7ce439eb,10,170,60,230,59,2009-07-07 17:17:53,2009-07-07 17:17:53
6b38f5ec17ac6eafd62893ee6d94597efd74bbee...e0851fb39089457041ce41fa621fce7f6acd1a47,1,0,9,9,1,2009-07-07 14:05:30,2009-07-07 14:05:30
e0851fb39089457041ce41fa621fce7f6acd1a47...65e16d430e2749df3d4436fbef658b4bf8c1e387,1,33,6,39,7,2009-07-07 14:44:43,2009-07-07 14:44:43
4e1ba7418ea3d54a6d5b3fddf89cf3b2d55be795...1920aea8d3127c65fab2013043997f97e3480639,1,11,0,11,1,2009-07-26 01:41:07,2009-07-26 01:41:07
1920aea8d3127c65fab2013043997f97e3480639...fbe8c8373fa7b18d9fda500b63e8d80609c90c59,1,23,0,23,1,2009-07-27 15:47:28,2009-07-27 15:47:28
fbe8c8373fa7b18d9fda500b63e8d80609c90c59...3cc17c8c5fb58dca4effe36602eabcdd1c3a078f,5,23,12,35,10,2009-07-27 17:50:25,2009-07-27 17:50:25
3cc17c8c5fb58dca4effe36602eabcdd1c3a078f...c662c71c509cb8e573af308cda8d77db5c3725a7,1,3,0,3,2,2009-07-27 18:02:32,2009-07-27 18:02:32
c662c71c509cb8e573af308cda8d77db5c3725a7...9cf1b9d68c92779f6d392e78a1fca742caed5ad2,1,9,5,14,4,2009-07-27 20:24:09,2009-07-27 20:24:09
9cf1b9d68c92779f6d392e78a1fca742caed5ad2...0933c25a43615bd001b414dc687d0a4beb16f406,1,1,1,2,1,2009-07-27 21:30:41,2009-07-27 21:30:41
0933c25a43615bd001b414dc687d0a4beb16f406...8f1fd28d05983ebe2168b603b5f6a23c3e8fa24a,1,2,1,3,1,2009-07-28 05:02:41,2009-07-28 05:02:41
8f1fd28d05983ebe2168b603b5f6a23c3e8fa24a...bb024cd3ea9c562346e574fdec190102b46ca1f9,1,10,2,12,4,2009-07-28 14:46:56,2009-07-28 14:46:56
bb024cd3ea9c562346e574fdec190102b46ca1f9...399b58066efa90485059211f2f4fd33cc0e10e87,1,1,1,2,1,2009-07-28 14:48:15,2009-07-28 14:48:15
399b58066efa90485059211f2f4fd33cc0e10e87...b9721f7a1ffaa47bf566d5a82992c61ac988fa90,1,11,2,13,4,2009-07-28 15:19:13,2009-07-28 15:19:13
b9721f7a1ffaa47bf566d5a82992c61ac988fa90...280c1358eef1bb73397b70cad6364a0ed3988e9b,1,57,47,104,8,2009-07-28 21:21:26,2009-07-28 21:21:26
280c1358eef1bb73397b70cad6364a0ed3988e9b...d4008f027b553e901adcf0c42f43076db0fd1a4a,1,3,2,5,2,2009-07-29 04:59:59,2009-07-29 04:59:59
ae994ff284fdd15c1d4c8240cdd16bc6fecf7114...502e762508941c67b0047326928d896f54567e3e,1,44,0,44,1,2009-07-23 14:40:37,2009-07-23 14:40:37
502e762508941c67b0047326928d896f54567e3e...dba7572265b657bde920bd69f943cb80eb8a7c58,1,189,189,378,38,2009-07-23 15:16:02,2009-07-23 15:16:02
dba7572265b657bde920bd69f943cb80eb8a7c58...e358971d6f7d57d77f1ce5b0a1b7849ae3ba93f1,2,8,6,14,4,2009-07-23 15:32:41,2009-07-23 15:32:41
e358971d6f7d57d77f1ce5b0a1b7849ae3ba93f1...529784d10def0b7f8dabace9b095104ac9917ae7,2,24,2,26,6,2009-07-23 20:47:52,2009-07-23 20:47:52
529784d10def0b7f8dabace9b095104ac9917ae7...a4a3d19ce1249f7dd669aac4439157a6ac40b429,2,28,2,30,6,2009-07-23 21:37:52,2009-07-23 21:37:52
a4a3d19ce1249f7dd669aac4439157a6ac40b429...767d576ca4730946feb34534625d0b96ab4e2018,1,6,4,10,2,2009-07-23 22:58:32,2009-07-23 22:58:32
767d576ca4730946feb34534625d0b96ab4e2018...2d61cb2d7c475ceeb76055cb473b1f1a6e84f360,1,5,4,9,3,2009-07-24 00:48:23,2009-07-24 00:48:23
2d61cb2d7c475ceeb76055cb473b1f1a6e84f360...9ff7fa1d895d2e72f87c73d99b12be38e0a044b5,1,2,0,2,1,2009-07-24 00:51:01,2009-07-24 00:51:01
9ff7fa1d895d2e72f87c73d99b12be38e0a044b5...168dcf76327692b7383940ae20932e13101069d4,4,45,18,63,21,2009-07-24 12:26:35,2009-07-24 12:26:35
168dcf76327692b7383940ae20932e13101069d4...0c46e6dd8f9faaaf5936b09063a2092b440482d5,3,3,1,4,3,2009-07-24 14:53:46,2009-07-24 14:53:46
0c46e6dd8f9faaaf5936b09063a2092b440482d5...956fd780e23cebfaf09c6d2fb02c8c3a5e4a9dd3,1,2,0,2,1,2009-07-24 15:01:04,2009-07-24 15:01:04
956fd780e23cebfaf09c6d2fb02c8c3a5e4a9dd3...de9d456c3577f6be96ccb458953a0c086343eaa2,1,1,0,1,1,2009-07-24 15:10:35,2009-07-24 15:10:35
d5b720a5e6673d0071c2f9edef1300e17c7ff07f...5dcdc3a59caf6f503637c13902ed7f002d25328c,13,138,10,148,22,2009-07-29 19:53:14,2009-07-29 19:53:14
5dcdc3a59caf6f503637c13902ed7f002d25328c...3a337ff121656c47ff665a5c18f9a9de349d505e,4,67,12,79,9,2009-07-29 23:10:34,2009-07-29 23:10:34
443c4013984826f080f5f2066034645d4e36d0a6...84e996ca2857bca34b8993f271e18c1e34fcf5cf,3,26,8,34,6,2009-07-16 16:06:36,2009-07-16 16:06:36
d4008f027b553e901adcf0c42f43076db0fd1a4a...384f32a70e7feb79961b21aef31017fc858d8d82,2,42,2,44,2,2009-07-29 15:16:51,2009-07-29 15:16:51
d4008f027b553e901adcf0c42f43076db0fd1a4a...6746cd2493a1e30e3bde1141d76b45f40aeaefa5,3,3,3,6,3,2009-07-29 15:16:33,2009-07-29 15:16:33
6746cd2493a1e30e3bde1141d76b45f40aeaefa5...dd9ba41ed4b77301fcc46d3d35cade8b415826af,4,27,7,34,9,2009-07-29 16:09:38,2009-07-29 16:09:38
de9d456c3577f6be96ccb458953a0c086343eaa2...8fe350ff00fae8a2ed1bac3f535d7a649ef8d2d3,2,11,6,17,7,2009-07-24 18:33:11,2009-07-24 18:33:11
8fe350ff00fae8a2ed1bac3f535d7a649ef8d2d3...e1cca5460aecf75dce95a7148de72f547739d11b,1,0,1,1,1,2009-07-24 18:35:27,2009-07-24 18:35:27
7fd282b98989ac84562549d77a5d2c4f1fbb960b...733ba1e11d6c4cfd304c2d81ca757bd4c08065ea,6,180,41,221,44,2009-08-03 18:16:49,2009-08-03 18:16:49
7fd282b98989ac84562549d77a5d2c4f1fbb960b...24a6ae09d77b198471c2b52f3a205e6f784be7d0,15,48,38,86,32,2009-08-01 18:54:20,2009-08-01 18:54:20
24a6ae09d77b198471c2b52f3a205e6f784be7d0...de1ce6719e5d0a08427bcc0f1a5af7665941464c,4,4,3,7,5,2009-08-01 19:11:10,2009-08-01 19:11:10
de1ce6719e5d0a08427bcc0f1a5af7665941464c...137f185298b36b59f98a7f3ec06de75a358eff96,2,217,71,288,11,2009-08-03 18:32:23,2009-08-03 18:32:23
137f185298b36b59f98a7f3ec06de75a358eff96...7162ec93433e789d1a0be02fed67b8a578eb6169,1,0,63,63,1,2009-08-03 18:47:03,2009-08-03 18:47:03
7162ec93433e789d1a0be02fed67b8a578eb6169...652323c67c1b864e3ee8e48cda832ed71a874b00,2,13,1,14,2,2009-08-03 19:02:30,2009-08-03 19:02:30
652323c67c1b864e3ee8e48cda832ed71a874b00...d91bb3a5650494ad8c52e487bc9c7f75fe7c07a2,4,48,43,91,9,2009-08-03 20:26:18,2009-08-03 20:26:18
d91bb3a5650494ad8c52e487bc9c7f75fe7c07a2...68dc075c00b48c1de8df14aa211738cdf0569c8b,2,9,6,15,9,2009-08-05 18:03:29,2009-08-05 18:03:29
68dc075c00b48c1de8df14aa211738cdf0569c8b...f76fbbc402a0f442b7a054f19dae72ea4acd9adc,5,58,16,74,17,2009-08-05 20:02:20,2009-08-05 20:02:20
f76fbbc402a0f442b7a054f19dae72ea4acd9adc...c009338653fed0df7f6f3ee9e08f7b70822bda62,1,8,2,10,2,2009-08-05 20:27:58,2009-08-05 20:27:58
982dd76d576c19d3ccac0d0b6c7788dc11a12c50...7d692b0e2c90a645a2092fb51a49776f2443a265,1,5,4,9,1,2009-07-29 16:17:55,2009-07-29 16:17:55
7d692b0e2c90a645a2092fb51a49776f2443a265...43bd4c2f8c29c23e578d6181fcce795f645741b6,1,1,1,2,1,2009-07-29 16:18:11,2009-07-29 16:18:11
43bd4c2f8c29c23e578d6181fcce795f645741b6...73be2f845405e3df0780e9db6030ef75bb7c7e22,3,51,0,51,3,2009-07-29 17:13:01,2009-07-29 17:13:01
73be2f845405e3df0780e9db6030ef75bb7c7e22...a60415e5a662d39026e63d96f1b1b7846af34b50,1,2,2,4,2,2009-07-29 17:32:08,2009-07-29 17:32:08
a60415e5a662d39026e63d96f1b1b7846af34b50...02d597b594bfbc2707e15327af8b3aa68453b28e,1,1,1,2,1,2009-07-29 17:47:52,2009-07-29 17:47:52
02d597b594bfbc2707e15327af8b3aa68453b28e...0fe89a134e1f37803c84090a1d76049042ba890c,1,8,0,8,2,2009-07-29 18:19:55,2009-07-29 18:19:55
0fe89a134e1f37803c84090a1d76049042ba890c...8be85b3e48b8b8073a11e726b37429c49f45fa85,3,41,13,54,9,2009-07-29 18:20:40,2009-07-29 18:20:40
8be85b3e48b8b8073a11e726b37429c49f45fa85...363f75a1506e1a4fa50a60a3f2ef24211386986b,1,1,1,2,1,2009-07-29 18:44:16,2009-07-29 18:44:16
363f75a1506e1a4fa50a60a3f2ef24211386986b...6dc201583a91ae97f547fbff748019dfbc8ea1d4,1,1,1,2,1,2009-07-29 18:49:21,2009-07-29 18:49:21
6dc201583a91ae97f547fbff748019dfbc8ea1d4...27cf5ce839e6191b2395d10205a58a7d29589087,1,1,1,2,1,2009-07-29 19:56:38,2009-07-29 19:56:38
27cf5ce839e6191b2395d10205a58a7d29589087...ce2640bfae3ca4e90dd705da768350a6adfc7552,1,7,6,13,3,2009-07-30 01:03:42,2009-07-30 01:03:42
733ba1e11d6c4cfd304c2d81ca757bd4c08065ea...e84e62cc537f69cc5cd4873e33e68954c28fa29d,1,3,3,6,2,2009-08-04 17:03:10,2009-08-04 17:03:10
733ba1e11d6c4cfd304c2d81ca757bd4c08065ea...d0ed87f6a848bd9b3ab410df69de5a5932f67e5e,1,1,0,1,1,2009-08-04 16:07:09,2009-08-04 16:07:09
d0ed87f6a848bd9b3ab410df69de5a5932f67e5e...846911b4215464409acb83e220dfd45ee888d4b3,1,2,1,3,2,2009-08-04 18:00:59,2009-08-04 18:00:59
63b8f32e1334f9e103be6fbf1c53e00311a69a1e...245b62517885e2ce2e04f17dfaaee1da30b59ad3,1,4,3,7,1,2009-08-11 06:25:45,2009-08-11 06:25:45
245b62517885e2ce2e04f17dfaaee1da30b59ad3...671cf3ddd45bca6ac7ee5e60dc835cc7e51e0b0e,1,1,1,2,2,2009-08-11 06:36:38,2009-08-11 06:36:38
671cf3ddd45bca6ac7ee5e60dc835cc7e51e0b0e...5025bb763778ced9c993f55e94a6c6de67ae1058,1,6,0,6,2,2009-08-11 08:54:58,2009-08-11 08:54:58
5025bb763778ced9c993f55e94a6c6de67ae1058...f0e44b290740367b720f219d28275acb76e9146a,1,2,38,40,2,2009-08-11 08:55:35,2009-08-11 08:55:35
f0e44b290740367b720f219d28275acb76e9146a...34fb6220f20580c1f5e4d47cb9270a5cd3b9331d,2,15,0,15,4,2009-08-11 08:58:19,2009-08-11 08:58:19
34fb6220f20580c1f5e4d47cb9270a5cd3b9331d...2b0dbe323df59ac1b4dda70679e43830acf0e23b,5,35,18,53,12,2009-08-11 08:58:54,2009-08-11 08:58:54
2b0dbe323df59ac1b4dda70679e43830acf0e23b...b3322b86a014683018ac81c30df0b0823bf03272,1,9,1,10,2,2009-08-11 14:28:32,2009-08-11 14:28:32
b3322b86a014683018ac81c30df0b0823bf03272...1205ca87862977be03985edaa5800f225431eb41,1,15,13,28,1,2009-08-11 14:48:33,2009-08-11 14:48:33
1205ca87862977be03985edaa5800f225431eb41...043f15bbd7cbd1bb1c041335e594430e1f6e3e82,2,3,3,6,3,2009-08-11 14:50:02,2009-08-11 14:50:02
043f15bbd7cbd1bb1c041335e594430e1f6e3e82...a9e20d2dfd0b6234d782064d6e76a7ea88d3719d,1,6,0,6,1,2009-08-11 14:52:20,2009-08-11 14:52:20
a9e20d2dfd0b6234d782064d6e76a7ea88d3719d...72c986acd6bfdb90a0cda3a1d2fd4b94da617a47,1,10,5,15,4,2009-08-11 15:27:02,2009-08-11 15:27:02
e1a52487e9130e742fd2f71a3e3b75a6a36a204d...c9ad39db791c46076571bdc2fdaa7cc6066593ad,5,229,21,250,41,2009-08-05 17:14:06,2009-08-05 17:14:06
c9ad39db791c46076571bdc2fdaa7cc6066593ad...d223c26df941d585693e1f81490117d84058469c,1,0,23,23,10,2009-08-05 17:24:53,2009-08-05 17:24:53
d223c26df941d585693e1f81490117d84058469c...b1793eae5b973b7270b7389f85aa71554a54358e,1,4,0,4,3,2009-08-05 17:30:55,2009-08-05 17:30:55
b1793eae5b973b7270b7389f85aa71554a54358e...c34247cd9633fe4824b972ba675cc7cb017a965f,1,3,0,3,3,2009-08-05 17:34:54,2009-08-05 17:34:54
c34247cd9633fe4824b972ba675cc7cb017a965f...a3475be9defff022330efb81fc374045c9320ec2,1,1,1,2,1,2009-08-05 17:39:01,2009-08-05 17:39:01
72c986acd6bfdb90a0cda3a1d2fd4b94da617a47...e3cfc2264ae37870582287eec3e714b7f41ebaee,1,2,0,2,1,2009-08-11 16:59:00,2009-08-11 16:59:00
72c986acd6bfdb90a0cda3a1d2fd4b94da617a47...d2caa282ca768a1790380aaff3d7c1ae0600592b,1,7,4,11,3,2009-08-11 15:32:03,2009-08-11 15:32:03
a3475be9defff022330efb81fc374045c9320ec2...4875e282d1e6e96ff84e852018cb4ad7b34b7d46,2,7,1,8,2,2009-08-06 15:37:33,2009-08-06 15:37:33
a3475be9defff022330efb81fc374045c9320ec2...7d335e715c65d71611c5c4d7134ad8529eb3893a,1,0,1,1,1,2009-08-05 18:10:36,2009-08-05 18:10:36
0d1165765a99362ac53d822e5329360ef4336d50...0545f5ff48052815825798cedf778d05ebbe8534,1,3,1,4,1,2009-08-11 18:34:45,2009-08-11 18:34:45
0d1165765a99362ac53d822e5329360ef4336d50...be7ff8eaddda7d197f2c32eb25f3e26213928977,2,35,17,52,8,2009-08-11 17:35:59,2009-08-11 17:35:59
d2caa282ca768a1790380aaff3d7c1ae0600592b...21415980caf8f43e4f140afa90db224455295a31,1,12,12,24,9,2009-08-11 17:57:01,2009-08-11 17:57:01
bc480966e5a2e79e828344a895849f2bceb65f03...32f5ebb4c626bceaed904736596660542c9c5ca6,3,45,45,90,40,2009-08-06 18:12:32,2009-08-06 18:12:32
32f5ebb4c626bceaed904736596660542c9c5ca6...e3cefee81d14210f4940e4ff76e2c88d23c3ad6f,1,54,54,108,47,2009-08-06 18:15:18,2009-08-06 18:15:18
bc480966e5a2e79e828344a895849f2bceb65f03...3578c9a2070aed26d912368e8132fdfc650fd86b,1,1,0,1,1,2009-08-06 15:54:09,2009-08-06 15:54:09
3578c9a2070aed26d912368e8132fdfc650fd86b...de9543ff4de19e776d82f2a5ba4528aaba58f374,2,4,2,6,5,2009-08-06 15:54:30,2009-08-06 15:54:30
de9543ff4de19e776d82f2a5ba4528aaba58f374...ade581aa6571951e2c0036e40072985c72517648,5,12,7,19,6,2009-08-06 17:53:03,2009-08-06 17:53:03
ade581aa6571951e2c0036e40072985c72517648...889c34777e2aa0096f3ce2b2152dec969c29db1d,1,10,0,10,1,2009-08-06 19:23:56,2009-08-06 19:23:56
889c34777e2aa0096f3ce2b2152dec969c29db1d...5b96c6de6a124835e2036e12bffc3fc778bc2991,1,11,5,16,1,2009-08-06 19:25:09,2009-08-06 19:25:09
5b96c6de6a124835e2036e12bffc3fc778bc2991...3567de373bb7ff6afb58251e6dfb5e334f7d87d9,2,5,3,8,3,2009-08-06 19:55:16,2009-08-06 19:55:16
3567de373bb7ff6afb58251e6dfb5e334f7d87d9...f6deb4d4df07386610c1a7fc230377e56a63472e,1,35,19,54,9,2009-08-06 20:15:25,2009-08-06 20:15:25
f6deb4d4df07386610c1a7fc230377e56a63472e...13c6e65bf6dff691cdd76b257938dab604777599,1,1,1,2,1,2009-08-07 13:15:29,2009-08-07 12:00:23
7d335e715c65d71611c5c4d7134ad8529eb3893a...79be4b64a3ef2e3a5d9c0606199c01c3ccfc5e24,14,47,32,79,31,2009-08-05 20:00:27,2009-08-05 20:00:27
7d335e715c65d71611c5c4d7134ad8529eb3893a...1fa83c18929249698bb66b949a4dad6bc41b9626,1,8,0,8,2,2009-08-05 19:38:58,2009-08-05 19:38:58
d22866abfff9e1a85f5fbec8b8be50653e4aa3d7...02959549f205696c7390083fd135c9176fc77e31,1,1,1,2,1,2009-08-13 16:28:30,2009-08-13 16:28:30
d22866abfff9e1a85f5fbec8b8be50653e4aa3d7...714de2af682431ffb6a1c930e03699fc3f065f69,3,155,12,167,18,2009-08-11 20:42:27,2009-08-11 20:42:27
714de2af682431ffb6a1c930e03699fc3f065f69...9fd0168effad55570a39a4c4f3af6b5c8ed9bbe7,6,175,163,338,82,2009-08-11 20:43:30,2009-08-11 20:43:30
b208f54e5a7290b8ab0e55cedaa6a63d97ab0925...01ff742b4e0eb9da187a98e6de2669c28fffc271,9,20,19,39,18,2009-08-11 18:29:03,2009-08-11 18:29:03
6eee7dac84de1f0a3a9f49971451c496546caebd...563fa6bb6461f8602beaccd7b8a50c9bed8ad83d,1,2,2,4,1,2009-08-07 14:07:57,2009-08-07 14:07:57
563fa6bb6461f8602beaccd7b8a50c9bed8ad83d...86c62a6911e5382a7473502c819714367b944f46,1,1,6,7,2,2009-08-07 14:10:18,2009-08-07 14:10:18
86c62a6911e5382a7473502c819714367b944f46...ae3312f1cc52f833b5235b1c2db5758fe247073a,1,83,107,190,15,2009-08-07 14:43:39,2009-08-07 14:43:39
ae3312f1cc52f833b5235b1c2db5758fe247073a...ee964dcbc9758c1a4c1831ad574a98f41f071a9e,1,3,1,4,1,2009-08-07 17:14:50,2009-08-07 17:14:50
ee964dcbc9758c1a4c1831ad574a98f41f071a9e...a38fe7f2f233fe6c83fffb167476596cbc5eaf3c,1,15,6,21,8,2009-08-07 20:02:56,2009-08-07 20:02:56
a38fe7f2f233fe6c83fffb167476596cbc5eaf3c...fbd2f4eb038858b0d35fcb6156e3e8746ce1c090,4,240,0,240,4,2009-08-07 20:03:11,2009-08-07 20:03:11
13c6e65bf6dff691cdd76b257938dab604777599...04d1d87a5fc5b357c336faa3b6eb8b0aa29b263a,2,13,3,16,8,2009-08-07 21:02:47,2009-08-07 21:02:47
13c6e65bf6dff691cdd76b257938dab604777599...abb40a551d49998a252dff8f6f532fa010136817,6,22,13,35,14,2009-08-07 19:37:50,2009-08-07 19:37:50
abb40a551d49998a252dff8f6f532fa010136817...11d8ba65b5449506d1125c59d2075bfb879de768,1,1,1,2,1,2009-08-07 19:43:31,2009-08-07 19:43:31
0b62b3f996a0c4329babd68b7bbc771c3bcb9df9...42fd57b9a8f71cde345b2805b91f69fb1bd02040,1,2,0,2,1,2009-08-05 20:02:26,2009-08-05 20:02:26
e6258aaa474984c6b0aeb08728fa972e3858cd31...f0c2c8003fc89a324e2e47aef0a218ddcd9e0d0d,8,34,30,64,18,2009-08-13 17:26:03,2009-08-13 17:26:03
e6258aaa474984c6b0aeb08728fa972e3858cd31...9f0fde9d3136a1dc22f868b904a8ec61f839f22a,1,1,0,1,1,2009-08-13 17:25:19,2009-08-13 17:25:19
9fd0168effad55570a39a4c4f3af6b5c8ed9bbe7...2f3398e6cc1107f256762da03278afad1d5b73c9,3,65,30,95,12,2009-08-12 21:45:29,2009-08-12 21:45:29
9fd0168effad55570a39a4c4f3af6b5c8ed9bbe7...2dc836fbb899e7af25ae725f74310e2a884d6736,1,2,2,4,2,2009-08-11 21:09:01,2009-08-11 21:09:01
2dc836fbb899e7af25ae725f74310e2a884d6736...c13927d6d3d9bf0a959d4df68a3801b69a436d6b,1,6,2,8,2,2009-08-11 21:14:15,2009-08-11 21:14:15
c13927d6d3d9bf0a959d4df68a3801b69a436d6b...886e5b605dbd4afc1231a726b2e44e48e00f09e5,1,1,0,1,1,2009-08-11 21:17:23,2009-08-11 21:17:23
886e5b605dbd4afc1231a726b2e44e48e00f09e5...b5bb4b2af946fd967596f400543ec948807f22af,4,57,8,65,27,2009-08-12 14:51:31,2009-08-12 14:51:31
b5bb4b2af946fd967596f400543ec948807f22af...d804f7f3ee3508be8aa54d0c0c60d3612b159157,5,66,14,80,7,2009-08-12 17:53:52,2009-08-12 17:53:52
d804f7f3ee3508be8aa54d0c0c60d3612b159157...e07cbd84344d768f3c7fe2f3228c991581214053,1,2,1,3,1,2009-08-12 18:29:38,2009-08-12 18:29:38
e07cbd84344d768f3c7fe2f3228c991581214053...7b9da727ba3e830f243946766215b39162a50e4f,3,5,3,8,4,2009-08-12 18:54:53,2009-08-12 18:54:53
7b9da727ba3e830f243946766215b39162a50e4f...172cec88a66782f25d168c4af2b1b5237f038505,1,3,3,6,3,2009-08-12 19:34:39,2009-08-12 19:34:39
172cec88a66782f25d168c4af2b1b5237f038505...a5b228603923871f09493ae51a94d05cde23faa1,1,1,2,3,1,2009-08-12 19:50:35,2009-08-12 19:50:35
a5b228603923871f09493ae51a94d05cde23faa1...016d49ffd22aadaae8da90af542127b2442d1296,7,47,5,52,14,2009-08-12 20:31:22,2009-08-12 20:31:22
016d49ffd22aadaae8da90af542127b2442d1296...0cfa107650fdc0f57b0823feb04ea7e1d705e102,2,8,1,9,3,2009-08-12 20:54:57,2009-08-12 20:54:57
0cfa107650fdc0f57b0823feb04ea7e1d705e102...38bb9b15c223e1abfe001b984ecc772064f76278,3,14,6,20,8,2009-08-12 20:55:18,2009-08-12 20:55:18
f56c39b8e2bc48adebaf803a5c46d9115fdbb42e...a22b8abeee2eebcbac7ae486d27e26289c15edec,1,24,0,24,1,2009-08-07 20:55:51,2009-08-07 20:55:51
a22b8abeee2eebcbac7ae486d27e26289c15edec...38bcbc9cae01530b4a93065e4aa968ff2a7609b6,2,13,3,16,3,2009-08-07 20:57:54,2009-08-07 20:57:54
a6e8d4cb01484a88061daf51528554c04f246ac2...be89353b284e391d8995714083cb3806df8a7189,3,14,2,16,4,2009-08-09 16:13:50,2009-08-09 16:13:50
be89353b284e391d8995714083cb3806df8a7189...71aa2443a3618253422171769113b04ef5b65bd2,1,9,1,10,2,2009-08-10 14:25:43,2009-08-10 14:25:43
71aa2443a3618253422171769113b04ef5b65bd2...7cadc27b27580c8eeafc8300bd37140d3943f281,1,3,2,5,2,2009-08-10 14:37:56,2009-08-10 14:37:56
7cadc27b27580c8eeafc8300bd37140d3943f281...d4961e1575f4a4229863eaf71b810cd0d9daf9c5,3,24,3,27,5,2009-08-10 15:10:15,2009-08-10 15:10:15
42fd57b9a8f71cde345b2805b91f69fb1bd02040...909a6bfd7ad0642da1249b52721cb69bc727b2a3,1,2,1,3,2,2009-08-05 21:05:59,2009-08-05 21:05:59
42fd57b9a8f71cde345b2805b91f69fb1bd02040...94ab9811a6abed3ea691a99ddc7136f4a4a22faf,1,2,1,3,1,2009-08-05 21:01:33,2009-08-05 21:01:33
03a3531a42c944c33eb7a2378fd86faf687be60d...062e60a661665b1386e96dc6558bc67f22f57a61,1,0,2,2,1,2009-08-13 17:26:47,2009-08-13 17:26:47
062e60a661665b1386e96dc6558bc67f22f57a61...c04c03474cbdc6c0b52bfe09af35732d7b7433e6,1,3,0,3,1,2009-08-14 02:44:55,2009-08-14 02:44:55
c04c03474cbdc6c0b52bfe09af35732d7b7433e6...974d71012896ee863b505b8d9c891e1f7f82f6d1,1,11,6,17,3,2009-08-14 14:55:52,2009-08-14 14:55:52
974d71012896ee863b505b8d9c891e1f7f82f6d1...115e9e42e1d78813fb65834769e58fcfbf7e9732,2,13,2,15,4,2009-08-14 15:06:10,2009-08-14 15:06:10
115e9e42e1d78813fb65834769e58fcfbf7e9732...bc193c4f5979d967c3e02cc51af2dd5216599143,1,3,2,5,2,2009-08-14 17:03:02,2009-08-14 17:03:02
bc193c4f5979d967c3e02cc51af2dd5216599143...acccbc1b192465325b2a4400bfcf531a7603b3d1,1,1,1,2,1,2009-08-14 17:24:02,2009-08-14 17:24:02
acccbc1b192465325b2a4400bfcf531a7603b3d1...de170c2bba8ba5bd5fbd1718b210916d8a8ea603,1,15,10,25,11,2009-08-14 17:33:45,2009-08-14 17:33:45
de170c2bba8ba5bd5fbd1718b210916d8a8ea603...4f1bf94a5eee35c6296a059f4f1d98ec22189ae5,1,1,1,2,1,2009-08-14 17:50:28,2009-08-14 17:50:28
4f1bf94a5eee35c6296a059f4f1d98ec22189ae5...66637b35da76b8fb4fe8876abd99a71cc6cab457,2,2,2,4,2,2009-08-14 18:25:55,2009-08-14 18:25:55
66637b35da76b8fb4fe8876abd99a71cc6cab457...75a58367af664525db5e7226db81082be19e4f06,1,1,1,2,1,2009-08-14 18:29:59,2009-08-14 18:29:59
75a58367af664525db5e7226db81082be19e4f06...443594f1756c6123c72b93ebb9a58f8fd4fc54d1,1,4,1,5,1,2009-08-14 19:10:07,2009-08-14 19:10:07
443594f1756c6123c72b93ebb9a58f8fd4fc54d1...cdff2417cbb685beb68ed2a56904df2c9ae4cdaa,1,1,1,2,1,2009-08-14 19:17:23,2009-08-14 19:17:23
cdff2417cbb685beb68ed2a56904df2c9ae4cdaa...752a747df8243fd9a426694a5f0ab021c79e93ef,3,30,25,55,13,2009-08-14 19:30:59,2009-08-14 18:19:23
752a747df8243fd9a426694a5f0ab021c79e93ef...e11d9c7efb131373c50ebd9c036ac492c0b55bea,2,11,0,11,3,2009-08-14 21:55:17,2009-08-14 21:55:17
e11d9c7efb131373c50ebd9c036ac492c0b55bea...bf34e9dec63cc4c218e76c6368864ed671d41e97,1,1,1,2,1,2009-08-16 03:39:36,2009-08-16 03:39:36
bf34e9dec63cc4c218e76c6368864ed671d41e97...b2d07883fa3cb10fd9c9f7c1be45511ea37b7b1b,1,1,1,2,1,2009-08-16 17:30:51,2009-08-16 17:30:51
b2d07883fa3cb10fd9c9f7c1be45511ea37b7b1b...2627b365fec2aad31b69121300589fa62e629f2c,1,3,1,4,1,2009-08-17 00:31:17,2009-08-17 00:31:17
2627b365fec2aad31b69121300589fa62e629f2c...0e8de9950b3c3b71471e02473ffd9d65a5fa18cc,1,14,0,14,1,2009-08-17 14:05:14,2009-08-17 14:05:14
0e8de9950b3c3b71471e02473ffd9d65a5fa18cc...3c651482c420357f1d01303d0c8dc733a6a9c21d,1,9,0,9,1,2009-08-17 14:46:19,2009-08-17 14:46:19
3c651482c420357f1d01303d0c8dc733a6a9c21d...3c93f8e57564c18bd1076cf459296a4f4226b7ef,4,23,13,36,7,2009-08-17 14:46:44,2009-08-17 14:46:44
3c93f8e57564c18bd1076cf459296a4f4226b7ef...8ad153d6312be3cf9ff2a4a40625f94c93307ef4,1,2,1,3,2,2009-08-17 14:51:23,2009-08-17 14:51:23
d4961e1575f4a4229863eaf71b810cd0d9daf9c5...e44b51ee69288b7fc1e04da3d8f25cb28c931c68,2,27,1,28,3,2009-08-10 17:31:48,2009-08-10 17:31:48
d4961e1575f4a4229863eaf71b810cd0d9daf9c5...f04c0ab0fc7574291a7d5e6a6dc119998fba535f,1,4,0,4,1,2009-08-10 16:28:04,2009-08-10 16:28:04
36f23c7b0dc59a01e1bcddbbf6a814bb4d89bd4d...488086994cea37019dfef744c45b196a8f4a9f92,5,20,1,21,9,2009-08-05 21:15:04,2009-08-05 21:15:04
488086994cea37019dfef744c45b196a8f4a9f92...94993960f79b793043393a98a2e15d179ad334a0,1,14,0,14,1,2009-08-06 04:50:31,2009-08-06 04:50:31
94993960f79b793043393a98a2e15d179ad334a0...35fa9f282b7385ea4ba3ce1ee8aa28c566b61578,1,4,0,4,1,2009-08-06 15:04:05,2009-08-06 15:04:05
35fa9f282b7385ea4ba3ce1ee8aa28c566b61578...1aaef4311c05b3e671113195503d8dd68e57a100,1,3,1,4,1,2009-08-06 15:25:15,2009-08-06 15:25:15
1aaef4311c05b3e671113195503d8dd68e57a100...1e5118fac5b177bf1cbdd163901604943e99f9cc,1,1,0,1,1,2009-08-06 15:32:35,2009-08-06 15:32:35
8ad153d6312be3cf9ff2a4a40625f94c93307ef4...8f33a37dce29749fbed779fb36a90ff46e1386a9,3,30,5,35,7,2009-08-17 15:58:18,2009-08-17 15:58:18
8ad153d6312be3cf9ff2a4a40625f94c93307ef4...20ef2dbf6851838d3f2e57b8f634bebc308e11a6,2,38,7,45,10,2009-08-17 15:19:02,2009-08-17 15:19:02
2f16b7065c20baa63e08f2d79290d633f3971e9f...8bbd6eadf6982525cda558d6ab21a49282ba0b37,2,7,5,12,2,2009-08-10 18:00:03,2009-08-10 18:00:03
8bbd6eadf6982525cda558d6ab21a49282ba0b37...79fcbfa97aa3e74f35cdc3ab414d1672f3e8e6a4,1,19,6,25,5,2009-08-10 18:00:18,2009-08-10 18:00:18
79fcbfa97aa3e74f35cdc3ab414d1672f3e8e6a4...9d23766511b28a52381fd039e890e62eaf1807a2,2,21,3,24,3,2009-08-10 19:24:48,2009-08-10 19:24:48
8a145572a5b015825568a5705ddf9c78f1d04730...4120dfc5684dca008c6c0cef64b2d9ff7ed3d158,8,21,13,34,11,2009-08-17 20:13:13,2009-08-17 20:13:13
4120dfc5684dca008c6c0cef64b2d9ff7ed3d158...a6cd2c479430f044bd05bb4dffc11f2be9a400a0,1,1,0,1,1,2009-08-17 20:45:34,2009-08-17 20:45:34
9d23766511b28a52381fd039e890e62eaf1807a2...af27a6594df4e3d672eb8e8941918fe533292f46,5,142,8,150,15,2009-08-10 21:08:43,2009-08-10 21:08:43
9d23766511b28a52381fd039e890e62eaf1807a2...c454bd3cd354ebb1b1a14f1b3b22a2f02a5cc298,3,24,7,31,7,2009-08-10 20:04:10,2009-08-10 20:04:10
c454bd3cd354ebb1b1a14f1b3b22a2f02a5cc298...17042c403e7c30b169de0a6eae994aa706d5db90,7,49,17,66,24,2009-08-10 20:57:59,2009-08-10 20:57:59
a6cd2c479430f044bd05bb4dffc11f2be9a400a0...92820c7cfbec83c5949e9b92d819e2c2180cda57,1,10,2,12,2,2009-08-17 20:54:47,2009-08-17 20:54:47
a6cd2c479430f044bd05bb4dffc11f2be9a400a0...1a700c121e2cf9080e4cbbd6f720da80915a5d40,1,1,1,2,1,2009-08-17 20:48:17,2009-08-17 20:48:17
94dadc846bcf84e38f66358fe7fcfd1a542633e3...4c6edcd91abbfc18cfc392effe25824914af4710,1,1,1,2,1,2009-08-10 21:14:42,2009-08-10 21:14:42
4c6edcd91abbfc18cfc392effe25824914af4710...d2dc0575e0e36059a8cd818b4ef6e0c71525c708,1,1,1,2,1,2009-08-11 00:46:08,2009-08-11 00:46:08
d2dc0575e0e36059a8cd818b4ef6e0c71525c708...386aa02cce9b0d47cf1dfd932530234fe8f689a7,2,5,11,16,5,2009-08-11 01:04:13,2009-08-11 01:04:13
1a700c121e2cf9080e4cbbd6f720da80915a5d40...bc50b778cf366128823a2cbf03fdc5b0059cbf1e,1,6,4,10,3,2009-08-17 21:33:04,2009-08-17 21:33:04
4b4efd2e484eea4eae2b48d469b78a0c3ea041c7...740318b133dd3b29ce39e31cf64a97093f05f686,2,12,1,13,4,2009-08-18 01:46:18,2009-08-18 01:46:18
740318b133dd3b29ce39e31cf64a97093f05f686...cd0bf23e74ef8ded0684f74996ee762889b93294,2,2,2,4,2,2009-08-18 17:00:30,2009-08-18 17:00:30
cd0bf23e74ef8ded0684f74996ee762889b93294...2869e47ae388c1a2f5cd388d654defd2788b057c,1,1,1,2,1,2009-08-18 18:22:35,2009-08-18 18:22:35
2869e47ae388c1a2f5cd388d654defd2788b057c...e481e6385a2a4dfe3f6a00b46718b5f1e7effdb7,1,1,1,2,1,2009-08-19 09:27:20,2009-08-19 09:27:20
e481e6385a2a4dfe3f6a00b46718b5f1e7effdb7...12766072240a39e09394b1425cee3ec4e18872b0,1,4,2,6,1,2009-08-19 11:02:30,2009-08-19 11:02:30
12766072240a39e09394b1425cee3ec4e18872b0...1e689145e6ca7907fd458c71a3c0543c23d52a21,1,15,1,16,2,2009-08-19 15:32:08,2009-08-19 15:32:08
1e689145e6ca7907fd458c71a3c0543c23d52a21...9ce02334be2738eec92da44d5450a5923c801ba5,3,22,12,34,8,2009-08-19 15:49:21,2009-08-19 15:49:21
9ce02334be2738eec92da44d5450a5923c801ba5...fcf1ca0afa0fd594e346ac5cc88646439f584dd0,4,142,10,152,11,2009-08-19 15:51:16,2009-08-19 15:51:16
fcf1ca0afa0fd594e346ac5cc88646439f584dd0...e57376179dbf656619549d9a54c1b39ef51748f7,1,1,1,2,1,2009-08-19 16:04:26,2009-08-19 16:04:26
e57376179dbf656619549d9a54c1b39ef51748f7...19c885c5a8ff574c5802e0c4d78c2a08ec48434c,1,5,1,6,1,2009-08-19 16:10:32,2009-08-19 16:10:32
19c885c5a8ff574c5802e0c4d78c2a08ec48434c...61ecff1e953cee8e5d7f4adb4fd59caf9b8f1d1a,1,167,45,212,58,2009-08-19 16:10:57,2009-08-19 16:10:57
61ecff1e953cee8e5d7f4adb4fd59caf9b8f1d1a...59622dbd76d9e5284136b08431c318c785b5ed9e,2,13,11,24,6,2009-08-19 16:33:06,2009-08-19 16:33:06
59622dbd76d9e5284136b08431c318c785b5ed9e...8da2e12652dd8d58e7eac38fe4c57ce66865c99e,1,0,1,1,1,2009-08-19 16:37:28,2009-08-19 16:37:28
8da2e12652dd8d58e7eac38fe4c57ce66865c99e...b6197c4be8dd85cd09f58a21004e789370bfefce,1,0,1,1,1,2009-08-19 17:53:11,2009-08-19 17:53:11
8da2e12652dd8d58e7eac38fe4c57ce66865c99e...9783eed68d7151681fd99cb136e7f1eef3c064c3,2,19,1,20,2,2009-08-19 17:18:32,2009-08-19 17:18:32
9783eed68d7151681fd99cb136e7f1eef3c064c3...f4d875ee0033d43a527b5ba34636bb5fa36e8a30,2,97,86,183,26,2009-08-19 18:46:27,2009-08-19 18:46:27
9783eed68d7151681fd99cb136e7f1eef3c064c3...7681d53e0aff4d087009df1ddc15a7163a9e4e63,1,5,0,5,1,2009-08-19 18:02:03,2009-08-19 18:02:03
8ff9529512e12e4e6fc19fe715c568132d87c70a...1a09d3a722c858b087b391dfd08f4cc367202c5c,2,1,6,7,2,2009-08-19 19:42:18,2009-08-19 19:42:18
e88821d778f4b75bec78807844938fd55259d28e...11b657f18d3d5824eed845caa7c51bdb72e43f7b,1,8,0,8,1,2009-08-20 00:44:31,2009-08-19 22:32:46
11b657f18d3d5824eed845caa7c51bdb72e43f7b...45683d835df3b17832f29dac33f27bd7e4167136,2,11,0,11,2,2009-08-20 02:53:37,2009-08-20 02:34:13
45683d835df3b17832f29dac33f27bd7e4167136...7831db0d557a6464032a7181b524097208a25a05,1,2,0,2,2,2009-08-20 14:06:47,2009-08-20 14:06:47
7831db0d557a6464032a7181b524097208a25a05...b00247a8585c77215598cd0b6d72d76d94acc7c2,3,33,8,41,10,2009-08-20 19:00:25,2009-08-20 19:00:25
b00247a8585c77215598cd0b6d72d76d94acc7c2...c0994c6b3a6b9cab0bcda1d09fb55fbfc9f13b4f,1,0,2,2,1,2009-08-20 19:28:04,2009-08-20 19:28:04
7831db0d557a6464032a7181b524097208a25a05...f0a26f673b19778ace2682ecf04b2d36dd9f8c9e,1,3,1,4,2,2009-08-20 17:23:21,2009-08-20 17:23:21
c0994c6b3a6b9cab0bcda1d09fb55fbfc9f13b4f...7e0ffc751713b0b9358b975cbbc6ec12d41bf04b,1,1,1,2,1,2009-08-20 21:02:11,2009-08-20 21:02:11
20fc44edfbf8816c7d08f6ac3380d42706ca51bc...48f47865da8ab436ae1a6f2c10fdf7350085b216,1,39,39,78,5,2009-08-20 20:18:50,2009-08-20 20:18:50
48f47865da8ab436ae1a6f2c10fdf7350085b216...afae0919bbf43392c00a06a6c7c03bee4e1b7813,1,9,0,9,1,2009-08-20 20:50:23,2009-08-20 20:50:23
afae0919bbf43392c00a06a6c7c03bee4e1b7813...792c9ea3f714c74b2fef567b0bc5a57579db0642,6,47,2,49,9,2009-08-20 20:50:58,2009-08-20 20:50:58
280d239455d8df6b29d4afb096a77bf57839378b...6e8e7bd75c6e8589745ab70da2deb10be5ef3698,1,7,0,7,1,2009-08-21 00:51:59,2009-08-21 00:51:59
6e8e7bd75c6e8589745ab70da2deb10be5ef3698...1bc91420b391cedbb6c7eb417735e14d202434a1,2,10,5,15,3,2009-08-21 01:35:19,2009-08-21 01:35:19
1bc91420b391cedbb6c7eb417735e14d202434a1...e1928bfda516298dc4dfa1b2782458422cbc98c9,1,22,12,34,5,2009-08-21 05:36:41,2009-08-21 05:36:41
e1928bfda516298dc4dfa1b2782458422cbc98c9...33ac3c31c302b8cb04bd54232bb9f9f6565a1ca7,2,5,1,6,3,2009-08-21 19:17:58,2009-08-21 19:17:58
33ac3c31c302b8cb04bd54232bb9f9f6565a1ca7...1e1977a6989a0b45446cd75dd874eeacc4acefcb,1,9,3,12,1,2009-08-21 20:15:36,2009-08-21 20:15:36
1e1977a6989a0b45446cd75dd874eeacc4acefcb...a9dc788da113af1654525b05f827acfc09c8472c,1,5,0,5,1,2009-08-21 21:05:19,2009-08-21 21:05:19
a9dc788da113af1654525b05f827acfc09c8472c...4be8bfc8054131a7dc092ff09c7d05bde086ef3f,1,1,1,2,1,2009-08-21 21:05:29,2009-08-21 21:05:29
4be8bfc8054131a7dc092ff09c7d05bde086ef3f...93382dd24ebce3268417ee73bd015d102fedebea,1,10,1,11,2,2009-08-21 21:17:20,2009-08-21 21:17:20
93382dd24ebce3268417ee73bd015d102fedebea...32871651e60b31fd00d40cfa578f26db3ab40f55,1,26,0,26,1,2009-08-21 22:31:52,2009-08-21 22:31:52
32871651e60b31fd00d40cfa578f26db3ab40f55...b078f98360c7ce7f4699c8938cc4fd77d0e71b97,2,16,11,27,9,2009-08-24 03:33:17,2009-08-24 03:33:17
b078f98360c7ce7f4699c8938cc4fd77d0e71b97...fd2155d554acbe12da09c525be1da108ab1dcbfc,8,17,9,26,10,2009-08-24 14:10:11,2009-08-24 14:10:11
fd2155d554acbe12da09c525be1da108ab1dcbfc...42504fc904b751ba30948a38601e26bc95f5146c,1,10,2,12,1,2009-08-24 14:21:34,2009-08-24 14:21:34
42504fc904b751ba30948a38601e26bc95f5146c...f67e06ba64115e4128f92fb798f46607b1a62fb5,3,7,3,10,5,2009-08-24 15:42:15,2009-08-24 15:42:15
42504fc904b751ba30948a38601e26bc95f5146c...1681f080f05df5a04fc7228e66cf40494e345125,1,3,1,4,1,2009-08-24 15:07:44,2009-08-24 15:07:44
1681f080f05df5a04fc7228e66cf40494e345125...a2e000830f884d3be8938b87ffaf6b84a62e5a50,1,16,2,18,6,2009-08-24 15:54:06,2009-08-24 15:54:06
a2e000830f884d3be8938b87ffaf6b84a62e5a50...f5a8781aae72d1596b0270f107a8575359bce779,1,24,16,40,10,2009-08-24 15:54:44,2009-08-24 15:54:44
1e7ade52ac1260a7f2cea7356500eb39550d0944...1f08223ab7d07606bd980abd0b0a7f50cd99314f,2,4,3,7,3,2009-08-24 15:59:00,2009-08-24 15:59:00
1f08223ab7d07606bd980abd0b0a7f50cd99314f...b3e717fc3c2fe68da1508e45989ccd2ddbd1c822,2,2,2,4,2,2009-08-24 15:59:42,2009-08-24 15:59:42
b3e717fc3c2fe68da1508e45989ccd2ddbd1c822...dabf2ce54614c6de9d728af445eec47f39dde19f,2,2,2,4,2,2009-08-27 13:46:00,2009-08-27 13:46:00
dabf2ce54614c6de9d728af445eec47f39dde19f...afe21e02c11f9a923ab1c95edf6fdd95b9a4a51e,1,2,0,2,1,2009-08-27 15:53:01,2009-08-27 15:52:22
afe21e02c11f9a923ab1c95edf6fdd95b9a4a51e...1a4490dbba239189489c8630ad8da27a95cf0c2d,1,1,1,2,1,2009-08-28 14:17:32,2009-08-28 14:17:04
1a4490dbba239189489c8630ad8da27a95cf0c2d...8c29986cf7372fe8008675bbc42a83ecec32e226,1,7,2,9,2,2009-10-19 21:38:45,2009-10-05 20:39:49
8c29986cf7372fe8008675bbc42a83ecec32e226...5049bce6a0455ffb962067a8ee9adb2138139fcb,2,115,1,116,3,2009-10-20 13:53:03,2009-10-13 20:44:52
5049bce6a0455ffb962067a8ee9adb2138139fcb...f40cd45c178b9ae4be9f260127676ce38b776a72,2,4,4,8,2,2009-10-22 14:51:16,2009-10-22 14:51:16
f40cd45c178b9ae4be9f260127676ce38b776a72...1c04baf9442be8109d0c271fc259b0181c23c64d,1,1,1,2,1,2009-10-22 14:54:24,2009-10-22 14:54:24
1c04baf9442be8109d0c271fc259b0181c23c64d...e316c78bc3dcbd0729454b81eff4e172579c1bc0,1,0,23,23,2,2009-10-22 15:22:10,2009-10-22 15:22:10
e316c78bc3dcbd0729454b81eff4e172579c1bc0...6b748b2ccd5db6e60aaf1e3ede72a782ffa55dcd,1,3,1,4,1,2009-10-26 14:34:37,2009-09-21 14:40:25
6b748b2ccd5db6e60aaf1e3ede72a782ffa55dcd...a705bdb4ddf5f2222c8c45df34438c42ecafb09e,1,2,2,4,2,2009-12-06 05:36:48,2009-12-06 05:36:48
a705bdb4ddf5f2222c8c45df34438c42ecafb09e...57a6542753bed4a78d6bece5cb44143732b3e45e,2,42,0,42,3,2009-12-07 16:10:46,2009-12-07 16:10:46
57a6542753bed4a78d6bece5cb44143732b3e45e...736490eeeff60d6cd89bec9da063450db9a730bc,1,1,2,3,2,2009-12-07 16:11:04,2009-10-26 00:35:33
736490eeeff60d6cd89bec9da063450db9a730bc...ebf50d623ed3583181b68a8f825d9647ee0b4148,2,2,1,3,2,2009-12-07 16:13:09,2009-10-25 04:47:43
b3e717fc3c2fe68da1508e45989ccd2ddbd1c822...567c2bad85457043ec13db6c4db9b14c59898df2,1,1,1,2,1,2009-08-24 19:31:54,2009-08-24 19:31:54
567c2bad85457043ec13db6c4db9b14c59898df2...9c1d0e2313a97aae76f31818a7d4b123f3b83635,1,18,0,18,1,2009-08-24 19:32:13,2009-08-24 19:32:13
ebf50d623ed3583181b68a8f825d9647ee0b4148...9045c292fcd2c70df08b4210a7a82a48fe0422f8,1,1,1,2,1,2009-12-07 17:27:31,2009-12-07 17:27:31
ebf50d623ed3583181b68a8f825d9647ee0b4148...eafca06a884d075dc673d7d8b84dbc60ce312148,1,0,32,32,1,2009-12-07 16:54:01,2009-12-07 16:54:01
9c1d0e2313a97aae76f31818a7d4b123f3b83635...6c4a830e21aad7565be587a36f74fc252112ab47,1,3,2,5,3,2009-08-24 20:43:33,2009-08-24 20:43:33
9c1d0e2313a97aae76f31818a7d4b123f3b83635...9328ab884efc972127e71c2957968756eabca6b4,1,1,0,1,1,2009-08-24 20:35:20,2009-08-24 20:35:20
9328ab884efc972127e71c2957968756eabca6b4...9a0818a69dc1cec33e23f46e9dabc8805b0fd804,1,18,0,18,2,2009-08-24 21:13:15,2009-08-24 21:13:15
9a0818a69dc1cec33e23f46e9dabc8805b0fd804...336d5335670e994f6481798e5a9ff55681229207,1,1,1,2,1,2009-08-24 21:13:21,2009-08-24 21:13:21
47d7da12480365217b2886a4b3ff587d7f99692f...07b2685b464f946910d2536840ae54de78039d35,1,26,1,27,3,2009-08-25 03:37:12,2009-08-25 03:37:12
07b2685b464f946910d2536840ae54de78039d35...360dc900a0e45481b535662acb5fd9970eba55ab,1,29,0,29,2,2009-08-25 06:24:27,2009-08-25 06:24:27
360dc900a0e45481b535662acb5fd9970eba55ab...a93d9e392cdbd3e4afaef4986de97b4e06493948,1,52,0,52,2,2009-08-25 14:30:35,2009-08-25 14:30:35
360dc900a0e45481b535662acb5fd9970eba55ab...2706a281233e0cef00cc92437865269a057b0707,16,72,34,106,39,2009-08-25 14:24:44,2009-08-25 14:24:44
0a95fb0e7f67079039c9047f6df8f9d74bf71ff3...879e7b153ef93bc3ef121b86e7d8d20ad86818f8,7,31,38,69,29,2009-08-25 18:35:22,2009-08-25 18:35:22
0a95fb0e7f67079039c9047f6df8f9d74bf71ff3...f5d28ebb1b66560ced65c4a924201c06cd0e7199,2,30,17,47,8,2009-08-25 14:52:17,2009-08-25 14:52:17
f5d28ebb1b66560ced65c4a924201c06cd0e7199...76bf7fb38eda6ab03fed42ee4308cc188672f329,1,0,2,2,1,2009-08-25 15:09:20,2009-08-25 15:09:20
76bf7fb38eda6ab03fed42ee4308cc188672f329...db6fe8300cf07833d0ef83be26e596ea532fafe2,1,17,0,17,1,2009-08-25 15:49:30,2009-08-25 15:49:30
db6fe8300cf07833d0ef83be26e596ea532fafe2...5501d7c3bac1ec7ae274f4147fe89fb4d06fe449,1,1,1,2,1,2009-08-25 16:24:36,2009-08-25 16:24:36
5501d7c3bac1ec7ae274f4147fe89fb4d06fe449...d0a925b7e4d3fa2d630f6adb494b44b23c0621a6,1,6,7,13,5,2009-08-25 16:24:51,2009-08-25 16:24:51
d0a925b7e4d3fa2d630f6adb494b44b23c0621a6...efb43a15c15e349efaf6ee19cff7e0114baca254,1,55,2,57,6,2009-08-25 17:54:01,2009-08-25 17:54:01
f42a88c9a94b02ce34808f90b7d3f81a6943ca9d...6a8b0363d961a7803d08b893924276b12c9f7f32,8,101,102,203,15,2009-08-25 20:14:55,2009-08-25 20:14:55
efb43a15c15e349efaf6ee19cff7e0114baca254...39a40f8f42991854231516e695636d7d89a37f27,1,24,1,25,8,2009-08-25 20:11:51,2009-08-25 20:11:51
39a40f8f42991854231516e695636d7d89a37f27...e90c98587bf076547b6aa060d04501330bd2bfde,1,50,35,85,15,2009-08-25 21:00:01,2009-08-25 21:00:01
1922050637fb9e42b1043bb2a36fe95461179016...662f01eb15a3b3af5e4a7017d96decce586adb80,1,3,4,7,5,2009-08-25 21:22:00,2009-08-25 21:22:00
662f01eb15a3b3af5e4a7017d96decce586adb80...358b5e638c44a234a3d40f653e99f925bde852b6,1,2,0,2,2,2009-08-25 21:26:43,2009-08-25 21:26:43
358b5e638c44a234a3d40f653e99f925bde852b6...99b20a0b6b99c9070afe533a65dc1ec3cba4eea9,2,52,3,55,5,2009-08-25 22:07:30,2009-08-25 22:07:30
99b20a0b6b99c9070afe533a65dc1ec3cba4eea9...fa7fd75fc747087d67aff85afd20a5ee1348a022,1,16,0,16,1,2009-08-26 04:16:16,2009-08-26 04:16:16
fa7fd75fc747087d67aff85afd20a5ee1348a022...2226f3292bea19538b7988eb3af592b292d0cc69,2,2,2,4,2,2009-08-27 19:26:29,2009-08-27 19:26:29
fa7fd75fc747087d67aff85afd20a5ee1348a022...0dd45e1251a21a9feca5fef26c1755456e070a98,1,2,0,2,2,2009-08-26 14:22:23,2009-08-26 14:22:23
0dd45e1251a21a9feca5fef26c1755456e070a98...4e284815741092dd1f870026cf0166df36939712,1,1,1,2,1,2009-08-26 14:22:33,2009-08-26 14:22:33
4e284815741092dd1f870026cf0166df36939712...b219b209e09664975439c73e51a406889eac0edf,2,93,18,111,6,2009-08-26 14:22:55,2009-08-26 14:22:55
b219b209e09664975439c73e51a406889eac0edf...e88425081d79c3fd70e13cb1e568d1759fe3c171,1,4,4,8,2,2009-08-26 16:22:48,2009-08-26 16:22:48
e88425081d79c3fd70e13cb1e568d1759fe3c171...7c7be67a765be133f0660455cb6b3c5c76e64fe0,1,13,0,13,1,2009-08-26 18:12:13,2009-08-26 18:12:13
7c7be67a765be133f0660455cb6b3c5c76e64fe0...daef3873b7e35719988d4ed1c70ab7ff3c7da4cf,1,5,0,5,1,2009-08-26 19:13:58,2009-08-26 19:13:58
daef3873b7e35719988d4ed1c70ab7ff3c7da4cf...3def379b2151819aabfcef1a689034acf0dece57,1,8,8,16,2,2009-08-26 20:48:10,2009-08-26 20:48:10
3def379b2151819aabfcef1a689034acf0dece57...da81fa2fccb27e4b92091ef8f28414925ef5238c,2,10,0,10,2,2009-08-27 13:41:21,2009-08-27 13:41:21
da81fa2fccb27e4b92091ef8f28414925ef5238c...5a732ac0e2368fc64ea51fb85484d19f1b26f6f4,1,24,1,25,3,2009-08-27 13:41:56,2009-08-27 13:41:56
5a732ac0e2368fc64ea51fb85484d19f1b26f6f4...157df4a2ccce0b4d49e8996cb6f287fd58c8fcb6,1,5,1,6,4,2009-08-27 14:09:55,2009-08-27 14:09:55
157df4a2ccce0b4d49e8996cb6f287fd58c8fcb6...08fcfcb34c53065a8a367a37860dce6ee01e59a3,4,7,8,15,4,2009-08-27 14:19:58,2009-08-27 14:19:58
08fcfcb34c53065a8a367a37860dce6ee01e59a3...3a0c430aec28086f5441ae27963e30289ae46291,1,2,0,2,1,2009-08-27 15:52:22,2009-08-27 15:52:22
3a0c430aec28086f5441ae27963e30289ae46291...a94e73d41e2f788fe8b72d70666164bc07e6f098,2,2,2,4,2,2009-08-27 17:33:53,2009-08-27 17:33:53
a94e73d41e2f788fe8b72d70666164bc07e6f098...ccf5dc907c86eb413fea28409930089d9e1b28b9,1,3,1,4,1,2009-08-27 17:45:31,2009-08-27 17:45:31
58fa03169faf9af5e79477a2b77928bb5af16c95...8de1e62a37e509403275d0cae322d2f8c6d362c9,1,8,5,13,2,2009-09-01 14:31:12,2009-09-01 14:31:12
58fa03169faf9af5e79477a2b77928bb5af16c95...c0f769582f8dd2c8c626bbd985f128aba70cde87,1,1,1,2,1,2009-08-28 04:04:43,2009-08-28 04:04:43
c0f769582f8dd2c8c626bbd985f128aba70cde87...2069e630536a7c38a28831ebc62ba5963f632b19,1,1,1,2,1,2009-08-28 06:09:14,2009-08-28 06:09:14
2069e630536a7c38a28831ebc62ba5963f632b19...af2d29ca3008f098ccfea7199538e96ee0861218,1,1,1,2,1,2009-08-28 14:17:04,2009-08-28 14:17:04
af2d29ca3008f098ccfea7199538e96ee0861218...27299f6d78a709c6d51c6280c3fec8bd83b1f2a8,1,9,0,9,2,2009-08-28 15:14:26,2009-08-28 15:14:26
27299f6d78a709c6d51c6280c3fec8bd83b1f2a8...97d1bdbca6a1242a03bc9dc1b178633e34008a1d,1,1,0,1,1,2009-08-28 15:20:06,2009-08-28 15:20:06
97d1bdbca6a1242a03bc9dc1b178633e34008a1d...507261e3d0bd5be9202dd4086d439998ae847f7d,1,9,0,9,2,2009-08-28 15:31:11,2009-08-25 15:10:11
507261e3d0bd5be9202dd4086d439998ae847f7d...6f3e4cd65f9b8536d913151bfa1ba0ddbbe6f4a1,1,1,0,1,1,2009-08-28 15:31:19,2009-08-25 15:41:18
6f3e4cd65f9b8536d913151bfa1ba0ddbbe6f4a1...7a1a7fe021c9aea1087104c0eb1c54bdeda5ee8d,2,8,1,9,4,2009-08-28 15:50:20,2009-08-28 15:50:20
7a1a7fe021c9aea1087104c0eb1c54bdeda5ee8d...e277dffe544c4c55d49f725a430a99a605679132,3,3,7,10,6,2009-08-28 15:57:09,2009-08-28 15:57:09
e277dffe544c4c55d49f725a430a99a605679132...b21aa65beeda59bcf5e12425f62538b14e83b3c2,1,1,0,1,1,2009-08-28 15:58:38,2009-08-28 15:58:38
b21aa65beeda59bcf5e12425f62538b14e83b3c2...5799c79d78c7754c8eb6b6cb7d0e08c19188b4a6,1,3,0,3,1,2009-08-28 16:34:56,2009-08-28 16:34:56
5799c79d78c7754c8eb6b6cb7d0e08c19188b4a6...e5ea2392760e1e1f60549917f6cfabb1eba555e8,1,2,2,4,2,2009-08-28 16:35:16,2009-08-28 16:35:16
e5ea2392760e1e1f60549917f6cfabb1eba555e8...cd1fe6505a5c36a678b2f7c30cdb6ffdaea250a8,1,1,2,3,2,2009-08-28 17:26:23,2009-08-28 17:26:23
3dbc214789e241c42a8f1c2749462159e374d6cf...10fc6958709b017ca1c7db5f2f6ef44a84c3b25d,2,9,6,15,3,2009-09-01 20:03:23,2009-09-01 20:03:23
cd1fe6505a5c36a678b2f7c30cdb6ffdaea250a8...41d2f24171a1aeb7db1b45d5303cb73a2662583e,1,4,3,7,3,2009-08-28 17:35:08,2009-08-28 17:35:08
cd1fe6505a5c36a678b2f7c30cdb6ffdaea250a8...3c6ec5274ac780a63ca671df479c9b2384777042,5,110,6,116,19,2009-08-28 17:27:15,2009-08-28 17:27:15
777c1883c3d019e1318703eb324fa55dff325ad8...7172529835487de9dec84e03c5eea4c2d065a621,3,79,23,102,28,2009-09-01 20:23:56,2009-09-01 20:23:56
41d2f24171a1aeb7db1b45d5303cb73a2662583e...e7b6dab2030b49b0628e1280cdd9cf2678c5f3cf,1,1,1,2,1,2009-08-28 19:48:10,2009-08-28 19:48:10
41d2f24171a1aeb7db1b45d5303cb73a2662583e...0e69584eebeb88c41022cb5c8a4d22d8809ba121,3,70,111,181,11,2009-08-28 19:18:15,2009-08-28 19:18:15
e6efaa9b2035a5223ed48201ca34204b3901e546...b3e8ab81199f6c1e1800197d0573246b78502f36,2,9,10,19,9,2009-08-28 18:03:08,2009-08-28 18:03:08
b3e8ab81199f6c1e1800197d0573246b78502f36...7245d462e9c588ba722a92540645b431a11c3936,1,54,24,78,7,2009-08-28 18:22:29,2009-08-28 18:22:29
7245d462e9c588ba722a92540645b431a11c3936...5f898ab0007fa6379a6e328d20a5eed481798fbf,1,9,4,13,6,2009-08-28 19:06:09,2009-08-28 19:06:09
5f898ab0007fa6379a6e328d20a5eed481798fbf...13a01a4b482252312a1c49e57d6ae40fb471dfc2,1,7,15,22,2,2009-08-28 19:36:12,2009-08-28 19:36:12
e061b7d9dae9698c7ceaf2586316937d2792142e...46cbb8a6b2c42cc82626dc3acd6fc11db64a05bf,2,10,3,13,6,2009-08-28 20:35:09,2009-08-28 20:35:09
46cbb8a6b2c42cc82626dc3acd6fc11db64a05bf...82c3aaa3cadeabbf2de2899fec1828a05ac86127,1,1,1,2,1,2009-08-28 20:39:13,2009-08-28 20:39:13
82c3aaa3cadeabbf2de2899fec1828a05ac86127...ba0f9ce5acaba846a321053ef4f9d84b33cc38a0,1,5,4,9,1,2009-08-28 20:44:03,2009-08-28 20:44:03
ba0f9ce5acaba846a321053ef4f9d84b33cc38a0...3f1d5ad8d443909c7737d7a6c816965257b403d7,1,9,6,15,7,2009-08-28 20:56:34,2009-08-28 20:56:34
3f1d5ad8d443909c7737d7a6c816965257b403d7...cbf26c5b21756307d2e6f049eed7678eae25f636,1,14,7,21,6,2009-08-29 05:26:50,2009-08-29 05:26:50
644df81d2167628a7a9494a1953f981d148ebfbb...b2e5245396cd66085f937caebc0d68d234d1edcf,1,59,60,119,1,2009-09-09 13:38:43,2009-09-09 13:38:43
644df81d2167628a7a9494a1953f981d148ebfbb...4ea89d9bda4e43fb357580f3884882a95deb686f,1,10,0,10,1,2009-09-03 14:03:25,2009-09-03 14:03:25
4ea89d9bda4e43fb357580f3884882a95deb686f...11b7f5c53b8662ca6eba6e50a559940bfdd1ecf6,1,4,1,5,1,2009-09-03 14:34:31,2009-09-03 14:34:31
cbf26c5b21756307d2e6f049eed7678eae25f636...42eae6ab4cc205a2cb9e42b7f658827891a36737,1,3,3,6,2,2009-08-30 01:17:34,2009-08-30 01:17:34
cbf26c5b21756307d2e6f049eed7678eae25f636...5e31aa0f19e7da2d047c37741ecbfced60e93583,5,19,15,34,12,2009-08-29 19:08:22,2009-08-29 19:08:22
82f397f133cafe632fbc678448e42c0f8d3c46de...2470913c7012b3d14a013a88bee3ee405705bf59,3,40,38,78,5,2009-09-03 17:11:30,2009-09-03 17:11:30
109df8809d9cd6f74536dbc52ee9f7bece3f7f46...bc7eeba54e55fa964b65fb0be10dc439500f26d3,1,3,1,4,1,2009-08-30 03:49:53,2009-08-30 03:49:53
5e31aa0f19e7da2d047c37741ecbfced60e93583...59cf927de300abf14b28468d13690adc025d170f,1,8,7,15,3,2009-09-03 16:52:08,2009-09-03 16:52:08
5e31aa0f19e7da2d047c37741ecbfced60e93583...6d6f8d5bf72cd76375bc68c7f7dcd1ae79009be5,12,35,30,65,19,2009-08-30 15:22:58,2009-08-30 15:22:58
5e31aa0f19e7da2d047c37741ecbfced60e93583...17867af75bfd8214373d6c117157a37a23cfe64b,1,1,3,4,1,2009-08-30 01:13:11,2009-08-30 01:13:11
b860415ae2a09bb3f81c7c37478017f47b11fe0d...fcf361cb2ca13a55b68b99e9a7af9dea48e18a30,2,2,1,3,2,2009-09-09 20:28:59,2009-09-09 20:28:59
fcf361cb2ca13a55b68b99e9a7af9dea48e18a30...42a0e0f00e66217795466d37bd5f08b426995032,1,1,1,2,1,2009-09-09 20:38:52,2009-09-09 20:38:52
42a0e0f00e66217795466d37bd5f08b426995032...89d5e0fe452c0d9bbd21f8ff03fbb1a3c69ef765,2,12,0,12,2,2009-09-09 20:52:02,2009-09-09 20:52:02
89d5e0fe452c0d9bbd21f8ff03fbb1a3c69ef765...af13f83c61c0139f8bf773061643a59570abe956,2,21,13,34,2,2009-09-09 21:17:17,2009-09-09 21:17:17
af13f83c61c0139f8bf773061643a59570abe956...780d6dfe1106952278032e01c209e93b365afdd3,3,76,0,76,3,2009-09-09 21:33:27,2009-09-09 21:33:27
780d6dfe1106952278032e01c209e93b365afdd3...30d4cf6114b4eb8321b67baabf52a592d0d80014,1,4,0,4,1,2009-09-10 01:38:55,2009-09-10 01:38:55
30d4cf6114b4eb8321b67baabf52a592d0d80014...b9d61d202c7acebac58ce55c1da89f8e67dd29a7,3,62,2,64,6,2009-09-10 04:39:30,2009-09-10 04:39:30
b9d61d202c7acebac58ce55c1da89f8e67dd29a7...bbc07f85eca951f216ffba82cd15fa08f1d9e6e4,6,61,0,61,10,2009-09-10 14:36:11,2009-09-10 14:36:11
bbc07f85eca951f216ffba82cd15fa08f1d9e6e4...236f13cec5705f6027a47be7095d49331872ef07,1,1,1,2,1,2009-09-10 14:40:38,2009-09-10 14:40:38
236f13cec5705f6027a47be7095d49331872ef07...29548da4c4f2581d5537d56bfa30c3e4b0b6402e,1,1,0,1,1,2009-09-10 14:41:17,2009-09-10 14:41:17
2470913c7012b3d14a013a88bee3ee405705bf59...93f07dbc7dd0780966a8f9057274b22637e99bbd,2,18,8,26,10,2009-09-03 18:58:05,2009-09-03 18:58:05
2470913c7012b3d14a013a88bee3ee405705bf59...cf46ccabe432382af30adb450cf339730daea718,1,13,7,20,4,2009-09-03 17:37:20,2009-09-03 17:37:20
436f29bf1cf4ea59e1d69644696394a70fc0be78...7a3868c91a3160f98149d484918eba4010ddb479,1,1,1,2,1,2009-08-30 21:05:51,2009-08-30 21:05:51
7a3868c91a3160f98149d484918eba4010ddb479...467b9c1028045d6e9617c04dff5346af650b6a38,2,2,2,4,2,2009-08-31 15:21:44,2009-08-31 15:21:44
467b9c1028045d6e9617c04dff5346af650b6a38...d4b7c8a525637599556f676325188464578e89aa,1,16,0,16,2,2009-08-31 15:22:40,2009-08-31 15:22:40
d4b7c8a525637599556f676325188464578e89aa...c3984ceaba6d55d819aa0a8351400e2a3cc64188,1,1,1,2,2,2009-08-31 17:20:48,2009-08-31 17:20:48
c3984ceaba6d55d819aa0a8351400e2a3cc64188...bcafeaa12d278a7872d6aec854c715d79232b371,1,17,2,19,4,2009-08-31 18:56:49,2009-08-31 18:56:49
bcafeaa12d278a7872d6aec854c715d79232b371...72d68a4ffdad3d8389cf69968d8a13f36be3789a,1,20,5,25,6,2009-08-31 19:38:43,2009-08-31 19:38:43
72d68a4ffdad3d8389cf69968d8a13f36be3789a...75e16447a430f6c3a4010b74bc7075b7031ff58c,15,221,231,452,154,2009-08-31 20:31:50,2009-08-31 20:31:50
29548da4c4f2581d5537d56bfa30c3e4b0b6402e...7910e29912cf0e85b04377632ec74e50fa09c031,1,7,7,14,3,2009-09-10 17:03:24,2009-09-10 17:03:24
29548da4c4f2581d5537d56bfa30c3e4b0b6402e...64a1af2b42ff879a7ac853796e23c95d87d29713,1,4,3,7,3,2009-09-10 15:01:37,2009-09-10 15:01:37
e58c6eaf7f8d4f1d8ffe668f1f9c0408fbc46205...b8d458bfec8d5e896739d595a59128e1b40a2bd3,1,14,14,28,8,2009-09-03 19:16:04,2009-09-03 19:16:04
cf46ccabe432382af30adb450cf339730daea718...6bf502094539906bc576e7363f126257be30f37a,1,2,1,3,2,2009-09-03 18:30:39,2009-09-03 18:30:39
75e16447a430f6c3a4010b74bc7075b7031ff58c...bcd665877bd0e604241c871640ff3b65f1b328a5,14,75,75,150,64,2009-09-01 15:09:43,2009-09-01 15:09:43
bcd665877bd0e604241c871640ff3b65f1b328a5...3ee681be363bb9f8b43496c22a947b10e8e18a80,16,105,98,203,89,2009-09-01 16:17:41,2009-09-01 16:17:41
3ee681be363bb9f8b43496c22a947b10e8e18a80...81bfbb9faad028c9e479b92c2a06733189801e2f,1,8,0,8,2,2009-09-01 17:50:08,2009-09-01 17:50:08
81bfbb9faad028c9e479b92c2a06733189801e2f...870972f4a9fe132690747bf182adb64d955fd8f4,1,2,0,2,1,2009-09-01 17:50:54,2009-09-01 17:50:54
870972f4a9fe132690747bf182adb64d955fd8f4...7ac635188e82e40ea08e40eb1a0f312df1cb9710,2,15,0,15,2,2009-09-01 18:06:50,2009-09-01 18:06:50
7ac635188e82e40ea08e40eb1a0f312df1cb9710...7e03b602ecf97eeaa61246de9fb6e5e2119d084d,1,1,1,2,1,2009-09-01 18:07:47,2009-09-01 18:07:47
7e03b602ecf97eeaa61246de9fb6e5e2119d084d...184870bf95a09ae696d0c1e2326d5145186b1170,1,14,9,23,10,2009-09-01 18:23:36,2009-09-01 18:23:36
f496a2e2d83bcc8634aaec3f2b298c396f4a9f06...47a7238303990fbd9ebf8834d8abd2b7fc50fe72,1,11,1,12,4,2009-09-10 17:09:26,2009-09-10 17:09:26
7d20a98cc1023bef1ad701808bd04126ceb1ffeb...222e767340ff1ec0bfd34a46213368db9d478aeb,1,1,1,2,1,2009-09-03 18:40:08,2009-09-03 18:40:08
222e767340ff1ec0bfd34a46213368db9d478aeb...66072780c042948026175ce1ba2d699f0fd9a75b,1,1,1,2,1,2009-09-03 18:48:47,2009-09-03 18:48:47
66072780c042948026175ce1ba2d699f0fd9a75b...08489a2b4279b2433603942648b9e437e97f7cfc,7,51,17,68,19,2009-09-03 20:48:34,2009-09-03 20:48:34
08489a2b4279b2433603942648b9e437e97f7cfc...6adeb370121ba2e0dd06104c933c361072b970c2,3,65,4,69,7,2009-09-03 21:19:32,2009-09-03 21:19:32
6adeb370121ba2e0dd06104c933c361072b970c2...467dc24e823af05e12c8584ebce211c07f7b064d,1,28,15,43,4,2009-09-04 14:24:32,2009-09-04 14:24:32
467dc24e823af05e12c8584ebce211c07f7b064d...c53e909cedbf306293ab8ef3ca6b9e082f7e2529,11,50,13,63,15,2009-09-04 15:00:43,2009-09-04 15:00:43
c53e909cedbf306293ab8ef3ca6b9e082f7e2529...fce76595ff5b617842f14aa611b121449c19248e,1,4,0,4,1,2009-09-04 15:05:06,2009-09-04 15:05:06
184870bf95a09ae696d0c1e2326d5145186b1170...7c11076e7334c6420d33f9d442f7eb3ddba4f4d4,3,50,0,50,4,2009-09-01 19:59:19,2009-09-01 19:59:19
7c11076e7334c6420d33f9d442f7eb3ddba4f4d4...cff5abd2f140e73455c469d7242a55882650785b,5,76,15,91,14,2009-09-01 20:30:20,2009-09-01 20:30:20
184870bf95a09ae696d0c1e2326d5145186b1170...2df6ddd566a0549e982e902aa69653efcc6e8bb6,1,8,8,16,8,2009-09-01 19:43:23,2009-09-01 19:43:23
2df6ddd566a0549e982e902aa69653efcc6e8bb6...fd2a19c1bc9003a5bd7663f5e790316d9d50d6fa,1,11,5,16,1,2009-09-01 19:51:17,2009-09-01 19:51:17
fd2a19c1bc9003a5bd7663f5e790316d9d50d6fa...0bbc36fae38cfb77b2de3ced4615e91bc7d564ae,2,14,14,28,12,2009-09-01 19:53:31,2009-09-01 19:53:31
0bbc36fae38cfb77b2de3ced4615e91bc7d564ae...71f76d998c2068a0bba2704c23fd085b4a6636bc,3,23,6,29,12,2009-09-01 20:27:08,2009-09-01 20:27:08
47a7238303990fbd9ebf8834d8abd2b7fc50fe72...1bdc3762c60f6ea73b2cbfedbf94851b75b40603,3,23,1,24,7,2009-09-11 14:58:59,2009-09-11 14:58:59
1bdc3762c60f6ea73b2cbfedbf94851b75b40603...8b83d8ad5f60536bd1f42f774d8d80513d0d329c,1,0,3,3,2,2009-09-11 15:00:03,2009-09-11 15:00:03
47a7238303990fbd9ebf8834d8abd2b7fc50fe72...cbb58275d2c68845ba1cce082b1949fb034c33fa,4,26,3,29,5,2009-09-10 19:45:31,2009-09-10 19:45:31
cbb58275d2c68845ba1cce082b1949fb034c33fa...6d173203500cd2bb38dba393d83130c63fda229f,1,32,5,37,7,2009-09-10 20:21:55,2009-09-10 20:21:55
6d173203500cd2bb38dba393d83130c63fda229f...17dcc317cd624062ed822b90a335f9a5f6c4bec1,1,1,0,1,1,2009-09-10 20:25:24,2009-09-10 20:25:24
17dcc317cd624062ed822b90a335f9a5f6c4bec1...be79e2aecc2b414286fe0446ce253d86be09136c,1,1,1,2,1,2009-09-10 21:15:37,2009-09-10 21:15:37
fce76595ff5b617842f14aa611b121449c19248e...43f7916bf674e38c0ec97d1e13e65c2ba7e013c3,2,1,0,1,1,2009-09-09 13:42:05,2009-09-09 13:42:05
fce76595ff5b617842f14aa611b121449c19248e...a39590a895cb45ac7a5313ac3a5cb83a64003c19,1,41,0,41,1,2009-09-06 04:08:25,2009-09-06 04:08:25
562564d8f4daa24fdcc859662355c226fe92c0a3...6281fe4ee7d418db2c0824e47c210afc5240b4e8,2,3,2,5,3,2009-09-01 21:08:57,2009-09-01 21:08:57
6281fe4ee7d418db2c0824e47c210afc5240b4e8...e8d20f47ac78cdc39ec10320adcba2b694fdb0a6,2,6,3,9,3,2009-09-01 21:28:15,2009-09-01 21:28:15
e8d20f47ac78cdc39ec10320adcba2b694fdb0a6...1b344adf4bb6a42351f060fa28152093487c1a13,2,22,0,22,2,2009-09-01 21:28:58,2009-09-01 21:28:58
71f76d998c2068a0bba2704c23fd085b4a6636bc...4cc0e1183486880c9d37f6cb25f8080e25d58ed7,1,20,2,22,5,2009-09-01 20:52:50,2009-09-01 20:52:50
fd36a649d01304d26ecb67eb818dcb8340cf4d73...378356ccbc018369fa7da6712ffd2091215f6a33,3,139,3,142,9,2009-09-11 15:56:57,2009-09-11 15:56:57
378356ccbc018369fa7da6712ffd2091215f6a33...73329a93a05648b46af5f54c2391579f60abfe99,4,67,8,75,12,2009-09-11 16:52:17,2009-09-11 16:52:17
73329a93a05648b46af5f54c2391579f60abfe99...fdc8d61ba3fe3afabb086078ea405196d1b0a1c8,1,1,1,2,1,2009-09-11 17:23:22,2009-09-11 17:23:22
fdc8d61ba3fe3afabb086078ea405196d1b0a1c8...6d48c898513988d4e69fef26c00fce76f8cb9f8b,1,0,23,23,1,2009-09-11 17:23:30,2009-09-11 17:23:30
45f6a97f0478bc6773ad1ae1ed929ad6e63b45c5...3315fba0bbfc8aab177e4e677e75b2d242e4bd02,2,120,2,122,5,2009-09-09 13:46:12,2009-09-09 13:46:12
3315fba0bbfc8aab177e4e677e75b2d242e4bd02...b6ce3c150b65a2170ec9716ff7f0ce49a9c007ce,1,10,4,14,2,2009-09-09 13:48:08,2009-09-09 13:48:08
b6ce3c150b65a2170ec9716ff7f0ce49a9c007ce...4e225bb3039183365a121abbf621bbeccbd0e972,1,46,0,46,2,2009-09-09 13:48:37,2009-09-09 13:48:37
4e225bb3039183365a121abbf621bbeccbd0e972...e9e472c119eeb3f24f58ebe4bf45548f1b18f9ed,1,129,97,226,11,2009-09-09 13:49:27,2009-09-09 13:49:27
e9e472c119eeb3f24f58ebe4bf45548f1b18f9ed...f3a27aaa7ead5e2e52b66b101dd9e6ad4e77b58e,1,1,1,2,1,2009-09-09 14:58:59,2009-09-09 14:58:59
f3a27aaa7ead5e2e52b66b101dd9e6ad4e77b58e...927078af784a2867e9851367b8e0975c3c024e29,4,58,15,73,17,2009-09-09 15:51:23,2009-09-09 15:51:23
927078af784a2867e9851367b8e0975c3c024e29...0cb4b01795614185bcc308d64cf282181d3a0a5e,3,71,12,83,6,2009-09-09 16:25:02,2009-09-09 16:25:02
0cb4b01795614185bcc308d64cf282181d3a0a5e...be97ce47b9825bd08f651879016a0b9c72b33936,1,1,3,4,1,2009-09-09 17:02:41,2009-09-09 17:02:41
be97ce47b9825bd08f651879016a0b9c72b33936...0d399715acf363324df9f6b9bdfa09219900cf73,2,0,4,4,2,2009-09-09 17:38:58,2009-09-09 17:38:58
0d399715acf363324df9f6b9bdfa09219900cf73...61390f8aea1c173871c8212dbab8d06b67f1b1d5,1,1,1,2,1,2009-09-09 17:39:16,2009-09-09 17:39:16
a39590a895cb45ac7a5313ac3a5cb83a64003c19...f222e44e1a4990f7492767b8c9ed878e8b8ca94e,2,23,0,23,2,2009-09-07 15:14:48,2009-09-07 15:14:48
f222e44e1a4990f7492767b8c9ed878e8b8ca94e...0cd6749deac9e0612dd34fe525187daee0f27168,1,1,0,1,1,2009-09-07 15:16:52,2009-09-07 15:16:52
a39590a895cb45ac7a5313ac3a5cb83a64003c19...8cda321b303cffee0ca1663dde71cd83f321cfc9,1,6,0,6,1,2009-09-07 03:16:08,2009-08-18 12:37:25
8cda321b303cffee0ca1663dde71cd83f321cfc9...9e2852976106f3b4eaa454bf0273b3bb32b4a073,3,65,29,94,13,2009-09-07 03:24:09,2009-08-18 14:19:27
9e2852976106f3b4eaa454bf0273b3bb32b4a073...61c65a1bce561d508010d41a4dc2544d2c0bf228,1,1,1,2,1,2009-09-07 03:25:57,2009-08-18 14:34:19
61c65a1bce561d508010d41a4dc2544d2c0bf228...b4ed11064c52731288a8e5e38d7e61319bf6bf39,4,83,66,149,28,2009-09-07 03:34:28,2009-08-18 15:59:40
b4ed11064c52731288a8e5e38d7e61319bf6bf39...02f48f89d13ad5046b365385bc74e159a3d3583a,2,3,3,6,3,2009-09-07 04:04:10,2009-09-07 04:04:10
02f48f89d13ad5046b365385bc74e159a3d3583a...05b8207cc0dd1a04bba5d82bffdd60cad94d51d6,3,34,9,43,7,2009-09-07 17:39:32,2009-09-07 17:39:32
6d48c898513988d4e69fef26c00fce76f8cb9f8b...48797ed11874594d2accdfaf50f28663d9edc028,2,16,0,16,2,2009-09-11 18:16:54,2009-09-11 18:16:54
48797ed11874594d2accdfaf50f28663d9edc028...ff495b5b73ee6eb46f8cd06600fd99b4566db00e,1,0,1,1,1,2009-09-11 20:10:38,2009-09-11 20:10:38
ff495b5b73ee6eb46f8cd06600fd99b4566db00e...4040d9799f1190f711313f6fa725ec9878226eec,2,25,2,27,7,2009-09-11 20:10:48,2009-09-11 20:10:48
4040d9799f1190f711313f6fa725ec9878226eec...1811d1e47f8894935b9c8f4f3bc004cf86b5f2b0,1,4,1,5,1,2009-09-11 20:11:00,2009-09-11 20:11:00
1811d1e47f8894935b9c8f4f3bc004cf86b5f2b0...335d92c443e23df5912f31f6310b8dbb5b23fda3,8,79,35,114,21,2009-09-11 20:14:14,2009-09-11 20:14:14
6d48c898513988d4e69fef26c00fce76f8cb9f8b...eae40d3e625abfa71b1828fa0a01960f98788c22,1,4,3,7,1,2009-09-11 18:14:31,2009-09-11 18:14:31
eae40d3e625abfa71b1828fa0a01960f98788c22...bf5faae277a4d9549ba4a3e19c6aed4c157e383f,2,31,31,62,30,2009-09-11 18:15:28,2009-09-11 18:15:28
bf5faae277a4d9549ba4a3e19c6aed4c157e383f...c03fe0d5c592a72b9be4404297c6404422529ccb,1,2,2,4,2,2009-09-11 18:33:10,2009-09-11 18:33:10
2b14dc6134cb210a417246b0aa6916ebe21b29b5...6840c4e03ad59f648d70baeddf7e9cbaae871d61,8,72,39,111,21,2009-09-07 18:44:41,2009-09-07 18:44:41
6840c4e03ad59f648d70baeddf7e9cbaae871d61...da4030319659ba6fb2bf489d78bcc6f7693188b2,2,16,12,28,7,2009-09-07 20:19:10,2009-09-07 20:19:10
da4030319659ba6fb2bf489d78bcc6f7693188b2...4a7330fd229cbaa43c4224c23a5f2383f5d5c75f,3,120,6,126,6,2009-09-07 20:49:22,2009-09-07 20:49:22
4a7330fd229cbaa43c4224c23a5f2383f5d5c75f...04c9565d4d28da0dce9247f0041fae9e5b7956e2,1,36,0,36,2,2009-09-07 21:19:41,2009-09-07 21:19:41
04c9565d4d28da0dce9247f0041fae9e5b7956e2...f65aff4734d431c8ef154be00eada01386cbe8a8,1,24,10,34,14,2009-09-08 02:51:51,2009-09-08 02:51:51
f65aff4734d431c8ef154be00eada01386cbe8a8...1f69aa1f1bd05dba49df19ecc14acdeb14810f8a,1,4,6,10,2,2009-09-08 03:44:12,2009-09-08 03:44:12
1f69aa1f1bd05dba49df19ecc14acdeb14810f8a...c2d331fc5f27eb33c2f69205d13ab7120b960f36,2,36,3,39,5,2009-09-08 19:20:21,2009-09-08 19:20:21
96a5d76821ef9b41d44ad13a1709447c81c341d1...d331919eb32148623ed74726c6e7b33607fd7c0c,2,87,0,87,3,2009-09-12 17:01:34,2009-09-12 17:01:34
d331919eb32148623ed74726c6e7b33607fd7c0c...8d07d50c48f76617b1a43d9e96efd47c890f6e8e,1,5,4,9,2,2009-09-13 10:58:00,2009-09-13 10:58:00
8d07d50c48f76617b1a43d9e96efd47c890f6e8e...68c24f3595b3c7e97dc51c12b352b41fd7f4ac34,2,11,2,13,4,2009-09-14 16:31:47,2009-09-14 16:31:47
8d07d50c48f76617b1a43d9e96efd47c890f6e8e...6d95f3cd1c95f939f6be053df38d2b43ad709676,2,16,1,17,5,2009-09-14 15:33:20,2009-09-14 15:33:20
6d95f3cd1c95f939f6be053df38d2b43ad709676...4df046f5b07673be1071f9041f08788111a0ccaa,2,6,0,6,2,2009-09-14 15:33:35,2009-09-14 15:33:35
4df046f5b07673be1071f9041f08788111a0ccaa...3b5b0caee9acb94f1a5266587213163945cc44a5,5,191,9,200,14,2009-09-14 15:33:42,2009-09-14 15:33:42
3b5b0caee9acb94f1a5266587213163945cc44a5...11ee78fc03529dde9b47405db65b1148738e33f4,3,13,2,15,5,2009-09-14 18:31:46,2009-09-14 18:31:46
11ee78fc03529dde9b47405db65b1148738e33f4...9bfcbbb34359e972d29a64d3e3f2c62b15308025,1,20,1,21,11,2009-09-14 18:32:04,2009-09-14 18:32:04
9bfcbbb34359e972d29a64d3e3f2c62b15308025...78bfd73520116e583a0682205cc9c3496bd47e33,6,19,6,25,15,2009-09-14 18:32:24,2009-09-14 18:32:24
78bfd73520116e583a0682205cc9c3496bd47e33...b7a242602ab0c37ec54ef027451f5f95b47f3e47,2,2,2,4,2,2009-09-14 20:13:47,2009-09-14 20:13:47
b21aea9c7f9fbac8943da4ffa68b51a5d3e6ad06...3972446b763a9476bc0cc1684882bee7f87ecb9b,1,14,9,23,2,2009-09-16 00:06:19,2009-09-16 00:06:19
b21aea9c7f9fbac8943da4ffa68b51a5d3e6ad06...2cab899cb427f38b2955024a88da8496bb4c827e,2,2,2,4,2,2009-09-15 06:43:53,2009-09-15 06:43:53
b7a242602ab0c37ec54ef027451f5f95b47f3e47...5d1efbd21e3ee6fbe4e946f676e099776a39d45e,2,15,1,16,6,2009-09-15 15:35:14,2009-09-15 15:35:14
5eba0ccf7c9887d5726032f0091c0391677dbb1f...fc6ecf760db5c8665c17a7ea99ee58bd52eaa16f,1,4,1,5,2,2009-09-16 03:11:17,2009-09-16 03:11:17
c566bf6016cbd211ca1805114bc59f07ba9a60a9...bde9da79b6b6900615d6e753bc4cacd1044e1ea6,3,180,180,360,137,2009-09-15 16:13:47,2009-09-14 20:55:57
bde9da79b6b6900615d6e753bc4cacd1044e1ea6...163db429542ae1a9598dafc19a21c111f0cacd06,1,17,0,17,2,2009-09-15 16:14:00,2009-09-15 15:10:06
163db429542ae1a9598dafc19a21c111f0cacd06...d78655dcf743b69ce278de4df7bcc3e1e2944825,1,8,2,10,4,2009-09-15 16:14:00,2009-09-15 15:44:30
d78655dcf743b69ce278de4df7bcc3e1e2944825...94f07156f71a8771b1da2e2772a2f1cab33cc774,2,36,13,49,13,2009-09-15 16:14:00,2009-09-15 16:00:41
94f07156f71a8771b1da2e2772a2f1cab33cc774...265af2d1f9c438903d23569e250bd5f54d354212,1,34,22,56,10,2009-09-15 17:48:26,2009-09-15 17:48:26
265af2d1f9c438903d23569e250bd5f54d354212...5ee8961f40ed47907e14c613f640036100385346,1,13,2,15,3,2009-09-15 18:02:39,2009-09-15 18:02:39
5ee8961f40ed47907e14c613f640036100385346...46e92266684e29cbef6f458054bff07951c0b605,2,33,12,45,7,2009-09-15 18:19:54,2009-09-15 18:19:54
46e92266684e29cbef6f458054bff07951c0b605...0c0a3893e430073c23a63db8df05242ca75b6050,2,22,2,24,4,2009-09-15 18:50:17,2009-09-15 18:50:17
0c0a3893e430073c23a63db8df05242ca75b6050...10f8eb1d9c32925f79a5636753516ba26b02a321,1,2,2,4,2,2009-09-15 18:51:30,2009-09-15 18:51:30
10f8eb1d9c32925f79a5636753516ba26b02a321...b754cb28082885324bb8011d84591ce8c1b1f316,3,29,5,34,11,2009-09-15 19:10:54,2009-09-15 19:10:54
b754cb28082885324bb8011d84591ce8c1b1f316...adeafb1d49ac5cea51dc88318d35b899b025fa2c,1,7,3,10,3,2009-09-15 21:03:03,2009-09-15 17:26:08
adeafb1d49ac5cea51dc88318d35b899b025fa2c...76c4935a58898abf681a6847a4c731ddc68442dd,1,35,15,50,14,2009-09-15 21:03:03,2009-09-15 21:02:12
76c4935a58898abf681a6847a4c731ddc68442dd...668d26b514126e2cdaf5b1c8b258c845b293feab,1,1,1,2,1,2009-09-16 00:17:54,2009-09-16 00:17:54
668d26b514126e2cdaf5b1c8b258c845b293feab...4d63454bc6e4cadd27ecebcb642ef8b0c292596f,1,11,0,11,2,2009-09-16 01:09:56,2009-09-16 01:09:56
4d63454bc6e4cadd27ecebcb642ef8b0c292596f...d5b26ce6b5682d9191fa44dcbc77e77f7633a246,2,25,0,25,2,2009-09-16 01:10:07,2009-09-16 01:10:07
d5b26ce6b5682d9191fa44dcbc77e77f7633a246...03404026b9cb3174905b0114dc73fc9264a8c741,4,416,1,417,6,2009-09-16 19:26:18,2009-09-16 19:26:18
03404026b9cb3174905b0114dc73fc9264a8c741...f2d24ba5d871eacc0ac933ab7390efef9a9f248d,1,2,2,4,2,2009-09-16 19:34:38,2009-09-16 19:34:38
f2d24ba5d871eacc0ac933ab7390efef9a9f248d...e6333cafc56cee1535f50ab35e67d429a4b4fa71,1,9,9,18,5,2009-09-16 19:42:26,2009-09-16 19:42:26
e6333cafc56cee1535f50ab35e67d429a4b4fa71...7d88c583cfeb2a69c945c7d87add3dff98efec3c,1,3,3,6,1,2009-09-16 19:42:42,2009-09-16 19:42:42
7d88c583cfeb2a69c945c7d87add3dff98efec3c...e8d152d762d9665411c3badab3a8b665dab20a79,1,3,1,4,2,2009-09-16 19:44:19,2009-09-16 19:44:19
e8d152d762d9665411c3badab3a8b665dab20a79...c70696f7a302df507f0038563d9a149601fdd949,2,49,49,98,2,2009-09-16 19:46:41,2009-09-16 19:46:41
c70696f7a302df507f0038563d9a149601fdd949...5738f9158dc85c61426aa0afde340f1260ad3e69,1,1,1,2,1,2009-09-16 20:01:07,2009-09-16 20:01:07
5738f9158dc85c61426aa0afde340f1260ad3e69...0ec495c2eb1d027389c23988c6880eab4fa7936f,1,4,1,5,1,2009-09-17 01:05:10,2009-09-17 01:05:10
0ec495c2eb1d027389c23988c6880eab4fa7936f...4a8c39140ba731efb5ca0bdb0c3521627b9f2469,2,3,3,6,2,2009-09-17 03:56:40,2009-09-16 05:05:47
4a8c39140ba731efb5ca0bdb0c3521627b9f2469...e5a3d001a692a39b107013c8dd4fb91c762a99f7,1,12,5,17,1,2009-09-17 15:01:12,2009-09-17 05:03:30
e5a3d001a692a39b107013c8dd4fb91c762a99f7...cf3f4ceca808a45785cfd73ec293df756b635a31,2,62,2,64,5,2009-09-17 15:01:15,2009-09-17 05:09:11
cf3f4ceca808a45785cfd73ec293df756b635a31...18b1091e01df79d6412e25d63f850735b952bd9e,1,6,2,8,2,2009-09-17 19:19:57,2009-09-17 19:19:57
18b1091e01df79d6412e25d63f850735b952bd9e...926eecc0cea878180d875b247aeedbc147fb710b,3,7,5,12,5,2009-09-18 17:28:40,2009-09-18 17:28:40
18b1091e01df79d6412e25d63f850735b952bd9e...34e48aaf5d1a626c3d114d88bab11d2e0921770e,19,457,130,587,57,2009-09-17 21:23:38,2009-09-17 21:23:38
34e48aaf5d1a626c3d114d88bab11d2e0921770e...d1831bf6a9a1d75c07698994042789fc5d1a4f26,1,1,14,15,2,2009-09-17 21:44:46,2009-09-17 21:44:46
d1831bf6a9a1d75c07698994042789fc5d1a4f26...44fabaec401181bb6070648c880056a7b021d442,3,0,36,36,3,2009-09-17 22:11:33,2009-09-17 22:11:33
44fabaec401181bb6070648c880056a7b021d442...dfdfb74a57016600b906c4d924029f5c4699de38,1,3,1,4,2,2009-09-18 02:00:58,2009-09-18 02:00:58
dfdfb74a57016600b906c4d924029f5c4699de38...9780f3092b519fa93da3e5da9133bb43d23ac66f,2,9,1,10,2,2009-09-18 05:26:09,2009-09-18 05:26:09
696f6ca986f6db7e63061d357d4d2fae85a87099...e86a0840aa778dad33bf82e125b911526627173e,2,46,46,92,46,2009-09-18 17:55:58,2009-09-18 17:10:07
e86a0840aa778dad33bf82e125b911526627173e...5919abfdc8e4f1438942fcecf5864e64159529c6,1,60,64,124,13,2009-09-18 17:55:58,2009-09-18 17:15:16
5919abfdc8e4f1438942fcecf5864e64159529c6...8f1e6bb3bfe235090e9641246cb6be9923c1a7b9,3,75,65,140,13,2009-09-18 17:55:58,2009-09-18 16:14:48
9780f3092b519fa93da3e5da9133bb43d23ac66f...88795bc740aee754bd122556846d96e3667f18e8,1,1,1,2,1,2009-09-18 18:20:44,2009-09-18 18:20:44
4017c53db0b40c6fe307db33f98387b0ee0fdd1f...bce82d19194cf21cf69833d89ce8be30dc873e72,2,16,11,27,6,2009-09-26 08:18:39,2009-09-26 08:18:39
8f1e6bb3bfe235090e9641246cb6be9923c1a7b9...35e2907814e53c9b6973c8cb59f40155f3ad9a13,1,4,0,4,2,2009-09-18 18:24:10,2009-09-18 18:24:10
35e2907814e53c9b6973c8cb59f40155f3ad9a13...53e89efce68e40fb920be3136155fb05acb300e7,2,153,153,306,133,2009-09-18 18:25:23,2009-09-18 18:25:23
53e89efce68e40fb920be3136155fb05acb300e7...a2261b1eb6f6b160d6d86380bc53f957e5bacc86,2,2,2,4,2,2009-09-18 18:26:15,2009-09-18 18:26:15
4e5795550c25028ed4275f03d5ce411dfb46238c...5d08c9eb22d3035ef104508a81bbe4ff0af94db2,2,35,42,77,25,2009-09-18 18:33:21,2009-09-18 18:33:21
20616d0565d47433b723501ef90144e7e9675770...5f75cfe408af147b1553df2f34ce3b50c6c8dc38,1,7,6,13,6,2009-09-27 03:47:01,2009-09-27 03:47:01
5f75cfe408af147b1553df2f34ce3b50c6c8dc38...4c364cb946b988c3eb8567409d18b7e5f378d4af,2,37,28,65,22,2009-09-27 03:47:08,2009-09-27 03:47:08
4c364cb946b988c3eb8567409d18b7e5f378d4af...a045dcf6afed88a5c226f0e0c87250df34ef8a05,1,6,0,6,1,2009-09-27 03:52:17,2009-09-27 03:52:17
a045dcf6afed88a5c226f0e0c87250df34ef8a05...5de6107490d00e7737dc78b8e15b515d0bb9df5d,1,2,0,2,1,2009-09-27 12:53:20,2009-09-27 12:53:20
5de6107490d00e7737dc78b8e15b515d0bb9df5d...29ec5bf837b2e8796112744c1ccdc7c76182bdda,4,37,29,66,14,2009-09-27 18:46:51,2009-09-27 18:46:51
29ec5bf837b2e8796112744c1ccdc7c76182bdda...4a4f5970122ee5d8ebad0678b00258e6f144852a,1,1,1,2,1,2009-09-27 18:49:09,2009-09-27 18:49:09
a2261b1eb6f6b160d6d86380bc53f957e5bacc86...b5ff48d649c4f9868f3f8c8a69d96059060dfae6,1,30,30,60,19,2009-09-18 18:32:25,2009-09-18 18:32:25
b5ff48d649c4f9868f3f8c8a69d96059060dfae6...c2b2e916bfe1554b27f036b993e21ab670f92b68,1,5,4,9,2,2009-09-18 18:37:31,2009-09-18 18:37:31
4a4f5970122ee5d8ebad0678b00258e6f144852a...1fd038c699ed16e70671c55b72683a6a4ef17961,1,1,1,2,1,2009-10-10 14:14:28,2009-10-10 14:14:28
4a4f5970122ee5d8ebad0678b00258e6f144852a...bda5802b46f286abac87a3341d1d1ef5d91aa412,1,58,1,59,3,2009-09-29 13:53:54,2009-09-29 13:53:54
bda5802b46f286abac87a3341d1d1ef5d91aa412...9641489751689f6dd58637fe8e00075ff7f2ecea,1,4,0,4,1,2009-09-29 14:14:54,2009-09-29 14:14:54
9641489751689f6dd58637fe8e00075ff7f2ecea...55be029b9de07d8f0e27834768ec9a294beabbda,1,55,0,55,1,2009-09-29 14:15:06,2009-09-29 14:15:06
55be029b9de07d8f0e27834768ec9a294beabbda...9359676af4992cb328d528a58cc4e263c76bff65,1,22,1,23,3,2009-09-29 14:18:14,2009-09-29 14:18:14
9359676af4992cb328d528a58cc4e263c76bff65...b5b610c8b1ede65dd01ac0977a0698900b2c075d,1,32,4,36,4,2009-09-29 14:40:39,2009-09-29 14:40:39
50deaa9dc9e36c2c4b50839c3901b1bfad7e50f9...984318614162d33683ce4d38a50c4d05a2ef1b11,1,64,64,128,57,2009-09-18 20:34:02,2009-09-18 20:34:02
984318614162d33683ce4d38a50c4d05a2ef1b11...a3ddeea651ba98929e15e1f439abdead20dd5565,4,100,113,213,13,2009-09-18 21:38:07,2009-09-18 21:38:07
a3ddeea651ba98929e15e1f439abdead20dd5565...c2f6c927789528347b879b3462622eea5299e8ad,2,1,4,5,2,2009-09-18 21:48:30,2009-09-18 21:48:30
c2f6c927789528347b879b3462622eea5299e8ad...4a3c382889f4327fb1b1d7ce88e6d511cea7d1bc,1,13,4,17,1,2009-09-18 22:14:15,2009-09-18 22:14:15
4a3c382889f4327fb1b1d7ce88e6d511cea7d1bc...91b5884ffe6ea8323c45f91094faeac18b84e6db,1,1,1,2,1,2009-09-18 22:30:19,2009-09-18 22:30:19
b5b610c8b1ede65dd01ac0977a0698900b2c075d...7cb2e80e14bef55097978748cce83869913e193e,1,35,5,40,6,2009-09-29 17:26:23,2009-09-29 17:26:23
b5b610c8b1ede65dd01ac0977a0698900b2c075d...966e13e27f875a863bea62e02c7425b77dab39c6,2,13,1,14,4,2009-09-29 16:59:16,2009-09-29 16:59:16
91b5884ffe6ea8323c45f91094faeac18b84e6db...a0c6cc62d23c3f7bf220fc1c9c182e3e4d339321,1,11,2,13,3,2009-09-20 02:06:36,2009-09-20 02:06:36
7d26935f348ce03416cae756a9df32d45eeb9739...f93d2e550402ed5e0863cee432b947388550d538,1,1,0,1,1,2009-10-10 20:10:52,2009-10-10 20:10:52
f93d2e550402ed5e0863cee432b947388550d538...d667638de041581406c5b8824e21a4f04b9895e7,1,1,1,2,2,2009-10-10 20:52:46,2009-10-10 20:52:46
665b14f97f03d807e2d3a42a0e0d2f02ae85fd83...2383059c03a3f480b136af179c3cecfaa3a0e6fb,3,13,3,16,7,2009-09-29 19:48:58,2009-09-29 19:48:58
966e13e27f875a863bea62e02c7425b77dab39c6...ae3d49d718ac6778f7abdc133263121971f64569,8,119,10,129,19,2009-09-29 20:54:31,2009-09-29 20:54:31
a0c6cc62d23c3f7bf220fc1c9c182e3e4d339321...c9e823f8cabaf91ddefe367b83c5a76d4dabd21d,2,4,7,11,3,2009-09-21 13:05:27,2009-09-21 13:05:27
c9e823f8cabaf91ddefe367b83c5a76d4dabd21d...71af757e56d42717811fd859032e5695cef4fb1c,1,10,4,14,4,2009-09-21 14:05:03,2009-09-21 14:05:03
71af757e56d42717811fd859032e5695cef4fb1c...d30ce5418dc205e427fd209b1d285b0e4808de2a,1,3,1,4,1,2009-09-21 14:40:25,2009-09-21 14:40:25
d667638de041581406c5b8824e21a4f04b9895e7...708ca2b8fb2de7f9133aa11725c4ef9f181429d0,1,3,0,3,1,2009-10-11 02:41:21,2009-10-11 02:41:21
d667638de041581406c5b8824e21a4f04b9895e7...6f30be62d4205d5d2dc4f9bf16327eee26c8ca0c,4,64,60,124,12,2009-10-11 02:24:08,2009-10-11 02:24:08
d7148cef45db8315846f739fb929c99033fcf302...f579b721757347d0419878d3c1ef6d21101bd7e2,1,1,1,2,1,2009-09-29 20:58:48,2009-09-29 20:58:48
f579b721757347d0419878d3c1ef6d21101bd7e2...c000bcaafd94c46bba57bdad247d7285a2d91507,1,22,9,31,8,2009-09-29 21:11:31,2009-09-29 21:10:19
c000bcaafd94c46bba57bdad247d7285a2d91507...754655029fad32f63dc76ac836aa126a29de9178,2,13,0,13,2,2009-09-30 03:37:13,2009-09-30 03:37:13
754655029fad32f63dc76ac836aa126a29de9178...b302244b0a752c1c0f1a2692a8901373fae6b7b7,2,17,17,34,17,2009-09-30 14:08:58,2009-09-30 14:08:58
b302244b0a752c1c0f1a2692a8901373fae6b7b7...9d0c7e66a3dd61814924f91c26fd1d93896eaa7a,1,8,3,11,6,2009-09-30 14:30:25,2009-09-30 14:30:25
9d0c7e66a3dd61814924f91c26fd1d93896eaa7a...8058f0b7f37065d7558925abf23a2385cbe53270,1,1807,0,1807,1,2009-09-30 15:58:44,2009-09-30 15:58:44
8058f0b7f37065d7558925abf23a2385cbe53270...7153023470d245f47a8964706cac353fff2ab957,17,17,3,20,18,2009-09-30 18:32:17,2009-09-30 18:32:17
7153023470d245f47a8964706cac353fff2ab957...74aefcc40592872dcf8c4b70d07ecb49f3f4afce,2,155,60,215,9,2009-09-30 18:32:26,2009-09-30 18:32:26
74aefcc40592872dcf8c4b70d07ecb49f3f4afce...04515195f83db0bca1a438d0a2d6ebc0d9f37338,2,1,2,3,2,2009-09-30 19:23:56,2009-09-30 19:23:56
04515195f83db0bca1a438d0a2d6ebc0d9f37338...993b94fceee166c717f9e9707d4908f62869e072,1,9,9,18,7,2009-09-30 20:34:18,2009-09-30 20:34:18
d30ce5418dc205e427fd209b1d285b0e4808de2a...6bbaf0fdc3a1cba0be4862b2169535f8b2f113a9,7,131,21,152,23,2009-09-21 20:31:00,2009-09-21 20:31:00
d30ce5418dc205e427fd209b1d285b0e4808de2a...42081471dba6e3cd5486944dcacd7eb07d8a894f,3,16,11,27,5,2009-09-21 15:51:06,2009-09-21 15:51:06
42081471dba6e3cd5486944dcacd7eb07d8a894f...f20838c3f3c46a12a328f9656fce5090e7389144,1,1,2,3,1,2009-09-21 16:02:45,2009-09-21 16:02:45
f20838c3f3c46a12a328f9656fce5090e7389144...be84f053562131e261dcda25d1d7aefe923fc06a,1,1,1,2,1,2009-09-21 16:43:45,2009-09-21 16:43:45
be84f053562131e261dcda25d1d7aefe923fc06a...5f21ef37f7129baec402cf644bde193a5268ccb3,1,1,1,2,1,2009-09-21 17:01:06,2009-09-21 17:01:06
5f21ef37f7129baec402cf644bde193a5268ccb3...e0496df06de6f1ef0d2c97187085d6862dcb715c,4,24,39,63,15,2009-09-21 19:22:15,2009-09-21 19:22:15
e0496df06de6f1ef0d2c97187085d6862dcb715c...c2456cf402045dbee76f1410a7e05022aec4ffff,1,1,1,2,1,2009-09-21 19:28:23,2009-09-21 19:28:23
c2456cf402045dbee76f1410a7e05022aec4ffff...dcbe8fbd95f25ec5edd4331b6ad2fc7d14a09033,3,39,21,60,4,2009-09-21 19:54:41,2009-09-21 19:54:41
dcbe8fbd95f25ec5edd4331b6ad2fc7d14a09033...b3c16e397ae5a9425b6774cbee20939068b1d1ef,3,210,1,211,3,2009-09-21 19:55:24,2009-09-21 19:55:24
708ca2b8fb2de7f9133aa11725c4ef9f181429d0...324438fbae4195aa0edcfdacc9ee7c3b92e2fe2a,1,2,1,3,2,2009-10-11 22:29:35,2009-10-11 22:29:35
324438fbae4195aa0edcfdacc9ee7c3b92e2fe2a...65fb01f0155128e276657d58247fb8df8b0239aa,1,6,2,8,4,2009-10-12 00:24:12,2009-10-12 00:24:12
7363cf4d3c9d6f4243fbcd8deb57e09f7d19b5f0...77fb45335a7563ceedf280d0c46642be53cb27fe,4,122,7,129,12,2009-10-11 22:15:12,2009-10-11 22:15:12
993b94fceee166c717f9e9707d4908f62869e072...b622636eb2d6c5e21a48c9832e1731512ebfdd13,3,16,8,24,9,2009-10-01 14:01:02,2009-10-01 14:01:02
993b94fceee166c717f9e9707d4908f62869e072...8658e97ed342f3a8c0e1be3b8bdfce847abd99a5,1,17,4,21,6,2009-09-30 21:11:56,2009-09-30 21:11:56
8658e97ed342f3a8c0e1be3b8bdfce847abd99a5...c9bbecda696efe7cffa27f2e699172e3ee7a94fe,1,20,10,30,9,2009-09-30 23:07:01,2009-09-30 23:07:01
c9bbecda696efe7cffa27f2e699172e3ee7a94fe...fdd776a50a43c1a25e6114632a5e7990920b7e4f,4,129,1,130,6,2009-10-01 03:08:33,2009-10-01 03:08:33
fdd776a50a43c1a25e6114632a5e7990920b7e4f...f7bfd1192ceea9a5fb0e9b62905a8145c0d12eb6,3,88,18,106,16,2009-10-01 03:32:28,2009-10-01 03:32:28
f7bfd1192ceea9a5fb0e9b62905a8145c0d12eb6...aaf8754d31686baf8d6430e504ba0ef427c36bfc,1,3,4,7,1,2009-10-01 05:25:53,2009-10-01 05:25:53
aaf8754d31686baf8d6430e504ba0ef427c36bfc...cc2377b335c3e169723f24dd2ec9305048acd08c,1,6,2,8,1,2009-10-01 05:26:10,2009-10-01 05:26:10
cc2377b335c3e169723f24dd2ec9305048acd08c...1bb3d4a00461d0aea02cf76eb7073d1776c7bc04,3,55,16,71,14,2009-10-01 05:26:19,2009-10-01 05:26:19
1bb3d4a00461d0aea02cf76eb7073d1776c7bc04...80b7497d697806c1d0bd0ded4f0bbb4a73e262c7,1,2,2,4,2,2009-10-01 05:26:57,2009-10-01 05:26:57
80b7497d697806c1d0bd0ded4f0bbb4a73e262c7...b8e956694f6db147c95e92a6d29cb7a7d024c1ad,1,2,11,13,3,2009-10-01 12:34:50,2009-10-01 12:34:50
b8e956694f6db147c95e92a6d29cb7a7d024c1ad...41a7ff05a753dbc82273a0a860df5c625a8d4f64,1,0,1,1,1,2009-10-01 12:35:04,2009-10-01 12:35:04
41a7ff05a753dbc82273a0a860df5c625a8d4f64...1f622ad076fcc5a0cf5b6006b7488651d8d3eac1,3,18,29,47,7,2009-10-01 13:49:17,2009-10-01 13:49:17
753703d600ed4325a7ac010abb9e842ed4769fc9...de8a957fdfe5a48dda15b6700c318be40b976655,1,3,2,5,1,2009-09-21 20:37:20,2009-09-21 20:37:20
de8a957fdfe5a48dda15b6700c318be40b976655...663b1bfd8ed2d6372a13cf31252484fdaccea53c,1,0,1,1,1,2009-09-22 00:30:40,2009-09-22 00:30:40
663b1bfd8ed2d6372a13cf31252484fdaccea53c...4fc1b55e0d13000718c1ce5a997f5317e02ceddb,1,1,6,7,2,2009-09-22 00:32:17,2009-09-22 00:32:17
4fc1b55e0d13000718c1ce5a997f5317e02ceddb...f694624575c872401475328a0a86eba04b97a9a1,1,12,2,14,2,2009-09-22 02:35:43,2009-09-22 02:35:43
f694624575c872401475328a0a86eba04b97a9a1...76e80e83e75294f3ce4bfeb5aa80d4ffa1fff1e2,2,26,11,37,7,2009-09-22 03:47:09,2009-09-22 03:47:09
76e80e83e75294f3ce4bfeb5aa80d4ffa1fff1e2...a82cc2b03191344e3a8a2ef70300a0b8200bf90b,1,1,1,2,1,2009-09-22 11:20:54,2009-09-22 11:20:54
65fb01f0155128e276657d58247fb8df8b0239aa...1777f1d93b99f6c7280cffb9780bff31bdfe73c9,1,9,0,9,2,2009-10-12 01:35:39,2009-10-12 01:35:39
19453752fc93c2391e64500b17df54894ebcbed9...1ebfc3519eee95628032674ead20e706a65aa35a,1,0,2,2,1,2009-10-01 14:07:54,2009-10-01 14:07:54
1ebfc3519eee95628032674ead20e706a65aa35a...1b508836b5c5e55aeec56858c0ca39a82678c91c,3,28,16,44,15,2009-10-01 14:10:02,2009-10-01 14:10:02
1f622ad076fcc5a0cf5b6006b7488651d8d3eac1...15a86d57ff2243680b7fbdd631d1e0186a4b78a3,3,3,3,6,3,2009-10-01 17:58:41,2009-10-01 17:58:41
1f622ad076fcc5a0cf5b6006b7488651d8d3eac1...9c83a9e08ca9c253e9b53e055321589cf4f59171,1,0,2,2,1,2009-10-01 14:12:16,2009-10-01 14:12:16
a82cc2b03191344e3a8a2ef70300a0b8200bf90b...20ce6638929936ba64d495ca4a5d08e4c79186f4,3,60,46,106,39,2009-09-22 14:10:02,2009-09-22 14:10:02
a82cc2b03191344e3a8a2ef70300a0b8200bf90b...a8a42c1ea055a810fdb35fd2eeb40eee7fb5c989,1,6,0,6,2,2009-09-22 14:05:53,2009-09-22 14:05:53
a8a42c1ea055a810fdb35fd2eeb40eee7fb5c989...665b1f748332be36432b49103a8bda69576ad99d,1,7,0,7,3,2009-09-22 14:07:53,2009-09-22 14:07:53
b4f18042ef8913d734a958d8082cc5ed6021184f...bd840cf7b0b512ff2441d77940ef895ae6c8e029,2,16,4,20,3,2009-10-12 15:22:30,2009-10-12 15:22:30
bd840cf7b0b512ff2441d77940ef895ae6c8e029...6c10cf4d98bbec63663547c97eff708017929f59,1,5,0,5,1,2009-10-12 15:25:49,2009-10-12 15:25:49
6c10cf4d98bbec63663547c97eff708017929f59...1410fa1b75aaca853b3b84073098e2de58f0cf95,2,17,4,21,6,2009-10-12 15:30:43,2009-10-12 15:30:43
61bd868ce193adb637ebcd1f202ccba2476623f9...86e9a31716cc152301ca94bc3d25bea3da223c7b,1,5,1,6,1,2009-10-01 14:41:15,2009-10-01 14:41:15
86e9a31716cc152301ca94bc3d25bea3da223c7b...d3ad7fa491e04d92974e8087857d5e737cfbd06b,2,4,4,8,4,2009-10-01 14:41:22,2009-10-01 14:41:22
d3ad7fa491e04d92974e8087857d5e737cfbd06b...3d263b1f46b4a2c437fde45eac95af65db15ab18,1,8,8,16,5,2009-10-01 16:06:04,2009-10-01 16:06:04
eca1e97b76dca3cb995ee2e806ae1b1071c3c837...c608d20a8bf51ad146449e434f04d3e904b8ed96,1,1,1,2,1,2009-10-01 18:54:57,2009-10-01 18:54:57
21f2de6ec9499663c6b5a34bade4351ff1b5ae99...1a53fbf2ed2da33ad759eec61878e7952115c17e,3,6,5,11,6,2009-09-22 17:45:42,2009-09-22 17:45:42
665b1f748332be36432b49103a8bda69576ad99d...a78800d5b8b5188b6cdde1ba66d743958975aaa3,1,8,3,11,2,2009-09-22 14:22:24,2009-09-22 14:22:24
1410fa1b75aaca853b3b84073098e2de58f0cf95...85354972aee184b2a0419095c978ebc6e765d560,2,71,29,100,20,2009-10-12 16:53:01,2009-10-12 16:53:01
1410fa1b75aaca853b3b84073098e2de58f0cf95...a4f7dc11d70c13132eb6ee1573dec7f880106e1a,6,57,1,58,10,2009-10-12 15:58:14,2009-10-12 15:58:14
a4f7dc11d70c13132eb6ee1573dec7f880106e1a...c7f0a55ee5eac6e1a3d1d10c43656b5c5e0ec68b,2,20,7,27,5,2009-10-12 16:00:25,2009-10-12 16:00:25
c608d20a8bf51ad146449e434f04d3e904b8ed96...95baa00d459fd2ea5588277e90a98edab7394b79,2,11,0,11,2,2009-10-01 21:15:33,2009-10-01 21:15:33
95baa00d459fd2ea5588277e90a98edab7394b79...529b27107003d7e302b661e7c990e9ae3014264e,2,16,2,18,4,2009-10-01 21:15:44,2009-10-01 21:15:44
c608d20a8bf51ad146449e434f04d3e904b8ed96...3866337b42dc3207a64f58cd374a42e9850be285,1,60,67,127,1,2009-10-01 18:59:24,2009-10-01 18:59:24
91b32ffc15fb3fcaf36ff9a5f8359fc18e818442...b71a69891e06acd0169d1dfd595c5b8f7edb2ea0,1,7,0,7,1,2009-09-22 18:34:55,2009-09-22 18:34:55
34995c3a6eddd56b468bea0ee4e31d468dbca8d9...1f7a4668a5e1d56ac2ff3e37476608787426f4c2,1,1,1,2,1,2009-09-22 17:24:09,2009-09-22 17:24:09
ea729cb14aca6ea605ed4de451d093a9e3eb4567...31272e80381b1d3355d0ed9b362501b6d31fff10,1,2,2,4,1,2009-10-12 17:02:03,2009-10-12 17:02:03
c7f0a55ee5eac6e1a3d1d10c43656b5c5e0ec68b...42544bd9af00e2153b5ca49faa2b370dad5dd804,2,5,2,7,3,2009-10-12 18:20:52,2009-10-12 18:20:52
c7f0a55ee5eac6e1a3d1d10c43656b5c5e0ec68b...e0462f7dcfa69eb090af5330096ff77e51a42dde,4,57,83,140,22,2009-10-12 16:58:43,2009-10-12 16:58:43
3866337b42dc3207a64f58cd374a42e9850be285...1c16fd57c0e98a7eb1bc53412204f080a48fb6f9,1,8,1,9,2,2009-10-02 19:01:45,2009-10-02 19:01:45
b71a69891e06acd0169d1dfd595c5b8f7edb2ea0...4429157203687f048104c7208907816972f04ade,2,17,4,21,4,2009-09-23 19:39:37,2009-09-23 19:39:37
1f7a4668a5e1d56ac2ff3e37476608787426f4c2...23ac7eaad399b66ed86a770a4975467d31e72ed0,1,11,2,13,2,2009-09-22 20:29:15,2009-09-22 20:29:15
25ab0cc339724ab4dad7fa724a628e11f0af5ee4...c628c7b93fe5f4f5ddae758da9973400aab26721,3,22,5,27,7,2009-10-12 17:27:04,2009-10-12 17:27:04
befa6fb41fa710f527b22b1521f1b5b25a454f93...04104f13a1da95d8f15cc56e547dd14401b82335,3,35,14,49,3,2009-10-02 20:55:47,2009-10-02 20:55:47
04104f13a1da95d8f15cc56e547dd14401b82335...cb060f8ce38df7791e30c35689603e0a71f8aa0d,1,10,6,16,1,2009-10-02 20:58:04,2009-10-02 20:58:04
befa6fb41fa710f527b22b1521f1b5b25a454f93...9b0f12bb1edffebba7bf05321352eedb393d7f1a,2,15,16,31,12,2009-10-02 19:43:30,2009-10-02 19:43:30
9b0f12bb1edffebba7bf05321352eedb393d7f1a...5db7ed9d3e51615e1a5dac2725e7fd6f802453f2,1,7,0,7,1,2009-10-02 20:06:20,2009-10-02 20:06:20
4d9812894b1af2d3982db12e8c2b5e455afb557e...6cf3d75d0845e9cc551a43adb7b56bea935e5231,4,186,31,217,28,2009-09-24 16:11:55,2009-09-24 16:11:55
6cf3d75d0845e9cc551a43adb7b56bea935e5231...0678cedd5bf8e0d54e4a9beae131b32da89639c5,6,38,9,47,16,2009-09-24 18:21:40,2009-09-24 18:21:40
96b770023cda242e6d51f68e02691752e6d05bf8...524956f52a6a9fbd3331ca7ea1bb3c52a0078bcf,2,12,10,22,6,2009-09-23 14:30:40,2009-09-23 14:30:40
524956f52a6a9fbd3331ca7ea1bb3c52a0078bcf...356d71309cb468b8cc2ef56e1573e66f80522cbc,1,14,7,21,4,2009-09-23 21:16:32,2009-09-23 21:16:32
c628c7b93fe5f4f5ddae758da9973400aab26721...cf7a86e0f90857771d06b68f1bd59e0282bd1679,21,97,88,185,68,2009-10-12 19:12:16,2009-10-12 19:12:16
cf7a86e0f90857771d06b68f1bd59e0282bd1679...81a73d0f63c66a01e2776571ab6d0ebfa302673a,2,11,1,12,2,2009-10-12 19:21:30,2009-10-12 19:21:30
c628c7b93fe5f4f5ddae758da9973400aab26721...dafa356e708de414059a2f13f24e305a90aa1d46,1,1,1,2,1,2009-10-12 18:43:38,2009-10-12 18:43:38
063aeec0a7078ac3327f28ba1232831f0aadea15...fcd3220d1629d7083645d236ecab143b66901a4c,3,52,19,71,8,2009-10-12 19:05:42,2009-10-12 19:05:42
ff458d03b745576ef9ef5ef78789cf8ed402e3f4...151d9607650448564d498772cebb13c500e2db96,2,8,2,10,2,2009-10-05 14:19:51,2009-10-05 14:19:51
5db7ed9d3e51615e1a5dac2725e7fd6f802453f2...eaf0c845bccc01d61b7971b8c3b507fc7a175d38,6,19,19,38,16,2009-10-02 20:38:20,2009-10-02 20:38:20
eaf0c845bccc01d61b7971b8c3b507fc7a175d38...cc2c5c491100d3c8782a1c95b6fc362db91158c5,6,86,0,86,7,2009-10-02 21:07:07,2009-10-02 21:07:07
86f4a5480af86c39dba2257fa0732a3737a621ac...29f0d366407c2e24230be2dc7fd99a0ec5d43410,7,91,28,119,20,2009-09-24 21:10:45,2009-09-24 21:10:45
6c5df5a98d050933e58ae4d293063020a7e68c9b...d4bc6a0491f688f34789c7e901bf0aa129c94f15,1,7,7,14,7,2009-09-24 14:11:10,2009-09-24 14:11:10
d4bc6a0491f688f34789c7e901bf0aa129c94f15...9a58bc685f9e14a4804b0852920091acf94df5a4,1,1,1,2,1,2009-09-24 14:21:08,2009-09-24 14:21:08
9a58bc685f9e14a4804b0852920091acf94df5a4...7c3a470c0b55e6e966d3311b09bfa6c951437361,1,8,4,12,7,2009-09-24 14:51:16,2009-09-24 14:51:16
7c3a470c0b55e6e966d3311b09bfa6c951437361...724d6617fa1734c1b542bdfe182b35271dae8c97,2,270,117,387,42,2009-09-24 14:51:27,2009-09-24 14:51:27
724d6617fa1734c1b542bdfe182b35271dae8c97...a74cdf759d60b59a9859b30612456e4dc0c071b5,2,0,0,0,0,2009-09-24 15:00:16,2009-09-24 15:00:16
a74cdf759d60b59a9859b30612456e4dc0c071b5...01e1564c031cfc2503b34bbc7553c8cac32901cf,7,7,7,14,7,2009-09-24 15:02:00,2009-09-24 15:02:00
01e1564c031cfc2503b34bbc7553c8cac32901cf...46000ef2d456b6cf9d6099e6bb2e0f26fbd1e690,4,55,11,66,12,2009-09-24 15:17:03,2009-09-24 15:17:03
46000ef2d456b6cf9d6099e6bb2e0f26fbd1e690...6d258c54de57565f632dcf086d93ef10a3ccaba8,3,64,10,74,14,2009-09-24 15:57:45,2009-09-24 15:57:45
6d258c54de57565f632dcf086d93ef10a3ccaba8...f6852db36b1f3dd9e1220e9ac8cbb6e9d55c6f84,1,2,2,4,2,2009-09-24 16:05:31,2009-09-24 15:41:57
f6852db36b1f3dd9e1220e9ac8cbb6e9d55c6f84...ee9b2ea7eafa63fa36327520e35aeffc24828ff5,1,2,6,8,2,2009-09-24 16:05:31,2009-09-24 15:54:42
ee9b2ea7eafa63fa36327520e35aeffc24828ff5...a4d00f78d36c28dca300e8cf11bedd776d22db24,1,6,1,7,2,2009-09-24 16:05:32,2009-09-24 16:04:51
a4d00f78d36c28dca300e8cf11bedd776d22db24...fad8b0ca02289ab373587c80bdfd4c248270183e,1,1,1,2,1,2009-09-24 16:46:35,2009-09-24 16:46:35
fcd3220d1629d7083645d236ecab143b66901a4c...1b27e7aae72ea7062f7fcb7a5409a5426c63326e,1,11,1,12,6,2009-10-12 19:24:38,2009-10-12 19:24:38
bf71601a955498c8ebf8b474fc34d2dae309b77d...e2fcb26d685f82f9405f954e11ad0d49994f4fbd,2,4,3,7,4,2009-10-05 01:49:36,2009-10-05 01:49:36
fad8b0ca02289ab373587c80bdfd4c248270183e...40bf2361076da98f88891efd252de4b21df2a0fd,1,8,7,15,4,2009-09-24 19:41:31,2009-09-24 19:41:31
40bf2361076da98f88891efd252de4b21df2a0fd...df64c0563b0d1b1c741b8fcaf976053fb4a42d8d,2,7,5,12,5,2009-09-24 20:31:18,2009-09-24 20:29:38
df64c0563b0d1b1c741b8fcaf976053fb4a42d8d...c5985d68924279c60277190e5e545bb48f52d1e0,1,17,11,28,11,2009-09-24 20:31:18,2009-09-24 20:30:38
c5985d68924279c60277190e5e545bb48f52d1e0...56698dc313c542513dda11b4e09e6261be142e5b,3,21,21,42,14,2009-09-24 21:04:44,2009-09-24 21:04:44
46fc3058c8b8588f6f334300b68f2454939080ac...7881edc2ca5fba2c148ceefd5de24862bf041686,1,13,10,23,10,2009-10-12 20:11:52,2009-10-12 20:11:52
7881edc2ca5fba2c148ceefd5de24862bf041686...adec9f4fae559811412014e8442893483115b07a,1,3,2,5,2,2009-10-12 20:12:00,2009-10-12 20:12:00
adec9f4fae559811412014e8442893483115b07a...6dad2527d203f0b4a9f1d3a94bbad74a8156a166,2,7,7,14,6,2009-10-12 20:27:35,2009-10-12 20:27:35
4142f3ebe494e4e0f55450499a09ba7b54a44227...2967c63e922930d1c0f94b224681467d3c2873bd,2,12,10,22,4,2009-10-05 16:59:51,2009-10-05 16:59:51
2967c63e922930d1c0f94b224681467d3c2873bd...417ba0f0ce30ed971d7d70c620c4201b8e2d120b,1,4,2,6,2,2009-10-05 17:49:03,2009-10-05 17:49:03
417ba0f0ce30ed971d7d70c620c4201b8e2d120b...6b79e14d967d05c3cbb70bb1b597fba6b8666bf8,1,3,2,5,1,2009-10-05 18:09:43,2009-10-05 18:09:43
6b79e14d967d05c3cbb70bb1b597fba6b8666bf8...27fd0a7a9fd84b1965f733848e9c38072ee8f7ee,3,42,43,85,3,2009-10-05 19:09:18,2009-10-05 19:09:18
27fd0a7a9fd84b1965f733848e9c38072ee8f7ee...727fc307f995126ef881ab57d428cb99404dd79f,2,10,2,12,7,2009-10-05 19:09:52,2009-10-05 19:09:52
e2fcb26d685f82f9405f954e11ad0d49994f4fbd...d006977e872c448b17ce6d5cdc1e945cf79159c3,2,4,1,5,3,2009-10-05 14:56:42,2009-10-05 14:56:42
56698dc313c542513dda11b4e09e6261be142e5b...d1ba3c244ab784d1745fbbc8f65bd754795f522f,1,28,2,30,4,2009-09-24 21:17:11,2009-09-24 21:17:11
d1ba3c244ab784d1745fbbc8f65bd754795f522f...1981f140a85848869ea6ae3d0de49be86ed51555,2,4,8,12,5,2009-09-24 21:24:45,2009-09-24 21:24:45
6dad2527d203f0b4a9f1d3a94bbad74a8156a166...1083a425c27e0a8b37b191af75cddb92f5a251e5,6,29,19,48,14,2009-10-13 16:55:23,2009-10-13 16:55:23
1083a425c27e0a8b37b191af75cddb92f5a251e5...2d934d1006c7c018fad0cdfe91dc4e2b00d2107e,18,101,66,167,60,2009-10-13 20:01:02,2009-10-13 20:01:02
6dad2527d203f0b4a9f1d3a94bbad74a8156a166...1719642eee3676a337ff51d43a52ff7a00c3cc9f,1,2,1,3,2,2009-10-13 15:35:55,2009-10-13 15:35:55
6dad2527d203f0b4a9f1d3a94bbad74a8156a166...5f62314f9e34c4ecba6f4ad328c2bb90a68d0447,2,2,2,4,2,2009-10-12 21:20:19,2009-10-12 21:20:19
5f62314f9e34c4ecba6f4ad328c2bb90a68d0447...fe88b0695996ba2f098c513ad26b7cdcc63e8b79,6,522,416,938,21,2009-10-13 14:12:44,2009-10-13 14:12:44
fe88b0695996ba2f098c513ad26b7cdcc63e8b79...f7553c7835e4d7a388bc82ba57a256a4c7441931,5,44,38,82,18,2009-10-13 14:48:38,2009-10-13 14:48:38
f7553c7835e4d7a388bc82ba57a256a4c7441931...feabc146574ecd56e8e3901e79c90d4e97567e36,5,39,17,56,18,2009-10-13 15:11:55,2009-10-13 15:11:55
727fc307f995126ef881ab57d428cb99404dd79f...29069c485d9fd64e9a67d8f4f59181ad7b2a1737,2,45,1,46,4,2009-10-05 20:02:15,2009-10-05 20:02:15
727fc307f995126ef881ab57d428cb99404dd79f...0742697d447cde0090aab1a704ca8861b622205c,1,5,0,5,1,2009-10-05 19:16:06,2009-10-05 19:16:06
0742697d447cde0090aab1a704ca8861b622205c...c2b148ad2fcbceae3b36af122691b892ac458d6c,1,3,3,6,1,2009-10-05 19:18:04,2009-10-05 19:18:04
90aa42984589401553d39e03ed4bc23ed51d0ec7...29821161c173372c87fd97f42c3ab8b5568f9c49,2,52,12,64,14,2009-09-25 14:46:49,2009-09-25 14:46:49
29821161c173372c87fd97f42c3ab8b5568f9c49...586252cffb05758eb0f6ef062c39b5d612ef947a,2,15,9,24,6,2009-09-25 14:56:02,2009-09-25 14:56:02
586252cffb05758eb0f6ef062c39b5d612ef947a...c9d513ffd36d003732e66ab468333790acefe909,2,9,9,18,8,2009-09-25 14:56:56,2009-09-25 14:56:56
c9d513ffd36d003732e66ab468333790acefe909...497a8c00c6b367cae50e37af38947db2262a6c44,1,19,0,19,1,2009-09-25 14:57:07,2009-09-25 14:57:07
1981f140a85848869ea6ae3d0de49be86ed51555...8b91377b098c378fc33bff10e81c2f0daa95feb1,3,169,18,187,5,2009-09-24 21:41:09,2009-09-24 21:41:09
ca9747f9cc34bd822c47f37b5629ea0d16fdd851...4d613fb1f4511be5c691ef74f45a0368ab7ecbd6,1,3,2,5,2,2009-10-13 20:26:29,2009-10-13 20:26:29
ca9747f9cc34bd822c47f37b5629ea0d16fdd851...9355cc739e8aaf5df1c11187cc0de94fa82ac916,6,67,39,106,26,2009-10-13 20:12:43,2009-10-13 20:12:43
2f038970dea3944c6c1dd1f2b2b34656a7c0045b...ed92b96011ba132e98278eea7c7d6e0bd21941eb,3,35,2,37,7,2009-10-13 16:33:25,2009-10-13 16:33:25
9ae442c2729341479c72a6458dca6a4641cff8e7...cb8a425f39037b6a6cc91c2650692a66b9f94104,3,18,2,20,4,2009-10-05 20:40:24,2009-10-05 20:40:24
9ae442c2729341479c72a6458dca6a4641cff8e7...75141728116853d97a85f10fbfaf2c089fd16534,1,7,2,9,2,2009-10-05 20:39:49,2009-10-05 20:39:49
c2b148ad2fcbceae3b36af122691b892ac458d6c...17da656d91d17c303318a9b5421e29fac9c92059,1,9,2,11,3,2009-10-05 20:26:19,2009-10-05 20:26:19
497a8c00c6b367cae50e37af38947db2262a6c44...ab135dd2f4f69a079e41ebf10be381d5656fb03a,1,27,1,28,3,2009-09-25 15:11:48,2009-09-25 15:11:48
ab135dd2f4f69a079e41ebf10be381d5656fb03a...c2c136a3f2a28ff471463cb896ea39fb0a64e599,3,36,3,39,10,2009-09-25 15:22:43,2009-09-25 15:22:43
c2c136a3f2a28ff471463cb896ea39fb0a64e599...ad29f4071616688bb030b700a9d755a85c3b7183,1,7,6,13,6,2009-09-25 15:56:17,2009-09-25 15:56:17
ad29f4071616688bb030b700a9d755a85c3b7183...42737c6e304bd5b3a762c393bdd0bb8e1d589bd5,1,2,0,2,1,2009-09-25 15:56:25,2009-09-25 15:56:25
42737c6e304bd5b3a762c393bdd0bb8e1d589bd5...4b31625836544c03c167eee3a1c0e79bce7854ec,1,54,0,54,1,2009-09-25 17:50:24,2009-09-14 20:16:37
4b31625836544c03c167eee3a1c0e79bce7854ec...e815aac1acf8bd7d34b317e86c84cbd0aa711f70,1,7,59,66,8,2009-09-25 17:50:24,2009-09-25 16:17:59
e815aac1acf8bd7d34b317e86c84cbd0aa711f70...2fedd80c4dda59cf2779a947f033cf730ba41901,2,7,7,14,8,2009-09-25 19:51:11,2009-09-25 19:51:11
e5e52e9eeb30723e5585d06b6bf2b65a8c45e3d0...49146962dc0ec28e09d609783e08fceb04fc8101,1,0,1,1,1,2009-10-13 20:44:47,2009-10-13 20:44:47
49146962dc0ec28e09d609783e08fceb04fc8101...ab1f46de2cc4984538d373e528e29bc190544c00,2,62,0,62,3,2009-10-13 20:44:52,2009-10-13 20:44:52
1537117b6618e200245865fea1942e3c0551a6fc...283572bebc03fb6b89a50430c7720377e12f9d5c,1,1,1,2,1,2009-10-05 21:13:55,2009-10-05 21:13:55
ab1f46de2cc4984538d373e528e29bc190544c00...55a8da77159a267de2e3ce7390c991b8b9b006d8,1,6,0,6,1,2009-10-13 21:14:32,2009-10-13 21:14:32
ab1f46de2cc4984538d373e528e29bc190544c00...a3d54ef5e4c8cf8a0187dee40d678c82b4aa76f0,1,2,3,5,2,2009-10-13 21:13:51,2009-10-13 21:13:51
283572bebc03fb6b89a50430c7720377e12f9d5c...b733978054f7b2cc2505e7a7e554d00b1f471663,2,15,3,18,4,2009-10-07 16:42:43,2009-10-07 16:42:43
b733978054f7b2cc2505e7a7e554d00b1f471663...498169e9e386f21e7ee83a9b900cae24dffa3d4b,3,47,47,94,12,2009-10-07 16:43:24,2009-10-07 16:43:24
498169e9e386f21e7ee83a9b900cae24dffa3d4b...fecc9119a7f504bb2d5ca4238d4686779aa1cb8d,1,9,3,12,2,2009-10-07 16:43:44,2009-10-07 16:43:44
283572bebc03fb6b89a50430c7720377e12f9d5c...103ae4cb6a110b17909a1cd66de616ec6b0ab56c,1,39,0,39,1,2009-10-06 19:02:01,2009-10-06 18:20:49
103ae4cb6a110b17909a1cd66de616ec6b0ab56c...85fed4ec3033428394e9f0fbf8f6ec8af015b3a6,1,102,102,204,88,2009-10-06 19:02:50,2009-10-06 18:31:02
85fed4ec3033428394e9f0fbf8f6ec8af015b3a6...32d147df9c9c3ca2e8d4cb1e7ed6af89017ccce3,1,7,2,9,1,2009-10-06 19:02:50,2009-10-06 19:01:18
32d147df9c9c3ca2e8d4cb1e7ed6af89017ccce3...0c9212038d87cdbac7cfd39ee93a099b6a291e61,7,22,24,46,17,2009-10-06 20:17:11,2009-10-06 20:17:11
0c9212038d87cdbac7cfd39ee93a099b6a291e61...eb27ae925ab846a66fdbf3caf57bcb654520fc85,1,1,0,1,1,2009-10-06 20:21:01,2009-10-06 20:21:01
283572bebc03fb6b89a50430c7720377e12f9d5c...99fd09c2e9c308638753f9f22cb66223e5d889db,1,12,0,12,2,2009-10-06 01:08:00,2009-10-06 01:08:00
47fcbc6b67a3f5661bf658ba4646ed204f5f45cc...25d2f88e1ec30777dedb0e3f6887cd4792344a30,6,52,2,54,12,2009-10-14 14:20:53,2009-10-14 14:20:53
eb27ae925ab846a66fdbf3caf57bcb654520fc85...9589c84edff464d451d9b3e2cd4984b7b6be56b5,6,10,2,12,7,2009-10-07 15:51:13,2009-10-07 15:51:13
a301303c983600bc23dcffcf764f46d7fe95fbe6...bbc42224b278dd4232814ee536393b9eb47c2d97,1,2,0,2,1,2009-10-07 13:15:30,2009-10-07 13:15:30
25d2f88e1ec30777dedb0e3f6887cd4792344a30...b5a86240a916697c5e4b4a93cf6b774584589893,1,2,6,8,2,2009-10-14 15:01:29,2009-10-14 15:01:29
25d2f88e1ec30777dedb0e3f6887cd4792344a30...3b02b0e68ce13386659b564294a83160c435c9d5,1,1,0,1,1,2009-10-14 14:55:49,2009-10-14 14:55:49
cfb8512886a0348feff97c55764a9cf9cc2b891b...a517b84d7f3fa15471c4aeaedf1763950bb4d4bc,3,202,53,255,39,2009-10-07 16:57:45,2009-10-07 16:57:45
36cfe4556a8462f056d2ab195bc4318d29736d67...1333a4bda940f3d94c95d8de70e7460282296941,1,4,3,7,2,2009-10-07 18:42:46,2009-10-07 18:42:46
36cfe4556a8462f056d2ab195bc4318d29736d67...1395da19a50af204bd7edde61789430a3c9cbf5c,1,4,2,6,3,2009-10-07 16:44:24,2009-10-07 16:44:24
9454547bb2861771d272960aa9694ab5d450a450...cd3b329548799da55d4ad3c8c80946650c9cb9cd,1,0,1,1,1,2009-10-14 15:04:46,2009-10-14 15:04:46
88c1b00b8b0de62a8a71aa4dc8c7408c106e4081...9e46e19eeb2af9d04053e209d47532f502b114da,3,29,8,37,6,2009-10-07 19:47:53,2009-10-07 19:47:53
88c1b00b8b0de62a8a71aa4dc8c7408c106e4081...d2db017c7a51173561e77df5d164471cf482b61c,4,10,66,76,12,2009-10-07 19:34:14,2009-10-07 19:34:14
d2db017c7a51173561e77df5d164471cf482b61c...a57f85698b08d49999dbd5934040c7bdedeee259,2,31,18,49,18,2009-10-07 19:47:08,2009-10-07 19:47:08
1395da19a50af204bd7edde61789430a3c9cbf5c...77d9e1fe4215a5d9df19deb7eeb1f8fee4ab3f51,1,0,2,2,1,2009-10-07 16:47:20,2009-10-07 16:47:20
cd3b329548799da55d4ad3c8c80946650c9cb9cd...16f8b77c5efd9334e7ddf3bfa7c667e6218fa366,26,137,105,242,119,2009-10-14 18:34:38,2009-10-14 18:34:38
cd3b329548799da55d4ad3c8c80946650c9cb9cd...2ebca2b128c7f865c2ddb8c539505732b6279f59,1,4,0,4,1,2009-10-14 18:30:55,2009-10-14 18:30:55
7425aa3d706f628ca50f6aa10c15520dee334a7a...75cc68851febcec4a77905433a1656b7c3c5d67a,4,91,50,141,29,2009-10-09 15:24:37,2009-10-09 15:24:37
7425aa3d706f628ca50f6aa10c15520dee334a7a...94a146742a297a669ecaef72bdffdd36f9dcd39e,1,23,0,23,1,2009-10-07 20:44:47,2009-10-07 20:44:47
94a146742a297a669ecaef72bdffdd36f9dcd39e...89c01e099cc75c7ffd3e8159746c2f4091e7ad95,3,21,281,302,5,2009-10-07 21:05:09,2009-10-07 21:05:09
89c01e099cc75c7ffd3e8159746c2f4091e7ad95...914bca4ff47b655945f5bfc00efc4ea8a70233a5,1,321,726,1047,409,2009-10-07 21:05:52,2009-10-07 21:05:52
914bca4ff47b655945f5bfc00efc4ea8a70233a5...a54742b3dea5bc35b1bb2dcc212a883d473fb750,2,23,12,35,15,2009-10-08 14:11:26,2009-10-08 14:11:26
a54742b3dea5bc35b1bb2dcc212a883d473fb750...23936952c13e1bcc072accc4b8adfcae09de9cfe,2,18,27,45,5,2009-10-08 15:04:13,2009-10-08 15:04:13
23936952c13e1bcc072accc4b8adfcae09de9cfe...1d1081a32fef759640ff60ec3db8ac72d52dcbba,1,14,0,14,1,2009-10-08 15:12:08,2009-10-08 15:12:08
1d1081a32fef759640ff60ec3db8ac72d52dcbba...f88a4415b6894cf44db2cc8a5ae666152e531404,1,7,4,11,3,2009-10-08 15:48:04,2009-10-08 15:48:04
f88a4415b6894cf44db2cc8a5ae666152e531404...677fbad312059efb0a8a8abecf220520facaa40b,3,5,15,20,11,2009-10-08 16:04:27,2009-10-08 16:04:27
677fbad312059efb0a8a8abecf220520facaa40b...920a858bc4dbbe88d5702de86f0d2fbb041c061c,2,4,8,12,6,2009-10-08 16:18:56,2009-10-08 16:18:56
920a858bc4dbbe88d5702de86f0d2fbb041c061c...c2b524522ae15f4477a4cf85c27244ba11037566,1,3,1,4,2,2009-10-08 16:32:50,2009-10-08 16:32:50
c2b524522ae15f4477a4cf85c27244ba11037566...a0d3663765b741044726b611c05f2ae50e73f10e,1,172,172,344,39,2009-10-08 16:59:03,2009-10-08 16:59:03
a0d3663765b741044726b611c05f2ae50e73f10e...3e3dda9c97274dc80a5c65caaf4163a266de6622,3,75,3,78,5,2009-10-08 17:07:25,2009-10-08 17:07:25
3e3dda9c97274dc80a5c65caaf4163a266de6622...3c23cd09be89ac70a8c1b49d20fc201ae8fe0036,1,11,2,13,4,2009-10-08 18:22:01,2009-10-08 18:22:01
3c23cd09be89ac70a8c1b49d20fc201ae8fe0036...ee72859d26fd63bb5e2c2c647480f2fe44f760eb,5,21,13,34,13,2009-10-08 20:29:04,2009-10-08 20:29:04
ee72859d26fd63bb5e2c2c647480f2fe44f760eb...e6069e40d9673de8d0824fef22e387a8527883ef,1,5,5,10,5,2009-10-08 20:35:15,2009-10-08 20:35:15
4dfc5d6288d957f37dfb61308b9c8c231cb7fd6d...41afc73c9c1399a946f579894ed795c89daeff25,2,11,7,18,7,2009-10-14 18:52:01,2009-10-14 18:52:01
e6069e40d9673de8d0824fef22e387a8527883ef...0ca301655e98b29c9d9e02c4963f8f9c7b4ee8c4,7,38,14,52,12,2009-10-09 14:12:19,2009-10-09 14:12:19
e6069e40d9673de8d0824fef22e387a8527883ef...8269a86c5fb51a2938cac34ab0f4752d70605edd,1,1,1,2,1,2009-10-08 23:45:49,2009-10-08 23:45:49
8269a86c5fb51a2938cac34ab0f4752d70605edd...39e85295584e438fa7b31369beaedb36593a2a68,1,0,8,8,1,2009-10-09 00:01:51,2009-10-09 00:01:51
39e85295584e438fa7b31369beaedb36593a2a68...55757f1547572b45910a933e742429aba84d7deb,1,4,0,4,1,2009-10-09 00:02:02,2009-10-09 00:02:02
55757f1547572b45910a933e742429aba84d7deb...b0b6fbbe360fc86dce164abe0d352c7e8f52e6d3,1,0,1,1,1,2009-10-09 01:37:13,2009-10-09 01:37:13
41afc73c9c1399a946f579894ed795c89daeff25...c43df1e5757f586202db6ddc957476e2a69cca09,7,61,30,91,32,2009-10-14 19:48:13,2009-10-14 19:48:13
41afc73c9c1399a946f579894ed795c89daeff25...f07a04bf341b806c9e45670ebd1a5311977a8591,1,2,1,3,1,2009-10-14 19:15:38,2009-10-14 19:15:38
f07a04bf341b806c9e45670ebd1a5311977a8591...87d435a70679fdc812dc68d98da274b320e04d39,2,1,1,2,2,2009-10-14 19:36:49,2009-10-14 19:36:49
1119ad03f26129128be67fd755e4124ae8679155...445c662ffc5b41108a4401489aeb3eb7c6830c33,3,30,3,33,10,2009-10-09 15:32:41,2009-10-09 15:32:41
445c662ffc5b41108a4401489aeb3eb7c6830c33...ff9100630e2a5adaf5106c8b31e718d991d27ab7,1,8,0,8,1,2009-10-09 15:55:56,2009-10-09 15:55:56
e36facf0a1377ef4ac1c8e6091c8bbd590c94bf0...6641b275590663a58ad9687eefac59313a48435e,2,3,1,4,2,2009-10-14 19:59:55,2009-10-14 19:59:55
e36facf0a1377ef4ac1c8e6091c8bbd590c94bf0...ec8def516bf0e610c9d0fe9b3d54de34e9e97ff6,1,1,1,2,1,2009-10-14 19:54:13,2009-10-14 19:54:13
28820dd01cb21738ffa2205692ce93f07bb5c587...12bf0ac29b041780b31a9c2b66ad755b3e02201b,1,4,0,4,2,2009-10-09 17:37:30,2009-10-09 17:37:30
ff9100630e2a5adaf5106c8b31e718d991d27ab7...9c3215b828c827c5c928e4dc267abc731cec5df2,1,1,0,1,1,2009-10-09 17:09:45,2009-10-09 17:09:45
9c3215b828c827c5c928e4dc267abc731cec5df2...ff170c0f9f825764d59bdb0c05efc5b95ef2ea61,3,32,26,58,13,2009-10-09 17:10:04,2009-10-09 17:10:04
d1ed8ec3b0e81a78328a492f2984de6c5b5fc764...ddcf5eeb32d0778b80f5b9538026b3631bee6917,8,15,7,22,10,2009-10-14 20:29:32,2009-10-14 20:29:32
d1ed8ec3b0e81a78328a492f2984de6c5b5fc764...2295bf1ec97dedd00fffe4daa959ce93644f2b2d,3,25,11,36,13,2009-10-14 20:19:13,2009-10-14 20:19:13
12bf0ac29b041780b31a9c2b66ad755b3e02201b...ff54f162713ba46f330ea22eef395f339195c0b1,19,123,69,192,51,2009-10-09 18:59:44,2009-10-09 18:59:44
ff170c0f9f825764d59bdb0c05efc5b95ef2ea61...35bb22d27ec01753a2507d19c3b2822cf29a8dbf,1,0,10,10,3,2009-10-09 17:48:57,2009-10-09 17:48:57
35bb22d27ec01753a2507d19c3b2822cf29a8dbf...0496aa5ac7e1a99b082f5375c38da9871d08847c,8,280,145,425,18,2009-10-09 18:55:29,2009-10-09 18:55:29
8566c4ec1032a14e9de9951d97f3657db19ed9d7...06aa85b12e4e1f5ef3efebe396a34510ee980c00,1,1,1,2,1,2009-10-14 20:34:25,2009-10-14 20:34:25
06aa85b12e4e1f5ef3efebe396a34510ee980c00...a3670180a99654f6f4b84b4edfab670a38804d62,1,1,1,2,1,2009-10-14 20:41:23,2009-10-14 20:41:23
a3670180a99654f6f4b84b4edfab670a38804d62...409e8b6db4027ca0e56a52a435e493ef25ec8cf9,1,1,0,1,1,2009-10-14 20:57:03,2009-10-14 20:57:03
409e8b6db4027ca0e56a52a435e493ef25ec8cf9...3dddfe2a7a677033d1dec28db402bfee71528035,1,2,1,3,1,2009-10-14 20:57:11,2009-10-14 20:57:11
3dddfe2a7a677033d1dec28db402bfee71528035...b7a086e1ad9c49c5e483e418c22b8c85f19a99b6,2,47,35,82,12,2009-10-14 21:43:18,2009-10-13 00:02:59
b7a086e1ad9c49c5e483e418c22b8c85f19a99b6...23bbf840badc77c13f1949bed3c4c5c993e70c38,3,23,12,35,8,2009-10-14 21:43:18,2009-10-13 21:57:59
23bbf840badc77c13f1949bed3c4c5c993e70c38...349132d1f576c61b4080807f6df8f200ea4912b7,1,1,0,1,1,2009-10-14 21:43:18,2009-10-14 19:50:27
349132d1f576c61b4080807f6df8f200ea4912b7...5bcc5521bb19e0ffff21ae8a6baa6763a00207c2,1,6,4,10,1,2009-10-14 22:12:55,2009-10-14 22:12:55
5bcc5521bb19e0ffff21ae8a6baa6763a00207c2...468b56691b91b16dd2f109b9e12ec7df316db084,1,7,0,7,2,2009-10-14 22:19:14,2009-10-14 22:19:14
468b56691b91b16dd2f109b9e12ec7df316db084...72dc2b9c22b8e939120a8ded299b56eb9bddfca4,1,7,4,11,1,2009-10-15 01:53:17,2009-10-15 01:53:17
72dc2b9c22b8e939120a8ded299b56eb9bddfca4...209ee5f43eb6bc9cf05f03dcd2f44c7f020f5680,1,1,1,2,1,2009-10-15 04:56:51,2009-10-15 04:56:51
209ee5f43eb6bc9cf05f03dcd2f44c7f020f5680...7ef85dd765ff464ac235b015d1fd215bcd843aed,1,7,2,9,1,2009-10-15 15:25:41,2009-10-15 15:25:41
7ef85dd765ff464ac235b015d1fd215bcd843aed...415f55421992c2eb2b992974d9633eb50d74ab7f,1,38,16,54,14,2009-10-15 15:26:15,2009-10-15 15:26:15
415f55421992c2eb2b992974d9633eb50d74ab7f...adfc0973c0e0a2f07e71c33b4cf7ccc3d1efc596,2,24,8,32,13,2009-10-15 15:26:51,2009-10-15 15:26:51
adfc0973c0e0a2f07e71c33b4cf7ccc3d1efc596...a3dc8e28a8bcc772161de8fb1cb292e12ba2f1e0,2,12,9,21,9,2009-10-15 15:27:02,2009-10-15 15:27:02
a3dc8e28a8bcc772161de8fb1cb292e12ba2f1e0...2894fe7b3551a9951ac50df40f5737f2be1cfa2c,2,4,4,8,4,2009-10-15 15:38:39,2009-10-15 15:38:39
67e37aa4b9db3168b1ba748d85bf5b9457d7630c...b5a5b5deb48c8094146641efe193c6ff80007867,1,1,0,1,1,2009-10-09 19:24:27,2009-10-09 19:24:27
b5a5b5deb48c8094146641efe193c6ff80007867...792c7c775abbdd9966367e467e6abf891ef69579,1,7,1,8,4,2009-10-09 19:32:05,2009-10-09 19:32:05
792c7c775abbdd9966367e467e6abf891ef69579...503d45411b3900764cc353f86cb33e4c04f7c35c,1,1,0,1,1,2009-10-10 00:58:41,2009-10-10 00:58:41
503d45411b3900764cc353f86cb33e4c04f7c35c...6e67c98509d80d88859a23548205d09a6d7d9b4a,1,1,1,2,1,2009-10-10 01:01:32,2009-10-10 01:01:32
6e67c98509d80d88859a23548205d09a6d7d9b4a...8a6dfdc9e967dca275720391dfa297087d4337c0,7,158,4,162,10,2009-10-10 02:11:15,2009-10-10 02:11:15
8a6dfdc9e967dca275720391dfa297087d4337c0...96d0418d96ccc5c5ff13330551b85410a30bd155,8,1035,36,1071,31,2009-10-10 05:30:00,2009-10-10 05:30:00
96d0418d96ccc5c5ff13330551b85410a30bd155...7885b8a7c0777765122d2fab23f3ad51d43c4bc3,4,0,1274,1274,4,2009-10-10 05:32:39,2009-10-10 05:32:39
2894fe7b3551a9951ac50df40f5737f2be1cfa2c...9ff72bdd61f68d56843e67631cc34c6c66167261,2,33,2,35,6,2009-10-15 19:44:50,2009-10-15 19:44:50
2894fe7b3551a9951ac50df40f5737f2be1cfa2c...4f16017dc4c53c311d2f44ebc0cff4432254c1ed,1,1,1,2,1,2009-10-15 16:42:00,2009-10-15 16:41:36
4f16017dc4c53c311d2f44ebc0cff4432254c1ed...f84a1f2429320be49d1a9f2ead3097074523863b,2,28,0,28,3,2009-10-15 17:59:30,2009-10-15 17:59:30
f84a1f2429320be49d1a9f2ead3097074523863b...8037dc89bfe27205a3bcec84ff94b673900ba032,2,6,3,9,3,2009-10-15 18:08:40,2009-10-14 17:21:25
8037dc89bfe27205a3bcec84ff94b673900ba032...e3caa5ec46c1cd4773d6f6543f444638b96e6e0a,1,1,1,2,1,2009-10-15 18:08:40,2009-10-15 14:21:17
e3caa5ec46c1cd4773d6f6543f444638b96e6e0a...d6a19bb42d82bf18813ef11c4e0bc48836cef065,1,1,1,2,1,2009-10-15 18:08:40,2009-10-15 14:22:16
d6a19bb42d82bf18813ef11c4e0bc48836cef065...326f612a9862661377b58c707112fa552ea81209,2,4,2,6,3,2009-10-15 19:23:53,2009-10-15 19:23:53
7885b8a7c0777765122d2fab23f3ad51d43c4bc3...b132ff2a9f56071ff7aaeca382667e5c0b707e12,1,1,1,2,1,2009-10-10 18:29:22,2009-10-10 18:29:22
81082c8d7f0ca1207c39b4535c020214ce4728eb...9d96f7ec4597c6f40730216e3b7f95d6b0ea83a9,1,5,5,10,5,2009-10-15 19:49:54,2009-10-15 19:49:54
9d96f7ec4597c6f40730216e3b7f95d6b0ea83a9...7636df40d7910bcce2a138f6ec09398c1d9f3339,2,4,2,6,3,2009-10-15 20:07:14,2009-10-15 20:07:14
7636df40d7910bcce2a138f6ec09398c1d9f3339...0abfa82d540ae6e7fc25b58d30af37340b2f7ba8,1,11,11,22,11,2009-10-15 20:14:20,2009-10-15 20:13:53
0abfa82d540ae6e7fc25b58d30af37340b2f7ba8...98d994eb51b174c4f464194ccb2b406ed9e37230,1,5,3,8,2,2009-10-15 20:19:25,2009-10-15 20:19:25
326f612a9862661377b58c707112fa552ea81209...f152047f195cc9a2e9a6d9d327f1097593e0ba11,9,30,6,36,14,2009-10-15 20:47:35,2009-10-15 20:47:35
5696d65d835ad279ea5ae8bef6c51230fba15b0f...f22a8219799cdb931f3fb4332d39fb67bea6ab66,3,52,3,55,4,2009-10-16 01:19:24,2009-10-16 01:19:24
f22a8219799cdb931f3fb4332d39fb67bea6ab66...2660c0ca229a557692780784a2b8b1a8ba7afd1f,1,16,0,16,1,2009-10-16 01:22:50,2009-10-16 01:22:50
2660c0ca229a557692780784a2b8b1a8ba7afd1f...41f1b86b7a8bf4f6b4706c8693425bb8b8ce96e7,1,17,4,21,5,2009-10-16 13:01:56,2009-10-16 06:20:08
41f1b86b7a8bf4f6b4706c8693425bb8b8ce96e7...3ca19ea3a16d13d1d7784c300ed7bba95e19fabb,1,3,0,3,1,2009-10-16 13:01:56,2009-10-16 07:07:53
3ca19ea3a16d13d1d7784c300ed7bba95e19fabb...8a7c1d8c1de1001b3227d065790024252a1021eb,1,4,1,5,1,2009-10-16 14:20:30,2009-10-16 14:20:30
8a7c1d8c1de1001b3227d065790024252a1021eb...7a0324acadf71bb634722fd04ba2f95f5f78568f,1,4,1,5,1,2009-10-16 14:20:48,2009-10-16 14:20:48
7a0324acadf71bb634722fd04ba2f95f5f78568f...166c722630d5adb41889b8ee583cf1b03d1e5b37,3,54,9,63,8,2009-10-16 14:56:15,2009-10-16 14:56:15
166c722630d5adb41889b8ee583cf1b03d1e5b37...543ce2b8a5ebd38ca1a213dd36893abea0f959fe,1,1,7,8,1,2009-10-16 15:31:49,2009-10-16 15:31:49
166c722630d5adb41889b8ee583cf1b03d1e5b37...6880a8788d2dc22fd48013a4d80c7851636189e3,2,43,1,44,6,2009-10-16 15:25:55,2009-10-16 15:23:09
8ad5ff91141096eff85f0a33089dd3852c50374f...f634e700936bf0a26ee1492209e1fdb2811cfa00,5,10,12,22,11,2009-10-16 15:36:38,2009-10-16 15:36:38
f634e700936bf0a26ee1492209e1fdb2811cfa00...411b4d279ee726c141b44a8cf75a7bb2e602be03,1,2,1,3,2,2009-10-16 15:37:31,2009-10-16 15:37:31
411b4d279ee726c141b44a8cf75a7bb2e602be03...e48db1f60ad4a04ea01d80a3b8129819913b30d2,11,18,18,36,17,2009-10-16 15:39:59,2009-10-16 15:39:59
e48db1f60ad4a04ea01d80a3b8129819913b30d2...01f1f6915ddc7c1df8e79819418e44c751ead6b5,17,192,95,287,63,2009-10-16 19:36:34,2009-10-16 19:36:34
e48db1f60ad4a04ea01d80a3b8129819913b30d2...d8235205f5a5ccc47ae2b860f34c00bbff1a14a4,3,22,2,24,7,2009-10-16 16:46:06,2009-10-16 16:46:06
d8235205f5a5ccc47ae2b860f34c00bbff1a14a4...e401ac9c355d4c4bcfad47019e65cb8ee6f85cee,1,5,1,6,2,2009-10-16 16:54:31,2009-10-16 16:54:31
e401ac9c355d4c4bcfad47019e65cb8ee6f85cee...d3961ff7facda4fb50a824de0846581b2dcf851e,1,1,1,2,1,2009-10-16 17:57:03,2009-10-16 17:02:07
d3961ff7facda4fb50a824de0846581b2dcf851e...8b431fb9a906e9652119753e4c43db372d1a747d,1,4,3,7,3,2009-10-16 17:57:03,2009-10-16 17:46:29
8b431fb9a906e9652119753e4c43db372d1a747d...74d68a42d42b95434570eebb81e4c1221deec8fa,1,1,1,2,1,2009-10-16 17:57:03,2009-10-16 17:50:27
74d68a42d42b95434570eebb81e4c1221deec8fa...448e629a814bb32be6a4a959f2df26be1a6b5c60,2,34,34,68,17,2009-10-16 17:57:03,2009-10-16 17:54:06
448e629a814bb32be6a4a959f2df26be1a6b5c60...137b8b00b417a357a544ee3276c6d19712dc6d9c,2,2,2,4,2,2009-10-16 18:12:43,2009-10-16 18:12:43
137b8b00b417a357a544ee3276c6d19712dc6d9c...8635f22cd60073bf07012e9f7b0d4a5715b5319e,1,1,1,2,1,2009-10-16 19:08:27,2009-10-16 19:08:27
8635f22cd60073bf07012e9f7b0d4a5715b5319e...10e82eae73630f53e13107e8aaabd17f846986f7,2,19,1,20,2,2009-10-16 19:33:56,2009-10-16 19:33:56
5d858e346ef204b9eeaf43c83db6fe2cb17d70bd...349961ae9c786bb2dcc8bb826d517b9f41990422,5,10,9,19,9,2009-10-17 03:32:34,2009-10-17 03:32:34
349961ae9c786bb2dcc8bb826d517b9f41990422...117a9b68f9b7b3e45b2b807170684b0025c2a12e,4,73,9,82,13,2009-10-17 03:41:21,2009-10-17 03:41:21
117a9b68f9b7b3e45b2b807170684b0025c2a12e...55ada812dd87b7bfde54499b9755919e930b9add,2,42,13,55,10,2009-10-17 05:10:48,2009-10-17 05:10:48
55ada812dd87b7bfde54499b9755919e930b9add...b8d49098008f55124d4f435f75c0f4e1371a4e46,1,1,1,2,1,2009-10-18 00:52:23,2009-10-18 00:52:23
b8d49098008f55124d4f435f75c0f4e1371a4e46...b8963886b76a016725ae379a58b3c32ef519163c,1,1,1,2,1,2009-10-18 00:53:43,2009-10-18 00:53:43
b8963886b76a016725ae379a58b3c32ef519163c...14cd7183e68da45332df74618e7df2e584ade0f2,3,12,2,14,5,2009-10-18 01:39:08,2009-10-18 00:35:03
14cd7183e68da45332df74618e7df2e584ade0f2...c1500cab8d1d960f863af118aa660cd6e9fdca4c,1,2,0,2,1,2009-10-18 01:48:16,2009-10-18 01:48:16
c1500cab8d1d960f863af118aa660cd6e9fdca4c...0b9aa268ba6e1bf3fb98d979e29d4be19cae5381,1,2,0,2,1,2009-10-18 01:56:35,2009-10-18 01:56:35
0b9aa268ba6e1bf3fb98d979e29d4be19cae5381...a8bc6f958490799c9677f67a8f7a5262f52a41b0,4,7,4,11,7,2009-10-18 03:07:26,2009-10-18 03:07:26
a8bc6f958490799c9677f67a8f7a5262f52a41b0...510e48d6930b7f4de06326cfc6df7197d6af59f3,1,51,30,81,24,2009-10-19 00:48:08,2009-10-19 00:48:08
510e48d6930b7f4de06326cfc6df7197d6af59f3...4c2eb48f9f4d18d2290b181cef392c3619a71ca4,1,4,0,4,1,2009-10-19 01:12:57,2009-10-19 01:12:57
4c2eb48f9f4d18d2290b181cef392c3619a71ca4...f550a78a96b8d12ff3eb732782b3e926a4fed165,1,0,0,0,0,2009-10-19 11:22:47,2009-10-19 10:49:26
f550a78a96b8d12ff3eb732782b3e926a4fed165...01d4ff8d19afa57ba623f1b14442339190021075,1,1,1,2,1,2009-10-19 11:22:47,2009-10-19 10:50:02
01d4ff8d19afa57ba623f1b14442339190021075...11ea1f1504f32f2cd3ae0c3c115d983948c9321d,1,4,0,4,1,2009-10-19 11:22:47,2009-10-19 10:50:33
11ea1f1504f32f2cd3ae0c3c115d983948c9321d...78ab7365b4c8699de95c35d9d057cfcf2696d98a,1,17,0,17,1,2009-10-19 13:52:45,2009-10-19 13:52:45
78ab7365b4c8699de95c35d9d057cfcf2696d98a...529167b0f5d5cf0d8d1df71d28f4a6265a9f1c8f,3,775,748,1523,3,2009-10-19 14:13:23,2009-10-19 14:13:23
529167b0f5d5cf0d8d1df71d28f4a6265a9f1c8f...f81362eb25768db22911ed577a0364c3863fb52c,1,6,3,9,3,2009-10-19 15:00:43,2009-10-19 15:00:43
f81362eb25768db22911ed577a0364c3863fb52c...a78cb6681caf611597367d5d30577c2bd1342e34,4,104,0,104,6,2009-10-19 15:00:53,2009-10-19 15:00:53
a78cb6681caf611597367d5d30577c2bd1342e34...fcbca1e70760481c6e544229adf6f5a8d24921bf,5,34,29,63,13,2009-10-19 16:14:20,2009-10-19 16:14:20
fcbca1e70760481c6e544229adf6f5a8d24921bf...691ac521d21663e98a707d45a6a2be536002d685,2,24,16,40,14,2009-10-19 17:25:53,2009-10-19 17:25:53
691ac521d21663e98a707d45a6a2be536002d685...8edc1244187ba4addaa6e560cc24e86fe29e75df,1,14,1,15,1,2009-10-19 17:29:12,2009-10-19 17:29:12
8edc1244187ba4addaa6e560cc24e86fe29e75df...314385b97eac406f3b117eaf7b0a0d70f8d4e532,4,21,10,31,9,2009-10-19 19:30:16,2009-10-19 19:30:16
8edc1244187ba4addaa6e560cc24e86fe29e75df...4f83c02fcc30972f8ec0487bbb870635e49ff2ec,1,2,4,6,1,2009-10-19 18:29:50,2009-10-19 16:54:34
4f83c02fcc30972f8ec0487bbb870635e49ff2ec...8190d8db538c629973a3a581a97251b22b668c7a,4,71,15,86,11,2009-10-19 18:30:46,2009-10-19 16:59:42
91328adb2d2a60b788547e95d9f7825c6370780a...a606c7a6b8dc211960b064a6203dc822956f5471,5,27,17,44,18,2009-10-19 20:53:58,2009-10-19 20:53:58
a606c7a6b8dc211960b064a6203dc822956f5471...b2b90b5568d742577cb0acbcf3e9561432bf21cd,2,8,1,9,2,2009-10-20 15:13:33,2009-10-20 15:13:33
b2b90b5568d742577cb0acbcf3e9561432bf21cd...844d96c19f45fba8c3eb1ed08df95493fc76ec98,13,267,106,373,70,2009-10-21 20:00:40,2009-10-21 20:00:40
b2b90b5568d742577cb0acbcf3e9561432bf21cd...672f2821af24bc31d16b9ef9133b5b5ce177bf8f,3,9,3,12,6,2009-10-20 17:29:05,2009-10-20 17:29:05
672f2821af24bc31d16b9ef9133b5b5ce177bf8f...8615f7d1cd2a4443b4ae6d2ce478d638021cfcab,1,5,0,5,2,2009-10-20 20:15:27,2009-10-20 20:15:27
8615f7d1cd2a4443b4ae6d2ce478d638021cfcab...4c856f6e8f664708cd8e03065430c9a61e454eb7,1,1,6,7,3,2009-10-20 20:20:22,2009-10-20 20:20:22
4c856f6e8f664708cd8e03065430c9a61e454eb7...c33f5a88a9206e6ae3ca4d78818bf4763afb353c,1,28,0,28,1,2009-10-20 20:45:33,2009-10-20 20:45:33
c33f5a88a9206e6ae3ca4d78818bf4763afb353c...1e1df0e4346cf50cef8c4cf7256877b3c63a9dd3,3,12,6,18,7,2009-10-20 21:31:52,2009-10-20 21:31:52
c33f5a88a9206e6ae3ca4d78818bf4763afb353c...d5415567a77e28e5e08a748e5cbb4023be77684f,1,16,6,22,6,2009-10-20 21:04:49,2009-10-20 21:04:49
458d202dc93efa3dba3f13c01f78bd02aa5ae58e...1d4aa0a204c3317ccb81f47380923352ba4a6a6d,1,3,3,6,1,2009-10-21 20:12:48,2009-10-21 20:12:48
1d4aa0a204c3317ccb81f47380923352ba4a6a6d...52333b5e73b36cf1436168c53b2e3bc27e493303,2,8,2,10,4,2009-10-21 20:40:31,2009-10-21 20:40:31
52333b5e73b36cf1436168c53b2e3bc27e493303...9e8b811472f2a801dde37d920a6b217724820bf1,1,1,1,2,1,2009-10-21 20:40:45,2009-10-21 20:40:45
9e8b811472f2a801dde37d920a6b217724820bf1...eeb0eae0bccbf7406501040adf8c140e4d4540d8,1,6,4,10,2,2009-10-21 22:29:27,2009-10-21 22:29:27
eeb0eae0bccbf7406501040adf8c140e4d4540d8...c737ba61df687a0c7e82b04277ec5a3b8f1c7e04,1,7,5,12,6,2009-10-22 00:47:45,2009-10-22 00:47:45
c737ba61df687a0c7e82b04277ec5a3b8f1c7e04...e8466f3dc5d2e8c7db7f1749d25d587d0ec0133e,6,124,20,144,26,2009-10-22 02:54:11,2009-10-22 02:54:11
e8466f3dc5d2e8c7db7f1749d25d587d0ec0133e...1bc6fff4e69d93f6f804a6df8d48dbf3469a6148,3,32,3,35,5,2009-10-22 13:43:31,2009-10-22 13:43:31
1bc6fff4e69d93f6f804a6df8d48dbf3469a6148...1d6e22725127dbf115fef9e318807e7f8eaf73a3,1,1,0,1,1,2009-10-22 14:41:08,2009-10-22 14:41:08
1d6e22725127dbf115fef9e318807e7f8eaf73a3...7e297a03c1efe22288548a913bdae853c3dd5def,1,37,35,72,16,2009-10-22 14:45:50,2009-10-22 14:45:50
7e297a03c1efe22288548a913bdae853c3dd5def...bf4e08f0f33451d2a041fa72d8df955a267d8fc2,2,8,0,8,3,2009-10-22 17:40:44,2009-10-22 17:40:44
bf4e08f0f33451d2a041fa72d8df955a267d8fc2...c66c479782e7ce7c8f9ed19a2d2d8cdf020fad5b,2,15,14,29,6,2009-10-23 01:38:02,2009-10-23 01:38:02
c66c479782e7ce7c8f9ed19a2d2d8cdf020fad5b...860a94f85281d73b50e056993881367491f7cabf,3,32,9,41,6,2009-10-23 01:40:45,2009-10-23 01:40:45
860a94f85281d73b50e056993881367491f7cabf...3146b3110b1652253c58eef014e2babebb175b2f,1,1,1,2,1,2009-10-23 03:46:03,2009-10-23 03:46:03
3146b3110b1652253c58eef014e2babebb175b2f...8fd95e2a1997849691ba00cab0e34c7111b53103,3,26,3,29,7,2009-10-23 03:47:39,2009-10-23 03:47:39
8fd95e2a1997849691ba00cab0e34c7111b53103...5ebb72b9eca43599738fbc62cd748ceff05e2016,1,5,2,7,2,2009-10-23 03:47:52,2009-10-23 03:47:52
5ebb72b9eca43599738fbc62cd748ceff05e2016...a50162fdbe73a7109c755d17df3164cc63b8132c,1,10,3,13,5,2009-10-23 03:48:12,2009-10-23 03:48:12
a50162fdbe73a7109c755d17df3164cc63b8132c...8633e5718131e4dd496d85ab2735eb28f5273132,1,0,2,2,2,2009-10-23 03:50:25,2009-10-23 03:50:25
8633e5718131e4dd496d85ab2735eb28f5273132...4c2cbf8a86d4dd1bf0fe4784d11ff7808a8a3642,1,0,1,1,1,2009-10-23 04:09:58,2009-10-23 04:09:58
4c2cbf8a86d4dd1bf0fe4784d11ff7808a8a3642...73ed0277ffabb283f315b1da18a90c9c889b4924,2,21,18,39,8,2009-10-23 15:13:08,2009-10-23 15:13:08
429f9517ab4ca8c9b254ed27f266db21a0103ad8...d188a16d18ef16f0bf4d48b40bdfd44bc6ae8fcd,1,14,5,19,5,2009-10-21 04:21:09,2009-10-21 04:21:09
d188a16d18ef16f0bf4d48b40bdfd44bc6ae8fcd...d54681458cad23fd6f4d1a2f5cfe8d8e15a9466e,5,71,15,86,14,2009-10-21 05:01:52,2009-10-21 05:01:52
d54681458cad23fd6f4d1a2f5cfe8d8e15a9466e...113cf4107d5b77fbbaef996d9c2db655ba66930f,1,2,1,3,1,2009-10-21 13:57:51,2009-10-21 13:57:51
113cf4107d5b77fbbaef996d9c2db655ba66930f...fb6971e9b468f894c9f4ddd7f3f83ca17acee93f,1,2,4,6,3,2009-10-21 14:14:45,2009-10-21 14:14:45
fb6971e9b468f894c9f4ddd7f3f83ca17acee93f...17568a92c47c6eb892221c74cc483d542b490378,5,92,12,104,15,2009-10-21 15:40:43,2009-10-21 15:40:43
17568a92c47c6eb892221c74cc483d542b490378...b446a74aec8e842f6caa638b9c4e80c6d6936df8,1,1,1,2,1,2009-10-21 18:04:31,2009-10-21 18:04:31
b446a74aec8e842f6caa638b9c4e80c6d6936df8...feb2a40d5ff3990c06a2cf8885ac964541163480,1,7,2,9,1,2009-10-21 18:17:58,2009-10-21 18:17:58
feb2a40d5ff3990c06a2cf8885ac964541163480...4774b56bf203db930dfd6493e9cb721070ae88bb,6,50,39,89,20,2009-10-21 19:18:21,2009-10-21 19:18:21
73ed0277ffabb283f315b1da18a90c9c889b4924...fe0226cd791007e63bc7f2e3244dbbdcd1cfdf7e,3,0,9,9,5,2009-10-24 18:34:54,2009-10-24 18:34:54
73ed0277ffabb283f315b1da18a90c9c889b4924...70e2ccab50a1d6e5d6232863117935aadf063974,1,1,1,2,1,2009-10-24 00:59:38,2009-10-24 00:59:38
4774b56bf203db930dfd6493e9cb721070ae88bb...7301029f4b226a5a790c7396ed0d18c1f49f874d,1,2,3,5,3,2009-10-21 20:01:46,2009-10-21 20:01:46
fe0226cd791007e63bc7f2e3244dbbdcd1cfdf7e...626aea91dfab263e8780b3624286ac332f20e8e0,1,3,2,5,3,2009-11-05 20:18:13,2009-11-05 20:18:13
69267a903265b7f70dd7777c569b74488ea4b9bc...8495bf5a337f749799769feab13c665efb56014f,1,23,23,46,2,2009-10-25 04:47:31,2009-10-25 04:47:31
8495bf5a337f749799769feab13c665efb56014f...ea9ae0425f87ea0d14d55c267ded87d3d6f2d5c2,2,2,1,3,2,2009-10-25 04:47:43,2009-10-25 04:47:43
ea9ae0425f87ea0d14d55c267ded87d3d6f2d5c2...6475aeecfb74746fef8a4e79149c5d29a0f9e772,1,1,2,3,2,2009-10-26 00:35:33,2009-10-26 00:35:33
6475aeecfb74746fef8a4e79149c5d29a0f9e772...65a1590594ca5b3efd147179e902966982e33eed,1,6,0,6,1,2009-10-26 04:36:57,2009-10-26 04:36:57
d8a0dc4bdbb3eed265dc29c16012994eae1ba2e1...8ca31804d2216179f4003a597dd84a792e2189e5,1,1,1,2,1,2009-11-06 13:18:44,2009-11-06 13:18:44
65a1590594ca5b3efd147179e902966982e33eed...31a1b75aa376914bd7845e965022ab0a68a174d7,2,13,9,22,5,2009-10-27 18:25:45,2009-10-27 18:25:45
65a1590594ca5b3efd147179e902966982e33eed...714aa47cbcd49d78ca19cd9a86c4f21945424658,1,4,0,4,1,2009-10-26 14:24:30,2009-10-26 14:24:30
714aa47cbcd49d78ca19cd9a86c4f21945424658...52f075cb13d2d863d7d3192a1cbf4489c8c73128,2,36,45,81,10,2009-10-26 15:20:45,2009-10-26 15:20:45
52f075cb13d2d863d7d3192a1cbf4489c8c73128...21964f0873a5f30d0f30d01f3db16561b0c966b0,2,84,13,97,11,2009-10-26 18:19:52,2009-10-26 18:19:52
21964f0873a5f30d0f30d01f3db16561b0c966b0...a361b49376426b95d04775ecf81d9b0a86d8f64c,2,70,7,77,3,2009-10-26 18:32:20,2009-10-26 18:32:20
a361b49376426b95d04775ecf81d9b0a86d8f64c...94f9c109bc7b96a51d4815a9068f1ec34c0df0cb,2,113,28,141,24,2009-10-26 21:20:33,2009-10-26 21:20:33
94f9c109bc7b96a51d4815a9068f1ec34c0df0cb...8fea4b6e73d1e39d5ac242e92cf5f8dc6ab11d2a,1,1,1,2,1,2009-10-26 21:26:38,2009-10-26 21:26:38
8fea4b6e73d1e39d5ac242e92cf5f8dc6ab11d2a...63e0ee59e4c68754a900f77c673b153a8c482f34,2,5,1,6,3,2009-10-27 01:10:45,2009-10-27 01:10:45
96047d90daca1498120c8324d3ba24461d55b981...428f988afe4aa9e3e0987d59e533947aaa927a30,2,21,4,25,7,2009-11-08 15:46:41,2009-11-08 15:46:41
96047d90daca1498120c8324d3ba24461d55b981...697ce04a25a2a0635227c6e8c8ef8ca01dc41ebf,1,40,1,41,2,2009-11-06 18:55:00,2009-11-06 18:55:00
697ce04a25a2a0635227c6e8c8ef8ca01dc41ebf...820c8e8db3fb5c9e6353e42196fe9ea0f68f4457,5,97,18,115,21,2009-11-06 18:57:01,2009-11-06 18:57:01
820c8e8db3fb5c9e6353e42196fe9ea0f68f4457...90949e1cc3868953d5a250b7e1c384b61da6d2de,1,3,0,3,1,2009-11-06 19:38:40,2009-11-06 19:38:40
90949e1cc3868953d5a250b7e1c384b61da6d2de...2364528abfb3f251911251ae5f7d133e4bb09f38,1,1,1,2,1,2009-11-06 21:25:57,2009-11-06 21:25:57
2364528abfb3f251911251ae5f7d133e4bb09f38...dfda4ccc393c53e49d7e2efde804434f99d81aba,4,160,3,163,11,2009-11-06 21:27:49,2009-11-06 21:27:49
dfda4ccc393c53e49d7e2efde804434f99d81aba...d0d19f97cfcae7e7115d1efe8eb7933d9a88e14c,1,4,2,6,1,2009-11-08 02:00:15,2009-11-08 02:00:15
36290f383b90a1b347583c89366b011f396e83ad...4a20517a71b639b0c9bb8fca7872cffa1bb0f143,1,8,0,8,1,2009-11-05 21:14:25,2009-11-05 21:14:25
4a20517a71b639b0c9bb8fca7872cffa1bb0f143...901abe74ebb80a8f60941788843337d060962938,1,4,7,11,4,2009-11-05 21:59:48,2009-11-05 21:59:39
63e0ee59e4c68754a900f77c673b153a8c482f34...d70e41008951d0e7319c61494abb4225b5971973,1,0,17,17,1,2009-10-27 15:34:53,2009-10-27 15:34:53
d70e41008951d0e7319c61494abb4225b5971973...2447360d90c52766c3d2529dea1aa283e2513004,2,30,9,39,4,2009-10-27 15:35:19,2009-10-27 15:35:19
63e0ee59e4c68754a900f77c673b153a8c482f34...24ce226aebf75aef8d97113a3d5ee6eceea08f52,1,1,1,2,1,2009-10-27 15:34:41,2009-10-27 15:11:10
91eda56a2a2172ab1a82b0a86de944a2e856faad...6e4f858c43548c43d789b88712374ba28dbe094f,4,36,89,125,18,2009-11-08 16:41:19,2009-11-08 16:41:19
6e4f858c43548c43d789b88712374ba28dbe094f...f6d06681413db0efbbca189ddf6e5e7cd6217349,7,186,15,201,19,2009-11-09 17:42:20,2009-11-09 17:42:20
f6d06681413db0efbbca189ddf6e5e7cd6217349...76d849e09077d1b3dbd5cad3fe296ca06e91119f,4,9,8,17,5,2009-11-09 18:10:30,2009-11-09 18:10:30
76d849e09077d1b3dbd5cad3fe296ca06e91119f...cbc63f0741a2e4c34e8ea8d90efd6b2762fed776,1,27,1,28,2,2009-11-09 20:21:16,2009-11-09 20:21:16
cbc63f0741a2e4c34e8ea8d90efd6b2762fed776...8f25fe33cf6f31a15896e9a3c4a96920d5b6cc7e,1,10,9,19,9,2009-11-09 20:21:37,2009-11-09 20:21:37
8f25fe33cf6f31a15896e9a3c4a96920d5b6cc7e...39c29494c1276808dd7c079c3f06b0907ecd6abe,1,32,18,50,6,2009-11-09 21:12:32,2009-11-09 21:12:32
39c29494c1276808dd7c079c3f06b0907ecd6abe...c04ee7b281c96551b96e97d1f42e6c72adee00f6,5,20,14,34,6,2009-11-09 22:08:25,2009-11-09 22:08:25
c04ee7b281c96551b96e97d1f42e6c72adee00f6...a2b62096929a59808b0300142bb1beaa246120d8,2,25,0,25,2,2009-11-10 03:25:37,2009-11-10 03:25:37
a2b62096929a59808b0300142bb1beaa246120d8...aa8b12e13fbbdfb293d94786dcc0df589cabef99,4,4,4,8,4,2009-11-10 16:00:43,2009-11-10 16:00:43
aa8b12e13fbbdfb293d94786dcc0df589cabef99...62ff89ad69bbc480b0bac3bd20df43636d8b1efa,2,2,2,4,2,2009-11-10 16:48:16,2009-11-10 16:48:16
62ff89ad69bbc480b0bac3bd20df43636d8b1efa...8af511ef9b8fab64893960b776b3682de6fb7932,2,19,0,19,2,2009-11-10 18:40:21,2009-11-10 18:40:21
8af511ef9b8fab64893960b776b3682de6fb7932...c47308b1b4c677d782b6f4ed516894bc5210774e,1,3,3,6,3,2009-11-10 18:49:15,2009-11-10 18:49:15
c47308b1b4c677d782b6f4ed516894bc5210774e...123cd0eb6734f397ebf4236e0779d056243446d4,3,65,1,66,5,2009-11-10 20:43:51,2009-11-10 20:43:51
123cd0eb6734f397ebf4236e0779d056243446d4...a3da013fabed286dc15a6400845b2f9ebd18d4d1,1,1,0,1,1,2009-11-10 21:55:26,2009-11-10 21:55:26
a3da013fabed286dc15a6400845b2f9ebd18d4d1...bb2e504105c6464522ca2415b1c11df0cb73550c,3,12,12,24,12,2009-11-10 22:28:51,2009-11-10 22:28:51
bb2e504105c6464522ca2415b1c11df0cb73550c...86b713fdffabbd2097cb7907fc9395d6bea63630,2,1,2,3,2,2009-11-10 22:49:47,2009-11-10 22:49:47
86b713fdffabbd2097cb7907fc9395d6bea63630...9f77794640db3a963aa0485e3bb4c33d3554946c,2,8,1,9,2,2009-11-11 18:02:04,2009-11-11 18:02:04
9f77794640db3a963aa0485e3bb4c33d3554946c...768e231da7976ee21252c9274d408b1cc805377a,4,254,247,501,12,2009-11-11 18:30:11,2009-11-11 18:30:11
768e231da7976ee21252c9274d408b1cc805377a...f9d031f12c99ed75c028c720318e71ab8e4727b9,3,25,6,31,5,2009-11-11 18:41:45,2009-11-11 18:41:45
f9d031f12c99ed75c028c720318e71ab8e4727b9...4dae04b643b82466a23c2d565227fbce7bc1d9e6,3,19,21,40,16,2009-11-11 18:54:05,2009-11-11 18:54:05
4dae04b643b82466a23c2d565227fbce7bc1d9e6...6f0dce36a5d60452d13cf6a5ab9a2276a6b77a32,4,36,38,74,22,2009-11-11 21:02:47,2009-11-11 21:02:47
6f0dce36a5d60452d13cf6a5ab9a2276a6b77a32...9b340c2f62b29ba17ff683ba5f983a496e8c8037,1,3,1,4,1,2009-11-11 21:04:52,2009-11-11 21:04:52
9b340c2f62b29ba17ff683ba5f983a496e8c8037...dbf7bce04ba69677236ebc570f36050fd3bc4fa3,1,31,21,52,2,2009-11-11 21:25:58,2009-11-11 21:25:58
dbf7bce04ba69677236ebc570f36050fd3bc4fa3...0630b33340d208dee0ba2cdb1e5227540c6eda81,2,51,61,112,15,2009-11-12 18:56:28,2009-11-12 18:56:28
0630b33340d208dee0ba2cdb1e5227540c6eda81...d0958dc1156a34b83b50186f1102f6b46c156d1d,3,63,6,69,12,2009-11-12 19:27:18,2009-11-12 19:27:18
d0958dc1156a34b83b50186f1102f6b46c156d1d...2b3ecd70b5585d97aa3d4d06a3bf7eb200fae19d,2,14,4,18,3,2009-11-12 21:01:35,2009-11-12 21:01:35
2b3ecd70b5585d97aa3d4d06a3bf7eb200fae19d...045a22df7ab48491b52bdb257ed29a8ebba68a8e,4,39,2,41,4,2009-11-13 16:08:42,2009-11-13 16:08:42
045a22df7ab48491b52bdb257ed29a8ebba68a8e...1557dc68d0c8cb4efb5dc8868a85279b39271bd5,3,81,1,82,3,2009-11-13 22:23:41,2009-11-13 22:23:41
1557dc68d0c8cb4efb5dc8868a85279b39271bd5...7db9f7ee87339b703d309f97fa20c17e243c5bad,1,12,25,37,3,2009-11-13 22:26:00,2009-11-13 22:26:00
7db9f7ee87339b703d309f97fa20c17e243c5bad...9d9600893812bc2d8def36ad9aacdb923556074b,1,20,0,20,1,2009-11-13 22:27:54,2009-11-13 22:27:54
9d9600893812bc2d8def36ad9aacdb923556074b...02dfcf62e7136b0b1dc74d9c9fe8e37a020d7b8f,1,2,1,3,1,2009-11-14 01:41:36,2009-11-14 01:41:36
02dfcf62e7136b0b1dc74d9c9fe8e37a020d7b8f...ca785a040086939005a88b06fa77f9133751450e,4,87,46,133,7,2009-11-14 02:07:15,2009-11-14 02:07:15
ca785a040086939005a88b06fa77f9133751450e...5946dbf4455f8e190bcc998d7c8b191ab732cb12,1,1,1,2,1,2009-11-14 02:19:38,2009-11-14 02:19:38
5946dbf4455f8e190bcc998d7c8b191ab732cb12...0d656aa0478d18d6a26e5f0cf14b8e3cb6bda8e4,2,7,1,8,3,2009-11-14 17:31:54,2009-11-14 17:31:54
0d656aa0478d18d6a26e5f0cf14b8e3cb6bda8e4...df71e4dcdcc2bc3f12258aa1214a92f95b9d5a0d,1,1,1,2,1,2009-11-15 03:11:15,2009-11-15 03:11:15
df71e4dcdcc2bc3f12258aa1214a92f95b9d5a0d...5edbfbc471aa781c9b20b4cfdbcb09569fb269ea,1,4,3,7,2,2009-11-15 17:45:17,2009-11-15 17:45:17
5edbfbc471aa781c9b20b4cfdbcb09569fb269ea...018511b3666f1bbc6fa4225190e3ebf95f5e3163,3,3,3,6,3,2009-11-16 16:33:57,2009-11-16 16:33:57
7515e47dacebf65c3d3adcd7126e76c7b5b66495...91e18dc16baf777cd3014b9cd8833c820e9ee3fc,2,12,3,15,5,2009-10-27 15:44:22,2009-10-27 15:44:22
91e18dc16baf777cd3014b9cd8833c820e9ee3fc...3eb4295ae939aa2cd3048e33e0792b64408d0877,1,2,0,2,2,2009-10-27 15:52:37,2009-10-27 15:52:37
3eb4295ae939aa2cd3048e33e0792b64408d0877...be1b3de4ca39acff3db7088a4f50719f0b9d09bb,2,9,0,9,2,2009-10-27 16:56:59,2009-10-27 16:56:59
018511b3666f1bbc6fa4225190e3ebf95f5e3163...37540835acdde03cab0dd6f32ebaf812118438b2,5,19,3,22,7,2009-11-16 20:55:03,2009-11-16 20:55:03
018511b3666f1bbc6fa4225190e3ebf95f5e3163...c8b48787b5e201bfa0bdcc31a8031aa51a51764e,1,23,2,25,5,2009-11-16 20:53:40,2009-11-16 20:53:40
1a3b7c3661e841339956dfc2390d22b9322348ec...25a9ee68ec9942ad12fd55b0cc7f68478aa936c9,2,1,9,10,3,2009-10-28 20:59:40,2009-10-28 20:59:40
25a9ee68ec9942ad12fd55b0cc7f68478aa936c9...60ae7d23602521fdbce3e98be407cd9c7f5c5189,1,20,1,21,4,2009-10-29 15:23:26,2009-10-29 15:23:26
60ae7d23602521fdbce3e98be407cd9c7f5c5189...a770c37bd882651f3f7dcc9e3233421434d7c1af,1,23,0,23,2,2009-10-29 15:58:32,2009-10-29 15:58:32
a770c37bd882651f3f7dcc9e3233421434d7c1af...c423f4cb6fee76dc7528e5b951402b1cb094e82f,1,9,5,14,1,2009-10-29 15:59:27,2009-10-29 15:59:27
c423f4cb6fee76dc7528e5b951402b1cb094e82f...aa6fc17f57fde41a8af15e62998ebd1057b493e6,1,8,1,9,2,2009-10-29 15:59:38,2009-10-29 15:59:38
aa6fc17f57fde41a8af15e62998ebd1057b493e6...f9cf3d47a0a2844a91e232dec49f8f277d5fd681,1,45,22,67,15,2009-10-29 16:00:04,2009-10-29 16:00:04
f9cf3d47a0a2844a91e232dec49f8f277d5fd681...2dcaea56d356f6d6bd6df838e8f49d72dce708cf,1,1,1,2,1,2009-10-29 16:06:16,2009-10-29 16:06:16
2dcaea56d356f6d6bd6df838e8f49d72dce708cf...944f8d43cefc598204c9f329db1722018688b272,1,14,14,28,6,2009-10-29 16:10:58,2009-10-29 16:10:58
944f8d43cefc598204c9f329db1722018688b272...d7544326abb0a6b7d6c3fc0b33c1afe0e1711c86,1,1,3,4,2,2009-10-29 20:06:35,2009-10-29 20:06:35
d7544326abb0a6b7d6c3fc0b33c1afe0e1711c86...fdcff3645eaea1c5a6ef6d7b0f6cfd7ebb6ef47e,7,31,18,49,16,2009-10-29 20:07:06,2009-10-29 20:07:06
fdcff3645eaea1c5a6ef6d7b0f6cfd7ebb6ef47e...90eceb3c9170badaa89e8d33d3f31840f19283b0,2,7,1,8,2,2009-10-29 20:14:43,2009-10-29 20:14:43
90eceb3c9170badaa89e8d33d3f31840f19283b0...de7fe40a96248c474677214f7030d27feb06d965,1,12,0,12,1,2009-10-29 21:19:23,2009-10-29 21:19:23
de7fe40a96248c474677214f7030d27feb06d965...e0c377e0ee5f47c801d5b85c0a268075fbb15f79,2,7,7,14,4,2009-10-30 19:50:21,2009-10-30 19:50:21
e0c377e0ee5f47c801d5b85c0a268075fbb15f79...30185da24af868607e1eea21b8dd26b6c06b5d08,2,27,12,39,11,2009-10-30 19:51:23,2009-10-30 19:51:23
30185da24af868607e1eea21b8dd26b6c06b5d08...2878fc0b5e402938c3c5e172a028289ef0ab4401,2,42,11,53,6,2009-10-30 19:52:54,2009-10-30 19:52:54
2878fc0b5e402938c3c5e172a028289ef0ab4401...b98067022f560a52793a429ca2327000bcaced4a,1,8,0,8,2,2009-10-31 15:23:29,2009-10-31 15:23:29
b98067022f560a52793a429ca2327000bcaced4a...d9f5e91892ba0c9f02b74d6e911d8986ad8988ce,1,9,1,10,4,2009-11-02 01:18:37,2009-11-02 01:18:37
d9f5e91892ba0c9f02b74d6e911d8986ad8988ce...48ae894e3f3eacc3e0472d021d2cf87e8ebff39e,1,1,1,2,1,2009-11-02 01:19:00,2009-11-02 01:19:00
48ae894e3f3eacc3e0472d021d2cf87e8ebff39e...9ecceafbca1c0f88ec69aa659f12a7098f563095,1,17,0,17,2,2009-11-02 04:29:20,2009-11-02 04:29:20
9ecceafbca1c0f88ec69aa659f12a7098f563095...d1057d5a9dbb916ed57a2b00900884d417bbf3c0,1,9,3,12,3,2009-11-02 14:52:58,2009-11-02 14:52:58
d1057d5a9dbb916ed57a2b00900884d417bbf3c0...8ca8a7b1a7fb7fafdfe630021a755d110d02fbb5,2,19,2,21,5,2009-11-02 15:40:19,2009-11-02 15:40:19
8ca8a7b1a7fb7fafdfe630021a755d110d02fbb5...a782eb24c348117a598b72175392d390f48d066a,4,11,13,24,10,2009-11-02 15:47:29,2009-11-02 15:47:29
a782eb24c348117a598b72175392d390f48d066a...d22098f810037a27a8bdb978b46c8adb2f3a39e7,3,27,42,69,29,2009-11-02 15:51:42,2009-11-02 15:51:42
d22098f810037a27a8bdb978b46c8adb2f3a39e7...39645a27394eddfaf41e7d503e8406405d6b7154,3,0,121,121,10,2009-11-02 16:00:49,2009-11-02 16:00:49
be1b3de4ca39acff3db7088a4f50719f0b9d09bb...5b8a87f0245c76f5c8ead8f7c4ff2c7cc823f650,1,3,1,4,1,2009-10-27 19:11:07,2009-10-27 18:07:41
5b8a87f0245c76f5c8ead8f7c4ff2c7cc823f650...d27c8505eac9299b517538d97cd5ead4d185d1f6,87,1248,727,1975,116,2009-10-27 19:59:37,2009-10-27 19:58:27
d27c8505eac9299b517538d97cd5ead4d185d1f6...ef6bc688823ec3cb3cb8ccb60467afe11ddc82b2,4,18,0,18,4,2009-10-27 20:23:07,2009-10-27 20:23:07
e60c3ea61c878f5516956298b01da70dc4722922...63fa175a9bc2722b4e6e6359ee75f4867d1fc0df,1,1,1,2,1,2009-11-17 18:17:07,2009-11-17 18:17:07
63fa175a9bc2722b4e6e6359ee75f4867d1fc0df...fd84836b8a1b50bf51bb627a2f296c6d61b526b8,8,181,227,408,27,2009-11-18 17:53:56,2009-11-18 17:53:56
fd84836b8a1b50bf51bb627a2f296c6d61b526b8...2a04857bcf7545574a0616d55ff752c184cd42a0,2,8,6,14,6,2009-11-18 18:11:13,2009-11-18 18:11:13
2a04857bcf7545574a0616d55ff752c184cd42a0...32fed6a14a26619e038d30d23e997513e4bea595,2,5,2,7,2,2009-11-18 18:59:01,2009-11-18 18:59:01
32fed6a14a26619e038d30d23e997513e4bea595...560185f6f14cfe3c8379fa5b5d3400ef5178f759,5,10,14,24,10,2009-11-18 19:22:00,2009-11-18 19:22:00
560185f6f14cfe3c8379fa5b5d3400ef5178f759...2e21112c7dfa56205d5560f08f3c1aee85ef3a08,2,8,2,10,4,2009-11-18 19:54:37,2009-11-18 19:54:37
2e21112c7dfa56205d5560f08f3c1aee85ef3a08...b6e7aafcd4d855de40c5c8d76342417b1d544018,2,8,8,16,6,2009-11-18 22:08:58,2009-11-18 22:08:58
b6e7aafcd4d855de40c5c8d76342417b1d544018...ee088fb8bbd42f7335188484ab0c901447e4570b,1,4,0,4,1,2009-11-18 22:19:26,2009-11-18 22:19:26
ee088fb8bbd42f7335188484ab0c901447e4570b...3607f69840a4072286cff140580a4144f06ce3ca,1,13,2,15,3,2009-11-19 01:37:00,2009-11-19 01:37:00
3607f69840a4072286cff140580a4144f06ce3ca...934525f8b160422ec2f1035ea00b3fa93b0cf22b,1,29,0,29,1,2009-11-19 15:03:42,2009-11-19 15:03:42
934525f8b160422ec2f1035ea00b3fa93b0cf22b...420a7e51f07a92e35d4c6c78358b974ad0e6b582,2,12,0,12,3,2009-11-19 15:07:59,2009-11-19 15:07:59
39645a27394eddfaf41e7d503e8406405d6b7154...7b8640f46867995ff755658ce6da62261c9ce1ba,2,5,2,7,3,2009-11-03 14:09:37,2009-11-03 14:09:37
39645a27394eddfaf41e7d503e8406405d6b7154...d79c6006e4d5659e91ff102225b602b3c74da0c0,2,24,2,26,4,2009-11-02 17:25:51,2009-11-02 17:25:51
ef6bc688823ec3cb3cb8ccb60467afe11ddc82b2...daaec9af98b14d09f4127b90f0aa4f7249a59ca7,1,0,7,7,3,2009-10-28 16:44:25,2009-10-26 15:53:24
daaec9af98b14d09f4127b90f0aa4f7249a59ca7...fc48a0fe454e212a63653a7063369f2e4ddb435b,5,102,71,173,23,2009-10-28 16:44:26,2009-10-28 15:52:23
fc48a0fe454e212a63653a7063369f2e4ddb435b...d5a99358f7f4ea39ae3c307580febbe45ffeea11,1,37,0,37,1,2009-10-28 16:44:26,2009-10-28 16:44:04
ef6bc688823ec3cb3cb8ccb60467afe11ddc82b2...0925cf6475cf2e009177eb9da8d95fbb07c4b6b1,1,5,0,5,1,2009-10-27 20:37:14,2009-10-27 20:37:14
420a7e51f07a92e35d4c6c78358b974ad0e6b582...9173ffaf11c89c1d0f89b6c1daef066b185b9f5e,1,12,24,36,7,2009-11-19 17:40:23,2009-11-19 17:40:23
420a7e51f07a92e35d4c6c78358b974ad0e6b582...571d3771c3c818dd10549ff2cbb72b797de7d320,3,62,49,111,6,2009-11-19 15:49:34,2009-11-19 15:49:34
571d3771c3c818dd10549ff2cbb72b797de7d320...07821d91c3de53b2cb62841e4a5cac65deafbe71,1,3,0,3,1,2009-11-19 16:19:40,2009-11-19 16:19:40
07821d91c3de53b2cb62841e4a5cac65deafbe71...253a1cd0cdd285e1b347f5df3e541ecf9980d99b,1,6,2,8,5,2009-11-19 16:19:48,2009-11-19 16:19:48
253a1cd0cdd285e1b347f5df3e541ecf9980d99b...e28a78dccd2fa946f0305280df55c920c5e838fe,2,15,0,15,3,2009-11-19 16:20:03,2009-11-19 16:20:03
771189511023688180b349391f7f1bba0e01da2d...d7a8eb644df4e93acc32c6094b43ab448a6ca1d8,1,1,1,2,1,2009-11-03 14:15:45,2009-11-03 14:15:45
d7a8eb644df4e93acc32c6094b43ab448a6ca1d8...f874b55f1ac769066e6ad1144a633eb0ff8d52e8,1,1,1,2,1,2009-11-03 14:43:24,2009-11-03 14:42:49
f874b55f1ac769066e6ad1144a633eb0ff8d52e8...3a1c9831c135fbef4bf02ac3458772196bd88038,14,530,283,813,41,2009-11-03 15:35:48,2009-11-03 15:35:48
3a1c9831c135fbef4bf02ac3458772196bd88038...6d5e43755d739b526d5b56c7a6c457e8f019a74b,5,127,30,157,23,2009-11-03 16:40:00,2009-11-03 16:40:00
6d5e43755d739b526d5b56c7a6c457e8f019a74b...05712a3965320065aa50b7398bca6467cc37fc64,4,41,7,48,5,2009-11-03 17:13:42,2009-11-03 17:13:42
05712a3965320065aa50b7398bca6467cc37fc64...aa15d45e9c4eb23a026b98a40c07eccd494cf0a1,1,2,3,5,3,2009-11-03 17:17:51,2009-11-03 17:17:51
aa15d45e9c4eb23a026b98a40c07eccd494cf0a1...d8fbead145525c2c79c798cc4b9b129b93c71083,1,4,0,4,1,2009-11-03 17:17:56,2009-11-03 17:17:56
d8fbead145525c2c79c798cc4b9b129b93c71083...8b23ad4f68243cdf1b11ace43ccd8b5f6d0e7b56,1,4,1,5,3,2009-11-03 18:01:07,2009-11-03 18:01:07
8b23ad4f68243cdf1b11ace43ccd8b5f6d0e7b56...6fd0beb957266bd5dee9beb68df99e4e18d30090,1,2,1,3,1,2009-11-03 18:02:39,2009-11-03 18:02:39
6fd0beb957266bd5dee9beb68df99e4e18d30090...093fe6825437a024b0229205c9c9812aba0c0574,1,1,1,2,1,2009-11-03 18:19:57,2009-11-03 18:19:57
d79c6006e4d5659e91ff102225b602b3c74da0c0...ccd4f093875dc2cd37396d7e854da8a4449e4676,2,33,4,37,5,2009-11-02 20:30:12,2009-11-02 20:30:12
ccd4f093875dc2cd37396d7e854da8a4449e4676...ac11d739e1e5d26ac1b16c7891351f53f340aa0f,1,6,6,12,6,2009-11-02 21:52:16,2009-11-02 21:52:16
d79c6006e4d5659e91ff102225b602b3c74da0c0...d7c527d437024a2ae101ee2279b6a200e6d3b074,2,92,70,162,3,2009-11-02 18:32:20,2009-11-02 17:35:06
d7c527d437024a2ae101ee2279b6a200e6d3b074...1acf77ce0cb080faae0b3127d32918e407a36f51,3,74,0,74,6,2009-11-02 18:32:20,2009-11-02 18:30:59
1acf77ce0cb080faae0b3127d32918e407a36f51...0c48803a9621ed4c7d62bd33dde0619e51ff90a7,1,2,3,5,2,2009-11-02 18:46:25,2009-11-02 18:46:25
9390f94cb4945124a31f5caa48d7cd4a0f3878ef...29f1a9fa2fc93e353f6e8a13911ca7a079876081,1,1,1,2,1,2009-10-28 17:41:38,2009-10-28 17:41:38
29f1a9fa2fc93e353f6e8a13911ca7a079876081...6529cbb29d9cd468cdf12ff7089a8f94f9495c7a,1,56,0,56,1,2009-10-28 18:31:47,2009-10-28 18:31:47
689c63ab501c9ee5117744ff222f245ce53d52c0...1c136572d66a7fc103026cbac7b5b053200e940c,1,1,1,2,1,2009-11-20 02:40:11,2009-11-20 02:40:11
1c136572d66a7fc103026cbac7b5b053200e940c...daaa53c4c52727a8e47e14da060ad436191c4555,4,38,4,42,4,2009-11-20 02:42:46,2009-11-20 02:42:46
daaa53c4c52727a8e47e14da060ad436191c4555...c7fb263e1a33883515e3f069fac3e5def7988359,1,2,2,4,1,2009-11-20 02:49:25,2009-11-20 02:49:25
c7fb263e1a33883515e3f069fac3e5def7988359...3e269473da363d680cefd19c0faf94125a0440db,1,15,1,16,2,2009-11-20 06:57:52,2009-11-20 06:57:19
3e269473da363d680cefd19c0faf94125a0440db...e93287ce336060abe037e7a819549eb17f4e8674,1,1,1,2,1,2009-11-20 16:44:10,2009-11-20 16:44:10
e93287ce336060abe037e7a819549eb17f4e8674...5b0a94ae0c091287b418c2b01ac22f1db58fe775,1,1,1,2,1,2009-11-20 18:24:26,2009-11-20 18:24:26
5b0a94ae0c091287b418c2b01ac22f1db58fe775...8eed8783083c333f24de758663d03bff55354009,1,8,1,9,2,2009-11-20 18:47:22,2009-11-20 18:47:22
8eed8783083c333f24de758663d03bff55354009...340f06ab2493625b283510208c3ea2a752328514,1,2,1,3,1,2009-11-20 19:24:20,2009-11-20 19:24:20
340f06ab2493625b283510208c3ea2a752328514...bed8ba812bd4280f405d4c66eebfee03991990ba,1,2,2,4,1,2009-11-22 02:31:37,2009-11-22 02:31:37
093fe6825437a024b0229205c9c9812aba0c0574...18e7e48ebd0b7eb426f13f913cd45bca725455ed,2,25,2,27,5,2009-11-03 19:44:41,2009-11-03 19:44:41
093fe6825437a024b0229205c9c9812aba0c0574...6e4852e1482ab95f68fdac928ef9c762ca87d11e,1,10,5,15,5,2009-11-03 18:23:13,2009-11-03 18:23:13
d680df473b47ed1da49ac86432c586a951aad34a...bf2467973f773b98535d3d2d8f6a0c6384390cfa,1,27,14,41,3,2009-11-02 23:56:29,2009-11-02 23:52:29
bf2467973f773b98535d3d2d8f6a0c6384390cfa...526e514bff09fb498034af61b5ac1bfa63a6e985,1,2,0,2,2,2009-11-02 23:56:29,2009-11-02 23:53:44
526e514bff09fb498034af61b5ac1bfa63a6e985...b92f5f3aa5c1fb4cfdd3dc81de3ff9ee8958d94f,1,26,0,26,2,2009-11-02 23:56:29,2009-11-02 23:54:44
b92f5f3aa5c1fb4cfdd3dc81de3ff9ee8958d94f...39a66ce531f21659df48362b0891e5f36b1dd36b,1,0,2,2,2,2009-11-03 06:56:40,2009-11-03 06:56:40
bed8ba812bd4280f405d4c66eebfee03991990ba...7eb8fab97ded16e1bd83db86e9a54f1d10cf9ad4,3,63,5,68,12,2009-11-23 03:05:46,2009-11-23 03:05:46
bed8ba812bd4280f405d4c66eebfee03991990ba...8397915d8f66486bf1456ac3951a97f915a15d23,3,22,1,23,4,2009-11-23 01:35:15,2009-11-23 00:33:43
03d189f51825c35dd545a5c435355f533965df86...8223d2d509075584794eb5adc6bc9b29f3d6d61a,2,4,1,5,2,2009-11-03 22:15:05,2009-11-03 22:15:05
8223d2d509075584794eb5adc6bc9b29f3d6d61a...6794c0eaf7b4f7cd75f3cd1c06e355f10f5f437c,1,17,0,17,2,2009-11-03 22:15:14,2009-11-03 22:15:14
03d189f51825c35dd545a5c435355f533965df86...80edd9e5cf1e30bce062917c7dc98e7c80f2397d,4,66,32,98,5,2009-11-03 21:39:55,2009-11-03 20:05:31
80edd9e5cf1e30bce062917c7dc98e7c80f2397d...6f7d89b01a3326b97937fd0ad76982efd5319a4a,1,1,0,1,1,2009-11-03 21:39:55,2009-11-03 20:10:24
6f7d89b01a3326b97937fd0ad76982efd5319a4a...9a815250184b11246100bed696728e26c9be7477,1,1,0,1,1,2009-11-03 21:39:55,2009-11-03 21:38:04
893346a0ac887190fa2dabf074e3ba97c9654599...455e3165fef44d6f144422a970c37c99d653f460,1,11,2,13,4,2009-11-23 03:52:38,2009-11-23 03:52:38
455e3165fef44d6f144422a970c37c99d653f460...1e388b0e6880adef288498d6b2e6d880879cef5d,1,28,27,55,5,2009-11-23 03:52:58,2009-11-23 03:52:58
1e388b0e6880adef288498d6b2e6d880879cef5d...f04da2c9ab9766e2c49bc2bf8bad6f73a2dfca28,1,31,0,31,1,2009-11-23 04:59:45,2009-11-23 04:59:45
f04da2c9ab9766e2c49bc2bf8bad6f73a2dfca28...53cf01bcc882957086574588b48b1025a7448d49,2,6,1,7,2,2009-11-23 05:38:53,2009-11-23 05:38:53
53cf01bcc882957086574588b48b1025a7448d49...e47b9a5452dfeae5d03cee09d56f9ff93edef285,2,6,6,12,4,2009-11-23 06:29:38,2009-11-23 06:29:38
e47b9a5452dfeae5d03cee09d56f9ff93edef285...6ecbbdebb7b39292d4be2b7c44211cfcee65ab7b,1,1,0,1,1,2009-11-23 13:59:46,2009-11-23 13:59:46
6ecbbdebb7b39292d4be2b7c44211cfcee65ab7b...14a6e978baa46850ee0360406a358dfcd0ab4fe2,1,1,1,2,1,2009-11-23 15:22:31,2009-11-23 15:22:31
14a6e978baa46850ee0360406a358dfcd0ab4fe2...edfdb6bfe8a4a26a0fd86ee768cdeb44c9324013,1,3,0,3,1,2009-11-23 16:26:49,2009-11-23 16:26:49
edfdb6bfe8a4a26a0fd86ee768cdeb44c9324013...33c85f0d84bbb72833e3f5f0ffe1612ae8243bdf,1,3,2,5,1,2009-11-23 16:33:27,2009-11-23 05:30:24
33c85f0d84bbb72833e3f5f0ffe1612ae8243bdf...498d87fe5b85c8bd3db9ecfb663e8ee53feebc71,2,14,3,17,7,2009-11-23 16:33:27,2009-11-23 16:30:01
498d87fe5b85c8bd3db9ecfb663e8ee53feebc71...3c71fb2ef96f8fe5655adef2afe513b6e88c9455,1,5,5,10,3,2009-11-24 03:41:49,2009-11-14 02:41:02
3c71fb2ef96f8fe5655adef2afe513b6e88c9455...705ec48cd9bb81ef85b7616b5d026e817e871fb7,5,52,4,56,10,2009-11-24 03:41:50,2009-11-24 02:36:10
705ec48cd9bb81ef85b7616b5d026e817e871fb7...4e9630f5d5b613050b9a040f665b534db81ffe03,2,6,1,7,2,2009-11-24 04:34:17,2009-11-24 04:34:17
77cacf845141149f16bbf101fd90e02dcc074b49...9871eb3591c94e2c8b9836b9263e7968c3d09595,1,16,10,26,8,2009-11-04 02:28:27,2009-11-04 02:28:27
9871eb3591c94e2c8b9836b9263e7968c3d09595...25dad379eb855a8408d17a05d4c33888f56ef95a,1,2,2,4,2,2009-11-04 03:47:14,2009-11-04 03:47:14
25dad379eb855a8408d17a05d4c33888f56ef95a...37baf952b83a24deeb98dc1a1e66adaed4e9a12b,1,11,0,11,1,2009-11-04 03:53:18,2009-11-04 03:53:18
37baf952b83a24deeb98dc1a1e66adaed4e9a12b...974dc89ad514256355a278536a337d573bedd52d,2,96,0,96,2,2009-11-04 03:53:32,2009-11-04 03:53:32
974dc89ad514256355a278536a337d573bedd52d...bdbd9143ed22f2e1d13177fe882ab4d7fab5c2f1,1,12,7,19,5,2009-11-04 03:56:49,2009-11-04 03:56:49
4e9630f5d5b613050b9a040f665b534db81ffe03...6ef4bd7aa62662d266ebb06a6c4f0c95280203e4,3,29,3,32,8,2009-11-24 23:09:20,2009-11-24 23:09:20
4e9630f5d5b613050b9a040f665b534db81ffe03...ea24725b8e4117f0dc28b0d2b4b22cb9bbdb1f55,4,21,7,28,7,2009-11-24 14:41:33,2009-11-24 14:41:33
bdbd9143ed22f2e1d13177fe882ab4d7fab5c2f1...f2f7104a5d814a0992630538b5f6d5213a14a902,1,1,1,2,1,2009-11-04 20:06:36,2009-10-30 18:23:39
f2f7104a5d814a0992630538b5f6d5213a14a902...305ebbe329b91d1257cb689aa977832a555deb97,1,0,5,5,1,2009-11-04 20:06:36,2009-11-02 16:01:35
305ebbe329b91d1257cb689aa977832a555deb97...6e135afa267fa1b0cf454d50c24f1f1ace79cbe3,3,4,8,12,3,2009-11-04 20:06:36,2009-11-02 20:16:29
6e135afa267fa1b0cf454d50c24f1f1ace79cbe3...19863b852e96cfe71e990e8fd3911916e574c8a1,2,25,8,33,11,2009-11-04 20:06:36,2009-11-02 20:37:15
19863b852e96cfe71e990e8fd3911916e574c8a1...9fcf4ba1ef07015ac560aebd1f1c45e343900f31,6,115,62,177,38,2009-11-04 20:06:36,2009-11-04 20:04:01
bdbd9143ed22f2e1d13177fe882ab4d7fab5c2f1...01c85879b1929e2d9117cc2361a9faade67aae8b,2,12,9,21,6,2009-11-04 19:48:36,2009-11-04 19:48:36
01c85879b1929e2d9117cc2361a9faade67aae8b...92d2689f1f633169f42191e1eeb0ffc0f5aeca33,1,11,1,12,3,2009-11-04 19:52:01,2009-11-04 19:52:01
92d2689f1f633169f42191e1eeb0ffc0f5aeca33...2dbc13e674091e4d67c0933be3018ee8e05c56ea,1,4,3,7,3,2009-11-04 19:52:11,2009-11-04 19:52:11
50abaa79366d9fbf70e33159ff4710b6330c086d...779f12d653c413cb35833d820340aaa886aed4f8,1,0,1,1,1,2009-11-25 20:54:58,2009-11-25 20:54:58
ea24725b8e4117f0dc28b0d2b4b22cb9bbdb1f55...1cdd8e876419b4617db28161e8eb4b812633e2ae,1,1,1,2,1,2009-11-24 18:08:26,2009-11-24 18:08:26
1cdd8e876419b4617db28161e8eb4b812633e2ae...0254bf6cf02c5b489728f88b4481cef43339586e,2,2,2,4,2,2009-11-24 18:08:36,2009-11-24 18:08:36
ea24725b8e4117f0dc28b0d2b4b22cb9bbdb1f55...bb1475d24de29984933e0ceca4bfb45f09fdfca4,1,7,4,11,1,2009-11-24 16:13:13,2009-11-24 16:13:13
bb1475d24de29984933e0ceca4bfb45f09fdfca4...76469ff66f940042312d5fc9e5ff6eaca2ef1daa,1,21,0,21,1,2009-11-24 17:01:32,2009-11-24 17:01:32
a5b8dc4e0def5566de33b70335bdc46b1e030f08...d5048b8e6c972899180b57e716e57d887c7dcfab,1,123,72,195,28,2009-11-04 20:25:45,2009-11-04 20:25:45
d5048b8e6c972899180b57e716e57d887c7dcfab...3818050a7d72ddd56a6ae95a177247c69dd1aabd,1,2,2,4,1,2009-11-04 22:09:03,2009-11-04 22:09:03
3818050a7d72ddd56a6ae95a177247c69dd1aabd...40f7fbff6d8bdc7e1c6d93de5f9a8bceb5fe0f4a,1,162,193,355,53,2009-11-04 22:11:17,2009-11-04 22:11:17
40f7fbff6d8bdc7e1c6d93de5f9a8bceb5fe0f4a...0dbf65df132b90e4a6daa062770d2769eedf5725,1,10,1,11,4,2009-11-04 22:34:59,2009-11-04 22:34:59
0dbf65df132b90e4a6daa062770d2769eedf5725...4aeeedc9f6731f416312ded0ff0bcc49bbbdd3d6,2,4,3,7,3,2009-11-05 02:48:49,2009-11-05 02:48:49
779f12d653c413cb35833d820340aaa886aed4f8...c44bff08fd95616302a73e92b48b2853c1fd948d,1,23,0,23,4,2009-11-28 03:27:04,2009-11-28 03:27:04
779f12d653c413cb35833d820340aaa886aed4f8...20d4e01e467ae51649fafd3561ec0d4755816cff,3,15,12,27,10,2009-11-27 21:40:58,2009-11-27 21:40:58
779f12d653c413cb35833d820340aaa886aed4f8...715b80c430388eb26bc95b9763da6c9e922a6953,1,4,4,8,2,2009-11-26 03:46:01,2009-11-26 03:46:01
de1b595ddf3e6afa9bd04f3f34142ea0d94098bf...8f1aea304a588d9d878812be99e145f31e4f5c72,1,1,1,2,1,2009-11-24 18:21:38,2009-11-24 18:21:38
8f1aea304a588d9d878812be99e145f31e4f5c72...d51dce22b3be522847fdb1f6f23fdbb56f0ba1f3,1,6,2,8,3,2009-11-24 18:38:57,2009-11-24 18:38:57
d51dce22b3be522847fdb1f6f23fdbb56f0ba1f3...0f5848f39892dd1f627ce135a540e375bbd4af42,1,1,0,1,1,2009-11-24 18:55:46,2009-11-24 18:55:46
0f5848f39892dd1f627ce135a540e375bbd4af42...7bb0b670e68f569a16079c1c418bbe3acf567d89,1,1,0,1,1,2009-11-24 18:56:41,2009-11-24 18:56:41
7bb0b670e68f569a16079c1c418bbe3acf567d89...a46dbe3daee74eda3b23acde0970b60eb301b8e9,6,76,4,80,16,2009-11-24 20:24:41,2009-11-24 20:24:41
a46dbe3daee74eda3b23acde0970b60eb301b8e9...314d24240c1833ba7cf950d91ade329beaf17587,1,1,6,7,2,2009-11-24 20:42:52,2009-11-24 20:42:52
314d24240c1833ba7cf950d91ade329beaf17587...0fb7289f3a17ff7a5ac1ac5d51e4651256c305b7,8,115,87,202,52,2009-11-24 22:28:57,2009-11-24 22:28:57
0fb7289f3a17ff7a5ac1ac5d51e4651256c305b7...09bd20c7a6c97a88c9b4e3973f9b43395bad0dbe,1,3,0,3,1,2009-11-25 04:09:44,2009-11-25 04:09:44
4aeeedc9f6731f416312ded0ff0bcc49bbbdd3d6...625190f3b1ac04ea3b1b8017c233631fed95a700,1,3,1,4,4,2009-11-05 20:41:51,2009-11-05 20:41:51
4aeeedc9f6731f416312ded0ff0bcc49bbbdd3d6...edd9f57e7f9ad6f6dc323f3d4c5872f97510bc18,2,20,0,20,3,2009-11-05 18:34:14,2009-11-05 16:27:26
edd9f57e7f9ad6f6dc323f3d4c5872f97510bc18...1ce5f2707b5a3ce2cade9bec6587a9e7b8614c2b,2,63,0,63,4,2009-11-05 18:34:14,2009-11-05 17:29:27
1ce5f2707b5a3ce2cade9bec6587a9e7b8614c2b...e863bb68d6357bbeef705e12da62a577477da436,2,36,19,55,14,2009-11-05 18:34:14,2009-11-05 17:55:33
e863bb68d6357bbeef705e12da62a577477da436...44498641eac992cb029f47a8f507fe16fe35c970,2,21,0,21,3,2009-11-05 18:34:14,2009-11-05 18:19:35
2420ed1d05a0d8d9d3ba1b479305cb10c95b9497...11804c717c01484f024717742924d663cd44794e,1,3,0,3,1,2009-11-28 03:28:56,2009-11-28 03:28:56
11804c717c01484f024717742924d663cd44794e...415f5e7fa8ec36c791afee70e8ceed15de9bdef5,1,1,0,1,1,2009-11-28 04:30:31,2009-11-28 04:30:31
415f5e7fa8ec36c791afee70e8ceed15de9bdef5...fbda5ee9bfb165f661df88f26a842d0b9158860c,1,1,1,2,1,2009-11-28 15:25:45,2009-11-28 15:25:45
09bd20c7a6c97a88c9b4e3973f9b43395bad0dbe...066f600082fe3e4fa03f043d56a7a7022c0c55ec,2,12,3,15,6,2009-11-25 15:14:08,2009-11-25 15:14:08
09bd20c7a6c97a88c9b4e3973f9b43395bad0dbe...eed27626b85e6e3ae2cfa2ccb36e6dfcf9fb2f6d,5,116,22,138,19,2009-11-25 15:09:59,2009-11-25 15:09:59
eed27626b85e6e3ae2cfa2ccb36e6dfcf9fb2f6d...3b724c73adf429400ae885e88f78ef2e56731559,3,123,66,189,8,2009-11-25 17:41:13,2009-11-25 17:41:13
fbda5ee9bfb165f661df88f26a842d0b9158860c...8a26ff4f8daffa350697d0267a24fd561fca9249,5,74,45,119,21,2009-11-28 16:50:46,2009-11-28 16:50:46
fbda5ee9bfb165f661df88f26a842d0b9158860c...b609747023b077b98452ca06f14573d1cdbdab41,1,2,3,5,3,2009-11-28 15:41:14,2009-11-28 15:41:14
b609747023b077b98452ca06f14573d1cdbdab41...2e23773bf9aecd2665b369e55e2589c2db13e1f8,2,45,3,48,3,2009-11-28 16:19:51,2009-11-28 16:19:51
7538327283a8d7c29ed9d7641bb21c8dd1b93e65...e8193c5df29123bd9b3eb97785a777a33c1a3eb9,1,1,0,1,1,2009-11-25 19:35:30,2009-11-25 19:35:30
e8193c5df29123bd9b3eb97785a777a33c1a3eb9...7024b54491f7d0babe31dd4fd3034bde456b3c87,3,4,3,7,4,2009-11-25 19:51:40,2009-11-25 19:51:40
fb974ef4ddbc5a1a50b2f62366b64fff082ef662...b85efc80643dd4b921d78f34cdd805ec254c777b,6,78,20,98,24,2009-11-28 18:57:30,2009-11-28 18:57:30
b85efc80643dd4b921d78f34cdd805ec254c777b...e65fba32c239eccaf38c83734f7399fc0f40bcbf,1,2,1,3,1,2009-11-28 19:05:24,2009-11-28 19:05:24
e65fba32c239eccaf38c83734f7399fc0f40bcbf...0eb196a2da4a83661dcfdb7e92c04c8b3ff5a552,1,4,1,5,3,2009-11-28 19:08:31,2009-11-28 19:08:31
0eb196a2da4a83661dcfdb7e92c04c8b3ff5a552...1624ff1eb0c3d8230a89a83c575417ecd80aaca0,1,1,2,3,1,2009-11-28 19:10:39,2009-11-28 19:10:39
1624ff1eb0c3d8230a89a83c575417ecd80aaca0...62987fc3d72f49405c0c4b6067d6880afe7f84c1,1,2,0,2,2,2009-11-28 20:49:16,2009-11-28 20:49:16
62987fc3d72f49405c0c4b6067d6880afe7f84c1...05d5719b1fda9e17b2c97b97ca91d311adaafa19,1,1,0,1,1,2009-11-28 21:31:57,2009-11-28 21:31:57
05d5719b1fda9e17b2c97b97ca91d311adaafa19...e0dff0748ac40bf81368e0321554b49635ebdf18,2,37,8,45,11,2009-11-28 22:29:23,2009-11-28 22:29:23
e0dff0748ac40bf81368e0321554b49635ebdf18...c919b7feecff8a28d5bd0217d6c26afcb536f33c,1,1,0,1,1,2009-11-28 22:43:33,2009-11-28 22:43:33
c919b7feecff8a28d5bd0217d6c26afcb536f33c...7c5992dbead773a896bfa44a3e1cad37367aeee4,1,4,2,6,1,2009-11-30 16:18:41,2009-11-30 16:18:41
c919b7feecff8a28d5bd0217d6c26afcb536f33c...aaf901fe6e4c53e170f1e8161a6cf20dee16e2a3,1,1,1,2,1,2009-11-30 15:01:59,2009-11-30 15:01:59
aaf901fe6e4c53e170f1e8161a6cf20dee16e2a3...76ff6851afc7b530782554e535fef60c21224972,1,1,1,2,1,2009-11-30 15:35:54,2009-11-30 15:35:54
76ff6851afc7b530782554e535fef60c21224972...57b0c56f527e6e4fd5d6c946d486a804d64cf3c9,1,4,0,4,2,2009-11-30 15:42:50,2009-11-30 15:42:50
57b0c56f527e6e4fd5d6c946d486a804d64cf3c9...d7280381dfbc77488186c063012b55e6f809ce8f,2,12,1,13,7,2009-11-30 15:52:02,2009-11-30 15:52:02
5c2c7efdfdf0c3d11bea5e82d7a84a1fdfa9f0a9...25bb636eb4df4c40ac4549d9a6502c278b2e786f,6,1329,8,1337,12,2009-11-30 17:09:39,2009-11-30 17:09:39
25bb636eb4df4c40ac4549d9a6502c278b2e786f...77e5ed58d6967ca0f91299a58dafa10bf185f067,6,11,11,22,11,2009-11-30 22:44:14,2009-11-30 22:44:14
25bb636eb4df4c40ac4549d9a6502c278b2e786f...47a01f2bfea233ef5aad51fdc62ddc397e0f0e28,2,4,3,7,3,2009-11-30 20:10:23,2009-11-30 20:10:23
47a01f2bfea233ef5aad51fdc62ddc397e0f0e28...8cbc9e1c1b7d23731796fea489f82a070b7372a0,1,2,0,2,1,2009-11-30 20:12:22,2009-11-30 20:12:22
8cbc9e1c1b7d23731796fea489f82a070b7372a0...ce036039e6c23ef2c6fcb5344f1beb07aa251cb5,4,71,4,75,8,2009-11-30 22:05:31,2009-11-30 20:10:14
ce036039e6c23ef2c6fcb5344f1beb07aa251cb5...31a82b30347d349a6c9d72d36c7e336da66716a8,1,1,1,2,1,2009-11-30 22:05:31,2009-11-30 22:05:01
31a82b30347d349a6c9d72d36c7e336da66716a8...d538c3c8b4b1d0b2de1623733c5d883edb655f5c,1,1,1,2,1,2009-11-30 22:27:52,2009-11-30 22:27:52
84fbab144fc44c3af8dde09d8ffbb8427b61d077...d5231d774e367ecbf6aad1fe5706b15891184e06,2,4,2,6,4,2009-11-30 23:51:39,2009-11-30 23:48:55
d5231d774e367ecbf6aad1fe5706b15891184e06...c72e870657137ab5c939ae36d081cf1623cca645,1,2,1,3,2,2009-12-01 17:25:48,2009-12-01 17:25:48
c72e870657137ab5c939ae36d081cf1623cca645...16bd507b512589f0e0a53275bdf298c6d65bcfb3,11,203,226,429,43,2009-12-02 14:39:17,2009-12-02 14:39:17
c72e870657137ab5c939ae36d081cf1623cca645...49b59721c487a82259d9218351a41b5191433590,3,3,17,20,19,2009-12-01 21:25:12,2009-12-01 21:25:12
49b59721c487a82259d9218351a41b5191433590...c582756bcba264f30f6d779c1418b2c92d7f7267,1,1,1,2,1,2009-12-01 21:33:58,2009-12-01 21:33:58
c582756bcba264f30f6d779c1418b2c92d7f7267...7564ceb7747368740250f0dbc6766fcf772ea614,1,3,0,3,1,2009-12-01 21:48:40,2009-12-01 21:48:40
60bde10fc2024272577fd84a3bd2a9cff3c7b899...4df961a405ad99be55ae5670c15b28b146d8b730,7,64,29,93,21,2009-12-03 16:50:09,2009-12-03 16:50:09
7564ceb7747368740250f0dbc6766fcf772ea614...7133196d6b90f71926af0ba69190dc5fb26fb328,3,20,10,30,7,2009-12-02 00:29:08,2009-12-02 00:28:27
7133196d6b90f71926af0ba69190dc5fb26fb328...31723f3d28d9c8b2d08a3ffcce23751f70a8b153,2,2,12,14,3,2009-12-02 01:08:34,2009-12-02 01:06:50
31723f3d28d9c8b2d08a3ffcce23751f70a8b153...c0e79bf1d4b6a2813a0aa93bc63fdb6c89c281c0,2,2,2,4,3,2009-12-02 01:25:48,2009-12-02 01:25:48
7564ceb7747368740250f0dbc6766fcf772ea614...f9bc76e4159da83dd0920e46f29734ebb26324fe,1,21,0,21,1,2009-12-01 22:40:18,2009-12-01 22:40:18
c0e79bf1d4b6a2813a0aa93bc63fdb6c89c281c0...f5c9a86b92343fd718129e6caceefc67e00a0ff5,1,27,2,29,3,2009-12-02 17:17:47,2009-12-02 17:17:47
e34dbcca11f510027b867d62397954667a3a3b8e...e8cb0b90f854f81ef9399de6fce20acdd8ef4257,1,12,8,20,7,2009-12-03 17:09:11,2009-12-03 17:09:11
e8cb0b90f854f81ef9399de6fce20acdd8ef4257...ad9d8bbdb46ab6800d4ac6853369a3901aa6986c,8,44,63,107,24,2009-12-03 18:12:51,2009-12-03 18:12:51
ad9d8bbdb46ab6800d4ac6853369a3901aa6986c...f05b2a328e6878574ba35726f087bc659f263760,1,2,2,4,3,2009-12-03 18:14:41,2009-12-03 18:14:41
f05b2a328e6878574ba35726f087bc659f263760...48217c0650f603acaaab5732795119f48272af4e,3,26,21,47,17,2009-12-03 18:48:45,2009-12-03 18:48:45
48217c0650f603acaaab5732795119f48272af4e...d4bb21cc66a9be733b95a4ba0e08eb3ac875fa9a,1,29,8,37,4,2009-12-03 19:14:06,2009-12-03 19:14:06
f5c9a86b92343fd718129e6caceefc67e00a0ff5...01d596cfe4e39ebf1ccbf42e60843e89340f2669,1,2,2,4,2,2009-12-02 17:33:14,2009-12-02 17:33:14
01d596cfe4e39ebf1ccbf42e60843e89340f2669...f610e9f657b9f4c6118647ecb52ea90988eb3425,1,2,2,4,2,2009-12-02 17:53:48,2009-12-02 17:53:48
d4bb21cc66a9be733b95a4ba0e08eb3ac875fa9a...dc01c83a75343be466685b7e4652c00a871ea5b2,1,11,3,14,7,2009-12-03 20:24:16,2009-12-03 20:24:16
f610e9f657b9f4c6118647ecb52ea90988eb3425...c58d0d3123e754b9816cf48ef4754d924eec9def,1,79,0,79,1,2009-12-02 19:33:06,2009-12-02 19:33:06
e2e5b3abfe202bf49a6b4f732cafc1d700c4d1f3...9ba5360e8bd3cb7741c0dfcad9d7453a340d2a98,2,24,8,32,15,2009-12-02 20:14:37,2009-12-02 20:14:37
054c62b300b129cd4994967bc0277d73ba507a6d...6569d4e8151eae85a323ac4935626c6eb066ea07,3,3,3,6,3,2009-12-03 20:27:19,2009-12-03 20:27:19
c3af5a5c515ca0ede07f0e4c13a634fa969a8721...58f7052028ddf6697e5db585dc6a8d10c59f9ce0,1,9,7,16,3,2009-12-03 19:31:23,2009-12-03 19:30:51
58f7052028ddf6697e5db585dc6a8d10c59f9ce0...7581e971819fa98314c470ad855d6c35d035b95d,1,1,1,2,1,2009-12-03 19:46:29,2009-12-03 19:46:29
ac1f4db189a9e0d810026d862151ba860209d7c1...04c6bf7241c9603b1cbafa045320a16b0536c150,1,13,8,21,3,2009-12-02 20:28:28,2009-12-02 20:15:24
6569d4e8151eae85a323ac4935626c6eb066ea07...a5880774b5691d07f1f22c382fbb825c3b09c950,1,1,1,2,1,2009-12-03 22:11:09,2009-12-03 22:11:09
a5880774b5691d07f1f22c382fbb825c3b09c950...5d8ca55f47ab04a8dd0214351137ec6f78e52c56,3,54,1,55,6,2009-12-03 22:11:24,2009-12-03 22:11:24
5d8ca55f47ab04a8dd0214351137ec6f78e52c56...843f365571571a8b154dd029eb770b15c9953010,3,16,5,21,6,2009-12-03 22:24:22,2009-12-03 22:24:22
6569d4e8151eae85a323ac4935626c6eb066ea07...ff0ddc89edf1e805d24b27d8fab80ee112ca517e,1,1,1,2,1,2009-12-03 21:41:12,2009-12-03 21:41:12
04c6bf7241c9603b1cbafa045320a16b0536c150...95c080d71959ab9091f13af7b30740aab6b9fd1a,2,21,4,25,4,2009-12-02 21:36:32,2009-12-02 21:36:32
95c080d71959ab9091f13af7b30740aab6b9fd1a...03e3c49ebecce872e6a26ee6f91b2412fd4c4564,6,195,13,208,24,2009-12-02 21:36:46,2009-12-02 21:36:46
04c6bf7241c9603b1cbafa045320a16b0536c150...a3d516c4b93c62141506ed1f1e25a8744ed3e724,1,2,1,3,1,2009-12-02 20:39:46,2009-12-02 20:39:46
af8039cfd32c82e95f7f6bc83683c3f558353b6a...9c2f1a1bd14b71dddfae0b7a0ed37bef1b3441b0,3,34,23,57,15,2009-12-03 22:41:45,2009-12-03 22:41:45
9c2f1a1bd14b71dddfae0b7a0ed37bef1b3441b0...b4029bed076795dda5e4add8384effd9f7c1901f,3,21,21,42,4,2009-12-03 22:48:18,2009-12-03 22:48:18
b4029bed076795dda5e4add8384effd9f7c1901f...dd8758ab74aaee7ee30c94f3fc4385bc3d26d737,2,31,1,32,2,2009-12-04 01:49:49,2009-12-04 01:49:49
dd8758ab74aaee7ee30c94f3fc4385bc3d26d737...d6c69369c02b1a065286f9a0bddeefd8c77033d3,2,5,5,10,6,2009-12-04 03:44:34,2009-12-04 03:44:34
d6c69369c02b1a065286f9a0bddeefd8c77033d3...31445b9fe00edf3f25868a2351424c9a6a78dfaf,1,9,1,10,2,2009-12-04 05:17:14,2009-12-04 05:17:14
31445b9fe00edf3f25868a2351424c9a6a78dfaf...f4d7fb2854762af8547746a564a0b37bf006bf3a,1,1,1,2,1,2009-12-04 06:25:09,2009-12-04 06:25:09
f4d7fb2854762af8547746a564a0b37bf006bf3a...2aec9ea61d05cb17a1b52e3198d40a7c74b81572,6,84,19,103,14,2009-12-04 06:25:50,2009-12-04 06:25:50
2aec9ea61d05cb17a1b52e3198d40a7c74b81572...4c67cef08b1106b8e5a7dbd18f47ba6f5fab638a,2,2,2,4,2,2009-12-04 14:46:11,2009-12-04 14:46:11
36e01bf30b876cd274b0dca3d8712e8f320a547d...d3ece690eff86181ad61bf2ad06e59c8e6e98c24,2,6,6,12,6,2009-12-02 21:56:37,2009-12-02 21:56:37
d3ece690eff86181ad61bf2ad06e59c8e6e98c24...84dc801b60256e17d0cc55964a19ef64a183c8aa,2,2,1,3,2,2009-12-02 21:56:49,2009-12-02 21:56:49
36e01bf30b876cd274b0dca3d8712e8f320a547d...888cfe8aaba417200ecb7ba6cb6ee0e0caead983,1,2,2,4,1,2009-12-02 21:44:53,2009-12-02 21:44:53
4c67cef08b1106b8e5a7dbd18f47ba6f5fab638a...dcd9411abf303ce601ac2956c4d2d5382f76d535,3,51,47,98,19,2009-12-04 16:18:42,2009-12-04 16:18:42
4c67cef08b1106b8e5a7dbd18f47ba6f5fab638a...415cb5e867ec2c8091f77fc40ccaae02d21e8bc8,1,0,1,1,1,2009-12-04 14:53:05,2009-12-04 14:53:05
c67c2f7dd681152f1784c8e1c2119b979e65881d...ec49006e35e929b83459f4668463d4bb3f6e2189,2,54,3,57,5,2009-12-03 16:50:28,2009-12-03 16:50:28
8968ae7be48e05f625356abb49ca1a2434b853ae...edfa5eca0180eba6fa3086e588b3a268a80c0126,4,14,1,15,5,2009-12-04 17:50:53,2009-12-04 17:50:53
edfa5eca0180eba6fa3086e588b3a268a80c0126...851a94b853f044a4954f3463ce8da0b88a77dedb,1,2,0,2,1,2009-12-04 20:56:57,2009-12-04 20:56:57
ec49006e35e929b83459f4668463d4bb3f6e2189...3c6a8cf7b7c24c87358cb9c6960786ce0057d4f0,3,277,0,277,3,2009-12-03 19:21:22,2009-12-03 19:20:35
3c6a8cf7b7c24c87358cb9c6960786ce0057d4f0...ad7fc8908396a3351a0f07bb1e2fc4baba2802ad,4,4,4,8,4,2009-12-03 20:03:20,2009-12-03 20:03:20
ad7fc8908396a3351a0f07bb1e2fc4baba2802ad...cb39613c0f6ae9afd799d77c84189e457e56c54f,1,1,1,2,1,2009-12-03 22:25:39,2009-12-03 22:11:09
cb39613c0f6ae9afd799d77c84189e457e56c54f...c0b78e37b56d40237de158648fd356ca981eb187,1,21,2,23,3,2009-12-05 16:54:36,2009-12-05 16:54:36
c0b78e37b56d40237de158648fd356ca981eb187...05c32be539c301e98c9b632d948caf64c10ffefd,1,1,1,2,1,2009-12-05 16:54:52,2009-12-05 16:54:52
05c32be539c301e98c9b632d948caf64c10ffefd...89b0957a4107621b8a75b34da435ae7875699004,1,6,0,6,1,2009-12-07 00:18:30,2009-12-07 00:18:30
89b0957a4107621b8a75b34da435ae7875699004...87f324edf8eba00cbe90b890fca8db3268cde3ca,1,1,1,2,1,2009-12-07 00:49:54,2009-12-07 00:49:54
87f324edf8eba00cbe90b890fca8db3268cde3ca...306c8c6b9841d600f630840842fe7daffde1e275,1,2,2,4,1,2009-12-08 17:19:09,2009-12-08 17:19:09
306c8c6b9841d600f630840842fe7daffde1e275...d6d9ce8ffeb383b942cb267704ae8a3dcb9118a5,1,1,1,2,1,2009-12-09 15:19:11,2009-12-09 15:18:09
d6d9ce8ffeb383b942cb267704ae8a3dcb9118a5...0775d99ea1b19018c5de41e0adda330c0fed7b56,4,23,4,27,5,2009-12-10 15:16:25,2009-12-09 22:00:14
0775d99ea1b19018c5de41e0adda330c0fed7b56...2add01f37ddf5a262dbc66f81353e88f38723dc6,4,4,4,8,4,2009-12-10 15:27:04,2009-12-10 15:27:04
2add01f37ddf5a262dbc66f81353e88f38723dc6...697c07f8c954c5bcc983f5e6765599b4f6a63e19,1,1,1,2,1,2009-12-11 02:31:15,2009-12-11 02:31:15
697c07f8c954c5bcc983f5e6765599b4f6a63e19...a0d90a4478d3e954235e740977b3d91a43b56374,1,1,1,2,1,2009-12-16 01:54:02,2009-12-16 01:54:02
a0d90a4478d3e954235e740977b3d91a43b56374...007da4fdc7da610cb44985be786795125abe0f94,1,2,1,3,2,2009-12-20 12:17:37,2009-12-20 12:17:37
007da4fdc7da610cb44985be786795125abe0f94...9280f63a83d15229b7437d980f36cbae7949a89b,1,1,1,2,1,2009-12-20 12:17:54,2009-12-20 12:17:54
9280f63a83d15229b7437d980f36cbae7949a89b...5dc18ddb3bb7e07eb915c37e13fe8a826a173a70,1,1,1,2,1,2009-12-22 16:07:36,2009-12-22 16:07:36
5dc18ddb3bb7e07eb915c37e13fe8a826a173a70...720eecdc012df963c59c960c5020f25762d02bb7,1,3,0,3,2,2009-12-22 17:58:41,2009-12-22 17:58:41
720eecdc012df963c59c960c5020f25762d02bb7...f8f12e8d13c5ea15a224208c3425d7162b44f85f,1,6,0,6,2,2009-12-29 19:26:12,2009-12-21 15:58:20
f8f12e8d13c5ea15a224208c3425d7162b44f85f...961d3ab8b21c06f633ddd83513baa848145b7916,1,5,4,9,4,2009-12-29 22:13:03,2009-12-29 22:12:14
961d3ab8b21c06f633ddd83513baa848145b7916...45992de574979343f34fdfe96b069d5d1eff0182,4,4,4,8,4,2009-12-30 18:01:40,2009-12-30 18:01:40
45992de574979343f34fdfe96b069d5d1eff0182...209968640d892d828fc7071f8b6aee0414daebb7,1,1,1,2,1,2009-12-30 19:44:38,2009-12-30 19:44:38
209968640d892d828fc7071f8b6aee0414daebb7...054917e5c4f158728b271eeff4ef219e593f9148,1,8,0,8,1,2010-01-03 02:42:11,2010-01-03 02:41:35
054917e5c4f158728b271eeff4ef219e593f9148...1c4843d4973db347afc0002fc5a3d36cafc4abf8,1,10,3,13,1,2010-01-10 01:21:48,2010-01-10 01:20:44
1c4843d4973db347afc0002fc5a3d36cafc4abf8...dc1ebc586ee8b6542d9b6a70e41084c2048c7aef,3,68,10,78,7,2010-01-11 11:17:06,2010-01-11 11:17:06
dc1ebc586ee8b6542d9b6a70e41084c2048c7aef...2b59b7f0c58a377ef96d6a61c7c98dfbd365512d,1,9,6,15,4,2010-01-11 11:29:40,2010-01-11 11:27:52
2b59b7f0c58a377ef96d6a61c7c98dfbd365512d...17a2a93bb58507a3e43f7095d615d50dc5d2979e,1,5,6,11,6,2010-01-11 11:39:01,2010-01-11 11:38:16
17a2a93bb58507a3e43f7095d615d50dc5d2979e...48c7684617ec139deff00bdf7e8ee4cd45695662,1,2,2,4,2,2010-01-11 11:44:32,2010-01-11 11:44:00
48c7684617ec139deff00bdf7e8ee4cd45695662...56b803b9f2f77e27f9f9fba8717f9756d15370bc,1,4,2,6,3,2010-01-11 11:54:39,2010-01-11 11:53:39
56b803b9f2f77e27f9f9fba8717f9756d15370bc...5b36ef5cfa0541306cb2511d6378fcc4ee80f768,2,46,0,46,4,2010-01-14 21:48:41,2010-01-14 21:48:41
5b36ef5cfa0541306cb2511d6378fcc4ee80f768...2ce38e33765808dc38e48bdc5d8401a45c7d7261,1,1,1,2,1,2010-01-15 14:31:05,2010-01-15 13:07:33
2ce38e33765808dc38e48bdc5d8401a45c7d7261...7907050da3a903d3873a4b93b548fef9f2ab61af,1,1,0,1,1,2010-01-19 21:43:37,2010-01-19 21:42:48
7907050da3a903d3873a4b93b548fef9f2ab61af...c461be6e17a5f2b8b6c3d6d45d7a0c5a0b78b42e,1,1,0,1,1,2010-01-20 03:04:17,2010-01-15 20:31:51
c461be6e17a5f2b8b6c3d6d45d7a0c5a0b78b42e...5a2da6b86f6c4e7ee0a18b3f392f83a579d67094,1,4,3,7,1,2010-01-20 03:04:25,2010-01-15 21:59:39
5a2da6b86f6c4e7ee0a18b3f392f83a579d67094...04aabf6194249e57811dc873c6d458d44f43e01a,1,4,2,6,2,2010-01-20 03:06:41,2010-01-15 22:16:17
04aabf6194249e57811dc873c6d458d44f43e01a...6a324b4a98007a76ae95d45cb168696d5e81a695,1,2,0,2,1,2010-01-20 14:53:48,2010-01-20 14:53:48
6a324b4a98007a76ae95d45cb168696d5e81a695...a4f9e4bc12b4d6399e1e296994c277cc0e3f823c,1,3,3,6,1,2010-01-25 21:14:10,2010-01-24 16:05:45
a4f9e4bc12b4d6399e1e296994c277cc0e3f823c...41232b6557dd7910bce7e91651fb9ffa997d6e8f,2,44,2,46,3,2010-01-26 15:06:33,2010-01-26 15:06:33
41232b6557dd7910bce7e91651fb9ffa997d6e8f...a6d37a6d3ebf7207b8778c6307e5cfbf1c4731b6,2,56,1,57,2,2010-01-26 15:43:30,2010-01-26 15:42:28
a6d37a6d3ebf7207b8778c6307e5cfbf1c4731b6...8a4fb8b1c7cb78648c55368d806ba35054f6be54,4,4,4,8,4,2010-01-26 17:56:05,2010-01-26 17:56:05
8a4fb8b1c7cb78648c55368d806ba35054f6be54...a6d7b21ccdf3c798550637fd195793b054d739ce,1,1,1,2,1,2010-01-27 15:00:04,2010-01-27 15:00:04
a6d7b21ccdf3c798550637fd195793b054d739ce...bda359e9a1679ad42c5590fa9d9a86ce8c33ff86,2,1,0,1,1,2010-01-30 04:18:39,2010-01-30 04:18:39
bda359e9a1679ad42c5590fa9d9a86ce8c33ff86...be98c677cccb1727895312723784d01dbdd554e6,1,1,1,2,1,2010-02-03 17:53:04,2010-02-03 17:53:04
be98c677cccb1727895312723784d01dbdd554e6...38a924346da737ad1d9c0b7d959f324317f8b0c2,1,0,1,1,1,2010-02-03 21:13:50,2010-02-03 21:09:23
38a924346da737ad1d9c0b7d959f324317f8b0c2...ba4cdb7b4cd03d13744f820ea57e6305e9d06e44,2,66,0,66,2,2010-02-05 14:45:33,2010-02-04 15:21:36
ba4cdb7b4cd03d13744f820ea57e6305e9d06e44...48ba6d29917de93cde166f72cdaa0e007adb5265,1,2,1,3,1,2010-02-05 15:53:51,2010-02-05 15:53:22
48ba6d29917de93cde166f72cdaa0e007adb5265...188436f8c9c7bb5ae311ce12b28ea93a6549e77c,1,4,0,4,2,2010-02-06 15:47:48,2010-02-06 15:47:30
188436f8c9c7bb5ae311ce12b28ea93a6549e77c...2dc3d5b5776c82cfed2937f6a0766f3e18724265,3,30,20,50,6,2010-02-06 15:49:42,2010-02-06 15:49:42
2dc3d5b5776c82cfed2937f6a0766f3e18724265...ec1550c63d420d86eb230028fdf080509f1fde93,1,3,1,4,1,2010-02-06 19:46:28,2010-02-06 19:45:58
ec1550c63d420d86eb230028fdf080509f1fde93...efb769e3b6744bcb69dd717192330535197b2472,1,1,1,2,1,2010-02-07 04:45:49,2010-02-07 04:45:49
efb769e3b6744bcb69dd717192330535197b2472...a2bc5e32690d80e84c79f9f7d1f953ea91431155,4,34,7,41,9,2010-02-09 01:48:50,2010-02-09 00:23:48
a2bc5e32690d80e84c79f9f7d1f953ea91431155...a71dbfc15ad59c7b199a87f310885383c05a7f7a,11,234,131,365,30,2010-02-10 15:37:02,2010-02-10 15:37:02
a71dbfc15ad59c7b199a87f310885383c05a7f7a...ba32baba1c3c5d4ecc6a61fde1994ede5203d9aa,1,2,2,4,2,2010-02-10 15:40:38,2010-02-10 15:40:38
ba32baba1c3c5d4ecc6a61fde1994ede5203d9aa...30c0576b8bcdf0e80ad4e942e7ae5a1d3fb19a65,3,107,1,108,3,2010-02-10 15:57:31,2010-02-10 15:57:31
30c0576b8bcdf0e80ad4e942e7ae5a1d3fb19a65...fc3d3acafc253da085f7d0cdcd91059cc9bcd8e3,1,1,1,2,1,2010-02-10 19:10:46,2010-02-10 19:10:46
ec49006e35e929b83459f4668463d4bb3f6e2189...39b64ce9f3e2093f98431421f0bca00e016107bb,3,277,0,277,3,2009-12-03 19:20:35,2009-12-03 19:20:35
851a94b853f044a4954f3463ce8da0b88a77dedb...078c8821d4da4e56c21eb8fb78418930ee47fbc6,2,28,21,49,6,2009-12-04 21:45:44,2009-12-04 21:45:44
851a94b853f044a4954f3463ce8da0b88a77dedb...df76570973552d78eea23512c270064f039bb147,1,4,3,7,6,2009-12-04 21:20:13,2009-12-04 21:20:13
fc3d3acafc253da085f7d0cdcd91059cc9bcd8e3...e07cbe6088d4650bedf5bf2c797fd34506952941,4,21,5,26,8,2010-02-16 05:39:39,2010-02-16 05:39:39
e07cbe6088d4650bedf5bf2c797fd34506952941...b83c5efe356b31b2fdb7411bc6352e0433bf1339,1,1,1,2,1,2010-02-17 19:57:30,2010-02-17 19:57:30
fc3d3acafc253da085f7d0cdcd91059cc9bcd8e3...899328a8cf10626eebf8a235f38040c35e7e01cf,1,1,1,2,1,2010-02-11 22:38:22,2010-02-11 22:38:22
d1587b662f4a71adc940fa968403edc66d688c78...ae743da2400b98be36ebb43d5666937bc2215cca,3,16,1,17,4,2009-12-04 22:11:17,2009-12-04 22:11:17
ae743da2400b98be36ebb43d5666937bc2215cca...788f07fcde96b9739c2896d323a8bfc7bf9fcc75,1,21,2,23,3,2009-12-05 17:03:34,2009-12-05 16:54:36
b790e13761f1e29ec2757ef00e4de86c5ff6ca60...e987a94c7c396cc2a15e6033aa9d0f65a717421a,1,2,2,4,2,2010-02-20 21:39:01,2010-02-20 21:38:37
e987a94c7c396cc2a15e6033aa9d0f65a717421a...d95fa41f505267d179d335588a2c5ebe3a190e45,1,5,4,9,4,2010-02-20 21:40:19,2010-02-20 21:40:19
d95fa41f505267d179d335588a2c5ebe3a190e45...bf7640dfa8474784486a00d24381b934cb4e0207,1,6,2,8,2,2010-02-20 21:40:27,2010-02-19 19:27:25
bf7640dfa8474784486a00d24381b934cb4e0207...c75c00cfa8752a804e911b2a9d4057cea523dd4b,1,1,1,2,1,2010-02-20 21:40:35,2010-02-19 19:38:02
c75c00cfa8752a804e911b2a9d4057cea523dd4b...8cd3f5b5d4480346cdb20abb6113d182eb8aa656,1,12,2,14,2,2010-02-21 15:40:34,2010-02-21 15:40:34
8cd3f5b5d4480346cdb20abb6113d182eb8aa656...3895bcd00bbeacb0ea38320f1e2cada186161330,1,5,1,6,2,2010-02-21 16:42:24,2010-02-21 16:42:24
3895bcd00bbeacb0ea38320f1e2cada186161330...67f8e660585d3beac8abb73cf7b596a1efe5ce33,1,1,1,2,1,2010-02-21 16:58:15,2010-02-21 16:58:15
67f8e660585d3beac8abb73cf7b596a1efe5ce33...90f5b501f2f43dd88d550ee7039be4d989aa1b4c,1,8,7,15,3,2010-02-23 19:52:45,2010-02-23 19:52:45
90f5b501f2f43dd88d550ee7039be4d989aa1b4c...8d182e16390e8884f1614b7fd7eea0830e10e302,1,5,1,6,1,2010-02-23 20:43:03,2010-02-23 20:43:03
8d182e16390e8884f1614b7fd7eea0830e10e302...d498124c60b8412dba4c49c4b404e207fff82b4c,4,4,4,8,4,2010-02-23 22:29:40,2010-02-23 22:29:40
d498124c60b8412dba4c49c4b404e207fff82b4c...5ded448a9079798a514121ad1879fc30116d1ed9,1,1,1,2,1,2010-02-24 02:37:28,2010-02-24 02:37:28
5ded448a9079798a514121ad1879fc30116d1ed9...c62aa841a22a391c9e1c9223955970cea9ec074f,3,7,38,45,4,2010-02-24 06:27:26,2010-02-02 22:29:14
c62aa841a22a391c9e1c9223955970cea9ec074f...92b27770bec81ead7f360d0feb6e8bf8e8d83fbc,1,1,1,2,1,2010-02-24 06:27:59,2010-02-09 19:38:19
92b27770bec81ead7f360d0feb6e8bf8e8d83fbc...074553298d403babb7265de7900257bb550b9ce7,1,1,1,2,1,2010-02-24 06:28:42,2010-02-09 21:45:59
074553298d403babb7265de7900257bb550b9ce7...fcb6a16b48324629122c7da28d75b3e8393fd913,1,4,4,8,4,2010-02-24 06:28:57,2010-02-10 03:13:28
fcb6a16b48324629122c7da28d75b3e8393fd913...a05b907fc4b4641a7d135df735b95cee386d5b27,1,2,0,2,1,2010-02-25 01:12:52,2010-02-02 23:12:08
a05b907fc4b4641a7d135df735b95cee386d5b27...de365ac8eb96572003bd158d098916272b68eb75,4,22,4,26,8,2010-02-26 04:59:44,2010-02-26 04:59:44
de365ac8eb96572003bd158d098916272b68eb75...1d82d20390804309258cd6d8fffd7f62c4accce6,1,6,6,12,2,2010-02-26 05:21:00,2010-02-26 05:21:00
1d82d20390804309258cd6d8fffd7f62c4accce6...76d4703561145d18e609b3e206a6a661ba553724,1,1,1,2,1,2010-02-26 23:00:08,2010-02-26 23:00:08
76d4703561145d18e609b3e206a6a661ba553724...8e3d106320a2471a2dc3d694984d6a73cf5074e4,1,16,1,17,3,2010-02-26 23:06:02,2009-12-10 02:30:09
788f07fcde96b9739c2896d323a8bfc7bf9fcc75...91c3bc2ce6ea67bb619a35481da60fc357e58045,1,3,1,4,1,2009-12-05 18:59:28,2009-12-05 18:59:28
788f07fcde96b9739c2896d323a8bfc7bf9fcc75...cff8b9a1ce58c9317df8b7f70597f174e0d6743b,1,26,0,26,1,2009-12-05 17:17:51,2009-12-05 17:17:51
8e3d106320a2471a2dc3d694984d6a73cf5074e4...4a7c73f5e2e779a807025f357b72468de5c261e0,4,11,3,14,4,2010-03-02 01:35:52,2010-03-02 01:35:52
8e3d106320a2471a2dc3d694984d6a73cf5074e4...ee388151a796dfc5415e7d200a71593e8ab97ab0,3,10,5,15,5,2010-03-01 22:59:58,2010-03-01 22:59:58
cff8b9a1ce58c9317df8b7f70597f174e0d6743b...45d59fcc7f848f47c0becb83db73a77ca2b4b6fa,1,2,1,3,1,2009-12-06 02:19:07,2009-12-06 02:19:07
45d59fcc7f848f47c0becb83db73a77ca2b4b6fa...a208f7991f577a3668e0db0473fb8912ab5fbe28,1,29,0,29,2,2009-12-06 02:19:52,2009-12-06 02:19:52
a208f7991f577a3668e0db0473fb8912ab5fbe28...a2b7ab3e2e6c3439d1572cfd2aea0b4cfd038941,1,2,2,4,1,2009-12-06 03:19:03,2009-12-06 03:19:03
a2b7ab3e2e6c3439d1572cfd2aea0b4cfd038941...9cad87e7be2dfc5230596e1d4334f0650ab40fe7,2,18,2,20,4,2009-12-06 04:46:00,2009-12-06 04:46:00
9cad87e7be2dfc5230596e1d4334f0650ab40fe7...8ea3e9f74a0dbaf11926f8e421cab608d28a34b9,1,1,0,1,1,2009-12-06 04:47:24,2009-12-06 04:47:24
8ea3e9f74a0dbaf11926f8e421cab608d28a34b9...856ebf91274421357f3b92fabaf42ea750e69023,1,1,0,1,1,2009-12-06 05:41:02,2009-12-06 05:41:02
856ebf91274421357f3b92fabaf42ea750e69023...7d160ea242c5126beb7767c5d1387e4d25c94fd6,2,6,8,14,2,2009-12-06 05:47:58,2009-12-06 05:47:58
7d160ea242c5126beb7767c5d1387e4d25c94fd6...066236ad581082f12114e40d622caa0a32adc89f,2,2,1,3,2,2009-12-06 06:01:07,2009-12-06 06:01:07
066236ad581082f12114e40d622caa0a32adc89f...bca215f03054d75b28f8b60de2a7121e18c48da0,2,4,12,16,5,2009-12-06 06:08:19,2009-12-06 06:08:19
bca215f03054d75b28f8b60de2a7121e18c48da0...e4e846e1501d4b371bf6cf917fc21a2a283e207a,1,14,0,14,1,2009-12-06 06:09:09,2009-12-06 06:09:09
5cf582d3d96b882c400c33e7670b811ccd47f477...084eb0c7f248eb56dc42dff528e1e6d32e4e6dff,1,1,1,2,1,2010-03-02 03:30:09,2010-03-02 03:30:09
084eb0c7f248eb56dc42dff528e1e6d32e4e6dff...cc206ecdf653b074d0e3ad1b639e1ce782888219,2,11,34,45,5,2010-03-07 03:20:44,2010-03-07 03:20:44
cc206ecdf653b074d0e3ad1b639e1ce782888219...c0a685292abfe4fc9532941ac1f325e4bf233449,1,4,0,4,1,2010-03-07 03:21:34,2010-03-05 04:14:03
c0a685292abfe4fc9532941ac1f325e4bf233449...b90ccb66528b0da2e1b18ce841359f31dcb3e7ee,2,9,2,11,2,2010-03-08 19:40:35,2010-03-08 19:40:35
b90ccb66528b0da2e1b18ce841359f31dcb3e7ee...97515db5b80e2ca8bbdcda0158695a91dc104b22,1,27,1,28,1,2010-03-09 17:51:30,2010-03-08 20:54:16
97515db5b80e2ca8bbdcda0158695a91dc104b22...063f651c6bcaa321ad2cb9bc534b724ce60aef6a,2,11,7,18,10,2010-03-09 17:57:20,2010-03-08 20:54:39
063f651c6bcaa321ad2cb9bc534b724ce60aef6a...447c9df927ded60e696086e98c1ca6a15b207756,6,37,6,43,13,2010-03-09 18:00:18,2010-03-08 20:55:18
447c9df927ded60e696086e98c1ca6a15b207756...b2973e7cc31b830fe9dd8ddca58af231125394bc,3,5,5,10,4,2010-03-09 18:01:15,2010-03-08 21:05:40
b2973e7cc31b830fe9dd8ddca58af231125394bc...677a095c221b699481da242520547a6b787dbafb,1,49,0,49,1,2010-03-09 18:01:30,2010-03-09 02:17:32
677a095c221b699481da242520547a6b787dbafb...06279cde9a0a4e840a93f1ac0185f93b30d80bee,1,23,2,25,3,2010-03-09 18:05:08,2010-03-09 03:51:05
06279cde9a0a4e840a93f1ac0185f93b30d80bee...dfe8582685fd09316b8fad70f80512f3fa611285,1,3,3,6,3,2010-03-09 18:05:56,2010-03-09 03:57:06
dfe8582685fd09316b8fad70f80512f3fa611285...bec48b040a12864ec893157bcffe5d2702fcd3f4,1,0,21,21,1,2010-03-09 18:10:44,2010-03-09 18:10:44
bec48b040a12864ec893157bcffe5d2702fcd3f4...dee49ac08054969d23fc969a67e20324af134d36,2,11,3,14,3,2010-03-09 18:24:11,2010-03-09 18:24:11
dee49ac08054969d23fc969a67e20324af134d36...7c4cd36d0a306f5f2a77b8585836d96e356da92b,1,5,1,6,2,2010-03-09 18:27:55,2010-03-09 18:27:55
7c4cd36d0a306f5f2a77b8585836d96e356da92b...639c39189fefbab21580e10695289e44cbb65bc2,1,17,2,19,2,2010-03-10 18:39:37,2010-03-10 18:39:37
639c39189fefbab21580e10695289e44cbb65bc2...6e44c363413a553a3380fdbf50548fb97c5be645,4,48,27,75,21,2010-03-16 14:41:04,2010-03-16 14:41:04
6e44c363413a553a3380fdbf50548fb97c5be645...84eab5e950fc267f82fb68bd0b34647876994ac3,1,1,1,2,1,2010-03-16 19:14:50,2010-03-16 19:14:50
84eab5e950fc267f82fb68bd0b34647876994ac3...fca1962ce402aac501512b780c81c52d2c0778da,1,1,1,2,1,2010-03-26 16:15:12,2010-03-26 16:15:12
fca1962ce402aac501512b780c81c52d2c0778da...2fd67aca84165be834319139d07634f888b18bb5,1,7,8,15,4,2010-03-31 21:03:51,2010-03-15 17:57:13
2fd67aca84165be834319139d07634f888b18bb5...c0acb04e0f3c837dd8e19d83d14dd0906a19517c,1,5,0,5,1,2010-04-07 15:49:12,2010-04-07 15:49:12
c0acb04e0f3c837dd8e19d83d14dd0906a19517c...672fda4244c91bf0dc405529767a6939938d3b12,4,9,3,12,4,2010-04-07 15:50:21,2010-04-07 15:50:21
672fda4244c91bf0dc405529767a6939938d3b12...5ab9c9b6a9cde4b4ca6373c277629a130cbb0734,1,1,1,2,1,2010-04-07 16:00:12,2010-04-07 16:00:12
5ab9c9b6a9cde4b4ca6373c277629a130cbb0734...5bd47701aa3e9dfb3345035e614959f1fd3ee702,1,1,1,2,1,2010-04-08 01:21:49,2010-04-08 01:21:49
5bd47701aa3e9dfb3345035e614959f1fd3ee702...22c7c88d013d78091e097525b43a9cfa69385a7b,2,4,1,5,2,2010-04-15 14:15:52,2010-04-15 14:15:10
1e589d60a67b8ff48fc60a33df24ce14117d5d2a...20eef73d618bbfba4259f95f384156443e6e357f,1,9,2,11,3,2009-12-06 14:41:53,2009-12-06 14:41:53
20eef73d618bbfba4259f95f384156443e6e357f...5bbbc781547ed902fbd5154b47ef1cf55aa217a0,1,6,2,8,3,2009-12-06 14:54:22,2009-12-06 14:54:22
5bbbc781547ed902fbd5154b47ef1cf55aa217a0...130bfc3af747400c81ebb3ce8b846660ec1c2987,1,9,4,13,1,2009-12-06 15:05:36,2009-12-06 15:05:36
130bfc3af747400c81ebb3ce8b846660ec1c2987...241a046b0eaa9141e1cffb0d33e71dea210d1495,1,7,6,13,3,2009-12-06 15:06:02,2009-12-06 15:06:02
241a046b0eaa9141e1cffb0d33e71dea210d1495...6487373835d01350b2a774a8136bf1b727771dc9,2,11,1,12,4,2009-12-06 16:18:35,2009-12-06 16:18:35
6487373835d01350b2a774a8136bf1b727771dc9...a246b2219fa57e601710bc69c38a8b7a492cd00b,1,0,2,2,1,2009-12-06 16:34:00,2009-12-06 16:34:00
a246b2219fa57e601710bc69c38a8b7a492cd00b...91b964522b67dd08dcee658f7c83522dbdf1b761,1,6,0,6,1,2009-12-07 00:19:51,2009-12-07 00:18:30
91b964522b67dd08dcee658f7c83522dbdf1b761...133aa839ec4d01d6d95f0d3b327018f7d0627383,1,1,1,2,1,2009-12-07 00:50:12,2009-12-07 00:49:54
133aa839ec4d01d6d95f0d3b327018f7d0627383...e0e46fcf9dd5f252a7b8937417a43dd97dd10787,1,1,1,2,1,2009-12-07 17:22:08,2009-12-07 17:22:08
e0e46fcf9dd5f252a7b8937417a43dd97dd10787...b16058e72ee93a61b0276cf7d5a7d5d16a12794d,3,20,5,25,8,2009-12-07 20:42:26,2009-12-07 20:42:26
b16058e72ee93a61b0276cf7d5a7d5d16a12794d...03b5ae207815cb07419cd38f4d0d3f8082c26e4f,3,302,202,504,8,2009-12-08 04:41:58,2009-12-08 04:41:58
03b5ae207815cb07419cd38f4d0d3f8082c26e4f...78964d14046fc5bbd417aa38b05b557b4e1e8861,1,39,0,39,1,2009-12-08 16:12:17,2009-12-08 16:12:17
78964d14046fc5bbd417aa38b05b557b4e1e8861...4f6a0fbf6255891da47fe4ffb34c142d4d29dcc3,1,1,1,2,1,2009-12-08 16:20:22,2009-12-08 16:20:22
4f6a0fbf6255891da47fe4ffb34c142d4d29dcc3...6fff93be922d7209fdc0617a0b6887f8c5d77dbc,3,6,5,11,6,2009-12-08 16:34:57,2009-12-08 16:34:57
6fff93be922d7209fdc0617a0b6887f8c5d77dbc...0e2a11a69a6256072ffc856512d87175ccce564e,3,16,2,18,7,2009-12-08 19:34:09,2009-12-08 19:34:09
6fff93be922d7209fdc0617a0b6887f8c5d77dbc...6c1f48d46f608358245263106a0f91eaca433aef,1,2,2,4,1,2009-12-08 17:18:37,2009-12-08 17:18:37
6c1f48d46f608358245263106a0f91eaca433aef...3b6ad7094099ccc25697ceb403f20df88bd4f180,1,2,2,4,2,2009-12-08 20:14:00,2009-12-08 20:14:00
0e2a11a69a6256072ffc856512d87175ccce564e...715796efb3d19c5278b69a0227e447c4d09386e6,2,16,14,30,12,2009-12-08 20:30:13,2009-12-08 20:30:13
2a9d3088a66345ec61ab795a2823ce43def18694...42aef472ecc35496f707d0dac843dc470dde0b4a,1,3,0,3,1,2009-12-08 22:00:17,2009-12-08 22:00:17
42aef472ecc35496f707d0dac843dc470dde0b4a...d6720785814a66493b779ab0c452c514ac86a223,3,262,90,352,55,2009-12-08 22:00:25,2009-12-08 22:00:25
d6720785814a66493b779ab0c452c514ac86a223...00a5220ec774cbb82d5a31618bf749d36a02429d,1,1,1,2,1,2009-12-08 22:04:32,2009-12-08 22:04:32
00a5220ec774cbb82d5a31618bf749d36a02429d...719cf8940b225818919f36a6b90c35e1eb89bcf0,2,2,3,5,3,2009-12-08 22:11:50,2009-12-08 22:11:50
719cf8940b225818919f36a6b90c35e1eb89bcf0...a6175a7e41b1840f6127bfb407a11f976cfe84c0,1,1,1,2,1,2009-12-09 15:18:09,2009-12-09 15:18:09
719cf8940b225818919f36a6b90c35e1eb89bcf0...a3a7634e3cf6dd1aea33a7d741d3b574d5f435ae,1,1,3,4,1,2009-12-09 01:54:27,2009-12-09 01:54:27
e1b753b84d731d887919e5b010d049b1dd4604f3...5660a25e9bf3bb86e2c84a3581154efc2d7d1b11,1,70,0,70,1,2009-12-09 16:55:26,2009-12-09 16:55:26
5660a25e9bf3bb86e2c84a3581154efc2d7d1b11...dcf3a10eeaef2ea22678c9ae9aaa1fa2e9a81fa2,20,59,32,91,34,2009-12-09 17:00:17,2009-12-03 22:25:22
dcf3a10eeaef2ea22678c9ae9aaa1fa2e9a81fa2...6b57e57e7b699217b2f44947e57dac484d1ff5aa,4,23,4,27,5,2009-12-09 22:00:14,2009-12-09 22:00:14
dcf3a10eeaef2ea22678c9ae9aaa1fa2e9a81fa2...ed04f1c7930912d2b873dfbe412c7310f07388ff,1,4,0,4,3,2009-12-09 19:58:37,2009-12-09 19:58:37
dcf3a10eeaef2ea22678c9ae9aaa1fa2e9a81fa2...4987213af9d1de0b948411e0d8ce4c16d4e59ba8,2,16,22,38,10,2009-12-09 18:19:18,2009-12-09 18:19:18
f684565c7109047dd08662d90f84246aed069362...f48ed07ffcadf4710584562db865c6d123adecce,1,18,4,22,4,2009-12-09 20:16:28,2009-12-09 20:16:28
f684565c7109047dd08662d90f84246aed069362...f64ec0964aeb1ac93fd399da1f7a60d97a0f4243,3,5,2,7,3,2009-12-09 20:02:42,2009-12-09 20:01:55
4987213af9d1de0b948411e0d8ce4c16d4e59ba8...5ee785e34a06f7b3177aa338bf8fbef5b6a5f790,8,99,82,181,49,2009-12-09 21:36:31,2009-12-09 21:36:31
79febf161657f380b8572f9cb5e10f5fdcd914aa...378e3ee276f35138235afcdb8cd093122f5746df,13,120,166,286,73,2009-12-10 01:38:48,2009-12-10 01:38:48
79febf161657f380b8572f9cb5e10f5fdcd914aa...4390797b8829d6e8a32319a6531466ead251bd57,7,43,23,66,22,2009-12-09 23:13:36,2009-12-09 23:13:36
79febf161657f380b8572f9cb5e10f5fdcd914aa...7702dd7964e640a010bddd2861ad0ef11324dfd6,1,1,0,1,1,2009-12-09 22:29:04,2009-12-09 22:29:04
7702dd7964e640a010bddd2861ad0ef11324dfd6...112875705669336ba801396b222ed8719dd6521a,1,1,2,3,2,2009-12-09 22:34:18,2009-12-09 22:34:18
112875705669336ba801396b222ed8719dd6521a...650f024d75f472f9be6340cc498b1d7602a7a005,1,1,1,2,1,2009-12-09 22:41:14,2009-12-09 22:41:14
496cec54952438f2e5dae3ffb164f491fb37fc49...f9184738d3bc6c6997a0f28f965c693fb55116e1,4,43,42,85,26,2009-12-09 21:57:53,2009-12-09 21:57:53
12db6e16ea98a2c81991829c6052d79a9ecb8230...a4a4fc0a58e71a62e7fe757e9f03128ba44d0451,1,1,1,2,1,2009-12-10 02:29:59,2009-12-10 02:29:59
a4a4fc0a58e71a62e7fe757e9f03128ba44d0451...32d56f6d81a98b569103149c9ffea9f25a1ece81,1,16,1,17,3,2009-12-10 02:30:09,2009-12-10 02:30:09
c34d47f79fbcae5cdab7267224d5ce9b692b567d...28141877ee7e411b1d86edccfa068c892f3f96da,6,29,46,75,32,2009-12-09 23:57:19,2009-12-09 23:55:59
f9184738d3bc6c6997a0f28f965c693fb55116e1...940e6d12edee04f2b080b249bf7dbe82f31f55e0,2,6,0,6,6,2009-12-09 22:04:14,2009-12-09 22:04:14
32d56f6d81a98b569103149c9ffea9f25a1ece81...beb2fcafd0a62a2600785679b956a2b04f79da15,2,6,8,14,3,2009-12-10 17:08:37,2009-12-10 17:08:37
beb2fcafd0a62a2600785679b956a2b04f79da15...2472c5e55633e747caabd59197f225089cb85742,1,1,1,2,1,2009-12-10 18:08:27,2009-12-10 18:08:27
2472c5e55633e747caabd59197f225089cb85742...e344ab3280f115831ccd933864f9336a6f547a4e,1,1,0,1,1,2009-12-10 18:13:33,2009-12-10 18:13:33
32d56f6d81a98b569103149c9ffea9f25a1ece81...a74353b6f15331125206c0db17695c66a3c3bcab,3,13,3,16,7,2009-12-10 15:46:41,2009-12-10 15:46:41
a74353b6f15331125206c0db17695c66a3c3bcab...3d055367324c74cf51bbf717501574a7238ee687,1,11,1,12,1,2009-12-10 18:54:21,2009-12-10 18:54:21
ecf1dd7d1ad6dec0dab265df2bd51916c7dd26b3...9bf50a42e3cfa56ee50947e0d83edd318221e0e6,3,50,13,63,12,2009-12-10 19:29:14,2009-12-10 19:29:14
9bf50a42e3cfa56ee50947e0d83edd318221e0e6...4119148e978553491c44abeabcf650c43c3cbdb7,4,127,20,147,17,2009-12-10 20:59:09,2009-12-10 20:59:09
4119148e978553491c44abeabcf650c43c3cbdb7...341cd83dd1784a38ff6a25f72c6b81a58ea85de0,3,47,17,64,10,2009-12-10 21:38:47,2009-12-10 21:38:47
341cd83dd1784a38ff6a25f72c6b81a58ea85de0...03da5382fb5c223d8d225593693d321f6c9ea4f9,3,6,232,238,13,2009-12-10 22:02:47,2009-12-10 22:02:47
03da5382fb5c223d8d225593693d321f6c9ea4f9...6504ce17660a32e7230529d90a8b75b8f36e439b,1,7,6,13,7,2009-12-10 22:30:11,2009-12-10 22:30:11
6504ce17660a32e7230529d90a8b75b8f36e439b...b07d09c466e8536a687078d111abd347c292b8d8,1,16,0,16,1,2009-12-10 22:30:16,2009-12-10 22:30:16
b07d09c466e8536a687078d111abd347c292b8d8...45c1c325091c599e26079b63f7f9876db7f35a15,1,1,1,2,1,2009-12-12 03:19:13,2009-12-12 03:19:13
b07d09c466e8536a687078d111abd347c292b8d8...e42ea09fd1b830f2fcbadb58a2676dae30b62208,2,12,8,20,6,2009-12-11 17:41:26,2009-12-11 17:41:26
b07d09c466e8536a687078d111abd347c292b8d8...85799367e759ed309a1103659560799bd37dbcc8,3,78,13,91,14,2009-12-11 17:33:16,2009-12-11 17:33:16
1d66de5bbf02c15e41779ea10066de42d54dfbec...5a1729625200853f2fa12d2dfbd9d8a47e94a08c,1,35,11,46,7,2009-12-14 14:50:49,2009-12-14 14:50:49
5a1729625200853f2fa12d2dfbd9d8a47e94a08c...0196d8c583cc82de5a8a38ef200d2049d379b03c,1,16,1,17,3,2009-12-14 14:51:06,2009-12-14 14:51:06
0196d8c583cc82de5a8a38ef200d2049d379b03c...eed9fe77cd15de124e977add1e54897e78a078e9,2,1,2,3,3,2009-12-14 14:56:24,2009-12-14 14:56:24
eed9fe77cd15de124e977add1e54897e78a078e9...7639d5d1550c9ec4f24faa2c907a16973d119677,1,1,1,2,1,2009-12-14 16:06:06,2009-12-14 16:06:06
7639d5d1550c9ec4f24faa2c907a16973d119677...2abcf7cf18e99d7707d576c0500292fc032f8d1e,1,1,1,2,1,2009-12-14 17:38:26,2009-12-14 17:38:26
2abcf7cf18e99d7707d576c0500292fc032f8d1e...4818b0af41afbc8ac76972883498b7a467838941,1,11,3,14,3,2009-12-14 17:38:53,2009-12-14 17:38:53
4818b0af41afbc8ac76972883498b7a467838941...e006eba3385b7de4209dd5d8ddfb3aa8d1193af6,2,19,0,19,2,2009-12-14 18:54:05,2009-12-14 17:08:40
e006eba3385b7de4209dd5d8ddfb3aa8d1193af6...82ff9097585fa701ffe5cb78e59f8d0018c9f25c,1,5,4,9,1,2009-12-14 22:06:10,2009-12-14 17:58:47
82ff9097585fa701ffe5cb78e59f8d0018c9f25c...eba078d0537cd7f5b4f5c74f4fab667c44ebb0d6,2,3,13,16,4,2009-12-14 22:06:29,2009-12-10 18:50:43
eba078d0537cd7f5b4f5c74f4fab667c44ebb0d6...807216811773c80e47d75be43dca5da4c646e283,1,1,0,1,1,2009-12-14 22:57:46,2009-12-14 22:57:46
807216811773c80e47d75be43dca5da4c646e283...c6420d62e0748d5df85cc0499126c3e797c3f6cc,1,15,0,15,1,2009-12-15 02:10:37,2009-12-15 02:10:37
0d626c9e1eb7983766bac554f57ac500fcdd1b18...98d4235cd7dd7d4d3907c8307ad81cb092031dbb,1,4,2,6,1,2009-12-11 18:50:16,2009-12-11 18:50:16
98d4235cd7dd7d4d3907c8307ad81cb092031dbb...290694e15376610aa3ffb4954c49b778ba8b490d,1,5,0,5,1,2009-12-11 19:29:10,2009-12-11 19:29:10
290694e15376610aa3ffb4954c49b778ba8b490d...cb16e7c62b094c81fd443b6f33f9b72b2f5a58f9,2,14,6,20,7,2009-12-11 21:02:53,2009-12-11 21:02:53
cb16e7c62b094c81fd443b6f33f9b72b2f5a58f9...c6f5acbcac47c6e1730b59029b924dc536fb2955,1,19,0,19,1,2009-12-11 21:07:49,2009-12-11 21:07:49
c6420d62e0748d5df85cc0499126c3e797c3f6cc...3231cd90b6f37154ab9402f79eb72f44df82c3ca,1,11,0,11,1,2009-12-15 15:55:25,2009-12-15 15:55:25
c6420d62e0748d5df85cc0499126c3e797c3f6cc...68d11daac53e78bd310b46a78b738b6f3ae3cdb1,1,1,1,2,1,2009-12-15 15:34:50,2009-12-15 15:34:50
043ad72b74b84b3e57360524e7d7a2133040b80c...a6e2b4a60513eb4f11084475053818228c0ce9a3,1,33,3,36,4,2009-12-15 19:22:19,2009-12-15 19:22:19
a6e2b4a60513eb4f11084475053818228c0ce9a3...8add9a17b9fe9d4a0a647c982326a2279aac2d23,5,105,16,121,16,2009-12-15 23:52:41,2009-12-15 23:52:41
a6e2b4a60513eb4f11084475053818228c0ce9a3...200a68a1ffe84083a8da3a082d0e6584cbeccf4e,1,0,245,245,3,2009-12-15 20:38:25,2009-12-15 20:35:11
28cc666186517ca5dc8072456cd76f7e9e15b6d4...98fc9169e42ffb457d2344ff306b01f4b5b4a3e0,1,0,1,1,1,2009-12-15 23:54:07,2009-12-15 23:54:07
98fc9169e42ffb457d2344ff306b01f4b5b4a3e0...ebdb8282a2150c22a280705e99240d97b68e46d0,1,58,19,77,13,2009-12-16 00:54:39,2009-12-16 00:54:39
ebdb8282a2150c22a280705e99240d97b68e46d0...bec620a87a8ea0974431952d0aba291372002558,2,24,3,27,5,2009-12-16 01:40:53,2009-12-16 01:40:53
bec620a87a8ea0974431952d0aba291372002558...df1867b3a798092243849e578464f2eaa00e0b66,1,8,0,8,1,2009-12-16 02:03:29,2009-12-16 02:03:29
df1867b3a798092243849e578464f2eaa00e0b66...cb67dbc196968595bb99613ce2977c8af1c469eb,1,2,2,4,2,2009-12-16 18:41:01,2009-12-16 18:41:01
df1867b3a798092243849e578464f2eaa00e0b66...b9ddc3e9ef3b1e234bc84dd6a80326f0196a249d,2,18,5,23,6,2009-12-16 17:31:56,2009-12-16 17:31:56
b9ddc3e9ef3b1e234bc84dd6a80326f0196a249d...25b56fbba919cba1c370fc3dd9ee72b7deeef7ef,1,25,2,27,3,2009-12-16 18:36:17,2009-12-16 18:36:17
25b56fbba919cba1c370fc3dd9ee72b7deeef7ef...7c13d80f1c046067a714658159e41a2e224a3bc8,1,3,0,3,2,2009-12-16 18:37:29,2009-12-16 18:37:29
7c13d80f1c046067a714658159e41a2e224a3bc8...df01c097d655133080dabb4b40f7c1bc8754b522,1,26,7,33,4,2009-12-16 19:14:48,2009-12-16 19:14:48
cb67dbc196968595bb99613ce2977c8af1c469eb...ee53e7ec8b7702574d36ad8d2245d042204fa4b3,2,107,0,107,4,2009-12-16 19:38:05,2009-12-16 19:35:33
c28e159520f23277156e22c6f3d25cff2a07eb73...385bb326413e01ba27e62ab582e9b57f9251c269,1,24,6,30,9,2009-12-16 19:42:46,2009-12-16 19:42:46
ec440eda858611bf023a662c614a2cac8ef869d8...78a9e77c33a0276893ec2412bc4305195a5b5665,2,15,21,36,5,2009-12-16 22:49:22,2009-12-16 22:49:22
ec440eda858611bf023a662c614a2cac8ef869d8...edfe77b6efbe1a831cabe66363d8308c7af85f43,6,140,31,171,29,2009-12-16 21:26:49,2009-12-16 21:26:49
edfe77b6efbe1a831cabe66363d8308c7af85f43...27ee2bb5d89a8d83103f8d11ec78f10a17be37d5,1,7,1,8,2,2009-12-16 21:31:31,2009-12-16 21:31:31
27ee2bb5d89a8d83103f8d11ec78f10a17be37d5...a87bb5b8788059f3d4b273f5d1410761329b28bc,1,0,1,1,1,2009-12-16 21:39:03,2009-12-16 21:39:03
2e5ca7d391230286bd17810fa66d3b086d5ece92...643ad02d77769b59a458116b123f3902f8867cc6,5,135,8,143,12,2009-12-17 00:50:36,2009-12-17 00:50:36
643ad02d77769b59a458116b123f3902f8867cc6...72f5a9db9c043a49d486a16cdf1d21ddd57dc519,1,5,3,8,1,2009-12-17 00:57:12,2009-12-17 00:57:12
72f5a9db9c043a49d486a16cdf1d21ddd57dc519...4cf6964975f5e7a87c2ac4a0f1e59a98c07f1666,1,2,2,4,2,2009-12-17 01:33:30,2009-12-17 01:33:30
4cf6964975f5e7a87c2ac4a0f1e59a98c07f1666...c3ea73736f3971adde40f41dfb7fdc9cff9b0a9a,1,4,1,5,1,2009-12-17 01:47:32,2009-12-17 01:47:32
c3ea73736f3971adde40f41dfb7fdc9cff9b0a9a...15971b9ad92f8c82897046c92b7bf55683f8c95b,1,4,0,4,1,2009-12-17 02:37:31,2009-12-17 02:37:31
15971b9ad92f8c82897046c92b7bf55683f8c95b...de3db911a0a9a7cd0e6b668cda1d45fe44c05155,3,41,6,47,5,2009-12-17 02:53:12,2009-12-17 02:53:12
de3db911a0a9a7cd0e6b668cda1d45fe44c05155...3e5d63dd63d4b89dbd52deb45248cd8610f7c4b1,1,0,1,1,1,2009-12-17 04:29:49,2009-12-17 04:29:49
3e5d63dd63d4b89dbd52deb45248cd8610f7c4b1...63c52d08da93d175b4fb9672cdf1ec13a3ed5807,2,8,3,11,4,2009-12-17 04:34:43,2009-12-17 04:34:43
63c52d08da93d175b4fb9672cdf1ec13a3ed5807...6405d2d0f88b6f88caafcf67884264d31a363b64,1,4,4,8,2,2009-12-17 15:23:23,2009-12-17 15:23:23
6405d2d0f88b6f88caafcf67884264d31a363b64...7ac119e0623256f95a96bbcf394e3492debbc5b6,4,18,11,29,11,2009-12-17 21:18:00,2009-12-17 21:18:00
6405d2d0f88b6f88caafcf67884264d31a363b64...fbbbdd3e70f294880d89a8427db3a54200fef4fa,1,6,0,6,1,2009-12-17 21:15:36,2009-12-17 21:15:36
fbbbdd3e70f294880d89a8427db3a54200fef4fa...a7635d3b09aa9421cb02a92366d0bf63705435ea,3,43,20,63,19,2009-12-17 21:54:40,2009-12-17 21:54:40
a7635d3b09aa9421cb02a92366d0bf63705435ea...d85fa3e076c45185216f1f8b9b8915736092019b,2,61,9,70,5,2009-12-17 21:55:13,2009-12-17 21:55:13
4771ba64e3918c7a5e859136c17e754ab7c8ccbd...9cc8e2608ab8bb5758a136227cd611167f230744,3,8,7,15,7,2009-12-17 22:17:46,2009-12-17 22:17:46
4771ba64e3918c7a5e859136c17e754ab7c8ccbd...e7eb18f2f2aceacd2e81c36ba8b759f14ab96b6a,1,17,17,34,9,2009-12-17 22:15:13,2009-12-17 22:15:13
e7eb18f2f2aceacd2e81c36ba8b759f14ab96b6a...6909e1412bccd93d13a9daaf2cd8ad4882e13b18,1,14,1,15,3,2009-12-17 22:21:46,2009-12-17 22:21:46
c908b7094cf1e5a0286145218b360d6ecc3375d6...23f6ef2c9a619244640efe91181bb908da7020c1,1,2,1,3,2,2009-12-17 22:27:57,2009-12-17 22:27:57
23f6ef2c9a619244640efe91181bb908da7020c1...0d1a097017799a5eab91cdd0ec9b768609b67989,1,1,1,2,1,2009-12-17 22:29:29,2009-12-17 22:29:29
0d1a097017799a5eab91cdd0ec9b768609b67989...558bb8ccb80b1677b55d0ec4ce45b9ce8a85b7ce,1,26,1,27,3,2009-12-18 15:23:10,2009-12-18 15:23:10
0d1a097017799a5eab91cdd0ec9b768609b67989...4ea2e8ff49ba65658962eba140b4aca946af47d2,3,45,1,46,3,2009-12-18 01:45:54,2009-12-18 01:45:54
4ea2e8ff49ba65658962eba140b4aca946af47d2...a71ff0770108a0f25a0abbc900b49d600c38d77b,3,91,1,92,6,2009-12-18 06:50:43,2009-12-18 06:50:43
a71ff0770108a0f25a0abbc900b49d600c38d77b...e9257ac7518b61bef5cdcde4215d9043b5a369b5,2,20,1,21,2,2009-12-18 06:51:43,2009-12-18 06:51:43
65ee1eafdeb72b900fbe787994f9019738d2a6b4...2437f989c9e3c6ba8ff817047c83f015fe2bd22f,3,39,13,52,13,2009-12-18 22:43:40,2009-12-18 22:43:40
65ee1eafdeb72b900fbe787994f9019738d2a6b4...159f7df930565d55afdcdbe4286b9aba38f7f825,2,4,2,6,4,2009-12-18 16:24:10,2009-12-18 16:24:10
159f7df930565d55afdcdbe4286b9aba38f7f825...96472f28a31a28860ebcfebc4a7074e36dc35a2d,3,54,32,86,6,2009-12-18 19:10:24,2009-12-18 19:10:24
96472f28a31a28860ebcfebc4a7074e36dc35a2d...ce3f73a645c72a480a2d0e9d96d31bd4f35251ad,1,2,0,2,1,2009-12-18 21:53:27,2009-12-18 21:53:27
ce3f73a645c72a480a2d0e9d96d31bd4f35251ad...92bc50cff133ef161911ab1f93ccfb7616c93252,3,12,3,15,8,2009-12-18 21:53:44,2009-12-18 21:53:44
92bc50cff133ef161911ab1f93ccfb7616c93252...da08edb63dc7ba51a236608f9288b4bef969db1a,3,51,2,53,3,2009-12-18 22:28:36,2009-12-18 22:28:36
da08edb63dc7ba51a236608f9288b4bef969db1a...773c59c53cdf51d3d3d9549097033f8ad93b34b8,1,1,1,2,1,2009-12-18 22:39:02,2009-12-18 22:39:02
773c59c53cdf51d3d3d9549097033f8ad93b34b8...a0945b20200514910ecb2585f71710610cc41dfe,2,2,4,6,4,2009-12-18 22:41:26,2009-12-18 22:41:26
d27a3e0a1c375f735a6f3a0ac44407de165e92e8...9a7f5fb2d02e002877c6ae387aeaff0c5023a415,1,4,0,4,1,2009-12-18 22:47:40,2009-12-18 22:47:40
9a7f5fb2d02e002877c6ae387aeaff0c5023a415...facd9e514eb4b2282386dc28f447bb3e2b881b4c,1,1,1,2,1,2009-12-20 12:19:40,2009-12-20 12:19:40
facd9e514eb4b2282386dc28f447bb3e2b881b4c...9935b7904bde66774f4c68306bc090931bdc837f,1,1,1,2,1,2009-12-20 12:19:48,2009-12-20 12:19:48
a0945b20200514910ecb2585f71710610cc41dfe...8f1e01b0e4aac874a928a2f95248dd4d5500e05e,10,37,38,75,32,2009-12-21 15:06:14,2009-12-21 15:06:14
bbd33359d9e4b66d762716dce80235bc818a4fce...3e2d226bee35cd6a53933df51699ddfe0fceae47,1,1,0,1,1,2009-12-21 15:20:30,2009-12-21 15:20:30
3e2d226bee35cd6a53933df51699ddfe0fceae47...dcd4040ed582578b215ca14288cc9187237d9044,1,6,0,6,2,2009-12-21 15:58:20,2009-12-21 15:58:20
dcd4040ed582578b215ca14288cc9187237d9044...3c30bcb82601373082b00bc1b057e3dadc028507,5,84,55,139,35,2009-12-21 18:19:20,2009-12-21 18:19:20
dcd4040ed582578b215ca14288cc9187237d9044...e6b27edec70573719e79fca102489939c7e89dc0,4,14,3,17,5,2009-12-21 17:26:16,2009-12-21 17:26:16
e6b27edec70573719e79fca102489939c7e89dc0...455bf0c0492421f8467f88e1f2371cb3e29dc5d9,4,93,25,118,13,2009-12-21 17:55:20,2009-12-21 17:55:20
455bf0c0492421f8467f88e1f2371cb3e29dc5d9...499cb647b65ca9d1b0cbdc27f72359b30bf2bf39,1,2,2,4,2,2009-12-21 17:57:04,2009-12-21 17:57:04
499cb647b65ca9d1b0cbdc27f72359b30bf2bf39...83d4e4f2e18c3aacbdada4afca468b44c75f42f3,1,1,1,2,1,2009-12-21 18:17:21,2009-12-21 18:17:21
0f17215227b9307c7f880a1c1da08a979617feb4...8a1cecd76e3630b6d3ba932de5ac5cc1944dec08,2,3,0,3,3,2009-12-21 19:08:13,2009-12-21 19:08:13
83d4e4f2e18c3aacbdada4afca468b44c75f42f3...81b7e051b2c42e47566b9005e3db13e6a59ea68b,14,597,446,1043,49,2009-12-21 19:21:25,2009-12-21 19:21:25
8a1cecd76e3630b6d3ba932de5ac5cc1944dec08...65ae0207087592fb779eefcc5d14fbd9fbe77387,4,22,85,107,10,2009-12-21 19:22:23,2009-12-21 19:22:23
92212a0cd2e739aec5dfb08f9e751b8ef8e8281c...e7e790ee960c7e455b6655064f15a7547d38b039,1,7,1,8,1,2009-12-21 19:34:02,2009-12-21 19:34:02
65cf70f9f61800b157aeafe603924e28ec0bccf9...4d7f8777bfaf0fbb6700f684894cc1c0cc3ae234,1,6,6,12,4,2009-12-21 19:32:23,2009-12-21 19:32:23
4d7f8777bfaf0fbb6700f684894cc1c0cc3ae234...fcda57d9de2a825397e2cb6c20e57b2ef7b531ea,1,1,0,1,1,2009-12-21 19:45:18,2009-12-21 19:45:18
4d7f8777bfaf0fbb6700f684894cc1c0cc3ae234...75883ad1f2e2696779e5804e026ddc925297761a,1,6,6,12,4,2009-12-21 19:45:13,2009-12-21 19:45:13
4f16eebd296cfd6108000bbf577f6d83292b5a57...fb9834049b826b2894523e158475ec9682464b20,1,11,0,11,1,2009-12-21 20:13:39,2009-12-21 20:13:39
1efd9ea3b47b50252da4a2ea6c00bf70a6727ea1...c32fbf2b0f4c8a87306d32bb9cb8c17860d5225b,1,44,1,45,3,2009-12-21 20:56:56,2009-12-21 20:56:56
65405649fce9f2f5bd813038bac539d54df1d79b...a9ba76825ecafb78987b523f9e73cc0abd62c23f,1,6,7,13,1,2009-12-21 21:34:09,2009-12-21 21:34:09
a9ba76825ecafb78987b523f9e73cc0abd62c23f...0e1575bd36b5ba6f26ac936ded86d0380f25dd37,10,77,54,131,50,2009-12-21 22:43:06,2009-12-21 22:43:06
a9ba76825ecafb78987b523f9e73cc0abd62c23f...ad93048085caf8d79b7850a61b2d0669f2b972e1,1,9,0,9,2,2009-12-21 22:37:23,2009-12-21 22:37:23
a9ba76825ecafb78987b523f9e73cc0abd62c23f...62a4aef8fd2ce7c3cf1b7ecded73a931887b0d18,3,103,12,115,14,2009-12-21 22:32:01,2009-12-21 22:32:01
d26ff27f29bd661ae442e78f5857dc9725ff6836...48feb5237fb8159adddb704e8b757a8c6975a62a,2,8,8,16,4,2009-12-21 22:45:53,2009-12-21 22:45:53
b5f9f43e1c9ac2a1cf7fc034833f2259d6ef8a3e...ad8698567078da9b0d085dd33e02ca98147afe60,1,5,0,5,2,2009-12-21 23:25:28,2009-12-21 23:25:28
ad8698567078da9b0d085dd33e02ca98147afe60...1477e29e2b3c41f677d0fe4eebcd9c827bd0f5e1,1,2,2,4,2,2009-12-21 23:36:00,2009-12-21 23:36:00
1477e29e2b3c41f677d0fe4eebcd9c827bd0f5e1...5d9f70180b38379b45450fdf27ef97319e97745d,1,3,0,3,1,2009-12-22 00:00:57,2009-12-22 00:00:57
5d9f70180b38379b45450fdf27ef97319e97745d...7c005a3fee2104ab00fb1c7c42c7cb5c0bd755b9,1,2,2,4,1,2009-12-22 00:09:47,2009-12-22 00:09:47
7c005a3fee2104ab00fb1c7c42c7cb5c0bd755b9...566603ad8b9f77e62676fdf72c0164453bea39b3,1,1,1,2,1,2009-12-22 12:26:28,2009-12-22 12:26:28
566603ad8b9f77e62676fdf72c0164453bea39b3...501ed5ac20568889c20dbc6476b95cb4f96cdb5e,1,13,0,13,1,2009-12-22 12:26:51,2009-12-22 12:26:51
7c005a3fee2104ab00fb1c7c42c7cb5c0bd755b9...de9e185d3d0ce38da0da0ff82509a90c383c4870,1,1,0,1,1,2009-12-22 00:48:52,2009-12-22 00:48:52
de9e185d3d0ce38da0da0ff82509a90c383c4870...bbcc6c1d0c80305396f051efdc34935505b614be,4,63,13,76,5,2009-12-22 01:03:12,2009-12-22 01:03:12
bbcc6c1d0c80305396f051efdc34935505b614be...0e045e2fe1f9dede478a2980d6f4f75b6bc7b0ad,1,7,0,7,2,2009-12-22 03:49:51,2009-12-22 03:49:51
0e045e2fe1f9dede478a2980d6f4f75b6bc7b0ad...44d85e4713ff79a3466ae03c71d43f2b173bfe68,1,3,4,7,3,2009-12-22 03:56:41,2009-12-22 03:56:41
44d85e4713ff79a3466ae03c71d43f2b173bfe68...793dfc134b24030ed19e29f4654077dfe56a75ce,1,2,0,2,2,2009-12-22 04:27:09,2009-12-22 04:27:09
793dfc134b24030ed19e29f4654077dfe56a75ce...643ec0261b21c8053dfabe9a9446d7bdc3ef788d,3,15,3,18,5,2009-12-22 04:40:04,2009-12-22 04:40:04
643ec0261b21c8053dfabe9a9446d7bdc3ef788d...6c7cc48dcd1788a97878f7c7a9ee6e4ea3092f63,1,26,13,39,5,2009-12-22 04:58:55,2009-12-22 04:58:55
6c7cc48dcd1788a97878f7c7a9ee6e4ea3092f63...2c1085d3a7c589045f8606e1a8c9900d1471e362,1,1,1,2,1,2009-12-22 15:00:47,2009-12-22 15:00:47
2c1085d3a7c589045f8606e1a8c9900d1471e362...62522b905bf96e12abd5d176ad1b70c2cb669930,13,79,54,133,32,2009-12-22 20:22:37,2009-12-22 20:22:37
2c1085d3a7c589045f8606e1a8c9900d1471e362...72282b1f8bff8f8f2056112643d9b2832b576828,1,4,1,5,2,2009-12-22 19:16:48,2009-12-22 19:16:48
2c1085d3a7c589045f8606e1a8c9900d1471e362...6da4e77c1a5ead6a08fd3d256a8a55a6e1e0c350,1,14,7,21,9,2009-12-22 17:13:58,2009-12-17 18:47:25
6da4e77c1a5ead6a08fd3d256a8a55a6e1e0c350...507622d302838c6c5e54f4863f14241e8190ad23,1,40,15,55,12,2009-12-22 17:13:58,2009-12-17 19:12:20
507622d302838c6c5e54f4863f14241e8190ad23...a871f11644754ecc283ea601067f1cf9b4ef33ea,4,250,1,251,6,2009-12-22 17:15:52,2009-12-22 17:13:40
a871f11644754ecc283ea601067f1cf9b4ef33ea...39967b06090dab2e55d71ab520708e5900b4c3d2,2,1,1,2,2,2009-12-22 17:52:11,2009-12-22 17:52:11
39967b06090dab2e55d71ab520708e5900b4c3d2...76275b5a6bae403289ab0dba760a3f5022761362,2,37,1,38,4,2009-12-22 18:12:30,2009-12-22 18:12:30
76275b5a6bae403289ab0dba760a3f5022761362...80bd8d169d617a90cd515fd720ba38720066617d,1,3,2,5,2,2009-12-22 18:19:48,2009-12-22 18:19:48
80bd8d169d617a90cd515fd720ba38720066617d...556a55420536d63159c762e377d4d1f640e54340,3,3,5,8,3,2009-12-22 18:47:03,2009-12-22 18:47:03
66f302878aabe48a5b6a2c0cd496a3b258403171...c86a5a480f70e9aea0cdbd60ebc8badf50657e93,1,2,0,2,1,2009-12-23 21:16:48,2009-12-23 21:16:48
c86a5a480f70e9aea0cdbd60ebc8badf50657e93...e19c177dec5da4d63e2665d4677e285bb0b92670,3,58,10,68,14,2009-12-24 18:11:10,2009-12-24 18:11:10
e19c177dec5da4d63e2665d4677e285bb0b92670...57137d6acaf8238cfe0686384b77d23800ef8b92,4,162,153,315,14,2009-12-26 03:06:07,2009-12-26 03:06:07
57137d6acaf8238cfe0686384b77d23800ef8b92...8a53ffb05c214775aab1df17bab818a7f83c7977,1,8,6,14,6,2009-12-26 04:24:37,2009-12-26 04:24:37
8a53ffb05c214775aab1df17bab818a7f83c7977...2390b483bc07433a4b0c3a25b064c85e73c8f6d3,1,6,0,6,2,2009-12-27 05:41:30,2009-12-27 05:41:30
2390b483bc07433a4b0c3a25b064c85e73c8f6d3...55744fd04cb8639465d36516e4791ef1eab7078e,1,5,0,5,1,2009-12-27 05:41:39,2009-12-27 05:41:39
55744fd04cb8639465d36516e4791ef1eab7078e...bffb7fd6e18c7f8ac34676600eedbbe8fa791777,2,18,19,37,14,2009-12-27 05:41:53,2009-12-27 05:41:53
09fa026665bf064231ef4bb40adbc4382a4aeac8...15535d09065e59d25e1b240f57f6a4f21cff0451,3,12,7,19,8,2009-12-22 21:42:49,2009-12-22 21:42:49
556a55420536d63159c762e377d4d1f640e54340...770394a02d11fdf3b62be0c671083fb14826e1a0,2,5,1,6,2,2009-12-22 19:39:23,2009-12-22 19:39:23
bffb7fd6e18c7f8ac34676600eedbbe8fa791777...24e2542d9525102369d8cf78bd165b2cc2629670,10,6,103,109,12,2009-12-29 18:42:45,2009-12-29 18:42:45
bffb7fd6e18c7f8ac34676600eedbbe8fa791777...3699192679c7aef16068d32f309c1df387a79a9e,1,13,3,16,5,2009-12-28 20:03:47,2009-12-28 20:03:47
3699192679c7aef16068d32f309c1df387a79a9e...ad6c3d4132ab83dfe5a2df5f13725e469f6499e9,2,31,15,46,8,2009-12-28 21:05:11,2009-12-28 21:05:11
ad6c3d4132ab83dfe5a2df5f13725e469f6499e9...083629d0d1505692a44a18454e3907cc3c95b524,1,2,0,2,2,2009-12-28 21:08:51,2009-12-28 21:08:51
bffb7fd6e18c7f8ac34676600eedbbe8fa791777...5d153aaee0a013f4507cf3f74dad4ebbfb5402b1,1,1,0,1,1,2009-12-28 18:09:34,2009-12-28 18:09:34
5d153aaee0a013f4507cf3f74dad4ebbfb5402b1...1c4f05b3bd21b8806ffe0ce25bf5ec3a381c3b72,2,13,3,16,2,2009-12-28 18:09:44,2009-12-28 18:09:44
1c4f05b3bd21b8806ffe0ce25bf5ec3a381c3b72...a7f5b115d9a07ef7be54fb7e6bbc8d89da9d2f11,1,1,1,2,1,2009-12-28 18:10:39,2009-12-28 18:10:39
a7f5b115d9a07ef7be54fb7e6bbc8d89da9d2f11...6df2dd965ee1ba576522096e67c2e1f773a669e9,1,25,0,25,1,2009-12-28 18:11:36,2009-12-28 18:11:36
6df2dd965ee1ba576522096e67c2e1f773a669e9...0a71e870ced185119b233e941d99bf363cae92cb,2,13,10,23,4,2009-12-28 20:37:18,2009-12-28 20:37:18
0a71e870ced185119b233e941d99bf363cae92cb...95137f262c2a57831dccf058428a2f64e900496e,1,16,0,16,1,2009-12-28 20:45:29,2009-12-28 20:45:29
791cc89fcc5f8f9832668c7c7f2fadfae335fd06...503473112d0da69914c8e58eb3aec61d8b0d7f27,2,5,5,10,4,2009-12-23 20:28:53,2009-12-23 20:28:53
791cc89fcc5f8f9832668c7c7f2fadfae335fd06...b5b18e4a71102a4f78cebd72bef0236bdddc31da,1,2,1,3,1,2009-12-23 17:00:04,2009-12-23 17:00:04
b5b18e4a71102a4f78cebd72bef0236bdddc31da...b8a19f52257d67da033907b90fe4b6d5545b7261,1,2,0,2,1,2009-12-23 17:09:56,2009-12-23 17:09:56
b8a19f52257d67da033907b90fe4b6d5545b7261...8c89428182c7728797e92d29cd1811235636464b,2,22,15,37,12,2009-12-23 17:12:39,2009-12-23 17:11:26
03eaaf92b0dfe9bf25fcd656ff1fed2b3207fe06...f97a6f32d69d42bba3b886d6eccf58a6256b9508,2,18,0,18,4,2009-12-22 21:07:36,2009-12-22 21:07:36
f97a6f32d69d42bba3b886d6eccf58a6256b9508...7dcfe01698f5a64baa6088fd22223490b746483c,5,136,0,136,7,2009-12-22 22:32:45,2009-12-22 22:32:45
7dcfe01698f5a64baa6088fd22223490b746483c...d70db47d96390357b91565df295b6d061b4136d7,6,33,6,39,12,2009-12-22 23:08:17,2009-12-22 23:08:17
d70db47d96390357b91565df295b6d061b4136d7...8435fd5526effa9433bf3796be93e46fb38734ae,1,22,0,22,1,2009-12-22 23:08:47,2009-12-22 23:08:47
8435fd5526effa9433bf3796be93e46fb38734ae...980006020db78f3a1f68777160da1dce72810fff,1,25,2,27,3,2009-12-23 01:56:54,2009-12-23 01:56:54
980006020db78f3a1f68777160da1dce72810fff...81cf93cf8af6f637ce41239c7157df4a4d622123,5,28,19,47,16,2009-12-23 01:56:57,2009-12-23 01:56:57
6f4bfb2e1481caff4b5013765bc28ccdf7900033...eba11eace346c9b16cf71ca0cc6f1661d259e425,1,0,0,0,0,2009-12-29 18:46:05,2009-12-29 18:46:05
df5dbd3a346f4070d071f063c55f181a693ee0f3...548fc0f895e17b5f1da9d6dca853a5d21ab75ee7,2,2,2,4,2,2009-12-28 21:16:47,2009-12-28 21:16:47
95137f262c2a57831dccf058428a2f64e900496e...0ab8149a8e9e900b63ee28b9590a249578339376,88,571,482,1053,435,2009-12-28 21:43:43,2009-12-28 21:43:43
34ce72162482ced2ef5c19dbfc3ccfa8ac44ded3...16b07128f3cb15cc785088852667b57c49fc66fb,1,3,0,3,1,2009-12-23 20:55:07,2009-12-23 20:55:07
16b07128f3cb15cc785088852667b57c49fc66fb...e8e4fd2d3c56d7a009ee64d3d096516b6789a7c6,1,1,0,1,1,2009-12-23 20:57:32,2009-12-23 20:57:32
e8e4fd2d3c56d7a009ee64d3d096516b6789a7c6...75c7d69277414bd9f95897bda970d19b1c42558f,1,1,1,2,1,2009-12-23 20:59:47,2009-12-23 20:59:47
75c7d69277414bd9f95897bda970d19b1c42558f...e1a4c3f0afe82aa029d37abb60cdc26807f20802,1,20,1,21,3,2009-12-23 21:00:04,2009-12-23 21:00:04
e1a4c3f0afe82aa029d37abb60cdc26807f20802...c7587eac0b2d5e816c52dd29bc784684aababc47,1,0,1,1,1,2009-12-23 21:10:58,2009-12-23 21:10:26
d00886d07eb3062e01efc156152ad4a99f2bfa0b...f05a6aafb31d483b56dc1c9008e5b07e44a735ef,2,2,1,3,2,2009-12-29 19:29:32,2009-12-29 19:29:32
548fc0f895e17b5f1da9d6dca853a5d21ab75ee7...91362b9e354970f54a2acab9cf7089bf603713e1,5,128,48,176,48,2009-12-29 19:04:00,2009-12-29 19:04:00
91362b9e354970f54a2acab9cf7089bf603713e1...453aa1977ebb8a897ae803bc093fa8d09a4afe26,2,29,65,94,21,2009-12-29 19:13:08,2009-12-29 19:13:08
a3a0bc64f9082d712d8a0789811257ad45a6cb0b...fa8961c3e8804a2fd606160d7649e973e906d0b4,24,68,53,121,55,2009-12-28 22:06:07,2009-12-28 22:06:07
fa8961c3e8804a2fd606160d7649e973e906d0b4...d5a5401f9ae5aacaf41cb34e70c8e9eecf1b2fb9,6,22,11,33,15,2009-12-28 22:12:49,2009-12-28 22:12:49
d5a5401f9ae5aacaf41cb34e70c8e9eecf1b2fb9...35dc5cd0fd38bb16a97b0fbff3d86a07452892bc,1,1,1,2,1,2009-12-28 22:17:01,2009-12-28 22:17:01
35dc5cd0fd38bb16a97b0fbff3d86a07452892bc...315995b8c7e3a5bd55d0248535bf5742bd7bdb7f,1,1,1,2,1,2009-12-28 22:46:41,2009-12-28 22:46:41
f05a6aafb31d483b56dc1c9008e5b07e44a735ef...758cd7350d350b9dc9433fd1e8f04990cf7e5294,6,21,15,36,12,2009-12-29 19:48:42,2009-12-29 19:48:42
315995b8c7e3a5bd55d0248535bf5742bd7bdb7f...b93d04c91f3e59320bef3f7eca9a8deb016089bd,1,1,1,2,1,2009-12-29 15:43:34,2009-12-29 15:43:34
315995b8c7e3a5bd55d0248535bf5742bd7bdb7f...afbe8c64d9fe1e36a302f5264d82462b200056f1,1,4,4,8,4,2009-12-28 23:27:18,2009-12-28 23:27:18
afbe8c64d9fe1e36a302f5264d82462b200056f1...959fc2c674e02ea38ea04912a5a2ad2312a79bd3,1,20,4,24,2,2009-12-29 00:00:33,2009-12-29 00:00:33
959fc2c674e02ea38ea04912a5a2ad2312a79bd3...ac11216a20f95717e971261418d6dd83611fa421,1,3,3,6,3,2009-12-29 00:05:26,2009-12-29 00:05:26
100ebb70d1ca3294d138b96dfd544176e2c17637...75c7995a2ac69e61b00390b607b2b5138f5b4626,1,0,6,6,1,2009-12-29 19:46:57,2009-12-29 19:46:57
34e82de19209dd7d3a3aa84997bb228837fb7a52...b4b9ccfde5b7273e5cd2167cb9f2b7e8bf459312,1,13,8,21,2,2009-12-29 19:49:24,2009-12-29 17:12:47
b4b9ccfde5b7273e5cd2167cb9f2b7e8bf459312...5c846e013994d19663ba5f964ece7cecc0003479,1,7,1,8,2,2009-12-29 19:49:24,2009-12-29 19:23:48
5c846e013994d19663ba5f964ece7cecc0003479...ac84841e638adcd03ccda7c97e940fb6cc6bdf5b,4,161,3,164,11,2009-12-29 22:32:31,2009-12-29 22:32:31
ac84841e638adcd03ccda7c97e940fb6cc6bdf5b...16268ad41fd7de0fb109bf71f2c1ae26e611a574,1,1,1,2,1,2009-12-30 02:17:11,2009-12-30 02:17:11
16268ad41fd7de0fb109bf71f2c1ae26e611a574...e610aaddca8b0a8a23f170e7b08a68f627ed967c,1,1,1,2,1,2009-12-30 02:26:55,2009-12-30 02:26:55
216d1e59effd5eeaa09c9f5d1d66717b27d5aac9...3fd317da0a15a93d827208b7a020267da5e301fa,5,29,10,39,5,2009-12-29 16:49:24,2009-12-29 16:49:24
3fd317da0a15a93d827208b7a020267da5e301fa...3b37c3fbd4fa4f705540696d07f9d2ddb7904f3b,4,37,12,49,5,2009-12-29 17:08:13,2009-12-29 17:08:13
3b37c3fbd4fa4f705540696d07f9d2ddb7904f3b...7d65d20f5aed286a418d6e9e0bcc12d8bcb75cb8,5,25,6,31,13,2009-12-29 17:27:27,2009-12-29 17:27:27
75c7995a2ac69e61b00390b607b2b5138f5b4626...24169676c46d8fd8d996d81f628f2d76c60425d9,2,36,2,38,3,2009-12-29 20:02:21,2009-12-29 20:02:21
24169676c46d8fd8d996d81f628f2d76c60425d9...aece98652ee7284357a7e729ae2ee21aee259fe5,5,87,11,98,20,2009-12-30 01:29:24,2009-12-30 01:29:24
aece98652ee7284357a7e729ae2ee21aee259fe5...978582f803cddd0df6551e4ed4fe704e3fc012d4,4,12,15,27,8,2009-12-30 01:38:29,2009-12-30 01:38:29
978582f803cddd0df6551e4ed4fe704e3fc012d4...d1e3f2afe5fc8aee3e40c3c2278cf560d981526c,2,7,7,14,8,2009-12-30 02:04:57,2009-12-30 02:04:57
d1e3f2afe5fc8aee3e40c3c2278cf560d981526c...8573d53da75b62e86c7b0d6b56766aa3a86f9b1b,5,34,26,60,24,2009-12-30 02:27:49,2009-12-30 02:27:49
8573d53da75b62e86c7b0d6b56766aa3a86f9b1b...e88f0fdf4562ebf6b6d48c0823cecfadd79f6335,1,0,1,1,1,2009-12-30 02:28:26,2009-12-30 02:28:26
e88f0fdf4562ebf6b6d48c0823cecfadd79f6335...33cd7bc1e148af949c86790a678b8732aae77ee1,5,44,27,71,12,2009-12-30 03:01:10,2009-12-30 03:01:10
33cd7bc1e148af949c86790a678b8732aae77ee1...c1d105d076651af14bea3304e3f03fba6d33ad58,1,2,2,4,2,2009-12-30 03:07:44,2009-12-30 03:07:44
c1d105d076651af14bea3304e3f03fba6d33ad58...3b84e7162e2d328ea7ea2e8c53c70cb6d8cb4dc4,1,2,5,7,3,2009-12-30 03:26:54,2009-12-30 03:26:54
e610aaddca8b0a8a23f170e7b08a68f627ed967c...5f36804299a717ef4a96e7c1ac38e62a796d0e3c,13,87,67,154,66,2009-12-30 04:30:29,2009-12-30 04:30:29
7d65d20f5aed286a418d6e9e0bcc12d8bcb75cb8...2dcb747bac3685cfc4d06554f3350f2b97100891,4,90,1,91,9,2009-12-29 19:09:53,2009-12-29 19:09:53
bf9e214caf95638747d1ff6bc3a4d83247f869a4...54fd59f6e1f6837df0a4244c78d577aa686950db,1,1,1,2,1,2009-12-30 04:23:33,2009-12-30 04:23:33
5f36804299a717ef4a96e7c1ac38e62a796d0e3c...9e96ad0a07d68f07297003169d940e87894d24bb,1,7,4,11,4,2009-12-30 04:50:45,2009-12-30 04:50:45
13533a68a80a78ef9a6a4a2b4b1940380cc3ca8b...cdda7a23e4901e4074b4a13bfc1c5e1da3d9d367,1,8,2,10,1,2009-12-30 17:13:05,2009-12-30 17:13:05
13533a68a80a78ef9a6a4a2b4b1940380cc3ca8b...b88f54e21973f639858148a6add41d43c9bbdffa,5,39,27,66,23,2009-12-30 16:59:54,2009-12-30 16:59:54
b88f54e21973f639858148a6add41d43c9bbdffa...9f20ce7c030d50c40e912f150e71b708c70a9ac1,2,8,1,9,2,2009-12-30 18:06:23,2009-12-30 18:06:23
b2105cd91f8ec229bd8962c5d1d5ffe17d1f5524...1c65a22de4fc0d7b4a9e519045c6fec27e7839e7,3,30,12,42,8,2009-12-30 20:55:00,2009-12-30 20:55:00
b2105cd91f8ec229bd8962c5d1d5ffe17d1f5524...d0526bc8e4edecbe8c18f9467d6c843262a73313,1,5,4,9,1,2009-12-30 19:58:42,2009-12-30 19:58:42
d0526bc8e4edecbe8c18f9467d6c843262a73313...9aec39e1d57fc8b0d3c9f510ecc15cdcf39329ea,1,1,1,2,1,2009-12-30 20:22:13,2009-12-30 20:22:13
b144f96fe2d4015e8c5821e96c2e1d9a4db504cb...bfeca0fe1e16a7fc386680b25e2a1f46ee683be9,2,11,2,13,3,2009-12-30 21:03:34,2009-12-30 21:03:34
9aec39e1d57fc8b0d3c9f510ecc15cdcf39329ea...0130ac4b3b9bd72b2cab62a4ce2b7f4638aa58e1,2,3,2,5,2,2009-12-30 20:58:16,2009-12-30 20:58:16
0976462c3b73fad209635358316109830309295c...b04c8cfe2567fb54a1e1706e78f45940658adb7c,1,2,2,4,1,2009-12-30 22:30:20,2009-12-30 22:30:20
b04c8cfe2567fb54a1e1706e78f45940658adb7c...692b618d7d43df3a6ceb86d03d38052918f57b27,2,18,3,21,6,2009-12-30 22:56:44,2009-12-30 22:55:57
692b618d7d43df3a6ceb86d03d38052918f57b27...53667da6d84c5943c1b778f31c20df9a63700bde,1,1,0,1,1,2009-12-30 23:41:07,2009-12-30 23:41:07
53667da6d84c5943c1b778f31c20df9a63700bde...225173bb31d7536b9e402145c7f65db00e2523ab,3,106,0,106,4,2009-12-31 01:08:43,2009-12-31 01:08:43
225173bb31d7536b9e402145c7f65db00e2523ab...ce20d70bd02a5223744e6a82d1eadebac9b05f2b,1,1,1,2,1,2009-12-31 01:48:48,2009-12-31 01:48:48
92736faa77768ff8a0c03b03d4f67e8a38567a5d...3efd53fc853420bdd0db0af944794eb5d7c24d8e,1,49,4,53,1,2009-12-30 22:03:53,2009-12-30 22:03:53
3d831edf3da3ecde73c84d25dbd9f542c3c8a665...6fb87032031c0d9f88490c14b953b5dd934a5849,2,2,2,4,2,2009-12-31 16:29:42,2009-12-31 16:29:42
6fb87032031c0d9f88490c14b953b5dd934a5849...417924bf1e84c5a402b336125ac2bfcdd7743af4,2,10,6,16,9,2009-12-31 20:51:58,2009-12-31 20:51:58
6fb87032031c0d9f88490c14b953b5dd934a5849...c9de787f171db9abdfe9f580c7fc043b7806a1a4,4,65,25,90,21,2009-12-31 19:04:44,2009-12-31 19:04:44
c9de787f171db9abdfe9f580c7fc043b7806a1a4...0a3e1071cb4bb91d1c9c6cb36cac3a0337a97230,2,41,4,45,6,2009-12-31 19:30:04,2009-12-31 19:30:04
0a3e1071cb4bb91d1c9c6cb36cac3a0337a97230...14174c7fa46e1a45dfdf04e0d0912d95f873e232,1,1,1,2,1,2009-12-31 19:56:07,2009-12-31 19:56:07
14174c7fa46e1a45dfdf04e0d0912d95f873e232...ba47f3a27d1ba668dd08f57b28910c1fe63a59b8,2,39,13,52,8,2009-12-31 20:18:43,2009-12-31 20:18:43
8d39a1f5aa5564cba0013bff7d9b97cb7433d47b...0aef7092be310f9253ac0e9218f81399e8e6f10c,7,13,10,23,11,2009-12-31 21:22:28,2009-12-31 21:22:28
0aef7092be310f9253ac0e9218f81399e8e6f10c...e21bb90572611fc7dd79a3b373e37f2dee38cf06,1,4,4,8,4,2009-12-31 21:26:26,2009-12-31 21:26:26
e21bb90572611fc7dd79a3b373e37f2dee38cf06...bf86eaeccf7d68f94ec8b7ba8758871c16acd37c,1,5,4,9,3,2009-12-31 21:30:10,2009-12-31 21:30:10
e21bb90572611fc7dd79a3b373e37f2dee38cf06...578f1973eae0f310c58ff00955232b36f38ae24d,1,2,0,2,1,2009-12-31 21:27:08,2009-12-31 21:27:08
578f1973eae0f310c58ff00955232b36f38ae24d...d531f77f671b849b03797a3ae5880fbe4b369579,11,30,30,60,30,2009-12-31 21:31:07,2009-12-31 21:31:07
135802bfffbdfa9a498116fcb7b47fc9ff2b39d7...54b7dbe7c30b30aaa2079fd9722cdf5756574e10,3,5,5,10,5,2009-12-31 21:34:27,2009-12-31 21:34:27
54b7dbe7c30b30aaa2079fd9722cdf5756574e10...23326c222d8a88c6d4b372a348241528a8726b5c,1,0,2,2,1,2009-12-31 21:42:45,2009-12-31 21:42:45
23326c222d8a88c6d4b372a348241528a8726b5c...ca426dd7664f2b694e4a7f30ac40f6c4a3d85861,1,4,0,4,1,2010-01-08 20:09:00,2010-01-08 20:09:00
23326c222d8a88c6d4b372a348241528a8726b5c...84d1ca75f73d219e7b5d2b8058cc8843fd8f82bf,5,335,220,555,18,2010-01-02 16:01:47,2010-01-02 16:01:47
23326c222d8a88c6d4b372a348241528a8726b5c...fcf2d5721c4e233009e12b0db325b164327db377,6,128,56,184,19,2010-01-02 06:25:53,2010-01-02 06:25:53
fcf2d5721c4e233009e12b0db325b164327db377...9b1d3f135d70fc30f7c85c50e088b2f59068c708,2,4,0,4,2,2010-01-02 06:28:08,2010-01-02 06:28:08
9b1d3f135d70fc30f7c85c50e088b2f59068c708...5f7ea78daee28c948c4e1bd4684eec044ce87bee,1,3,3,6,3,2010-01-02 13:41:12,2010-01-02 13:41:12
de3163e5eb19ca91a88af9c6ae1b0763b6ddca8c...fd05bdf2225ddf3219e4eafc570d603a6ef6c9c4,1,2,2,4,2,2010-01-08 20:33:31,2010-01-08 20:33:31
0556be40804a549bc5eb5c85a061b4cbfa6c3b33...3bd638645a573dbee4c007cbd08b5557e4d2a4ea,2,23,0,23,2,2010-01-02 16:31:38,2010-01-02 16:31:38
3bd638645a573dbee4c007cbd08b5557e4d2a4ea...d1b20f280b3d0194db04f464ceedbc290085b275,1,5,2,7,2,2010-01-02 22:02:45,2010-01-02 22:02:45
d1b20f280b3d0194db04f464ceedbc290085b275...bf939ef98543c077a70cc1a57994972c7e702853,1,8,0,8,1,2010-01-03 02:41:35,2010-01-03 02:41:35
bf939ef98543c077a70cc1a57994972c7e702853...7d265530618f209bae0bf2fd4da8f223b614e66b,16,69,53,122,47,2010-01-03 21:37:38,2010-01-03 21:37:38
7d265530618f209bae0bf2fd4da8f223b614e66b...4d8a09b25add1a55a439361e1b7a3fa7d856ac11,8,75,27,102,31,2010-01-04 16:15:09,2010-01-04 16:15:09
4d8a09b25add1a55a439361e1b7a3fa7d856ac11...70a290f86194409c592ca5dc86f531ac979ed4d7,1,1,1,2,1,2010-01-04 17:34:24,2010-01-04 17:34:24
70a290f86194409c592ca5dc86f531ac979ed4d7...c8dc0fe1316ad95d6aaf8dc47e62046a7221b014,1,14,0,14,2,2010-01-04 17:34:34,2010-01-04 17:34:34
c8dc0fe1316ad95d6aaf8dc47e62046a7221b014...a0f882dae0a477f8c3ed1c75daa6bf84cab83cc8,2,10,11,21,2,2010-01-04 18:11:46,2010-01-04 18:11:46
a0f882dae0a477f8c3ed1c75daa6bf84cab83cc8...f0d60f2396aa57210aaddf5b208d0d4ab047aded,4,49,8,57,15,2010-01-04 18:50:36,2010-01-04 18:50:36
f0d60f2396aa57210aaddf5b208d0d4ab047aded...d77c57138b066585ea90e60bdd3903b68338be8d,1,0,15,15,4,2010-01-04 18:54:12,2010-01-04 18:54:12
d77c57138b066585ea90e60bdd3903b68338be8d...e95f9121ca16c3a86b78c6e64066aed21d5fc3bd,1,3,3,6,2,2010-01-04 19:23:12,2010-01-04 19:23:12
e95f9121ca16c3a86b78c6e64066aed21d5fc3bd...3cec831af71e75e24234a68c036aba1753f746dd,1,9,4,13,3,2010-01-04 20:38:29,2010-01-04 20:38:29
5f7ea78daee28c948c4e1bd4684eec044ce87bee...d58e419f37484605211518550a735502576f6212,1,8,3,11,1,2010-01-02 15:10:40,2010-01-02 15:10:40
5f7ea78daee28c948c4e1bd4684eec044ce87bee...02a960c1d3352dad794a681a37ed0a578f5ed360,2,26,0,26,2,2010-01-02 13:59:54,2010-01-02 13:59:54
6c9f7c49b4c0cd92ada884feebbd5fbafa170ce5...ce00f71bd4fac6514a697aaba8af3077cae5c60c,1,1,1,2,1,2010-01-10 01:20:37,2010-01-10 01:20:37
ce00f71bd4fac6514a697aaba8af3077cae5c60c...51cbeda9d4cd5196553995ccda45d99c67929a29,1,10,3,13,1,2010-01-10 01:20:44,2010-01-10 01:20:44
51cbeda9d4cd5196553995ccda45d99c67929a29...b490e0a4ab5d8d81b0aa64c404c3992c07972a44,4,72,11,83,9,2010-01-11 01:22:17,2010-01-11 01:22:17
b490e0a4ab5d8d81b0aa64c404c3992c07972a44...721588bd261f19d883aa5c2d73d07422ca77e19e,1,9,6,15,4,2010-01-11 11:27:52,2010-01-11 11:27:52
721588bd261f19d883aa5c2d73d07422ca77e19e...fa1b3331b2eb4709020519247c1625210a740a87,1,3,1,4,1,2010-01-11 11:28:27,2010-01-11 11:28:27
fa1b3331b2eb4709020519247c1625210a740a87...e011523b20b490b90dfe4096d207e7850a6cfd93,1,5,6,11,6,2010-01-11 11:38:16,2010-01-11 11:38:16
e011523b20b490b90dfe4096d207e7850a6cfd93...cfdca85934468a703774ea2338e661ef271a0332,1,2,2,4,2,2010-01-11 11:44:00,2010-01-11 11:44:00
cfdca85934468a703774ea2338e661ef271a0332...0cae27cbe34533aca017ff6b99cd84390651ad68,1,4,2,6,3,2010-01-11 11:53:39,2010-01-11 11:53:39
0cae27cbe34533aca017ff6b99cd84390651ad68...63df738650175dadb9ac5f590516b3585f229a6d,1,1,2,3,3,2010-01-11 18:04:11,2010-01-11 18:04:11
63df738650175dadb9ac5f590516b3585f229a6d...a583a72db9587e25a6fe83d4f29a152635893c38,3,19,19,38,7,2010-01-11 18:14:21,2010-01-11 18:14:21
a583a72db9587e25a6fe83d4f29a152635893c38...d377e7ad992b5fe515525da68e4ef44349818c7b,1,14,2,16,7,2010-01-11 19:24:20,2010-01-11 19:24:20
d377e7ad992b5fe515525da68e4ef44349818c7b...3c40bf8771435d7a4606e7e6c78e4e54badd72f2,3,19,19,38,7,2010-01-11 19:49:54,2010-01-11 19:49:54
3c40bf8771435d7a4606e7e6c78e4e54badd72f2...a3f980f8fca5b4b519e29273fffd672d396269f1,1,3,3,6,3,2010-01-11 19:51:25,2010-01-11 19:51:25
3cec831af71e75e24234a68c036aba1753f746dd...6e0c19bf1f0d3061feb7042a191b64af1d4a0a43,2,34,28,62,15,2010-01-04 23:33:42,2010-01-04 23:33:42
3cec831af71e75e24234a68c036aba1753f746dd...755804209e4dcb17beb0895305310289504296ad,4,42,11,53,13,2010-01-04 21:37:28,2010-01-04 21:37:28
755804209e4dcb17beb0895305310289504296ad...59954ffa3552345fefccac9bf6618920e7cbb3d2,1,8,1,9,2,2010-01-04 22:41:12,2010-01-04 22:41:12
a3f980f8fca5b4b519e29273fffd672d396269f1...530c24aa55e75aac0ac45b865e7912a6147f480d,1,1,1,2,1,2010-01-12 02:18:06,2010-01-12 02:18:06
530c24aa55e75aac0ac45b865e7912a6147f480d...1430432a39e2f1c9c8b937e9ef4124640b9cf00e,1,22,4,26,7,2010-01-12 02:19:25,2010-01-12 02:19:25
a3f980f8fca5b4b519e29273fffd672d396269f1...cb18f33caff861f9a69ea8afe8491880022a4308,1,3,3,6,3,2010-01-12 01:10:20,2010-01-12 01:10:20
cb18f33caff861f9a69ea8afe8491880022a4308...00b731fa0b35a36986eb98836fd96c534bcda25e,1,1,1,2,1,2010-01-12 01:47:22,2010-01-12 01:47:22
11a7f62149d94e23e1792dbc7b9d2d72f10bffb4...973a40dd6f121916132327f76152b847c0eeb87f,1,1,1,2,1,2010-01-04 23:45:14,2010-01-04 23:45:14
973a40dd6f121916132327f76152b847c0eeb87f...5864c4a8dbfd7cb705805b72702084b4922e8d8f,1,16,0,16,2,2010-01-05 01:02:30,2010-01-05 01:02:30
5864c4a8dbfd7cb705805b72702084b4922e8d8f...35d800321b1b87bcd940d07aed2eeaae0c072468,1,15,8,23,6,2010-01-05 01:03:34,2010-01-05 01:03:34
35d800321b1b87bcd940d07aed2eeaae0c072468...e2bac039d1707ccd5ebc23e2d40b6f3713adf625,2,2,2,4,2,2010-01-05 01:28:42,2010-01-05 01:28:42
e2bac039d1707ccd5ebc23e2d40b6f3713adf625...73dd7cb3ebe47a6a6e7b07236cc7dcd41c855382,2,41,3,44,5,2010-01-05 01:29:28,2010-01-05 01:29:28
73dd7cb3ebe47a6a6e7b07236cc7dcd41c855382...8833b6dc37d9aba90dd29289ae9599f5154567e3,1,7,1,8,1,2010-01-05 01:40:47,2010-01-05 01:40:47
903fb0338161b5a3edd14e1623c93c1c64278cfa...2460cc0e2d4a2e09bc8f140bc22f4b8a8f442667,1,2,1,3,1,2010-01-12 02:30:22,2010-01-12 02:30:22
2460cc0e2d4a2e09bc8f140bc22f4b8a8f442667...b691dc629e0696de36ba7b7607f4fd7c28a8e86b,1,7,7,14,4,2010-01-12 02:48:38,2010-01-12 02:48:38
b691dc629e0696de36ba7b7607f4fd7c28a8e86b...b94ecc8f2db71651ab50bdbfbc13ae3871b4de0d,1,1,1,2,1,2010-01-12 03:47:18,2010-01-12 03:47:18
b94ecc8f2db71651ab50bdbfbc13ae3871b4de0d...367a68dffc71c6a9624a74b7524b7c609a515eef,1,1,1,2,1,2010-01-12 06:04:10,2010-01-12 06:04:10
367a68dffc71c6a9624a74b7524b7c609a515eef...4c03735ef8a4d5eb2bdced759e2e87b146bde0f0,1,7,7,14,4,2010-01-12 06:04:39,2010-01-12 06:04:39
4c03735ef8a4d5eb2bdced759e2e87b146bde0f0...ca537582dd1682ee5e0de2176701b006bda3ada6,1,1,2,3,1,2010-01-12 06:04:46,2010-01-12 06:04:46
ca537582dd1682ee5e0de2176701b006bda3ada6...29f41538ed7a148e5434b30550dc80c9a1466733,1,4,22,26,7,2010-01-12 06:04:59,2010-01-12 06:04:59
8833b6dc37d9aba90dd29289ae9599f5154567e3...63c26a96bdead538d77470be1bae1ed4925d4614,3,49,8,57,11,2010-01-06 18:39:57,2010-01-06 18:39:57
8833b6dc37d9aba90dd29289ae9599f5154567e3...df1c01d6fedc84b72cefa2a09fbcc67b10fe0b54,2,10,2,12,2,2010-01-05 17:54:01,2010-01-05 17:54:01
df1c01d6fedc84b72cefa2a09fbcc67b10fe0b54...e93fad288b48b23b27bba19eb10f299945fb0c4b,6,15,16,31,15,2010-01-05 18:48:26,2010-01-05 18:48:26
e93fad288b48b23b27bba19eb10f299945fb0c4b...d8e6e36089c0836fc9719c020fc3aea6188a3cae,1,5,2,7,3,2010-01-05 18:58:51,2010-01-05 18:58:51
d8e6e36089c0836fc9719c020fc3aea6188a3cae...4fbf8deaa971d3bc10e1ce0521eadd9c9eead466,1,7,4,11,2,2010-01-05 19:09:44,2010-01-05 19:09:44
4fbf8deaa971d3bc10e1ce0521eadd9c9eead466...5869ed26b864f335345c7a496f592bf23c3f1ed6,5,84,45,129,30,2010-01-05 20:52:26,2010-01-05 20:52:26
5869ed26b864f335345c7a496f592bf23c3f1ed6...88eb16dc0f8b06311b5e04670c6377be491652e4,3,120,79,199,10,2010-01-05 22:05:40,2010-01-05 22:05:40
88eb16dc0f8b06311b5e04670c6377be491652e4...3a1907331af23a634d9a52e9457e967d5f691577,2,16,5,21,8,2010-01-05 22:31:47,2010-01-05 22:31:47
3a1907331af23a634d9a52e9457e967d5f691577...70e9ed6418b592c666c893dfd4fee7886e6b8575,1,40,0,40,1,2010-01-05 22:32:34,2010-01-05 22:32:34
70e9ed6418b592c666c893dfd4fee7886e6b8575...9d671360dc7ddce193dd59d9875c27023d514fa3,2,8,4,12,5,2010-01-05 22:45:45,2010-01-05 22:45:45
9d671360dc7ddce193dd59d9875c27023d514fa3...b4230ff11ee0c4080b7e1846ad53f0f3acdf9221,2,28,0,28,3,2010-01-05 22:55:34,2010-01-05 22:55:34
b4230ff11ee0c4080b7e1846ad53f0f3acdf9221...5163695eca1f22cfde7d40968574dba21d97153f,2,28,0,28,3,2010-01-05 23:13:43,2010-01-05 23:13:43
5163695eca1f22cfde7d40968574dba21d97153f...2b6fa5493780817d14927a3ccab8156c87b3deb3,2,11,10,21,2,2010-01-05 23:58:25,2010-01-05 23:58:25
2b6fa5493780817d14927a3ccab8156c87b3deb3...796528283a1ba9d078dc9d22fa971e8f682bbc69,3,19,19,38,7,2010-01-06 00:10:29,2010-01-06 00:10:29
796528283a1ba9d078dc9d22fa971e8f682bbc69...4ec798cafe3c1ad353ec774481241cedf60f040a,1,1,0,1,1,2010-01-06 00:34:29,2010-01-06 00:34:29
4ec798cafe3c1ad353ec774481241cedf60f040a...f2e55c508320951711d150ac7baed18313373215,1,14,14,28,8,2010-01-06 01:00:06,2010-01-06 01:00:06
29f41538ed7a148e5434b30550dc80c9a1466733...f1f1493304d9b83b19bee82c71b8dc86c0bd26fb,4,42,4,46,8,2010-01-12 19:38:00,2010-01-12 19:38:00
29f41538ed7a148e5434b30550dc80c9a1466733...69737781387b0e880f07f7ffcac0ee7e18786bf9,3,6,4,10,4,2010-01-12 19:08:38,2010-01-12 19:08:38
29f41538ed7a148e5434b30550dc80c9a1466733...494d9678b9d06b5b6e7b99fdaf36cf4c0d559e91,1,1,1,2,2,2010-01-12 18:17:16,2010-01-12 18:17:16
494d9678b9d06b5b6e7b99fdaf36cf4c0d559e91...8c86bf3456fbc48556e7cd4967173e6ca7d2030c,1,1,1,2,2,2010-01-12 18:22:31,2010-01-12 18:22:31
2be1bc865279e23d2ff50aab5d6adc798e8052e6...5e557f4071cbd5969b46bd06cf9ebeeb718cdd5e,1,1,1,2,1,2010-01-06 18:41:20,2010-01-06 18:41:20
5e557f4071cbd5969b46bd06cf9ebeeb718cdd5e...1b5e6cb00bd7f562758cc0b5aa445beb8aecc06d,3,13,12,25,5,2010-01-07 21:56:43,2010-01-07 21:56:23
f2e55c508320951711d150ac7baed18313373215...ddf26da6eb406884dfe2421010ac27d86907de39,1,17,18,35,10,2010-01-06 02:58:50,2010-01-06 02:58:50
f2e55c508320951711d150ac7baed18313373215...8740d9fc5d720bc12d84672e11ff7353fe32048e,2,4,1,5,2,2010-01-06 02:27:41,2010-01-06 02:27:41
d0ab98809cc283997aadad7288eb6bb798779d66...c87c0cbed864c46e0ba0a30d3ef20a85cca88099,3,19,19,38,7,2010-01-12 19:55:51,2010-01-12 19:55:51
c87c0cbed864c46e0ba0a30d3ef20a85cca88099...06d536bd025cc4dfd6ed97b5e667cddbb7cc9b88,1,14,14,28,8,2010-01-12 19:56:06,2010-01-12 19:56:06
06d536bd025cc4dfd6ed97b5e667cddbb7cc9b88...6956fa0005e2d19ec6543be22ec295756ed780ef,1,1,0,1,1,2010-01-12 19:56:14,2010-01-12 19:56:14
1b5e6cb00bd7f562758cc0b5aa445beb8aecc06d...2d35a54b16a49bdbc0b3e370781824cab73893c9,6,48,24,72,9,2010-01-09 01:58:12,2010-01-09 01:58:12
218374c9d6e9cc2959d82cc36bd06695f5b20d88...2d5a2946d9034a9ffb1b3ce81c32f0ed230f8617,1,18,17,35,10,2010-01-06 08:09:33,2010-01-06 08:09:33
2d5a2946d9034a9ffb1b3ce81c32f0ed230f8617...6e89112398f2c96e0c342cf66beb567d6cdc429e,1,14,14,28,8,2010-01-06 08:09:54,2010-01-06 08:09:54
6e89112398f2c96e0c342cf66beb567d6cdc429e...4e93eb843dd31f4816cf62b4af3568b3b29a046e,1,0,1,1,1,2010-01-06 08:10:09,2010-01-06 08:10:09
4e93eb843dd31f4816cf62b4af3568b3b29a046e...f124e60fd1f9b4f90cdbd752d138b968f59b4096,3,19,19,38,7,2010-01-06 08:10:19,2010-01-06 08:10:19
6956fa0005e2d19ec6543be22ec295756ed780ef...07c26f78eaf016b9ce798e52ca78232877d23536,1,1,3,4,2,2010-01-14 22:26:06,2010-01-14 22:26:06
07c26f78eaf016b9ce798e52ca78232877d23536...b6bc172fa31479f9d6500903b0241460d5aa528a,1,1,1,2,1,2010-01-24 15:26:24,2010-01-24 15:26:24
6956fa0005e2d19ec6543be22ec295756ed780ef...386a525c2fc299aeec3943143d5ff04783b4298c,2,9,2,11,2,2010-01-13 01:33:03,2010-01-13 01:33:03
386a525c2fc299aeec3943143d5ff04783b4298c...5d67aa7014707d518ed291dd5c583042b9c4e068,2,4,4,8,4,2010-01-13 02:00:29,2010-01-13 02:00:29
6956fa0005e2d19ec6543be22ec295756ed780ef...cf3b8f2468ef1844e38c092b72d53148cd775567,6,24,18,42,14,2010-01-12 23:33:29,2010-01-12 23:33:29
cf3b8f2468ef1844e38c092b72d53148cd775567...81dd7eed519dd1e911ff344c1f098501fa6bdd97,4,37,30,67,20,2010-01-13 00:56:29,2010-01-13 00:56:29
d735d2d2db257b8a5cc5d46f05ecb97142aaa200...05d80f56d8f5edbc77cc3f1a896c055739e7c92e,1,3,3,6,1,2010-01-24 16:05:45,2010-01-24 16:05:45
05d80f56d8f5edbc77cc3f1a896c055739e7c92e...5fa0d5e030c74fe617b5dcd2685b066bac6f0366,4,15,2,17,4,2010-01-25 02:05:46,2010-01-25 02:05:46
5fa0d5e030c74fe617b5dcd2685b066bac6f0366...b982d25d5be4e6da727bf1641bec766268deaee3,1,6,4,10,4,2010-01-25 16:23:22,2010-01-25 16:23:22
b982d25d5be4e6da727bf1641bec766268deaee3...33bd6d1fe1fff2d9b457662e41e217ceee4d174b,3,22,18,40,12,2010-01-25 17:25:29,2010-01-25 17:25:29
6759276276980e9af68205647ec9c889aa8806e6...2652e7faad43dc3c8fc57479dbf88ae16a7b6eab,1,2,4,6,1,2010-01-13 02:47:44,2010-01-13 02:47:44
6759276276980e9af68205647ec9c889aa8806e6...e73ba7834e523505856aac3a29305b2822b9b37a,1,29,6,35,5,2010-01-13 02:16:52,2010-01-13 02:15:45
33bd6d1fe1fff2d9b457662e41e217ceee4d174b...a85db023f9a01bcab68386fbe0cf32ccc196d785,4,33,17,50,17,2010-01-25 18:06:06,2010-01-25 18:06:06
33bd6d1fe1fff2d9b457662e41e217ceee4d174b...d0fce9592dd379078e031a571878b191e89eb155,1,8,5,13,1,2010-01-25 18:01:37,2010-01-25 18:01:37
d0fce9592dd379078e031a571878b191e89eb155...55cbb8c62af069a36aa6268c8f6097e5ca88e777,1,1,1,2,1,2010-01-25 18:08:03,2010-01-25 18:08:03
58f1bdeaaf04234148af78151c52d8e48ddc2a7f...a63ddb26dbe7fa3e5d81694349174f0525d5fd18,1,3,3,6,2,2010-01-13 19:31:30,2010-01-13 19:31:30
a63ddb26dbe7fa3e5d81694349174f0525d5fd18...3f155f1bcb2657c50eb4a5f2274128dc52f66556,2,21,0,21,2,2010-01-13 19:57:44,2010-01-13 19:57:44
3f155f1bcb2657c50eb4a5f2274128dc52f66556...8a81ec59b9f9f0889fd6150108b03c029c0da45d,3,25,6,31,9,2010-01-14 02:08:23,2010-01-14 02:08:23
8a81ec59b9f9f0889fd6150108b03c029c0da45d...a0b4be402d78f00d1a1bb341677eea02add0e724,1,1,1,2,2,2010-01-14 05:08:41,2010-01-14 05:08:41
a0b4be402d78f00d1a1bb341677eea02add0e724...8b50f1ce38094db6196d484b2674df0140c4eda9,1,56,0,56,1,2010-01-14 15:37:03,2010-01-14 15:37:03
8b50f1ce38094db6196d484b2674df0140c4eda9...dd742c42fe01d6094a58dd9b7d8f155515b53deb,2,16,0,16,2,2010-01-14 15:41:41,2010-01-14 15:41:41
dd742c42fe01d6094a58dd9b7d8f155515b53deb...1d5186004c3c12fcd1af2574147c5c39976b4f4e,1,1,1,2,1,2010-01-14 15:42:55,2010-01-14 15:42:55
1d5186004c3c12fcd1af2574147c5c39976b4f4e...c0a2b977691232ea27011c5e06452b6298eda736,4,59,19,78,8,2010-01-14 18:07:17,2010-01-14 18:07:17
c0a2b977691232ea27011c5e06452b6298eda736...718ec488d5e4cde1e5eed395d122cc2d531e12ed,4,7,7,14,5,2010-01-14 18:17:32,2010-01-14 18:17:32
718ec488d5e4cde1e5eed395d122cc2d531e12ed...eab3b5f06e6d2d9bf2bda75b1c5d6d1594870c79,2,46,0,46,4,2010-01-14 20:35:29,2010-01-14 20:35:29
eab3b5f06e6d2d9bf2bda75b1c5d6d1594870c79...f186f7e483e37d3ba183a2b628c20000964b4933,1,1,0,1,1,2010-01-14 21:45:03,2010-01-14 21:45:03
f186f7e483e37d3ba183a2b628c20000964b4933...23ea3a46e151398d16ddfa8154249f0576ed4aab,1,12,7,19,6,2010-01-15 03:47:37,2010-01-15 03:47:37
23ea3a46e151398d16ddfa8154249f0576ed4aab...a40772067168bd7a905a1b4f170e734d5bdd4a23,1,15,0,15,1,2010-01-15 04:03:28,2010-01-15 04:03:28
a40772067168bd7a905a1b4f170e734d5bdd4a23...6ed57e7166175a1f5f3eb8f383d3ac12fd935edf,3,30,6,36,8,2010-01-15 04:24:22,2010-01-15 01:24:01
6ed57e7166175a1f5f3eb8f383d3ac12fd935edf...4d29c6b654e53df75d303e6ffcea6529bb380b4c,2,100,95,195,6,2010-01-15 04:24:22,2010-01-15 01:57:50
4d29c6b654e53df75d303e6ffcea6529bb380b4c...30403cdeb51b721ee0b68b9b61c69e62c2b00ae9,3,32,6,38,3,2010-01-15 04:24:22,2010-01-15 02:36:49
30403cdeb51b721ee0b68b9b61c69e62c2b00ae9...60bfc82a4d1d34ccabf355b8a23e6e594614a8d0,1,36,22,58,12,2010-01-15 04:52:49,2010-01-15 03:47:34
60bfc82a4d1d34ccabf355b8a23e6e594614a8d0...2ca97f66235cdd348bc470c449c1468e61c56b86,1,1,8,9,3,2010-01-15 04:56:51,2010-01-15 04:56:51
2ca97f66235cdd348bc470c449c1468e61c56b86...f8be8a7529bdfdade5868cf358fc21f498f3e4d7,3,25,11,36,9,2010-01-15 04:57:07,2010-01-15 04:57:07
f8be8a7529bdfdade5868cf358fc21f498f3e4d7...1ba0144d4f92ed2a4f97d89ad343668c36373bde,5,31,5,36,14,2010-01-15 06:27:01,2010-01-15 06:27:01
1ba0144d4f92ed2a4f97d89ad343668c36373bde...d309bc1b09c6b13122b887fc8d27670d61ddb865,1,1,1,2,1,2010-01-15 13:07:33,2010-01-15 13:07:33
68b9522a09d99951a0d29ff34707c71176533ee1...1664c3da4f7c54ce014fec9e6f1e77c61130661d,2,2,1,3,2,2010-01-25 18:27:21,2010-01-25 18:27:21
1664c3da4f7c54ce014fec9e6f1e77c61130661d...3b4a0b04dde91b7109c6ad08e366ab64e3c96808,4,55,6,61,10,2010-01-25 19:32:51,2010-01-25 19:32:51
3b4a0b04dde91b7109c6ad08e366ab64e3c96808...39e349743a3df966ba394eb9fe4f123339f2d311,1,0,1,1,1,2010-01-25 19:39:28,2010-01-25 19:39:28
d309bc1b09c6b13122b887fc8d27670d61ddb865...68e9f42e4b12e80a241e8c94eaf81892a7d74be9,3,13,13,26,11,2010-01-15 16:44:06,2010-01-15 16:44:06
d309bc1b09c6b13122b887fc8d27670d61ddb865...c02e200b104ce4ca73b0741acc0c0a16abf82477,6,358,299,657,8,2010-01-15 16:03:05,2010-01-15 16:03:05
39e349743a3df966ba394eb9fe4f123339f2d311...b16a83769daaa8ebabbe7c0c0de5b72e7d734112,1,24,0,24,2,2010-01-25 21:17:44,2010-01-25 21:17:44
39e349743a3df966ba394eb9fe4f123339f2d311...16d16168532e089dfc1d29db42d8b1f93b88c16b,1,1,1,2,2,2010-01-25 20:11:08,2010-01-25 20:11:08
16d16168532e089dfc1d29db42d8b1f93b88c16b...d0cd08bfb2e577a7cd2cce96f6a16f47c8636dc7,1,2,0,2,1,2010-01-25 20:11:21,2010-01-25 20:11:21
686e23d17410ea3ef408717695aaf5de318e41bc...1eeef2990216ee2b0c708c5b4b8c3aa9cc62d05a,3,9,1,10,3,2010-01-15 16:48:42,2010-01-15 16:48:42
1eeef2990216ee2b0c708c5b4b8c3aa9cc62d05a...3f6cb1fdcd9ece0b82277f85aff0b0e6e6e50e76,1,5,2,7,1,2010-01-15 17:52:07,2010-01-15 17:52:07
c02e200b104ce4ca73b0741acc0c0a16abf82477...08bbb8ba78cbe25eebcfbb705b7ccd9c4b14c9d6,2,31,10,41,5,2010-01-15 17:32:29,2010-01-15 17:32:29
e4e7e35f8c8a119f68d48a15c6681f43dac51e47...0e7d5c6d0165c5c091d8b4ffd7241fea985c6a1d,5,370,277,647,78,2010-01-25 22:23:37,2010-01-25 22:23:37
e4e7e35f8c8a119f68d48a15c6681f43dac51e47...45886bc7259eb8b003a394af32004f0e7f858aa6,1,6,0,6,2,2010-01-25 21:26:03,2010-01-25 20:19:30
45886bc7259eb8b003a394af32004f0e7f858aa6...ab09697687879474810e39377796c80d807a8803,1,11,5,16,4,2010-01-25 21:26:03,2010-01-25 20:35:54
ab09697687879474810e39377796c80d807a8803...7eb1d29f1b75b3507c43a7c6aef394abfce3d95b,1,1,0,1,1,2010-01-25 21:26:03,2010-01-25 20:36:57
7eb1d29f1b75b3507c43a7c6aef394abfce3d95b...4548ba59c962a8639f958e713981bc9c58d0f444,1,62,3,65,7,2010-01-25 21:26:03,2010-01-25 21:25:31
d0cd08bfb2e577a7cd2cce96f6a16f47c8636dc7...769029d7c8b243a30d0494c9fc526a3c20031f40,4,44,10,54,12,2010-01-25 22:07:02,2010-01-25 22:07:02
769029d7c8b243a30d0494c9fc526a3c20031f40...8cfc0ef3063bef12f083cc1bee9d015048c4e7ac,1,1,1,2,1,2010-01-25 23:45:29,2010-01-25 23:45:29
8cfc0ef3063bef12f083cc1bee9d015048c4e7ac...826cd391e01e149e96f065d4743c51730c8a5d44,3,49,3,52,3,2010-01-25 23:45:53,2010-01-25 23:45:53
826cd391e01e149e96f065d4743c51730c8a5d44...6a53bfcd3ed2c0007125286feb23dab8d317833b,3,61,16,77,13,2010-01-26 00:11:39,2010-01-26 00:11:39
d0cd08bfb2e577a7cd2cce96f6a16f47c8636dc7...ffcb0f6ba6c09ffa58ba365f23b79c1fb796b34a,2,63,45,108,2,2010-01-25 21:12:16,2010-01-25 21:10:18
3f6cb1fdcd9ece0b82277f85aff0b0e6e6e50e76...94ed98667fbd63f53af6fe0787381dab47ecaa14,3,10,4,14,8,2010-01-15 18:19:35,2010-01-15 18:19:35
b27e1762c5ee75b49ed65cb8c28995edb2ec0cbc...43355195b4ac32d61f93b32960c4eb1d966a49e4,4,45,12,57,11,2010-01-15 18:54:52,2010-01-15 18:54:52
191c6b8712463ca87149d15316d7ee9775acbc35...0b299c608f443e9bf2a55af79f83bf2541ea305f,3,4,4,8,4,2010-01-26 15:37:26,2010-01-26 15:37:26
e6f4d0dffdaa038b06916f21a3311a018e7187a5...84e5a5d88b2bce95b56f7904958733cd5ac0f7e2,1,5,3,8,3,2010-01-26 00:48:49,2010-01-26 00:48:49
e6f4d0dffdaa038b06916f21a3311a018e7187a5...70b79686683bd2ac73a7b56a8146fb8038cd83cf,8,133,45,178,27,2010-01-26 00:33:10,2010-01-26 00:32:00
94ed98667fbd63f53af6fe0787381dab47ecaa14...2628d0213acdbb5868d0b25c0b1b372806658819,5,108,61,169,8,2010-01-15 21:05:14,2010-01-15 21:05:14
fcbce5dc303b50449d92257c7debb28f6b4b7571...72cb9c483208c5522a56a85251e8e8d4c83fcef0,1,2,1,3,2,2010-01-15 19:17:01,2010-01-15 19:17:01
72cb9c483208c5522a56a85251e8e8d4c83fcef0...32acd37d754eb9f083485e6004e1c6ed0306d1a9,1,1,0,1,1,2010-01-15 20:31:51,2010-01-15 20:31:51
32acd37d754eb9f083485e6004e1c6ed0306d1a9...02e33dafc066677d0f6c33f78937835ddb0cf1ce,1,4,2,6,2,2010-01-15 20:57:57,2010-01-15 20:57:57
26dda502babef05af808bb769b15f28f8aa6ff7c...66f5cd1f73b44d767befae470785447ea05da788,1,3,0,3,3,2010-01-26 01:41:46,2010-01-26 01:41:46
66f5cd1f73b44d767befae470785447ea05da788...8a31ed49aa91af01d2b5a75771cd1780ae2c86a9,1,5,7,12,5,2010-01-26 03:03:14,2010-01-26 03:02:48
8a31ed49aa91af01d2b5a75771cd1780ae2c86a9...969f8dfeda28d56253064119cd6d1a582c91d72c,2,2,2,4,2,2010-01-26 04:26:42,2010-01-26 04:26:42
969f8dfeda28d56253064119cd6d1a582c91d72c...c4388ac021d74c7cbce90cee15ffc8e0e0d6e02b,1,14,0,14,1,2010-01-26 04:48:52,2010-01-26 04:48:52
c4388ac021d74c7cbce90cee15ffc8e0e0d6e02b...81001819bebb81b44a260676b62f696f2203e45d,2,40,1,41,3,2010-01-26 15:03:30,2010-01-26 15:03:30
cf91f7211af0116bc5ac1df8a4751ca2bfe266a3...98db9eed8a58e2361cf2f8323bf7d80a95efb4a9,2,2,3,5,3,2010-01-15 22:12:16,2010-01-15 22:12:16
02e33dafc066677d0f6c33f78937835ddb0cf1ce...4539b8e7c51fb46d419fc80b48469cee91d4e149,1,11,1,12,1,2010-01-15 21:11:00,2010-01-15 21:11:00
a3d3ab96cf81945dc0b39c236a19b0764351767b...cfe572adffb61b278d1b80bee2fdbdaecf637ab9,1,1,1,2,1,2010-01-27 16:25:57,2010-01-27 16:25:57
cfe572adffb61b278d1b80bee2fdbdaecf637ab9...7302f4ac0010b2456cbb3a6c65b83e52a009d2e4,1,1,1,2,1,2010-01-27 18:43:35,2010-01-27 18:43:35
7302f4ac0010b2456cbb3a6c65b83e52a009d2e4...f52bc8f43a39b8e45439796e5854ef1041ff29f4,2,4,4,8,3,2010-01-27 20:07:00,2010-01-27 20:07:00
f52bc8f43a39b8e45439796e5854ef1041ff29f4...0048e481c5974e1122da678e98318419e65ea8d4,2,47,2,49,3,2010-01-27 20:52:28,2010-01-27 20:52:28
0048e481c5974e1122da678e98318419e65ea8d4...8a52d0120ff7d57039eaf451ff30a8e71a7213f4,1,67,0,67,1,2010-01-28 02:41:50,2010-01-28 02:41:50
8a52d0120ff7d57039eaf451ff30a8e71a7213f4...721a702f47851de39a7b4da32574937ef28f79d5,1,4,10,14,5,2010-01-28 02:53:23,2010-01-28 02:53:23
81001819bebb81b44a260676b62f696f2203e45d...c86eda25ac2256ec595ed9979c867b46c0f1c3df,2,56,1,57,2,2010-01-26 15:42:28,2010-01-26 15:42:28
945f38416c566a494da880355816cbcc5d1733fd...95ba1b843ec69b2fba574b2a502f3df7efe33d92,1,4,2,6,2,2010-01-15 22:16:17,2010-01-15 22:16:17
e33f6fc92f060b364f333aaf866a988f7d6e57b6...efbf3382cd76ef742e31a75e699c17864929723b,4,51,30,81,12,2010-01-15 21:46:17,2010-01-15 21:46:17
721a702f47851de39a7b4da32574937ef28f79d5...367de296118dbed2cf636fd253c61976ab4aba6d,1,1,1,2,1,2010-01-28 16:52:02,2010-01-28 16:52:02
367de296118dbed2cf636fd253c61976ab4aba6d...6df2f6c7e67a34fdb2717cfe3acdb5badc4a38b7,5,43,27,70,11,2010-01-28 17:21:56,2010-01-28 17:21:56
721a702f47851de39a7b4da32574937ef28f79d5...91c38b48ec0762ce535ca7ef11ec45f4114d73f7,1,2,1,3,1,2010-01-28 16:13:50,2010-01-28 16:11:32
c86eda25ac2256ec595ed9979c867b46c0f1c3df...60c2a79e9c9d9b173c81daddf601e40e2dbe8bea,3,5,35,40,5,2010-01-26 17:19:14,2010-01-26 17:19:14
c86eda25ac2256ec595ed9979c867b46c0f1c3df...47b67b74b4e1ec8c5adab2f132a8992a6ccc7bc6,3,39,10,49,10,2010-01-26 16:54:45,2010-01-26 16:54:45
47b67b74b4e1ec8c5adab2f132a8992a6ccc7bc6...77f1686f376088cbc99d06be8e1636b2a35177ed,1,7,1,8,2,2010-01-26 16:58:33,2010-01-26 16:58:33
95ba1b843ec69b2fba574b2a502f3df7efe33d92...0165ec1fda0ce57506cfb307bc9d198e9cdab8be,1,5,4,9,5,2010-01-15 22:33:44,2010-01-15 22:33:44
efbf3382cd76ef742e31a75e699c17864929723b...9f004b0cb219aee5a7571ba49a46377541e80023,2,17,7,24,7,2010-01-15 22:22:11,2010-01-15 22:22:11
efbf3382cd76ef742e31a75e699c17864929723b...42ec730af272cacbf312c69baddf97a3d9991d5b,1,4,3,7,1,2010-01-15 21:59:39,2010-01-15 21:59:39
91c38b48ec0762ce535ca7ef11ec45f4114d73f7...03abb654fb854eb1f16c798c820cd11bbbffc3e0,9,42,60,102,34,2010-01-28 18:41:51,2010-01-28 18:41:51
77f1686f376088cbc99d06be8e1636b2a35177ed...10e1711a0ef20760585d632406e4fe1900491352,1,1,1,2,1,2010-01-26 17:19:40,2010-01-26 17:19:40
4b29cdb1e531ae4c25622d42c12bb89c0dcb446e...4ea9dde3fb6cc78c8b56eae8b0a6a0bbf303ab78,6,30,1,31,9,2010-01-15 22:55:41,2010-01-15 22:53:33
4ea9dde3fb6cc78c8b56eae8b0a6a0bbf303ab78...e85270d503ad85d4c6f43e86cdc097c482160b0e,1,4,0,4,1,2010-01-16 00:21:42,2010-01-16 00:21:42
e85270d503ad85d4c6f43e86cdc097c482160b0e...5ffd7e4d51991327e3115d6290927c9e917748f4,1,0,4,4,1,2010-01-16 00:40:35,2010-01-16 00:40:35
5ffd7e4d51991327e3115d6290927c9e917748f4...fb6c3315afa55e168466750910ee67470bc65e24,5,86,3,89,7,2010-01-16 05:50:02,2010-01-16 05:50:02
fb6c3315afa55e168466750910ee67470bc65e24...d4e5f8a3b81c976c133e44c234400843d7a05c7b,2,17,10,27,2,2010-01-16 13:00:42,2010-01-16 13:00:42
d4e5f8a3b81c976c133e44c234400843d7a05c7b...ae7110f3bc28e8c279f7e1615b4591a3cb073856,2,9,7,16,4,2010-01-16 13:01:38,2010-01-16 13:01:38
ae7110f3bc28e8c279f7e1615b4591a3cb073856...d61342572459e7942871b427e373a686a04b55f7,2,15,5,20,4,2010-01-16 15:25:32,2010-01-16 15:25:32
d61342572459e7942871b427e373a686a04b55f7...cd7148702bd90ab0b300e1f43b5eba5e173c895c,2,17,0,17,3,2010-01-16 15:39:51,2010-01-16 15:39:51
cd7148702bd90ab0b300e1f43b5eba5e173c895c...6830dd0dd0462492ec0547050fb0eeb2908591b3,3,64,0,64,4,2010-01-16 16:08:32,2010-01-16 16:08:32
6830dd0dd0462492ec0547050fb0eeb2908591b3...53b5dae92e8c045f6aa94add14dc0564ee9ee6e9,3,14,2,16,6,2010-01-16 16:16:30,2010-01-16 16:16:30
53b5dae92e8c045f6aa94add14dc0564ee9ee6e9...c93766e975c606fa704b19462487f95c9328ec28,1,25,0,25,2,2010-01-16 22:34:44,2010-01-16 22:34:44
c93766e975c606fa704b19462487f95c9328ec28...059ebd4b6aad0c93aee080dca400ad404ede5143,8,57,44,101,17,2010-01-17 21:57:35,2010-01-17 21:57:35
059ebd4b6aad0c93aee080dca400ad404ede5143...0591a5b96a78f3dd26597a7ecdcf6eb8b19e5b4b,3,26,18,44,16,2010-01-18 16:06:10,2010-01-18 16:06:10
0591a5b96a78f3dd26597a7ecdcf6eb8b19e5b4b...036e6f7ba8bd98339e77f9ab5c865382e832c62f,3,84,32,116,14,2010-01-18 19:34:33,2010-01-18 19:34:33
62e40da7a0cbf01d859fa0e484506177e517cedb...af8d9e70717d371de4ebf7db0f74ad747b1c392b,3,9,1,10,3,2010-01-28 18:44:47,2010-01-28 18:44:47
af8d9e70717d371de4ebf7db0f74ad747b1c392b...efe264364e468fd622d177e7fc02731cf3279e9e,5,62,0,62,7,2010-01-28 19:14:33,2010-01-28 19:14:33
efe264364e468fd622d177e7fc02731cf3279e9e...51f4a0dfdbedbbe93416fb68865a18839c66f7a1,4,103,1,104,10,2010-01-28 19:14:47,2010-01-28 19:14:47
51f4a0dfdbedbbe93416fb68865a18839c66f7a1...62ab3d32616d7e744d742122cbdcb29cd3b581de,2,3,1,4,3,2010-01-28 19:20:18,2010-01-28 19:20:18
f7c9d0fc70af2ccfa9fc3ad172d3ace3fe5546ae...21f1e8a0676fa65fd8516680ad218e2e5f3e2262,1,2,1,3,1,2010-01-26 18:22:01,2010-01-26 18:22:01
21f1e8a0676fa65fd8516680ad218e2e5f3e2262...1666a6507ec82e7adc8cc33137da92f2eb33d5cd,1,1,1,2,1,2010-01-26 18:22:25,2010-01-26 18:22:25
f7c9d0fc70af2ccfa9fc3ad172d3ace3fe5546ae...27c26e5fab83825417853edde9a54be3a45f14e8,1,2,1,3,2,2010-01-26 18:09:46,2010-01-26 18:09:46
036e6f7ba8bd98339e77f9ab5c865382e832c62f...d8e9164616aa346cc653765a76d2f8e32ed3c55f,8,54,55,109,51,2010-01-19 16:04:52,2010-01-19 16:04:52
036e6f7ba8bd98339e77f9ab5c865382e832c62f...069d9e9c3cfd20ed7e6c370e36526b4fe6408cae,1,14,1,15,1,2010-01-19 15:01:15,2010-01-19 15:01:15
069d9e9c3cfd20ed7e6c370e36526b4fe6408cae...b7b8ac1a43828280a9c16b31cb2118e0127fda35,1,2,3,5,2,2010-01-19 15:09:13,2010-01-19 15:09:13
b7b8ac1a43828280a9c16b31cb2118e0127fda35...14a02175208dba44255211ee187f618a1bcedaa6,3,19,0,19,4,2010-01-19 15:16:45,2010-01-19 15:16:45
14a02175208dba44255211ee187f618a1bcedaa6...693b5980dce96d28133b10e45fb484476f277af5,1,9,4,13,7,2010-01-19 15:58:35,2010-01-19 15:58:35
62ab3d32616d7e744d742122cbdcb29cd3b581de...4008f94cfc33509b157ce3cf7646ca5608987d98,2,2,1,3,2,2010-01-28 19:58:23,2010-01-28 19:58:23
62ab3d32616d7e744d742122cbdcb29cd3b581de...deb05df864867373ab52a57ecf720845ddac8048,2,76,0,76,3,2010-01-28 19:40:45,2010-01-28 19:24:45
deb05df864867373ab52a57ecf720845ddac8048...cf09ddc3d6d1dcf11a6a2a3818ac71901516401b,1,7,2,9,2,2010-01-28 19:40:45,2010-01-28 19:39:23
aa982f23f1254028958f588a0aa6e367199c7c39...ec3731c75b0c21c876f5465b98817f7f2ec122a2,4,9,16,25,9,2010-01-26 19:21:31,2010-01-26 19:21:31
ec3731c75b0c21c876f5465b98817f7f2ec122a2...b151a6f5b16b3107d544e502572123925c239024,1,4,2,6,2,2010-01-26 19:26:07,2010-01-26 19:26:07
b151a6f5b16b3107d544e502572123925c239024...9909d2959b33e3ec520dd6d1017b1c6c9c615e31,1,0,12,12,1,2010-01-26 20:38:26,2010-01-26 20:38:26
9909d2959b33e3ec520dd6d1017b1c6c9c615e31...a13d0b88c23e553a278244490613a13292027979,1,4,1,5,1,2010-01-26 20:46:07,2010-01-26 20:46:07
a13d0b88c23e553a278244490613a13292027979...d0847c99123bc5d2362a90ec11316724256b85e2,10,135,25,160,27,2010-01-26 22:40:06,2010-01-26 22:40:06
aa982f23f1254028958f588a0aa6e367199c7c39...1ed6940015c5b54acc6452c539a93ae8fa2e67e1,1,1,2,3,1,2010-01-26 18:49:55,2010-01-26 18:49:55
1ed6940015c5b54acc6452c539a93ae8fa2e67e1...ca42b6de8ad0e1571d8c7aa38ea5f9c9338b0685,1,3,1,4,1,2010-01-26 19:59:05,2010-01-26 19:59:05
ca42b6de8ad0e1571d8c7aa38ea5f9c9338b0685...556c5a6d7d0fdf71a3f43960d82d4e0cf723a81b,3,74,5,79,13,2010-01-26 22:29:06,2010-01-26 22:29:06
91637c8e9ba0d6f386664e73361ff9dcab86a794...2772af49a11ca8b5209770f6a8d722e84a542c25,5,73,38,111,25,2010-01-20 18:57:20,2010-01-20 18:57:20
693b5980dce96d28133b10e45fb484476f277af5...439e5e995e2fef9071aefd88588c281008c0a5bb,1,49,0,49,1,2010-01-19 16:23:59,2010-01-19 16:23:59
9c685ac75ff074d3b781b93ddcfce7117d8d3321...51a99bbce0120aadca21e8e32a2164e2789a65ff,1,1,0,1,1,2010-01-28 20:06:02,2010-01-28 20:06:02
c11297df9a7dca4170a1f7c6ec6b97335753aeca...a449c2c367a58794b2c1cb71a68577f327f7a37b,2,29,0,29,2,2010-01-27 02:04:36,2010-01-27 02:04:36
c11297df9a7dca4170a1f7c6ec6b97335753aeca...dcce5e795e5728214d6973a2e4f7168d05b22ecf,11,79,15,94,16,2010-01-27 01:04:09,2010-01-27 01:04:09
dcce5e795e5728214d6973a2e4f7168d05b22ecf...990092ce3d105d88a5f857e7c2dd196868324dcf,1,2,1,3,2,2010-01-27 01:05:28,2010-01-27 01:05:28
990092ce3d105d88a5f857e7c2dd196868324dcf...6ba9f4c9bc4556e3c99d1253ccd18c0011ca9e3b,6,53,1,54,10,2010-01-27 01:28:49,2010-01-27 01:28:49
6ba9f4c9bc4556e3c99d1253ccd18c0011ca9e3b...2fc5cd666f9906911fc66f7c18ac9c397989bc5b,1,1,1,2,1,2010-01-27 01:35:30,2010-01-27 01:35:30
2fc5cd666f9906911fc66f7c18ac9c397989bc5b...922532f0a5b2d181d3a84c3c774c590a6b16dc33,1,1,1,2,1,2010-01-27 02:00:00,2010-01-27 01:59:12
e9a6c707f36c64e88b252170908aa58ff5c4d9ba...0a3f5af2c352690fc5e17b0c2372604252ef00c5,5,36,28,64,25,2010-01-20 19:34:53,2010-01-20 19:34:53
737776e3b8159dcfb87c9417d56b39c0fd8ab0fc...84ec76b935af3a8a848a351ee24dc28688994d97,1,32,0,32,1,2010-01-19 19:44:17,2010-01-19 19:44:17
84ec76b935af3a8a848a351ee24dc28688994d97...9d42a8e04bdc4aa99148122c0e51c3745f87f906,1,6,6,12,1,2010-01-20 19:35:54,2010-01-20 19:35:54
9d42a8e04bdc4aa99148122c0e51c3745f87f906...e5e39b21da286ddad5fc6c0bbbaa03d32a70aa96,6,153,31,184,31,2010-01-20 19:36:11,2010-01-20 19:36:11
737776e3b8159dcfb87c9417d56b39c0fd8ab0fc...96fbb6c9fbd6211890994b14940e597409f6f395,5,39,25,64,15,2010-01-19 18:03:23,2010-01-19 18:03:23
51a99bbce0120aadca21e8e32a2164e2789a65ff...a65e789e1ab15c7a01cddab4a9c54a176316f30b,1,1,1,2,1,2010-01-28 20:16:22,2010-01-28 20:16:22
51a99bbce0120aadca21e8e32a2164e2789a65ff...1864b5e78ad747a58a38d8a0332ccd5392f4e482,1,0,13,13,1,2010-01-28 20:07:45,2010-01-28 20:07:45
8025069091483ab8bc1234802a67ffd9444cc7b4...8f93c4e6f248f104c57a86212cc256fe7a5de0b6,2,0,8,8,2,2010-01-20 19:39:57,2010-01-20 19:39:57
5995cef015c9d82093f8ac6ca707554dadd1917d...9f3561944572086d0bb883e3665d482eff72d454,1,2,2,4,2,2010-01-20 19:45:29,2010-01-20 19:45:29
9f3561944572086d0bb883e3665d482eff72d454...2597876acbb883cd3b80d17cbc5cf00396429b81,1,1,1,2,1,2010-01-20 20:17:04,2010-01-20 20:17:04
2597876acbb883cd3b80d17cbc5cf00396429b81...0036246413fd1cd6fd96a60c7512f303572d432f,2,74,0,74,3,2010-01-20 20:17:22,2010-01-20 20:17:22
0036246413fd1cd6fd96a60c7512f303572d432f...fdde436041be95bf91819f2712e4c41eae36759a,7,31,225,256,32,2010-01-21 00:35:45,2010-01-21 00:35:45
96fbb6c9fbd6211890994b14940e597409f6f395...e3fef5ee1e30660d22966c7b9fc6e6f8fd35474f,1,1,0,1,1,2010-01-19 21:42:48,2010-01-19 21:42:48
96fbb6c9fbd6211890994b14940e597409f6f395...3f4d6f7bf5f509c471883955227377ce2c6aa5d0,1,3,0,3,2,2010-01-19 20:28:55,2010-01-19 20:28:55
1862acd66b6b49414739f2c3f294ca168527bc9d...4d780e974d5786cb0e19f7fe640e8b7d87faa6a6,1,1,0,1,1,2010-01-28 20:27:35,2010-01-28 20:26:26
4d780e974d5786cb0e19f7fe640e8b7d87faa6a6...78a30eef7e9fe2f9cff8d0a96ed6d63ec0e8ef31,1,3,0,3,1,2010-01-28 21:22:17,2010-01-28 21:22:17
78a30eef7e9fe2f9cff8d0a96ed6d63ec0e8ef31...5a43260f0c5416a6b094dac33c87e549693e4521,1,7,4,11,3,2010-01-28 21:36:47,2010-01-28 21:36:47
5a43260f0c5416a6b094dac33c87e549693e4521...0ed56f5b2bcd95433c6b4c65dd961c610eee1268,1,1,0,1,1,2010-01-28 22:03:33,2010-01-28 22:03:33
8f93c4e6f248f104c57a86212cc256fe7a5de0b6...11a2fb7e25a4ea1ddb6de1827571e63e263109aa,4,12,15,27,9,2010-01-20 22:11:25,2010-01-20 22:11:25
8f93c4e6f248f104c57a86212cc256fe7a5de0b6...b6f8abcef16d092275a125b8e34fdd8d884792a9,1,1,1,2,1,2010-01-20 19:41:49,2010-01-20 19:41:49
d26dff949ea2ab8e6783b279b8fd177fdec1ef86...f623739aca557c54dec885c482aacfd5c97f74a3,1,28,1,29,3,2010-01-21 02:09:27,2010-01-21 02:09:27
b0b6a102ceb0e3cde0b7a9b35142411e5fbf956c...2ff6749889ee6d22b8d195d54eca59de5bc3cfcd,4,33,33,66,28,2010-01-19 22:36:01,2010-01-19 22:36:01
3f4d6f7bf5f509c471883955227377ce2c6aa5d0...ce217513aa537b8c9696d365a6b464cd8ada3d9c,1,19,0,19,1,2010-01-19 23:11:21,2010-01-19 23:11:21
ce217513aa537b8c9696d365a6b464cd8ada3d9c...1f9867f393d33b769a4e34780be798f3d654d281,3,14,2,16,6,2010-01-20 00:33:41,2010-01-20 00:33:41
0ed56f5b2bcd95433c6b4c65dd961c610eee1268...58e7807a9b0766c68a743ffba26265da08969b7a,6,13,13,26,10,2010-01-28 22:33:33,2010-01-28 22:21:26
0ed56f5b2bcd95433c6b4c65dd961c610eee1268...2c3e16caa32947986cabe6e4810accb02a5709f4,2,22,6,28,4,2010-01-28 22:30:58,2010-01-28 22:30:58
b6f8abcef16d092275a125b8e34fdd8d884792a9...b147ccf752830e24956cf04e388905acd30a4b7d,4,83,3,86,12,2010-01-20 23:02:46,2010-01-20 23:02:46
b147ccf752830e24956cf04e388905acd30a4b7d...37d6be190898c84d9d0c1626ca4fa2a2f9770cca,1,1,1,2,1,2010-01-21 00:21:07,2010-01-21 00:21:07
37d6be190898c84d9d0c1626ca4fa2a2f9770cca...fb093990ac182d2555312dbe088840b51f6fe1ad,5,101,4,105,12,2010-01-21 00:21:19,2010-01-21 00:21:19
b6f8abcef16d092275a125b8e34fdd8d884792a9...024506e7770c69c72374e6ded1a0aa78b05a8c6e,1,5,0,5,1,2010-01-20 22:01:58,2010-01-20 22:01:58
f89d78e1acadacd9a06f2080cf9b9f12ebf7a40a...15a31df5e98a1e2625f9327c8ca8f32161a6f097,2,4,4,8,4,2010-01-20 01:07:30,2010-01-20 01:07:30
15a31df5e98a1e2625f9327c8ca8f32161a6f097...0cde1d796f820a2f359b34b718036e6919dc84cd,1,5,3,8,4,2010-01-20 01:20:34,2010-01-20 01:20:34
0cde1d796f820a2f359b34b718036e6919dc84cd...7b0fd14cbd3f2c2fcd030e99cde48349f0a5c6d8,1,9,2,11,1,2010-01-20 01:30:07,2010-01-20 01:30:07
7b0fd14cbd3f2c2fcd030e99cde48349f0a5c6d8...19732ca8f936dac45e52b62757a4437a02607f57,2,37,1,38,3,2010-01-20 02:14:01,2010-01-20 02:12:22
19732ca8f936dac45e52b62757a4437a02607f57...80076622e1de6b3100b43da5de30399097602458,1,9,3,12,2,2010-01-20 02:59:27,2010-01-20 02:59:27
80076622e1de6b3100b43da5de30399097602458...5a9013d3ccc3d034251055eccc5eb313eb671cd0,1,2,2,4,2,2010-01-20 03:22:32,2010-01-20 03:22:32
5a9013d3ccc3d034251055eccc5eb313eb671cd0...d473198914f58153ef9926b4e3ed28efc650aa50,1,4,5,9,2,2010-01-20 03:34:43,2010-01-20 03:34:43
d473198914f58153ef9926b4e3ed28efc650aa50...d1f0ffe23bcd667f4ed18a27b5fd31a0beab5535,2,4,10,14,3,2010-01-20 03:49:22,2010-01-20 03:44:54
d1f0ffe23bcd667f4ed18a27b5fd31a0beab5535...b617df5a1a48fe5ac6f7d5cb653832d09bc99ad2,2,14,3,17,3,2010-01-20 14:53:19,2010-01-20 14:53:19
b617df5a1a48fe5ac6f7d5cb653832d09bc99ad2...9cde296ca6bdaf968396de9be2c65bf067771187,2,29,10,39,8,2010-01-20 18:42:39,2010-01-20 18:41:39
813f5d6f28c19d64e541d5a53d45ce3b0e0d74b1...37f6d236eade2a38dee5bdd3fca721aecfae9ec1,1,4,4,8,2,2010-01-29 14:39:53,2010-01-29 14:39:53
37f6d236eade2a38dee5bdd3fca721aecfae9ec1...bf8d55b490e5568755a408f89b16c51a502777d0,1,13,0,13,2,2010-01-29 15:43:02,2010-01-29 15:43:02
bf8d55b490e5568755a408f89b16c51a502777d0...8f21c738c16ce79f36d2db7e4f7fa267bad90ee2,1,5,6,11,4,2010-01-29 19:12:02,2010-01-29 19:12:02
3b366cd27963c89952d219f2439cfaf4cf78fa46...aaad1a1c863f6f23cb258432ff44e81586d2ed66,1,2,2,4,1,2010-01-21 00:29:27,2010-01-21 00:29:27
ed1b8154241e81d9fea5bd4ed9b2b710e2f71aea...6a78423e5d777bd9fb4c077e1e6ae1a1afecd6fa,1,3,3,6,2,2010-01-21 02:40:19,2010-01-21 02:40:19
9cde296ca6bdaf968396de9be2c65bf067771187...ea6189d491c3cd5e25438f9a652873880810dae4,5,37,24,61,13,2010-01-20 19:02:14,2010-01-20 19:02:14
ea6189d491c3cd5e25438f9a652873880810dae4...32fc230be46b61be6985af7f89857757a391279b,4,4,4,8,4,2010-01-20 19:18:33,2010-01-20 19:18:33
8f21c738c16ce79f36d2db7e4f7fa267bad90ee2...b8f779a2a24f67f04e7630e12c3100c6e75b1327,3,46,44,90,5,2010-01-29 19:58:10,2010-01-29 19:58:10
8f21c738c16ce79f36d2db7e4f7fa267bad90ee2...cf92a4b67becd5ed43fa4941d09d590bd8220d08,2,10,1,11,3,2010-01-29 19:24:26,2010-01-29 19:23:54
aaad1a1c863f6f23cb258432ff44e81586d2ed66...22bea6840a42ed0dd52074b87f10392f0ffc18f6,1,7,4,11,3,2010-01-21 01:13:15,2010-01-21 01:13:15
22bea6840a42ed0dd52074b87f10392f0ffc18f6...1e85d9cacdbd03edf63106d9f028ccb10c7ccc3c,1,0,3,3,1,2010-01-21 01:17:36,2010-01-21 01:17:36
6a78423e5d777bd9fb4c077e1e6ae1a1afecd6fa...3f09bd4f64827e3491d34f866a2cf3e5325f188f,3,11,11,22,9,2010-01-21 17:23:44,2010-01-21 17:23:44
3f09bd4f64827e3491d34f866a2cf3e5325f188f...a5a781593683909e1c3024d7a07212d365282f8e,6,46,5,51,11,2010-01-21 18:40:18,2010-01-21 18:40:18
a5a781593683909e1c3024d7a07212d365282f8e...c78ec26e0f03e88263f567c3e400a54d358522f0,2,36,22,58,20,2010-01-21 21:35:35,2010-01-21 21:35:35
6a78423e5d777bd9fb4c077e1e6ae1a1afecd6fa...96031302053e3a15c88e7fbbad6b7d98feab919c,2,51,50,101,4,2010-01-21 13:57:09,2010-01-21 13:57:09
96031302053e3a15c88e7fbbad6b7d98feab919c...3c527d8c43d9730beda790a6c8743c8f876979fd,3,17,13,30,8,2010-01-21 17:29:18,2010-01-21 17:29:18
3c527d8c43d9730beda790a6c8743c8f876979fd...0c814f1af9c15c2824fd9c838bf861ef31f1a97f,2,9,3,12,5,2010-01-21 18:24:18,2010-01-21 18:24:18
5661edfcef3644af3f2fbadba7b4171b3d523e61...2cea986a7373497bdb2670b2ea1f82ce656c3880,1,1,1,2,1,2010-01-29 20:11:00,2010-01-29 20:08:38
2cea986a7373497bdb2670b2ea1f82ce656c3880...6278c079cf3b4a541443083a68d2103d40f8f2c1,1,43,0,43,2,2010-01-29 21:41:14,2010-01-29 19:46:05
6278c079cf3b4a541443083a68d2103d40f8f2c1...009242886fcaf115f3142aa1828dd4e1b5058100,1,3,2,5,3,2010-01-29 21:42:37,2010-01-26 15:39:25
009242886fcaf115f3142aa1828dd4e1b5058100...c81ca9783f77348c735dad627a7b9be706dceb64,2,6,2,8,5,2010-01-29 21:42:38,2010-01-28 15:31:24
c81ca9783f77348c735dad627a7b9be706dceb64...96badcb5ca29cf6f4df8be408e58409c868aff18,1,18,0,18,2,2010-01-29 21:42:38,2010-01-29 21:38:27
96badcb5ca29cf6f4df8be408e58409c868aff18...bb4e3ea5ba744f614f9ad7b848c6ab41aacc4087,1,1,1,2,1,2010-01-29 21:43:09,2010-01-29 21:43:09
bb4e3ea5ba744f614f9ad7b848c6ab41aacc4087...c5c56cd612e9b018a5387c5c567f7582d1a9c4db,1,7,3,10,1,2010-01-29 21:59:22,2010-01-29 21:59:22
c5c56cd612e9b018a5387c5c567f7582d1a9c4db...afa43dc8cd7ffe55c8c0112373b636f4e36c8ecb,22,317,311,628,147,2010-01-29 22:22:34,2010-01-29 22:22:34
afa43dc8cd7ffe55c8c0112373b636f4e36c8ecb...7090fb2c5b2c41bbb377f170b676c4a979771e8d,1,2,2,4,1,2010-01-30 01:57:50,2010-01-30 01:57:50
7090fb2c5b2c41bbb377f170b676c4a979771e8d...50ff092ff6ac024ca8993a12cec9c0c1fe556729,1,9,2,11,1,2010-01-30 02:02:03,2010-01-30 02:02:03
50ff092ff6ac024ca8993a12cec9c0c1fe556729...1f84d7aa8245d9a7fe2d9fddbbb2eeb28a1bcbfb,1,2,5,7,1,2010-01-30 03:00:50,2010-01-30 03:00:50
1f84d7aa8245d9a7fe2d9fddbbb2eeb28a1bcbfb...113441207c8a9f3c35a290e97ec5b72697a69e50,1,2,0,2,1,2010-01-30 03:14:43,2010-01-30 03:14:43
113441207c8a9f3c35a290e97ec5b72697a69e50...2c8eb25e1c1f5554f78f1da25d196e08c8105065,2,2,2,4,2,2010-01-30 03:27:05,2010-01-30 03:27:05
2c8eb25e1c1f5554f78f1da25d196e08c8105065...c59789357cd75d770953c05a169d265f49af23d2,1,1,1,2,1,2010-01-30 03:32:35,2010-01-30 03:32:35
c59789357cd75d770953c05a169d265f49af23d2...0cd9880023a5b67ac418d5844895bc37ed91fdd8,1,5,3,8,3,2010-01-30 03:32:44,2010-01-30 03:32:44
0cd9880023a5b67ac418d5844895bc37ed91fdd8...75fd1d625740d9d3dced353e003a379cd31dd84f,1,1,0,1,1,2010-01-30 04:06:17,2010-01-30 04:06:17
1e85d9cacdbd03edf63106d9f028ccb10c7ccc3c...d44586f265bdfaf9509819462ffeadad57a3beb3,1,4,4,8,2,2010-01-21 02:12:38,2010-01-21 02:12:38
c78ec26e0f03e88263f567c3e400a54d358522f0...dc6ecb1ce9a2c1491f4d4fc54f6ae14ad406beaf,2,41,9,50,8,2010-01-22 16:03:35,2010-01-22 16:03:35
acafaffa320edb539ba584fd46601b73d051a2f9...ead28f59e2902c5f31606be8f733e3c9f62ff185,1,2,1,3,1,2010-01-22 04:26:46,2010-01-22 04:26:46
75fd1d625740d9d3dced353e003a379cd31dd84f...946d42e8e718d0e11ab3389c286b5ae41a23d5e7,2,20,4,24,5,2010-02-01 18:31:08,2010-02-01 18:31:08
946d42e8e718d0e11ab3389c286b5ae41a23d5e7...53998ac7fc1058ded4eebbb94cba940521446f5e,2,20,3,23,5,2010-02-01 19:17:14,2010-02-01 19:17:14
53998ac7fc1058ded4eebbb94cba940521446f5e...0131eaf887f0e77941e318ad638273e1260295d2,7,63,38,101,15,2010-02-01 23:41:04,2010-02-01 23:41:04
0131eaf887f0e77941e318ad638273e1260295d2...ad8292a9f7102a9a4f048710136f297419c5ab5a,2,4,9,13,6,2010-02-01 23:53:34,2010-02-01 23:53:34
ad8292a9f7102a9a4f048710136f297419c5ab5a...56c790cb76ba471f152317ba962c5894b0330e7e,3,10,8,18,5,2010-02-01 23:59:01,2010-02-01 23:59:01
56c790cb76ba471f152317ba962c5894b0330e7e...40184615d5f10e8885b9927fce4a94964ca5f58a,1,3,0,3,2,2010-02-02 00:13:33,2010-02-02 00:13:33
75fd1d625740d9d3dced353e003a379cd31dd84f...aff272915781e39631a0c33e6f56fdfc4cb741d4,7,14,12,26,11,2010-02-01 15:38:00,2010-02-01 15:38:00
aff272915781e39631a0c33e6f56fdfc4cb741d4...4f8d71b47519256d70381f2f78ceafa8331aca2d,6,2,4,6,4,2010-02-01 15:47:28,2010-02-01 15:47:28
8d789a66e0a18b8052a6d2d836e1646ace133c03...28f3a90f8c041366941d9863d4df6d844ee572e0,2,10,5,15,4,2010-01-22 17:15:24,2010-01-22 17:15:24
8d789a66e0a18b8052a6d2d836e1646ace133c03...80ac4248a949e293f5053759e285bccb07760d5d,1,2,2,4,1,2010-01-22 16:53:14,2010-01-22 16:53:14
80ac4248a949e293f5053759e285bccb07760d5d...5e387405ebc1752fb63a2b3bcab54f82581addc0,1,1,1,2,1,2010-01-22 17:04:32,2010-01-22 17:04:32
7b2d93d070ae5d61e2e7c015761e73ce1384e5df...eab0cc8da6a84575eca13cad923ccb5e099a50f9,2,2,2,4,2,2010-02-02 18:03:15,2010-02-02 18:03:15
4f8d71b47519256d70381f2f78ceafa8331aca2d...ea575be2777da5ea340a2331c411a19e63d7d6f3,10,241,80,321,55,2010-02-01 18:27:05,2010-02-01 18:27:05
ea575be2777da5ea340a2331c411a19e63d7d6f3...ef206c16b230f4cf063945c195910ea6f1c2b41d,1,11,1,12,1,2010-02-01 18:56:27,2010-02-01 18:56:27
ef206c16b230f4cf063945c195910ea6f1c2b41d...9d3e50fbd71d4fce0c2a54d6d2c0c8db0a055370,3,50,15,65,6,2010-02-01 18:56:52,2010-02-01 18:56:52
4f8d71b47519256d70381f2f78ceafa8331aca2d...112011382684f171eb155a6c65ac05c469263965,2,15,8,23,2,2010-02-01 17:01:26,2010-02-01 17:01:26
112011382684f171eb155a6c65ac05c469263965...361e981ecec254cc9bf90af5aaca933756c8f348,1,12,3,15,1,2010-02-01 17:19:51,2010-02-01 17:19:51
361e981ecec254cc9bf90af5aaca933756c8f348...99dc251ea9f08141ea497d6f595ca3acf214b156,1,23,58,81,13,2010-02-01 20:45:11,2010-02-01 20:45:11
90a16efb01ca68e03755e71c9eef3ac3a5b1f909...adf21e940480e08e0ccccec91e3e1b6363b0fb39,10,177,42,219,47,2010-01-22 20:17:03,2010-01-22 20:17:03
adf21e940480e08e0ccccec91e3e1b6363b0fb39...530b1b2e7ad8d18168d505316a24582429da4b17,6,22,17,39,18,2010-01-22 20:58:49,2010-01-22 20:58:49
eab0cc8da6a84575eca13cad923ccb5e099a50f9...7f24acaf6d9b40fba1c685f1e22cc76291821952,2,97,15,112,10,2010-02-02 19:46:02,2010-02-02 19:46:02
7f24acaf6d9b40fba1c685f1e22cc76291821952...727e7201f71d17d12d23f5dcc945280faff9c337,1,7,0,7,1,2010-02-02 20:38:11,2010-02-02 20:38:11
727e7201f71d17d12d23f5dcc945280faff9c337...1b251ab297b1d9d8b938cda09648f73b5cac8880,2,42,1,43,6,2010-02-02 20:38:48,2010-02-02 20:38:48
99dc251ea9f08141ea497d6f595ca3acf214b156...d01f1d167d7d07466d76ba03e5548f499e01c80e,1,38,7,45,10,2010-02-01 22:44:52,2010-02-01 22:44:52
d01f1d167d7d07466d76ba03e5548f499e01c80e...b00e8e991581cbf07acbc16d9b71059c80b6dba7,1,7,38,45,10,2010-02-01 23:46:22,2010-02-01 23:46:22
b00e8e991581cbf07acbc16d9b71059c80b6dba7...bb9af80fa3862731fe183b94f6fa19f41b573c9b,1,1,1,2,1,2010-02-02 01:50:14,2010-02-02 01:50:14
bb9af80fa3862731fe183b94f6fa19f41b573c9b...322761d1769a48d98092716ed91674fd0b5993af,1,9,0,9,1,2010-02-02 01:50:21,2010-02-02 01:50:21
322761d1769a48d98092716ed91674fd0b5993af...039856e9e76b2d3af1048adca310d3a37b4ef00a,1,1,1,2,1,2010-02-02 02:02:06,2010-02-02 02:02:06
039856e9e76b2d3af1048adca310d3a37b4ef00a...9f7f493c601637bdf422b2d29426dab1d92a1df8,1,1,0,1,1,2010-02-02 02:06:48,2010-02-02 02:06:48
9f7f493c601637bdf422b2d29426dab1d92a1df8...4de5ca45569d5a5ffb0d980bc2cb8807f0017d7a,1,125,36,161,20,2010-02-02 02:23:33,2010-02-02 02:23:26
4de5ca45569d5a5ffb0d980bc2cb8807f0017d7a...981d13fb83443f5b1c51b207555e2b69ec3ca343,1,3,5,8,4,2010-02-02 02:27:42,2010-02-02 02:27:42
1b251ab297b1d9d8b938cda09648f73b5cac8880...ccf1d618f50f3e6cda67e8adfb2e0e1fd920d568,1,2,2,4,1,2010-02-02 20:53:46,2010-02-02 20:53:46
ccf1d618f50f3e6cda67e8adfb2e0e1fd920d568...a34be8d49938beec19ed83769537483013d8d581,1,1,1,2,1,2010-02-02 21:16:57,2010-02-02 21:16:57
a34be8d49938beec19ed83769537483013d8d581...95574b3c9ec842ac7636be8e8013150f110e2a59,1,1,1,2,1,2010-02-02 21:52:52,2010-02-02 21:52:52
981d13fb83443f5b1c51b207555e2b69ec3ca343...e70c6030b10826634bc9bd18baa578ad03db7621,2,3,2,5,2,2010-02-02 02:35:54,2010-02-02 02:35:54
981d13fb83443f5b1c51b207555e2b69ec3ca343...2de4b90bf98c6b410c14c8dc049b4f26a75cb36b,1,1,1,2,1,2010-02-02 02:34:13,2010-02-02 02:34:13
95574b3c9ec842ac7636be8e8013150f110e2a59...a0010982f7d252f082391d85a1c7f13c7b1a0f54,3,14,44,58,7,2010-02-02 22:29:14,2010-02-02 22:29:14
cddedd78afbad2973dbea287ae28b28cb0aa94ea...7de05dd6a2c06e2621b425391fe756e89a99b98d,1,1,0,1,1,2010-02-02 21:37:32,2010-02-02 21:37:32
7de05dd6a2c06e2621b425391fe756e89a99b98d...146d15a1d6b08a952a374f7ea6a2e750ba989a7d,1,3,0,3,1,2010-02-02 21:37:44,2010-02-02 21:37:44
146d15a1d6b08a952a374f7ea6a2e750ba989a7d...2195c268771c4f0fbe025f565bed90b0759ee35f,1,1,1,2,1,2010-02-02 22:16:19,2010-02-02 22:16:19
2195c268771c4f0fbe025f565bed90b0759ee35f...f15acfe81917a3c6d172a09cdac27125ab265d53,4,112,77,189,24,2010-02-02 22:16:25,2010-02-02 22:16:25
cb26bb442878b334bb6a6660d47e283240901daa...c7a9785fb495f3ef121c4153fc3540bc34e03dfc,2,21,0,21,3,2010-02-02 03:07:05,2010-02-02 03:07:05
c7a9785fb495f3ef121c4153fc3540bc34e03dfc...90d549337189d1e64e43c8f4830b45e7726a4ac6,1,1,0,1,1,2010-02-02 03:50:49,2010-02-02 03:50:49
abbdaabefa26881dbdea408c3d690a50cd668c99...857518458441d8182669c115575f341f05a0a6f1,1,2,0,2,1,2010-02-02 23:12:08,2010-02-02 23:12:08
abbdaabefa26881dbdea408c3d690a50cd668c99...18404274b5f21e52a86bdabd9bd8d1c60902607d,1,1,1,2,1,2010-02-02 23:06:47,2010-02-02 23:04:04
fb3dd133668218ecff086d91b91037a847c4e5c7...57aa47c740e51ee4b5d494b41dc4ccea3ddc912e,2,258,0,258,2,2010-02-02 22:17:09,2010-02-02 22:17:09
90d549337189d1e64e43c8f4830b45e7726a4ac6...a0fdf6d9e938289325484afff1d20db0c4e48ca9,2,9,4,13,4,2010-02-02 18:01:11,2010-02-02 18:01:11
90d549337189d1e64e43c8f4830b45e7726a4ac6...925571b8c2781c701b7795949096c619cfe7251b,7,0,0,0,0,2010-02-02 16:46:10,2010-02-02 16:46:10
c5c1c1d59126df1f74b4c96e37e01ac8ab151ab3...68909a6d715e57f61039f4ceb450bca9127fdc93,1,5,0,5,2,2010-02-03 00:16:25,2010-02-03 00:16:25
68909a6d715e57f61039f4ceb450bca9127fdc93...b16ad764e52ed055cf7098b5d624026378429f57,7,19,5,24,10,2010-02-03 00:40:52,2010-02-03 00:40:52
b16ad764e52ed055cf7098b5d624026378429f57...8086003928fbe3cf41781a30223637b5b8098cbf,6,4,18,22,9,2010-02-03 00:42:32,2010-02-03 00:42:32
8086003928fbe3cf41781a30223637b5b8098cbf...86bfa3c1c8b53de2e009833f0fd5ab24ddc28f29,1,1,1,2,2,2010-02-03 00:49:43,2010-02-03 00:49:43
86bfa3c1c8b53de2e009833f0fd5ab24ddc28f29...817c2a30281540c88b029677dad8ff2b9b919a87,1,1,2,3,1,2010-02-03 01:20:17,2010-02-03 01:20:17
817c2a30281540c88b029677dad8ff2b9b919a87...fbeca98a61f872abc2644c5d7f7c1eccc1b822f1,2,5,5,10,7,2010-02-03 01:24:50,2010-02-03 01:24:50
925571b8c2781c701b7795949096c619cfe7251b...c7a4a0eec8e05e255655ae3ed8698256fa4b3492,1,8,0,8,1,2010-02-02 17:39:04,2010-02-02 17:36:58
fbeca98a61f872abc2644c5d7f7c1eccc1b822f1...7bc4b39c8c28a1094374172ef49f5bf8fdc62d1d,2,8,3,11,4,2010-02-03 01:44:58,2010-02-03 01:44:58
fbeca98a61f872abc2644c5d7f7c1eccc1b822f1...88d780e621cc4829dcb9d1c491e50b9cf9d3adf0,1,1,0,1,1,2010-02-03 01:30:09,2010-02-02 23:49:05
88d780e621cc4829dcb9d1c491e50b9cf9d3adf0...3c2ca2bb6672c744ad4753ad5e9562bd4419415e,1,2,1,3,2,2010-02-03 01:30:09,2010-02-03 01:28:31
8b569d6b4206d18104fc046f57fd45ba6647d80c...2a9163d3e343662c921e55d426d7d3e7e2baabd1,8,58,41,99,16,2010-02-03 20:31:48,2010-02-03 20:31:48
caa4c95e61a707486bd307fc72f10616b113f288...36fd4db154a925d45bc1f03392e232ef101c37b0,1,1,1,2,1,2010-02-03 01:55:08,2010-02-03 01:55:08
2a9163d3e343662c921e55d426d7d3e7e2baabd1...b9be275c37da9b6f037837fd1c4ef0df762a34bf,3,21,13,34,10,2010-02-03 22:31:52,2010-02-03 22:31:52
2a9163d3e343662c921e55d426d7d3e7e2baabd1...aeae928580e5e9ae5aa21f46ee1b7857bd5cd282,1,1,1,2,1,2010-02-03 21:10:05,2010-02-03 19:10:51
aeae928580e5e9ae5aa21f46ee1b7857bd5cd282...492200452750eb091bb199e4a384d45de6c21779,1,0,1,1,1,2010-02-03 21:10:05,2010-02-03 21:09:23
36fd4db154a925d45bc1f03392e232ef101c37b0...0fcb345fd1417e1d0847b59e8148075cda3c1146,2,39,17,56,10,2010-02-03 02:43:26,2010-02-03 02:43:26
36fd4db154a925d45bc1f03392e232ef101c37b0...a733d58f95d1cdb3981f36e6989b55457459c5d4,2,45,2,47,4,2010-02-03 02:34:21,2010-02-03 02:34:21
1dcb888bc9585be67759907fd1966e884d3b3b93...2c5dbf323c2dec2c73c40bb6f609e4430ad3c542,1,4,1,5,1,2010-02-03 22:51:06,2010-02-03 22:51:06
c49737335dbd147b1b367a676b31f9728d1b7c96...9eaaef4a6c665a0cd19f6ff5ffc7295537a11619,1,6,1,7,2,2010-02-03 08:06:06,2010-02-03 08:06:06
c49737335dbd147b1b367a676b31f9728d1b7c96...9455bdc8d723aba50ca4848583509f1d7a583075,1,1,0,1,1,2010-02-03 03:34:15,2010-02-03 03:34:15
9455bdc8d723aba50ca4848583509f1d7a583075...8250ddea8c08c2111c5fa5f69d21e19a7044661b,2,5,5,10,5,2010-02-03 03:46:43,2010-02-03 03:46:31
2c5dbf323c2dec2c73c40bb6f609e4430ad3c542...92e756eabc3e2e485949859e13d98ea47703911b,14,120,38,158,38,2010-02-04 19:25:49,2010-02-04 19:25:49
92e756eabc3e2e485949859e13d98ea47703911b...397e511e3a409ee3398d77d84468178eed7f3206,2,4,4,8,4,2010-02-04 20:46:11,2010-02-04 20:46:11
2c5dbf323c2dec2c73c40bb6f609e4430ad3c542...6b46b838689f378283494958e692a350e733103a,1,8,6,14,3,2010-02-04 02:06:47,2010-02-04 02:06:47
6b46b838689f378283494958e692a350e733103a...cb550b0774fef933032ebb66dedc8ea0341ebcd3,2,2,2,4,2,2010-02-04 02:07:44,2010-02-04 02:07:44
cb550b0774fef933032ebb66dedc8ea0341ebcd3...effedd950de374a91ab415e66f405a2ae4a3885b,1,1,1,2,1,2010-02-04 14:20:42,2010-02-04 14:20:42
7ba50bffabfb019a085b359d41c18316407b1a81...12f5a46e4d5bf4bac42ba9fd42c44f85d9a9c25e,2,2,1,3,2,2010-02-03 08:13:42,2010-02-03 08:13:42
12f5a46e4d5bf4bac42ba9fd42c44f85d9a9c25e...194afe347e0bce5ee61f54a1bfd4f46850ecece3,1,1,1,2,1,2010-02-03 08:58:52,2010-02-03 08:58:52
194afe347e0bce5ee61f54a1bfd4f46850ecece3...75e5857ab00d70983bef9640f466c431ef079f95,1,12,17,29,10,2010-02-03 15:22:04,2010-02-03 15:22:04
effedd950de374a91ab415e66f405a2ae4a3885b...f8273464b7daa74ed4a06952eccc892fb14b0f05,2,66,0,66,2,2010-02-04 15:21:36,2010-02-04 15:21:36
effedd950de374a91ab415e66f405a2ae4a3885b...ffcce1a0a58f3588d71f62282d26fcde2ff90223,1,1,0,1,1,2010-02-04 14:58:03,2010-02-04 14:19:17
ffcce1a0a58f3588d71f62282d26fcde2ff90223...9f9907d733073fceaa769e0c10f36b73b225d319,1,27,14,41,10,2010-02-04 15:44:43,2010-02-04 15:44:43
75e5857ab00d70983bef9640f466c431ef079f95...0aeea38d26638e7db8455ff7a05f789d519a65a3,1,1,1,2,1,2010-02-03 17:14:03,2010-02-03 17:14:03
0aeea38d26638e7db8455ff7a05f789d519a65a3...32f3348ed8ec936dec30886e8be4c59591aeefc2,2,0,23,23,3,2010-02-03 18:11:10,2010-02-03 18:11:10
32f3348ed8ec936dec30886e8be4c59591aeefc2...b49e1a6fb11bc5e3775a9086e3c21c306809cae8,1,1,4,5,2,2010-02-03 18:12:14,2010-02-03 18:12:14
75e5857ab00d70983bef9640f466c431ef079f95...76ac79734ab8436f29121e8ef45c88d895207ba8,2,23,21,44,15,2010-02-03 16:06:13,2010-02-03 16:06:13
76ac79734ab8436f29121e8ef45c88d895207ba8...6c18efe606058963dd76e928562f86a530d369e1,1,3,3,6,2,2010-02-03 16:34:21,2010-02-03 16:34:21
6c18efe606058963dd76e928562f86a530d369e1...cff55fcc0780f9770287d60f9ed36f2cb5fef035,3,13,15,28,9,2010-02-03 16:52:15,2010-02-03 16:52:15
cff55fcc0780f9770287d60f9ed36f2cb5fef035...8e28795bab57de30c55aa4ca30d0b4442db38e31,4,10,12,22,10,2010-02-03 17:03:33,2010-02-03 17:03:33
8e28795bab57de30c55aa4ca30d0b4442db38e31...3c06fe34baf009a1bfadc5d3ea86853765c8164f,1,3,3,6,2,2010-02-03 17:33:48,2010-02-03 17:33:48
3c06fe34baf009a1bfadc5d3ea86853765c8164f...1439431b7ef07d4c21dfb1585841e037502b0345,1,1,5,6,2,2010-02-03 17:40:49,2010-02-03 17:40:49
1439431b7ef07d4c21dfb1585841e037502b0345...ff34ec6348c5cd2fa3a40c685fc2037335925806,1,1,1,2,1,2010-02-03 17:44:50,2010-02-03 17:44:50
5c3df745124d441f9c07931f6e4c6b3f10f2e225...dbce9b90199668b7f836d4263b05ee2a57a85361,1,1,1,2,1,2010-02-04 20:58:37,2010-02-04 20:58:37
f8273464b7daa74ed4a06952eccc892fb14b0f05...cecffe079e564f81fae8d34839d08ab2c3bcb13d,1,1,1,2,1,2010-02-04 15:40:07,2010-02-04 15:40:07
cecffe079e564f81fae8d34839d08ab2c3bcb13d...62f47cc910f68b842a512533bd06b5343f7da41e,14,157,122,279,60,2010-02-04 15:49:19,2010-02-04 15:49:19
9f9907d733073fceaa769e0c10f36b73b225d319...0185d56a441ac73dc46b4dc945868e9b651c2554,1,1,1,2,1,2010-02-04 16:58:29,2010-02-04 16:58:29
25d0bcda67d864dccec548a5af81f3ca8824a4f3...8e61e09042f33dab8208620c5835d8085ea945e0,2,213,0,213,2,2010-02-03 18:31:51,2010-02-03 18:31:51
8e61e09042f33dab8208620c5835d8085ea945e0...016c2530911fa1af8904e679506520856c475ec2,1,1,1,2,1,2010-02-03 19:33:09,2010-02-03 19:23:20
dbce9b90199668b7f836d4263b05ee2a57a85361...9b0c78412742b8ed054a6981a01464947c8ce90b,4,10,12,22,8,2010-02-04 22:06:54,2010-02-04 22:06:54
dbce9b90199668b7f836d4263b05ee2a57a85361...b2584c122234d682e8a585debc2a462731f5a7f5,1,1,1,2,1,2010-02-04 21:33:19,2010-02-04 21:33:19
b2584c122234d682e8a585debc2a462731f5a7f5...08d0a9568826100c879ba860272b73f62735d3d4,1,1,0,1,1,2010-02-04 21:53:34,2010-02-04 21:53:34
94b1649755690b75bd2e5d953da427a3e0b61529...57c0843f7626e4cc091b6b7beeb4f42c702ab278,2,3,3,6,3,2010-02-04 15:52:59,2010-02-04 15:52:59
57c0843f7626e4cc091b6b7beeb4f42c702ab278...f7901fdc2c45ce58ce253a1abb270ac35bcc4c0a,3,13,2,15,4,2010-02-04 15:59:13,2010-02-04 15:59:13
016c2530911fa1af8904e679506520856c475ec2...04de8d47e9be0928e4261305d37132b041cdfec4,2,644,0,644,2,2010-02-03 19:33:35,2010-01-29 21:35:01
04de8d47e9be0928e4261305d37132b041cdfec4...82b6de8472c68354803c4ae6e05c1930547b24fd,1,2,2,4,2,2010-02-03 19:33:35,2010-02-01 17:31:48
82b6de8472c68354803c4ae6e05c1930547b24fd...e3b1bbeb5e0d5b9c71fe14fce11e840491e31007,1,1,3,4,1,2010-02-03 19:33:35,2010-02-01 20:48:33
e3b1bbeb5e0d5b9c71fe14fce11e840491e31007...7e34f06e4cdab5e5e1e626209bfce2f5a2c9d32e,1,3,3,6,3,2010-02-03 19:33:35,2010-02-01 20:50:20
7e34f06e4cdab5e5e1e626209bfce2f5a2c9d32e...c609d245a5611db0df8517734b91a3b1cf2dfa3d,1,7,1,8,1,2010-02-03 19:33:35,2010-02-03 18:22:27
c609d245a5611db0df8517734b91a3b1cf2dfa3d...21aed2f0c17429ceeebf4821ca9d17ad1f954050,2,21,20,41,4,2010-02-03 19:33:35,2010-02-03 18:51:05
21aed2f0c17429ceeebf4821ca9d17ad1f954050...316c38eb7c57508244c5c973b30a3b139122bc2d,1,1,1,2,1,2010-02-03 20:22:51,2010-02-03 20:22:51
316c38eb7c57508244c5c973b30a3b139122bc2d...3a4cc2735456be8e4c4f02da153789d56696a797,1,13,10,23,8,2010-02-03 22:24:59,2010-02-03 22:24:59
08d0a9568826100c879ba860272b73f62735d3d4...424e7d9585c20dd0279dadc0d20f263ba73c9503,4,20,5,25,8,2010-02-04 22:12:14,2010-02-04 22:12:14
f7901fdc2c45ce58ce253a1abb270ac35bcc4c0a...c39b3ddb543a6b174ce9da4ce1827d0ea7e5bb6f,1,8,7,15,1,2010-02-04 17:07:33,2010-02-04 17:07:33
3fd74e33c2bbd06206b6b830cbdcaa37c429549c...baf0d1a4ae80fc0bce44787482f8e2a364b06143,1,1,1,2,1,2010-02-04 17:11:44,2010-02-04 17:11:44
baf0d1a4ae80fc0bce44787482f8e2a364b06143...117cb6e8b5790cc1ccc5ab0e3fa291cf5f519c9c,1,1,0,1,1,2010-02-04 17:12:01,2010-02-04 17:12:01
117cb6e8b5790cc1ccc5ab0e3fa291cf5f519c9c...d1de5e6204922109d50c67703e0d9c75c562ddb1,1,2,0,2,1,2010-02-04 18:45:38,2010-02-04 18:45:08
d1de5e6204922109d50c67703e0d9c75c562ddb1...fe4d8d585edd7b1f9c0129d631db21d025dea062,1,1,1,2,1,2010-02-04 18:50:36,2010-02-04 18:50:36
78bc86c0f03f78aef15b7e8fdb77c550c7fc3e27...87d7f0a48f3d34857d5ff6e7c039763ca8763ecc,1,1,1,2,1,2010-02-04 22:17:09,2010-02-04 22:17:09
424e7d9585c20dd0279dadc0d20f263ba73c9503...214dfb69910dc37111eab52b3aa65f6955c09d7b,1,1,0,1,1,2010-02-04 22:16:50,2010-02-04 22:16:50
fe4d8d585edd7b1f9c0129d631db21d025dea062...8ef72cbff5c749755ef8025c55d8bf31d7426ddf,1,1,1,2,1,2010-02-04 19:08:34,2010-02-04 19:08:34
fe4d8d585edd7b1f9c0129d631db21d025dea062...e14c3fd42834a33752cc4724c2ed2047b88c119f,1,2,1,3,1,2010-02-04 19:00:01,2010-02-04 18:59:39
e14c3fd42834a33752cc4724c2ed2047b88c119f...90bb11a39c9825ffb36d52736265e026e2630bad,1,0,3,3,1,2010-02-04 19:07:42,2010-02-04 19:07:42
04e0939289b05b3be2241f4ce11355e8b947c9c6...a84fc5843a64db0a2835f0e56e1789c1a5b48c08,12,17,9,26,11,2010-02-04 23:06:04,2010-02-04 23:06:04
1b42418fb2d1ce30475b72922d7f783e63788bde...caadcee6f984af5ca5a0b0882dc42bb0f8449e7b,1,4,1,5,2,2010-02-04 22:24:22,2010-02-04 22:24:22
f5376e1297bd7bf459b24eda08fe5410fdfaf8e6...cf2c6c068e4b8f9c42885985df941cddc55d8f28,5,49,25,74,34,2010-02-04 20:56:02,2010-02-04 20:56:02
b2a360229b1b382e69154fc74b2c3e41fc86fc25...ae5e03de122426a8d3e885afa605bb09a5eecab7,1,4,4,8,2,2010-02-05 02:32:38,2010-02-05 02:32:38
ae5e03de122426a8d3e885afa605bb09a5eecab7...b0ce7bb204af55cad388080ede3a609850e56a71,1,3,2,5,1,2010-02-05 03:04:32,2010-02-05 03:04:32
ae5e03de122426a8d3e885afa605bb09a5eecab7...e5a49e306fd7bf199493ae469d3bb3636ab79cf3,1,5,2,7,1,2010-02-05 03:01:48,2010-02-05 03:01:48
de8efe0a2aa6df39f1b3d3f0df9101a0be4f12bb...52427e60ebef9e70fa65f38c31f63bdf6784a9b9,3,21,1,22,5,2010-02-05 03:51:57,2010-02-05 03:51:57
52427e60ebef9e70fa65f38c31f63bdf6784a9b9...dff4eb0fa3dcb14b9acd476b07acb953083b8997,1,2,2,4,1,2010-02-05 06:09:56,2010-02-05 06:09:56
dff4eb0fa3dcb14b9acd476b07acb953083b8997...6fe52c51ad180551339327d0920e6c918b187363,1,1,0,1,1,2010-02-05 14:07:43,2010-02-05 14:05:41
6fe52c51ad180551339327d0920e6c918b187363...116bd9e645a6c068a90cecc53b4f8d44a0ccf1a6,1,82,14,96,16,2010-02-05 14:07:43,2010-02-05 14:07:09
116bd9e645a6c068a90cecc53b4f8d44a0ccf1a6...db1f3a7914e18a79fe478c03141b09ea7c461436,1,6,1,7,1,2010-02-05 14:47:21,2010-02-05 14:47:21
db1f3a7914e18a79fe478c03141b09ea7c461436...c0314c9c6569975f7b55c2a175692dde10142e7b,1,2,1,3,1,2010-02-05 15:53:22,2010-02-05 15:53:22
c0314c9c6569975f7b55c2a175692dde10142e7b...68eae18d00b194dc05cc9d7aed06f95f36aaaa2d,3,20,1,21,5,2010-02-05 17:02:01,2010-02-05 17:02:01
c0314c9c6569975f7b55c2a175692dde10142e7b...46db8f7559c7ad3ce905c034afa97d68eda906cb,1,1,1,2,1,2010-02-05 16:30:44,2010-02-03 22:28:36
46db8f7559c7ad3ce905c034afa97d68eda906cb...7fba165329da171bfb682a1bcd4f9036fa5f102b,1,1,1,2,1,2010-02-05 16:31:17,2010-02-05 16:31:17
7fba165329da171bfb682a1bcd4f9036fa5f102b...c9bd589e57a0e6e9dbe41bc4fa523ce4fdf45709,1,1,1,2,1,2010-02-05 16:35:51,2010-02-05 16:35:11
8cee590ebb6d31665853722098df87d596921a2c...7674785f2f42225bb86497475cc34b489538bce8,2,19,4,23,6,2010-02-05 17:44:08,2010-02-05 17:44:08
c9bd589e57a0e6e9dbe41bc4fa523ce4fdf45709...5a7dd696953423d21c3cf9c31f19231d13d20130,1,4,0,4,1,2010-02-05 17:44:12,2010-02-05 17:44:12
c9bd589e57a0e6e9dbe41bc4fa523ce4fdf45709...5d823a9049927c8fec88d198f2deeffc675f2262,1,22,20,42,11,2010-02-05 17:43:37,2010-02-05 17:43:37
7674785f2f42225bb86497475cc34b489538bce8...af5fe539b808c8e2b0076d76b8255691862d03d9,1,1,1,2,1,2010-02-05 17:45:05,2010-02-05 17:45:05
5a7dd696953423d21c3cf9c31f19231d13d20130...4a56c1577f9818cca47ca1498f69105b3ab91f94,1,5,3,8,3,2010-02-05 18:09:49,2010-02-05 18:09:49
af5fe539b808c8e2b0076d76b8255691862d03d9...4786c923f8baef8da6d1b22cd32bf497caae6129,1,0,2,2,2,2010-02-05 18:24:19,2010-02-05 18:24:19
4a56c1577f9818cca47ca1498f69105b3ab91f94...07e4c44edcb172d7297871ff6bc1520de1b9e2ef,2,51,35,86,21,2010-02-05 21:15:01,2010-02-05 21:15:01
294df23c007e26609240693c0adff2a8a1d46ed9...5c5fd566404046f25bdc55f9ddbf9571ba03304b,3,91,2,93,3,2010-02-05 21:45:40,2010-02-05 21:45:22
5c5fd566404046f25bdc55f9ddbf9571ba03304b...ce1ab23ce7b255d8f48eeb312528c60ef510d352,2,9,2,11,3,2010-02-05 22:21:56,2010-02-05 22:21:56
ce1ab23ce7b255d8f48eeb312528c60ef510d352...2dad09f2f77dac230412cd7644910e7615b94224,1,1,1,2,1,2010-02-05 23:08:10,2010-02-05 23:06:11
2dad09f2f77dac230412cd7644910e7615b94224...a39d197a5aa996569d39d073a973a690fde11296,1,2,3,5,1,2010-02-05 23:08:10,2010-02-05 23:07:42
a39d197a5aa996569d39d073a973a690fde11296...cc3f8770efcc761f55d1a1fe65881bcbebacd3db,1,4,0,4,2,2010-02-06 15:47:30,2010-02-06 15:47:30
cc3f8770efcc761f55d1a1fe65881bcbebacd3db...7c48eed652df3046a48f205da869c13963f9695f,1,3,1,4,1,2010-02-06 19:45:58,2010-02-06 19:45:58
7c48eed652df3046a48f205da869c13963f9695f...1d562aeb9b3c19ff2d062627927313ce455a2ee7,1,5,13,18,4,2010-02-06 22:56:48,2010-02-06 22:56:48
1d562aeb9b3c19ff2d062627927313ce455a2ee7...656cd3a9f46625f4b3223030e8ffe5f51233ca3d,2,5,1,6,2,2010-02-07 05:49:47,2010-02-07 05:49:47
656cd3a9f46625f4b3223030e8ffe5f51233ca3d...1342db66743eeff1c7f72003d77f097692084d88,3,30,1,31,7,2010-02-07 06:10:12,2010-02-07 06:10:12
1342db66743eeff1c7f72003d77f097692084d88...85000c0649e5bbce004ce83a2558a05f57699711,1,14,5,19,3,2010-02-07 06:21:28,2010-02-07 06:21:28
85000c0649e5bbce004ce83a2558a05f57699711...efc3bd2a93b662bad3571192a16eb58ffa57aa9a,1,3,2,5,1,2010-02-07 06:28:36,2010-02-07 06:28:36
efc3bd2a93b662bad3571192a16eb58ffa57aa9a...6c6d40a375924fc1433c853d4e66a60cedd57bcb,4,16,6,22,4,2010-02-07 06:38:54,2010-02-07 06:38:54
6c6d40a375924fc1433c853d4e66a60cedd57bcb...4afc973c3e4cafbbc8321fd6be28caa3e76621c5,1,1,1,2,1,2010-02-07 06:58:31,2010-02-07 06:58:31
4afc973c3e4cafbbc8321fd6be28caa3e76621c5...df9e034ad3b1092895228bc43d80c7c1f0c8341e,2,2,4,6,2,2010-02-07 07:04:19,2010-02-07 07:04:19
df9e034ad3b1092895228bc43d80c7c1f0c8341e...662af525506152c913d67e53fb7a937b32840c12,3,19,8,27,7,2010-02-07 15:38:23,2010-02-07 15:38:23
662af525506152c913d67e53fb7a937b32840c12...9bab846512a84777f3982b1dcda6571fadf2adff,1,2,2,4,1,2010-02-07 17:48:23,2010-02-07 17:48:23
9bab846512a84777f3982b1dcda6571fadf2adff...61aa20971d78ebf13c791f7530c0624b52eb7d58,1,6,6,12,5,2010-02-07 20:22:59,2010-02-07 20:22:59
61aa20971d78ebf13c791f7530c0624b52eb7d58...d1c3f1a9eb91481754a57bdb2c5f2d953b4b1a17,2,53,30,83,3,2010-02-07 20:25:38,2010-02-07 20:25:38
d1c3f1a9eb91481754a57bdb2c5f2d953b4b1a17...ddd617b35a05dcb74e9f3af84b4716bcc5784022,2,2,2,4,2,2010-02-07 20:41:52,2010-02-07 20:41:52
ddd617b35a05dcb74e9f3af84b4716bcc5784022...cf605da1fb65e241fc9a4c0ef538a6babaf3653d,1,1,0,1,1,2010-02-08 15:08:57,2010-02-08 15:08:57
cf605da1fb65e241fc9a4c0ef538a6babaf3653d...a5078c00d58b86e7913b5eade93c5132ff087ea1,1,1,1,2,1,2010-02-08 15:28:16,2010-02-08 15:28:16
811c90a9018c75233e3429e5c5aab9ddb1eba96a...14567ea1f069d35b5bbd42c2649cc32bc6eee960,1,2,2,4,2,2010-02-05 18:30:07,2010-02-05 18:30:07
5db24d2088d4fb09d18dd9919315a30d010c9fe9...42d958985f5bf13607fe91ceb00f3840e0357fc3,2,40,38,78,4,2010-02-09 23:28:36,2010-02-09 23:28:36
a5078c00d58b86e7913b5eade93c5132ff087ea1...b284b8b6e67831a5012e085fa33e6c2ea50545c7,2,4,4,8,4,2010-02-08 17:35:29,2010-02-08 17:35:29
a5078c00d58b86e7913b5eade93c5132ff087ea1...476f0427b62d0af794b1b727ed99807ed76406f5,3,25,17,42,15,2010-02-08 16:29:49,2010-02-08 16:29:49
476f0427b62d0af794b1b727ed99807ed76406f5...2c1274202f16673b452903bee15fc9736442f2df,1,1,1,2,1,2010-02-08 17:10:15,2010-02-08 17:10:15
b818cf6c74013705688d80b567fceaf6b4b24100...285f6034e1d35251b9c84f741199430309fc18a7,3,484,484,968,8,2010-02-09 23:30:32,2010-02-09 23:30:32
b4fe153800f7cc65825607af5cd4e4216aff8808...aa703d372f2ef617e01c561c2688db4821b87efa,4,67,2,69,7,2010-02-08 18:57:59,2010-02-08 18:57:59
2c1274202f16673b452903bee15fc9736442f2df...94116f7c6d2ffeb6645aeb3d1489219aa652f10b,4,34,7,41,9,2010-02-09 00:23:48,2010-02-09 00:23:48
2c1274202f16673b452903bee15fc9736442f2df...a38baaa991dd88c368b3f539544f9649b488eaf7,1,48,0,48,1,2010-02-08 21:49:26,2010-02-08 21:49:26
56092b9e2d081b4b2ddf0aeec63f2742037ec0b0...4b372247f1f2584ebcb4ba27a9775611b0c559b1,4,134,134,268,15,2010-02-12 13:46:53,2010-02-12 13:46:53
a919dd90c9453dfe5687288df73aa0622d99851d...90157edb27cabd9b111508a9000a2b8d87a8b67b,3,49,26,75,9,2010-02-08 22:17:18,2010-02-08 22:17:18
5af401d94b2f29934558b0d3b926783188709fca...04ef27cb4f32c5f17f70d19ca003ce72c0d5e35b,4,0,48,48,7,2010-02-09 00:52:41,2010-02-09 00:52:41
4b372247f1f2584ebcb4ba27a9775611b0c559b1...690f58b63f8b88d4e60db1c6eb5b0d680cbb39d0,1,7,6,13,1,2010-02-12 16:44:21,2010-02-12 16:44:21
690f58b63f8b88d4e60db1c6eb5b0d680cbb39d0...7c0369cb904d44b25ec84481278ce58ccef9b0c1,2,2,41,43,3,2010-02-12 17:15:30,2010-02-12 17:15:30
7c0369cb904d44b25ec84481278ce58ccef9b0c1...d28bcd5876c40eb52e0329cab11faa6269c3b950,1,1,29,30,2,2010-02-12 17:19:33,2010-02-12 17:19:33
d28bcd5876c40eb52e0329cab11faa6269c3b950...af43db2acadf3790ec36437bf29430578d48083f,3,11,13,24,6,2010-02-12 20:56:17,2010-02-12 20:56:17
af43db2acadf3790ec36437bf29430578d48083f...dd5d11e8abfa759982e65da541d2067b13d798c5,1,3,3,6,2,2010-02-12 21:05:05,2010-02-12 21:05:05
4b372247f1f2584ebcb4ba27a9775611b0c559b1...9f06af5d7b017f164889787b31f0a537c09d79b7,1,67,67,134,16,2010-02-12 15:00:50,2010-02-12 15:00:50
9f06af5d7b017f164889787b31f0a537c09d79b7...65d6f42b83625a1e039c29e246e1d97ccfbd7464,1,1,1,2,1,2010-02-12 16:07:37,2010-02-12 16:07:37
65d6f42b83625a1e039c29e246e1d97ccfbd7464...a4e79e80c2c6a853de69d2bcdbd445fe28e7a656,2,21,8,29,10,2010-02-12 16:07:57,2010-02-12 16:07:57
04ef27cb4f32c5f17f70d19ca003ce72c0d5e35b...a01100d8e55d14dc78b111d8516f644583b80de5,3,17,2,19,4,2010-02-09 02:21:42,2010-02-09 02:21:42
04ef27cb4f32c5f17f70d19ca003ce72c0d5e35b...a2a95072bd83c3956ba21c09df2122ca7fa5f002,1,1,0,1,1,2010-02-09 01:43:08,2010-02-09 01:43:08
a2a95072bd83c3956ba21c09df2122ca7fa5f002...c037f216740d75d019dd066093862e55d6213960,9,49,42,91,31,2010-02-09 02:04:09,2010-02-09 02:04:09
10287f9e036b79870b58a3cc171df2f55f02d68d...d87a1293574269ac6540867ac9f33c8c1b823b24,1,0,12,12,1,2010-02-13 03:17:30,2010-02-12 18:07:17
d87a1293574269ac6540867ac9f33c8c1b823b24...1799de115205514f2e80aac1cc3fc65aeea842bf,1,0,17,17,5,2010-02-13 03:17:30,2010-02-12 18:58:49
1799de115205514f2e80aac1cc3fc65aeea842bf...0bf045c2e1984718dec59e64cc6cc428b6461119,4,13,23,36,11,2010-02-13 03:17:31,2010-02-12 19:06:01
0bf045c2e1984718dec59e64cc6cc428b6461119...61578bdf8ff4477de2760c73303e22a226ed37ad,1,16,12,28,9,2010-02-13 03:17:31,2010-02-12 20:19:28
61578bdf8ff4477de2760c73303e22a226ed37ad...07dea15c9249dcd8950b0d4caf7120f60a0f6d32,1,37,40,77,24,2010-02-13 03:17:31,2010-02-13 00:48:33
07dea15c9249dcd8950b0d4caf7120f60a0f6d32...8294bd2d641b74778ac6293261fdff0dc062f77b,2,47,11,58,13,2010-02-13 03:17:31,2010-02-13 02:55:37
8294bd2d641b74778ac6293261fdff0dc062f77b...51ebf0fc741727511cb15c95c6c8edbf533f8fe9,2,46,27,73,9,2010-02-13 03:22:00,2010-02-13 03:16:12
51ebf0fc741727511cb15c95c6c8edbf533f8fe9...ff767ba537c5642ba087db25df0c2a9b71401451,1,20,0,20,1,2010-02-13 04:58:46,2010-02-13 04:58:46
a4e79e80c2c6a853de69d2bcdbd445fe28e7a656...eaf2a30a5b24b81836c0de6e22f67b15cfc82990,1,1,1,2,1,2010-02-12 16:32:44,2010-02-12 16:32:44
eaf2a30a5b24b81836c0de6e22f67b15cfc82990...2f406ce7620eb7850fb79db9e8028985826894bc,5,146,10,156,15,2010-02-12 16:33:07,2010-02-12 16:33:07
2f406ce7620eb7850fb79db9e8028985826894bc...d56750fe7f943b42036b8d5b0c1265cf9e211562,1,46,52,98,10,2010-02-12 16:33:15,2010-02-12 16:33:15
a4e79e80c2c6a853de69d2bcdbd445fe28e7a656...7677986ab7c83cf477158a36cec65c16ca835d07,2,6,3,9,3,2010-02-12 16:17:22,2010-02-11 22:21:32
7677986ab7c83cf477158a36cec65c16ca835d07...22530d6b64c4366d8c67edf52e83ae2003caa42d,1,2,1,3,1,2010-02-12 16:17:22,2010-02-12 16:14:29
22530d6b64c4366d8c67edf52e83ae2003caa42d...861c8513f32d7107fa0fca1db524f2c606cff7f3,1,1,1,2,1,2010-02-12 16:25:19,2010-02-12 16:25:19
bc142fbcdbcbdfd11356153d8ecad1279072f8d2...9be0100c844caf68705dd8e4b904175e83875849,1,19,0,19,2,2010-02-09 03:08:10,2010-02-09 03:08:10
9be0100c844caf68705dd8e4b904175e83875849...16b0080200a86e337eaaea06f4e7fdf949efdfa1,1,2,0,2,1,2010-02-09 03:13:51,2010-02-09 03:13:51
16b0080200a86e337eaaea06f4e7fdf949efdfa1...c751a4a047bc7f3f9d9a4e3731728f7984a75b75,2,7,7,14,5,2010-02-09 03:33:10,2010-02-08 09:53:32
c751a4a047bc7f3f9d9a4e3731728f7984a75b75...eefff3bcc434183574f99a0d77a1baba80e33724,1,1,0,1,1,2010-02-09 03:33:10,2010-02-08 10:01:45
eefff3bcc434183574f99a0d77a1baba80e33724...76ca6a2887e26f8b9db1a4e399db16d888b1ed64,2,19,3,22,3,2010-02-09 05:48:02,2010-02-09 05:48:02
76ca6a2887e26f8b9db1a4e399db16d888b1ed64...ecc40e19dbb294ab221d4a52512c71ab8b43061d,3,64,30,94,10,2010-02-09 15:25:05,2010-02-09 15:25:05
ecc40e19dbb294ab221d4a52512c71ab8b43061d...12a8eee52c1cdb9fc2fda98c04673b0e98faaf95,3,68,19,87,9,2010-02-09 15:35:31,2010-02-09 15:35:31
ff767ba537c5642ba087db25df0c2a9b71401451...2ad5ffd39cada943b7f00aa5079df3ad517d75d7,1,164,160,324,16,2010-02-13 22:41:15,2010-02-13 22:41:15
2ad5ffd39cada943b7f00aa5079df3ad517d75d7...bb740f55275095a3a6cc55089d4b3648791147da,1,63,63,126,7,2010-02-13 22:47:32,2010-02-13 22:47:32
bb740f55275095a3a6cc55089d4b3648791147da...5ca3413cce807db33ec29f5c62312e4876ad6287,1,21,21,42,8,2010-02-14 03:15:27,2010-02-14 03:15:27
5ca3413cce807db33ec29f5c62312e4876ad6287...c459854f736066d8fc83f291eb563c296c370dcb,1,10,8,18,8,2010-02-14 15:44:06,2010-02-14 15:44:06
c459854f736066d8fc83f291eb563c296c370dcb...491f7c448d8a37d30e19f5ed747be459e975b9df,1,4,4,8,3,2010-02-14 15:50:53,2010-02-14 15:50:53
ff767ba537c5642ba087db25df0c2a9b71401451...7e2be82e218a5bf0898aff4d17b3ef8662a97c2f,2,14,3,17,5,2010-02-13 17:37:00,2010-02-13 17:37:00
bf8d571e5efaba76a9a3a1d24e3efcb8846c5001...ee3b7145e3f723391cdcacae3c079414bd3056d0,3,96,60,156,5,2010-02-12 18:04:20,2010-02-12 18:04:20
bf8d571e5efaba76a9a3a1d24e3efcb8846c5001...6ed87776434dc9e7f670bb3c9b08244ecac0447a,1,5,3,8,4,2010-02-12 18:03:40,2010-02-12 18:03:40
12a8eee52c1cdb9fc2fda98c04673b0e98faaf95...dc9f26e421bc2a2437c6e25920cf9298d24bccb9,2,54,13,67,8,2010-02-09 17:35:26,2010-02-09 17:35:26
12a8eee52c1cdb9fc2fda98c04673b0e98faaf95...8258e00f7d542612bf2a8b7f4da644b896d92280,1,1,0,1,1,2010-02-09 16:35:34,2010-02-09 16:35:34
8258e00f7d542612bf2a8b7f4da644b896d92280...cedbc789e44b475faea10ab10d251936339b5c4c,3,19,2,21,5,2010-02-09 16:50:53,2010-02-09 16:50:53
dd4a68eed7c12bcbc6bd05377d2108ec1aac32cd...e74ce5f592a4f5cb899962f388d1d111f4c439e1,1,22,17,39,4,2010-02-15 01:36:18,2010-02-15 01:36:18
e74ce5f592a4f5cb899962f388d1d111f4c439e1...62aad0ee18bc8a9430a8aa7d81ed0ae75b82fd2f,7,240,115,355,21,2010-02-16 03:33:27,2010-02-16 03:33:27
62aad0ee18bc8a9430a8aa7d81ed0ae75b82fd2f...43499d2457c1c179ae389fccb33d813f08637292,3,27,27,54,17,2010-02-16 04:17:42,2010-02-16 04:17:42
43499d2457c1c179ae389fccb33d813f08637292...cfec75960b02b456ba6a582dec62ff083de31973,2,2,4,6,3,2010-02-16 04:55:41,2010-02-16 04:55:41
cfec75960b02b456ba6a582dec62ff083de31973...a330ad65dd86a1de3f001c8f21540ae58fa23cb0,3,91,2,93,11,2010-02-16 04:58:08,2010-02-16 04:58:08
a330ad65dd86a1de3f001c8f21540ae58fa23cb0...0dcc8b9262e17b641d97eb735a6063dbc615e053,1,1,1,2,1,2010-02-16 05:06:39,2010-02-16 05:06:39
0dcc8b9262e17b641d97eb735a6063dbc615e053...6dbd99b3dba68f766c623353b15ce0e56cb71887,2,18,41,59,16,2010-02-16 05:56:22,2010-02-16 05:56:22
6dbd99b3dba68f766c623353b15ce0e56cb71887...abdc594a661a888a33b8204499fe475fc6628fa2,2,15,12,27,7,2010-02-16 06:05:04,2010-02-16 06:05:04
abdc594a661a888a33b8204499fe475fc6628fa2...431714d0eac19a195f143365925be5ac512ee7b4,1,8,0,8,1,2010-02-16 13:25:30,2010-02-16 13:25:30
431714d0eac19a195f143365925be5ac512ee7b4...c0b7ca3add50986f6cb76db684068b278250172f,1,5,21,26,6,2010-02-16 14:06:49,2010-02-16 14:06:49
c0b7ca3add50986f6cb76db684068b278250172f...3d5d5a29bd1a8d44f189fa6b61e2821b623cbdd4,1,10,10,20,4,2010-02-16 15:03:12,2010-02-16 15:03:12
3d5d5a29bd1a8d44f189fa6b61e2821b623cbdd4...0a4d316701e48ab734d450264547599491cfbb17,1,16,7,23,2,2010-02-16 15:03:24,2010-02-16 15:03:24
0a4d316701e48ab734d450264547599491cfbb17...2ce2cfa8ae9905d66da827287a7b46a71c770239,1,2,2,4,1,2010-02-16 15:11:49,2010-02-16 15:11:49
2ce2cfa8ae9905d66da827287a7b46a71c770239...6b67db1f230512d757d5ffa0e09d3d8283354580,1,1,1,2,1,2010-02-16 15:18:26,2010-02-16 15:18:26
6b67db1f230512d757d5ffa0e09d3d8283354580...773570b8a80d2e592f4e1f824fe44a5ed8828389,3,161,146,307,59,2010-02-16 16:13:31,2010-02-16 16:13:31
773570b8a80d2e592f4e1f824fe44a5ed8828389...4f1687162891fad437832791c7307e887cb3537a,4,63,16,79,18,2010-02-16 16:37:47,2010-02-16 16:37:47
4f1687162891fad437832791c7307e887cb3537a...0ef13aa1d6ee7cb3a16dd2c0e5fff9e3653c4dad,3,66,8,74,11,2010-02-16 18:42:47,2010-02-16 18:42:47
0ef13aa1d6ee7cb3a16dd2c0e5fff9e3653c4dad...ee1eb4a1c27e8de707f9e4c44a9763a2a33e4bdd,1,3,3,6,2,2010-02-16 19:29:34,2010-02-16 19:29:34
ee1eb4a1c27e8de707f9e4c44a9763a2a33e4bdd...e0dbd0131feb120ad53cdf00514f8f5ff2885b5d,2,20,9,29,5,2010-02-16 19:30:50,2010-02-16 19:30:50
e0dbd0131feb120ad53cdf00514f8f5ff2885b5d...2b7dd6ad055fa1b8ec9f63dae394985f58a8c417,1,3,3,6,3,2010-02-16 19:51:51,2010-02-16 19:51:51
a4ae3d420e61ecdcd90b968aef282b07456ea463...96f7493c21fc673a16df114963fbd5f27146b139,4,113,93,206,8,2010-02-12 18:21:33,2010-02-12 18:21:33
96f7493c21fc673a16df114963fbd5f27146b139...1775dc371920c015c6a54d32ca607f3ac1b17826,1,41,27,68,8,2010-02-12 18:33:22,2010-02-12 18:33:22
1775dc371920c015c6a54d32ca607f3ac1b17826...2348a3cc129ea94f493105a36113332b19dc0560,2,7,1,8,4,2010-02-12 18:36:10,2010-02-12 18:36:10
1748b99c6c8567f8e74ad9fef8c7675ba9f603b4...fd8f4be646e9d4811aefcc3671d7a0c3d7f828e4,1,1,1,2,1,2010-02-09 19:38:19,2010-02-09 19:38:19
1748b99c6c8567f8e74ad9fef8c7675ba9f603b4...551d924f5484014fe9787a8207a405b0266a6cc8,1,17,0,17,5,2010-02-09 18:53:49,2010-02-09 18:53:18
cedbc789e44b475faea10ab10d251936339b5c4c...7e736f67c1fa069f50d7c6733ff42743ea1221d6,5,10,3,13,4,2010-02-09 20:32:49,2010-02-09 20:32:49
cedbc789e44b475faea10ab10d251936339b5c4c...392d9bfe8d4ce5086768acdfe31592509f2e2df1,2,17,17,34,16,2010-02-09 17:30:58,2010-02-09 17:20:10
392d9bfe8d4ce5086768acdfe31592509f2e2df1...95fa5a3bc7e3f33dae53abe75180fba98b667f78,1,18,0,18,1,2010-02-09 17:30:58,2010-02-09 17:20:56
95fa5a3bc7e3f33dae53abe75180fba98b667f78...611e665e478cf780ca9117e2301be860d8400d71,2,150,0,150,2,2010-02-09 17:30:58,2010-02-09 17:30:04
2b7dd6ad055fa1b8ec9f63dae394985f58a8c417...7ed81cdf6bc3af668273983c8dd890e545bcdaa4,5,86,11,97,17,2010-02-16 23:20:35,2010-02-16 23:20:35
2b7dd6ad055fa1b8ec9f63dae394985f58a8c417...d1e3572f45318511402b8482e7c63d3446d52ec8,4,21,5,26,5,2010-02-16 21:24:23,2010-02-16 21:23:25
d1e3572f45318511402b8482e7c63d3446d52ec8...f485e25f82b9d96e0cf7173615eaa85cd93cbe5e,2,9,6,15,7,2010-02-16 21:24:28,2010-02-16 21:23:52
2348a3cc129ea94f493105a36113332b19dc0560...eeae78fbf2c431b3db59c55b8c8f5868b48f01f1,1,19,5,24,2,2010-02-12 19:07:17,2010-02-12 19:07:17
2348a3cc129ea94f493105a36113332b19dc0560...4f209028b11f3997bf59aa085a84bd92daf6e623,1,1,1,2,1,2010-02-12 18:47:27,2010-02-12 18:47:27
18562c9ea76f125d93f513224f54c117cfcd080e...b96e4b297600dc47b921d204e7f2f45226f7ca16,36,576,0,576,36,2010-02-09 21:48:21,2010-02-09 21:48:21
18562c9ea76f125d93f513224f54c117cfcd080e...1e7d97e82c8e8a512bc164c8f895b1f671a85466,1,1,1,2,1,2010-02-09 21:45:59,2010-02-09 21:45:59
1e7d97e82c8e8a512bc164c8f895b1f671a85466...086d64580da33cfabc27ba2f5a0ea6323c730cb2,2,91,0,91,3,2010-02-09 21:46:30,2010-02-09 21:46:30
18562c9ea76f125d93f513224f54c117cfcd080e...fcc79ef58ed578dd3d245e8edbbaad772f559e32,2,0,26,26,4,2010-02-09 20:28:26,2010-02-09 20:28:26
f7f02b12f2ad13ffebb77b5804948f8509b337d9...1d38e43c7734fb08eba42835322efdb869306ad4,1,1,1,2,1,2010-02-09 21:10:58,2010-02-09 21:10:58
714b242f9221e9bb6a184b90de947621264528a4...b92ecb5690780c0b32ad05a0089c8e54ec01af1b,1,12,0,12,1,2010-02-16 23:28:49,2010-02-16 23:28:49
b92ecb5690780c0b32ad05a0089c8e54ec01af1b...37949e561c1f3cda3271b4a7939f4995cbcefa46,2,17,5,22,7,2010-02-17 00:25:38,2010-02-17 00:25:38
37949e561c1f3cda3271b4a7939f4995cbcefa46...2f796e3d2a608da167e67cde0dce220f2387191b,1,0,5,5,4,2010-02-17 00:36:01,2010-02-17 00:36:01
2f796e3d2a608da167e67cde0dce220f2387191b...23475ac37fa350480eb0fe5e0c2800c15ad77995,7,106,3,109,12,2010-02-17 03:33:24,2010-02-17 03:33:24
23475ac37fa350480eb0fe5e0c2800c15ad77995...241ec02cae768a0da98ebf745269bf4cf9e80b67,3,27,9,36,13,2010-02-17 04:50:55,2010-02-17 04:50:55
241ec02cae768a0da98ebf745269bf4cf9e80b67...243bb5d0527bf689eba231597cb09e3862a5c72e,2,2,1,3,2,2010-02-17 05:18:54,2010-02-17 05:18:54
1aa71a419ee98e252f7bde3b5a4fb1d302339b4d...202d0e55f3ff3490b679bf81c5b5c89865b7ee57,1,11,5,16,3,2010-02-12 19:15:20,2010-02-12 19:15:20
202d0e55f3ff3490b679bf81c5b5c89865b7ee57...c468109cbe6bae05e90eab43802d676b11f3c80b,1,6,0,6,2,2010-02-12 19:19:57,2010-02-12 19:19:57
c468109cbe6bae05e90eab43802d676b11f3c80b...48a9c8cc712633dc259bbdb2ba055c30b2e623b6,1,1,1,2,1,2010-02-12 19:23:05,2010-02-12 19:23:05
48a9c8cc712633dc259bbdb2ba055c30b2e623b6...09454a9ef6fbbfd2c4e88fd63cf3a210c58985b1,1,1,1,2,1,2010-02-12 19:33:43,2010-02-12 19:33:43
09454a9ef6fbbfd2c4e88fd63cf3a210c58985b1...a023fc861b1bcd3f3cd9e3723a8e97a743c53bd8,3,13,6,19,5,2010-02-12 19:43:27,2010-02-12 19:43:27
a023fc861b1bcd3f3cd9e3723a8e97a743c53bd8...4685677e23eb23aed5053b72e7a23eb5f3f9408f,1,0,2,2,2,2010-02-12 19:44:21,2010-02-12 19:44:21
4685677e23eb23aed5053b72e7a23eb5f3f9408f...e310776ecf1ef6f52f60ebf5e03aceaef5e90b6e,6,37,5,42,7,2010-02-12 20:27:43,2010-02-12 20:27:43
afa21134b2eeec1b09cd247f8f4b4172ad7942d5...61c9af96fef1e239d157c880cc4554c557e5c736,1,6,4,10,5,2010-02-09 22:55:33,2010-02-09 22:55:33
afa21134b2eeec1b09cd247f8f4b4172ad7942d5...929ae35cdd0d5aaa4e9338e05b8ad7abcc5d8b26,3,17,3,20,9,2010-02-09 21:58:03,2010-02-09 21:58:03
87a9f972e0de28cee1b813abfaa096225983131d...2567639a1d2852cdb9ae1d2df671c9441b6c6a35,1,1,1,2,1,2010-02-09 22:20:46,2010-02-09 22:20:46
243bb5d0527bf689eba231597cb09e3862a5c72e...47d84a962d62521ebfad4e0e87e2e9eac8cc6e46,1,3,2,5,3,2010-02-17 17:29:17,2010-02-17 17:29:17
243bb5d0527bf689eba231597cb09e3862a5c72e...a8a36e6ff2a104ec63b75eaff97a8c427b81b75e,1,6,1,7,2,2010-02-17 14:58:02,2010-02-17 14:58:02
a8a36e6ff2a104ec63b75eaff97a8c427b81b75e...8fbc9c34acf011a23238241d55550cea529c58fa,2,5,6,11,2,2010-02-17 16:03:29,2010-02-17 16:02:36
8fbc9c34acf011a23238241d55550cea529c58fa...7700abb01197a0415ae337ac4305a150750d3978,2,31,2,33,11,2010-02-17 16:03:39,2010-02-17 16:02:56
7700abb01197a0415ae337ac4305a150750d3978...1b5596861e3be722702e5e2eb40417de39bedffe,1,11,4,15,5,2010-02-17 16:51:11,2010-02-17 16:50:37
b122797eb2ab63fa79e875f754f2101e9262b22e...ac51e771deaca9a558c59bee6f27ed9e179ec8a2,1,1,1,2,1,2010-02-09 23:15:56,2010-02-09 23:15:52
39911b056aab6fa3e2d636ac9b9ed7dfefc5cbf4...fe075a0af70ddef85d48c1c0c944f21e5709f54b,2,4,0,4,3,2010-02-09 22:51:58,2010-02-09 22:51:58
39911b056aab6fa3e2d636ac9b9ed7dfefc5cbf4...41f0e6d464a3c047ae515d5dce37b1aefc7c87fd,3,5,0,5,4,2010-02-09 22:51:15,2010-02-09 22:50:38
9a8fcf127617d32b698a969296a56cb76ac4bad7...154cce03f4d89533558933acd8ee21a167d6d2b5,1,1,1,2,1,2010-02-17 18:24:19,2010-02-17 18:24:19
37d6ee1a89ed8e4aa87418cb0e2b121e570b3ca4...5a9c6c75ee63208ee29f7f996914d2fc9a4ae400,1,1,1,2,1,2010-02-09 23:33:23,2010-02-09 23:33:23
5a9c6c75ee63208ee29f7f996914d2fc9a4ae400...d036173dc1207d83d4dd9800ff0276f74049737a,1,2,2,4,2,2010-02-10 00:08:24,2010-02-10 00:08:24
d036173dc1207d83d4dd9800ff0276f74049737a...c60c5642ea67317d17cfdd883d7bc818e700e11c,1,0,0,0,0,2010-02-10 00:09:00,2010-02-10 00:09:00
c60c5642ea67317d17cfdd883d7bc818e700e11c...57fedf6db082933fb463ad946b1b1b1b54a76b2b,1,0,0,0,0,2010-02-10 00:15:21,2010-02-10 00:15:21
57fedf6db082933fb463ad946b1b1b1b54a76b2b...3ed4103d93e7208b18bef6d55704fccb84af62df,1,1,0,1,1,2010-02-10 00:47:11,2010-02-10 00:47:11
3ed4103d93e7208b18bef6d55704fccb84af62df...5d00480dcbbf70aab4c9ed03c7dfa4dabcbfe0f6,1,10,10,20,9,2010-02-10 01:20:20,2010-02-10 01:20:20
5d00480dcbbf70aab4c9ed03c7dfa4dabcbfe0f6...09a5a250ea674e2f08b55cfab4aace514ee0d2f9,1,4,0,4,1,2010-02-10 01:21:05,2010-02-10 01:21:05
09a5a250ea674e2f08b55cfab4aace514ee0d2f9...2e5494cf788d9c736bd9ba7799c7439f2d0f956b,1,5,0,5,2,2010-02-10 01:23:49,2010-02-10 01:23:49
2e5494cf788d9c736bd9ba7799c7439f2d0f956b...ba830a02d41cd9104bb3acd7c5a060cb45b1c619,1,0,0,0,0,2010-02-10 01:24:17,2010-02-10 01:24:17
ba830a02d41cd9104bb3acd7c5a060cb45b1c619...5eb5dab79fa6f24fe0a1b6739c510ac3a0f46e32,1,4,4,8,4,2010-02-10 03:13:28,2010-02-10 03:13:28
5eb5dab79fa6f24fe0a1b6739c510ac3a0f46e32...58dff03bbb5c51d40baf35e76c4536d460098743,1,2,2,4,2,2010-02-10 04:17:48,2010-02-10 04:17:48
58dff03bbb5c51d40baf35e76c4536d460098743...b255688822a2958530233ff2d9d438b23ede1839,1,0,6,6,1,2010-02-10 15:09:41,2010-02-10 15:09:41
1116c759be379bc62a30200a97d3ffc94b79253b...a1f7d6726d11588423262ab085c021e78860e9bb,1,1,1,2,1,2010-02-09 23:23:14,2010-02-09 23:23:14
a1f7d6726d11588423262ab085c021e78860e9bb...c4fce33450a5b54b860652525bd9d3273737839f,1,74,0,74,1,2010-02-09 23:23:42,2010-02-09 23:23:42
154cce03f4d89533558933acd8ee21a167d6d2b5...0ffefe9bc0d01585671e4ddbd4101663aa386fe7,4,42,17,59,12,2010-02-17 19:59:35,2010-02-17 19:59:35
0ffefe9bc0d01585671e4ddbd4101663aa386fe7...081795ed7592466bf5788470ab3d23316c6714fa,2,12,10,22,5,2010-02-17 20:42:24,2010-02-17 20:42:24
154cce03f4d89533558933acd8ee21a167d6d2b5...edbdec4f15e1491edb915862f781cc61e1d34ef5,2,8,0,8,3,2010-02-17 19:16:49,2010-02-17 19:16:49
edbdec4f15e1491edb915862f781cc61e1d34ef5...60391897f34659143e20af6113901430d4d422c6,1,30,0,30,2,2010-02-17 20:14:46,2010-02-17 20:14:46
b255688822a2958530233ff2d9d438b23ede1839...635a16e94c583d7fc97ff65e32aa7f058caeefe0,6,63,27,90,24,2010-02-10 20:34:41,2010-02-10 20:34:41
b255688822a2958530233ff2d9d438b23ede1839...8e3bf0fecada98f2e348256573b1f349e1f4dc45,1,1,1,2,1,2010-02-10 18:18:13,2010-02-10 18:18:13
1c55567e76e55d0dcf09723f79b770e557e42c49...1d97a69eaea63cbff5889a115f66634a6aa2d317,1,3,2,5,3,2010-02-17 21:42:16,2010-02-17 21:42:16
1d97a69eaea63cbff5889a115f66634a6aa2d317...810eb323c33e210974b8aaa0814c0039253c7321,1,1,1,2,1,2010-02-17 23:36:45,2010-02-17 23:36:45
810eb323c33e210974b8aaa0814c0039253c7321...56150cc727b8faabbb255daa74b3b2bdbb912852,7,63,6,69,15,2010-02-18 01:06:54,2010-02-18 01:06:54
d311ff64ff9a05e193649870e6aaa2659ecf9c37...0ae466d158e090f88500749b05acf62d4deea695,2,76,56,132,7,2010-02-11 19:49:55,2010-02-11 19:49:55
d311ff64ff9a05e193649870e6aaa2659ecf9c37...db18c068d406305286745bf524d266471e32e7ad,1,9,3,12,1,2010-02-11 02:57:14,2010-02-11 02:57:14
db18c068d406305286745bf524d266471e32e7ad...7935d23cca442aa696fd266b2339bc46d9d838bf,1,1,12,13,1,2010-02-11 03:28:29,2010-02-11 03:28:29
7935d23cca442aa696fd266b2339bc46d9d838bf...c9ed60974d3a795a25353f3790d6af6093bfad3d,4,27,2,29,4,2010-02-11 16:36:08,2010-02-11 16:36:08
c9ed60974d3a795a25353f3790d6af6093bfad3d...c3b8492cf0f8dd2012e0aa6de3e025adec3f7b29,8,45,18,63,27,2010-02-11 17:52:26,2010-02-11 17:52:26
c3b8492cf0f8dd2012e0aa6de3e025adec3f7b29...e2a8e2f12d8f12c32a28a3567213e4fd91870bc1,1,2,1,3,1,2010-02-11 18:49:37,2010-02-11 18:49:37
8e3bf0fecada98f2e348256573b1f349e1f4dc45...ce7b2867452f9158ba548c370e95c6f3d348914d,3,15,12,27,8,2010-02-10 18:28:08,2010-02-10 18:28:08
ce7b2867452f9158ba548c370e95c6f3d348914d...38b822809b4ee78dc7721b49096b7b52761d155b,1,17,0,17,1,2010-02-10 18:35:43,2010-02-10 18:35:43
38b822809b4ee78dc7721b49096b7b52761d155b...f765ec0442d243cdbd47713b6d63a1237dde863b,3,19,6,25,6,2010-02-10 19:18:57,2010-02-10 19:18:57
f765ec0442d243cdbd47713b6d63a1237dde863b...b88e91c8f56fcbd309bd1b2fc337d5c877ccc3b4,4,10,18,28,12,2010-02-10 20:16:00,2010-02-10 20:16:00
8e3bf0fecada98f2e348256573b1f349e1f4dc45...e9676be9b59a085d3c0900802db163083a6a369e,1,16,11,27,6,2010-02-10 18:18:57,2010-02-08 21:14:17
e9676be9b59a085d3c0900802db163083a6a369e...9e21b214fc5b2432daeb35d58eed5348148ce7da,1,14,8,22,11,2010-02-11 19:37:08,2010-02-11 19:37:08
56150cc727b8faabbb255daa74b3b2bdbb912852...562901361140eb82966fd73c1359da3923a58fbe,1,1,1,2,1,2010-02-18 06:23:31,2010-02-18 06:23:31
56150cc727b8faabbb255daa74b3b2bdbb912852...15390838c552e2c7abdfb7e6f8f36f4e9e10e281,1,5,2,7,2,2010-02-18 02:08:10,2010-02-18 02:08:10
15390838c552e2c7abdfb7e6f8f36f4e9e10e281...258fd02642ce228a816634915cce90842ed6d681,2,29,11,40,4,2010-02-18 03:53:32,2010-02-18 03:53:32
3005fcb976b2f56914ff94b746da5a07a8b2c16f...328754c4eca7d554be7f7697ec1c24c33cdd8d10,4,4,4,8,4,2010-02-11 20:29:16,2010-02-11 20:29:16
e2a8e2f12d8f12c32a28a3567213e4fd91870bc1...2b96337203082bc22da70ed9e8c3460940eec281,2,30,1,31,3,2010-02-11 19:35:55,2010-02-11 19:35:55
e2a8e2f12d8f12c32a28a3567213e4fd91870bc1...72f8e1ae733f5089faa5d2c1d9a107439d364448,1,2,0,2,2,2010-02-11 18:50:34,2010-02-11 17:54:02
72f8e1ae733f5089faa5d2c1d9a107439d364448...6ea23ccfa27e65b7caa0ad31ea5f67d132a0394b,2,2,2,4,2,2010-02-11 18:50:34,2010-02-11 18:49:36
678f2d9bce7587922ebfef816749055625c3a262...dfa63a69a7c567ebda598de5f31f94bdd5b7ac14,1,0,0,0,0,2010-02-11 19:39:59,2010-02-11 19:39:59
954899929524e9ef262e1e57077e5147fc3ffcf0...78930bdb28fb6fcf2a7e55d85b4432ad79e01d2d,1,1,0,1,1,2010-02-18 06:56:07,2010-02-18 06:56:07
78930bdb28fb6fcf2a7e55d85b4432ad79e01d2d...5c8d2d1538e27a2f6e112b9b6e6bf16d2276be94,1,14,0,14,1,2010-02-18 07:46:53,2010-02-18 07:46:53
5c8d2d1538e27a2f6e112b9b6e6bf16d2276be94...1ec372ec3b03657c1ceabdc21aeb453f092c747b,1,53,32,85,13,2010-02-18 07:47:15,2010-02-18 07:47:15
1ec372ec3b03657c1ceabdc21aeb453f092c747b...9e0c0ec4801b5d8763096aefde5b7f3d5e4afbd4,1,32,53,85,13,2010-02-18 19:12:57,2010-02-18 19:12:57
9e0c0ec4801b5d8763096aefde5b7f3d5e4afbd4...488f4a32254b40e10bfddc3f90b03c1457c83740,2,8,2,10,3,2010-02-19 16:42:58,2010-02-19 16:42:16
488f4a32254b40e10bfddc3f90b03c1457c83740...09e19df797a9628f825b2a2823c2016df8b27be1,1,5,4,9,4,2010-02-19 18:52:36,2010-02-19 18:52:36
09e19df797a9628f825b2a2823c2016df8b27be1...c8fb2fb8925db3ad0f314c9c97a0ea53f28f8c65,1,6,2,8,2,2010-02-19 19:27:25,2010-02-19 19:27:25
c8fb2fb8925db3ad0f314c9c97a0ea53f28f8c65...8e311b0094ea53e289b57b88c9183801e9626af2,1,1,1,2,1,2010-02-19 19:38:02,2010-02-19 19:38:02
8e311b0094ea53e289b57b88c9183801e9626af2...ad92a65350c117a42d1b3a3b49a8878903d09468,3,67,13,80,9,2010-02-19 21:11:55,2010-02-19 21:11:55
328754c4eca7d554be7f7697ec1c24c33cdd8d10...eb75c9529f6362327ba4dd15be298df1b0e5fb18,4,6,3,9,4,2010-02-23 16:06:26,2010-02-23 16:06:26
328754c4eca7d554be7f7697ec1c24c33cdd8d10...e13c189def565b7cb1b3ac1e02655eb218c2c174,1,1,0,1,1,2010-02-11 22:17:24,2010-02-11 22:17:24
e13c189def565b7cb1b3ac1e02655eb218c2c174...5d44f01b1fb59093878d323f1ea254fdcf9301eb,2,28,5,33,5,2010-02-11 22:17:36,2010-02-11 22:17:36
5d44f01b1fb59093878d323f1ea254fdcf9301eb...74d81e44b59ff57e81c3f64d8092fc3f31031bc5,2,0,0,0,0,2010-02-11 22:33:13,2010-02-11 22:33:13
74d81e44b59ff57e81c3f64d8092fc3f31031bc5...a94e0b79b1e8640db475afc9d28aee75b6b8e519,1,1,1,2,1,2010-02-11 22:45:29,2010-02-11 22:45:29
a94e0b79b1e8640db475afc9d28aee75b6b8e519...29f0b15d5f7b78e51f5996ba1552bd686a996855,1,23,4,27,6,2010-02-12 01:22:32,2010-02-12 01:21:58
29f0b15d5f7b78e51f5996ba1552bd686a996855...6370984c5dd2d3982cb0c3b99cedbe99a41cd301,1,1,1,2,1,2010-02-12 03:38:53,2010-02-12 03:38:53
ad92a65350c117a42d1b3a3b49a8878903d09468...34a03aa718f846e12d3ec9b409389666f054e9f6,1,1,1,2,1,2010-02-20 15:48:00,2010-02-20 15:48:00
ad92a65350c117a42d1b3a3b49a8878903d09468...5725f09db31277e0b30d9b5550775f560427ba3e,1,1,0,1,1,2010-02-20 01:51:03,2010-02-20 01:51:03
5725f09db31277e0b30d9b5550775f560427ba3e...9c8858d85a2b6caace2ea056e720c865ba05dfec,3,18,2,20,4,2010-02-20 21:16:17,2010-02-20 21:16:17
9c8858d85a2b6caace2ea056e720c865ba05dfec...6adaeeaa85a91cbc160067b0582cea3a1ef5f24a,3,56,7,63,11,2010-02-20 21:20:33,2010-02-20 21:20:33
6adaeeaa85a91cbc160067b0582cea3a1ef5f24a...ebb37d118f6ba2fa8a0fb6abe1474c19eeeed596,1,10,2,12,7,2010-02-20 21:25:10,2010-02-20 21:25:10
ebb37d118f6ba2fa8a0fb6abe1474c19eeeed596...5383659f5efab34ec2fb512b3388dbb9ad768c52,4,179,15,194,26,2010-02-20 21:35:26,2010-02-20 21:35:26
32c065676e30e3ee528a30e07483ec664476cb29...c23e098ecdefecb7b272b65712aad5bd9ffbd84a,4,24,9,33,13,2010-02-23 16:44:10,2010-02-23 16:44:10
73f2f91c6a0f8e05b7fe0ecde99481c6a47fff38...8e6c51441ea64f412553669b804359cc0edea216,1,2,2,4,2,2010-02-20 21:38:37,2010-02-20 21:38:37
8e6c51441ea64f412553669b804359cc0edea216...0f7a192cec937321d56fcb219a8aae1629445ea3,1,1,1,2,1,2010-02-20 21:54:37,2010-02-20 21:54:37
0f7a192cec937321d56fcb219a8aae1629445ea3...267056081f2fc627a94fa310b7e4a9438006ba2f,4,12,4,16,8,2010-02-20 22:37:12,2010-02-20 22:37:12
267056081f2fc627a94fa310b7e4a9438006ba2f...a1309b7c345c41d93bf8a942b240ff325c96235f,4,11,8,19,7,2010-02-21 15:42:38,2010-02-21 15:42:38
a1309b7c345c41d93bf8a942b240ff325c96235f...28e592d50d5eb43ab91197c9997b06da103ea924,1,2,2,4,2,2010-02-21 19:55:12,2010-02-21 19:55:12
28e592d50d5eb43ab91197c9997b06da103ea924...fa4eddeba7a8324505e10e2e4604a3eec803dfc6,1,1,1,2,1,2010-02-22 16:01:20,2010-02-22 16:01:20
fa4eddeba7a8324505e10e2e4604a3eec803dfc6...6ebe1c95328a55d01cf2bd0feaf12a34dd922e6e,1,2,1,3,1,2010-02-22 17:35:56,2010-02-22 17:35:56
6ebe1c95328a55d01cf2bd0feaf12a34dd922e6e...ae80a66ff8d30bc9785d12a5f9d8fafd0bc37e2a,7,22,6,28,12,2010-02-22 18:32:55,2010-02-22 18:32:55
ae80a66ff8d30bc9785d12a5f9d8fafd0bc37e2a...8f5ee9d1ba1ade5321771db14d7b7ac6419a35c8,1,5,1,6,1,2010-02-22 18:39:34,2010-02-22 18:39:34
8f5ee9d1ba1ade5321771db14d7b7ac6419a35c8...8bac9d01008fb88aff7230a621c4d277556cc7dd,1,53,32,85,13,2010-02-22 18:42:09,2010-02-22 18:42:09
8bac9d01008fb88aff7230a621c4d277556cc7dd...149248b4eb1a8f0cbfe28c4d43c4d2664b00b063,7,6,22,28,12,2010-02-22 19:40:47,2010-02-22 19:40:47
c23e098ecdefecb7b272b65712aad5bd9ffbd84a...442ff28ed640ccde5f0837ce1b234ee1da5ddbab,4,7,3,10,6,2010-02-23 17:30:53,2010-02-23 17:30:53
149248b4eb1a8f0cbfe28c4d43c4d2664b00b063...0ce8996a44e19c0380e66335e6b6c32a229f3bba,4,103,31,134,29,2010-02-22 22:33:24,2010-02-22 22:33:24
0ce8996a44e19c0380e66335e6b6c32a229f3bba...fe607048a1559d057171b5eb8e7665658191dfff,2,20,5,25,8,2010-02-23 00:24:17,2010-02-23 00:24:17
149248b4eb1a8f0cbfe28c4d43c4d2664b00b063...cd1dfe32b0efe7b0faa1db0c8ecc5d9528eac177,7,22,6,28,12,2010-02-22 20:08:54,2010-02-22 20:08:54
cd1dfe32b0efe7b0faa1db0c8ecc5d9528eac177...3dfbf854dafd3b656c430339eac37db754827b73,3,22,5,27,8,2010-02-22 20:45:58,2010-02-22 20:45:58
3dfbf854dafd3b656c430339eac37db754827b73...3284b510288d722d9507be4d9f9033e803b1d2c9,1,4,4,8,4,2010-02-22 21:01:23,2010-02-22 21:01:23
3284b510288d722d9507be4d9f9033e803b1d2c9...079031215d946eb118f6228a36eb04dc53b9dac4,6,15,6,21,10,2010-02-23 00:20:50,2010-02-23 00:20:50
e7365d7c92080052d3659cb8f9eddb9bd6ffd710...a61c72881ea963599ddab103bb597f84598225e4,3,3,3,6,3,2010-02-23 18:10:09,2010-02-23 18:10:09
e7365d7c92080052d3659cb8f9eddb9bd6ffd710...44e826fbbff6f77d26e01ab3c78eec27e15b6652,1,6,3,9,2,2010-02-23 17:49:24,2010-02-23 17:49:24
3f9f47e8841e97995495a62f05f5ec91702f8ebb...a1254dbc2cc2cdc1a43d063266e3091298bd4ab9,3,132,88,220,18,2010-02-23 18:29:10,2010-02-23 18:29:10
079031215d946eb118f6228a36eb04dc53b9dac4...a561c31a23ef0d69f89a21e7eebe61f67d7e1475,2,80,0,80,4,2010-02-23 02:23:20,2010-02-23 02:23:20
a561c31a23ef0d69f89a21e7eebe61f67d7e1475...d065d1bd7258cc860e5fd6cbb6f9363a10b70022,2,19,20,39,6,2010-02-23 03:16:13,2010-02-23 03:16:13
d065d1bd7258cc860e5fd6cbb6f9363a10b70022...221301072d101fdd17134ded5f6267958d6de05b,3,49,0,49,7,2010-02-23 12:51:36,2010-02-23 12:51:36
221301072d101fdd17134ded5f6267958d6de05b...fd3a8e76e55678b42d654c908f87bee8ca572974,5,899,1,900,5,2010-02-23 15:41:07,2010-02-23 15:41:07
fd3a8e76e55678b42d654c908f87bee8ca572974...e10779d9b6b12a65b63ba08e12c80555dab4eca3,1,1,1,2,1,2010-02-23 15:47:41,2010-02-23 15:47:41
799d462346417ebc17d211219fb1700e4940a1a0...7e6790bf3b37c98fe9bf4396bac7a09d31b1b1dd,2,11,4,15,7,2010-02-23 20:57:59,2010-02-23 20:57:59
44e826fbbff6f77d26e01ab3c78eec27e15b6652...18437f522451b259c5b7b3d1f4081e9abd5529cf,1,4,0,4,1,2010-02-23 18:22:17,2010-02-23 18:22:17
18437f522451b259c5b7b3d1f4081e9abd5529cf...0f88bb48d2e1dc476487042db1c5b47d0bd9e69c,1,1,1,2,1,2010-02-23 18:22:27,2010-02-23 18:22:27
295ae04c413b9d4692bda41d54115cffd922416d...952b9f03705e3cd605c1a9f0ae5e5565fc3b414a,1,4,4,8,4,2010-02-23 18:31:39,2010-02-23 18:31:39
952b9f03705e3cd605c1a9f0ae5e5565fc3b414a...3f1befcda1264f14498eea796dd39d57abd56d48,2,13,9,22,5,2010-02-23 20:49:22,2010-02-23 20:49:22
e10779d9b6b12a65b63ba08e12c80555dab4eca3...2d10a75568064e8c1aa0d02df6eda27def66da11,1,6,14,20,2,2010-02-23 17:21:16,2010-02-23 17:21:16
804a3917eefe93a1147839d706ba211ce45d8543...75d4cf06795068bf656d43fff866220b5e7402e4,1,1,1,2,1,2010-02-23 22:19:16,2010-02-23 22:19:16
804a3917eefe93a1147839d706ba211ce45d8543...211ae74188aff87306787df40a176e558aa92d37,1,5,4,9,1,2010-02-23 21:54:34,2010-02-23 21:54:34
59c8daaccb3cf09ad5d79faa202800afb086e137...881fd932ba0f0ea3e98133f17d4cf379367661b2,1,13,0,13,5,2010-02-23 18:54:01,2010-02-23 18:54:01
881fd932ba0f0ea3e98133f17d4cf379367661b2...1ee7d79eff773cbf1babf5dd0a010dee3e1b9b78,1,0,7,7,2,2010-02-23 19:02:26,2010-02-23 19:02:26
1ee7d79eff773cbf1babf5dd0a010dee3e1b9b78...9c8733f2072559c828d389052d3747e17788491d,1,4,1,5,2,2010-02-23 19:14:58,2010-02-23 19:14:58
2cb6d5fe8cd632ac0e0edec959767e2833fa92e9...9721b332282c3d6710097cece603400d5fe3c714,1,1,1,2,1,2010-02-23 20:55:48,2010-02-23 20:55:48
9721b332282c3d6710097cece603400d5fe3c714...cc74e804004d24a882b8c61baee7264b394813b3,3,120,42,162,19,2010-02-23 22:20:28,2010-02-23 22:20:28
cc74e804004d24a882b8c61baee7264b394813b3...ce1293782f29197053098fb90094eac2a7a93627,2,35,19,54,7,2010-02-23 22:41:05,2010-02-23 22:41:05
94b37bb60f0c7dac4b19b72ac39e274bb72d63b1...5098eaa288309a49f083ffe27f25041cc3f3e9e7,1,1,1,2,1,2010-02-23 22:46:50,2010-02-23 22:46:50
9c8733f2072559c828d389052d3747e17788491d...723a1490f7893771e3f056a2da036a5a9adcb78d,1,1,1,2,1,2010-02-23 20:21:09,2010-02-23 20:21:09
9c8733f2072559c828d389052d3747e17788491d...8584ce9c8de4699cc0b77ff616ab02487e243c40,2,14,0,14,3,2010-02-23 19:20:39,2010-02-23 19:20:15
8584ce9c8de4699cc0b77ff616ab02487e243c40...975a714cc76e72d1516f4bf1bf6da38ab4425548,2,5,1,6,3,2010-02-23 19:48:40,2010-02-23 19:48:40
5098eaa288309a49f083ffe27f25041cc3f3e9e7...392b9a82677590e3f7b661ef29fe328ac145bd4a,1,11,1,12,3,2010-02-24 03:01:07,2010-02-24 03:01:07
9cc83c175278f3fe281b3278aec1da23e021e66b...8d572b8fb8997b3071abb461780ed111cec30c6a,3,146,1,147,3,2010-02-23 20:37:30,2010-02-23 20:37:30
975a714cc76e72d1516f4bf1bf6da38ab4425548...22ed9e154c2d28cdcd84ae4966a0b886b3ae89fd,3,36,26,62,6,2010-02-23 20:45:12,2010-02-23 20:45:12
9ae652440fbf42057b0a7dde1fe4685e76a4c8de...2fcc53a5e4a71d6ba0c90a706bb64e05783290eb,1,5,0,5,2,2010-02-23 23:29:11,2010-02-23 23:28:56
2fcc53a5e4a71d6ba0c90a706bb64e05783290eb...57038c59781b737f9b1d89352f316e364f8840ca,3,17,5,22,9,2010-02-24 00:10:17,2010-02-24 00:10:17
a10f15bc2d92a184c1114d6b2bfc1cbe13663673...92e7cf1b2a3b3cee52c185ea2859493452c79de3,1,1,1,2,1,2010-02-24 03:38:09,2010-02-24 03:38:09
c4586990d02254fbd410fddf4d7966686e023293...14ad5c3e5f444cb58d00587124740d586aa0e074,1,1,1,2,1,2010-02-23 20:55:32,2010-02-23 20:55:32
57038c59781b737f9b1d89352f316e364f8840ca...439a43f876e40f357c2d263c3775a80e65e09cdf,1,1,0,1,1,2010-02-24 06:15:31,2010-02-24 06:15:31
57038c59781b737f9b1d89352f316e364f8840ca...46faa56d94c05062d3dacbd6156c83324e0de32b,1,4,1,5,1,2010-02-24 02:02:58,2010-02-24 01:59:59
46faa56d94c05062d3dacbd6156c83324e0de32b...365f9803afbb5b7bb8fa104f744ea6611994f14f,1,1,1,2,1,2010-02-24 02:21:24,2010-02-24 02:21:24
365f9803afbb5b7bb8fa104f744ea6611994f14f...78a9a1fab0853092152117ef92eed375cbc1c3e8,1,0,5,5,2,2010-02-24 02:35:40,2010-02-24 02:35:40
e828661d89f51d594faac4cee7f6573b964d9e33...c0e6f059435869604765b4059e6188c9e5b2a357,1,0,1,1,1,2010-02-24 06:49:50,2010-02-24 06:49:50
c0e6f059435869604765b4059e6188c9e5b2a357...e0b1d9f7638098f56e246dc2347e3cd7815f3346,1,13,3,16,4,2010-02-24 18:12:37,2010-02-24 18:12:37
e0b1d9f7638098f56e246dc2347e3cd7815f3346...5eb18472ae0066308bd91bf5ef694c9e6cfdce4e,2,24,0,24,4,2010-02-24 18:15:17,2010-02-24 18:15:17
5eb18472ae0066308bd91bf5ef694c9e6cfdce4e...ca22b2e3474dc4249329ea3a5892a75a0fbed14a,2,12,1,13,3,2010-02-24 18:57:16,2010-02-24 18:57:16
ca22b2e3474dc4249329ea3a5892a75a0fbed14a...f0ffbefee859bceeaa6973d7855f9f5be03a22d0,1,1,1,2,1,2010-02-24 22:01:42,2010-02-24 22:01:42
f0ffbefee859bceeaa6973d7855f9f5be03a22d0...d819733c321a84edecdae59a51e3f672e51f3007,1,2,1,3,1,2010-02-25 02:17:39,2010-02-25 02:17:39
d819733c321a84edecdae59a51e3f672e51f3007...0c822b5cceb4d52e71231782fa1bc057e8f4f3bd,3,14,7,21,7,2010-02-25 02:17:57,2010-02-25 02:17:57
0c822b5cceb4d52e71231782fa1bc057e8f4f3bd...fa4fd06df93c6bb115a694cbcf70d76eb6fa147a,1,14,0,14,1,2010-02-25 13:08:30,2010-02-25 13:08:30
0c822b5cceb4d52e71231782fa1bc057e8f4f3bd...e2a0be82337726d3d5480c5095bcea0042eeecc2,1,27,3,30,4,2010-02-25 03:29:36,2010-02-25 03:29:36
e2a0be82337726d3d5480c5095bcea0042eeecc2...a7da6490f4d0750fbadb591e18c2e9990234ed11,1,5,2,7,2,2010-02-25 03:50:26,2010-02-25 03:50:26
a7da6490f4d0750fbadb591e18c2e9990234ed11...e6e21350a952880285babe5357e1922e3570f325,1,2,2,4,1,2010-02-25 04:06:54,2010-02-25 04:06:54
e6e21350a952880285babe5357e1922e3570f325...46a4f1cca042f17ab72f9faae04fc567fd761170,7,49,6,55,12,2010-02-25 04:44:49,2010-02-25 04:44:49
b845f5e28eeebb5895e134472279bcee471f1b92...dd19daa8e8086eba8d18d120cf77fb5d6bb66e6a,2,3,3,6,3,2010-02-25 18:52:58,2010-02-25 18:52:58
b845f5e28eeebb5895e134472279bcee471f1b92...6d0bc9cc2f21277c893a56062cdd19fa5ca68139,3,22,1,23,3,2010-02-25 18:47:59,2010-02-25 18:47:59
0287bee615f613242634a7747e68ff05cc34305e...f4707226e452fb731786b6bc8d0b4fbfb44498d0,2,3,2,5,2,2010-02-25 19:16:30,2010-02-25 19:16:30
6d0bc9cc2f21277c893a56062cdd19fa5ca68139...1ace46483b6ca248e2d2a8facb0ab0b55e35846e,4,153,106,259,28,2010-02-25 19:13:50,2010-02-25 19:13:50
1ace46483b6ca248e2d2a8facb0ab0b55e35846e...e134217dd5fa4fb8e439bf16866cc6cdaf4315ef,1,1,3,4,1,2010-02-25 20:12:06,2010-02-25 20:12:06
f4707226e452fb731786b6bc8d0b4fbfb44498d0...c502a5cd7243f4419cbbeae120b40986ab6a9a2d,2,55,55,110,2,2010-02-25 22:28:19,2010-02-25 22:28:19
3d2b4f8ad4c3b4697501e32f864e790ca92c7ee4...f08ba724c3370a5a4f046ed9ab87c5cca11808b7,10,78,7,85,20,2010-02-25 21:24:34,2010-02-25 21:24:34
e966d1031d3a2d7d701509c3155d44a110a87580...12544983bc7810a9d04f9e5e42691d29f2e6b300,4,42,18,60,15,2010-02-26 07:06:37,2010-02-26 07:06:37
e966d1031d3a2d7d701509c3155d44a110a87580...e80771caad5386baf1a6f64e1fb5e0112e66f746,1,1,12,13,3,2010-02-26 03:19:18,2010-02-24 21:31:05
e80771caad5386baf1a6f64e1fb5e0112e66f746...621686366df16b482493034cdecc06dfec762991,2,20,0,20,3,2010-02-26 03:19:18,2010-02-25 21:16:31
621686366df16b482493034cdecc06dfec762991...5073a411035fb45ddc7ccc8a3e90a477d9710ecd,3,109,72,181,20,2010-02-26 03:19:18,2010-02-26 02:42:46
5073a411035fb45ddc7ccc8a3e90a477d9710ecd...22246ef94db3bce9407665d735faa8553f21dcc9,6,123,43,166,24,2010-02-26 04:34:01,2010-02-26 04:34:01
22246ef94db3bce9407665d735faa8553f21dcc9...329423dbc0c0041d265579f781c3bbd4f884ceff,3,22,11,33,8,2010-02-26 05:06:26,2010-02-26 05:06:26
478bad6685c1d3fe961d4ccb1712159ad3b11911...5d59f644691cee9998295472d8d85adf4fefd934,1,2,1,3,1,2010-02-26 07:30:59,2010-02-26 07:30:59
5d59f644691cee9998295472d8d85adf4fefd934...96d6221a9e1bfea31c0687bad8ef3530d73d4d84,2,25,15,40,14,2010-02-26 15:37:17,2010-02-26 15:37:17
96d6221a9e1bfea31c0687bad8ef3530d73d4d84...066b8376cf67fef649d2bb346fe130a6b886fb37,2,46,0,46,2,2010-02-26 16:33:20,2010-02-26 16:33:20
066b8376cf67fef649d2bb346fe130a6b886fb37...27e94db45caa61293da51898c3df72e538f18805,1,2,2,4,2,2010-02-26 16:33:27,2010-02-26 16:33:27
27e94db45caa61293da51898c3df72e538f18805...c3f07f3be05934d8dae18c83d6c1bad57eaff739,3,45,3,48,6,2010-02-26 17:07:46,2010-02-26 17:07:46
c3f07f3be05934d8dae18c83d6c1bad57eaff739...53ada277438e77fe14d9802928f1e094538ef623,1,25,1,26,3,2010-02-26 18:44:03,2010-02-26 18:44:03
53ada277438e77fe14d9802928f1e094538ef623...a347ce9b85e29bfda30ec22ec0e3f1c5fa08ed52,17,98,48,146,85,2010-02-26 19:38:51,2010-02-26 19:38:51
a347ce9b85e29bfda30ec22ec0e3f1c5fa08ed52...da23ec8f562fa04eb3c4c24055accc7c3d8576fe,4,10,10,20,9,2010-02-26 19:40:09,2010-02-26 19:40:09
da23ec8f562fa04eb3c4c24055accc7c3d8576fe...3e36fa8fd41d9a191fb3bc64105f1380da894a4b,1,1,0,1,1,2010-02-26 19:42:11,2010-02-26 19:42:11
3e36fa8fd41d9a191fb3bc64105f1380da894a4b...ca075ce816d7c802377cc400196d64fc3842f9dd,1,1,1,2,1,2010-02-26 20:10:04,2010-02-26 20:10:04
ca075ce816d7c802377cc400196d64fc3842f9dd...5bc4788ff461d30a0826a5c294e88b9afa2483c5,1,1,1,2,1,2010-02-27 03:40:50,2010-02-27 00:51:38
5bc4788ff461d30a0826a5c294e88b9afa2483c5...56bbdda127c86cc68fc08bf2f4f43fcad4369d02,2,8,7,15,3,2010-02-27 03:40:50,2010-02-27 02:19:14
56bbdda127c86cc68fc08bf2f4f43fcad4369d02...11c49cb19526c02fb7411ea0efa2d608879feed1,4,39,3,42,9,2010-02-27 03:40:50,2010-02-27 03:39:55
11c49cb19526c02fb7411ea0efa2d608879feed1...dd1920617207d2742ca2ae81da1b926bb5765484,8,52,24,76,30,2010-02-27 16:16:26,2010-02-27 16:16:26
dd1920617207d2742ca2ae81da1b926bb5765484...05d67e6ac40682cd3d0548aa39735ee97c9bd74d,1,4,3,7,4,2010-02-27 16:27:37,2010-02-27 16:27:37
05d67e6ac40682cd3d0548aa39735ee97c9bd74d...11b9ab758c70f635157c95186bcf027758caafa9,2,13,9,22,9,2010-02-27 17:11:41,2010-02-27 17:11:41
11b9ab758c70f635157c95186bcf027758caafa9...c7bc4b3d96e881b1e5545ebdc3a9d93988e1c4fb,1,5,0,5,1,2010-02-27 17:14:12,2010-02-27 17:14:12
c7bc4b3d96e881b1e5545ebdc3a9d93988e1c4fb...ee8f28dcfdf8518c23101a98fad9a5afecdcb8ef,2,64,0,64,2,2010-02-27 21:42:00,2010-02-27 21:42:00
ee8f28dcfdf8518c23101a98fad9a5afecdcb8ef...6ac50f8e9eca08843c68f95c86ad070483cbd6db,2,39,1,40,3,2010-02-28 02:53:28,2010-02-28 02:53:28
6ac50f8e9eca08843c68f95c86ad070483cbd6db...b32a47826e349b4cda491def8267f7daa3b80721,3,100,27,127,13,2010-02-28 03:05:59,2010-02-28 03:05:59
b32a47826e349b4cda491def8267f7daa3b80721...00ca5d90fe11b3e3fa6c3651542113736adddcf1,1,3,1,4,2,2010-02-28 04:05:40,2010-02-28 04:05:40
00ca5d90fe11b3e3fa6c3651542113736adddcf1...30dcf4bf83f0da5f4e2d3b63d9f0ab537ec38ee7,3,22,13,35,13,2010-02-28 05:51:39,2010-02-28 05:51:39
30dcf4bf83f0da5f4e2d3b63d9f0ab537ec38ee7...b2705cfd32d531c8efad692963ed7fc75990630a,2,13,1,14,4,2010-02-28 17:35:18,2010-02-28 17:35:18
b2705cfd32d531c8efad692963ed7fc75990630a...64e0803877b3da98c0d293b6989946ebce5568c3,1,190,186,376,46,2010-02-28 17:36:40,2010-02-28 17:36:40
64e0803877b3da98c0d293b6989946ebce5568c3...4ff5b76bafc37b5cccbd105a6a920111f9d3fe38,1,1,1,2,1,2010-03-06 17:12:32,2010-03-06 17:12:32
64e0803877b3da98c0d293b6989946ebce5568c3...0e10fb37681679f7429dc5243e7d75263c905b9f,2,32,14,46,10,2010-02-28 18:51:34,2010-02-28 18:51:34
0e10fb37681679f7429dc5243e7d75263c905b9f...63b5f7e470fc2d63603bd7b49f8057052f4826e6,1,1159,1652,2811,145,2010-02-28 18:52:33,2010-02-28 18:52:33
63b5f7e470fc2d63603bd7b49f8057052f4826e6...c85b784793b46c07c663223dd769de35d302185a,2,23,1,24,3,2010-03-01 01:40:36,2010-03-01 01:40:36
c85b784793b46c07c663223dd769de35d302185a...8d3801a3b721de909968335aef85a2b5ef59983a,1,1,1,2,1,2010-03-01 02:10:38,2010-03-01 02:10:38
8d3801a3b721de909968335aef85a2b5ef59983a...e75dd195493e386d194c1c093f5df169a0322a16,4,52,11,63,12,2010-03-01 03:11:13,2010-03-01 03:11:13
e75dd195493e386d194c1c093f5df169a0322a16...0c9f3912125e2fe47e8d5f929f94e1322fd61804,2,7,6,13,4,2010-03-01 03:15:57,2010-03-01 03:15:57
0c9f3912125e2fe47e8d5f929f94e1322fd61804...346a47331c29075e525096e5b4c27a1d822fe8f7,2,15,0,15,2,2010-03-01 03:19:04,2010-03-01 03:19:04
346a47331c29075e525096e5b4c27a1d822fe8f7...4ada6f436d7794078f3fe22e6af7fb8d0e0695a4,1,3,2,5,2,2010-03-01 03:23:11,2010-03-01 03:23:11
4ada6f436d7794078f3fe22e6af7fb8d0e0695a4...2ea2c01ba5455bfc3f494a673adb8f29b1f41208,1,1,1,2,1,2010-03-01 15:24:28,2010-03-01 15:24:28
2ea2c01ba5455bfc3f494a673adb8f29b1f41208...165b9c3ea5f0626bda36edb4f44aeeb9f3412e74,1,1,1,2,1,2010-03-01 15:27:19,2010-03-01 15:27:19
4ada6f436d7794078f3fe22e6af7fb8d0e0695a4...6f2446713f97fba13e0846249f55bfd4d6cc37e8,1,1,1,2,1,2010-03-01 15:10:45,2010-03-01 15:10:45
aad72885f7475d36d204cb1b32b7fd8e26c79755...09054bb579bd5afe413238feec437233dc73935e,1,1,1,2,1,2010-03-07 04:03:16,2010-03-07 04:03:16
09054bb579bd5afe413238feec437233dc73935e...7f75c1b5f713121575d1d7e32f155a10239117ca,1,1,1,2,1,2010-03-07 19:05:12,2010-03-07 19:05:12
c3ae414ff8a29579c74190c8b7939833487e5d0b...45d3cfbfcf6176d70f7ea4be7b136eb1213f0c4a,1,8,4,12,4,2010-03-01 15:33:52,2010-03-01 15:33:52
7f75c1b5f713121575d1d7e32f155a10239117ca...bc5ea71d55a27bb30bee09c281ee7eceec9415bb,1,17,0,17,1,2010-03-08 01:55:14,2010-03-08 01:55:14
7f75c1b5f713121575d1d7e32f155a10239117ca...dbe03734ce6f54dcc86f73a9c26414c6f159f8e1,1,0,2,2,2,2010-03-08 00:51:04,2010-03-08 00:51:04
45d3cfbfcf6176d70f7ea4be7b136eb1213f0c4a...25e157a20488044e09ac95b560d016b2e045a51b,1,7,2,9,2,2010-03-01 21:18:46,2010-03-01 21:18:46
45d3cfbfcf6176d70f7ea4be7b136eb1213f0c4a...ca2a6d8db0e5396b8f720161fb2438a7725a3def,6,21,12,33,8,2010-03-01 18:30:10,2010-03-01 18:30:10
45d3cfbfcf6176d70f7ea4be7b136eb1213f0c4a...218036b2a46b8bed6f46145c3b10c176f47a2b8f,3,48,2,50,7,2010-03-01 18:07:01,2010-03-01 18:07:01
218036b2a46b8bed6f46145c3b10c176f47a2b8f...bdeca98185ef9b47af20f3fb8e557546f9466d44,5,130,57,187,24,2010-03-01 21:55:31,2010-03-01 21:55:31
45d3cfbfcf6176d70f7ea4be7b136eb1213f0c4a...89f3e6d65b0d0daa5e70a9dc97a60297ed167678,2,36,8,44,4,2010-03-01 17:26:35,2010-03-01 17:26:35
89f3e6d65b0d0daa5e70a9dc97a60297ed167678...ee47bb3c123e9dabf755857036b728a9dcf58561,4,62,26,88,15,2010-03-01 18:36:40,2010-03-01 18:36:40
6cd9f294f3bd1e5ee9c048e01510b6bfe8b3313f...c276f6001b820e81b069b3281dc7282d0255530c,2,16,12,28,9,2010-03-08 02:42:58,2010-03-08 02:42:58
e33b79fb107455ca2c6d534610a7d0c0f41a13e7...119b5afae8a3908f523ef4a2dbb5f0ff7ef8feff,4,312,101,413,63,2010-03-01 21:50:03,2010-03-01 21:50:03
a0d53654fbbee64e56d7a83151abd7ff49a7cea8...3112a2d0ec8335fea70bf4853c48ccd0b3e162c4,1,1,1,2,1,2010-03-01 18:45:54,2010-03-01 18:45:54
3112a2d0ec8335fea70bf4853c48ccd0b3e162c4...05de70c790644e51a5590725cd143124089b5eab,2,5,5,10,5,2010-03-01 19:04:09,2010-03-01 19:03:29
0de2e2e29f7859c1c480e51471f6bfd28f97b08e...ee3e5923e55f419a8d0fc144cc6251d432421563,1,2,2,4,2,2010-03-01 22:34:03,2010-03-01 22:34:03
c276f6001b820e81b069b3281dc7282d0255530c...a0e7513df399603c420fbc3c329c76932ed935a3,1,2,0,2,1,2010-03-08 17:49:10,2010-03-08 17:49:10
c276f6001b820e81b069b3281dc7282d0255530c...dc035fb72355863ff61dabd09c6e66eb1c1c844b,1,6,7,13,2,2010-03-08 15:57:45,2010-03-08 15:57:45
119b5afae8a3908f523ef4a2dbb5f0ff7ef8feff...dc29dbbb7c9c9497c928a8b3dc1d8f3b6847f756,7,71,26,97,14,2010-03-01 22:14:23,2010-03-01 22:14:23
119b5afae8a3908f523ef4a2dbb5f0ff7ef8feff...4dd943379bd40b46d85a7dcd20978cc9de9afa11,1,2,5,7,2,2010-03-01 22:10:06,2010-03-01 22:10:06
892d8b4a9587c24bbf15e496c687602644cdc5ba...bccf8f4113a8864514832306448e67b271b93253,4,68,25,93,22,2010-03-01 23:04:01,2010-03-01 23:04:01
bccf8f4113a8864514832306448e67b271b93253...584310b50c09860747823c16ffe6f3507ae0c1ae,1,10,0,10,1,2010-03-01 23:04:21,2010-03-01 23:04:21
fd3e9557acb9d3506c598f018930d9c73cd3cc7a...78781d20d26716fabff4f6f6477205d93e6472e8,1,1,1,2,1,2010-03-01 22:52:51,2010-03-01 22:52:51
91f1d9db3f8213c9483e396ed0c1df4370c618e5...91f3fcf6dfaea756032960aee0bbc27bc21b6236,3,14,7,21,10,2010-03-09 04:33:10,2010-03-09 04:33:10
91f3fcf6dfaea756032960aee0bbc27bc21b6236...406ed2dc3f09608a319c1cb2c68fdc673e9727fd,2,27,1,28,4,2010-03-09 04:52:12,2010-03-09 04:52:12
dc035fb72355863ff61dabd09c6e66eb1c1c844b...775a9ddf19836401c367b71e18106a5edee28309,1,30,0,30,2,2010-03-08 20:54:16,2010-03-08 20:54:16
775a9ddf19836401c367b71e18106a5edee28309...402995517928df09672ffa3ba7524d32ef809f61,2,11,8,19,10,2010-03-08 20:54:39,2010-03-08 20:54:39
402995517928df09672ffa3ba7524d32ef809f61...cfe99b636336dbe855e54d31f8738caa3ee76b9b,7,38,6,44,15,2010-03-08 20:55:18,2010-03-08 20:55:18
cfe99b636336dbe855e54d31f8738caa3ee76b9b...df00eaacf5749f6a78d581ecd4c6e3b4b0940d5c,3,5,5,10,4,2010-03-08 21:05:40,2010-03-08 21:05:40
dc035fb72355863ff61dabd09c6e66eb1c1c844b...fed38a980581ce4586776c861697656e2bf0ec20,1,8,2,10,4,2010-03-08 18:40:24,2010-03-08 18:40:24
fed38a980581ce4586776c861697656e2bf0ec20...d22498af7ace74d0a0228cbedd54180203898b14,1,8,2,10,1,2010-03-08 18:56:55,2010-03-08 18:56:55
d3f132a13e6c993ed9a0e835b17682b7a5f0d4e4...59eb3a8b0c0699b24d52c98fe895abf659866334,1,2,2,4,1,2010-03-01 22:19:05,2010-03-01 22:19:05
262374df1d435dc730f0957b81d76ed75a2c7bab...6a95b558e12a9a13f3ca9dcdd6590d9d30f7990d,2,47,10,57,7,2010-03-02 07:58:24,2010-03-02 07:58:24
6a95b558e12a9a13f3ca9dcdd6590d9d30f7990d...df8fb47a4c70a99ae34b4a58a79490781b1bde23,1,1,1,2,1,2010-03-02 18:20:10,2010-03-02 18:20:10
df8fb47a4c70a99ae34b4a58a79490781b1bde23...bbbe0aaf31d4b0a536768a58245a07d42c8eb190,6,105,7,112,10,2010-03-02 20:29:54,2010-03-02 20:29:54
bbbe0aaf31d4b0a536768a58245a07d42c8eb190...246109cc18b72e39e92bc1c4e4a9a28e70379cb9,5,31,14,45,9,2010-03-02 21:16:20,2010-03-02 21:16:20
246109cc18b72e39e92bc1c4e4a9a28e70379cb9...6546599f73b490d8f8ad4bb54a27ac99e809e5fb,1,6,1,7,1,2010-03-03 06:42:44,2010-03-03 06:42:44
75457332d53bc26e2ee7059c28a7bd50d83275cf...dc54b5b6e058ec82ec6e0777ba6f90e3631ceebe,1,1,1,2,1,2010-03-01 22:55:44,2010-03-01 22:55:44
dc54b5b6e058ec82ec6e0777ba6f90e3631ceebe...a72123ced13783728a9c8fbc4bafe3992f8b40d6,2,21,26,47,5,2010-03-02 00:53:43,2010-03-01 22:57:27
a72123ced13783728a9c8fbc4bafe3992f8b40d6...15a53a9af53cb045677862fe0acd40dda2f88cde,4,35,0,35,5,2010-03-02 00:53:43,2010-03-01 22:59:20
15a53a9af53cb045677862fe0acd40dda2f88cde...bd2991edf2b80f22afe93db2d4cd7ec8493760d0,2,5,17,22,6,2010-03-02 00:53:43,2010-03-02 00:53:22
bd2991edf2b80f22afe93db2d4cd7ec8493760d0...55df6a9a233806f3823d5fa527704a6c63e2d135,1,8,1,9,2,2010-03-02 01:24:08,2010-03-02 01:24:08
55df6a9a233806f3823d5fa527704a6c63e2d135...fe4b68b1ea900c20bf0acc319e9e6115d32f9aa5,1,13,4,17,4,2010-03-02 01:24:50,2010-03-02 01:24:50
fe4b68b1ea900c20bf0acc319e9e6115d32f9aa5...863ccc38bf375627ceb16969d406e866be8efae0,1,1,0,1,1,2010-03-02 01:40:22,2010-03-02 01:40:22
863ccc38bf375627ceb16969d406e866be8efae0...f26a2d1bc3e50bf768d8882871fdd7ff09379eac,1,2,0,2,2,2010-03-02 02:02:58,2010-03-02 02:02:22
f26a2d1bc3e50bf768d8882871fdd7ff09379eac...c1f0d3f3620f5297010795eb3a66c2f00e9d046f,5,64,18,82,11,2010-03-02 02:36:56,2010-03-02 02:36:56
c1f0d3f3620f5297010795eb3a66c2f00e9d046f...581980efa09ec2c6a516257c0a5ce4241e89e129,1,1,1,2,1,2010-03-02 02:41:31,2010-03-02 02:41:31
581980efa09ec2c6a516257c0a5ce4241e89e129...0a8e1f91c83bce14480e9cda00a1f630a5c64e93,6,64,12,76,11,2010-03-02 03:06:30,2010-03-02 03:06:30
0a8e1f91c83bce14480e9cda00a1f630a5c64e93...18b5ef501336e51cfb7a22b1c2a7059c314b29ad,1,2,2,4,1,2010-03-02 03:38:09,2010-03-02 03:38:09
406ed2dc3f09608a319c1cb2c68fdc673e9727fd...329ee5a37f397d871e81829ab81b2ef804ecf2a0,1,5,0,5,1,2010-03-09 18:42:04,2010-03-09 18:42:04
406ed2dc3f09608a319c1cb2c68fdc673e9727fd...6820535ea7661e9e7cd49ef7e1edcbc050f0f1bf,1,5,7,12,1,2010-03-09 18:36:10,2010-03-09 18:36:10
53235fdc3667ebd7785788749ca3ec564d6486c6...6d095cf3574b7791155b22c5c9f4f13c464df9c8,7,165,55,220,22,2010-03-09 00:53:45,2010-03-09 00:53:45
53235fdc3667ebd7785788749ca3ec564d6486c6...ddc9397431f5ece23bfe670752894aa0aae10885,2,10,13,23,8,2010-03-08 21:39:23,2010-03-08 21:35:10
ddc9397431f5ece23bfe670752894aa0aae10885...434a2e4b72b6dae16d90fc990a047da4ef39a477,1,5,3,8,4,2010-03-08 21:39:23,2010-03-08 21:36:44
d22498af7ace74d0a0228cbedd54180203898b14...5ddd713d438d0334e9f7fd852ff68b02f2c21996,3,47,21,68,10,2010-03-08 20:03:00,2010-03-08 20:03:00
d22498af7ace74d0a0228cbedd54180203898b14...09f3ed3808adf50dde49338317d715b5a503830d,2,9,2,11,2,2010-03-08 19:32:44,2010-03-08 19:32:44
09b1285b950febdfe3da45499dc3d542cb8a4a0e...4461c46f3f34a8a5c4d24cfb0485e09014135af5,3,28,7,35,9,2010-03-03 07:09:34,2010-03-03 07:09:34
4461c46f3f34a8a5c4d24cfb0485e09014135af5...e9c6ec66ff8903d16fb026a1ce5f1796b07e285b,1,1,1,2,1,2010-03-03 07:23:38,2010-03-03 07:23:38
e9c6ec66ff8903d16fb026a1ce5f1796b07e285b...2691d5bde9a9f5b784a0223d3b262edc4e9af5cc,1,1,1,2,1,2010-03-03 08:03:55,2010-03-03 08:03:55
2691d5bde9a9f5b784a0223d3b262edc4e9af5cc...95b9d930fb32a4bbac7ba48cb5723c38d9723091,11,40,26,66,15,2010-03-03 09:46:31,2010-03-03 09:46:31
95b9d930fb32a4bbac7ba48cb5723c38d9723091...c8c070f781cc79da83a9d87ea92155af6da5783d,1,2,0,2,1,2010-03-03 15:28:20,2010-03-03 15:28:20
c8c070f781cc79da83a9d87ea92155af6da5783d...ba903dcd09d94b6283ee661a6a4a6c351a91b7c5,3,24,10,34,7,2010-03-03 20:18:09,2010-03-03 20:18:09
18b5ef501336e51cfb7a22b1c2a7059c314b29ad...4308f8e6117cc839c553709aafb1122e6ef30190,1,1,1,2,1,2010-03-02 05:00:01,2010-03-02 05:00:01
18b5ef501336e51cfb7a22b1c2a7059c314b29ad...677c053850393f8ee670e4bf68cce41f49305cde,2,5,5,10,5,2010-03-02 04:16:36,2010-03-02 04:16:36
82859271336f9d618b26c477142f30aabbfca8ef...971e7e845c6513cdbfcf1fee0e4982f9976f9e1f,3,8,8,16,6,2010-03-09 19:31:40,2010-03-09 19:31:40
6820535ea7661e9e7cd49ef7e1edcbc050f0f1bf...67c299cf51310545c3f61d0ecd3e4c0cdfbdaa32,4,39,11,50,14,2010-03-09 19:53:40,2010-03-09 19:53:40
f4170e6a86b9ee075a729f3239e33944084574d7...916468b7e7305f4cd16f46d678fb8e1b4984c449,3,44,6,50,7,2010-03-09 01:33:47,2010-03-09 01:33:47
916468b7e7305f4cd16f46d678fb8e1b4984c449...6c7dc2b0f8831fac6621f125889d873241588b02,2,24,9,33,2,2010-03-09 02:16:53,2010-03-09 02:16:53
6c7dc2b0f8831fac6621f125889d873241588b02...c85601f4e2581eef528b2e187b5c85cb1e0072e2,1,49,0,49,1,2010-03-09 02:17:32,2010-03-09 02:17:32
c85601f4e2581eef528b2e187b5c85cb1e0072e2...2133974f5fe37fe871a4e597233aa32a28761b19,1,24,1,25,2,2010-03-09 03:32:35,2010-03-09 03:32:35
2133974f5fe37fe871a4e597233aa32a28761b19...29933435e6e4ab36999375b06deb45cd38aa7782,1,3,3,6,3,2010-03-09 03:51:05,2010-03-09 03:51:05
29933435e6e4ab36999375b06deb45cd38aa7782...0065a65eaf8eb7c2e2f7a56a0233a05973e175a5,1,3,3,6,3,2010-03-09 03:57:06,2010-03-09 03:57:06
ba903dcd09d94b6283ee661a6a4a6c351a91b7c5...b0b9635b61fb136c5a11a2dd0282092aac1256e3,1,1,1,2,1,2010-03-04 20:26:56,2010-03-04 20:26:56
ba903dcd09d94b6283ee661a6a4a6c351a91b7c5...a3f64b719d67221c3eb1ea23239f3fa8ca96f1a3,3,11,0,11,3,2010-03-03 22:14:00,2010-03-03 22:14:00
a3f64b719d67221c3eb1ea23239f3fa8ca96f1a3...982ca5d436283e809578deb80c065e9a2f221efc,3,5,7,12,3,2010-03-03 22:19:56,2010-03-03 22:19:56
982ca5d436283e809578deb80c065e9a2f221efc...0a823625819116f9e79f580a93b68288eb9cc0e4,1,3,4,7,2,2010-03-03 22:23:37,2010-03-03 22:23:37
0a823625819116f9e79f580a93b68288eb9cc0e4...4f9ae7b88b2add9201059e3e6038ec3268b5cfe5,1,2,2,4,1,2010-03-03 22:43:55,2010-03-03 22:43:35
4f9ae7b88b2add9201059e3e6038ec3268b5cfe5...e259b94f552c0e5e8325424dfc9eed5ea8ddb83a,1,6,10,16,7,2010-03-04 01:20:00,2010-03-04 01:20:00
9959628dd561c7c181469cb193a286481e478aad...a195c56c3ca46b4b31a86a5a0e2880adeecdfb91,1,22,0,22,1,2010-03-02 15:10:00,2010-03-02 15:10:00
a195c56c3ca46b4b31a86a5a0e2880adeecdfb91...853524dc41aa926f4fd1504e6c46186769f51771,4,9,3,12,4,2010-03-02 15:37:07,2010-03-02 15:37:07
853524dc41aa926f4fd1504e6c46186769f51771...246d6655b4c794841029a0d86f75c9c924d74015,1,1,1,2,1,2010-03-02 17:44:56,2010-03-02 17:44:56
246d6655b4c794841029a0d86f75c9c924d74015...e03392121bad4f016c6cf0a0bff50172f59e8917,1,1,4,5,1,2010-03-02 20:32:42,2010-03-02 20:32:42
e03392121bad4f016c6cf0a0bff50172f59e8917...00684b8c1bd0bd3f0892045bb149cf2ea6b5774c,2,13,2,15,4,2010-03-03 00:21:51,2010-03-03 00:21:51
00684b8c1bd0bd3f0892045bb149cf2ea6b5774c...b3f2b01d678b9c9819737877327ba42bdd0859b4,1,3,2,5,2,2010-03-03 00:23:14,2010-03-03 00:23:14
b3f2b01d678b9c9819737877327ba42bdd0859b4...2bdb76cf6f0652e90ef35c23de35225c3e0b0ef8,4,23,4,27,10,2010-03-03 00:53:07,2010-03-03 00:53:07
2bdb76cf6f0652e90ef35c23de35225c3e0b0ef8...49edf4a645cc2c4df7840ca1cbe7f23b8d6848bf,2,14,2,16,3,2010-03-03 01:35:13,2010-03-03 01:35:13
49edf4a645cc2c4df7840ca1cbe7f23b8d6848bf...86b88644407bc94cf4358434d221703d234d75c7,1,2,1,3,1,2010-03-03 01:58:31,2010-03-03 01:58:31
971e7e845c6513cdbfcf1fee0e4982f9976f9e1f...493c6bd7268cd78a64fd10abd589efb605a4d77a,1,0,0,0,0,2010-03-10 02:20:45,2010-03-10 02:20:45
48f68d1f2eb22504c5fc69093c377c47cc4af176...57d2a1d901d7bbd2bb433ff17ba3d1ea819350ea,4,157,133,290,17,2010-03-09 21:54:19,2010-03-09 21:54:19
48f68d1f2eb22504c5fc69093c377c47cc4af176...f99e4c1257e0d1db3d5f5d2fed7267708dd2ef22,1,6,1,7,1,2010-03-09 20:19:37,2010-03-09 20:19:37
f99e4c1257e0d1db3d5f5d2fed7267708dd2ef22...08b0a8a0a3cf3906bbe8d72de1237808680bb1f8,1,1,1,2,1,2010-03-09 20:21:47,2010-03-09 20:21:47
08b0a8a0a3cf3906bbe8d72de1237808680bb1f8...631f3f59ac2ba3809cf034cddba2dee9868b4afa,1,515,439,954,57,2010-03-09 20:26:29,2010-03-01 14:44:36
631f3f59ac2ba3809cf034cddba2dee9868b4afa...c8fb728d2b13314aa3c58188613a233d614f5944,1,14,2,16,3,2010-03-09 20:26:29,2010-03-01 20:19:35
c8fb728d2b13314aa3c58188613a233d614f5944...fd9f37f5b4aaef9276c7a53b3d54f0fb3f89e561,1,35,19,54,9,2010-03-09 20:26:30,2010-03-03 15:15:11
fd9f37f5b4aaef9276c7a53b3d54f0fb3f89e561...06f5b6c13c237e711de6d6ef7dbb61f7d6f6ed85,1,8,5,13,3,2010-03-09 20:27:12,2010-03-08 14:27:43
06f5b6c13c237e711de6d6ef7dbb61f7d6f6ed85...e6b54b81f711b23ade936e9a7964e2dbbcc7c7fa,1,1,7,8,1,2010-03-09 20:30:37,2010-03-09 20:30:37
e6b54b81f711b23ade936e9a7964e2dbbcc7c7fa...a31ec892fe1f4c84fb0e445519bf3725004c35ae,1,17,0,17,1,2010-03-09 20:36:54,2010-03-09 20:36:54
e259b94f552c0e5e8325424dfc9eed5ea8ddb83a...5dbac3d28f5e3f76108498882b4d2a99267b10a9,3,11,1,12,5,2010-03-04 03:37:41,2010-03-04 03:37:41
e259b94f552c0e5e8325424dfc9eed5ea8ddb83a...59de6c4b382b7a9ab3b0756383def13866ec4612,2,40,20,60,6,2010-03-04 02:49:50,2010-03-04 02:39:14
59de6c4b382b7a9ab3b0756383def13866ec4612...6c05aebf19b0634d34b2bcabb88c9a89833f5ebc,3,22,2,24,5,2010-03-04 03:06:03,2010-03-04 03:06:03
93c286d0d3ea2fd25a6d4e9be30cb90fe12d2f82...bca88a8001e471b85af0787a39300d3ae2fa29f8,3,7,7,14,7,2010-03-10 02:24:36,2010-03-10 02:24:36
bca88a8001e471b85af0787a39300d3ae2fa29f8...9172d692cd57624902443e93c3b571734b97d23a,1,0,1,1,1,2010-03-10 02:25:33,2010-03-10 02:25:33
9172d692cd57624902443e93c3b571734b97d23a...ae02e6101528a5f748da95ce6abbed5c6499bcaf,1,17,2,19,2,2010-03-10 02:49:12,2010-03-10 02:46:47
ae02e6101528a5f748da95ce6abbed5c6499bcaf...67070a195694185cc7bd50d4a18b0e88747315f9,1,1,1,2,1,2010-03-10 02:49:12,2010-03-10 02:47:54
2c1c71b311570fedcfcfacd885032834bbb429ef...94479c550fcbce7ae2d9b3275d6d368bad98fba8,3,42,6,48,15,2010-03-10 00:19:51,2010-03-10 00:19:51
2c1c71b311570fedcfcfacd885032834bbb429ef...6929e828e5010af2fd132a46e05c15f3f519dc49,1,1,0,1,1,2010-03-09 22:40:21,2010-03-09 22:39:27
7969923944bcc61e53782f7f570bc35a4982f3b5...6fb243a6147a644ea2380e7d488dde046f8df99c,1,18,10,28,8,2010-03-05 18:50:46,2010-03-05 18:50:46
7969923944bcc61e53782f7f570bc35a4982f3b5...8ec2fbf7eae13ca449af7381a6e03beba9a42a8b,1,30,1,31,5,2010-03-05 18:07:29,2010-03-05 18:07:29
8ec2fbf7eae13ca449af7381a6e03beba9a42a8b...deab7505e69e8fcaca875a04bfd5c7151b2749bc,1,5,3,8,3,2010-03-05 18:35:15,2010-03-05 18:35:15
be389e7cde4009963b4cb8d5bbf9e792a2f3987b...fdb5d475f74f03d83d7f941416f8a3b17eb547c0,1,4,0,4,1,2010-03-05 04:14:03,2010-03-05 04:14:03
fdb5d475f74f03d83d7f941416f8a3b17eb547c0...b9f32586ed8016ae7c2127d5542c94c5a2c4c86e,1,29,25,54,1,2010-03-05 04:14:59,2010-03-05 04:14:59
65fa7f9e1618fcaabda925372a649180674afece...d9b3fbe120d49dd905055fefed4db98122172ca3,1,4,0,4,2,2010-03-10 08:18:42,2010-03-10 08:18:42
d9b3fbe120d49dd905055fefed4db98122172ca3...26b6ffe30a81e80cafd427ca0c78e072ff918f23,1,0,4,4,2,2010-03-10 08:39:12,2010-03-10 08:39:12
26b6ffe30a81e80cafd427ca0c78e072ff918f23...eb7cde3e751b02eae055a922af8985fe52c807fa,50,153,204,357,154,2010-03-10 08:39:26,2010-03-10 08:39:26
eb7cde3e751b02eae055a922af8985fe52c807fa...141a94b37a51945bb80e439fcb5faaa786fecbee,1,1,0,1,1,2010-03-10 19:13:18,2010-03-10 19:13:18
141a94b37a51945bb80e439fcb5faaa786fecbee...64cf3e2b14f6fbd86e0a158c86fef15eb2c68066,1,6,1,7,1,2010-03-11 03:17:52,2010-03-11 03:17:52
64cf3e2b14f6fbd86e0a158c86fef15eb2c68066...461ccefb2baf3f6400309f1f96d49d41b0533a7d,2,8,2,10,2,2010-03-11 03:18:11,2010-03-11 03:18:11
461ccefb2baf3f6400309f1f96d49d41b0533a7d...6ecf847f803d5f69e22f5b36121d6a4d18eb5b02,6,21,9,30,9,2010-03-11 03:31:10,2010-03-11 03:31:10
6ecf847f803d5f69e22f5b36121d6a4d18eb5b02...5986ec8a4215d4c972b97941c163c723227d4069,1,2,0,2,1,2010-03-11 03:44:51,2010-03-11 03:44:51
5986ec8a4215d4c972b97941c163c723227d4069...9add6f1d80f68e5b667bd713487e55f3f28f0df2,2,116,0,116,2,2010-03-11 13:57:00,2010-03-11 13:57:00
9add6f1d80f68e5b667bd713487e55f3f28f0df2...f20775afda28714a9235693198e75d522be79b44,1,1,0,1,1,2010-03-11 16:20:10,2010-03-11 16:20:10
f20775afda28714a9235693198e75d522be79b44...43ab678aa0a8127b04d1bee5bdaed92852761e4d,5,64,4,68,12,2010-03-11 16:20:20,2010-03-11 16:20:20
43ab678aa0a8127b04d1bee5bdaed92852761e4d...4557de537618ef1c6aa9275384c7f9ed80e49e85,1,1,1,2,1,2010-03-11 16:40:27,2010-03-11 16:40:27
a91331c1e3548c8dff9d1f9f6ce9a785edd149a3...b2eb0c8d88ac5621fff03d4f0adf7d33008ebbc6,1,1,1,2,1,2010-03-18 19:48:53,2010-03-18 19:48:53
b2eb0c8d88ac5621fff03d4f0adf7d33008ebbc6...91da5d30e06e1e8f67e9aebb2e6e0037edfdf201,1,6,0,6,3,2010-03-18 20:12:35,2010-03-18 20:12:35
a91331c1e3548c8dff9d1f9f6ce9a785edd149a3...c4b55b2957e0ac13b918212fff72656c448532f9,3,19,11,30,6,2010-03-10 01:03:01,2010-03-10 01:03:01
5c6df740af1f13510763e713ce13f7ccf3750f9b...73ec2d62ade533ffe3784a06d1b6bc42983c70e8,1,2,2,4,2,2010-03-05 19:11:00,2010-03-05 19:11:00
deab7505e69e8fcaca875a04bfd5c7151b2749bc...550f84a6cf04cb3c89e4320a340d1704486fdc43,2,2,2,4,2,2010-03-05 18:43:21,2010-03-05 18:43:21
4557de537618ef1c6aa9275384c7f9ed80e49e85...77c164408b4a365b7a00d9515f2eb24a221b70ec,2,39,33,72,5,2010-03-11 17:24:05,2010-03-11 17:24:05
4557de537618ef1c6aa9275384c7f9ed80e49e85...62df0bde11177004912a89a9970e28399bd8ece6,1,1,1,2,1,2010-03-11 16:43:48,2010-03-11 16:43:48
62df0bde11177004912a89a9970e28399bd8ece6...0ecf45bf848fa3c38ec99a45de2f52d0615cf80d,1,15,2,17,2,2010-03-11 16:55:10,2010-03-11 16:55:10
c4b55b2957e0ac13b918212fff72656c448532f9...714ec2fdc8e9c8dc1c2cdf5486afdbc185beef14,50,204,153,357,154,2010-03-10 07:59:10,2010-03-10 07:59:10
73ec2d62ade533ffe3784a06d1b6bc42983c70e8...02d6682a839602371e3cf1f9e91da03946fbe996,2,4,31,35,4,2010-03-06 21:55:26,2010-03-06 21:55:26
02d6682a839602371e3cf1f9e91da03946fbe996...da4507b7c6fb088f55a368d404e15ce349ada692,3,26,2,28,6,2010-03-06 22:53:50,2010-03-06 22:53:50
da4507b7c6fb088f55a368d404e15ce349ada692...d3da0d7bbc6ace93df2eecdc3d5862b8e5cac154,5,117,39,156,44,2010-03-07 03:12:58,2010-03-07 03:12:58
0a089d3a8c2d88a52f95d58aafa0b4e631d171bc...74e22e9d7377e1a275066a6f561f5955b0a80d18,1,12,1,13,1,2010-03-12 15:28:07,2010-03-12 15:28:07
74e22e9d7377e1a275066a6f561f5955b0a80d18...44057b4e1c66c729a3658e480e316c74a6f8b1e3,1,1,0,1,1,2010-03-12 15:42:03,2010-03-12 15:42:03
44057b4e1c66c729a3658e480e316c74a6f8b1e3...5cb4789317b8e93dd4127b22c9e52ead4d9aba69,1,22,4,26,5,2010-03-12 16:23:15,2010-03-12 16:23:15
5cb4789317b8e93dd4127b22c9e52ead4d9aba69...ea9cdf79a0ba90e4998251d1b4f5e9dd2d640bd8,1,1,1,2,1,2010-03-12 17:13:48,2010-03-12 17:13:48
ea9cdf79a0ba90e4998251d1b4f5e9dd2d640bd8...0cbd5b6a379981f1eeed9a436be5c1e3a06a2fe5,6,31,7,38,10,2010-03-12 17:14:23,2010-03-12 17:14:23
0cbd5b6a379981f1eeed9a436be5c1e3a06a2fe5...81ff09077c3afce308380751515fec907688966e,1,9,0,9,1,2010-03-12 18:56:28,2010-03-12 18:56:28
81ff09077c3afce308380751515fec907688966e...0797f888001b1fbd4b0c9a802911f315cfe20dd6,3,27,18,45,15,2010-03-12 20:00:01,2010-03-12 20:00:01
0797f888001b1fbd4b0c9a802911f315cfe20dd6...22f1dc62048250ddc80c156d67368fc623f04300,2,14,12,26,7,2010-03-12 20:19:33,2010-03-12 20:19:33
22f1dc62048250ddc80c156d67368fc623f04300...be63c9ca5094ea2638f5eb1f0f6b89ded5fb06e1,3,43,1,44,5,2010-03-12 20:49:21,2010-03-12 20:49:21
be63c9ca5094ea2638f5eb1f0f6b89ded5fb06e1...43b2fab5cdcb6f935c68215e81e7977841efb624,1,1,1,2,1,2010-03-12 20:58:21,2010-03-12 20:58:21
43b2fab5cdcb6f935c68215e81e7977841efb624...71da97dd221ca1da0ebc3b68974d971bffadc972,2,7,1,8,3,2010-03-13 04:09:51,2010-03-13 04:09:51
71da97dd221ca1da0ebc3b68974d971bffadc972...c42ae951e705164d80706e78a0e09059be40f301,1,4,2,6,3,2010-03-13 16:40:42,2010-03-13 16:40:42
c42ae951e705164d80706e78a0e09059be40f301...8b8bd9a34cc7a9e0bbebce9249b387a160b1f712,2,14,12,26,9,2010-03-13 18:41:31,2010-03-13 18:41:31
8b8bd9a34cc7a9e0bbebce9249b387a160b1f712...f927ace9d17f14fef42792d7aa4f49a73f38a476,2,38,3,41,9,2010-03-14 05:36:13,2010-03-14 05:36:13
f927ace9d17f14fef42792d7aa4f49a73f38a476...6c250b7c23fecb48c7269248905c23efd6a14054,1,14,11,25,8,2010-03-14 06:18:14,2010-03-14 06:18:14
64ab4a8019da2ae4efcab3e1749e745e356f8ceb...52ae8b64d3711185a3f1eba454ee040b106edb4a,2,29,4,33,8,2010-03-11 20:14:11,2010-03-11 20:14:11
6c250b7c23fecb48c7269248905c23efd6a14054...0d779a3fa881a89c5746d94d6e4ecd36bd989167,5,79,7,86,17,2010-03-15 15:18:08,2010-03-15 15:18:08
6c250b7c23fecb48c7269248905c23efd6a14054...f39aec7867221c1d6b7e8ce481ddc93a78984604,2,41,0,41,3,2010-03-15 14:02:07,2010-03-15 14:02:07
d968785b5c1f103310140be5cad406cd6278dbcf...f74efc98ad58aeedd4e75682f4e35f5596c837f3,1,1,1,2,1,2010-03-19 03:18:28,2010-03-19 03:18:28
f74efc98ad58aeedd4e75682f4e35f5596c837f3...b14d45ae5575fbdc7042c4798a63bd77d50ec92e,2,88,17,105,17,2010-03-19 13:55:24,2010-03-19 13:55:24
2cf067a11f4c078ed51bf4e4e35c3c4d5f97d619...3c7fed91e55ebffe71fe554cf89990f79c9a954b,2,13,7,20,9,2010-03-15 15:26:56,2010-03-15 15:26:56
3c7fed91e55ebffe71fe554cf89990f79c9a954b...6f7833894153521de0079aa5eb2d2dbb92d84ea7,1,1,0,1,1,2010-03-15 15:36:31,2010-03-15 15:36:31
6f7833894153521de0079aa5eb2d2dbb92d84ea7...8158e35cc077397e0cacfedf49491fdc90e23e4c,2,2,2,4,3,2010-03-15 16:22:23,2010-03-15 16:22:23
8158e35cc077397e0cacfedf49491fdc90e23e4c...31330598f556770648d260ffcb04dabfd92ba498,3,60,3,63,7,2010-03-15 16:29:14,2010-03-15 16:29:14
31330598f556770648d260ffcb04dabfd92ba498...c971842a5598d50ce178840b33282a832b9d5d82,50,204,153,357,154,2010-03-15 16:42:01,2010-03-15 16:42:01
c971842a5598d50ce178840b33282a832b9d5d82...c457973dc696823afbdd4ab19d49c3995d98f04e,4,17,11,28,9,2010-03-15 16:56:10,2010-03-15 16:56:10
c457973dc696823afbdd4ab19d49c3995d98f04e...f097370033273ad79f061a066657fed2362972a0,3,4,0,4,3,2010-03-15 17:02:12,2010-03-15 17:02:12
f097370033273ad79f061a066657fed2362972a0...6d8e0f047ecd4f338423c6db2574f347edaf637e,2,16,4,20,6,2010-03-15 17:30:11,2010-03-15 17:30:11
b14d45ae5575fbdc7042c4798a63bd77d50ec92e...87f148a7ee9c4445c7602521c0e90e52c4b89a98,1,2,4,6,4,2010-03-19 15:59:51,2010-03-19 15:59:51
87f148a7ee9c4445c7602521c0e90e52c4b89a98...fc5ec754da83f740c8e14dcd7ce3239272b3094a,1,3,0,3,1,2010-03-19 18:00:40,2010-03-19 18:00:40
fc5ec754da83f740c8e14dcd7ce3239272b3094a...a1da8961abc17cef7564d42ca1b95c0ba8b45fa5,2,90,21,111,13,2010-03-19 18:00:46,2010-03-19 18:00:46
b14d45ae5575fbdc7042c4798a63bd77d50ec92e...d488a77cb9cad433d321ae1ed8cd2df30d3ac371,1,4,4,8,2,2010-03-19 15:59:32,2010-03-19 15:59:32
d488a77cb9cad433d321ae1ed8cd2df30d3ac371...fc611e02f3f083c8f4d4fe4e621cdcfe985312a3,1,35,0,35,1,2010-03-19 16:30:56,2010-03-19 16:30:56
6d8e0f047ecd4f338423c6db2574f347edaf637e...73fca8f0289a0d570049884f02718f2165f691cd,1,2,2,4,1,2010-03-15 20:45:27,2010-03-15 20:45:27
6d8e0f047ecd4f338423c6db2574f347edaf637e...d3c36d8e6c9ec00b6c7656b861034e7240340fa5,1,1,1,2,1,2010-03-15 19:29:38,2010-03-15 19:29:38
d3c36d8e6c9ec00b6c7656b861034e7240340fa5...9634ebafe07f30a29b55dfdafd47c2a59c59f2fa,1,1,1,2,1,2010-03-15 19:48:08,2010-03-15 19:48:08
9634ebafe07f30a29b55dfdafd47c2a59c59f2fa...93e9383c12a72a74a466122062af8257becc05c6,1,7,2,9,1,2010-03-15 19:51:34,2010-03-15 19:51:34
e5f46e6e9ed95503934994fb54257a9938a1ed94...0e04502b6e34dbe888dff3d33f53f0c8c7b81134,1,2,2,4,1,2010-03-19 18:02:48,2010-03-19 18:02:48
0e04502b6e34dbe888dff3d33f53f0c8c7b81134...a64e2e2ebc86f9907c8ba5a7d64fd0f0a9c5cd09,1,20,5,25,5,2010-03-19 20:31:02,2010-03-19 20:31:02
a64e2e2ebc86f9907c8ba5a7d64fd0f0a9c5cd09...25567181a4187f83bb8de97d470eff9ddb87ba4e,1,1,1,2,1,2010-03-19 20:31:35,2010-03-19 20:31:35
25567181a4187f83bb8de97d470eff9ddb87ba4e...a9e9dc70d010a93f6808b1110f4380a111f7f69d,1,1,1,2,1,2010-03-19 20:33:18,2010-03-19 20:33:18
a9e9dc70d010a93f6808b1110f4380a111f7f69d...1535b29e7518d6055d768f77c40210249a938992,1,19,0,19,1,2010-03-20 15:30:13,2010-03-20 15:30:13
1535b29e7518d6055d768f77c40210249a938992...7a118d59f26c596f509d2d2f422588992e1ed1eb,5,15,10,25,6,2010-03-21 03:46:19,2010-03-21 03:46:19
7a118d59f26c596f509d2d2f422588992e1ed1eb...f154df074d4bbf9aece18a20fef8eef4f49a5a62,1,23,4,27,2,2010-03-22 04:21:52,2010-03-22 04:21:52
807aa4d121e3f6ea8c97026476747991cd4533a9...8f28569fa0cf8fb4ffcaa3011e34da657bc3ec28,1,1,1,2,1,2010-03-16 06:18:24,2010-03-16 06:18:24
8f28569fa0cf8fb4ffcaa3011e34da657bc3ec28...7aaaaa01a7367fe868b0e16a595fd25bb68c5423,3,24,1,25,5,2010-03-16 06:18:49,2010-03-16 06:18:49
93e9383c12a72a74a466122062af8257becc05c6...aa6c394b72667bb59effcdb4f13a0c70202e7258,4,80,1,81,12,2010-03-15 20:52:41,2010-03-15 20:52:41
aa6c394b72667bb59effcdb4f13a0c70202e7258...b425b6bfe0e212768fc99e4a19635ecb22ab6ba5,4,1,80,81,12,2010-03-15 20:53:31,2010-03-15 20:53:31
93e9383c12a72a74a466122062af8257becc05c6...d8cbbd959e0fa4a13b3f3624dfd744a0e3813d3a,1,9,3,12,2,2010-03-15 20:26:12,2010-03-15 17:50:10
d8cbbd959e0fa4a13b3f3624dfd744a0e3813d3a...1fe29d5b7fdb46dba599a4ab08cdaf6b14c5bcb5,1,7,8,15,4,2010-03-15 20:26:12,2010-03-15 17:57:13
1fe29d5b7fdb46dba599a4ab08cdaf6b14c5bcb5...15249fbfd66c109f3046f9745cf081d5321b885e,1,1,1,2,1,2010-03-15 20:26:12,2010-03-15 17:59:26
15249fbfd66c109f3046f9745cf081d5321b885e...cce309e895e090027c3263e8eb7732073ece8a5d,4,47,0,47,6,2010-03-15 20:26:12,2010-03-15 20:02:24
f154df074d4bbf9aece18a20fef8eef4f49a5a62...3ddfaa43dbce2ab9f8be1539d447787b85e3fc79,2,2,2,4,2,2010-03-22 14:39:01,2010-03-22 14:39:01
3ddfaa43dbce2ab9f8be1539d447787b85e3fc79...d6e3981dc7286a34c8f1030c0dde7c1e2b087abc,2,5,2,7,3,2010-03-22 15:19:50,2010-03-22 15:19:50
f154df074d4bbf9aece18a20fef8eef4f49a5a62...92dca86601a5f54c76e748e04ecb3a96d35ca0b4,5,58,28,86,13,2010-03-22 13:51:06,2010-03-22 13:51:06
4a04ea9ec8c63e63898cad80d1b5e846bb13af48...ce47853ec846c16ef6b3a1d3dd718be64a530e3d,1,4,4,8,4,2010-03-16 07:46:13,2010-03-16 07:46:13
ce47853ec846c16ef6b3a1d3dd718be64a530e3d...9a5dbd5c0316bf4a1aaf87166fd6de155ce4e411,3,14,11,25,12,2010-03-16 07:58:47,2010-03-16 07:58:47
dd921036bb215d72af712e096a0c9218caa9580c...44dcc1ae77651be1ae9f1326e317f8d2336afb6e,1,1,1,2,1,2010-03-15 21:35:08,2010-03-15 21:35:08
44dcc1ae77651be1ae9f1326e317f8d2336afb6e...5cd5489893c24636c655c136f0f557b558af8f19,1,17,0,17,1,2010-03-16 00:46:10,2010-03-16 00:46:10
5cd5489893c24636c655c136f0f557b558af8f19...3f6d78ca29529446362440c5ae209c40019f8cbe,5,15,6,21,6,2010-03-16 03:50:14,2010-03-16 03:50:14
3f6d78ca29529446362440c5ae209c40019f8cbe...c09ded578037bab3cd1d3ac6b215cda001f2c899,2,7,5,12,6,2010-03-16 04:09:52,2010-03-16 04:09:52
cce309e895e090027c3263e8eb7732073ece8a5d...1e2bc390de0afc9539e4a57f1f87e5d54d828ee3,1,2,0,2,2,2010-03-15 23:18:01,2010-03-15 23:18:01
d6e3981dc7286a34c8f1030c0dde7c1e2b087abc...c0c57984d9f7f38f90257e7ac2780894dadbd9ad,1,8,7,15,3,2010-03-22 16:07:44,2010-03-22 16:07:44
ced7756639f0ed3171cea587534ef2ead75004a1...1e6780f8444e2477ad6317a4edc62b43b6ad35cc,13,158,41,199,44,2010-03-22 15:47:37,2010-03-22 15:47:37
38028c6e8fe184dd8a69df35a898e8aaa14d737b...2b7eb102159a36129222afa1883ea3b15145e08b,3,39,25,64,14,2010-03-16 14:06:36,2010-03-16 14:05:32
c09ded578037bab3cd1d3ac6b215cda001f2c899...3c454428299aa050390dc60238b724d51bd5c23e,2,28,0,28,2,2010-03-16 12:48:24,2010-03-16 12:48:24
e7bef0269dca87698bb840d57e9298e00d4cc5a3...f35ab906b1c3ea3b48b9bfc4c5c71fb1fe2e59ef,1,3,2,5,2,2010-03-16 16:26:26,2010-03-16 16:26:26
f35ab906b1c3ea3b48b9bfc4c5c71fb1fe2e59ef...5476c8a13e421fd7432fe6b1076d5328c93842ea,1,1,1,2,1,2010-03-16 19:13:57,2010-03-16 19:13:57
0f7ba87de3211cfe499cbdffd0851353bf6cbb79...8db83567639358ee690ced92cc1ec7fe3528ba82,1,1,1,2,1,2010-03-22 16:42:04,2010-03-22 16:42:04
1e6780f8444e2477ad6317a4edc62b43b6ad35cc...fd7616631bbbd8317449b5e093890b326d026492,2,2,12,14,5,2010-03-22 17:10:06,2010-03-22 17:10:06
fd7616631bbbd8317449b5e093890b326d026492...4aea2b8ca54ac62f57fdb38897c56bf590ee315b,2,73,25,98,7,2010-03-22 17:37:56,2010-03-22 17:37:56
2b7eb102159a36129222afa1883ea3b15145e08b...16ee2d34de510d11edf9084af09d44b2e9d3339c,1,61,14,75,13,2010-03-16 15:47:35,2010-03-16 15:47:35
2b7eb102159a36129222afa1883ea3b15145e08b...c3fbc45b5567f9de1b3642e839e05856bdd70776,1,70,0,70,1,2010-03-16 14:55:26,2010-03-15 21:29:30
c3fbc45b5567f9de1b3642e839e05856bdd70776...ea63cbc1f87004a73735e3bab9c93e2c37920515,1,9,5,14,7,2010-03-16 15:25:50,2010-03-16 15:25:44
ea63cbc1f87004a73735e3bab9c93e2c37920515...ce00ed27e7d2f6503af20db5eebcd04c37f21e8c,1,10,2,12,2,2010-03-16 15:39:29,2010-03-16 15:39:29
5476c8a13e421fd7432fe6b1076d5328c93842ea...87e865d8906545cd1bff982ef5c87e9d88d065bb,1,14,3,17,4,2010-03-16 20:04:35,2010-03-16 20:04:35
5476c8a13e421fd7432fe6b1076d5328c93842ea...7cff2409906a30fa0662aef8f560b08830328a86,4,39,41,80,27,2010-03-16 19:55:13,2010-03-16 19:43:57
7cff2409906a30fa0662aef8f560b08830328a86...8167e4a7ad6d91b1cac6e77b724f0dbb8b4eaee0,3,4,5,9,4,2010-03-16 19:55:13,2010-03-16 19:54:55
8167e4a7ad6d91b1cac6e77b724f0dbb8b4eaee0...d5ad7f95c8ec1ec64374b89e06de34ba1e02631a,1,10,2,12,2,2010-03-16 20:01:59,2010-03-16 20:01:59
8db83567639358ee690ced92cc1ec7fe3528ba82...82be9226a67a465e62615d088c90d6085f9e841d,3,12,6,18,8,2010-03-22 17:50:55,2010-03-22 17:50:55
254f59877e4402c510914a7ba7025dbdbe504e6d...6a27f13e5d26745b335408b200a5813819a418ec,1,10,3,13,6,2010-03-22 17:55:38,2010-03-22 17:55:38
2c76db0ffbc64482bc7e093cd0a592f3585544eb...42820656f3b5ff3570006ba101595d09f54fc8ae,2,345,86,431,44,2010-03-16 20:11:06,2010-03-16 20:11:06
5d7f77dda7126caacd4823c180ba59cd28a435f8...07db021d74e7f23939fa49bbe10895b89632f67b,3,76,12,88,9,2010-03-22 19:44:45,2010-03-22 19:44:45
f69f94cbb4eed4a8b8cc49f32e0272d06e8e351f...d74909dfc0a78fec4f650f692cd7665f2d46a3a5,1,24,0,24,1,2010-03-22 18:02:30,2010-03-22 18:02:30
f69f94cbb4eed4a8b8cc49f32e0272d06e8e351f...f816dc8419cafb9d5af92443bff43d80846b1052,2,34,19,53,7,2010-03-22 17:56:48,2010-03-22 17:52:21
5af02ef16fee549244c1db2517224bb729872974...10e373e07923a8b37eb9168fc56669ab583c22f0,3,8,1,9,3,2010-03-16 20:18:36,2010-03-16 20:18:36
97275707db0f0bf80f81245ee72857b1ef237300...4912b401063f65ec79ad585e3406ca51dfd7d501,1,3,4,7,3,2010-03-22 20:57:59,2010-03-22 20:57:59
80525110a306797283d799d03a8506a29163b974...3d4d7efb469d7b9401a7d55ce5cf7226e2da39bf,3,151,0,151,4,2010-03-22 18:18:51,2010-03-22 18:18:51
10e373e07923a8b37eb9168fc56669ab583c22f0...b4257fa816266b8a0e0803bfec1949ea2c287860,2,3,1,4,3,2010-03-16 21:05:25,2010-03-16 21:05:25
b4257fa816266b8a0e0803bfec1949ea2c287860...a9880d51ccedffb9d4489b8a4ce857aa5525216c,1,1,1,2,1,2010-03-16 21:05:41,2010-03-16 21:05:41
10e373e07923a8b37eb9168fc56669ab583c22f0...17825fe4ccb029f5451d8385e64c832711dd19a8,2,140,6,146,11,2010-03-16 21:02:17,2010-03-16 21:02:17
17825fe4ccb029f5451d8385e64c832711dd19a8...a36f11068bc3c34573d2971b5fcbf2ed7166e0c2,2,9,9,18,7,2010-03-16 21:07:34,2010-03-16 21:07:34
4912b401063f65ec79ad585e3406ca51dfd7d501...8f7d5a26f5b0a53fabd8eb26c230029f1dc06b3d,3,86,1,87,4,2010-03-22 21:51:37,2010-03-22 21:51:37
3d4d7efb469d7b9401a7d55ce5cf7226e2da39bf...59488feffc96d2664c635ef7ea98d1c2e79819ae,4,17,1,18,5,2010-03-22 21:02:05,2010-03-22 21:02:05
a9880d51ccedffb9d4489b8a4ce857aa5525216c...3b46bf3fcca4813152fc57d063cac82739f00df0,1,2,0,2,1,2010-03-16 21:45:06,2010-03-16 21:45:06
1e42decc4c2172958ee23491efb0c24bf081a8d5...6ff986d3a53b20fe7b21c83f5265682acae4d7c1,3,12,1,13,7,2010-03-16 21:38:39,2010-03-16 21:38:39
b3ee79ea6265da26e961d2e8e40e69efd6790c9f...f6ea3d75f4576c007553d53f5bb9496e6b0c6f19,2,57,0,57,3,2010-03-23 00:24:09,2010-03-23 00:24:09
192dc4f79afa0626aa9cf1ff819d00891acd7e5b...d52baa2858499d40c8e1374eec29b7a9fd7381c7,2,8,3,11,5,2010-03-22 21:21:16,2010-03-22 20:18:58
d52baa2858499d40c8e1374eec29b7a9fd7381c7...2b79d806c204fe7b4782df59067921fc22202d24,3,37,6,43,6,2010-03-22 21:35:07,2010-03-22 21:35:07
2b79d806c204fe7b4782df59067921fc22202d24...f5e10fef7641d6aae6d129337a10b89bb57ec120,1,1,1,2,1,2010-03-22 21:44:20,2010-03-22 21:44:20
c96de7cbb648f3d73759fab3e70c185244a57618...ca5d99d53a37e76faccd1d428d3efc93f04a3ec0,1,36,7,43,3,2010-03-17 02:14:00,2010-03-17 02:14:00
f6ea3d75f4576c007553d53f5bb9496e6b0c6f19...5468103d28983d35510ef81ffa33e2be829ab23f,1,9,5,14,3,2010-03-23 19:04:54,2010-03-23 19:04:54
f6ea3d75f4576c007553d53f5bb9496e6b0c6f19...19658410941569bb9df4407d136d556ea2f8e908,1,5,1,6,3,2010-03-23 01:47:03,2010-03-23 01:47:03
19658410941569bb9df4407d136d556ea2f8e908...48cc94ad5523faec1eba48f1c44bc70d3b9ed809,5,10,4,14,5,2010-03-23 02:12:51,2010-03-23 02:12:51
ca5d99d53a37e76faccd1d428d3efc93f04a3ec0...3c2ac2749b43d33f7d8603e550bcbd4072ec7ead,1,27,10,37,13,2010-03-17 05:16:20,2010-03-17 05:16:20
ca5d99d53a37e76faccd1d428d3efc93f04a3ec0...941f70164bdd0322937419eb645426d953119ef5,1,1,1,2,1,2010-03-17 03:09:37,2010-03-17 00:30:13
2928f8b2e7828c129499210571daa16162b20a54...5e78c52f1b03fa2d7079a227285f927b4756c1b2,1,24,15,39,14,2010-03-23 20:38:20,2010-03-23 20:38:20
48cc94ad5523faec1eba48f1c44bc70d3b9ed809...a7833959a5b1f4dab3f7a8ed930e861f676c317d,1,1,0,1,1,2010-03-23 16:13:23,2010-03-23 16:13:23
48cc94ad5523faec1eba48f1c44bc70d3b9ed809...876a99b097b57afd4aa1819d6d5cc140de0919be,1,1,1,2,1,2010-03-23 04:16:41,2010-03-23 04:16:41
46fc051a74ec85910516309d436d5708c26c2576...a9d6f4d52e0f40d000a0df2599b4d619fb2e5f71,1,1,0,1,1,2010-03-17 14:10:38,2010-03-17 14:10:38
a9d6f4d52e0f40d000a0df2599b4d619fb2e5f71...ccd6e1bca56f0f0b42cbe2f79f087c116f1923be,2,23,8,31,12,2010-03-17 14:41:19,2010-03-17 14:41:19
ccd6e1bca56f0f0b42cbe2f79f087c116f1923be...ff8c904d30a864b0311b882f5186503dc048ff63,2,9,9,18,6,2010-03-17 15:12:21,2010-03-17 15:12:21
ff8c904d30a864b0311b882f5186503dc048ff63...877278b04e1bd94420bff1228d1a3b1bc2318425,2,10,1,11,2,2010-03-17 15:28:26,2010-03-17 15:28:26
877278b04e1bd94420bff1228d1a3b1bc2318425...7fa2feb8913dec022fd5c4a533d68034b896cfd5,5,21,5,26,9,2010-03-17 15:46:26,2010-03-17 15:46:26
7fa2feb8913dec022fd5c4a533d68034b896cfd5...cc5f1f770a93bd3c6bf5e03bb86008578c3464ec,4,9,3,12,4,2010-03-17 16:47:49,2010-03-17 16:47:49
cc5f1f770a93bd3c6bf5e03bb86008578c3464ec...89c448422ff2b8d96e71117d824d3366cca2093e,1,1,1,2,1,2010-03-17 20:23:49,2010-03-17 20:23:49
89c448422ff2b8d96e71117d824d3366cca2093e...df2dd73fdb3b945e691d5dec50a08fdce4abd34c,3,11,3,14,3,2010-03-18 01:51:14,2010-03-18 01:51:14
df2dd73fdb3b945e691d5dec50a08fdce4abd34c...ad6e86e451b94230041d413e7c46fc0ad30c7633,1,0,8,8,1,2010-03-18 06:16:23,2010-03-18 06:16:23
ad6e86e451b94230041d413e7c46fc0ad30c7633...8c69ba521d2d035e0d8d895262eac66b8bc57038,1,6,2,8,1,2010-03-18 06:50:57,2010-03-18 06:50:57
8c69ba521d2d035e0d8d895262eac66b8bc57038...e07aa8a7ca29241d4209cf05db1fb63d38af49e7,1,8,0,8,1,2010-03-18 07:22:31,2010-03-18 07:22:31
5e78c52f1b03fa2d7079a227285f927b4756c1b2...2dce721f654c5560c3e5f98948ae132a9d2aea6d,2,18,1,19,2,2010-03-24 14:19:28,2010-03-24 14:19:28
5e78c52f1b03fa2d7079a227285f927b4756c1b2...30ccee77aa80eb133275b32f2047f8a1cee2eafd,1,1,0,1,1,2010-03-23 21:51:31,2010-03-23 21:51:31
4bc75aab3d8dbb9edabea189a17c1c9e9e266eec...8c484cdce81ac434ed1c92e83a88be9a5b5aaecc,2,23,7,30,15,2010-03-23 18:51:36,2010-03-23 18:51:36
8c484cdce81ac434ed1c92e83a88be9a5b5aaecc...612763233ba5a357d14d292951b83e2dd7b17816,1,1,0,1,1,2010-03-23 18:59:02,2010-03-23 18:59:02
e07aa8a7ca29241d4209cf05db1fb63d38af49e7...5e9f1e69411ca3abdbdb6b72dec4ff4ab90ae05c,1,3,1,4,2,2010-03-18 16:05:50,2010-03-18 16:05:50
e07aa8a7ca29241d4209cf05db1fb63d38af49e7...6bba1c318455041ff5f389f6ecd99336cd2dc239,3,98,54,152,13,2010-03-18 15:09:36,2010-03-18 15:09:36
b42d93b75ab6d179d3ebefbd4e5093514f5b8d72...0da2c646ab4e60126fd67bf3f5984f7f8bea335b,1,1,1,2,1,2010-03-24 16:49:25,2010-03-24 16:49:25
0da2c646ab4e60126fd67bf3f5984f7f8bea335b...a46c77023b22eb551f4e4182055591198b91be5f,1,7,2,9,1,2010-03-24 23:51:43,2010-03-24 23:51:43
6bba1c318455041ff5f389f6ecd99336cd2dc239...0bba41a0bb37c54590daafcaced5896a225e315d,5,91,57,148,25,2010-03-18 16:15:29,2010-03-18 16:15:29
a46c77023b22eb551f4e4182055591198b91be5f...77dcef5af910f27b5e4ab5a7ddddb28e473484e7,1,1,1,2,1,2010-03-25 05:16:10,2010-03-25 05:16:10
77dcef5af910f27b5e4ab5a7ddddb28e473484e7...459357d50601125a9d4e539f6dca1a607467a195,1,9,5,14,5,2010-03-25 14:17:51,2010-03-25 14:17:51
a46c77023b22eb551f4e4182055591198b91be5f...41a2421ab975f7afe43f2455d224ddc9e9fed0c5,1,1,1,2,1,2010-03-25 03:15:02,2010-03-25 03:15:02
41a2421ab975f7afe43f2455d224ddc9e9fed0c5...656cd5df27a705c714ac0052a54e5cd0e2bfeb56,1,1,1,2,1,2010-03-25 05:20:06,2010-03-25 05:20:06
656cd5df27a705c714ac0052a54e5cd0e2bfeb56...35885ba8de830d09d8b29d3385154159dee70ccc,1,9,5,14,5,2010-03-25 14:34:55,2010-03-25 14:17:51
35885ba8de830d09d8b29d3385154159dee70ccc...514f8bbab657c1dc110d45eea6ea33de296dbb26,4,9,3,12,4,2010-03-25 15:04:10,2010-03-25 15:04:10
514f8bbab657c1dc110d45eea6ea33de296dbb26...dac3b92e7c3f6a603ea5b066e0372de9d960aca8,1,1,1,2,1,2010-03-25 16:02:37,2010-03-25 16:02:37
dac3b92e7c3f6a603ea5b066e0372de9d960aca8...b44262e4efc6ebb1d86d9ccab852fdcaea248912,1,1,1,2,1,2010-03-26 16:14:15,2010-03-26 16:14:15
b44262e4efc6ebb1d86d9ccab852fdcaea248912...1bab750b19e1735a7fc9741e6a3a6c3ad63547c8,4,66,27,93,20,2010-03-26 19:31:11,2010-03-26 19:30:29
1bab750b19e1735a7fc9741e6a3a6c3ad63547c8...2b2f91fad03dae0a3135930155691479d4716b29,1,2,0,2,1,2010-03-26 20:33:38,2010-03-26 20:33:12
2b2f91fad03dae0a3135930155691479d4716b29...6a05e9026eef5fe730e2a62c4c2223c03c212768,3,9,4,13,4,2010-03-27 01:39:22,2010-03-27 01:38:39
6a05e9026eef5fe730e2a62c4c2223c03c212768...2f3fc6261917cb9ec9bd80c7bb24fe070ff9e31b,1,1,1,2,1,2010-03-28 04:34:09,2010-03-28 04:33:33
2f3fc6261917cb9ec9bd80c7bb24fe070ff9e31b...6de759673dba3e69c1b9148403c54a30107cedef,2,9,2,11,2,2010-03-28 21:15:56,2010-03-28 21:15:27
6de759673dba3e69c1b9148403c54a30107cedef...d979fd7da676eb255294bccaf9e18b7599ba169c,1,4,1,5,2,2010-03-29 14:41:04,2010-03-29 14:40:32
d979fd7da676eb255294bccaf9e18b7599ba169c...1cab1d1c7c3fbf0e166c7fd6ffbdefbb66ba8dd5,2,5,1,6,3,2010-03-30 06:25:04,2010-03-29 21:14:50
1cab1d1c7c3fbf0e166c7fd6ffbdefbb66ba8dd5...3e286b07bb93b949069a7150cbe1566cf22559c4,1,1,1,2,1,2010-03-30 06:25:17,2010-03-29 23:35:06
3e286b07bb93b949069a7150cbe1566cf22559c4...7109c020a33dc721acc75f184cba444cfce15dc8,7,13,5,18,9,2010-03-31 15:58:09,2010-03-31 15:57:27
7109c020a33dc721acc75f184cba444cfce15dc8...da5872874f2285ef3c1eb3a45810f73f4b6ae6af,1,20,13,33,1,2010-04-01 14:20:10,2010-04-01 14:19:38
da5872874f2285ef3c1eb3a45810f73f4b6ae6af...a57baf1d0505012b045619e8a6ee0733c9f27fea,1,1,0,1,1,2010-04-01 16:00:01,2010-04-01 15:50:49
a57baf1d0505012b045619e8a6ee0733c9f27fea...fc7f36ad702fc1b45b17b0e1d08586c8faf77a72,2,21,6,27,7,2010-04-01 19:33:50,2010-04-01 19:32:52
fc7f36ad702fc1b45b17b0e1d08586c8faf77a72...601f3d44fae113086d110e168ae0ec02925de910,2,54,17,71,17,2010-04-09 01:35:58,2010-04-08 21:43:30
601f3d44fae113086d110e168ae0ec02925de910...adb8a476bc86dc96a583f45cb0dee21b0c8afd59,2,3,1,4,2,2010-04-09 18:32:49,2010-04-09 18:32:24
b4f52b1ac822abdfafa336e48ec3922476d27c93...4d38eeec43ecddd1a98868349065a7a6ee8f7b66,3,30,10,40,15,2010-03-18 19:00:29,2010-03-18 19:00:29
4d38eeec43ecddd1a98868349065a7a6ee8f7b66...bfb09e93ea5efd5ada1addace06ada34062881a8,2,9,3,12,4,2010-03-18 19:05:13,2010-03-18 19:05:13
bfb09e93ea5efd5ada1addace06ada34062881a8...2e38dbcc69c46c8168a1fe8165a1444118d6914d,6,41,26,67,10,2010-03-18 20:38:27,2010-03-18 20:38:27
459357d50601125a9d4e539f6dca1a607467a195...04f21a1ffe7019cb51fe0366d5ce48115bf9ee10,3,7,6,13,6,2010-03-25 19:49:06,2010-03-25 19:49:06
459357d50601125a9d4e539f6dca1a607467a195...7a8eafa9ba4068130cb1a6f219d7b87412306744,1,1,1,2,1,2010-03-25 15:49:49,2010-03-25 15:49:49
adb8a476bc86dc96a583f45cb0dee21b0c8afd59...f8339b000d80c35248a5c7a7e6a8fe2182702f6c,4,24,0,24,5,2010-04-13 21:19:28,2010-04-06 17:49:51
adb8a476bc86dc96a583f45cb0dee21b0c8afd59...4fb7888bfeb08cd538fc9cdf090e19f00c3605ee,1,1,1,2,1,2010-04-10 06:39:06,2010-03-30 20:45:57
4fb7888bfeb08cd538fc9cdf090e19f00c3605ee...811623e38508fb03eb073098ed68403fc0e41c6f,2,6,2,8,2,2010-04-10 06:39:14,2010-04-10 06:36:30
2e38dbcc69c46c8168a1fe8165a1444118d6914d...443436bae3048f3c91405f67e60dd69f0479add0,1,27,7,34,9,2010-03-18 21:56:19,2010-03-18 21:56:19
2e38dbcc69c46c8168a1fe8165a1444118d6914d...75ad011c4dd3f0fe4379ba7fbb84bde34a33abcb,1,42,0,42,3,2010-03-18 21:11:02,2010-03-18 21:11:02
024255e9051090e13a610c43342402e5bbab48e1...c86ea1f913cd1e4006ddc2140b2b1b306751466c,4,6,6,12,6,2010-03-25 20:16:59,2010-03-25 20:16:59
c86ea1f913cd1e4006ddc2140b2b1b306751466c...18149f3c47b7c8b1b547184fc571640821e96224,1,23,0,23,1,2010-03-25 20:17:08,2010-03-25 20:17:08
7a8eafa9ba4068130cb1a6f219d7b87412306744...9ad05c8c936e73adbfd980524ed4e82e7966f4e4,1,4,0,4,1,2010-03-25 18:18:31,2010-03-25 18:18:31
7a8eafa9ba4068130cb1a6f219d7b87412306744...a6c0d8735dfb461966014470959b49a66c51cc2d,1,2,2,4,1,2010-03-25 18:01:48,2010-03-25 18:01:48
828178f05adb43462023a3e948cbe9c343780ac4...5b29dec9707d50979c283057ca1b1572351eef9a,4,10,3,13,4,2010-04-14 19:52:44,2010-04-14 19:52:44
5b29dec9707d50979c283057ca1b1572351eef9a...4731f0bc59eb09b6c942630baaa415aa04a84c2d,1,1,1,2,1,2010-04-14 20:50:09,2010-04-14 20:50:09
4731f0bc59eb09b6c942630baaa415aa04a84c2d...cddcfc5c94fb9359e5889f3426e3d4aa7438bda9,2,4,1,5,2,2010-04-15 14:21:55,2010-04-15 14:15:10
cddcfc5c94fb9359e5889f3426e3d4aa7438bda9...d946d442d2711d1b84fcb2d965bf620e56dbd56d,1,1,0,1,1,2010-04-16 15:55:35,2010-04-14 20:37:29
d946d442d2711d1b84fcb2d965bf620e56dbd56d...9945f76ea76baa5403785f67995f85208a9a122e,1,11,2,13,4,2010-04-16 15:55:50,2010-04-16 15:54:21
9945f76ea76baa5403785f67995f85208a9a122e...1561c0a3e2464320b5d810c8c70fd11db55f7c3b,1,6,1,7,4,2010-04-21 15:41:32,2010-04-21 14:09:25
1561c0a3e2464320b5d810c8c70fd11db55f7c3b...a0e88a89ead7ecd5c5928f1a2a674c6ae5b62f43,1,6,1,7,3,2010-04-21 15:41:40,2010-04-21 15:41:05
a0e88a89ead7ecd5c5928f1a2a674c6ae5b62f43...351b01e2a992e99792aeee009511caaa6ab38fa1,1,1,1,2,1,2010-04-21 16:55:29,2010-04-21 16:54:37
351b01e2a992e99792aeee009511caaa6ab38fa1...839236d8699c8b9590f21d8c158e4f3177b946c0,4,42,11,53,15,2010-04-26 19:25:08,2010-04-26 19:24:16
839236d8699c8b9590f21d8c158e4f3177b946c0...1a7ad0ec4a28f43a45824fb842bc6dd406ef3a11,1,4,1,5,1,2010-04-27 13:38:52,2010-04-15 15:49:16
1a7ad0ec4a28f43a45824fb842bc6dd406ef3a11...e171d10a100ba70f565eb49e2ba902ba0efe39ac,1,1,0,1,1,2010-04-27 13:41:07,2010-04-27 13:41:07
e171d10a100ba70f565eb49e2ba902ba0efe39ac...53749fc2d547a3139fcf169d84d58442778ea4b0,4,10,3,13,4,2010-04-27 15:19:01,2010-04-27 15:19:01
53749fc2d547a3139fcf169d84d58442778ea4b0...57956a51fc7213014fc640326349201ffd393244,1,1,1,2,1,2010-04-27 16:59:57,2010-04-27 16:59:57
57956a51fc7213014fc640326349201ffd393244...4e6d4b0a3d1214d37ae12c941158acc61ae2fa96,1,1,1,2,1,2010-05-03 12:30:02,2010-05-03 12:29:34
4e6d4b0a3d1214d37ae12c941158acc61ae2fa96...e9ef03782ca0b5f8d979a9c439d49c6ab8b540ce,2,32,6,38,5,2010-05-03 16:58:41,2010-04-28 20:56:14
e9ef03782ca0b5f8d979a9c439d49c6ab8b540ce...c76768d3e8e34e781f30e40427259ffe0a1f8176,2,8,4,12,3,2010-05-03 19:03:18,2010-05-03 19:03:18
c76768d3e8e34e781f30e40427259ffe0a1f8176...fe2d4d93f2599cf2b955e880be2fb64d8dca9097,1,26,14,40,5,2010-05-04 04:44:29,2010-05-04 04:44:29
fe2d4d93f2599cf2b955e880be2fb64d8dca9097...4e8cafb9e909fe9a71ba12fc1863251cfa7455b0,2,32,3,35,3,2010-05-04 23:20:59,2010-05-04 23:20:59
4e8cafb9e909fe9a71ba12fc1863251cfa7455b0...1868b5c37c800eb85e46d226ec96749323766b8d,1,18,18,36,14,2010-05-05 01:50:28,2010-05-05 01:50:28
1868b5c37c800eb85e46d226ec96749323766b8d...19672f06efbb3edf279e175b2fdca2469a7fbeb1,1,3,0,3,2,2010-05-05 04:14:47,2010-05-05 04:14:47
19672f06efbb3edf279e175b2fdca2469a7fbeb1...c1007834f6c7d724e824a91c60ab1e2aef2e07c9,2,97,2,99,4,2010-05-06 02:53:59,2010-05-06 02:52:51
c1007834f6c7d724e824a91c60ab1e2aef2e07c9...1b4e06c64eecb8bb80ee6aacf311457fcf9e375d,1,2,0,2,1,2010-05-06 21:28:25,2010-05-06 21:28:25
1b4e06c64eecb8bb80ee6aacf311457fcf9e375d...8fa4644f25cb4416a84a40187151fc2b17abc979,3,8,5,13,7,2010-05-10 15:59:02,2010-05-10 15:26:08
8fa4644f25cb4416a84a40187151fc2b17abc979...fc58c9babfde872a7c876951064a890a4cf61aa0,1,2,3,5,2,2010-05-11 19:12:49,2010-05-11 19:12:17
fc58c9babfde872a7c876951064a890a4cf61aa0...598ef8ba63003776aad5cce9d85814f529e1306c,1,38,1,39,3,2010-05-13 07:24:24,2010-05-13 07:13:55
598ef8ba63003776aad5cce9d85814f529e1306c...9243ee9097940afd7dcc8aa92e1bf01948ec3665,1,15,7,22,3,2010-05-13 18:02:08,2010-05-13 18:02:08
9243ee9097940afd7dcc8aa92e1bf01948ec3665...797db1f61ffa77b8e55d4cdaefde45388692d979,1,1,1,2,1,2010-05-14 15:20:55,2010-05-14 15:20:55
797db1f61ffa77b8e55d4cdaefde45388692d979...dc461306241ec2263f16220947ac6d49b6d77ee7,1,15,5,20,5,2010-05-24 14:36:34,2010-05-11 19:23:50
dc461306241ec2263f16220947ac6d49b6d77ee7...c9181b253b3216e496633dfe53f8078894a1df4c,1,1,1,2,1,2010-05-24 14:53:41,2010-05-24 14:53:41
c9181b253b3216e496633dfe53f8078894a1df4c...b4774a4fcdd7e9febf3adc21ed1462827630f1e3,1,4,1,5,3,2010-05-24 15:11:31,2010-05-24 15:09:10
b4774a4fcdd7e9febf3adc21ed1462827630f1e3...47ffbdfd53f46edeb6ff54bbb734783db7abc8ca,4,9,3,12,4,2010-05-24 16:56:23,2010-05-24 16:56:23
47ffbdfd53f46edeb6ff54bbb734783db7abc8ca...658c2213e44030f6244b4f369dc11a6a6959fb92,1,1,1,2,1,2010-05-24 21:45:45,2010-05-24 21:45:45
658c2213e44030f6244b4f369dc11a6a6959fb92...650e5b099fd9f56084954aec025b4acd458ce4af,4,31,16,47,14,2010-05-25 01:54:48,2010-05-25 00:33:01
650e5b099fd9f56084954aec025b4acd458ce4af...ccf56ae4c251f571a395d759f03a44d8bf5e40df,1,7,1,8,1,2010-05-27 04:55:03,2010-05-27 04:55:03
ccf56ae4c251f571a395d759f03a44d8bf5e40df...637dbb7bb2f66de95ab38b0b1712f8fc7ef98263,1,2,2,4,2,2010-05-27 13:48:36,2010-05-27 13:48:36
637dbb7bb2f66de95ab38b0b1712f8fc7ef98263...5bf66857bc03076771077a92da2e05efafc36412,3,27,7,34,8,2010-05-27 15:45:24,2010-05-27 15:45:24
5bf66857bc03076771077a92da2e05efafc36412...15147c7e3fda0d0cd63e464d11002d7a67dfc5fb,1,4,4,8,4,2010-05-28 17:53:17,2010-05-28 17:53:17
15147c7e3fda0d0cd63e464d11002d7a67dfc5fb...60b052f024a318b949b8c65b6042b3e6fb37b729,1,7,2,9,1,2010-06-01 17:24:02,2010-06-01 17:24:02
60b052f024a318b949b8c65b6042b3e6fb37b729...68bcdb17fbebd8d071e6fca845dacd6e940813c2,2,7,3,10,4,2010-06-02 14:03:32,2010-06-02 14:01:42
68bcdb17fbebd8d071e6fca845dacd6e940813c2...74fe4041a0b25917bc13ad5d8644b46a09cebde7,2,64,12,76,10,2010-06-08 15:04:18,2010-06-08 15:04:18
74fe4041a0b25917bc13ad5d8644b46a09cebde7...d79f8e1ea1155774d0f10598253d4d814b307ad2,1,1,1,2,1,2010-06-08 15:08:26,2010-06-08 15:08:26
d79f8e1ea1155774d0f10598253d4d814b307ad2...5ac1a08dbb9532ad0e52af6ce6fe508d122f329f,1,3,5,8,1,2010-06-08 15:18:23,2010-06-08 15:18:23
5ac1a08dbb9532ad0e52af6ce6fe508d122f329f...ecae23c29f4bebd030bbf1e65ecbf2b5c57be108,1,7,3,10,1,2010-06-08 17:03:10,2010-06-08 17:03:10
ecae23c29f4bebd030bbf1e65ecbf2b5c57be108...be489c67050c196dbfbd1136457d3cb6311035f0,1,6,8,14,2,2010-06-08 17:43:01,2010-06-08 17:43:01
be489c67050c196dbfbd1136457d3cb6311035f0...8cffdd6ed0e8e1c37b565e86b371c52e0190c706,1,5,2,7,2,2010-06-10 20:14:31,2010-06-02 21:06:51
8cffdd6ed0e8e1c37b565e86b371c52e0190c706...48b6a237d21a3a634694d823a1acdb0c6302474e,2,14,15,29,12,2010-06-25 16:13:28,2010-03-29 14:11:16
48b6a237d21a3a634694d823a1acdb0c6302474e...58f19f39f96234f89ef8bb350f27f71ed4d62633,1,1,1,2,1,2010-06-26 15:39:26,2010-06-26 15:39:26
58f19f39f96234f89ef8bb350f27f71ed4d62633...a92bead078f048bbe562871d921eae005419ccab,1,13,0,13,3,2010-06-29 16:08:00,2010-06-29 16:08:00
a92bead078f048bbe562871d921eae005419ccab...ef213b85e384cef040e4fff5c30028bcebec1b45,1,9,6,15,2,2010-06-29 17:27:33,2010-06-29 17:27:33
ef213b85e384cef040e4fff5c30028bcebec1b45...9dcac11bd72c7cb34ca278313f033efcdd4908eb,1,1,1,2,1,2010-06-29 20:29:27,2010-06-29 20:29:27
9dcac11bd72c7cb34ca278313f033efcdd4908eb...27aa3b67d43c2d862929c7a8c6f4b185b9dc790e,3,8,2,10,3,2010-06-29 22:19:41,2010-06-29 22:19:41
27aa3b67d43c2d862929c7a8c6f4b185b9dc790e...60a3995b7573a13ee699972c03edc0e9bd2adf76,1,1,1,2,1,2010-06-29 22:26:47,2010-06-29 22:26:47
60a3995b7573a13ee699972c03edc0e9bd2adf76...3ef75220fcb41f767a1868cf12a91baf975ff7e2,2,6,5,11,5,2010-06-30 03:57:51,2010-06-30 03:57:51
3ef75220fcb41f767a1868cf12a91baf975ff7e2...eb9efb78c7e94de6a6b0d3f6b131335e10922bc4,2,5,0,5,2,2010-07-01 14:22:40,2010-07-01 14:22:40
eb9efb78c7e94de6a6b0d3f6b131335e10922bc4...8d5f5b6002325c0d6ac537ffd28d39ce93a24441,3,42,1,43,6,2010-07-01 18:35:34,2010-07-01 18:35:34
8d5f5b6002325c0d6ac537ffd28d39ce93a24441...f07303e44fbfaab5d9eb014aaaec8cb3b64a4c48,1,3,0,3,1,2010-07-02 04:13:34,2010-07-02 04:13:34
f07303e44fbfaab5d9eb014aaaec8cb3b64a4c48...95be0b890674763aa69313d501df2a067f80eb68,1,9,17,26,9,2010-07-08 05:23:07,2010-07-07 20:12:16
95be0b890674763aa69313d501df2a067f80eb68...f793409815265d1c8d663af490ad2b670e67a26c,1,1,1,2,1,2010-07-09 16:56:35,2010-07-09 16:56:35
f793409815265d1c8d663af490ad2b670e67a26c...13a2ba57e5f49194e1367e07d24e16c7dffa741b,2,33,1,34,2,2010-07-12 20:29:32,2010-07-12 20:29:32
13a2ba57e5f49194e1367e07d24e16c7dffa741b...65b1a70858613b866440bcebbe6d2fb8f55ea1d4,1,2,1,3,2,2010-07-13 21:14:07,2010-07-13 21:14:07
65b1a70858613b866440bcebbe6d2fb8f55ea1d4...538e71eea1df905664a9b0d0427e35da133a98fd,1,9,0,9,2,2010-07-14 15:16:11,2010-07-14 15:12:59
538e71eea1df905664a9b0d0427e35da133a98fd...ede2c74ab4333ade62f1e476ab55c0f1df512e7d,1,1,1,2,1,2010-07-14 15:53:27,2010-07-14 15:50:42
ede2c74ab4333ade62f1e476ab55c0f1df512e7d...cc07aeceea73553e0ab36690031872a88f2ea975,1,2,0,2,1,2010-07-28 04:59:06,2010-07-28 04:55:58
cc07aeceea73553e0ab36690031872a88f2ea975...f93e19c34b1b62931d877b2b0ffb60e3027eecfd,1,4,0,4,1,2010-07-29 16:20:55,2010-07-29 16:20:55
f93e19c34b1b62931d877b2b0ffb60e3027eecfd...22f9a17983dba05e04f5004d1356f22d064e8182,1,1,1,2,1,2010-08-17 13:27:28,2010-08-17 13:27:28
22f9a17983dba05e04f5004d1356f22d064e8182...ccf35e6e8f2bffe56d37f9d7bff0458c154f9754,4,10,3,13,4,2010-08-30 14:40:12,2010-08-30 14:40:12
ccf35e6e8f2bffe56d37f9d7bff0458c154f9754...d58f9b867fdc7889221329eaa3296570fbd660a0,1,3,1,4,2,2010-08-30 14:50:24,2010-08-30 14:50:24
d58f9b867fdc7889221329eaa3296570fbd660a0...6013e9d536538ac26da62b5fd1d075ee3de4969e,1,1,1,2,1,2010-08-31 13:34:10,2010-08-31 13:34:10
faa7392e05ade88f151784b1a280e13ec6a53edd...e3731a1ed6c6c6c6927adbbc23bea63333de3a99,1,3,3,6,2,2010-03-18 22:06:40,2010-03-18 18:40:35
e3731a1ed6c6c6c6927adbbc23bea63333de3a99...d6d9d114f1d328f32e7bd9638cd52ea5bf3c4c91,3,81,1,82,6,2010-03-18 22:06:40,2010-03-18 18:49:25
d6d9d114f1d328f32e7bd9638cd52ea5bf3c4c91...26e947b4d3cf8fe6ce7fde8ce2296280d5591755,3,30,1,31,7,2010-03-18 22:08:30,2010-03-18 22:05:36
26e947b4d3cf8fe6ce7fde8ce2296280d5591755...f9d00c910683fa9aff316f543ab016f8b65ce200,1,2,2,4,2,2010-03-18 22:20:26,2010-03-18 22:20:26
18149f3c47b7c8b1b547184fc571640821e96224...31c93582892516f7cf379e25366160a4877b9fad,4,66,27,93,20,2010-03-26 19:30:29,2010-03-26 19:30:29
18149f3c47b7c8b1b547184fc571640821e96224...8c0333345a5205b8b390811eb248e8c359a2cc35,7,77,36,113,36,2010-03-26 18:37:31,2010-03-26 18:37:31
18149f3c47b7c8b1b547184fc571640821e96224...bdcd6683e7400db0d695a80104431204ee6b362a,1,1,1,2,1,2010-03-26 16:02:25,2010-03-26 16:02:25
7772cca678929c4cb701b166754c5d44b4c4d6a3...14e61fb61951ef3733027d05eb14cf981e03ee58,6,12,10,22,12,2010-03-25 19:42:11,2010-03-25 19:42:11
f9d00c910683fa9aff316f543ab016f8b65ce200...84b81af874b779b497741a8ea2bf59b13b70b8fb,1,2,2,4,2,2010-03-19 01:56:25,2010-03-19 01:56:25
84b81af874b779b497741a8ea2bf59b13b70b8fb...0358eae8999214c8b5dfc65f053b1ac5ff41b6e1,3,1,84,85,6,2010-03-19 01:59:23,2010-03-19 01:59:23
0358eae8999214c8b5dfc65f053b1ac5ff41b6e1...7a2722a92f11cb59aa64d3c43f6a41555c590f83,1,6,8,14,3,2010-03-19 02:47:40,2010-03-19 02:47:40
f9d00c910683fa9aff316f543ab016f8b65ce200...d3f56501c0bedf9136271c735e185ef97ed48902,2,4,5,9,5,2010-03-19 01:22:49,2010-03-19 01:22:49
9aacbdcdcf414909eeaa90ecbf1735619b7ff972...65d2ac74a81b3750cc0f432a403f7169f9897269,1,2,0,2,1,2010-03-26 20:33:12,2010-03-26 20:33:12
35b3e5c69c61c256a18e2865fd4bd1e08ad18ba8...07967c616d63dd07bf36982a8ba08b6f036b15c5,1,2,2,4,2,2010-03-26 20:48:27,2010-03-26 20:48:27
07967c616d63dd07bf36982a8ba08b6f036b15c5...d9b634eb10f03bfe9aa2255cefbd1557b3400892,1,3,2,5,3,2010-03-26 20:51:32,2010-03-26 20:51:32
d9b634eb10f03bfe9aa2255cefbd1557b3400892...7a2ba3526f3802a49e12320daeda8e77728fdace,3,9,4,13,4,2010-03-27 01:38:39,2010-03-27 01:38:39
7a2ba3526f3802a49e12320daeda8e77728fdace...c0f6cf1c906060b1634f86f206f2aa2e02e2addc,2,13,2,15,3,2010-03-27 03:32:14,2010-03-27 03:32:14
c0f6cf1c906060b1634f86f206f2aa2e02e2addc...2618026380918fd90d54aec4a5e586ffd6150aeb,1,2,2,4,2,2010-03-27 03:59:06,2010-03-27 03:59:06
2618026380918fd90d54aec4a5e586ffd6150aeb...b0d7248aabab936ca6eb15c2a0a57b5ef4c86758,2,11,15,26,4,2010-03-27 04:59:17,2010-03-27 04:59:17
b0d7248aabab936ca6eb15c2a0a57b5ef4c86758...f6f734e0020ffbdbdd2212c6cb9b7a746c7e1e62,1,2,2,4,2,2010-03-27 05:03:45,2010-03-27 05:03:45
f6f734e0020ffbdbdd2212c6cb9b7a746c7e1e62...e79f4a9710e42cf99edf6f41c4ccc908abfe2495,1,8,2,10,1,2010-03-27 05:11:43,2010-03-27 05:11:43
e79f4a9710e42cf99edf6f41c4ccc908abfe2495...aa0f581bf94eaf0493736980b83a32153c33911f,1,1,1,2,1,2010-03-27 05:17:32,2010-03-27 05:17:32
aa0f581bf94eaf0493736980b83a32153c33911f...e7282bd1eef05bbfc53ce1cef2ea2b504ff72b0a,1,1,1,2,1,2010-03-28 04:33:33,2010-03-28 04:33:33
e7282bd1eef05bbfc53ce1cef2ea2b504ff72b0a...21cdef341f37aad7eb711c969863e3046ae56270,1,9,3,12,4,2010-03-28 04:33:38,2010-03-28 04:33:38
aa0f581bf94eaf0493736980b83a32153c33911f...fe8cb18ecaed400f5ea309137abeb0f2abf0119b,2,7,5,12,6,2010-03-27 16:23:39,2010-03-27 16:23:39
fe8cb18ecaed400f5ea309137abeb0f2abf0119b...f05bae1a2d3a28a5ed7a77f6cb49f87ca5b94596,1,11,2,13,4,2010-03-27 16:37:38,2010-03-27 16:37:38
35d8abd1c422975853fb7f380133145cc82f5e9a...1ffe1df4233b04d269f2fd97e7e420bcdd8f5b1f,2,9,2,11,2,2010-03-28 21:15:27,2010-03-28 21:15:27
1ffe1df4233b04d269f2fd97e7e420bcdd8f5b1f...df6709a2da7ad46ee62ef337cde4421cd50c1584,2,14,15,29,12,2010-03-29 14:11:16,2010-03-29 14:11:16
df6709a2da7ad46ee62ef337cde4421cd50c1584...b5bc2adc903d10ef4c3818c079d94d77bd87d0df,1,4,1,5,2,2010-03-29 14:40:32,2010-03-29 14:40:32
b5bc2adc903d10ef4c3818c079d94d77bd87d0df...45f8d675d3dde087c0e171089aea319e223216d2,2,33,10,43,8,2010-03-29 15:24:00,2010-03-29 15:24:00
45f8d675d3dde087c0e171089aea319e223216d2...5b5d73a6529b95e47033e40dcebee01d9417ff7f,6,37,7,44,10,2010-03-29 16:55:44,2010-03-29 16:55:44
45f8d675d3dde087c0e171089aea319e223216d2...71e1d3442cc89b22fbeb71d07e945d6088284c71,1,11,11,22,6,2010-03-29 16:36:16,2010-03-29 16:36:16
0fb4491d143b8039104215a925c58d01806c2588...963ed6cd90c8b141d79a231626623de9dea4eb50,1,16,7,23,5,2010-03-29 17:07:45,2010-03-29 17:07:45
963ed6cd90c8b141d79a231626623de9dea4eb50...401bcd044ce2d5d69f70aeda48bf6040bb784e9a,1,0,2,2,1,2010-03-29 17:37:37,2010-03-29 17:37:37
401bcd044ce2d5d69f70aeda48bf6040bb784e9a...ec2e4eaf5a4bbf722058d443fea919f009669111,2,5,1,6,3,2010-03-29 21:14:50,2010-03-29 21:14:50
401bcd044ce2d5d69f70aeda48bf6040bb784e9a...90d73f012a17c72cd3a38356fda8516ebb5bf257,2,6,7,13,4,2010-03-29 17:49:32,2010-03-29 17:49:32
3c0f6e00cdc932a7fef8303f4b86e29b8241c124...e339760675f70ace6586aa7bb22f8f3cf898a9ff,1,1,1,2,1,2010-03-29 23:35:06,2010-03-29 23:35:06
90d73f012a17c72cd3a38356fda8516ebb5bf257...3e5a7a1d4484de6a8682cccc833bfd67119dab16,2,5,3,8,3,2010-03-29 23:00:14,2010-03-29 23:00:14
90d73f012a17c72cd3a38356fda8516ebb5bf257...cc315b96e6b64c0d9489fa59e61ac93492d6a562,1,36,50,86,4,2010-03-29 21:07:47,2010-03-29 20:23:34
cc315b96e6b64c0d9489fa59e61ac93492d6a562...03c08deb4437d2b958af6256c682f831b3dfb874,2,32,16,48,6,2010-03-29 21:08:58,2010-03-29 21:08:58
e339760675f70ace6586aa7bb22f8f3cf898a9ff...19e879c5091fa43870751527d773b9864e50efb9,1,4,4,8,3,2010-03-30 05:52:17,2010-03-30 05:52:17
e339760675f70ace6586aa7bb22f8f3cf898a9ff...4d90a98d69e103c77302b8c05850e3a6566cc4c4,1,29,6,35,7,2010-03-30 00:25:44,2010-03-30 00:17:10
4d90a98d69e103c77302b8c05850e3a6566cc4c4...9387e8b60417b967eb59f73d8941614d1d08b553,1,55,7,62,8,2010-03-30 04:03:41,2010-03-30 04:03:41
ff0f3b2bd7e5ac4740889fa72d4111afa2aaf6a6...977765e76de90e96a8b8cd10f1744c295710c9c3,1,1,1,2,1,2010-03-30 06:24:13,2010-03-30 06:24:13
977765e76de90e96a8b8cd10f1744c295710c9c3...6b34772e70881e9d8e8dbeeae3ef00996497d027,1,60,0,60,1,2010-03-30 15:00:16,2010-03-30 15:00:16
6b34772e70881e9d8e8dbeeae3ef00996497d027...81bba7795eab74d2737b038a94ae4b9f26854611,1,113,49,162,20,2010-03-30 15:01:02,2010-03-30 15:01:02
977765e76de90e96a8b8cd10f1744c295710c9c3...f70df5352bc60cc31901d27c8c59ae2d0006f3da,3,8,9,17,10,2010-03-30 14:11:28,2010-03-30 14:11:28
8cfdca9d3ffae661a633ea468403a9b9cd437183...b0a3df820cdb66fd26ecea2e4e440b5a5bf47dbd,7,47,9,56,18,2010-04-07 23:29:56,2010-04-07 23:29:56
b0a3df820cdb66fd26ecea2e4e440b5a5bf47dbd...c90c1797547dec6d8a9d7b4ed89829fe8afb23c9,1,2,2,4,2,2010-04-08 00:09:20,2010-04-08 00:09:20
c90c1797547dec6d8a9d7b4ed89829fe8afb23c9...e621ebc91ceb60e8143f5e2429e861a6b4d63a48,1,20,0,20,1,2010-04-08 04:08:27,2010-04-08 04:08:27
baf89bf596c1104cf6a118ad4b3ed955df54a878...0c6a7ac3ddf5b8226301d8754c0c4ac466dd90ce,1,5,0,5,2,2010-03-30 17:27:40,2010-03-30 17:27:40
baf89bf596c1104cf6a118ad4b3ed955df54a878...a050b7a0a81b0e74a1b6261a911bb686aca3d652,2,15,2,17,3,2010-03-30 15:56:37,2010-03-30 00:41:57
e621ebc91ceb60e8143f5e2429e861a6b4d63a48...0f946e0f983345c24b435eaefb5060ecd031ade4,1,1,1,2,1,2010-04-08 04:24:24,2010-04-08 04:24:24
e621ebc91ceb60e8143f5e2429e861a6b4d63a48...6e68fe7d70cc77ce253cd16838787a31af7ca589,4,12,4,16,6,2010-04-08 04:08:56,2010-04-07 19:45:41
6e68fe7d70cc77ce253cd16838787a31af7ca589...49dc591f5d7f1889e3451aca31b0a7daf73473f4,3,42,63,105,8,2010-04-08 04:08:57,2010-04-08 03:02:18
49dc591f5d7f1889e3451aca31b0a7daf73473f4...e6ca10ed6dd063d037d33b54c5dccd07f634ca64,1,3,0,3,1,2010-04-08 04:17:12,2010-04-08 04:17:12
e6ca10ed6dd063d037d33b54c5dccd07f634ca64...005a87caf13faacc49b865f3742f00a072e612b9,1,2,2,4,1,2010-04-08 04:19:48,2010-04-08 04:19:48
c2797cbbadb990dea27ed8117a87021f200bc4ae...11129084912c11925568dd3957174c04151368df,1,4,0,4,1,2010-03-30 17:28:30,2010-03-30 17:28:30
c85e1313879535a33a4e818716f55bbe0e6a4cb1...ae8e216f44d4024159cb7f3c6e39bcc5ca815c6c,1,2,1,3,2,2010-04-08 04:29:47,2010-04-08 04:29:41
ae8e216f44d4024159cb7f3c6e39bcc5ca815c6c...60d44a675a8f11cb7d9b70b7ac8bc457baa0c3ca,1,1,1,2,1,2010-04-08 05:04:51,2010-04-08 05:04:51
60d44a675a8f11cb7d9b70b7ac8bc457baa0c3ca...5cad0d6a80c2b94e877f56bc7f67b3ce825ee094,2,4,1,5,2,2010-04-08 05:44:33,2010-04-08 05:44:33
11129084912c11925568dd3957174c04151368df...5085e409181bc3ef50732a28eae5ccd8f703a969,1,1,1,2,1,2010-03-30 17:53:20,2010-03-30 17:53:20
11129084912c11925568dd3957174c04151368df...67d7d7936b0b961791db2cb19470dceb64de69ef,1,2,2,4,1,2010-03-30 17:48:47,2010-03-30 17:48:47
5cad0d6a80c2b94e877f56bc7f67b3ce825ee094...05a16ff3dd14df0f2f47c799912d7a55d83e8dee,1,57,18,75,3,2010-04-08 14:21:58,2010-04-08 14:20:26
05a16ff3dd14df0f2f47c799912d7a55d83e8dee...06f0c91b87e62ccaafd65c0f59a5c6f368f0fb2f,5,11,4,15,5,2010-04-08 14:57:05,2010-04-08 14:57:05
06f0c91b87e62ccaafd65c0f59a5c6f368f0fb2f...2c284c7aa7658a6a8a918cf67056e66710d9ce8b,1,3,4,7,2,2010-04-08 17:24:08,2010-04-08 17:24:08
2c284c7aa7658a6a8a918cf67056e66710d9ce8b...1ef1d7d2c5d629cdafbe5ca881749f3eaf792222,2,2,0,2,2,2010-04-08 17:27:14,2010-04-08 17:27:14
1ef1d7d2c5d629cdafbe5ca881749f3eaf792222...8f4a76a88819e2dd76da9074132cd75c7330feec,1,2,1,3,1,2010-04-08 17:31:36,2010-04-08 17:31:36
8f4a76a88819e2dd76da9074132cd75c7330feec...93b3a2e00841e28d85dc916bcef392a02cb24f11,1,1,1,2,1,2010-04-08 18:12:00,2010-04-08 18:12:00
93b3a2e00841e28d85dc916bcef392a02cb24f11...6378b9da4ce466f21dfda1bbe675b517d474fc58,3,16,11,27,6,2010-04-08 18:25:06,2010-04-08 18:20:52
6378b9da4ce466f21dfda1bbe675b517d474fc58...19da03b95eae7cfc4cadcd8dcb2ad7d46a94c389,1,2,1,3,2,2010-04-08 18:59:50,2010-04-08 18:59:50
4be521e22d075db6617b2b2cd4adc4f419e77b48...2c7c558cf8995874279a5b6362ac6e375491b5a4,2,19,0,19,2,2010-03-30 18:58:21,2010-03-30 18:58:21
2c7c558cf8995874279a5b6362ac6e375491b5a4...093c24fdd040ae5003b2ce26492fbd79a6de36a2,1,5,2,7,1,2010-03-30 18:59:45,2010-03-30 18:59:45
67d7d7936b0b961791db2cb19470dceb64de69ef...6451237c29f12d57376831680ac6939adb5e1ebb,1,4,2,6,2,2010-03-30 18:31:57,2010-03-30 18:31:57
6451237c29f12d57376831680ac6939adb5e1ebb...20775488957dcfba22d23676f1807f09ec317122,5,169,7,176,18,2010-03-30 18:32:15,2010-03-30 18:32:15
67d7d7936b0b961791db2cb19470dceb64de69ef...7e60b2d432d3718e12fa6d95f080f6f8825e122e,1,25,4,29,9,2010-03-30 17:50:54,2010-03-30 17:50:54
19da03b95eae7cfc4cadcd8dcb2ad7d46a94c389...0efadc48e9da3259765126e035aa33e2cdf0afdd,7,25,3,28,12,2010-04-08 19:15:35,2010-04-08 19:14:38
ec721d26e0ca3fe324ae5e67f54b87f6714abe4a...1b0b94cb9cb43421f93e5121d9c9c5402756a729,7,157,124,281,38,2010-04-08 19:14:20,2010-04-08 19:14:20
310e55c122b74a5f24aafd2f0b4c8d8c36178b38...799d94ad698d04464b7db9ab51853f0c5136e9c1,1,1,1,2,1,2010-03-30 20:45:57,2010-03-30 20:45:57
799d94ad698d04464b7db9ab51853f0c5136e9c1...9b9f820fb3b114e7ca3e62a7023c78fd102b9665,1,1,0,1,1,2010-03-30 20:48:15,2010-03-30 20:48:15
9b9f820fb3b114e7ca3e62a7023c78fd102b9665...ea8c66809211a667cb30b0ef97175c030f8170f3,1,1,3,4,1,2010-03-30 21:18:34,2010-03-30 21:18:34
ea8c66809211a667cb30b0ef97175c030f8170f3...ba3934e273a912a39afc506508da590b30438771,2,14,12,26,10,2010-03-30 21:19:33,2010-03-30 21:19:33
c790fe6b8217c8cf2ad785357a8c117082539354...f078b67f187fa99d3f18e007169662e5b621bf02,3,18,2,20,7,2010-03-30 19:20:22,2010-03-30 19:20:22
0efadc48e9da3259765126e035aa33e2cdf0afdd...48d2acc0de66704bce7fc20ca1f50cdf5c522a80,4,16,10,26,5,2010-04-08 19:26:12,2010-04-08 19:26:12
0efadc48e9da3259765126e035aa33e2cdf0afdd...f06d17a35b4eeae2c45245c7510349401f388eb9,1,2,2,4,2,2010-04-08 19:24:59,2010-04-08 19:24:59
49334953eac73bfaf0b87b734ba9f80c05c0df4a...3a2d0e8741970c2aef5cc67aadbcad041d9a6dee,1,3,1,4,1,2010-03-30 21:46:53,2010-03-30 21:46:53
3a2d0e8741970c2aef5cc67aadbcad041d9a6dee...bfad8be6ba3161739759bf136e1515251d941cd5,1,1,0,1,1,2010-03-30 21:49:41,2010-03-30 21:49:41
bfad8be6ba3161739759bf136e1515251d941cd5...691de0d1ba21a0b53a17684414021c709eda7c2d,1,0,8,8,4,2010-03-30 22:04:54,2010-03-30 22:04:54
691de0d1ba21a0b53a17684414021c709eda7c2d...18d01a0c606bd81029d4f4ef7084d80e9e87ffe1,1,3,1,4,1,2010-03-31 03:37:45,2010-03-31 03:37:45
18d01a0c606bd81029d4f4ef7084d80e9e87ffe1...5dd8290ecbb8a06ce3fbcc43e917818d36477db6,1,0,3,3,1,2010-03-31 04:11:17,2010-03-31 04:11:17
afbb75acbec9896306755a651f65a9082b0e352a...253462a33883162f10cd3bdadade0b0a7cbd44f6,1,14,0,14,2,2010-03-30 19:43:23,2010-03-30 19:43:23
253462a33883162f10cd3bdadade0b0a7cbd44f6...7b69199a3760840ffefed21f15e60c6ccba52e03,1,1,1,2,1,2010-03-30 21:07:07,2010-03-30 21:07:07
c8c9e0e1943afc9c9e91a35c204e9c7bb42f1ee3...5a235ba8f6477b8c20a943303a6c9c002e1505a5,1,7,0,7,2,2010-04-08 19:58:36,2010-04-08 19:58:36
5a235ba8f6477b8c20a943303a6c9c002e1505a5...89e671b0a262ad71141c87a4f80c0b286b56451d,1,4,0,4,1,2010-04-08 19:58:49,2010-04-08 19:57:40
1007c905b02d7ed456fa5c4b2dfae99ab18c175a...30c91f9d0615218f0b81addf60c7e08ed20a589a,1,2,2,4,2,2010-04-08 20:47:13,2010-04-08 20:47:13
30c91f9d0615218f0b81addf60c7e08ed20a589a...c4769e9f86b2cd256aca1276ece362f3795a1ee8,2,54,17,71,17,2010-04-08 21:43:30,2010-04-08 21:43:30
c4769e9f86b2cd256aca1276ece362f3795a1ee8...dfa0c41aa11ae1d97576e1b72180f0a398d4894a,2,11,6,17,7,2010-04-08 23:57:48,2010-04-08 22:42:48
dfa0c41aa11ae1d97576e1b72180f0a398d4894a...dff285ac2d20b1783a38ba25c6a67435897f77f2,1,4,2,6,1,2010-04-09 01:40:28,2010-04-09 01:40:28
dff285ac2d20b1783a38ba25c6a67435897f77f2...41d92fdeaf8bee4136ea060409d6a549b266a1de,1,1,1,2,1,2010-04-09 17:17:41,2010-04-09 17:17:41
41d92fdeaf8bee4136ea060409d6a549b266a1de...f528f30c4fb604600f24d227c1c57e5c7bbfd191,2,3,1,4,2,2010-04-09 18:32:24,2010-04-09 18:32:24
f528f30c4fb604600f24d227c1c57e5c7bbfd191...217860f1f19b1d976ebac1a3c4f1ade7468b4431,2,6,2,8,2,2010-04-10 06:36:30,2010-04-10 06:36:30
217860f1f19b1d976ebac1a3c4f1ade7468b4431...850c918878b119abb9b4b6dbe1ac0a02153a047b,4,23,18,41,19,2010-04-10 20:14:46,2010-04-10 20:14:46
850c918878b119abb9b4b6dbe1ac0a02153a047b...db772a7ee6257a0d8b86a0e2de107c9ac7d1d1e1,1,6,6,12,6,2010-04-11 01:18:38,2010-04-11 01:18:38
db772a7ee6257a0d8b86a0e2de107c9ac7d1d1e1...ebf2ab9607c5ae65f2e4db206dc1ce7462716384,2,55,1,56,4,2010-04-12 02:18:04,2010-04-12 02:18:04
ebf2ab9607c5ae65f2e4db206dc1ce7462716384...a1f1b3e9aedf1c618b788362da79c038651689b0,1,3,3,6,3,2010-04-12 02:29:34,2010-04-12 02:29:34
a1f1b3e9aedf1c618b788362da79c038651689b0...06f1acf530a5b1b0ef72f88432c96945cf1d0d8b,1,5,5,10,5,2010-04-12 02:37:17,2010-04-12 02:37:17
06f1acf530a5b1b0ef72f88432c96945cf1d0d8b...230e8cae8bacc9bd3e8bbe45aff713a9268ca81a,1,1,1,2,1,2010-04-12 14:46:13,2010-04-12 14:46:13
230e8cae8bacc9bd3e8bbe45aff713a9268ca81a...0a1bed6f5e5931b7c8d035101500605922924375,1,5,1,6,1,2010-04-12 14:57:58,2010-04-12 14:57:58
0a1bed6f5e5931b7c8d035101500605922924375...a5139bcff6154e0ef16f9db660f0cbba8989a337,1,2,0,2,2,2010-04-12 19:34:51,2010-04-12 19:34:51
5dd8290ecbb8a06ce3fbcc43e917818d36477db6...60a659e6417fa6113628d952e8d4a3b23b50ee16,5,67,28,95,29,2010-03-31 16:45:40,2010-03-31 16:45:40
5dd8290ecbb8a06ce3fbcc43e917818d36477db6...8eb65b02fb3eb8cc361df1ef1eb54a8f8e09ab40,1,1,0,1,1,2010-03-31 14:27:37,2010-03-31 14:27:37
8eb65b02fb3eb8cc361df1ef1eb54a8f8e09ab40...d8e56af586c6445682e4ce8bf49751fb731176ca,7,13,5,18,9,2010-03-31 15:57:27,2010-03-31 15:57:27
d8e56af586c6445682e4ce8bf49751fb731176ca...c91e3ba45682d429da827ebcbbbb325511b2919a,4,25,18,43,8,2010-03-31 16:27:10,2010-03-31 16:27:10
a5139bcff6154e0ef16f9db660f0cbba8989a337...ffcd9ad93685a34d66fbe386b5c243c957a806b8,11,110,60,170,14,2010-04-13 17:22:42,2010-04-13 17:22:42
a5139bcff6154e0ef16f9db660f0cbba8989a337...d137e9c4fa1fe38ee54b47463947ff1fc4eb291e,1,4,2,6,2,2010-04-12 21:57:15,2010-04-12 21:57:15
d137e9c4fa1fe38ee54b47463947ff1fc4eb291e...6d21546c9da76c317a955a5ecd3d5066d14d17eb,1,1,1,2,1,2010-04-13 00:47:58,2010-04-13 00:47:58
6d21546c9da76c317a955a5ecd3d5066d14d17eb...43f94b12180b3be3852a7e930077f1500b349e13,1,1,0,1,1,2010-04-13 00:48:15,2010-04-13 00:48:15
43f94b12180b3be3852a7e930077f1500b349e13...12a6aecb300ccf53869f6b8ad1437b963934ff90,3,30,0,30,5,2010-04-13 00:48:55,2010-04-13 00:48:55
12a6aecb300ccf53869f6b8ad1437b963934ff90...2c64f5c758ed0c96e32eb785835a8916b3f6cf58,1,47,0,47,1,2010-04-13 00:49:13,2010-04-13 00:49:13
2c64f5c758ed0c96e32eb785835a8916b3f6cf58...2e64af288eda9eeee586576c7a2e714766d2e2ac,1,1,0,1,1,2010-04-13 00:50:48,2010-04-13 00:50:48
2e64af288eda9eeee586576c7a2e714766d2e2ac...b2830ef27082e653e58d7fc6f12743aa6eb9ee82,1,1,1,2,1,2010-04-13 00:55:39,2010-04-13 00:55:39
a4db903faa72bf83b92f5c81537f63db2e5335b8...4778a2c4add21e0696877c884ba4fd88c52cedf6,5,16,15,31,12,2010-03-31 19:08:40,2010-03-31 19:08:40
c91e3ba45682d429da827ebcbbbb325511b2919a...e8583f2a6b9206fadcd7baa98b9328dffad291ae,2,125,73,198,9,2010-03-31 18:33:49,2010-03-31 18:33:49
b2830ef27082e653e58d7fc6f12743aa6eb9ee82...41d65a81f9e0b04e80ee435c81d909c7c4b6fe98,1,12,3,15,3,2010-04-13 18:24:18,2010-04-13 18:24:18
41d65a81f9e0b04e80ee435c81d909c7c4b6fe98...9ff79142507703a0bb0cd8233233a9c022d43a59,4,95,20,115,11,2010-04-13 22:17:34,2010-04-13 22:17:34
b2830ef27082e653e58d7fc6f12743aa6eb9ee82...1ef66b2155a4bf33d2434eaab360fa64334a65e0,1,3,1,4,1,2010-04-13 03:08:29,2010-04-12 18:45:44
1ef66b2155a4bf33d2434eaab360fa64334a65e0...bc63a3f9c7e3add53e5e86f3041a3d4825ff3c82,2,43,7,50,6,2010-04-13 03:08:30,2010-04-13 03:04:03
bc63a3f9c7e3add53e5e86f3041a3d4825ff3c82...14910098cb4bd05af3dd67431d4ac73f9889ac2f,1,1,1,2,1,2010-04-13 03:34:00,2010-04-13 03:34:00
14910098cb4bd05af3dd67431d4ac73f9889ac2f...4cde3da0f514a21aa63a380da209b4cd22f57a53,2,1,98,99,7,2010-04-13 04:10:55,2010-04-13 04:10:55
4cde3da0f514a21aa63a380da209b4cd22f57a53...ac321ab2595d1de4601cdd8f3b1b19110109e9da,7,220,158,378,9,2010-04-13 15:45:01,2010-04-13 15:45:01
9fcf53a7df09c6bf65b16215e46b8acd54ec3b35...3cb1ef8cd9d619a70560794d3d88d5cce4bd8779,6,15,17,32,12,2010-03-31 19:49:28,2010-03-31 19:49:28
3cb1ef8cd9d619a70560794d3d88d5cce4bd8779...8657d88065db9d5ff600fb76bea83cc2a8b81262,3,8,6,14,7,2010-03-31 20:21:20,2010-03-31 20:21:20
8657d88065db9d5ff600fb76bea83cc2a8b81262...1f655abccbc34708e14f7c90b35627d4f112a283,4,8,3,11,5,2010-03-31 20:39:43,2010-03-31 20:39:43
1f655abccbc34708e14f7c90b35627d4f112a283...58821896fbdde29ca0f4e87e9191670f8d66c1b2,1,20,13,33,1,2010-04-01 14:19:38,2010-04-01 14:19:38
1f4c6e822f723055eb30275263ad5cbc3764f726...440388c0de9c4324e7eb7d507c034d7ef7d68866,2,2,6,8,2,2010-03-31 18:44:11,2010-03-31 18:44:11
e54c7290f5d4e7cba84c2ac6a215913b13ffde95...cea03ac9158128d229f376ea263940212cf16f6c,4,247,201,448,15,2010-04-13 20:13:18,2010-04-13 20:13:18
6d0c5735f07e909a0431d0ff168ddbc3e2651567...948256f3df6a50d3261cc789309a9f93f80ac25f,1,1,1,2,1,2010-04-13 22:27:53,2010-04-13 22:27:53
ac321ab2595d1de4601cdd8f3b1b19110109e9da...0f0959515451284f4cb63f5b50b68b6c876a1591,7,454,388,842,15,2010-04-13 17:50:09,2010-04-13 17:50:09
ac321ab2595d1de4601cdd8f3b1b19110109e9da...b346c424be729f64cb69a8e1806c4bf53894857f,1,3,0,3,1,2010-04-13 15:55:06,2010-04-13 15:55:06
58821896fbdde29ca0f4e87e9191670f8d66c1b2...1e3abf89b90bef04b0d8ce601a60860dc31c632a,2,21,6,27,7,2010-04-01 19:32:52,2010-04-01 19:32:52
58821896fbdde29ca0f4e87e9191670f8d66c1b2...2cc5eb12144a8912891ff1b8d5a9f432dcb9ffff,1,1,0,1,1,2010-04-01 15:50:49,2010-04-01 15:50:49
cea03ac9158128d229f376ea263940212cf16f6c...b4ca3766a6043c80484f4adbed3c0bad15392461,1,0,3,3,1,2010-04-13 21:23:53,2010-04-13 21:23:53
cea03ac9158128d229f376ea263940212cf16f6c...46495f0510d76c3f799a4d364b6852f810e20e40,2,39,3,42,6,2010-04-13 21:21:45,2010-04-13 21:21:45
948256f3df6a50d3261cc789309a9f93f80ac25f...51daf493a177247bfd065956d69dc6aa853ca1dd,4,112,14,126,9,2010-04-27 00:22:33,2010-04-27 00:22:33
948256f3df6a50d3261cc789309a9f93f80ac25f...5514fc44732e605edfaf00cbc40d82df1db020b6,1,1,1,2,1,2010-04-14 00:56:43,2010-04-13 19:35:12
5514fc44732e605edfaf00cbc40d82df1db020b6...4c0481213f19b43d44707f81dac2537a80ab71d5,2,42,1,43,2,2010-04-14 01:02:45,2010-04-14 00:53:48
4c0481213f19b43d44707f81dac2537a80ab71d5...58c3c7857a2f143ef6cb283836fa2707e95d9c7b,1,2,0,2,1,2010-04-14 01:05:55,2010-04-14 01:05:55
58c3c7857a2f143ef6cb283836fa2707e95d9c7b...949b5c8b214637979e63fb9ea4214304cb64da63,1,3,3,6,1,2010-04-14 02:55:53,2010-04-14 02:55:53
949b5c8b214637979e63fb9ea4214304cb64da63...fc486ef3658020f87eb53ab3c03586026d71f937,1,5,4,9,2,2010-04-14 14:35:29,2010-04-14 14:35:29
fc486ef3658020f87eb53ab3c03586026d71f937...8bed26cdf8bf906076f6f5ad8c88431d370f58bf,4,31,8,39,14,2010-04-14 17:46:54,2010-04-14 17:46:54
8bed26cdf8bf906076f6f5ad8c88431d370f58bf...b0eb9fff8347787e97ee924b2bfda71da8ae9ec8,2,17,36,53,17,2010-04-14 17:57:51,2010-04-14 17:57:51
552fe0fc2c60202e3a437e3c37a9347b68533941...61ae5fa244e5a38b1778d2bd8df21211b0edcfd1,12,573,408,981,34,2010-04-13 19:23:57,2010-04-13 19:23:57
552fe0fc2c60202e3a437e3c37a9347b68533941...ec00b8f650a042a682da43ed29137d3303eac5b4,1,1,1,2,1,2010-04-13 18:29:27,2010-04-13 18:29:27
b346c424be729f64cb69a8e1806c4bf53894857f...07335af80d091e51bb3156fbe67fb94f1d5fea88,1,2,1,3,1,2010-04-13 17:24:37,2010-04-13 17:24:37
d42bd9af1c42d40410dae91da1327258f06ce925...9c8fa4b93548c6c6e1113e9b66d2400e3eacfdd1,5,16,3,19,6,2010-04-01 21:17:32,2010-04-01 21:17:32
d42bd9af1c42d40410dae91da1327258f06ce925...3a252136550aa3a0dd2d4e774efedfa951029c98,2,15,4,19,10,2010-04-01 19:41:13,2010-03-31 18:45:15
3a252136550aa3a0dd2d4e774efedfa951029c98...12fa9864c4c95c2b95c2b0e62ce3f96d2d40f62b,1,2,0,2,1,2010-04-01 19:41:13,2010-04-01 19:40:45
b4ca3766a6043c80484f4adbed3c0bad15392461...e70082b29e75003f4af4c15610eb368314263269,1,11,0,11,1,2010-04-13 21:28:39,2010-04-13 21:28:39
e70082b29e75003f4af4c15610eb368314263269...26b81130ce3009c4d3de8cf70f03fc6232b2bc07,1,7,1,8,4,2010-04-13 21:28:46,2010-04-13 21:28:46
0b6270f0422e42c699a10db99f6aa74f0bb5888f...b86409926897d71934f769762cd7bdb97c86512a,1,317,1,318,5,2010-04-13 21:30:50,2010-04-13 21:30:50
45048fa94fca9f86484357fb80399d9fbb51f1fd...ccb496081ec1bbe05ea8e0e9e8d9c7ac59f5e7b5,1,3,3,6,2,2010-04-27 00:24:40,2010-04-27 00:24:40
b0eb9fff8347787e97ee924b2bfda71da8ae9ec8...35f91394cc5f4a2579eb3f97881d48af10ac2b1a,4,47,6,53,11,2010-04-14 20:15:57,2010-04-14 20:15:57
35f91394cc5f4a2579eb3f97881d48af10ac2b1a...e2db25b8548af63e98ab677ef4262b0174d216f2,1,1,0,1,1,2010-04-14 20:37:29,2010-04-14 20:37:29
34eddc3b5fcb93651c6475767efc23603d597e77...3b59851a13186f39fef039864dadb742095ec985,2,42,0,42,5,2010-04-02 15:29:33,2010-04-02 15:29:33
3b59851a13186f39fef039864dadb742095ec985...8ecaf5dc18d0f0a1cf51b8833b913a5c3a23a446,5,97,17,114,16,2010-04-02 15:29:45,2010-04-02 15:29:45
12fa9864c4c95c2b95c2b0e62ce3f96d2d40f62b...666fb52bdd835e549fac7d91db8cd1ab60870993,2,67,56,123,19,2010-04-02 15:28:32,2010-04-02 15:28:32
9708f109462bd0c95571012e6af6289797233d88...00c7d95126eb12c9e0884a7a7e5d44a46c32889b,2,35,0,35,3,2010-04-13 21:38:15,2010-04-13 21:38:15
00c7d95126eb12c9e0884a7a7e5d44a46c32889b...3d207f88b8c39e79d4a9ed17b1ebb84780da429c,1,4,0,4,1,2010-04-13 21:39:05,2010-04-13 21:39:05
3d207f88b8c39e79d4a9ed17b1ebb84780da429c...8228c6f329e0a3179f0c5099fb4d9a9140093157,1,8,2,10,3,2010-04-13 21:40:49,2010-04-13 21:40:49
e1cfc5d676ce4f546e5079ceef7acdc4a3e471e0...5f13e864d7f514c7e5d1e3574ea086c2bf96b4cc,7,104,9,113,14,2010-04-27 07:33:35,2010-04-27 07:33:35
e1cfc5d676ce4f546e5079ceef7acdc4a3e471e0...ae424605393d82fb9349b0f3bf95a4d72e56938c,1,3,8,11,4,2010-04-27 00:58:41,2010-04-27 00:58:41
ae424605393d82fb9349b0f3bf95a4d72e56938c...e9561a49e941cfe5b993488522ba3add63be438a,1,1,1,2,1,2010-04-27 01:16:57,2010-04-27 01:16:57
e9561a49e941cfe5b993488522ba3add63be438a...0d21a119d228fa04b237665a0df503fd334b8f42,3,207,3,210,28,2010-04-27 01:29:08,2010-04-27 01:29:08
e2db25b8548af63e98ab677ef4262b0174d216f2...4caad722e7f42505e2c80ce6308d97dd20a8fd15,2,4,1,5,2,2010-04-15 14:15:10,2010-04-15 14:15:10
bf81a950fc3c5001b941328bba97cc9089a6da92...0cd71edbc2a44669a6a82fe076f5d36bffbe8b5e,7,115,8,123,13,2010-04-14 21:25:03,2010-04-14 21:25:03
0cd71edbc2a44669a6a82fe076f5d36bffbe8b5e...848e45aa4126c1cb9482ca6a7bed62d193046062,3,48,1,49,3,2010-04-14 21:30:23,2010-04-14 21:30:23
091c922b03f08b84b5d38dfb4be187557b2b1e7f...d1138e570e16f658e28fa54bbcc47f47d653657e,1,8,7,15,6,2010-04-02 20:43:10,2010-04-02 20:43:10
091c922b03f08b84b5d38dfb4be187557b2b1e7f...36acf154d5e31c0ccd54dc95099cf5d607cca571,1,0,1,1,1,2010-04-02 16:56:11,2010-04-02 16:56:11
36acf154d5e31c0ccd54dc95099cf5d607cca571...5645c80f94fb267eed2c81393f59bdc494d763a4,7,40,22,62,18,2010-04-02 17:18:06,2010-04-02 17:18:06
8228c6f329e0a3179f0c5099fb4d9a9140093157...5d4a1068fba92a9c175969f5687d75fc9c3c1db3,1,1,0,1,1,2010-04-14 18:57:04,2010-04-14 18:57:04
fb7a84b79132da8d919c4022fb85f48bc1e3d6df...01127481178d2688f8f32fbc8b14b5fa7cfacc3c,1,1,1,2,1,2010-04-27 07:52:21,2010-04-27 07:52:21
0d21a119d228fa04b237665a0df503fd334b8f42...6e852cd109a9b07fda0c060241bf57bb19a799c1,2,5,5,10,4,2010-04-27 12:40:17,2010-04-27 12:40:17
0d21a119d228fa04b237665a0df503fd334b8f42...3cbdcddd136c3c92986c4393210364273529a129,1,18,0,18,1,2010-04-27 04:24:12,2010-04-27 04:24:12
3cbdcddd136c3c92986c4393210364273529a129...a16d4d1159568fcdbbb22ed9f009ef89cf820325,1,1,1,2,1,2010-04-27 04:24:33,2010-04-27 04:24:33
c4d44e49fb1e14b55afb32a88e825fd7f609f80f...d72a7fcfcaf4e14d837f07b3b8205a9f19543f91,5,61,7,68,12,2010-04-15 14:59:13,2010-04-15 14:59:13
d72a7fcfcaf4e14d837f07b3b8205a9f19543f91...550f0209728c7010e7223cc757046ac152a3513b,1,4,1,5,1,2010-04-15 15:49:16,2010-04-15 15:49:16
550f0209728c7010e7223cc757046ac152a3513b...8e50585bcf216a4210162f0a3b72aa2a38e61228,3,13,7,20,6,2010-04-15 16:20:21,2010-04-15 16:20:21
aaab74fdb9b565c5e2a81187e99862573a7f58c2...1153865ebfb16339f7c7122f4d79d4159419320c,1,0,11,11,1,2010-04-14 23:53:28,2010-04-14 19:09:42
1153865ebfb16339f7c7122f4d79d4159419320c...0cae84589ef3c20a8c2ffbf09a5e1fe27ebbb3e9,3,38,0,38,4,2010-04-14 23:53:28,2010-04-14 19:31:00
0cae84589ef3c20a8c2ffbf09a5e1fe27ebbb3e9...7e25fdb8e8fd9e080e62a6a86c1804699f3119f7,3,38,2,40,6,2010-04-14 23:53:28,2010-04-14 23:52:21
7e25fdb8e8fd9e080e62a6a86c1804699f3119f7...037511f6ef0d8bbc13cf643465e144b84d12200c,4,54,54,108,4,2010-04-15 00:31:44,2010-04-15 00:31:44
ff23d77d0759fc081f45c670f32d3c8b5204ee24...3f6871c96d09ecbde2d501c040ef0bdfac6b5ef6,1,64,11,75,9,2010-04-02 23:26:13,2010-04-02 21:51:10
3f6871c96d09ecbde2d501c040ef0bdfac6b5ef6...b6744bbde64118b5debde40c5c1108c49f7b032c,3,4,4,8,4,2010-04-02 23:26:13,2010-04-02 22:13:36
b6744bbde64118b5debde40c5c1108c49f7b032c...a9382d41f040d362b60848e9962c177ea17ba155,4,29,10,39,6,2010-04-02 23:26:13,2010-04-02 23:24:59
a9382d41f040d362b60848e9962c177ea17ba155...4cd861085b6f015444204290fa4c34f84d41be9e,1,1,0,1,1,2010-04-02 23:37:43,2010-04-02 23:37:43
4cd861085b6f015444204290fa4c34f84d41be9e...c8480344eeb8e7a63772f685fe363a705b9f6749,2,6,0,6,2,2010-04-03 00:09:56,2010-04-03 00:04:56
c8480344eeb8e7a63772f685fe363a705b9f6749...ec5293b1cea2e941161b1a640089ee54244fe56d,1,1,1,2,1,2010-04-03 00:24:08,2010-04-03 00:24:08
ec5293b1cea2e941161b1a640089ee54244fe56d...06d8b84a13e68e28a37a4c4977c983c9e90b4c5a,1,7,2,9,7,2010-04-03 01:26:57,2010-04-03 01:26:57
06d8b84a13e68e28a37a4c4977c983c9e90b4c5a...5a3085296134dd75fe32397efd2752663a7e9ec9,1,1,1,2,2,2010-04-03 01:28:55,2010-04-03 01:28:55
5a3085296134dd75fe32397efd2752663a7e9ec9...aa3c941f93689ecac4fccf91f10f927d8f4b858e,1,4,1,5,1,2010-04-04 01:08:04,2010-04-04 01:08:04
aa3c941f93689ecac4fccf91f10f927d8f4b858e...f59b5173eaea8e7c312eba3efb7de41376e3a18f,2,53,1,54,4,2010-04-04 01:15:00,2010-04-04 01:15:00
f59b5173eaea8e7c312eba3efb7de41376e3a18f...d9d76cf2d50321ff2ee3b3f65e78a5df5269e63a,1,11,0,11,1,2010-04-04 15:36:33,2010-04-04 15:36:33
d9d76cf2d50321ff2ee3b3f65e78a5df5269e63a...163c040888f582c50edae42e56964084248fe918,5,30,72,102,17,2010-04-05 14:52:38,2010-04-05 12:57:44
163c040888f582c50edae42e56964084248fe918...61e921730c9c22faf4059e85df88c99f32d625ec,5,3,5,8,5,2010-04-05 14:52:38,2010-04-05 13:12:25
61e921730c9c22faf4059e85df88c99f32d625ec...abfa039e2245c1e3b9319c6552c69d55d567756a,2,88,85,173,5,2010-04-05 14:52:38,2010-04-05 13:51:03
abfa039e2245c1e3b9319c6552c69d55d567756a...66a489efcc17fef2239029f1002f00df6886d7ea,6,11,25,36,13,2010-04-05 14:52:38,2010-04-05 14:51:33
66a489efcc17fef2239029f1002f00df6886d7ea...41e683a2a50ed945eae630e7ffe8f169b53f3377,1,10,1,11,2,2010-04-05 16:59:22,2010-04-05 16:59:22
5645c80f94fb267eed2c81393f59bdc494d763a4...d580263c0557c53bebe02e7225006161f77ba717,1,0,1,1,1,2010-04-02 17:56:48,2010-04-02 17:56:48
5645c80f94fb267eed2c81393f59bdc494d763a4...74ac2df0c76cad0c06859b5168b98645107c497d,1,0,117,117,2,2010-04-02 17:21:27,2010-04-01 20:21:35
74ac2df0c76cad0c06859b5168b98645107c497d...3c53fbaedc3c08f701810b4a762d33f09af36438,6,11,14,25,9,2010-04-02 17:21:27,2010-04-01 21:19:46
3c53fbaedc3c08f701810b4a762d33f09af36438...d43f1949891a9b83707dcdee6a1f07273f9261c9,1,26,21,47,13,2010-04-02 17:21:27,2010-04-01 21:31:05
d43f1949891a9b83707dcdee6a1f07273f9261c9...b03cc0e07df2f5b012401cd2dc56b35eff0a68d0,3,15,30,45,13,2010-04-02 17:21:27,2010-04-02 16:50:18
b03cc0e07df2f5b012401cd2dc56b35eff0a68d0...1d10bf7d5e9dde57f03ddc163c23216bb6daf757,2,2,10,12,3,2010-04-02 17:21:27,2010-04-02 17:01:32
32f60715a6e46acd89d7e059dde6d8e7084a7f64...dc77ed7c554844daa03d0ba92c8251e2a4233bdd,1,1,1,2,1,2010-04-27 12:49:09,2010-04-27 12:49:09
8e50585bcf216a4210162f0a3b72aa2a38e61228...555fe07fbf1d7d434a194abe31319bc5d5cee017,1,11,2,13,4,2010-04-16 15:54:21,2010-04-16 15:54:21
037511f6ef0d8bbc13cf643465e144b84d12200c...c3cf2b73b66a858d4e8942eb238ad9f2ea703265,5,16,1,17,8,2010-04-15 00:50:15,2010-04-15 00:50:15
037511f6ef0d8bbc13cf643465e144b84d12200c...2440b04f33c2fbebd5a1ad8da74ddb0f02b8cf99,1,2,2,4,2,2010-04-15 00:42:31,2010-04-15 00:41:51
41e683a2a50ed945eae630e7ffe8f169b53f3377...4acaab52a7c4098866cfafcf65f932e8ab1c4511,1,1,0,1,1,2010-04-06 13:36:16,2010-04-06 13:36:16
41e683a2a50ed945eae630e7ffe8f169b53f3377...caf3617fc551e4fbd545552f405c76d9b4806903,2,9,4,13,5,2010-04-05 18:11:40,2010-04-05 18:11:40
caf3617fc551e4fbd545552f405c76d9b4806903...43fb9be758d19ac2de1ba6d0ccd77b61071bc6be,2,3,1,4,3,2010-04-05 18:24:09,2010-04-05 18:24:09
8445cb20d2dcc5b00c011776cb6e3926c3ede2d3...6f7f0a92c3a1d59c270b14d13857ccccbdc73e3d,1,7,2,9,2,2010-04-02 18:20:20,2010-04-02 18:20:20
6f7f0a92c3a1d59c270b14d13857ccccbdc73e3d...c64dc2337b3874b84d20bd7adf640404f58c435e,2,1,4,5,2,2010-04-02 18:19:27,2010-04-02 18:19:11
dc77ed7c554844daa03d0ba92c8251e2a4233bdd...5b2a78a134b950ec96b858a2ee935d34bd673da0,3,58,14,72,12,2010-04-27 16:51:49,2010-04-27 16:51:49
5b2a78a134b950ec96b858a2ee935d34bd673da0...5f62e6af47a4604a1dcf24a572e23003a464b1fe,2,151,67,218,30,2010-04-27 17:04:08,2010-04-27 17:04:08
dc77ed7c554844daa03d0ba92c8251e2a4233bdd...a19e9929255c2796700939535ca9b5323cd7f69c,18,275,132,407,112,2010-04-27 16:32:59,2010-04-27 16:32:59
6bc64c479c2050a31c2000c9635ae7b34ef62143...b90b8c1abd5a23345ca9d36462e2425fc286b948,1,55,0,55,1,2010-04-16 21:06:01,2010-04-16 21:06:01
6bc64c479c2050a31c2000c9635ae7b34ef62143...0cd709783028ee29129d18d82e23abe6221a904a,3,137,5,142,13,2010-04-16 20:54:02,2010-04-16 20:52:54
1ae88e2a1b5ad2a30d0fe4dbd49fdb34c33afe33...db4df3afcb485a2a3739f9588f663bd4785bc78e,6,122,18,140,16,2010-04-15 23:12:28,2010-04-15 23:12:28
db4df3afcb485a2a3739f9588f663bd4785bc78e...5da3be0bf35cbbfd0abca0bf18cc5fdd971e9773,1,1,0,1,1,2010-04-15 23:13:20,2010-04-15 23:13:20
5da3be0bf35cbbfd0abca0bf18cc5fdd971e9773...be4e9161105f69fda4d6c9035a985622f1730c96,1,1,1,2,1,2010-04-15 23:17:26,2010-04-15 23:17:26
be4e9161105f69fda4d6c9035a985622f1730c96...fa3b0ce55ee96302a3b3239bd6a321358ad6e5d2,2,40,2,42,5,2010-04-16 05:14:35,2010-04-16 05:14:35
fa3b0ce55ee96302a3b3239bd6a321358ad6e5d2...d9e4b16738eba75c2b98c35d258073e595af37c6,1,1,0,1,1,2010-04-16 05:14:45,2010-04-16 05:14:45
d9e4b16738eba75c2b98c35d258073e595af37c6...29b39b18dee6aa32bb3910be25a97cfc47ce3005,3,61,6,67,15,2010-04-16 05:15:09,2010-04-16 05:15:09
29b39b18dee6aa32bb3910be25a97cfc47ce3005...db2ad2b318dd3e5f404d506102ba27f8f61f234d,1,2,2,4,1,2010-04-16 05:31:25,2010-04-16 05:31:25
e314bff02f352ee28f626ba5753b37a6cc9a9227...a7773efd71726a5ac58676a5e680f4a7785edc0c,1,1,1,2,1,2010-04-16 14:21:15,2010-04-16 14:21:15
e314bff02f352ee28f626ba5753b37a6cc9a9227...c74d5003d0e5d4a0d6ccef8f0d522a04962e2850,1,25,0,25,1,2010-04-15 03:23:44,2010-04-15 03:23:44
c74d5003d0e5d4a0d6ccef8f0d522a04962e2850...9834129fdab2d79fe766f13a7bd6264cb5023a05,1,3,6,9,4,2010-04-15 13:39:30,2010-04-15 13:39:30
0c9d1b42841e8bf39060d22239fcd6662ad06ef7...009e2e4e0a1c1bbcfcc1acb4b18f035dee7b31fb,4,24,0,24,5,2010-04-06 17:49:51,2010-04-06 17:49:51
43fb9be758d19ac2de1ba6d0ccd77b61071bc6be...89a3d0db821062111814bd9f54f175b505402243,9,134,23,157,30,2010-04-05 21:26:40,2010-04-05 21:26:40
43fb9be758d19ac2de1ba6d0ccd77b61071bc6be...29477f1f8e403f28dc9d216780523f61c59e10f4,1,1,0,1,1,2010-04-05 18:25:56,2010-04-05 18:25:36
c64dc2337b3874b84d20bd7adf640404f58c435e...824e1a51a40c6d0189cde785fe5e73960108d3d5,1,6,1,7,1,2010-04-02 18:49:45,2010-04-02 18:49:45
c64dc2337b3874b84d20bd7adf640404f58c435e...b85dabdaabd5552411a2c03671d6d476baf47f38,2,6,7,13,3,2010-04-02 18:40:19,2010-04-02 18:40:19
a53f68340b1be33a7e793e904b39897fc82092e9...4ea1fe91d3656c5b3a185257f95059dfe06b2b6f,7,99,50,149,20,2010-04-27 18:22:46,2010-04-27 18:22:46
a19e9929255c2796700939535ca9b5323cd7f69c...8bbeed00674c8066c6b5d99a880f33869f20365e,1,10,0,10,1,2010-04-27 17:09:28,2010-04-27 17:09:28
4dd94be57bf59a43d8088d9656bc3008c34e4b06...e9c541820b499ea35cb0f5a07c43863be13fe4a7,3,35,8,43,9,2010-04-17 21:22:19,2010-04-17 21:22:19
c86440ab872147ad584618fecbc08f7a2f218b98...dbaab6e1cea1f0276f4907d09cd03e82e5852d53,8,143,29,172,21,2010-04-18 16:30:40,2010-04-18 16:30:40
9834129fdab2d79fe766f13a7bd6264cb5023a05...e18d0186e8a9b3a412f72c277c0fca0862a074a6,1,2,0,2,1,2010-04-15 16:46:03,2010-04-15 16:46:03
3cfeda9c9101b9a145f334aa076d83579d51c334...977e24670256cb76e9a9df15cc15fbb58d8f9703,2,10,6,16,6,2010-04-06 22:05:30,2010-04-06 22:05:30
977e24670256cb76e9a9df15cc15fbb58d8f9703...6a13b467ce517265153ade13349af9669606b1ef,1,19,4,23,1,2010-04-07 04:07:28,2010-04-07 04:07:28
6a13b467ce517265153ade13349af9669606b1ef...2f668bd486b73ef41395500c09a21ef52b441fa3,1,4,0,4,3,2010-04-07 04:57:46,2010-04-07 04:57:46
2f668bd486b73ef41395500c09a21ef52b441fa3...8dbbef72675b406f69f96f4b3368916ffe52e87d,3,9,7,16,6,2010-04-07 13:34:14,2010-04-07 13:34:14
8dbbef72675b406f69f96f4b3368916ffe52e87d...25add7b27d7f3f8aa167f1377bfeeb42844512ca,1,1,1,2,1,2010-04-07 14:15:34,2010-04-07 14:15:34
8d0d3435e2ba1e81d0d6df070188c7ea09f3d7c1...1f928b9e5ac983b9a5837cddab8ee73fa670f13d,1,4,0,4,2,2010-04-05 21:30:59,2010-04-05 21:30:59
1f928b9e5ac983b9a5837cddab8ee73fa670f13d...4116770ea927a21b15d52e457a4f85037fcbc6d3,1,1,1,2,1,2010-04-05 21:31:58,2010-04-05 21:31:58
4116770ea927a21b15d52e457a4f85037fcbc6d3...19755df99ac16777154761a1ef6f96cafc2ed0e7,1,2,2,4,1,2010-04-05 22:15:12,2010-04-05 19:44:10
19755df99ac16777154761a1ef6f96cafc2ed0e7...df4874f9a809302f71f8366c368346f981291fbd,4,128,49,177,14,2010-04-05 22:26:17,2010-04-05 22:12:18
e0ad7be7ff705a7caf39862f80e0ace8abd9a7cc...735382978a4276dccc35740d314e1591a2c3bbbe,1,8,2,10,1,2010-04-02 19:35:54,2010-04-02 19:35:54
735382978a4276dccc35740d314e1591a2c3bbbe...16718fe78555180bf4da08bfa9a966642966a13e,2,69,0,69,2,2010-04-02 19:36:25,2010-04-02 19:36:25
16718fe78555180bf4da08bfa9a966642966a13e...44237031b1c0edec4ffc931aad1b8914de53ad5e,2,18,2,20,2,2010-04-02 19:56:43,2010-04-02 19:56:43
44237031b1c0edec4ffc931aad1b8914de53ad5e...72ad34e3f01dfb3dcba45dad784355c297feadb8,1,2,1,3,1,2010-04-02 20:03:06,2010-04-02 20:03:06
72ad34e3f01dfb3dcba45dad784355c297feadb8...e29eacd7986fcefe2195a1705b62e3969a6fae79,1,7,3,10,1,2010-04-02 20:25:31,2010-04-02 20:25:31
42bf241b9df428d2b8d597665464b4dd599d953b...b95d9603a0b41cef870f5d8142921f235a1c0fad,3,15,1,16,4,2010-04-27 18:37:41,2010-04-27 18:37:41
f466636958fd2a835d47408f76bbeb5af8926918...23bfd4eaacd938ef8308c3dbb1e1f27b43f922bf,1,41,41,82,1,2010-04-27 17:18:06,2010-04-27 17:18:06
23bfd4eaacd938ef8308c3dbb1e1f27b43f922bf...3f8a0d553ae2c77d797fe420aed69c1c960e1638,1,41,26,67,3,2010-04-27 17:18:51,2010-04-27 17:18:51
3f8a0d553ae2c77d797fe420aed69c1c960e1638...2e596ac2bb2e7e886845a1be6455e1b0c26cb351,1,4,1,5,1,2010-04-27 17:28:31,2010-04-27 17:28:31
2e596ac2bb2e7e886845a1be6455e1b0c26cb351...241ba14f4de9328491aa4e74013ae4a003002ad8,1,1,1,2,1,2010-04-27 17:29:26,2010-04-27 17:29:26
241ba14f4de9328491aa4e74013ae4a003002ad8...ef6b1e355e3bae485b62475699d82671e699638e,1,11,3,14,4,2010-04-27 18:02:11,2010-04-27 18:02:11
ef6b1e355e3bae485b62475699d82671e699638e...b2b69c229b22700f4ccbe9e4f5b64fbe9cbb4f4d,1,33,11,44,4,2010-04-27 18:18:56,2010-04-27 18:18:56
b2b69c229b22700f4ccbe9e4f5b64fbe9cbb4f4d...a3cb25a0a365c3f39303a8fb6e1b8a5fb4d66425,3,9,2,11,4,2010-04-27 18:19:10,2010-04-27 18:19:10
3664f5a5c9f26e9f28b7b2ee76f18ce7aaa28165...a9cb4e6918bce0364ec0ebdea78f9ef9bf28d01d,2,6,1,7,4,2010-04-18 16:35:37,2010-04-18 16:35:37
a9cb4e6918bce0364ec0ebdea78f9ef9bf28d01d...aaf23bff896a62a57ada59e19e4d34e380981dd7,4,97,19,116,12,2010-04-18 17:05:57,2010-04-18 17:05:57
aaf23bff896a62a57ada59e19e4d34e380981dd7...a17c26a33453f06dd164780e6db673a0628bb82d,1,1,1,2,1,2010-04-18 17:10:59,2010-04-18 17:10:59
a17c26a33453f06dd164780e6db673a0628bb82d...419185c449b7832ed6a72356a3d6f24f63a2ff7b,1,5,3,8,3,2010-04-18 17:14:00,2010-04-18 17:14:00
419185c449b7832ed6a72356a3d6f24f63a2ff7b...161fb6d5915e13366e4b5db6367ade4478e2074d,2,31,7,38,9,2010-04-19 16:09:58,2010-04-19 16:09:58
161fb6d5915e13366e4b5db6367ade4478e2074d...d894599f74271a2443effb93984e485acb77c537,1,4,3,7,2,2010-04-19 16:15:50,2010-04-19 16:15:50
d894599f74271a2443effb93984e485acb77c537...e3a1d9e7925cef321ce5702e8ddf36301a22b418,3,20,8,28,10,2010-04-19 16:43:45,2010-04-19 16:43:45
25add7b27d7f3f8aa167f1377bfeeb42844512ca...ec7e1561d5d46df4dbd3230d782be02c42ada9ff,5,100,15,115,9,2010-04-07 21:15:36,2010-04-07 21:15:36
25add7b27d7f3f8aa167f1377bfeeb42844512ca...432d978c28c07faa9ce1521482ef13968e8868b2,1,7,7,14,4,2010-04-07 18:06:47,2010-04-07 17:48:56
432d978c28c07faa9ce1521482ef13968e8868b2...f425b15c6bd9a38c8912d2a09ac98efd2e881097,1,2,6,8,3,2010-04-07 18:12:28,2010-04-07 18:12:28
f425b15c6bd9a38c8912d2a09ac98efd2e881097...845f421fd4aff961754aaabd3894f73499b5d65d,1,15,14,29,9,2010-04-07 21:09:37,2010-03-15 17:09:54
845f421fd4aff961754aaabd3894f73499b5d65d...953df5a1bc1caf539405d4b9fe07bf78449c2f01,1,80,17,97,15,2010-04-07 21:09:37,2010-04-02 19:56:01
953df5a1bc1caf539405d4b9fe07bf78449c2f01...9c932e1c3b3227a8fe045e94069b597c8bb12f46,1,6,6,12,6,2010-04-07 21:09:37,2010-04-06 19:49:53
9c932e1c3b3227a8fe045e94069b597c8bb12f46...41394fd4b393587ea0bae28adde6ae04abf5b2d8,2,426,0,426,2,2010-04-07 21:09:37,2010-04-07 21:08:59
df4874f9a809302f71f8366c368346f981291fbd...a0fdfa0c4ee12182b4f1dc2e661619bbe7ad4515,3,58,58,116,3,2010-04-05 23:44:45,2010-04-05 23:44:45
df4874f9a809302f71f8366c368346f981291fbd...0f2e939810db49b413073c67ce1fb03ae6e1658a,1,2,2,4,1,2010-04-05 23:25:01,2010-04-05 23:25:01
0f2e939810db49b413073c67ce1fb03ae6e1658a...9d5da5e69092afbf9c3cc382e2754007c1828b84,1,10,0,10,1,2010-04-05 23:33:37,2010-04-05 23:33:37
b95d9603a0b41cef870f5d8142921f235a1c0fad...bd28578ab81c87f1b685237117bd0b5624773ccc,166,217,208,425,179,2010-04-27 19:27:52,2010-04-27 19:27:52
b95d9603a0b41cef870f5d8142921f235a1c0fad...380fb64c0cb8171c587a6fdee3ffc2420bdd04d8,1,7,7,14,3,2010-04-27 19:14:32,2010-04-27 19:14:32
b95d9603a0b41cef870f5d8142921f235a1c0fad...c6cfe9fc00fd94b5098f4ab0b7cf7c130c03c324,1,23,2,25,4,2010-04-27 19:05:09,2010-04-27 19:04:05
e3a1d9e7925cef321ce5702e8ddf36301a22b418...b0da7500d9d0bcc66fa509d4fd99ea232ee93110,11,75,21,96,23,2010-04-20 01:05:46,2010-04-20 01:05:46
e3a1d9e7925cef321ce5702e8ddf36301a22b418...00bd05e7506de1639e117a76cad0a5cd41ec5b8d,1,1,1,2,1,2010-04-19 20:14:46,2010-04-19 20:14:46
00bd05e7506de1639e117a76cad0a5cd41ec5b8d...8afdf52bada2f435c9be70712e2589ee819b0b82,11,174,64,238,63,2010-04-19 20:55:16,2010-04-19 20:55:16
8afdf52bada2f435c9be70712e2589ee819b0b82...2d818b6e4fee62bcfd69a440e83472a7c872a000,1,32,31,63,2,2010-04-19 20:55:21,2010-04-19 20:43:46
2d818b6e4fee62bcfd69a440e83472a7c872a000...35d20473713fe8484ff3eea305adb99fbe8aa796,1,2,0,2,1,2010-04-19 20:59:50,2010-04-19 20:59:50
bec96f190dbb17c15e8d8b91bfa7c4fb2f079f86...7e2be7ff64de78975f47feee05a438c6fa273e97,1,2,1,3,2,2010-04-07 21:16:51,2010-04-07 21:16:51
5b2e9fdad3ff9515702a79d2893ad7835f5286ed...653e98cd64113def3d1d9614de012786e03ca4e8,1,8,3,11,5,2010-04-06 00:22:33,2010-04-06 00:22:33
653e98cd64113def3d1d9614de012786e03ca4e8...72625c6fa892d02d8127cee5ecf61d8545d06ac2,1,5,5,10,5,2010-04-06 00:31:19,2010-04-06 00:31:19
72625c6fa892d02d8127cee5ecf61d8545d06ac2...b93b91ff8d786d208b7bb2896ebbaca0e82f6a68,1,1,1,2,1,2010-04-06 00:51:54,2010-04-06 00:51:54
b93b91ff8d786d208b7bb2896ebbaca0e82f6a68...06d88881b1f0c3ffb61d25aad329d07eef74e9d9,1,2,1,3,2,2010-04-06 00:52:05,2010-04-06 00:52:05
d85a93fc76a84f8ed722f8ffc482447a100da992...0a7fd9cc2bf111ac812d834e5607eeca0c6577ac,39,48,48,96,48,2010-04-27 19:33:27,2010-04-27 19:33:27
0a7fd9cc2bf111ac812d834e5607eeca0c6577ac...f947bce011a3cd8ad9325cd1c7d97d8931101f32,3,4,4,8,4,2010-04-27 19:48:38,2010-04-27 19:48:38
f947bce011a3cd8ad9325cd1c7d97d8931101f32...a32f6a2fb909e8139dc3c331e4d07a6048b47fe3,1,2,2,4,1,2010-04-27 19:50:33,2010-04-27 19:50:33
a32f6a2fb909e8139dc3c331e4d07a6048b47fe3...a6045bbb861d38f76f9ce203026155312bb25be1,1,1,1,2,1,2010-04-27 19:58:45,2010-04-27 19:58:45
a6045bbb861d38f76f9ce203026155312bb25be1...2b1665670d93234527f3e70a7b62e5f5b185dd23,2,3,3,6,4,2010-04-27 20:17:35,2010-04-27 20:17:35
1a7fe47b3116edf0d73905cd93a9d213af70daf9...5ba206e9d3e59c1f51c7e59da2ef25dbcb7714da,1,1,1,2,1,2010-04-27 19:19:33,2010-04-27 19:19:33
5ba206e9d3e59c1f51c7e59da2ef25dbcb7714da...59b496be18a21ec0892f6c8be17e2d6dc983c7a8,2,13,1,14,2,2010-04-27 19:24:35,2010-04-27 19:24:35
ebbb932c3ecdbc034c37654132f9ed2f0226fab7...0395379c3067b3dfe086afae55237d6e099959bc,1,9,3,12,1,2010-04-20 03:24:57,2010-04-20 03:24:57
ebbb932c3ecdbc034c37654132f9ed2f0226fab7...5c6ab24ee20624f66a6cbf6d48a42bf481be08a8,2,25,18,43,4,2010-04-20 02:24:37,2010-04-20 02:24:37
06d88881b1f0c3ffb61d25aad329d07eef74e9d9...d02c18cde4f2658426c5f7269d0a74dbc51b7bd6,1,11,1,12,2,2010-04-06 01:29:01,2010-04-06 01:29:01
d02c18cde4f2658426c5f7269d0a74dbc51b7bd6...afafbfa5a7924889bcd4e409b570db7d2d07ecb0,1,1,1,2,1,2010-04-06 01:46:04,2010-04-06 01:18:45
afafbfa5a7924889bcd4e409b570db7d2d07ecb0...418c926354f9d4a77068963923386ad21eacbe7d,1,5,0,5,2,2010-04-06 01:46:04,2010-04-06 01:45:14
418c926354f9d4a77068963923386ad21eacbe7d...00f604c06334bad02565e8fc6bb300708d67f395,3,17,6,23,9,2010-04-06 06:48:09,2010-04-06 06:48:09
2b1665670d93234527f3e70a7b62e5f5b185dd23...7cdfaa8a8a57d202ce461393141235eab2677b67,1,2,2,4,1,2010-04-27 21:07:07,2010-04-27 21:07:07
2b1665670d93234527f3e70a7b62e5f5b185dd23...92b48ea825815709fdd27466c5f90b4d412cbdf4,6,59,8,67,14,2010-04-27 20:49:22,2010-04-27 20:49:22
92b48ea825815709fdd27466c5f90b4d412cbdf4...0d41b1e86977a36bb247ce7654fbd2dc0396e219,1,1,1,2,1,2010-04-27 20:55:38,2010-04-27 20:55:38
8e6791183f5f65c6097ed5dfd72731aaba1fbbcf...04d32ba5be5d61ca8974588bb6010375898800ef,1,1,1,2,1,2010-04-20 13:59:43,2010-04-20 13:59:43
04d32ba5be5d61ca8974588bb6010375898800ef...fb09b882408b9c607437dc27bd402fe562bdc3a1,16,101,41,142,39,2010-04-20 16:29:00,2010-04-20 16:29:00
00f604c06334bad02565e8fc6bb300708d67f395...e18041f47b0b3a885f9e54e35925572c2e28995a,1,12,0,12,1,2010-04-06 17:41:19,2010-04-06 17:41:19
00f604c06334bad02565e8fc6bb300708d67f395...897b81a7b2673526bb0ccf690f7409f06614b30c,1,0,15,15,1,2010-04-06 17:31:42,2010-04-06 17:30:30
0d41b1e86977a36bb247ce7654fbd2dc0396e219...c2af7912ca844283e225cf5d9dc9d9073bbf8390,4,35,10,45,20,2010-04-27 21:22:17,2010-04-27 21:22:17
fb09b882408b9c607437dc27bd402fe562bdc3a1...b3347b10d70378b81a782705ff80faf5bb548226,10,106,35,141,46,2010-04-20 19:30:37,2010-04-20 19:30:37
fb09b882408b9c607437dc27bd402fe562bdc3a1...55e8b26481cfe877c4bd90ffe9e74e99c657cd44,16,178,37,215,47,2010-04-20 16:58:04,2010-04-20 16:58:04
55e8b26481cfe877c4bd90ffe9e74e99c657cd44...517d8f02777c0bb547f78ba96573e99e7372c735,9,105,1,106,15,2010-04-20 19:05:48,2010-04-20 19:05:48
8393443389d65ca66c419c7fc10543c3d46f12eb...30fd95fcb5d998ba2af196dfdb4928325a09dad8,4,1179,1179,2358,4,2010-04-27 21:50:26,2010-04-27 21:50:26
30fd95fcb5d998ba2af196dfdb4928325a09dad8...d09a9ea08793fa72af727699f1e7662990a57f67,5,345,380,725,20,2010-04-27 22:16:43,2010-04-27 22:16:43
d09a9ea08793fa72af727699f1e7662990a57f67...542b7cdbb39279d629dc86027a9e7213b0e291a9,1,49,66,115,2,2010-04-27 22:22:07,2010-04-27 22:22:07
542b7cdbb39279d629dc86027a9e7213b0e291a9...f8654f8f5608b5cb0ea756b8f6c877cd7d3285a8,2,1,2,3,2,2010-04-27 22:28:10,2010-04-27 22:28:10
f8654f8f5608b5cb0ea756b8f6c877cd7d3285a8...0e695b7a56a7b3b32fdbfaaddc3ef60df3f2e678,1,20,6,26,6,2010-04-27 22:55:45,2010-04-27 22:55:45
1057b2c4e2fb0eafbb90a10b302f70626414d90a...a2ab816f8e978b31bfca43cc39d89436e88d18a6,4,17,0,17,5,2010-04-20 19:38:49,2010-04-20 19:38:49
a2ab816f8e978b31bfca43cc39d89436e88d18a6...9f7f0be204e8ddf41976773847314437a3f5a735,3,6,6,12,5,2010-04-20 19:41:47,2010-04-20 19:41:47
9f7f0be204e8ddf41976773847314437a3f5a735...79b5cc21a1664922c4621c235c4efd31f9d05906,5,109,1,110,5,2010-04-20 20:24:06,2010-04-20 20:24:06
517d8f02777c0bb547f78ba96573e99e7372c735...9314ac2ca6c8e44ca651e77e21f6d98b29a2247d,2,15,1,16,2,2010-04-20 21:07:07,2010-04-20 21:07:07
9314ac2ca6c8e44ca651e77e21f6d98b29a2247d...f1db30470ad1b98932574d37f8e7ac4a4ac38594,4,68,1,69,10,2010-04-20 21:07:10,2010-04-20 21:07:10
0e695b7a56a7b3b32fdbfaaddc3ef60df3f2e678...3483f22813a7aa89dfc45359b6b4b40a2e342e05,15,75,46,121,41,2010-04-28 12:25:56,2010-04-28 12:25:56
0e695b7a56a7b3b32fdbfaaddc3ef60df3f2e678...65f9f38b1e2c248b5d664dd347e86617046320ff,2,6,7,13,6,2010-04-28 01:39:58,2010-04-28 01:39:58
08ae9f55fdc6d15e48e7fb13a88e155385e22ff4...833370f29b1f25e7f7507deba1dd62c8c428da92,1,1,2,3,1,2010-04-20 21:15:48,2010-04-20 21:15:48
833370f29b1f25e7f7507deba1dd62c8c428da92...28a303759cf6bc1a0d082939496b959495d74a00,2,62,0,62,4,2010-04-20 22:12:30,2010-04-20 22:12:30
28a303759cf6bc1a0d082939496b959495d74a00...2bef8e784f6b2f9ba9799c5f931be5353208fece,5,37,31,68,9,2010-04-20 23:07:37,2010-04-20 23:07:37
2bef8e784f6b2f9ba9799c5f931be5353208fece...18f361418835e8379c5a80869e35dfb61347c233,8,75,51,126,57,2010-04-20 23:42:53,2010-04-20 23:42:53
18f361418835e8379c5a80869e35dfb61347c233...b0cdfca990dd68c8591f0eaa490723ad13a35c7a,3,17,11,28,10,2010-04-21 01:55:34,2010-04-21 01:55:34
b0cdfca990dd68c8591f0eaa490723ad13a35c7a...54619e3b90112dc119a3a73fae607636c6e5d079,2,61,16,77,7,2010-04-21 02:15:16,2010-04-21 02:15:16
54619e3b90112dc119a3a73fae607636c6e5d079...a70a2973d41c2cba61afa4961bbf837f4240242e,1,1,1,2,1,2010-04-21 03:11:25,2010-04-21 03:11:25
a70a2973d41c2cba61afa4961bbf837f4240242e...5660d034776250a15adec0433ee04724a1d15dcc,4,45,5,50,8,2010-04-21 03:11:35,2010-04-21 03:11:35
9be14d4901a9a3998eafb5972594c4bbe99315ba...747b7203bd988b67df6126a90318c1e9a337b066,1,1,1,2,1,2010-04-28 13:54:01,2010-04-28 13:54:01
747b7203bd988b67df6126a90318c1e9a337b066...5f18106462388fda48da2f3e52eacdbfee54eec1,1,6,2,8,3,2010-04-28 14:08:28,2010-04-28 14:08:28
5f18106462388fda48da2f3e52eacdbfee54eec1...be8ca3a191b264d6fabfa5a586b526f266201cbd,2,12,1,13,2,2010-04-28 14:57:18,2010-04-28 14:57:18
5660d034776250a15adec0433ee04724a1d15dcc...7fb0052d9ccf944e59e3eb863bf93972c22a0121,8,190,105,295,38,2010-04-21 18:41:09,2010-04-21 18:41:09
5660d034776250a15adec0433ee04724a1d15dcc...7ba0914ed41c8318a72b956980b2fa7b336b8481,1,6,1,7,4,2010-04-21 14:09:25,2010-04-21 14:09:25
7ba0914ed41c8318a72b956980b2fa7b336b8481...50ffb4ac70fd015e0aba781fb0eb05185061a4fb,1,6,1,7,3,2010-04-21 15:41:05,2010-04-21 15:41:05
50ffb4ac70fd015e0aba781fb0eb05185061a4fb...0d6ea43699236e99242f064eaf5b35e20f5884d7,1,1,1,2,1,2010-04-21 16:54:37,2010-04-21 16:54:37
0d6ea43699236e99242f064eaf5b35e20f5884d7...12dbcd895959bb0f33f53d7e318f32ec5eda62a5,1,20,4,24,6,2010-04-21 18:37:58,2010-04-21 18:37:58
be8ca3a191b264d6fabfa5a586b526f266201cbd...c8e9ec0247b3ba425297d37b1d642f4e12e66b64,2,28,13,41,9,2010-04-28 16:19:46,2010-04-28 16:19:46
be8ca3a191b264d6fabfa5a586b526f266201cbd...ed9dabff0570d262509e1f6a654d7fd6e4b126f5,1,11,11,22,1,2010-04-28 16:15:19,2010-04-28 16:15:19
6ef037a784d1c33e0415a7406c3dc938c28a7f4e...29fc7049a800b84bc5a2a0fb88370c8b0ed0299a,4,107,528,635,21,2010-04-21 19:03:05,2010-04-21 19:03:05
12dbcd895959bb0f33f53d7e318f32ec5eda62a5...64c2ab5a0627653551d177fda60c36bcc37d6b8b,3,58,14,72,13,2010-04-21 19:02:37,2010-04-21 19:02:37
ddd3e6e4d09a13ac325e9a93c6b292a658a65544...e4e164d4295c81a67dfb689bfd741d0d95d26a0d,1,4,4,8,4,2010-04-28 16:28:47,2010-04-28 16:28:47
e4e164d4295c81a67dfb689bfd741d0d95d26a0d...c3ee67911673d34423f11b986788cf3509f46eb1,1,2,0,2,2,2010-04-28 17:19:45,2010-04-28 17:19:45
c3ee67911673d34423f11b986788cf3509f46eb1...2531a6cafdb51e46682a9a4d4a165e3f79382a5f,4,185,134,319,9,2010-04-28 17:20:08,2010-04-28 17:20:08
2531a6cafdb51e46682a9a4d4a165e3f79382a5f...f1114721c669e7d0d2fd3f3fe26b6d9be2c43e75,1,27,0,27,1,2010-04-28 17:20:26,2010-04-28 17:20:26
f1114721c669e7d0d2fd3f3fe26b6d9be2c43e75...5c0d6731e86a5f1e1cc7dd467632de7672d5339a,1,1,1,2,1,2010-04-28 17:28:11,2010-04-28 17:28:11
73ee41d32d994b128431663ed42636baafd3ddd7...4c709a735a2a0d9561cf5c3804664cdb9270598e,3,510,0,510,4,2010-04-21 19:07:38,2010-04-21 19:07:38
4c709a735a2a0d9561cf5c3804664cdb9270598e...c0081cc3c54c630190e29f9dca5d3259bfb850b5,1,1,1,2,1,2010-04-21 19:09:28,2010-04-21 19:09:28
5c0d6731e86a5f1e1cc7dd467632de7672d5339a...b0ddd5e622571bca5f6854560c24c1e289c78d79,2,20,0,20,3,2010-04-28 17:54:34,2010-04-28 17:54:34
5c0d6731e86a5f1e1cc7dd467632de7672d5339a...6fab348c026866e663067068e28244a8afa28538,1,2,2,4,2,2010-04-28 17:44:31,2010-04-28 17:44:31
c0081cc3c54c630190e29f9dca5d3259bfb850b5...bb90349ac1fda963e9010273f96ae295f443a216,2,508,508,1016,35,2010-04-21 19:14:39,2010-04-21 19:14:39
c0081cc3c54c630190e29f9dca5d3259bfb850b5...f658ff62f8b6c1d6332a51334e698238dcdb2ba4,1,4,1,5,1,2010-04-21 19:13:24,2010-04-21 19:13:24
4d399fb7e51d5509a21cf3a27c52038333d5f623...6e84f86d59068fa139725a5e7e3c36553365d4fd,1,0,18,18,1,2010-04-28 18:02:01,2010-04-28 18:02:01
6e84f86d59068fa139725a5e7e3c36553365d4fd...146858e8f291b9f42b91ba2a49b1539186c24fd6,1,1,1,2,1,2010-04-28 18:35:31,2010-04-28 18:35:31
6fab348c026866e663067068e28244a8afa28538...00c1bff5c1116c2e7fb39029fa8467d343e0dc56,3,105,0,105,5,2010-04-28 18:36:41,2010-04-28 18:36:41
bb90349ac1fda963e9010273f96ae295f443a216...d5cda23b2fe244cdae246903bc6cb5deb5d84609,1,1,0,1,1,2010-04-21 19:24:25,2010-04-21 19:24:25
e4c7e95d7f6404101c06b41934e453c1f27b809d...5dab211e68c95b02a0f98645c628f26be502d1b5,5,732,682,1414,15,2010-04-21 19:23:00,2010-04-21 19:23:00
db42f86ddf3d2da9169f0e7416c2f8fdfaed620c...5a4d061c896d291249a7e3d81424087843f4933b,1,10,0,10,1,2010-04-28 18:41:07,2010-04-28 18:41:07
5a4d061c896d291249a7e3d81424087843f4933b...e3fa699ae4f9a56fba3a5e3e75f4074d7f778136,1,3,1,4,1,2010-04-28 18:42:54,2010-04-28 18:42:54
5dab211e68c95b02a0f98645c628f26be502d1b5...213c83e9cac19da9d5cc311daf045fd9d9a66a69,1,4,6,10,6,2010-04-21 19:24:30,2010-04-21 19:24:30
e3fa699ae4f9a56fba3a5e3e75f4074d7f778136...071f4015b4902bf17c0be268e38c0a26d4a3d29a,2,52,6,58,8,2010-04-28 19:04:22,2010-04-28 19:04:22
e3fa699ae4f9a56fba3a5e3e75f4074d7f778136...7055f7afaf3c48a206c62c42cf2897ca37ccc09b,1,4,0,4,1,2010-04-28 19:01:56,2010-04-28 18:32:56
7055f7afaf3c48a206c62c42cf2897ca37ccc09b...49e04a4a60ceb73095ed5a1d30b9023490f519eb,1,11,0,11,1,2010-04-28 19:01:56,2010-04-28 19:01:17
b125f0bda805be73e180ad802b77357bba0084e4...371cd0ee4118dcc6b70dec3aa44b6780fec0d91c,1,2,2,4,2,2010-04-21 19:54:29,2010-04-21 19:54:29
b125f0bda805be73e180ad802b77357bba0084e4...9fb9801971df24120b318b4aa1b34cd078f1a89e,2,25,25,50,15,2010-04-21 19:26:38,2010-04-21 19:26:38
b125f0bda805be73e180ad802b77357bba0084e4...1142df2e2a9998ceafc3709b4d76fa813b3e6e59,1,2,2,4,1,2010-04-21 19:26:08,2010-04-21 19:26:08
a9b24c70fd4c2ab428f269b652a48f7878433627...7c352b1b13219b455dcad61aaf4e3afd34a78c81,1,3,0,3,1,2010-04-28 19:24:32,2010-04-28 19:20:52
7c352b1b13219b455dcad61aaf4e3afd34a78c81...a634d541ade8c645bb55fbe3e22b81165c24f070,2,61,2,63,5,2010-04-28 19:24:32,2010-04-28 19:22:51
a634d541ade8c645bb55fbe3e22b81165c24f070...e0d8e8541d2870a2280c9513ac742b5b1864c766,7,19,17,36,16,2010-04-28 19:39:52,2010-04-28 19:39:52
e0d8e8541d2870a2280c9513ac742b5b1864c766...aa82a787890de97c2613e719b114f570b5c34d06,3,27,2,29,7,2010-04-28 20:11:27,2010-04-28 20:11:27
aa82a787890de97c2613e719b114f570b5c34d06...4002e942bd96c55be54fda788eb680e8938a8533,2,32,6,38,5,2010-04-28 20:56:14,2010-04-28 20:56:14
4002e942bd96c55be54fda788eb680e8938a8533...c8da89c5b6afb7426078cbe65d5bd9818a3711da,1,1,1,2,1,2010-04-28 21:39:09,2010-04-28 21:39:09
c8da89c5b6afb7426078cbe65d5bd9818a3711da...0355daf5348d43aaf93579cbec38c10f55d9f383,4,1914,243,2157,361,2010-04-28 22:04:32,2010-04-28 22:04:32
0355daf5348d43aaf93579cbec38c10f55d9f383...d0cb26db492c52a3377bdac8d4b2cc6b6cca997e,1,2,0,2,1,2010-04-28 22:05:03,2010-04-28 22:05:03
d0cb26db492c52a3377bdac8d4b2cc6b6cca997e...5de1d2ee5c2b3ba109fe8a3cb8032fc04bc94e3d,4,10,10,20,8,2010-04-28 22:16:16,2010-04-28 22:16:16
5de1d2ee5c2b3ba109fe8a3cb8032fc04bc94e3d...164095778e11b18955d97fc2a390e700fe430e2c,8,50,23,73,33,2010-04-28 23:39:21,2010-04-28 23:39:21
f91a3e56e41ba8ab0b0e05fb67aa249d6dfeb5b3...f0928e5f7d451cf02d937cc47148e58951b85e0e,7,159,111,270,39,2010-04-21 20:14:28,2010-04-21 20:14:28
f91a3e56e41ba8ab0b0e05fb67aa249d6dfeb5b3...b63a7c1eb02062c2fbfdd22293436b64dc88e561,1,8,0,8,2,2010-04-21 19:55:58,2010-04-21 19:55:58
164095778e11b18955d97fc2a390e700fe430e2c...577afd27569725ebe98ccb6aebfb50bd94a04d72,6,24,1119,1143,195,2010-04-29 14:52:37,2010-04-29 14:52:37
164095778e11b18955d97fc2a390e700fe430e2c...b5818a204d9d3fa04d00eaaa97d946c8f15f0498,1,3,1,4,2,2010-04-29 00:56:40,2010-04-29 00:56:40
b5818a204d9d3fa04d00eaaa97d946c8f15f0498...19b7872bd8453d1bce0c86340ba506d8ca0e586d,1,2,2,4,2,2010-04-29 00:57:32,2010-04-29 00:57:32
19b7872bd8453d1bce0c86340ba506d8ca0e586d...791386affedd07abfe413174b0dc7f8966456928,3,13,3,16,6,2010-04-29 02:13:38,2010-04-29 02:13:38
791386affedd07abfe413174b0dc7f8966456928...a155ee29325403ff16a5d4a18bc9d59786c74390,1,1,1,2,1,2010-04-29 03:59:20,2010-04-29 03:59:20
a155ee29325403ff16a5d4a18bc9d59786c74390...0d7e6b49131779f396b1186860e23803569ba062,2,44,11,55,14,2010-04-29 03:59:24,2010-04-29 03:59:24
0d7e6b49131779f396b1186860e23803569ba062...1ba7715c1f0f1d3ec878c0937e059c45a403a44c,6,356,291,647,10,2010-04-29 14:15:05,2010-04-29 14:15:05
1ba7715c1f0f1d3ec878c0937e059c45a403a44c...5e8355818848719b263b24b9c8fc279f18819bbe,3,88,26,114,18,2010-04-29 14:40:59,2010-04-29 14:40:59
34d920becd17a4f423356489530fd8a7f677df1b...a814321b0125c931f1491f53600c51afcfd57cc5,1,26,1,27,2,2010-04-21 20:02:44,2010-04-21 20:02:44
c4cba90e0ec2e06c9e71c4f0e0717983b5923a20...0e251248a2615e7413e322db82e93f12577cb166,1,1,1,2,1,2010-04-21 21:22:44,2010-04-21 21:22:44
0e251248a2615e7413e322db82e93f12577cb166...6434dc146a218aa1b2c83376d7046e503c9ba9f1,1,12,0,12,1,2010-04-21 21:22:55,2010-04-21 21:22:55
c4cba90e0ec2e06c9e71c4f0e0717983b5923a20...60b6c65c2a99d526078323c04b948b6ead0a7ce0,8,69,21,90,24,2010-04-21 20:43:51,2010-04-21 20:43:51
60b6c65c2a99d526078323c04b948b6ead0a7ce0...2932118a103f2ac62961d7dce10cc1ad9143d59a,1,1,1,2,1,2010-04-21 20:48:30,2010-04-21 20:48:30
2932118a103f2ac62961d7dce10cc1ad9143d59a...dbb9439a5833a9755bedc68d4fa354d8ad48f30b,3,20,2,22,5,2010-04-21 21:13:25,2010-04-21 21:13:25
492d1b8764d423593b77af98233dd0123ee258d2...1387990cab050cab7a46e16abc3cfae6a491ea32,3,3,0,3,3,2010-04-29 15:29:16,2010-04-29 15:29:16
dbb9439a5833a9755bedc68d4fa354d8ad48f30b...927000277ea83b7ed74bd702c19ad0711c45733f,6,78,23,101,15,2010-04-21 21:40:24,2010-04-21 21:40:24
1387990cab050cab7a46e16abc3cfae6a491ea32...3894aa4c52378b0ac3834a9312ef5d7dbfe4c05c,3,32,20,52,9,2010-04-29 15:32:26,2010-04-29 15:32:26
1387990cab050cab7a46e16abc3cfae6a491ea32...0b2132d8fd719ae39260c1ed4117f77454d0d987,1,4,4,8,2,2010-04-29 15:32:22,2010-04-29 15:32:22
ed752e848ce25136b40f200239111713b1c1ae28...aa1b777c619a63614a8a8c35e79f55beb352d3fe,6,142,28,170,22,2010-04-21 21:44:07,2010-04-21 21:44:07
3894aa4c52378b0ac3834a9312ef5d7dbfe4c05c...c9a8840035fef4b2ed858b77f349b935674cc086,1,2,2,4,2,2010-05-01 06:58:46,2010-05-01 06:58:46
86bf00a35c35e78bf8c9abe37c9d90b306c0f366...aeabb978d4b84aa795fa067cc3773a3f7f3c6673,2,11,6,17,5,2010-04-29 16:35:36,2010-04-29 16:35:36
aeabb978d4b84aa795fa067cc3773a3f7f3c6673...3e6d9c36c8a8f678a6ffebd5d0e5a6e87e9418c8,1,2,0,2,1,2010-04-29 16:42:27,2010-04-29 16:42:27
3e6d9c36c8a8f678a6ffebd5d0e5a6e87e9418c8...996278ed70e3c16e3041d9701486fa648d48cc79,1,3,2,5,2,2010-04-29 17:27:52,2010-04-29 17:27:52
996278ed70e3c16e3041d9701486fa648d48cc79...33d3ce4ea8e774b152154d8ac46db3154d59c7f7,1,1,0,1,1,2010-04-29 18:05:31,2010-04-29 18:05:31
33d3ce4ea8e774b152154d8ac46db3154d59c7f7...846453e82a517832bc7d52ad9b23c6ab547ade9e,1,7,1,8,2,2010-04-29 18:05:52,2010-04-29 18:05:52
846453e82a517832bc7d52ad9b23c6ab547ade9e...5d2ac5576dc4a87be438182a2131151f17567233,1,2,2,4,2,2010-04-29 18:49:01,2010-04-29 18:49:01
5d2ac5576dc4a87be438182a2131151f17567233...acf722bb9e67e63d42a00feaf4b3f93f80963797,3,149,46,195,23,2010-04-29 20:51:43,2010-04-29 15:20:48
acf722bb9e67e63d42a00feaf4b3f93f80963797...95025562ff8c94b536fe5cac2e8b7ffa62d4f3a0,1,62,123,185,25,2010-04-29 20:51:44,2010-04-29 20:51:01
95025562ff8c94b536fe5cac2e8b7ffa62d4f3a0...e812c222710dc0eaa138c7d0f6f1f2959b3eea15,1,10,7,17,3,2010-04-29 20:54:02,2010-04-29 20:54:02
e812c222710dc0eaa138c7d0f6f1f2959b3eea15...d9a9c71fdd76358e6e773cb6e760e196128b1429,1,2,2,4,1,2010-04-29 21:03:40,2010-04-29 21:03:40
d9a9c71fdd76358e6e773cb6e760e196128b1429...7f03ac9d75f8da12ddaf1430cb4600eaae65d94a,1,1,1,2,1,2010-04-29 22:18:21,2010-04-29 22:12:26
7f03ac9d75f8da12ddaf1430cb4600eaae65d94a...3e47000a1a85527334fb6150403df82d0e6066f4,1,4,2,6,1,2010-04-29 22:18:21,2010-04-29 22:15:30
3e47000a1a85527334fb6150403df82d0e6066f4...ea0fbff07b426a494be8857767453769768dd7b3,1,1,1,2,1,2010-04-29 22:37:09,2010-04-29 22:37:09
ea0fbff07b426a494be8857767453769768dd7b3...97aa0c2837877ed21e593b63e231f78bc6f4a932,1,1,1,2,1,2010-04-29 23:50:54,2010-04-29 23:50:54
97aa0c2837877ed21e593b63e231f78bc6f4a932...226b6f8ad6deac7ce67e19642911d59274083566,1,12,9,21,3,2010-04-30 00:09:10,2010-04-30 00:09:10
226b6f8ad6deac7ce67e19642911d59274083566...4147810106a47aedcea32fccc5e7ae4891bae43f,1,4,1,5,1,2010-04-30 00:32:52,2010-04-30 00:32:52
4147810106a47aedcea32fccc5e7ae4891bae43f...1721270c5b43e9bb1e7fb6bfdd201c9e38ad3695,2,61,33,94,8,2010-04-30 01:04:54,2010-04-30 01:04:54
1721270c5b43e9bb1e7fb6bfdd201c9e38ad3695...b3b64405f5517c098a3adc8c652706fbf614e3f9,1,4,0,4,2,2010-04-30 01:45:58,2010-04-30 01:45:58
b3b64405f5517c098a3adc8c652706fbf614e3f9...67575ac7eb899028b76ea8b98b4b4a0af68181d6,1,4,0,4,2,2010-04-30 06:30:43,2010-04-30 06:30:43
67575ac7eb899028b76ea8b98b4b4a0af68181d6...8df6518e62d98201aa281dc500d28f9901228283,1,19,12,31,3,2010-04-30 15:59:28,2010-04-30 15:59:28
8df6518e62d98201aa281dc500d28f9901228283...9890ad669af4be1b1da63b7f695f5b353a8d3068,1,5,4,9,3,2010-04-30 16:19:50,2010-04-30 16:19:50
9890ad669af4be1b1da63b7f695f5b353a8d3068...663c3a7682c16ba07f99ccf1ed0bf3a6341b228e,1,2,0,2,1,2010-04-30 18:47:48,2010-04-30 18:47:48
663c3a7682c16ba07f99ccf1ed0bf3a6341b228e...b89833d549f5f30aa6e17bb025ef1b50132aa54c,4,35,15,50,10,2010-05-01 01:39:01,2010-05-01 01:20:24
aa1b777c619a63614a8a8c35e79f55beb352d3fe...ac91527d4700332feefe26aefc4e588586561b55,7,7,8,15,8,2010-04-21 22:46:31,2010-04-21 22:46:31
aa1b777c619a63614a8a8c35e79f55beb352d3fe...c4299e6c31b2e5e83611813d6ef66343f775458a,2,16,1,17,2,2010-04-21 22:26:31,2010-04-21 22:19:51
20445aa7e4dd28261cb9dfcd16f9dc6f02851322...d502f918b22249a073583f97ad53494c9d16f6a8,4,12,742,754,41,2010-05-01 19:12:10,2010-05-01 19:12:10
d502f918b22249a073583f97ad53494c9d16f6a8...19ef9359cac21d053ca0df717c22bf9be3e1e313,7,223,140,363,11,2010-05-01 23:40:57,2010-05-01 23:40:57
19ef9359cac21d053ca0df717c22bf9be3e1e313...e2d7f15df072a967b55747b3154dc66dc0baf3c0,1,18,19,37,9,2010-05-01 23:52:44,2010-05-01 23:52:44
e2d7f15df072a967b55747b3154dc66dc0baf3c0...ea26348dcbc532a89901ac1eea10f22666592e22,1,7,2,9,2,2010-05-02 00:30:15,2010-05-02 00:30:15
ea26348dcbc532a89901ac1eea10f22666592e22...5473d2a554b145c41f103ad5c2a98ac409a15e10,4,669,665,1334,11,2010-05-02 01:36:33,2010-05-02 01:36:33
5473d2a554b145c41f103ad5c2a98ac409a15e10...60a9adc550924b91d7059a2ce7f1d36ef9dada26,3,1151,1149,2300,13,2010-05-02 19:24:09,2010-05-02 19:24:09
60a9adc550924b91d7059a2ce7f1d36ef9dada26...3461ea7c2d2ac9a61a279b9777473712d9cecb6d,2,129,131,260,3,2010-05-02 21:31:50,2010-05-02 21:31:50
3461ea7c2d2ac9a61a279b9777473712d9cecb6d...8be209992dda6e5b987780ec2c5da9f3410e3af6,7,276,9,285,13,2010-05-02 23:17:35,2010-05-02 23:17:35
3d7d79aa9e5415f1735d058153bd4870fce3ecc1...4150161551ec833e56765b974770010734c82860,9,37,12,49,19,2010-04-22 01:19:37,2010-04-22 01:19:37
3d7d79aa9e5415f1735d058153bd4870fce3ecc1...dd8d1e3e8d8ad736eef3912dc46ff08a07939c28,2,2,1,3,2,2010-04-21 23:32:36,2010-04-21 23:32:36
8be209992dda6e5b987780ec2c5da9f3410e3af6...ed4225a36a78405bc3cbfadfa7eb2f4bf23e3987,5,74,3,77,14,2010-05-03 17:33:49,2010-05-03 17:33:49
8be209992dda6e5b987780ec2c5da9f3410e3af6...5bd568f0bedbdaf3054ca3a262181b64baccce98,1,8,1,9,2,2010-05-03 02:23:43,2010-05-03 02:23:43
5bd568f0bedbdaf3054ca3a262181b64baccce98...aff81e633ec93bdd0c726a17bb6b24bbb280d70f,1,1,1,2,1,2010-05-03 12:29:34,2010-05-03 12:29:34
aff81e633ec93bdd0c726a17bb6b24bbb280d70f...f68e9e023513d01e3c088e015047b6daec62f228,2,8,4,12,3,2010-05-03 12:48:15,2010-05-03 12:48:15
f68e9e023513d01e3c088e015047b6daec62f228...d1082cf676e372970ce62254fabb61b9c6fca96b,7,64,44,108,18,2010-05-03 15:18:27,2010-05-03 15:18:27
d1082cf676e372970ce62254fabb61b9c6fca96b...e57c74e843d619e02ea1bb9e3f7166ca099a0976,2,49,6,55,8,2010-05-03 15:43:12,2010-05-03 15:43:12
e57c74e843d619e02ea1bb9e3f7166ca099a0976...e6f2a36e00999a042d637989c3226f6a0e5a0267,1,2,1,3,1,2010-05-03 15:50:06,2010-05-03 15:50:06
e6f2a36e00999a042d637989c3226f6a0e5a0267...5eaf86ede01a6c318b4d007994e00ca2d09e717c,4,9,3,12,4,2010-05-03 16:37:49,2010-05-03 16:37:49
162f57111ededcaed4c6de9f579d4a68e50a5a2e...dc75bbf201ddbb2e503e4aa9033553807a19e80f,2,19,5,24,3,2010-04-22 01:49:09,2010-04-22 01:49:09
dc75bbf201ddbb2e503e4aa9033553807a19e80f...d8b762a2ea75f1e8af00fa47a3fb1cfb797c9bb4,3,7,0,7,4,2010-04-22 01:58:00,2010-04-22 01:58:00
d8b762a2ea75f1e8af00fa47a3fb1cfb797c9bb4...c6643c12f64f2b36f4ff591d3282f00b0480fd30,3,18,1,19,4,2010-04-22 02:32:26,2010-04-22 02:32:26
c6643c12f64f2b36f4ff591d3282f00b0480fd30...835c65adc298dde1b311d6346f914f9c60e4a71e,1,9,0,9,1,2010-04-22 02:35:15,2010-04-22 02:35:15
3f54488de0a8dc28aace91e56b8293b88295b95a...f95e56e5a00043e1575caecc8b31141b72a1575c,1,1,1,2,1,2010-05-03 18:12:45,2010-05-03 18:12:45
f95e56e5a00043e1575caecc8b31141b72a1575c...ead6f3dbd0fd4ab271fb50ed7f9dafdf0c940032,2,18,1,19,3,2010-05-03 18:17:36,2010-05-03 18:17:36
ead6f3dbd0fd4ab271fb50ed7f9dafdf0c940032...1e9856247a9ad5dca733d4fce48d8500672b1add,1,8,1,9,4,2010-05-03 18:29:31,2010-05-03 18:29:31
5eaf86ede01a6c318b4d007994e00ca2d09e717c...b042060ce8975febf448b6bb3f0beb3f35ea0a10,1,2,0,2,1,2010-05-03 20:22:52,2010-05-03 20:22:52
b042060ce8975febf448b6bb3f0beb3f35ea0a10...34a9c96763c710c2442b217161f682fb3d906813,2,12,0,12,2,2010-05-10 16:51:49,2010-05-10 16:51:49
34a9c96763c710c2442b217161f682fb3d906813...af4beb47b138d370e5abfe3adc7bbe3e8a998aaf,2,99,99,198,58,2010-05-10 17:06:20,2010-05-10 17:06:20
835c65adc298dde1b311d6346f914f9c60e4a71e...67e3503b9d10a2e3e1fbea48baba6d4846019134,13,1037,943,1980,18,2010-04-22 14:31:16,2010-04-22 14:31:16
835c65adc298dde1b311d6346f914f9c60e4a71e...a3242b6791c3a958f8d94d01a1f9a9e82fa41d4d,5,215,123,338,6,2010-04-22 14:29:05,2010-04-22 14:29:05
1e9856247a9ad5dca733d4fce48d8500672b1add...a48c830de9d222257cd225aaaea16e3f5fec2ca0,27,179,216,395,161,2010-05-03 20:25:34,2010-05-03 20:25:34
1e9856247a9ad5dca733d4fce48d8500672b1add...d2cec0e4d03c152b295e8aac6ae8c1ceca932c63,1,1,1,2,1,2010-05-03 18:30:41,2010-05-03 17:06:37
d2cec0e4d03c152b295e8aac6ae8c1ceca932c63...3e8304b41177a5decefc75d0c400b820067a9367,1,7,1,8,1,2010-05-03 18:30:41,2010-05-03 18:29:08
902c6712b09f3a3a88dabdcded8c094a58e7531e...521136dfc06894f4e1e0d7ecd6ef94ec043f3954,12,623,286,909,80,2010-05-12 17:38:58,2010-05-12 17:38:58
2119496d618c4246bd7f32da43e034cbc20028f9...08f3c6968893f6bce39a772a890120235163447c,1,4,0,4,1,2010-04-22 14:33:38,2010-04-22 14:33:38
a3242b6791c3a958f8d94d01a1f9a9e82fa41d4d...3a1764027e6d5d1b28cdd604e30f05e1127c2e93,1,7,3,10,2,2010-04-22 14:36:17,2010-04-22 14:36:17
143b80e6e9321c4001dca4d9674351620afb7166...085eb2a0d14fde964de8f7d0031f5755ecd8b354,1,1,3,4,2,2010-05-03 20:27:44,2010-05-03 20:27:44
085eb2a0d14fde964de8f7d0031f5755ecd8b354...7e8ab84b41b51945fb7bf9d85fc767a91c57cf78,2,12,2,14,3,2010-05-03 20:36:04,2010-05-03 20:36:04
7e8ab84b41b51945fb7bf9d85fc767a91c57cf78...d586d7f9d9d6f79cb82d932f0fb4bb9e3a4a349b,1,20,0,20,2,2010-05-03 20:59:48,2010-05-03 20:44:16
9ed625ed2ed78fef1c333028e2d84d6d25f7cf12...bc1b26d0a90ce04a01e0124746ecaff362ce6fd2,1,1,1,2,1,2010-05-12 17:46:30,2010-05-12 17:46:30
bc1b26d0a90ce04a01e0124746ecaff362ce6fd2...190c9fb91712cf2075829f104963bad664c02349,3,15,12,27,6,2010-05-12 17:58:16,2010-05-12 17:58:16
190c9fb91712cf2075829f104963bad664c02349...322177d9c6b1673707cd4584cbe1c0e799f52aa8,1,15,13,28,6,2010-05-12 18:03:51,2010-05-12 18:03:51
322177d9c6b1673707cd4584cbe1c0e799f52aa8...37f2f983a40a9ba6915648ef1e8b55269c24084e,4,28,6,34,14,2010-05-12 18:52:43,2010-05-12 18:52:43
37f2f983a40a9ba6915648ef1e8b55269c24084e...7efe88f445b528969e24c5efa9905244c3a0db6a,15,182,115,297,81,2010-05-12 22:26:00,2010-05-12 22:26:00
7efe88f445b528969e24c5efa9905244c3a0db6a...0443cbae47175fb20ecf487035a6ecc8eb4f7ab3,2,6,3,9,4,2010-05-13 06:58:52,2010-05-13 06:58:52
08f3c6968893f6bce39a772a890120235163447c...2f2f4866398ae7afd077addf31664de3d1830e88,2,36,31,67,12,2010-04-22 15:58:19,2010-04-22 15:58:19
3e015f17c8c382cb142aafebe4bfa6d8e7469461...8e58f0256875d5c40c44d78e9d890d0a9b6ea487,1,37,11,48,8,2010-04-22 17:32:01,2010-04-22 17:32:01
8e58f0256875d5c40c44d78e9d890d0a9b6ea487...ed087a257f82dc6bc38b5abf343f0e6429278b42,1,8,1,9,2,2010-04-22 17:32:22,2010-04-22 17:32:22
ed087a257f82dc6bc38b5abf343f0e6429278b42...7486cca9e7443540f0ac5ed57f4ff5fdbc1735f3,1,1,1,2,1,2010-04-22 17:32:41,2010-04-22 17:32:41
7486cca9e7443540f0ac5ed57f4ff5fdbc1735f3...be37180c5d08bf27a9d45123c0e88a825ce2b4a9,6,164,4,168,11,2010-04-22 17:34:53,2010-04-22 17:34:53
d586d7f9d9d6f79cb82d932f0fb4bb9e3a4a349b...12293c0b3b70734d43df29964024490eb14ed585,1,9,6,15,2,2010-05-03 21:29:49,2010-05-03 21:29:49
d586d7f9d9d6f79cb82d932f0fb4bb9e3a4a349b...914a2017e5e7c451d4e88471397d8874e180b628,1,3,5,8,1,2010-05-03 21:04:55,2010-05-03 21:04:55
512fdab98cccd265cd7f07f653ed00258b343565...d72e26995e15c9c632ff9ddd0c6fa5f53e859109,1,2,3,5,2,2010-05-13 07:23:41,2010-05-13 07:23:41
d72e26995e15c9c632ff9ddd0c6fa5f53e859109...88723569747e49ab1ad644d1f91d8366e2b0f19b,4,0,10,10,7,2010-05-13 07:29:59,2010-05-13 07:29:59
88723569747e49ab1ad644d1f91d8366e2b0f19b...d2d668d31408dee1707a814fb932ef59e8dcdb24,1,4,1,5,2,2010-05-13 07:42:22,2010-05-13 07:42:22
975c730efdc7d744101d50b446d76ab0bc425c59...3243403a5fa36604a33c6ea686ee733eeaf870a2,3,31,23,54,14,2010-04-22 17:07:36,2010-04-22 17:07:36
3495eadfbb99bf5b90c9ad9b8d17dee323c7b114...ab537aed1de40c73943f2f943a535c0a89152202,3,35,13,48,16,2010-04-22 19:39:04,2010-04-22 19:39:04
3ea5307b139313209d6ba75c05b535bd0c9327ba...49d51c17274493986fa3b6dfbdc20a95677507fa,1,1,1,2,1,2010-05-04 01:49:38,2010-05-04 01:49:38
49d51c17274493986fa3b6dfbdc20a95677507fa...98e28e523c5110c48e4e6e861780f6d20a669c86,1,10,0,10,1,2010-05-04 03:21:59,2010-05-04 03:21:59
98e28e523c5110c48e4e6e861780f6d20a669c86...c540e566de6c1e2a478f62beb66efbf65a5fba56,3,36,18,54,7,2010-05-04 04:12:36,2010-05-04 04:12:36
c540e566de6c1e2a478f62beb66efbf65a5fba56...ffc097e429cd58aea0063be168b91e229b4f9942,1,1,1,2,1,2010-05-04 04:19:50,2010-05-04 04:19:50
914a2017e5e7c451d4e88471397d8874e180b628...8d7a7320cbec9b926e9704319b603b146e3e2aca,1,3,3,6,2,2010-05-04 13:58:55,2010-05-04 13:58:55
052f894fd199cb99bac173d7f4156804113f5e15...12f2748b5159b85dc824a8d285773112f2d3f782,2,2,2,4,2,2010-05-13 17:55:14,2010-05-13 17:55:14
3243403a5fa36604a33c6ea686ee733eeaf870a2...09a4b1540488c8ce9209956857dafefc0eacf296,12,118,52,170,44,2010-04-22 20:17:18,2010-04-22 20:17:18
ab537aed1de40c73943f2f943a535c0a89152202...8a477653a980779d3b115cc1d347111e8e9ac018,2,9,8,17,2,2010-04-22 21:06:13,2010-04-22 21:06:13
8a477653a980779d3b115cc1d347111e8e9ac018...5cd1a20b7fce711a784445353c2bebaab5f14ece,3,105,1,106,5,2010-04-22 21:06:39,2010-04-22 21:06:39
5cd1a20b7fce711a784445353c2bebaab5f14ece...2734be0052ea20677d1c37d4d664978e5777113b,1,2,0,2,1,2010-04-22 21:07:47,2010-04-22 21:07:47
ab537aed1de40c73943f2f943a535c0a89152202...bbb8ca9316ca429cb15aaeb7f917b3a1903b3aca,2,42,5,47,7,2010-04-22 20:00:59,2010-04-22 19:22:48
37d63af93988c6f534c6f080bed810340f255117...ed7c6c551699af5f70972526d73739d32909e99c,1,2,1,3,2,2010-05-04 14:43:31,2010-05-04 14:43:31
ed7c6c551699af5f70972526d73739d32909e99c...a8aab6f98a6c792eff72ca5f6cd6ceeb87ac6c09,3,15,5,20,7,2010-05-04 14:47:20,2010-05-04 14:47:20
a8aab6f98a6c792eff72ca5f6cd6ceeb87ac6c09...e3811ab624b674dae7c94bca8ac65a2528185169,2,122,0,122,2,2010-05-04 14:51:29,2010-05-04 14:51:29
12f2748b5159b85dc824a8d285773112f2d3f782...501b8d4d6654e6ee1586d64a245f237c8dc6566a,2,30,1,31,6,2010-05-13 18:09:22,2010-05-13 18:09:22
12f2748b5159b85dc824a8d285773112f2d3f782...a85e107de587e3f34dca26023aadd10a72440e6a,1,2,1,3,1,2010-05-13 18:00:06,2010-05-13 18:00:06
a85e107de587e3f34dca26023aadd10a72440e6a...495d0050e866ee95219280f9fb0ef370d474f001,1,24,24,48,3,2010-05-13 18:01:10,2010-05-13 18:01:10
9a640cbaa48078f9ac00a95731be4b5dcffc4134...0976928780396beb0e9c0b215e00ecaabe2a4a43,2,16,9,25,4,2010-04-22 20:23:59,2010-04-22 20:23:59
81c90b34e523ad3679a7f3d54f24eeb5dcf8269e...48fdb9c1517bc576e45a1cf3c1f2356d30ae5e78,2,3,2,5,3,2010-04-22 21:18:18,2010-04-22 21:18:18
48fdb9c1517bc576e45a1cf3c1f2356d30ae5e78...f86d93fd949777d5fbe00bf9784ec0947d6e75b9,1,9,2,11,2,2010-04-22 21:22:46,2010-04-22 21:22:46
e3811ab624b674dae7c94bca8ac65a2528185169...1efea63bdb011804bbb92fcb9c7ba2dbd9b8300e,4,113,11,124,27,2010-05-04 21:08:30,2010-05-04 21:08:30
e3811ab624b674dae7c94bca8ac65a2528185169...330f0fbe2cb4555f87d9c62254caa38d79fcd8ef,2,12,12,24,12,2010-05-04 20:49:04,2010-05-03 18:35:03
330f0fbe2cb4555f87d9c62254caa38d79fcd8ef...bad71c158460c43c6d51c94e83a5a3ce107b4f68,1,1,1,2,1,2010-05-04 20:49:04,2010-05-03 20:32:00
bad71c158460c43c6d51c94e83a5a3ce107b4f68...c8ef0e555866d6b23fd201a89cbdc669b2f60c30,2,242,2,244,16,2010-05-04 20:49:04,2010-05-04 20:46:14
d7e538ba9f34ba5a6148569cf48206db424aa157...38dd2871ad977dd01e023634db3c8019bde9ba64,1,1,1,2,1,2010-05-13 18:10:55,2010-05-13 18:10:55
38dd2871ad977dd01e023634db3c8019bde9ba64...2b4eaa94889a45db199cae250c97ce6ee2b745d6,2,57,62,119,4,2010-05-13 18:21:05,2010-05-13 18:21:05
0976928780396beb0e9c0b215e00ecaabe2a4a43...ca84dc6bb13766a36d7348cdb38c0fad5f6a50ac,9,62,24,86,21,2010-04-22 22:43:37,2010-04-22 22:43:37
fdcc7e9ba6a28f67656680e384f3c74e9ca64592...dd4097595a10332ce86f8b5103b7c8f179825637,4,5,207,212,23,2010-04-23 01:41:51,2010-04-23 01:41:51
fdcc7e9ba6a28f67656680e384f3c74e9ca64592...3758c71ab8a08a8d33fdbe7b7199d776f4c5c644,2,14,1,15,2,2010-04-23 01:02:44,2010-04-23 01:02:44
c8ef0e555866d6b23fd201a89cbdc669b2f60c30...59ea1f67e4446e96aa361ca214328534aeab0562,1,3,0,3,1,2010-05-04 20:58:31,2010-05-04 20:58:31
59ea1f67e4446e96aa361ca214328534aeab0562...1d57896a64ed13b97eeed8727fab3f64eb997b4e,1,1,1,2,1,2010-05-04 21:40:40,2010-05-04 21:40:40
2b4eaa94889a45db199cae250c97ce6ee2b745d6...4ac5ac7345df64fa701d61ebe10e93be02eeb225,1,1,0,1,1,2010-05-13 22:07:23,2010-05-13 22:07:23
9af0d52aa83c523102ae32ce10d59a9c35230246...2ec0b874c7cc287e126741f70aafafbc75c5fcd4,2,5,1,6,2,2010-04-23 03:50:02,2010-04-23 03:50:02
3758c71ab8a08a8d33fdbe7b7199d776f4c5c644...fdf1d708cfc952d58175cd6a6f479ed41aa16fd9,1,1,1,2,1,2010-04-23 03:00:10,2010-04-23 03:00:10
2d7f26f121d698147fc9a4e5e26dca1e7ecfc20b...4b81c59f016a96de9feebc36c5159a7a99999cdb,1,3,3,6,3,2010-05-04 21:43:53,2010-05-04 21:43:53
4b81c59f016a96de9feebc36c5159a7a99999cdb...5d4d3c74f1b9e33fc5b0c6d8d3910eab572a7bfe,2,18,5,23,4,2010-05-04 23:18:59,2010-05-04 23:18:59
5d4d3c74f1b9e33fc5b0c6d8d3910eab572a7bfe...14bed20c0aaf4a006d40e1901a950a47102363e3,1,19,18,37,14,2010-05-05 01:51:31,2010-05-05 01:51:31
14bed20c0aaf4a006d40e1901a950a47102363e3...646f8a72500e5e90b98662a4f279a33ceb30166c,1,4,22,26,3,2010-05-05 04:29:36,2010-05-05 04:29:36
646f8a72500e5e90b98662a4f279a33ceb30166c...0347f7e728414799ae43f962dee54bb243e5e503,1,11,11,22,1,2010-05-05 14:00:04,2010-05-05 14:00:04
e8f6e503e8bbe640f9b4c8a1b95e0344570df250...2e73b896a042d296ed84684f2fac1c76c6e70214,2,8,12,20,6,2010-05-14 01:42:08,2010-05-14 01:42:08
2e73b896a042d296ed84684f2fac1c76c6e70214...2dbdcf9e4cc4e095af4ee96607e951a5ad144b33,1,1,1,2,1,2010-05-14 14:05:46,2010-05-14 14:05:46
2dbdcf9e4cc4e095af4ee96607e951a5ad144b33...32ebb1048ad051c2cf3f32417f9084a3b68f9a20,1,6,1,7,1,2010-05-14 14:37:11,2010-05-14 14:37:11
32ebb1048ad051c2cf3f32417f9084a3b68f9a20...125940bd3b8681bc7e46f23c4b12f37b95aa4e66,2,10,1,11,2,2010-05-14 15:18:48,2010-05-14 15:18:48
125940bd3b8681bc7e46f23c4b12f37b95aa4e66...e8a8a31b18219e04ece58db614cd739a7df9b22b,4,43,22,65,9,2010-05-14 17:07:24,2010-05-14 17:07:24
e8a8a31b18219e04ece58db614cd739a7df9b22b...d060bfb595b04ba33f90a8efba1dcafe8267cb07,6,10,35,45,7,2010-05-14 17:34:50,2010-05-14 17:33:16
d060bfb595b04ba33f90a8efba1dcafe8267cb07...4b79590e83607926bfccd4dc3277796d1f26aedf,8,50,26,76,24,2010-05-14 18:01:51,2010-05-14 18:01:51
d0aa6b1cb1cf78a4fcdc4a8ef56c6d34ca9bad7e...b23e6273f4e3dab834ecb8f1c787f24581078785,2,1,2,3,2,2010-05-13 21:28:53,2010-05-13 21:28:53
d0aa6b1cb1cf78a4fcdc4a8ef56c6d34ca9bad7e...d4292887237e29bdfad87e22713f273c3de9ab70,1,2,2,4,2,2010-05-13 21:22:27,2010-05-13 21:20:12
ec5d02b9209ecf947af62eee6fcc283987dcb9b2...a60318c503bf4b2c470be23abe3acd3e721375b2,2,38,7,45,7,2010-04-23 15:22:35,2010-04-23 15:22:35
a60318c503bf4b2c470be23abe3acd3e721375b2...e7e41410dc4dacc266ab1e1c644727ec44c6a5b8,2,34,9,43,8,2010-04-23 15:22:56,2010-04-23 15:22:56
0347f7e728414799ae43f962dee54bb243e5e503...30e567df031edc474a73edd3e0f7573855c0f73d,1,12,10,22,5,2010-05-05 16:01:20,2010-05-05 16:01:20
0347f7e728414799ae43f962dee54bb243e5e503...14bbe81d6cc4e4f38dc0e05568c7a650aeaa31cd,1,12,10,22,3,2010-05-05 14:56:44,2010-05-05 14:56:44
4b79590e83607926bfccd4dc3277796d1f26aedf...d00eeffc0b0def2b703f1e24a7678da05e7fdb27,11,183,8,191,21,2010-05-14 18:45:54,2010-05-14 18:45:54
4b79590e83607926bfccd4dc3277796d1f26aedf...af9848aef93d664e3887eb255b2e388ec7aa92ff,2,7,4,11,3,2010-05-14 18:30:40,2010-05-14 18:29:41
774abd2aed568f8851383ccda869c641e86c7743...334a3eee4b515187fd5a4404bc0b36de04129499,1,1,2,3,3,2010-05-13 21:30:42,2010-05-13 21:30:42
e7e41410dc4dacc266ab1e1c644727ec44c6a5b8...837fd2cd86362410da83f3d188162545e100d94d,22,337,204,541,183,2010-04-23 19:50:49,2010-04-23 19:50:49
e7e41410dc4dacc266ab1e1c644727ec44c6a5b8...32c403d752d2530e090bb4acbc7117d4fa96efa0,1,3,1,4,2,2010-04-23 17:44:59,2010-04-23 17:44:59
32c403d752d2530e090bb4acbc7117d4fa96efa0...1d746cc4ca39790b89c8904c63ab42b41ed3d83b,4,10,7,17,11,2010-04-23 18:26:26,2010-04-23 18:19:55
1d746cc4ca39790b89c8904c63ab42b41ed3d83b...60002a474169de84eac6bce20836ee553abf731c,2,80,0,80,4,2010-04-23 18:26:26,2010-04-23 18:24:59
1e4230d41d29a37ac338819e1908b13bb4584e1d...c783a1fbba68eb760e352524885c385f02f4ef0f,8,90,15,105,19,2010-05-05 18:00:25,2010-05-05 18:00:25
14bbe81d6cc4e4f38dc0e05568c7a650aeaa31cd...59645ef064b05f5743a0ea3d0274cee479cd1088,3,34,0,34,3,2010-05-05 15:51:28,2010-05-05 15:49:14
14bbe81d6cc4e4f38dc0e05568c7a650aeaa31cd...274e404f8390c932126ba791e63e30881fd444b7,3,33,13,46,18,2010-05-05 15:02:46,2010-05-05 15:02:46
33ca8058efd410926ee97d01a464f7c83323dcc1...44b4bf454aad46a6eebf76dd0d6431deda22fa49,1,3,1,4,1,2010-05-14 20:40:40,2010-05-14 20:40:40
44b4bf454aad46a6eebf76dd0d6431deda22fa49...c73d192855799a42a1c0e8865152e8bad5059fc4,2,26,5,31,7,2010-05-14 21:08:03,2010-05-14 21:08:03
33ca8058efd410926ee97d01a464f7c83323dcc1...34e2b5421d47879291235719308cf43b404ad765,11,133,121,254,29,2010-05-14 20:32:24,2010-05-14 20:32:24
34e2b5421d47879291235719308cf43b404ad765...13406e9ac473595cce04168daf3f25fd39f7bd6c,3,4,4,8,3,2010-05-14 21:00:42,2010-05-14 21:00:42
7925232f7e0f2b9738cb29c877e7b769aab516f7...bd8a3e9527bd67c1566c4de691ed924755ac2406,21,125,93,218,64,2010-04-23 20:41:56,2010-04-23 20:41:56
7925232f7e0f2b9738cb29c877e7b769aab516f7...5e104b1f506a3288120e23b7fead5145d67f325b,1,3,3,6,1,2010-04-23 20:23:56,2010-04-23 20:23:56
5e104b1f506a3288120e23b7fead5145d67f325b...fe092fc6245453e9f03e7dec3bdc98f298ee3e9e,3,48,20,68,12,2010-04-23 20:32:31,2010-04-19 15:25:56
fe092fc6245453e9f03e7dec3bdc98f298ee3e9e...5100a7c81369f94252b05af5986e8c472adfe5b3,3,135,93,228,37,2010-04-23 20:32:31,2010-04-23 20:31:58
e33b721f4c8ce7e93beab72d49882197ecb70b74...e2972cb6a0ef05c477f9f55c8d293bc225353d82,9,62,38,100,29,2010-05-05 18:57:49,2010-05-05 18:57:49
e33b721f4c8ce7e93beab72d49882197ecb70b74...20deda97c2c96152eb39bd02d007390d49169866,4,73,52,125,42,2010-05-05 18:37:14,2010-05-05 18:36:41
39eb68c5923cdece99e1d44b46508e2e56501bb1...c8f781ce32c70ac8eaffed33322fc136fccc1394,3,0,34,34,3,2010-05-05 20:13:59,2010-05-05 20:13:59
687644ba22e592273acd5836f1611503a9f4e210...a998cca6471c39118e69f91bd6ddf7dfe6814e5a,1,7,0,7,2,2010-05-14 21:22:46,2010-05-14 21:22:46
13406e9ac473595cce04168daf3f25fd39f7bd6c...185e1497b4ce13c4e4ad93db5df8aa6e107ee428,5,18,13,31,6,2010-05-14 21:22:15,2010-05-14 21:22:15
13406e9ac473595cce04168daf3f25fd39f7bd6c...77abb3c61a4113591ae5b766e159d468ac1ee2cf,1,215,0,215,1,2010-05-14 21:01:50,2010-05-13 20:07:26
77abb3c61a4113591ae5b766e159d468ac1ee2cf...f7cf5657796d5fcf41a99a47744272dcbe17d9dc,1,6,2,8,3,2010-05-14 21:01:51,2010-05-13 20:46:44
f7cf5657796d5fcf41a99a47744272dcbe17d9dc...b7feb6af294ab63f18294242931485e00da0019c,2,50,41,91,19,2010-05-14 21:01:51,2010-05-14 17:38:26
b7feb6af294ab63f18294242931485e00da0019c...f9bba9c120426584c99458d4410bbdf7db776558,1,8,6,14,4,2010-05-14 21:01:51,2010-05-14 21:00:55
1d7e7984b61105e7747a8100c5d8d99e4b2e70f9...1d908a2740e9bda55a22d7acfb12794a180f85ab,2,8,5,13,8,2010-04-23 20:55:31,2010-04-23 20:55:31
1d908a2740e9bda55a22d7acfb12794a180f85ab...103b84006a89c24877c07963f8ae14a63f696e10,9,31,9,40,17,2010-04-23 21:35:05,2010-04-23 21:35:05
103b84006a89c24877c07963f8ae14a63f696e10...52fe13e41a71309749333aa5026f6b442f15b9ef,2,8,10,18,8,2010-04-23 21:37:05,2010-04-23 21:37:05
c64d1eddda87d4c6fe164191753740efe8577db7...e70ce01e326241aba815bed110e75f474304f56f,8,85,37,122,15,2010-05-05 20:33:35,2010-05-05 20:33:35
c64d1eddda87d4c6fe164191753740efe8577db7...9e6121b6cb59312f3106b55a2b8c4852cedcbefd,3,19,5,24,4,2010-05-05 19:52:40,2010-05-05 19:51:46
126a0f80b60aa6b5b523eda0936bccc736691bd3...30103e54184245feaedb07083c1400f91ba1eae2,2,19,18,37,3,2010-05-05 20:28:11,2010-05-05 20:27:43
e0f77553d637fc0096c7f53d3ebdc7f099b79965...d86eb9590885aa43e9153b677da3bb9b3dbc87ae,6,10,7,17,7,2010-05-14 21:29:56,2010-05-14 21:29:56
d86eb9590885aa43e9153b677da3bb9b3dbc87ae...bb4dc1d191787eab0ec63267742a7d5badb54902,1,12,0,12,1,2010-05-15 03:37:29,2010-05-15 03:37:29
bb4dc1d191787eab0ec63267742a7d5badb54902...f91cd9eda753463b1fe4bc44a4627ddf0bf2c39b,1,8,0,8,1,2010-05-15 03:57:55,2010-05-15 03:57:55
f91cd9eda753463b1fe4bc44a4627ddf0bf2c39b...acc5d31ed22ad3b83da39ca05b09543b25b63845,1,2,0,2,2,2010-05-15 11:52:23,2010-05-15 11:52:23
acc5d31ed22ad3b83da39ca05b09543b25b63845...63b7b35c7c3df010391a70b492554ab966e1c3e7,6,23,22,45,17,2010-05-15 15:44:03,2010-05-15 15:44:03
63b7b35c7c3df010391a70b492554ab966e1c3e7...b7ab21a02117b913b87c2f3c76f00d88dcf52412,2,17,2,19,4,2010-05-15 17:32:10,2010-05-15 17:32:10
b7ab21a02117b913b87c2f3c76f00d88dcf52412...c24b859ed2ea416894b6c32e357f8822d916d1cd,3,49,24,73,9,2010-05-15 18:07:11,2010-05-15 18:07:11
c24b859ed2ea416894b6c32e357f8822d916d1cd...0be3c7b901bdd0aed180a76524f70202b336c192,1,1,1,2,1,2010-05-15 18:22:30,2010-05-15 18:22:30
0be3c7b901bdd0aed180a76524f70202b336c192...6545333cb6e576670173ff59d96573a6342fc692,3,19,3,22,7,2010-05-15 18:48:40,2010-05-15 18:48:40
52fe13e41a71309749333aa5026f6b442f15b9ef...4b77d7fc780ac49a573c71fbec173c71698016c5,6,129,72,201,88,2010-04-23 22:48:20,2010-04-23 22:48:20
4b77d7fc780ac49a573c71fbec173c71698016c5...998a363ec421a179000b3bb921cf2f4ea9533b4d,1,1,1,2,1,2010-04-23 22:51:51,2010-04-23 22:51:51
52fe13e41a71309749333aa5026f6b442f15b9ef...b51ccb0204940f685c3f341dac3fdc108e24f350,1,2,2,4,1,2010-04-23 21:55:01,2010-04-23 21:55:01
b51ccb0204940f685c3f341dac3fdc108e24f350...2f197d519217eee23d04ecff2d0050cda842e89b,12,223,82,305,19,2010-04-23 22:10:14,2010-04-23 21:52:10
1faf2cb388cbb599dcbbaa061de8732f596262c5...76895b69576d4a870a0c6ab9d1dc289a2426414b,1,1,1,2,1,2010-05-05 21:47:13,2010-05-05 21:47:13
5894e3f972ab6c860a053864aad58b03ae57750c...4101e3b690ff3db71561580447a4838ad056d671,2,9,9,18,7,2010-05-06 21:25:56,2010-05-06 21:25:56
6545333cb6e576670173ff59d96573a6342fc692...4992d8314fb4540fc52b9eb81b9d4d77cf174ae2,1,8,5,13,5,2010-05-15 19:33:32,2010-05-15 19:33:32
6545333cb6e576670173ff59d96573a6342fc692...81f51d8d13d1f901c4c7edc7e770ea09334b8fdf,3,11,5,16,6,2010-05-15 19:09:18,2010-05-15 19:09:18
3f179391fb690cf9463add768456085fe6b30e78...1a277506821045e4edea4971cfb10931df046183,4,61,62,123,8,2010-04-23 23:32:21,2010-04-23 23:32:21
1a277506821045e4edea4971cfb10931df046183...ae303a06c5f8b01f00c3d18dbe97b90a69368620,5,0,10,10,7,2010-04-24 00:11:54,2010-04-23 23:43:51
ae303a06c5f8b01f00c3d18dbe97b90a69368620...0638bbfee235b70df345bf251b36228ec0416763,8,97,99,196,64,2010-04-24 00:14:37,2010-04-23 23:54:00
0638bbfee235b70df345bf251b36228ec0416763...4f4dd053aa4c50552f6504ea9900784591b684a6,15,12,17,29,15,2010-04-24 00:14:37,2010-04-24 00:09:32
4f4dd053aa4c50552f6504ea9900784591b684a6...4f3c48b853c16523e983fb00f80969e220e6ac52,1,1,1,2,1,2010-04-24 00:17:51,2010-04-24 00:17:51
4f3c48b853c16523e983fb00f80969e220e6ac52...036a302e3806d216a2b768f24c501710b9acce8d,8,7,21,28,11,2010-04-24 01:07:59,2010-04-24 01:07:59
036a302e3806d216a2b768f24c501710b9acce8d...452e5c21ea7e321b38f51dad1e9fad24faac94cc,1,1,1,2,1,2010-04-24 03:28:44,2010-04-24 03:28:44
452e5c21ea7e321b38f51dad1e9fad24faac94cc...6b337f36e1f66327186f531f2cdf52d2871a3b33,4,4,110,114,12,2010-04-24 16:58:00,2010-04-24 16:58:00
6b337f36e1f66327186f531f2cdf52d2871a3b33...0c7aa5f86140af68d79ff002453eaa7930675e6c,2,15,13,28,11,2010-04-24 17:01:26,2010-04-24 17:01:26
0c7aa5f86140af68d79ff002453eaa7930675e6c...0c7e5438e069650fdc13a75f64b492c4d4eb3e41,10,55,47,102,28,2010-04-24 18:03:14,2010-04-24 18:03:14
0c7e5438e069650fdc13a75f64b492c4d4eb3e41...07757ed88a2dfa9511c2a9799b0db215051bd35f,1,2,2,4,2,2010-04-24 18:22:43,2010-04-24 18:22:43
07757ed88a2dfa9511c2a9799b0db215051bd35f...66039bd827a1c54f619c300c67662cd01d8e19a1,5,22,12,34,10,2010-04-24 18:23:25,2010-04-24 18:23:25
66039bd827a1c54f619c300c67662cd01d8e19a1...38d1bd875ce1b5727291d2372aed328598499e7b,2,9,4,13,5,2010-04-24 18:27:15,2010-04-24 18:27:15
38d1bd875ce1b5727291d2372aed328598499e7b...7c30f9f75546520ae3a5285db68644e3d38cf640,2,2,2,4,2,2010-04-24 18:28:55,2010-04-24 18:28:55
7c30f9f75546520ae3a5285db68644e3d38cf640...d11dad41b7b201ff7c9df61f418505d90aad3b14,2,14,2,16,3,2010-04-24 18:31:23,2010-04-24 18:31:23
d11dad41b7b201ff7c9df61f418505d90aad3b14...eee1ce9b3d303d87b4f2a8881945ffc0a7c19af5,2,8,7,15,5,2010-04-24 18:40:22,2010-04-24 18:40:22
eee1ce9b3d303d87b4f2a8881945ffc0a7c19af5...ebb1a574eb81481911fd0278dee49bed86ae8ae8,3,1,13,14,4,2010-04-24 18:42:59,2010-04-24 18:42:59
ebb1a574eb81481911fd0278dee49bed86ae8ae8...0dd902e0962caf78e873dfa7adeb599456e86690,3,163,163,326,11,2010-04-24 19:04:35,2010-04-24 19:04:35
0dd902e0962caf78e873dfa7adeb599456e86690...0fdc95bfb564eaa1824a554199d8c2134e165368,6,54,24,78,21,2010-04-24 19:45:50,2010-04-24 19:45:50
0fdc95bfb564eaa1824a554199d8c2134e165368...8d3ab6a171ea3463f6bc2053351779fe37539d69,10,409,57,466,21,2010-04-24 20:43:09,2010-04-24 20:43:09
8d3ab6a171ea3463f6bc2053351779fe37539d69...96b58977fcc6cad83a79589162843659221ea1ab,9,92,30,122,20,2010-04-24 21:14:44,2010-04-24 21:14:44
96b58977fcc6cad83a79589162843659221ea1ab...c4bd46504276f7b7da07b8ab2bc1c5685004a29d,25,100,50,150,44,2010-04-24 22:25:58,2010-04-24 22:25:58
c4bd46504276f7b7da07b8ab2bc1c5685004a29d...88e56090e64516351063e4a1ad008117d2ddbada,12,346,315,661,35,2010-04-24 23:24:07,2010-04-24 23:24:07
88e56090e64516351063e4a1ad008117d2ddbada...5be10027f3663b580f57a13dd58d5d307199bd07,6,28,7,35,10,2010-04-24 23:56:42,2010-04-24 23:56:42
5be10027f3663b580f57a13dd58d5d307199bd07...98f7edd4cd06e63934700c9a79d1726e9db68a34,6,14,12,26,13,2010-04-25 01:42:37,2010-04-25 01:42:37
98f7edd4cd06e63934700c9a79d1726e9db68a34...980efef0f1925d12c302f9243e90d2b449f544bc,1,1,1,2,1,2010-04-25 01:58:05,2010-04-25 01:58:05
980efef0f1925d12c302f9243e90d2b449f544bc...4653fe570956027c687f025bcca708636a9b0b4d,1,4,0,4,1,2010-04-25 02:23:36,2010-04-25 02:23:36
4653fe570956027c687f025bcca708636a9b0b4d...35b3b71bcf036b3b9bcb3d0cf0339aed5563ca78,2,44,3,47,4,2010-04-25 02:48:09,2010-04-25 02:48:09
35b3b71bcf036b3b9bcb3d0cf0339aed5563ca78...e79374e3c964941f4a97f44d0dbefc0bcef7a566,1,0,5,5,2,2010-04-25 02:55:49,2010-04-25 02:55:23
e79374e3c964941f4a97f44d0dbefc0bcef7a566...92bca9876e76f8397b7c4929b6e7776ee0ec037e,1,3,1,4,2,2010-04-25 03:03:14,2010-04-25 03:03:14
92bca9876e76f8397b7c4929b6e7776ee0ec037e...81649832c4f7a8cf11856e756d2e037782226cc9,5,58,20,78,20,2010-04-25 20:13:21,2010-04-25 20:13:21
81649832c4f7a8cf11856e756d2e037782226cc9...8fb9289813b63ea5fcfc5800264f8b4e939c48ed,8,314,170,484,68,2010-04-25 21:48:49,2010-04-25 21:48:49
8fb9289813b63ea5fcfc5800264f8b4e939c48ed...c09a3a470346971f0e1ba510c7fe2092ef0f6506,2,3,4,7,3,2010-04-26 02:11:16,2010-04-26 02:11:16
c09a3a470346971f0e1ba510c7fe2092ef0f6506...0967ed4b5d06ecbd235f78e08ed62c97fb505f5b,4,43,12,55,11,2010-04-26 03:15:42,2010-04-26 03:15:42
0967ed4b5d06ecbd235f78e08ed62c97fb505f5b...f9b3ae89393bb00768549eaa330270a75547047e,1,1,1,2,1,2010-04-26 04:05:02,2010-04-26 04:05:02
f9b3ae89393bb00768549eaa330270a75547047e...01f08202534f5920ed71bee1a8f90b801d61bc64,5,52,8,60,18,2010-04-26 04:05:10,2010-04-26 04:05:10
01f08202534f5920ed71bee1a8f90b801d61bc64...edeafad487838a012f4b794639bf389d0e2983a3,1,1,0,1,1,2010-04-26 04:44:57,2010-04-26 04:44:57
76895b69576d4a870a0c6ab9d1dc289a2426414b...0deaaf82e7d2db20e2d31d09d9e1c4116cd1c081,2,97,2,99,4,2010-05-06 02:52:51,2010-05-06 02:52:51
76895b69576d4a870a0c6ab9d1dc289a2426414b...98abf6279ea0c9951b94156c9bfa7f238ea3240f,1,8,1,9,1,2010-05-06 00:59:11,2010-05-06 00:59:11
76895b69576d4a870a0c6ab9d1dc289a2426414b...36421f21ca0d2fcb19e11a7dcb8a8ad34d36acd7,7,20,5,25,14,2010-05-05 22:46:15,2010-05-05 22:41:59
2ffc37dce5d9d59a17c0bf070026f8a935ea619b...63f1038d2fadcd49a9eaced71016b332ddfb6b47,1,3,0,3,2,2010-05-07 02:12:13,2010-05-07 02:12:13
2ffc37dce5d9d59a17c0bf070026f8a935ea619b...d9bdbeef93e49d202d3bb03108e9f9a39f3e167d,5,40,31,71,9,2010-05-07 01:50:52,2010-05-07 01:50:52
81f51d8d13d1f901c4c7edc7e770ea09334b8fdf...0a222c57bd582ff8cba97bc99040dba0b83e62cf,1,1,1,2,1,2010-05-15 19:34:12,2010-05-15 19:34:12
edeafad487838a012f4b794639bf389d0e2983a3...53ad3023c96b654dc4d88555fa0b2398856444ee,4,13,19,32,15,2010-04-26 21:09:56,2010-04-26 21:09:56
edeafad487838a012f4b794639bf389d0e2983a3...ef571d995ff9559118a3077a477cb92bdf5e8bfa,6,41,23,64,12,2010-04-26 16:14:14,2010-04-26 16:14:14
ef571d995ff9559118a3077a477cb92bdf5e8bfa...027dbd515b9880ddb769b591432a3918fd21f174,1,3,1,4,3,2010-04-26 16:51:11,2010-04-26 16:51:11
f16161e6f103f50a3306c168bdb5a2baf9e9ad45...cabcd3c1adc3708f83453fa266a4258a73927eac,5,73,23,96,14,2010-05-06 14:05:48,2010-05-06 14:05:48
580f0c453d29d2e56d61cfce3a8547a148abea57...2bfb8ce1156f9505e0ab3327afcbdeba9b9ceb17,1,1,1,2,2,2010-05-07 13:13:41,2010-05-07 13:13:41
d9bdbeef93e49d202d3bb03108e9f9a39f3e167d...f475599d96b9c942338338f3d40fb09344a33082,5,15,13,28,15,2010-05-07 13:20:59,2010-05-07 13:20:59
0534f35b1d13df0330e8b8df3700462cd72b0697...ca9e079e22a6c11a313c51900f171946af4a628c,1,1,1,2,1,2010-05-15 21:26:00,2010-05-15 21:26:00
ca9e079e22a6c11a313c51900f171946af4a628c...803c4e15142f55445b7806a829139115d64cee9a,3,65,49,114,17,2010-05-15 22:20:55,2010-05-15 22:20:55
8351cbb2a72d4855a676cd8b64d4e9763cd8cc3d...ef19329468e90d6c50644ac454ca3d0c3f3a4ce5,1,3,0,3,1,2010-04-26 21:14:09,2010-04-26 21:14:09
027dbd515b9880ddb769b591432a3918fd21f174...9134fe08581f5cf3d1abfc6e84300ba4c0add245,1,5,3,8,4,2010-04-26 17:18:49,2010-04-26 17:18:49
027dbd515b9880ddb769b591432a3918fd21f174...a41766bef07937fe9f0e7e2d54e24126300427a9,1,52,122,174,13,2010-04-26 17:16:41,2010-04-26 17:16:41
cabcd3c1adc3708f83453fa266a4258a73927eac...edefb29e37f55d649b802924519e3441e79df5e1,7,76,67,143,28,2010-05-06 19:38:58,2010-05-06 19:38:58
cabcd3c1adc3708f83453fa266a4258a73927eac...71431eb9709e6ecb1dc7072ff06c06db9b9a4b6f,3,37,0,37,3,2010-05-06 15:51:21,2010-05-06 15:51:21
cd059bb4dd80aac3b3f9c6cf0c3177c1fbd4efad...aaebac3baaedc3a055067b35c0c7eedfd4c8b0ed,1,8,4,12,1,2010-05-07 13:53:56,2010-05-07 13:53:56
803c4e15142f55445b7806a829139115d64cee9a...0f9f5170583316a1916393902b77753b0462f702,5,17,18,35,9,2010-05-15 22:48:13,2010-05-15 22:48:13
803c4e15142f55445b7806a829139115d64cee9a...b5803d8698c417ffcd1c3808e46f7b341ba9d392,1,4,0,4,1,2010-05-15 22:27:26,2010-05-15 22:26:09
ef19329468e90d6c50644ac454ca3d0c3f3a4ce5...d646f78d6230f0fa0d619497817e17fc193f4a42,1,1,1,2,1,2010-04-27 00:31:43,2010-04-27 00:31:43
14308ffc513591bc12331637d8f2e6ea92f68b91...2ff883624b404af6652c012986b12a336b1d56bb,4,42,11,53,15,2010-04-26 19:24:16,2010-04-26 19:24:16
14308ffc513591bc12331637d8f2e6ea92f68b91...624804617e25922224dcbe87e4575124776773b1,1,4,2,6,3,2010-04-26 17:26:09,2010-04-26 16:53:44
624804617e25922224dcbe87e4575124776773b1...a71e8dc16db3ef3ccda847a8b72c6310868bb9fa,2,8,8,16,3,2010-04-26 17:26:09,2010-04-26 17:23:14
c0cb9d136e6f379a95a9214648c37d3bdd3c43ea...fba2392bb70d777efc9a575f09f49ef45a566757,1,1,1,2,1,2010-05-06 19:45:59,2010-05-06 19:45:59
fba2392bb70d777efc9a575f09f49ef45a566757...53ca30be25f99b77b90ac3708b8bdff88f51e6de,2,12,11,23,4,2010-05-06 19:46:11,2010-05-06 19:46:11
53ca30be25f99b77b90ac3708b8bdff88f51e6de...e7832618709e1ce9150c5397d1faf04dfaf8e012,5,106,8,114,9,2010-05-06 20:48:07,2010-05-06 20:48:07
aaebac3baaedc3a055067b35c0c7eedfd4c8b0ed...14a72201cfb91b1f67eb003309d53d7d2a4117da,4,72,36,108,26,2010-05-07 16:37:09,2010-05-07 16:37:09
aaebac3baaedc3a055067b35c0c7eedfd4c8b0ed...c43ab4c85dba85e39a453bf4f916492f4f6a9173,6,65,14,79,20,2010-05-07 16:19:00,2010-05-07 16:19:00
29de0a5735a35578b84962ff958614de3b8ceb07...9c12e64c4aadb67eaff0facd00a6a3cb001b5c10,1,3,4,7,4,2010-05-16 14:57:52,2010-05-16 14:57:52
29de0a5735a35578b84962ff958614de3b8ceb07...417335ae9e452bd60879a0216358b41611b2b8d4,1,11,11,22,6,2010-05-16 07:21:41,2010-05-16 07:21:41
8a0425c6df6d22e008e5463619007dba6243ddd1...b74ec76bfddb9dd694a1f0adea927d2356a3506b,1,6,0,6,1,2010-04-26 20:22:38,2010-04-26 20:21:26
e7832618709e1ce9150c5397d1faf04dfaf8e012...f6cdee6fc43b764a076297f3fe679b2dba593b03,5,64,21,85,17,2010-05-06 21:25:50,2010-05-06 21:25:50
3b4a1a3055a6a25d594f06f0f551e09523229f5b...110911331fb9e8605ad2e5249eee057909baad0b,8,76,13,89,26,2010-05-07 19:35:16,2010-05-07 19:35:16
3b4a1a3055a6a25d594f06f0f551e09523229f5b...5d0ad1504e09c29037488bdae8484804d0995311,1,3,1,4,1,2010-05-07 19:17:23,2010-05-07 19:17:23
5eb8f31fcaddee7520533d0e5ea610d8365b5c09...2f02e0c2f0d44c81175fed67bd4e05eab48a5846,8,92,69,161,42,2010-05-16 21:34:22,2010-05-16 21:34:22
2f02e0c2f0d44c81175fed67bd4e05eab48a5846...c16308dd5ef7520af26c049df68c2ab95a400595,8,102,35,137,22,2010-05-16 22:32:06,2010-05-16 22:32:06
c16308dd5ef7520af26c049df68c2ab95a400595...494b178b95ede83bb7a9819be8946c11ca1c42f7,2,30,2,32,6,2010-05-16 22:47:21,2010-05-16 22:47:21
e8102565b55945f6b0c7cf7446ca8d0c148d609c...8717179475a98d264770a70c5582bd9023271cbd,12,132,27,159,37,2010-05-07 20:42:55,2010-05-07 20:42:55
494b178b95ede83bb7a9819be8946c11ca1c42f7...8b003eab8f29ff90311662656e244020826525ce,2,2,2,4,2,2010-05-17 03:38:17,2010-05-17 03:38:17
494b178b95ede83bb7a9819be8946c11ca1c42f7...77459bc8a88a4568482f5c4858b7940b4df2fbab,1,8,1,9,2,2010-05-17 01:55:48,2010-05-17 01:55:48
8717179475a98d264770a70c5582bd9023271cbd...40a80f287e856934bc4586dc7fce8bac439fcfe6,4,25,16,41,9,2010-05-07 21:49:24,2010-05-07 21:49:24
8717179475a98d264770a70c5582bd9023271cbd...740cc1308e2e672d346e44d4b989c57c12a5bcd5,21,79,78,157,78,2010-05-07 21:25:57,2010-05-07 21:25:57
dd680041464146045df9f63258da4d0c650fe17c...1ea54f26abd464c2c2c7b1a5766dadaef31916bc,2,8,8,16,4,2010-05-17 14:16:57,2010-05-17 14:16:57
41c64683b84308bd27fcfb9a786407f8be825b96...d90d9690aa1f4cbd7fc93c343c88dfb80c74ff4f,4,14,14,28,14,2010-05-07 22:59:22,2010-05-07 22:59:22
1ea54f26abd464c2c2c7b1a5766dadaef31916bc...016af45e0b5cbe1711906fb75002031b0b573183,2,24,2,26,2,2010-05-17 14:44:17,2010-05-17 14:44:17
1ea54f26abd464c2c2c7b1a5766dadaef31916bc...8ac01ac9dc4046a04aeff48df58e670e8ea324e1,13,30,27,57,22,2010-05-17 14:38:36,2010-05-17 14:38:36
d90d9690aa1f4cbd7fc93c343c88dfb80c74ff4f...435cdcea554d5a9a103fa9ecd37ec739351171c7,3,8,8,16,8,2010-05-08 15:46:40,2010-05-08 15:46:40
435cdcea554d5a9a103fa9ecd37ec739351171c7...60395ece6f4fc676cf38f4f2b2dc233e6af783fe,1,1,1,2,1,2010-05-08 15:47:17,2010-05-08 15:47:17
60395ece6f4fc676cf38f4f2b2dc233e6af783fe...27f8361d4d651a2bce8959847c5a410a11218a20,4,129,1,130,13,2010-05-09 02:05:36,2010-05-09 02:05:36
d90d9690aa1f4cbd7fc93c343c88dfb80c74ff4f...59a33e57a1f340ae0d0b43505582c2cedda2a9fa,2,11,2,13,4,2010-05-08 02:39:33,2010-05-08 02:39:33
59a33e57a1f340ae0d0b43505582c2cedda2a9fa...e5f2cd1e3d635f21e5dedffebc47b754a33e1f83,10,182,83,265,30,2010-05-08 18:12:24,2010-05-08 18:12:24
b34044e6b2e38e32aa04d07586702ab412ffb63e...d2bb11b4b311106935d1e8692933a22972de6209,5,144,137,281,41,2010-05-17 15:00:31,2010-05-17 15:00:31
d2bb11b4b311106935d1e8692933a22972de6209...4a74e06beb68e11879aa1ac50ebb1b162c79489c,2,0,2,2,2,2010-05-17 15:15:41,2010-05-17 15:15:41
4a74e06beb68e11879aa1ac50ebb1b162c79489c...a1ecb4c44817349605288141f2ccdb605e1f55fb,1,2,6,8,2,2010-05-17 15:44:16,2010-05-17 15:44:16
ab0f396867c54037a180d32dd733982223b60c6f...84711b6e1232a9915b43012cc2f60b9284c03bf8,1,16,5,21,6,2010-05-09 02:18:43,2010-05-09 02:18:43
84711b6e1232a9915b43012cc2f60b9284c03bf8...c443bacc8f8209c8a8d3cffce415d30c46a3c68d,1,1,1,2,1,2010-05-09 02:20:53,2010-05-09 02:20:53
c443bacc8f8209c8a8d3cffce415d30c46a3c68d...3a0b24b71c5a4808bca662e5907195edc0a94dbb,1,1,0,1,1,2010-05-09 02:51:46,2010-05-09 02:51:46
3a0b24b71c5a4808bca662e5907195edc0a94dbb...859c0e775ddd3163a827118a071085583d7e7830,1,1,1,2,1,2010-05-09 03:26:59,2010-05-09 03:26:59
859c0e775ddd3163a827118a071085583d7e7830...a2ddc10462b78f14655e3fe22eeacdc7532f5687,1,12,6,18,2,2010-05-09 14:19:16,2010-05-09 14:19:16
a2ddc10462b78f14655e3fe22eeacdc7532f5687...cb3417f29b91d063c5b4030b339851c8142e9019,8,32,20,52,20,2010-05-09 19:16:14,2010-05-09 19:16:14
cb3417f29b91d063c5b4030b339851c8142e9019...6c1f1a21c0a3b9cafe45a99830a8c1a57b5cc399,6,40,22,62,19,2010-05-09 21:29:35,2010-05-09 21:29:35
6c1f1a21c0a3b9cafe45a99830a8c1a57b5cc399...02e174be471103b58e0e5cb73d00ef71ebfb372f,4,22,2,24,6,2010-05-09 22:56:06,2010-05-09 22:56:06
02e174be471103b58e0e5cb73d00ef71ebfb372f...7ff25dc9755397027046b91bf6667be6f46759d0,1,14,1,15,1,2010-05-10 12:12:52,2010-05-10 12:12:52
a1ecb4c44817349605288141f2ccdb605e1f55fb...a9e2a23cd660d048673b2cffb91956557111694f,1,1,1,2,1,2010-05-17 19:23:02,2010-05-17 19:23:02
a1ecb4c44817349605288141f2ccdb605e1f55fb...1928de9fa0482c52f8fcc2f8cb3ff2281a6895a1,1,15,5,20,5,2010-05-17 18:59:27,2010-05-17 18:59:27
a1ecb4c44817349605288141f2ccdb605e1f55fb...14114b403e1bbf890e0df9c3517a25db12e7a925,2,33,63,96,5,2010-05-17 17:02:02,2010-05-17 17:02:02
14114b403e1bbf890e0df9c3517a25db12e7a925...b55098dd80f10622481bd572143acc9815239e34,1,26,1,27,3,2010-05-18 00:26:44,2010-05-18 00:26:44
7ff25dc9755397027046b91bf6667be6f46759d0...33faaa57b1494e4ce8219245451254b0e097e735,3,13,4,17,5,2010-05-10 15:26:02,2010-05-10 15:26:02
7ff25dc9755397027046b91bf6667be6f46759d0...7728b70838ba50afa1e44adee720cb54432106da,1,1,1,2,1,2010-05-10 15:15:35,2010-05-10 15:15:35
c84569159ba7b5f1aa45999ddbfdf59c3e645089...002abac76787f5ff6cf1ca95b7f6116459be773c,1,2,0,2,2,2010-05-17 19:35:39,2010-05-17 19:35:39
7728b70838ba50afa1e44adee720cb54432106da...f20f5b76f1619cbc3c004afe2b868652ca66c626,3,8,5,13,7,2010-05-10 15:26:08,2010-05-10 15:26:08
002abac76787f5ff6cf1ca95b7f6116459be773c...ce35c184a88e3011459c6ce06bd3d5c22a0d03dc,8,65,3,68,12,2010-05-17 21:11:48,2010-05-17 21:11:48
002abac76787f5ff6cf1ca95b7f6116459be773c...7f50e165b60c576d331b3d878ec54c13fd554fad,1,4,4,8,4,2010-05-17 19:44:26,2010-05-17 19:43:56
7f50e165b60c576d331b3d878ec54c13fd554fad...cda4dc0772fbeddc934e3bf6a5e19ada5cf631e9,1,3,3,6,3,2010-05-17 20:50:33,2010-05-17 20:50:33
cda4dc0772fbeddc934e3bf6a5e19ada5cf631e9...0afdef1676fcc0e822540f0c1b8c701d4a27a670,2,0,13,13,2,2010-05-17 20:50:47,2010-05-17 20:50:47
0afdef1676fcc0e822540f0c1b8c701d4a27a670...c0adf87b3c69ce9bb7d3ad62a65e9428d50bb5fc,2,8,8,16,14,2010-05-17 20:50:58,2010-05-17 20:50:58
d107ff9d0ffafb301d4fdd66782e3267c5522e9e...dad28843bd154ab902d64e0c86ab87539a584402,2,22,5,27,6,2010-05-19 05:09:03,2010-05-19 05:09:03
dad28843bd154ab902d64e0c86ab87539a584402...4b2e9d9ac16aab622f3e1c59ae448fe6067e44e4,3,63,45,108,26,2010-05-19 05:09:22,2010-05-19 05:09:22
4b2e9d9ac16aab622f3e1c59ae448fe6067e44e4...39514a356d8555aae9e9e7aa83ae6de6f0a11721,1,5,3,8,3,2010-05-19 05:21:25,2010-05-19 05:21:25
a85b8bf517c55b99e2e1c873d4abb0bd33e69a02...3a9615865fbca730ba9b91bbca65fb212b5f4af7,1,1,1,2,1,2010-05-10 15:29:05,2010-05-10 15:29:05
3a9615865fbca730ba9b91bbca65fb212b5f4af7...4a40ae3a34b864d9ea8e8d7a7b50341f413ddc7d,1,1,1,2,1,2010-05-10 15:52:59,2010-05-10 15:52:59
5c05c7a81de7d80b33807abc789a1217ff745972...8cbcdcc9b6c6931943de09d427472a0d3662d3a9,5,26,4,30,9,2010-05-18 13:59:43,2010-05-18 13:59:43
5c05c7a81de7d80b33807abc789a1217ff745972...d2e6035de90bbc53cccb36838a6dcccfc24761dc,2,41,0,41,3,2010-05-17 21:29:19,2010-05-17 21:29:19
d2e6035de90bbc53cccb36838a6dcccfc24761dc...13fc91124c4b59f366c7983aba78e0741f664da8,3,88,11,99,10,2010-05-17 22:06:53,2010-05-17 22:06:53
39514a356d8555aae9e9e7aa83ae6de6f0a11721...9e82896c9c52f3ce9d8d012c141dfa1790dba748,1,8,4,12,4,2010-05-19 16:57:37,2010-05-19 16:57:37
4a40ae3a34b864d9ea8e8d7a7b50341f413ddc7d...4ea65d35986af7bdafdca7cc9ec6a67b24e63bf5,4,21,19,40,12,2010-05-10 18:38:10,2010-05-10 18:38:10
8e95eec64968a05135b82f7d39bdc730e62c4059...df4d9f36174ef2bf5e364874039379e6c45d4e9f,1,2,2,4,2,2010-05-18 15:36:10,2010-05-18 15:36:10
df4d9f36174ef2bf5e364874039379e6c45d4e9f...c9b60c4d663b2c2e6ac2bd4b2bfc0fa37964d79d,1,2,2,4,2,2010-05-18 16:10:26,2010-05-18 16:10:26
13fc91124c4b59f366c7983aba78e0741f664da8...c33904ddfb0edf7ba2f1d6a3acda5f2328aab5f8,16,58,41,99,19,2010-05-18 16:17:43,2010-05-18 16:17:43
17c3cef648ecdc4dc81de860756157e6fb7b4686...c1a862ddd64b0b520ab13cae59f3485eb3a972be,5,15,259,274,9,2010-05-19 13:55:45,2010-05-19 13:55:45
c1a862ddd64b0b520ab13cae59f3485eb3a972be...ec4b5cb36795dc1f97cdb0a2fe7ac40b1f96deb7,3,54,29,83,16,2010-05-19 15:56:58,2010-05-19 15:56:58
ec4b5cb36795dc1f97cdb0a2fe7ac40b1f96deb7...c830be1477b83d44df21c0909b9f64dfc5c945a6,12,30,18,48,22,2010-05-19 16:11:17,2010-05-19 16:11:17
c830be1477b83d44df21c0909b9f64dfc5c945a6...7b156448361551ab65e6d57fb743402a18a4a6d3,2,5,1,6,2,2010-05-19 16:19:56,2010-05-19 16:19:56
7b156448361551ab65e6d57fb743402a18a4a6d3...680c34aa4c4c3dc9d5b33adb57967fb270355ffd,1,1,1,2,1,2010-05-19 16:23:22,2010-05-19 16:23:22
4ea65d35986af7bdafdca7cc9ec6a67b24e63bf5...5ffd41d64674e08baed0ced379704e99a5c3f9cc,1,0,1,1,1,2010-05-11 15:17:16,2010-05-11 15:17:16
4ea65d35986af7bdafdca7cc9ec6a67b24e63bf5...a199ddb5a6521fb183e5875b9380eade442fb735,4,14,9,23,7,2010-05-10 21:13:21,2010-05-10 21:13:21
a199ddb5a6521fb183e5875b9380eade442fb735...0fd7ed8c2351fe7f836a9bc3a49beb121db64886,1,2,0,2,2,2010-05-10 23:58:01,2010-05-10 23:58:01
0fd7ed8c2351fe7f836a9bc3a49beb121db64886...9b9be9a4ee365f3c56f319daae20985e3b841d10,1,1,1,2,1,2010-05-11 01:26:32,2010-05-11 01:26:32
9b9be9a4ee365f3c56f319daae20985e3b841d10...a5e1865e2802a1a3abc078d5f3715aff111d95a1,2,11,12,23,6,2010-05-11 14:05:34,2010-05-11 14:05:34
a5e1865e2802a1a3abc078d5f3715aff111d95a1...ac0ab886748f094cfb078f020e9a7c99aa2efb06,1,1,1,2,1,2010-05-11 14:21:23,2010-05-11 14:21:23
ac0ab886748f094cfb078f020e9a7c99aa2efb06...e20da4adcf400b2e43572b58c1f7f5d546492a76,1,1,1,2,1,2010-05-11 14:48:41,2010-05-11 14:48:41
5c63d3e7e9a31eeb01b5ecc0f793c6e2c0c5e09f...0630b1946ceb66714c97dc4d7037cf45f13223f2,1,26,26,52,2,2010-05-18 16:43:35,2010-05-18 16:43:35
103ce4cc6974de49d9be53dbfaf7ffa0c0bd70f5...499ba7d2e85601b4fbe79842a9151499ea81ae88,1,17,7,24,3,2010-05-19 17:34:06,2010-05-19 17:34:06
680c34aa4c4c3dc9d5b33adb57967fb270355ffd...1b07178606bf84e31585aca4942f6b53a13b2684,2,44,13,57,8,2010-05-19 17:09:00,2010-05-19 17:09:00
680c34aa4c4c3dc9d5b33adb57967fb270355ffd...9691e2c743e135ae05af8a5e152c1d8736cbd74b,1,82,0,82,1,2010-05-19 16:48:40,2010-05-19 16:48:40
6b68851be7df93c253a76d9d9b0e9ae0e2cdeb49...1e2350147538f9220bd06a1006b2f52ded569af3,2,59,21,80,19,2010-05-11 17:33:55,2010-05-11 17:33:55
e20da4adcf400b2e43572b58c1f7f5d546492a76...04662e21d9433df61dd44a8e023c0400df40e72a,7,61,4,65,14,2010-05-11 16:06:09,2010-05-11 16:06:09
0630b1946ceb66714c97dc4d7037cf45f13223f2...638e4bcd3c9309dc3114497c5454b8549563fdfe,8,105,77,182,26,2010-05-18 18:47:11,2010-05-18 18:47:11
0630b1946ceb66714c97dc4d7037cf45f13223f2...2d06d5ea5755ab2f7aa9f2271c1ae2eebe261b32,1,6,4,10,2,2010-05-18 16:45:38,2010-05-18 16:45:38
499ba7d2e85601b4fbe79842a9151499ea81ae88...5ebeb7e122d661f498df0164971f9131a1472974,1,6,4,10,4,2010-05-19 17:36:36,2010-05-19 17:36:36
499ba7d2e85601b4fbe79842a9151499ea81ae88...d040396fa8ef656bc68ddfb2b2713ff1f2fbdd99,1,18,13,31,8,2010-05-19 17:34:29,2010-05-17 19:14:46
d040396fa8ef656bc68ddfb2b2713ff1f2fbdd99...e239134b55e3ab27ca488ecd6a646ffab5f5651b,2,38,13,51,8,2010-05-19 17:34:29,2010-05-18 23:45:23
9691e2c743e135ae05af8a5e152c1d8736cbd74b...2e34008046e694559b2a578e9e1a4a35a20d6494,1,55,9,64,8,2010-05-20 16:07:12,2010-05-20 16:07:12
c513597ca90d0b2b9d23e18007378bd78aa8be70...93a3b8ae71ab8f5e2ab8fe4e8bd8238d69cd5755,8,106,25,131,31,2010-05-11 19:58:44,2010-05-11 19:58:44
c513597ca90d0b2b9d23e18007378bd78aa8be70...6845ac00e7fd391157b2c4efb14371d26de5f105,2,21,5,26,7,2010-05-11 17:54:28,2010-05-11 17:54:28
11dfe6c7b5d8fd1812cbca5d814b86ef899ad0e7...0853f8cb209ea369f4a03b65445da10a090d3fbd,2,21,5,26,6,2010-05-11 18:14:16,2010-05-11 18:14:16
11dfe6c7b5d8fd1812cbca5d814b86ef899ad0e7...101f69cee9113e302fec35d61dd6becbd2b523e8,2,39,5,44,5,2010-05-11 16:44:10,2010-05-11 16:43:33
18dfee2cb0661180e67118730855c960b0dbea42...0f96d0434764ac833050ddba50f0d1548e31cda7,1,13,2,15,3,2010-05-18 19:08:32,2010-05-18 19:08:32
0f96d0434764ac833050ddba50f0d1548e31cda7...09a7c66525ca470bd1559df5a2fa2b61d9e93230,12,181,135,316,13,2010-05-18 20:09:46,2010-05-18 20:09:46
09a7c66525ca470bd1559df5a2fa2b61d9e93230...54e3f097b48dfae14475eacf2f97fb85c027961c,1,1,1,2,1,2010-05-18 20:32:34,2010-05-18 20:32:34
54e3f097b48dfae14475eacf2f97fb85c027961c...ba445370330a834af48dbe877d6920816a1aa849,3,76,2,78,7,2010-05-18 21:21:11,2010-05-18 21:21:11
ba445370330a834af48dbe877d6920816a1aa849...2c1d3c106c08d98f5e09b3a75f42951c1af7eb73,1,2,0,2,2,2010-05-18 21:32:28,2010-05-18 21:32:28
5093e209d0ffa145624781790041168189be3e32...433808e97574776126843b46f1ba0063863b4658,1,3,1,4,2,2010-05-19 18:56:35,2010-05-19 18:56:35
5093e209d0ffa145624781790041168189be3e32...cad5f3e5a586d6c28219de4757f5e13660223fc7,4,29,11,40,13,2010-05-19 18:21:41,2010-05-19 18:21:41
cad5f3e5a586d6c28219de4757f5e13660223fc7...51c11bc0ce67655909d11b77fca9250e80e1c382,7,24,46,70,14,2010-05-19 18:40:10,2010-05-19 18:40:10
d5936caad2e605e2b5aa46c4a1f789ba5d20f866...b5faf3b514150922d52257e554002cc01707573c,2,3,3,6,3,2010-05-20 16:10:36,2010-05-19 14:33:23
b5faf3b514150922d52257e554002cc01707573c...b35be1cbb4279e4cddab19e81aafcb7a97cc9d1e,2,10,1,11,5,2010-05-20 16:18:07,2010-05-20 16:17:42
4ed9e0f78384b823d30c9548756ed51232b6c633...334e7b55df3f737840498a5704df8f7586f5c484,4,12,2,14,5,2010-05-11 20:10:02,2010-05-11 20:10:02
334e7b55df3f737840498a5704df8f7586f5c484...9ba63e65c8092005c1db6a73f4b9d956b0f84ab2,1,13,0,13,1,2010-05-11 20:13:44,2010-05-11 20:13:44
9ba63e65c8092005c1db6a73f4b9d956b0f84ab2...9684c9cac54b7df8c4aadb5de49822ef833dcc23,2,3,2,5,2,2010-05-11 20:21:24,2010-05-11 20:21:24
9684c9cac54b7df8c4aadb5de49822ef833dcc23...c0f0eda37e85c1e36595d55a354bc89575a096ab,1,3,3,6,2,2010-05-11 20:26:33,2010-05-11 20:26:33
c0f0eda37e85c1e36595d55a354bc89575a096ab...6aa22d5172783e139415603eef01048ace13f456,2,3,2,5,2,2010-05-11 20:30:14,2010-05-11 20:30:14
6aa22d5172783e139415603eef01048ace13f456...81482b22e1441760e21fefe12e45831b3e5952e4,1,2,2,4,2,2010-05-11 20:36:26,2010-05-11 20:36:26
98494ccac9f97f84f2c81cd7785dd7053a5e33dd...d0d08c9527cce4b77ee0aeb61c17d97ee247990b,1,2,3,5,2,2010-05-11 19:12:17,2010-05-11 19:12:17
98494ccac9f97f84f2c81cd7785dd7053a5e33dd...ba5b24587c4923920f29ad2b2d41ae78a2f90e30,1,10,9,19,1,2010-05-11 19:11:01,2010-05-11 19:10:07
98494ccac9f97f84f2c81cd7785dd7053a5e33dd...bf780fbbfff29af8030aa56ca19f41d20995f08c,1,3,3,6,1,2010-05-11 19:10:48,2010-05-11 19:10:48
2c1d3c106c08d98f5e09b3a75f42951c1af7eb73...fb843b82e6680606c66362a4006472125a654a64,7,318,25,343,19,2010-05-19 13:02:27,2010-05-19 13:02:27
51c11bc0ce67655909d11b77fca9250e80e1c382...4af35d003327620ff2ca57b91e972b6a218f234e,1,11,5,16,3,2010-05-19 18:57:27,2010-05-19 18:57:27
b35be1cbb4279e4cddab19e81aafcb7a97cc9d1e...ecec906288814519103f7d50dff5475dec969edb,16,113,73,186,68,2010-05-20 17:36:29,2010-05-20 17:36:29
b35be1cbb4279e4cddab19e81aafcb7a97cc9d1e...661478e40bbc1388daa6bed2d8ef0f7557718cff,1,12,1,13,2,2010-05-20 16:27:43,2010-05-20 16:26:47
81482b22e1441760e21fefe12e45831b3e5952e4...890bfc498115ca348d547b270c6e811c3b283755,1,28,4,32,6,2010-05-12 15:47:05,2010-05-12 15:47:05
e9f05dd09181a793261a5bf587c208e9e0ff06ec...0edfb44bbfbb1b92e26cf376133d33026909e2dc,4,9,9,18,7,2010-05-11 19:18:07,2010-05-11 19:18:07
e3a72000b03b5d47e00a07e45f89fb4ec6ecb2fe...b0fa349d2eb222af8bd4aee8222128264e79b074,1,20,2,22,4,2010-05-11 21:12:43,2010-05-11 21:12:43
f72751fd2efe21adca8ae2dcc1405a99ab3ded8d...29130d0c12bd8ba64e9ca7003e817e46a54d8c4e,13,225,44,269,38,2010-05-19 21:01:09,2010-05-19 21:01:09
f72751fd2efe21adca8ae2dcc1405a99ab3ded8d...0b6d9c5a4dab05899c7de7737a5796f6ecd7ad88,2,51,15,66,7,2010-05-19 19:26:17,2010-05-19 19:25:12
0b6d9c5a4dab05899c7de7737a5796f6ecd7ad88...ed2cd04e97cda4895ca350e25a1ad083af93534c,1,1,1,2,1,2010-05-19 20:32:16,2010-05-19 20:32:16
a5a021464e72669ad013c606457a89d3112dcc5f...aeb2b3a14c829a565a6b289f0907414ed87482bf,5,28,29,57,23,2010-05-20 17:52:30,2010-05-20 17:52:30
aeb2b3a14c829a565a6b289f0907414ed87482bf...660f34878e0a87852306b2533d3d721cc177e6a5,4,17,2,19,6,2010-05-20 18:01:22,2010-05-20 18:01:22
660f34878e0a87852306b2533d3d721cc177e6a5...270f831f58517ed693835e0cf5f8805160e2fd0e,2,4,0,4,2,2010-05-20 18:05:49,2010-05-20 18:05:49
e0cd10454b34fb4306809aa031cca99fe0b53063...5ca456e9d5ea5620a9317ede544e401c7991d8fa,3,10,14,24,8,2010-05-20 17:54:57,2010-05-20 17:54:57
5ca456e9d5ea5620a9317ede544e401c7991d8fa...1b3225224b1eea5992889220592473eebc6a42cb,1,2,1,3,2,2010-05-20 18:12:42,2010-05-20 18:12:42
1b3225224b1eea5992889220592473eebc6a42cb...e4424bbe838935dadad08a4eec8714f91a80e507,2,4,2,6,4,2010-05-20 18:16:19,2010-05-20 18:16:19
e4424bbe838935dadad08a4eec8714f91a80e507...ecfa20fafef05388f9be97079910480bdc886b4a,1,12,1,13,3,2010-05-20 18:29:57,2010-05-20 18:29:57
222f2ddf5b03fdda9b93abb0fdd9138ecc62b5e6...fc66d421926fa09feb19ff179da9f5dd74cf3134,1,3,4,7,4,2010-05-12 18:03:07,2010-05-12 18:03:07
fc66d421926fa09feb19ff179da9f5dd74cf3134...8084bae344ccfbcd5baa7aa274ce704341bf0a08,1,1,0,1,1,2010-05-12 18:49:29,2010-05-12 18:49:29
8084bae344ccfbcd5baa7aa274ce704341bf0a08...f1a71ef426445167d1f3fb1fe9bd382c4b629052,2,722,2,724,2,2010-05-12 19:20:04,2010-05-12 19:20:04
f1a71ef426445167d1f3fb1fe9bd382c4b629052...063192fa3db46c4a100d27897be486d33935baba,1,320,0,320,1,2010-05-12 19:20:36,2010-05-12 19:20:36
063192fa3db46c4a100d27897be486d33935baba...37442e988784690e8dbb56c3fa74724c1207d8bb,1,601,0,601,1,2010-05-12 19:22:45,2010-05-12 19:22:45
37442e988784690e8dbb56c3fa74724c1207d8bb...d82b729a2ef0f16ca5104d8c4857af6a939637f1,4,55,32,87,19,2010-05-12 20:03:09,2010-05-12 20:03:09
d82b729a2ef0f16ca5104d8c4857af6a939637f1...d6cda7b75546c27686dc68c669d4ca13a7668492,4,85,20,105,14,2010-05-12 21:43:21,2010-05-12 21:43:21
d6cda7b75546c27686dc68c669d4ca13a7668492...89c139e69a3077a7f64418d6738185d17ac0e11b,1,1,1,2,1,2010-05-12 22:15:09,2010-05-12 22:14:45
29df4539c47d5406fbee58c2a01bcf98e97949fc...f99aba9824adf754609239274e91a9bdbd8e4cce,6,47,14,61,25,2010-05-11 23:12:13,2010-05-11 23:10:33
f99aba9824adf754609239274e91a9bdbd8e4cce...efe3870c618ad0ce0d6a75bb4f016f400a9aa589,1,1,1,2,1,2010-05-12 02:41:11,2010-05-12 02:41:11
efe3870c618ad0ce0d6a75bb4f016f400a9aa589...66683609c56bb79f117c6ac6cc0d7ea2410acb45,1,4,1,5,1,2010-05-12 03:44:14,2010-05-12 03:44:14
0edfb44bbfbb1b92e26cf376133d33026909e2dc...3caba184b41fe50a6dff7290240326bbfc471307,1,1,1,2,1,2010-05-11 19:39:04,2010-05-11 19:39:04
0edfb44bbfbb1b92e26cf376133d33026909e2dc...d0eccc9c80123e1d7e1fbfad32431d044b925008,1,15,5,20,5,2010-05-11 19:29:19,2010-05-11 19:23:50
22a5344bc460a14ffbb50f4a18770bfc9030db02...7e49e9b2261dcae4137d740dc76298b4fde57162,1,1,1,2,1,2010-05-19 21:07:46,2010-05-19 21:07:46
7e49e9b2261dcae4137d740dc76298b4fde57162...9d0b0f219753aa417a5541303453c50223eeecff,1,0,3,3,1,2010-05-19 21:12:25,2010-05-19 21:12:25
9d0b0f219753aa417a5541303453c50223eeecff...8bf7d06756d72e7ba65716279e20d0d9efdd2a59,2,1,2,3,2,2010-05-19 21:29:39,2010-05-19 21:29:39
270f831f58517ed693835e0cf5f8805160e2fd0e...5fd674d66fd8f386f834ca756bd310cafbe0d6c3,6,99,50,149,18,2010-05-20 18:50:36,2010-05-20 18:50:36
e784931f899b81f0b72257612743d41b3b603027...3c2dadcec5f606b8f689d90d7a761f37732f0a77,2,2,1,3,2,2010-05-20 18:44:22,2010-05-20 18:44:22
3c2dadcec5f606b8f689d90d7a761f37732f0a77...b75acdc7fbaec291a33b7ff9239d608ddacadf08,2,10,4,14,3,2010-05-21 05:11:46,2010-05-21 05:11:46
b75acdc7fbaec291a33b7ff9239d608ddacadf08...e22cd871582a97ee82e8ba7ea2a3461c2c48174b,2,16,1,17,3,2010-05-21 06:27:47,2010-05-21 06:27:47
89c139e69a3077a7f64418d6738185d17ac0e11b...0eec36ababbca6ef45bc22439a0b929164b2bf38,2,53,8,61,6,2010-05-13 07:13:55,2010-05-13 07:13:55
0eec36ababbca6ef45bc22439a0b929164b2bf38...42f2ce74cfee0baefde3d5235e4089f86f89dae2,6,46,18,64,20,2010-05-13 15:03:23,2010-05-13 15:03:23
8bf7d06756d72e7ba65716279e20d0d9efdd2a59...0fc313b2e3c68ebfbb56e516759ccce9f0e81bd0,2,2,0,2,2,2010-05-20 03:13:48,2010-05-20 03:13:48
8bf7d06756d72e7ba65716279e20d0d9efdd2a59...c8805d4219f72819767661543096796bb1117c87,6,16,3,19,7,2010-05-20 00:24:38,2010-05-20 00:24:38
c8805d4219f72819767661543096796bb1117c87...f858e787eb14ecbd0b600f27d3359ca05fe79160,3,9,13,22,9,2010-05-20 00:54:34,2010-05-19 21:52:27
f858e787eb14ecbd0b600f27d3359ca05fe79160...ba7d2aeb804e98edcff3c36276a4617a135fe3fe,3,40,2,42,3,2010-05-20 00:54:34,2010-05-19 23:27:04
ba7d2aeb804e98edcff3c36276a4617a135fe3fe...250294b68ec72ffc36776f10732e2fa44dafec38,2,57,13,70,6,2010-05-20 02:47:15,2010-05-20 02:47:15
1a7e2cba039d65fef6762e3b08be6df39e42a2d2...df7520399309b4f8c9d90c910ffc9d0a60ac1e10,3,84,56,140,26,2010-05-21 19:34:22,2010-05-21 19:34:22
df7520399309b4f8c9d90c910ffc9d0a60ac1e10...5dbfc209948f5578e78475032626ff45b448a612,1,7,5,12,7,2010-05-21 19:53:05,2010-05-21 19:53:05
5dbfc209948f5578e78475032626ff45b448a612...94792549ea1c9b9654ece5ad177ba4c45a476610,1,3,0,3,1,2010-05-21 19:53:37,2010-05-21 19:53:37
94792549ea1c9b9654ece5ad177ba4c45a476610...13e25a71718f5cc982477d7b71d059e1775b2dc7,2,27,14,41,5,2010-05-21 21:39:25,2010-05-21 21:39:25
13e25a71718f5cc982477d7b71d059e1775b2dc7...27e55029fd934680b93a7fcd3370345908e05151,2,11,14,25,6,2010-05-21 21:50:08,2010-05-21 21:50:08
42f2ce74cfee0baefde3d5235e4089f86f89dae2...a2e86ec16144744f7b74a8be5d836dd1951ae923,11,155,95,250,63,2010-05-13 21:18:17,2010-05-13 21:18:17
84d4b8055b1c004b3211875ea5c306fdce0ada57...008816c9ea6c7efd29eddd6bd575f316bca7210b,1,2,2,4,2,2010-05-20 11:38:47,2010-05-20 11:38:47
008816c9ea6c7efd29eddd6bd575f316bca7210b...2b0c727f943b5bf4ab2d8569d2679fadf462f80a,1,4,4,8,4,2010-05-20 13:27:59,2010-05-20 13:27:59
27e55029fd934680b93a7fcd3370345908e05151...64b10f6464b70eb5217ca44052ee95907733d203,2,1,2,3,2,2010-05-21 22:10:09,2010-05-21 22:10:09
27e55029fd934680b93a7fcd3370345908e05151...9675dc776f7a0c71a364bc00974920bf7710c435,3,1,3,4,3,2010-05-21 22:03:11,2010-05-21 22:03:11
9675dc776f7a0c71a364bc00974920bf7710c435...3de0890b5e13af0e0a4793665d2bb8f996db07b7,3,17,12,29,12,2010-05-22 20:23:09,2010-05-22 20:23:09
3de0890b5e13af0e0a4793665d2bb8f996db07b7...584be9aca6c07ee4997ad01b3b9f7d4153656d6d,2,19,25,44,7,2010-05-22 20:54:20,2010-05-22 20:54:20
584be9aca6c07ee4997ad01b3b9f7d4153656d6d...f2c178f4bcffeabf1dd8f0439dbdbb70d38c2c8b,1,1,1,2,1,2010-05-22 22:24:55,2010-05-22 22:24:55
f2c178f4bcffeabf1dd8f0439dbdbb70d38c2c8b...b375d9f7e51cbb3b0021a3ace62ea7ace577f976,1,1,1,2,1,2010-05-22 22:41:38,2010-05-22 22:41:38
b375d9f7e51cbb3b0021a3ace62ea7ace577f976...9aa407fd4e74f4a378dab7cf3437e4755a3fa1db,1,2,2,4,2,2010-05-22 23:22:07,2010-05-22 23:22:07
2b0c727f943b5bf4ab2d8569d2679fadf462f80a...d1442c9f049a7205903de4e838ab2c86677b72fb,1,2,2,4,1,2010-05-20 14:21:33,2010-05-20 14:21:33
d1442c9f049a7205903de4e838ab2c86677b72fb...69d84101daf27ee4ef1cb9fa0c7887fc66d71195,6,23,20,43,22,2010-05-20 16:40:22,2010-05-20 16:40:22
c5d40feed1da0b8c8a389c512570b1b2948c539e...7c1dcb6c1a0a2ad3ee4885de03d2b5f9bab1865b,3,24,2,26,3,2010-05-24 15:16:37,2010-05-24 15:16:37
7c1dcb6c1a0a2ad3ee4885de03d2b5f9bab1865b...ef2e50415891479b7263c57f5bd37fb3d9f0b26b,1,4,1,5,3,2010-05-24 15:21:56,2010-05-24 15:09:10
9aa407fd4e74f4a378dab7cf3437e4755a3fa1db...27f5790d110eed10b1cef77a176c945ccaab2159,7,163,83,246,29,2010-05-23 19:00:39,2010-05-23 19:00:39
27f5790d110eed10b1cef77a176c945ccaab2159...608ef69bc42570d37defbe7b966cebdb319ed3dc,5,9,9,18,8,2010-05-23 19:07:32,2010-05-23 19:07:32
608ef69bc42570d37defbe7b966cebdb319ed3dc...069b24f45a3068e3564efacc13f34aacdc619641,2,2,2,4,3,2010-05-23 19:22:46,2010-05-23 19:22:46
069b24f45a3068e3564efacc13f34aacdc619641...ae80fc22479e98bff94af6e84a4440f4a9773d30,2,12,0,12,2,2010-05-23 19:44:21,2010-05-23 19:44:21
ae80fc22479e98bff94af6e84a4440f4a9773d30...68fd2fd927e1d14c97f4faf4a5fe094abdb59380,4,21,16,37,11,2010-05-23 20:05:08,2010-05-23 20:05:08
68fd2fd927e1d14c97f4faf4a5fe094abdb59380...60c2d7dceda0f6e5aca9f20b34bda360f806f7d2,4,51,78,129,29,2010-05-23 20:23:54,2010-05-23 20:23:54
60c2d7dceda0f6e5aca9f20b34bda360f806f7d2...6efbf9af37bb6798773798244a07e9a0993908b4,4,35,4,39,9,2010-05-23 22:35:08,2010-05-23 22:35:08
6efbf9af37bb6798773798244a07e9a0993908b4...d1c913cc728905ce283dfe72da2d58f7416b12c4,2,1,2,3,2,2010-05-23 22:52:26,2010-05-23 22:52:26
9aa407fd4e74f4a378dab7cf3437e4755a3fa1db...14e68fa774a21606b7b369ae782d10d72d261656,1,17,89,106,25,2010-05-23 16:33:34,2010-05-23 16:33:34
14e68fa774a21606b7b369ae782d10d72d261656...db6337a8e85b960f18deec7bd2cad788ec4c1b05,6,307,19,326,21,2010-05-24 03:30:52,2010-05-24 03:30:52
ef2e50415891479b7263c57f5bd37fb3d9f0b26b...1b1fbec129cd118b90c2299405929729e1cecef6,7,152,29,181,30,2010-05-24 17:38:53,2010-05-24 17:38:53
ef2e50415891479b7263c57f5bd37fb3d9f0b26b...aa16959dd4c5cd4e5e5288b8b33f103ddca75553,1,8,5,13,6,2010-05-24 16:52:28,2010-05-24 16:52:28
d1c913cc728905ce283dfe72da2d58f7416b12c4...5cec50c79dc6d0cf8f9387b7fbad69a690c2d467,9,35,54,89,29,2010-05-24 12:06:05,2010-05-24 12:06:05
d1c913cc728905ce283dfe72da2d58f7416b12c4...68ce7b981ef580285e2757c16020f2b84ad87901,3,23,11,34,14,2010-05-24 05:54:15,2010-05-24 05:54:15
68ce7b981ef580285e2757c16020f2b84ad87901...b7add1f6221bd2fc3b6ffe5dcabc35a020a63033,5,267,214,481,61,2010-05-25 05:00:25,2010-05-25 05:00:25
b7add1f6221bd2fc3b6ffe5dcabc35a020a63033...595e8104a0814b4f3a7e486bcfc1a32b3040a3ff,2,34,3,37,4,2010-05-25 05:32:54,2010-05-25 05:32:54
595e8104a0814b4f3a7e486bcfc1a32b3040a3ff...54921ae594ad644081b37163baadcd9ffcfacfb9,4,65,27,92,26,2010-05-25 06:51:24,2010-05-25 06:51:24
1bab140145cfa4250716e11098cfdd014a063e9f...7c778b8c9a77f10ecc69f6528c174f47ef463131,1,2,0,2,1,2010-05-24 03:38:51,2010-05-24 03:38:51
34e707eca37bdad2ce36e2c321712bf135eaf05c...f52dfdaab1438626f8b290ac46efc35356254cb8,3,52,8,60,10,2010-05-24 18:11:08,2010-05-24 18:11:08
d8a90c0f41b113adad4dd60b911086a884250ddd...375d5f729327b7177510f4f021b3e953d1d0efea,1,1,1,2,1,2010-05-24 21:24:32,2010-05-24 21:24:32
375d5f729327b7177510f4f021b3e953d1d0efea...4bdbf1fc6752891d9a37c3ff0381a3eda1634c88,9,108,91,199,71,2010-05-24 21:24:41,2010-05-24 21:24:41
cbcce3bac1a83151fc0151e165d0bdd09d7db3a2...342e84a7aae563f258b36b217d11e0accda080ef,1,1,2,3,1,2010-05-24 15:17:29,2010-05-24 15:17:29
342e84a7aae563f258b36b217d11e0accda080ef...a8b0cceb6d751429872adefb77dce6a807b23106,1,15,3,18,2,2010-05-24 15:19:07,2010-05-24 15:19:07
f52dfdaab1438626f8b290ac46efc35356254cb8...f02bea65180cb70af01b5f2e7c074f4b2f5b3d41,8,154,92,246,46,2010-05-24 21:11:47,2010-05-24 21:11:47
f52dfdaab1438626f8b290ac46efc35356254cb8...12a3059132cf008f0a090ba52246e9fff603a472,2,20,0,20,2,2010-05-24 20:56:10,2010-05-24 20:55:26
da27708ae0b3c719c6afcfa31089cd3768c969c9...2ecc53d01558949a1de0faded6bc52aceb1a04df,4,31,16,47,14,2010-05-25 00:33:01,2010-05-25 00:33:01
2ecc53d01558949a1de0faded6bc52aceb1a04df...f26d964736d5d6130ba76bf063ee24b5b6c13273,23,0,4858,4858,23,2010-05-25 01:28:14,2010-05-25 01:28:14
6be03bc03ed40d46fdcd66f1f49f39fb0b7a81e7...db4774c752352b4afd30d75de8973bc03c2207b6,12,197,130,327,37,2010-05-26 00:39:57,2010-05-26 00:39:57
6be03bc03ed40d46fdcd66f1f49f39fb0b7a81e7...5f480f2af63f3e3f389005a1b01b0726a33a43b6,1,8,1,9,1,2010-05-25 17:13:49,2010-05-25 17:13:49
5f480f2af63f3e3f389005a1b01b0726a33a43b6...712f9eb273d2617c6a450bd39ef3b76c580de31e,1,1,0,1,1,2010-05-25 17:27:37,2010-05-25 17:27:37
712f9eb273d2617c6a450bd39ef3b76c580de31e...daf718d7e0c39a7bb901bfd1ef2c7b1f29e49355,1,1,3,4,2,2010-05-25 17:33:20,2010-05-25 17:33:20
daf718d7e0c39a7bb901bfd1ef2c7b1f29e49355...713e03c506abc803fca347902fa89815d3c6fe8c,7,62,16,78,19,2010-05-25 20:03:47,2010-05-25 20:03:47
713e03c506abc803fca347902fa89815d3c6fe8c...fa4e812db842a02cd53ddfa815011aacbee65f1c,1,2,5,7,4,2010-05-25 20:08:41,2010-05-25 20:08:41
fa4e812db842a02cd53ddfa815011aacbee65f1c...b2a9ff3aeac23468b2008ff8c70cc5771c14d3cb,3,8,9,17,6,2010-05-25 20:37:05,2010-05-25 20:37:05
633e20282f415a45ffd960c8952b5e94830721b2...5e92741bc20250874326ebf474b75751735414c6,3,24,23,47,4,2010-05-24 21:16:57,2010-05-24 21:16:57
f26d964736d5d6130ba76bf063ee24b5b6c13273...139920a1770b8c4e36236031637f3a007419e2ae,6,44,17,61,12,2010-05-25 12:34:49,2010-05-25 12:34:49
b2a9ff3aeac23468b2008ff8c70cc5771c14d3cb...349d039224e9885723f60ec5d46dffdc6689e69f,4,8,9,17,9,2010-05-25 23:01:06,2010-05-25 23:01:06
349d039224e9885723f60ec5d46dffdc6689e69f...6a0f9dfa91f4ff4e5fe40b097636fc220fdbbe77,2,0,2,2,2,2010-05-25 23:09:24,2010-05-25 23:09:24
b2a9ff3aeac23468b2008ff8c70cc5771c14d3cb...18de73318736ed61a028f03ddfd4b562cd204c39,1,3,1,4,1,2010-05-25 20:53:49,2010-05-25 20:53:49
4b683f95fc7cd562d57ad2c2cf4dec5ebd0b8c4f...6c63edff126571fb900792d6c9aed2058f520a44,1,0,11,11,1,2010-05-26 01:00:47,2010-05-26 01:00:47
e3c24717c4b7bb30da7bbe0f4160383cddc8d0f8...2a290e98a640a213774f1353f10dfdf0d59c0cbb,2,4,0,4,3,2010-05-25 23:49:52,2010-05-25 23:49:52
2a290e98a640a213774f1353f10dfdf0d59c0cbb...b545f83c754435207509ed6f0ace7af33b2cad34,2,18,13,31,6,2010-05-26 00:37:44,2010-05-26 00:37:44
9b1d7544f562b6523cf5c1f6f5dfc144dfa05e02...9f3c0fcf093d04ca6a378f048cac44e37522311c,5,4,14,18,7,2010-05-26 01:11:38,2010-05-26 01:11:38
3f5515304b9ac66996dc0e1f90ae964ccfa21e5a...b9010af418e1a8c7662677024ad1578639433827,1,2,0,2,1,2010-05-26 05:02:47,2010-05-26 05:02:47
b545f83c754435207509ed6f0ace7af33b2cad34...8affe97c8db922b0a589cf861599c1b1661b2786,1,1,0,1,1,2010-05-26 00:49:40,2010-05-26 00:49:40
9f3c0fcf093d04ca6a378f048cac44e37522311c...39f1354781b48ab08fe2cd2ee9a7997baf09589f,1,4,4,8,4,2010-05-26 04:32:39,2010-05-26 04:32:39
9f3c0fcf093d04ca6a378f048cac44e37522311c...558f5e4166f316fea31e494d2f5ad37f1eaf2251,1,3,2,5,3,2010-05-26 01:53:01,2010-05-26 01:53:01
558f5e4166f316fea31e494d2f5ad37f1eaf2251...a6e5b141c2d0bfac88d22fdf9d3bafc85c95b523,3,6,5,11,5,2010-05-26 01:53:55,2010-05-26 01:53:55
4a91c2c8b2c0913691e3114fdaa27852364fb142...ea362c0ca4c11c67358f4757741cc5f5d8839a52,7,113,51,164,23,2010-05-26 08:30:50,2010-05-26 08:30:50
8affe97c8db922b0a589cf861599c1b1661b2786...cb17065baedc5478d36a229086ae70b96fef69fb,1,1,0,1,1,2010-05-26 00:57:50,2010-05-26 00:57:50
e1188a3c61cee63ff4274251ffa319409a30485e...12f8eb68773affd75f86e6374143a8bf3831b440,2,1,1,2,1,2010-05-26 05:09:14,2010-05-26 05:09:14
a6e5b141c2d0bfac88d22fdf9d3bafc85c95b523...a190583c5180cca0f937b969e9959a1cddc19c5c,44,262,195,457,67,2010-05-26 04:46:49,2010-05-26 04:46:49
a6e5b141c2d0bfac88d22fdf9d3bafc85c95b523...560b7baafc3183ededabe99a65510ee1f39ac385,3,19,0,19,3,2010-05-26 03:26:42,2010-05-26 02:08:45
560b7baafc3183ededabe99a65510ee1f39ac385...a0925e2b80ebfae0935d324f32308303642b6d85,1,16,3,19,6,2010-05-26 03:27:37,2010-05-26 03:26:11
537967b32569f9380d8097a9997908d48f941cbd...075874207e6b189cd2428de570ee3b9b46471182,1,14,0,14,1,2010-05-26 08:47:47,2010-05-26 08:47:47
795e5ff72c5d985a4974b084468f777665934b87...fa5bb38499d9798af2aaef2a3a443b8767c83121,1,1,1,2,1,2010-05-26 05:13:33,2010-05-26 05:13:33
795e5ff72c5d985a4974b084468f777665934b87...95ce1e79ea945831201b9ae724f86a1af204100b,1,1,1,2,1,2010-05-26 05:12:49,2010-05-26 05:12:49
4f63588cbbc74fcf5ce725eaa6bbf8026b8cdff4...edc97846b7869b339de07ed6924ca59fab0ca638,2,1,2,3,2,2010-05-26 04:54:53,2010-05-26 04:54:53
edc97846b7869b339de07ed6924ca59fab0ca638...19d06f4138af0b636f38f0e66c9a96ff97f3770e,1,3,2,5,4,2010-05-26 04:56:30,2010-05-26 04:56:30
075874207e6b189cd2428de570ee3b9b46471182...24df6ebf211303196ca91df5d37a14258e2f3340,1,1,1,2,1,2010-05-26 14:34:43,2010-05-26 14:34:43
075874207e6b189cd2428de570ee3b9b46471182...c86f376300322103d46f19133a4340c243d59ba0,1,13,1,14,1,2010-05-26 13:56:51,2010-05-26 13:55:34
c86f376300322103d46f19133a4340c243d59ba0...4156a0764875c34977f585e6f5942d3229350907,1,1,1,2,1,2010-05-26 14:07:06,2010-05-26 14:07:06
afd0d0ea87b4b18621572512c5443f443cda5123...4b284d9aab2bd79bc44457250f2e08bc07f3b68c,1,1,0,1,1,2010-05-26 05:44:09,2010-05-26 05:44:09
4b284d9aab2bd79bc44457250f2e08bc07f3b68c...73895c59fca224c0b87f9b9bcc352fffe0cdf13a,1,1,0,1,1,2010-05-26 05:45:21,2010-05-26 05:45:21
19d06f4138af0b636f38f0e66c9a96ff97f3770e...ee57458fcd7d4f47936f1369c50300980886ddd7,1,1,1,2,1,2010-05-26 05:10:25,2010-05-26 05:10:25
2f12fef4cf4fa64b52cee8e2148a3a6cb9fcaa7d...4021dd2187ecc960aa0f348e9c734c4236db656d,1,12,5,17,4,2010-05-26 17:16:54,2010-05-26 17:16:54
2f12fef4cf4fa64b52cee8e2148a3a6cb9fcaa7d...11e54f988ee7a6b179a4c51b8a5cfc5d8fabdbb8,1,1,1,2,1,2010-05-26 15:11:00,2010-05-26 15:11:00
11e54f988ee7a6b179a4c51b8a5cfc5d8fabdbb8...c00f9ebe0213fd2163d130c60cdfb43ebb65d5d8,1,5,1,6,5,2010-05-26 15:11:10,2010-05-26 15:11:10
c00f9ebe0213fd2163d130c60cdfb43ebb65d5d8...0f04c206d94512341a31c8104b62900c37e29478,1,4,0,4,3,2010-05-26 15:11:15,2010-05-26 15:11:15
0f04c206d94512341a31c8104b62900c37e29478...a1c8d1b2c34a995d1928538af101c87e43f52c14,2,64,8,72,8,2010-05-26 15:32:36,2010-05-26 15:32:36
a1c8d1b2c34a995d1928538af101c87e43f52c14...4f517d086b2e05dfa1bc22c4a1331e84f540b9a4,1,5,2,7,1,2010-05-26 15:35:16,2010-05-26 15:35:16
4f517d086b2e05dfa1bc22c4a1331e84f540b9a4...ad22ba4b60e8b5760a9d520c4e2eeaf95338ab14,1,49,49,98,1,2010-05-26 15:37:28,2010-05-26 15:37:28
ad22ba4b60e8b5760a9d520c4e2eeaf95338ab14...6c101b56c11d235da8ab400f50b83334872d9571,1,29,0,29,1,2010-05-26 15:40:34,2010-05-26 15:40:34
6c101b56c11d235da8ab400f50b83334872d9571...ffd977a64c24ef880e894d3dd31dd824765dec85,12,49,44,93,44,2010-05-26 16:40:46,2010-05-26 16:40:46
6c101b56c11d235da8ab400f50b83334872d9571...e58f0f9c8ffe4500696656f47ba8da0ad7b15ba5,1,1,1,2,1,2010-05-26 16:11:21,2010-05-26 16:11:21
5f20fb048ded61f0360e047aa5234009404dcfc3...b200d9e3cb2d427b34c3586c04f2ec329a6b53ff,4,20,0,20,5,2010-05-26 17:26:16,2010-05-26 17:26:16
b200d9e3cb2d427b34c3586c04f2ec329a6b53ff...bb946a2792cd23f9b83be7321189776f3501c947,1,4,4,8,4,2010-05-26 17:27:42,2010-05-26 17:27:42
8e4612979e382e7a6cb54a82dcaa88cfba36254e...a3c322dd060b2aa1931443f08ceb5d77cd91edc9,1,1,1,2,1,2010-05-26 17:22:31,2010-05-26 17:22:31
bb946a2792cd23f9b83be7321189776f3501c947...8cd3607d2cbc90edaf1c3ab3d57faadec75f31f1,3,120,38,158,15,2010-05-26 18:44:52,2010-05-26 18:44:52
bb946a2792cd23f9b83be7321189776f3501c947...baf3721656fb68b9b6a9648fd4b09c079b0b0383,6,4,4,8,3,2010-05-26 17:35:28,2010-05-26 17:35:01
96d0a0292111a2bade56f421b138390118cd78af...2418b8cd35127f0ce522fb830379820ebb3404e7,1,1,0,1,1,2010-05-26 18:45:51,2010-05-26 18:45:51
2418b8cd35127f0ce522fb830379820ebb3404e7...3ffcb16346d34b614c8ffccf869efb2ce37f2a4b,2,82,0,82,4,2010-05-26 19:04:56,2010-05-26 19:04:56
3ffcb16346d34b614c8ffccf869efb2ce37f2a4b...2ccc219102424eddc6cadf99b13e928e227bdd78,2,17,2,19,7,2010-05-26 19:24:06,2010-05-26 19:24:06
2ccc219102424eddc6cadf99b13e928e227bdd78...16741b0805334116e7fbb6412774a763f0fc0377,1,3,0,3,1,2010-05-26 20:58:54,2010-05-26 20:58:54
16741b0805334116e7fbb6412774a763f0fc0377...4436e111c6b7f1714192d9309e8fe5ff87036be4,2,2,2,4,2,2010-05-26 21:15:27,2010-05-26 20:01:56
4436e111c6b7f1714192d9309e8fe5ff87036be4...d434279f761c540fb8d3f783c589986c6a20a48c,4,38,35,73,22,2010-05-27 03:30:48,2010-05-27 03:30:48
d434279f761c540fb8d3f783c589986c6a20a48c...aa3e6e29afc8b9ed3548d2c631eae4f8b7d41710,1,17,0,17,1,2010-05-27 05:06:45,2010-05-27 05:06:45
aa3e6e29afc8b9ed3548d2c631eae4f8b7d41710...37f2cc06a58b911f96347d02c7e105b89a0976e2,7,57,8,65,22,2010-05-27 19:21:10,2010-05-27 19:21:10
aa3e6e29afc8b9ed3548d2c631eae4f8b7d41710...d5e520ff7c7b73f7bfc2dda61f68bb79ffff0dc7,3,70,31,101,25,2010-05-27 15:39:48,2010-05-27 15:39:48
d5e520ff7c7b73f7bfc2dda61f68bb79ffff0dc7...03817ed01653204ca474f402e64d54c94ebb1094,4,9,3,12,4,2010-05-27 15:54:02,2010-05-27 15:54:02
967776e77c2d7397f0df1b5b9ea6cb6fddffaa78...1737e7eb16c711d944cd6d7e9a16b206f16de5fb,1,1,1,2,1,2010-05-27 19:50:53,2010-05-27 19:50:53
1737e7eb16c711d944cd6d7e9a16b206f16de5fb...ec609581b41b10858bb8980313703a6d6cc8baa1,6,21,20,41,14,2010-05-27 20:09:49,2010-05-27 01:47:02
ec609581b41b10858bb8980313703a6d6cc8baa1...c2db61f0aa0e24a69a84328993d8ccdd6a3f06e5,3,9,2,11,4,2010-05-27 20:09:49,2010-05-27 20:09:22
c2db61f0aa0e24a69a84328993d8ccdd6a3f06e5...42721e32cbbaa996b5fe2c4acc60b7c46a874b85,2,12,2,14,3,2010-05-27 20:33:20,2010-05-27 20:33:20
42721e32cbbaa996b5fe2c4acc60b7c46a874b85...0d9a05bce347cab58fb0a11c66ba8e0f6b4c5932,2,14,0,14,2,2010-05-27 21:29:13,2010-05-27 21:29:13
0d9a05bce347cab58fb0a11c66ba8e0f6b4c5932...d6986f0ab34d5af799d9a0763c45a629d60cfb4d,2,5,5,10,3,2010-05-27 21:36:57,2010-05-27 21:36:57
03817ed01653204ca474f402e64d54c94ebb1094...44a79b42ae557684599d91996a14c3b149ad6dbd,1,5,4,9,4,2010-05-27 19:20:41,2010-05-27 19:20:41
44a79b42ae557684599d91996a14c3b149ad6dbd...275d05f9683b622fdf2e46a958309520a04949a0,1,93,60,153,10,2010-05-27 23:03:08,2010-05-27 23:03:08
89e922485f31ceaed364cc740f51d55cd4e294a3...cf644e099151ac8dd1d96755ebfa9c51c425ab8b,3,19,0,19,3,2010-05-28 00:37:13,2010-05-28 00:37:13
cf644e099151ac8dd1d96755ebfa9c51c425ab8b...7b933846b1e9d2ff40a0ba9a565ff3e7b4c1443a,1,1,1,2,1,2010-05-28 00:46:48,2010-05-28 00:31:12
7b933846b1e9d2ff40a0ba9a565ff3e7b4c1443a...69d221f946af8643e6e0c8dafac264c80a8ad696,1,3,0,3,1,2010-05-28 15:49:07,2010-05-28 15:49:07
7b933846b1e9d2ff40a0ba9a565ff3e7b4c1443a...d3815fd318a08b1017a717117b1876f171f3aa18,1,1,1,2,1,2010-05-28 15:32:40,2010-05-28 15:32:40
59240440a809f3ad0108eb4154a1abaa7bfa5782...1798ea2d855505d2a02cf8a9b1936487caa1b568,14,124,71,195,18,2010-05-28 16:08:36,2010-05-28 16:08:36
1798ea2d855505d2a02cf8a9b1936487caa1b568...e365deea86c16237daf71decaa3600d82bd59594,14,173,10,183,31,2010-05-28 18:23:37,2010-05-28 18:23:37
e365deea86c16237daf71decaa3600d82bd59594...b6e64def70483a7bfe2b169fec501025703ad488,2,13,1,14,3,2010-05-28 18:43:49,2010-05-28 18:43:49
1798ea2d855505d2a02cf8a9b1936487caa1b568...db65d0e63caaa049e9c3fc810a336ed2fc1f1bd5,1,3,3,6,3,2010-05-28 17:56:37,2010-05-28 17:56:37
9153da3c9f9c588dc7dd3877c83ac5f69fe8b460...c9f99b7ef1079e5f2225878f451c9dadcdb6c38f,1,1,1,2,1,2010-05-28 19:14:43,2010-05-28 19:12:41
c9f99b7ef1079e5f2225878f451c9dadcdb6c38f...c347ef85f53e814cf90a3a24f6e615305702d0d0,4,34,23,57,15,2010-05-28 20:27:06,2010-05-28 20:24:52
c347ef85f53e814cf90a3a24f6e615305702d0d0...cc53dee09b16510073ac8e3cdef18823b4a3f3ed,9,65,5,70,14,2010-05-28 21:07:18,2010-05-28 21:07:18
cc53dee09b16510073ac8e3cdef18823b4a3f3ed...743d21d752a96af25b89c6c712b6d6278298aba9,7,41,35,76,34,2010-05-28 21:24:03,2010-05-28 18:18:51
743d21d752a96af25b89c6c712b6d6278298aba9...418e6790542270c51e2e17228bce530fa34acf6d,2,5,10,15,7,2010-05-28 21:24:03,2010-05-28 21:23:32
418e6790542270c51e2e17228bce530fa34acf6d...5c6f353ad689b4488efc39c8eccc9e8c33e68ac0,1,4,1,5,1,2010-05-28 22:11:52,2010-05-28 22:11:52
5c6f353ad689b4488efc39c8eccc9e8c33e68ac0...24f1d1216ad281eb98d794214dcd215712fedc73,3,10,10,20,10,2010-05-28 23:29:44,2010-05-28 23:29:44
24f1d1216ad281eb98d794214dcd215712fedc73...b6bf43c7ae1840ab47dc872df0d8e4da8bc3a748,2,207,213,420,162,2010-05-29 14:23:54,2010-05-29 14:23:54
b6bf43c7ae1840ab47dc872df0d8e4da8bc3a748...dbe11eec88a8aa65665f26251163b33a4f85fb7e,7,16,2,18,10,2010-05-29 15:10:13,2010-05-29 15:10:13
dbe11eec88a8aa65665f26251163b33a4f85fb7e...a403fb5de82290fc76e81591b33b5b9d5d69b88e,17,70,59,129,43,2010-05-29 19:45:47,2010-05-29 19:45:47
a403fb5de82290fc76e81591b33b5b9d5d69b88e...9d68fe11956184fb1c74963f5de66fae04fa763e,1,52,0,52,1,2010-05-29 19:48:17,2010-05-29 19:48:17
9d68fe11956184fb1c74963f5de66fae04fa763e...41e7a264717693993614d890f87cd4d40c1f4182,4,17,6,23,9,2010-05-29 19:54:46,2010-05-29 19:54:46
41e7a264717693993614d890f87cd4d40c1f4182...40f1af4db06913b93b97237dec316934f549f8ec,1,3,2,5,1,2010-05-29 19:57:24,2010-05-29 19:57:24
40f1af4db06913b93b97237dec316934f549f8ec...f36becfb54d64899c922111966aba3d50a60396c,5,23,30,53,12,2010-05-29 20:17:33,2010-05-29 20:17:33
f36becfb54d64899c922111966aba3d50a60396c...811980a7eb78026a1f4bf94ffdf70600808fa60a,2,23,21,44,22,2010-05-29 20:26:38,2010-05-29 20:26:38
811980a7eb78026a1f4bf94ffdf70600808fa60a...e9d175a86c4e7edd99a4e09b4095f6ce43f40440,2,11,6,17,7,2010-05-30 19:04:20,2010-05-30 19:04:20
e9d175a86c4e7edd99a4e09b4095f6ce43f40440...fbcc10e5f9fc3b69b7751fe46f66f71e59440b1a,2,20,5,25,12,2010-05-30 19:38:37,2010-05-30 19:38:37
fbcc10e5f9fc3b69b7751fe46f66f71e59440b1a...0b7047b2f44a2a9719daa771f35a8d29c8f1091a,1,1,1,2,1,2010-05-30 20:06:12,2010-05-30 20:06:12
0b7047b2f44a2a9719daa771f35a8d29c8f1091a...639d95b1f00a66315d5400138b583e9d9d6a9898,2,14,2,16,5,2010-05-31 18:24:03,2010-05-31 18:24:03
639d95b1f00a66315d5400138b583e9d9d6a9898...f5db5368e0bfa8d554037c96b4a26f7189cbf0fe,1,1,1,2,1,2010-06-01 00:40:02,2010-06-01 00:40:02
f5db5368e0bfa8d554037c96b4a26f7189cbf0fe...c1ecb70ef3159a4ba1b3c602fac540d9702398f7,6,468,462,930,28,2010-06-01 12:56:06,2010-06-01 12:56:06
c1ecb70ef3159a4ba1b3c602fac540d9702398f7...fd99e5d3abedc310b97de667034c3beaa0ce824e,8,116,35,151,33,2010-06-01 15:08:27,2010-06-01 15:08:27
fd99e5d3abedc310b97de667034c3beaa0ce824e...e40db913fc43fa3eff61099ed312c1391b4cea9b,1,0,3,3,2,2010-06-01 17:13:33,2010-06-01 17:13:33
e40db913fc43fa3eff61099ed312c1391b4cea9b...0b0fd9cd61a31a600534f563dc03574b76ac033c,3,72,12,84,9,2010-06-01 19:36:34,2010-06-01 19:36:34
0b0fd9cd61a31a600534f563dc03574b76ac033c...3a484848ea1c3e5150110542dfd5df234cb110a2,3,41,42,83,7,2010-06-01 19:57:12,2010-06-01 19:57:12
3a484848ea1c3e5150110542dfd5df234cb110a2...eb9e26c66e7676f6e7b73eeb01b1b3c2bb7bb6d6,3,43,16,59,11,2010-06-01 23:07:35,2010-06-01 23:07:35
eb9e26c66e7676f6e7b73eeb01b1b3c2bb7bb6d6...e327eff2618d2caa9afda5c3eacb440cef23e4cd,4,129,125,254,32,2010-06-01 23:21:21,2010-06-01 23:21:21
e327eff2618d2caa9afda5c3eacb440cef23e4cd...d59931700d5bef1f1f2969ce52284befe2c0d612,4,102,71,173,13,2010-06-02 19:04:46,2010-06-02 19:04:46
e40db913fc43fa3eff61099ed312c1391b4cea9b...d5bf9b19d9cfec9c4c66e51a9d533e0adb84e347,6,89,115,204,86,2010-06-01 19:17:38,2010-06-01 19:17:38
2727e026fa48dec75fa91dbbc8eceaff21f19bf6...11a67c278822a24de5a9907bb9b1c8d3b2d44690,3,13,14,27,14,2010-06-02 19:48:41,2010-06-02 19:48:41
11a67c278822a24de5a9907bb9b1c8d3b2d44690...152d1a06093553bfca9e6ba762808c0196c1bd82,1,3,3,6,3,2010-06-02 20:00:00,2010-06-02 20:00:00
152d1a06093553bfca9e6ba762808c0196c1bd82...69cb3c068d4d36ff1674cbdcd7528974d72749c5,6,15,15,30,14,2010-06-02 20:00:20,2010-06-02 20:00:20
69cb3c068d4d36ff1674cbdcd7528974d72749c5...57caf02ff3730f384bb822e8af3a1babc434c32a,11,94,127,221,86,2010-06-03 00:10:34,2010-06-03 00:10:34
57caf02ff3730f384bb822e8af3a1babc434c32a...52c30c2ccefae3855e57dce329fd30405c7dcc0c,4,39,19,58,17,2010-06-03 04:24:04,2010-06-03 04:24:04
d5bf9b19d9cfec9c4c66e51a9d533e0adb84e347...dd63f76c38f28dd8799350478367beb10a088501,6,164,123,287,64,2010-06-01 20:25:47,2010-06-01 20:25:47
d5bf9b19d9cfec9c4c66e51a9d533e0adb84e347...fd70ada38016311d609791575285a54d7fbbee61,1,1,0,1,1,2010-06-01 19:22:45,2010-05-28 16:38:12
fd70ada38016311d609791575285a54d7fbbee61...7fb0763b38c93c79cbc9a080f850e558e16a3772,1,17,8,25,6,2010-06-01 19:22:46,2010-05-28 20:19:03
7fb0763b38c93c79cbc9a080f850e558e16a3772...285568137248721603b4afe9030eba64a5b2af56,1,14,1,15,1,2010-06-01 19:38:40,2010-06-01 19:38:40
285568137248721603b4afe9030eba64a5b2af56...741d9f7a19b569beefd6156517df2cc13eed92c9,1,5,1,6,1,2010-06-01 19:48:02,2010-06-01 19:48:02
741d9f7a19b569beefd6156517df2cc13eed92c9...7d76c5e6b346fcb354ca41b3a882577e19d32d55,1,4,2,6,2,2010-06-01 20:16:02,2010-06-01 20:08:47
bcf08288c19ee91df2d9643d48a077a7868103e7...3e9108ca49a0195c9473ac3e67d316a4ec708565,4,112,84,196,81,2010-06-03 08:04:50,2010-06-03 08:04:50
3e9108ca49a0195c9473ac3e67d316a4ec708565...8d0e099546a733ae8522ef20f81365c27fd210be,1,0,1,1,1,2010-06-03 08:05:29,2010-06-03 08:05:29
8d0e099546a733ae8522ef20f81365c27fd210be...5408868567f211a234871d4bf0069555c5d7cfd8,6,14,9,23,11,2010-06-03 19:24:13,2010-06-03 19:24:13
e1043799239bae9ff0b94b4310029e684fbc6092...2c5209350cb2222065d5ade2f9089d3636a5a594,1,17,2,19,1,2010-06-01 20:36:20,2010-06-01 20:36:20
2c5209350cb2222065d5ade2f9089d3636a5a594...d869691eef5d8f49960f0717e4ca67b13d30205a,1,17,6,23,9,2010-06-01 21:25:25,2010-06-01 21:25:25
d869691eef5d8f49960f0717e4ca67b13d30205a...1262fcd3a3b7bdfaf936b1535564eebcc7f47e04,1,6,5,11,2,2010-06-01 22:40:31,2010-06-01 22:40:31
1262fcd3a3b7bdfaf936b1535564eebcc7f47e04...783bf1e4d7f5f9caadf73233df59f6672b47120f,2,3,3,6,2,2010-06-01 23:12:38,2010-06-01 23:12:38
43554f2403b2808e0e177eb6bfcf5323db9c4b5b...d7f94346d01e6431a82cc45912981e665b6dfa32,2,7,4,11,7,2010-06-03 19:50:49,2010-06-03 19:50:49
d7f94346d01e6431a82cc45912981e665b6dfa32...a87557466874e0e84df5243c7a851492aea5e018,1,2,4,6,2,2010-06-03 20:00:59,2010-06-03 20:00:59
783bf1e4d7f5f9caadf73233df59f6672b47120f...701240d1baa2303b871e232371e19fcb7d36e71f,4,299,1,300,4,2010-06-02 14:53:51,2010-06-02 14:53:51
783bf1e4d7f5f9caadf73233df59f6672b47120f...6b0b96f48a1159e5222d0aec4d0d6808a8c94513,2,7,3,10,4,2010-06-02 14:01:42,2010-06-02 14:01:42
1ebefa3cb756801de311da93ebdf0f8a98c259c2...49535d34bfd92e105e0da2b9f38ce13c7b8a0d46,5,46,6,52,13,2010-06-02 16:30:08,2010-06-02 16:30:08
49535d34bfd92e105e0da2b9f38ce13c7b8a0d46...3114e51429e588783176e2275972896caeda2352,1,14,12,26,9,2010-06-02 16:32:22,2010-06-02 16:32:22
3114e51429e588783176e2275972896caeda2352...441794c5f1e0a176293b3e61cfadeb1027da30c6,1,1,0,1,1,2010-06-02 17:06:58,2010-06-02 17:06:58
441794c5f1e0a176293b3e61cfadeb1027da30c6...70cc54c5082471a1ef85a6bedf1d12c4ae986c77,1,3,0,3,1,2010-06-02 17:09:43,2010-06-02 17:09:43
70cc54c5082471a1ef85a6bedf1d12c4ae986c77...dd276b99da24ad337cefb217aa067e0299190a26,1,16,4,20,3,2010-06-02 17:21:29,2010-06-02 17:21:29
dd276b99da24ad337cefb217aa067e0299190a26...191594cdc3fa255f8f765bcae20084cecbcea016,1,1,0,1,1,2010-06-02 17:24:41,2010-06-02 17:24:41
191594cdc3fa255f8f765bcae20084cecbcea016...9a5638cee679eebf849cf22d67f9843ec56a07d2,1,0,1,1,1,2010-06-02 17:25:59,2010-06-02 17:25:59
307b6e86f695ba9d1fa798d7af308b59ce57cac8...124efbfd638ff59353b56a940e0f0ed6ea45deaa,1,4,0,4,2,2010-06-03 20:58:46,2010-06-03 20:58:14
9a5638cee679eebf849cf22d67f9843ec56a07d2...8e7d38906d4bf8a5ba355a0c6cc360f93d37c970,1,5,3,8,2,2010-06-02 17:39:01,2010-06-02 17:39:01
9a5638cee679eebf849cf22d67f9843ec56a07d2...b0451e7853d7488c1d203bd873c0335f14f6621b,1,1,1,2,1,2010-06-02 17:35:09,2010-06-02 17:35:09
124efbfd638ff59353b56a940e0f0ed6ea45deaa...797b4f86a3b5ef80be5ce392db5be320a47d3e12,4,34,48,82,28,2010-06-03 22:45:14,2010-06-03 22:45:14
797b4f86a3b5ef80be5ce392db5be320a47d3e12...df8785e6fb184893b737c0d3fe1a0bf98ec4baf0,1,5,7,12,2,2010-06-03 22:49:08,2010-06-03 22:49:08
124efbfd638ff59353b56a940e0f0ed6ea45deaa...a923513e69d12711d84b14f97c12545c12c0c328,1,1,1,2,1,2010-06-03 21:05:03,2010-06-03 21:05:03
a923513e69d12711d84b14f97c12545c12c0c328...a0ce62f1eab82a54cc5ca31fa5d3636a0af1c25e,1,4,0,4,2,2010-06-03 22:17:26,2010-06-03 22:17:26
a0ce62f1eab82a54cc5ca31fa5d3636a0af1c25e...464850bce3bbe582b84d83c2338f158bc9b19e32,1,2,1,3,2,2010-06-03 22:37:45,2010-06-03 22:37:45
9051766500793f55b447aec23955d862b56aa01e...4d201c39db21a9201313d421bcbcd91eff6ca3cf,1,1,1,2,1,2010-06-02 18:15:54,2010-06-02 18:15:54
4d201c39db21a9201313d421bcbcd91eff6ca3cf...11e1c574e2a834ff9ed7fb76ce8ccbb2df43ee70,1,14,1,15,3,2010-06-02 18:16:01,2010-06-02 18:16:01
b0451e7853d7488c1d203bd873c0335f14f6621b...4921fd2d1ded9c08e2c9043cbaa9dda682159ca7,7,426,1,427,7,2010-06-02 17:43:18,2010-06-02 17:43:18
0ab23b6cf64fd0326c964ec17a20f97ac611fbda...7adf138b31c1f1b4b2bee82e93372ab46325ffef,1,1,1,2,1,2010-06-03 23:29:40,2010-06-03 23:28:31
7adf138b31c1f1b4b2bee82e93372ab46325ffef...6a3199b14fac03f465fb88c4684947143f1dac70,2,5,4,9,5,2010-06-03 23:29:40,2010-06-03 23:28:49
6a3199b14fac03f465fb88c4684947143f1dac70...2f13545f3728b89cfe773cc0935080c67ca711b4,2,8,0,8,2,2010-06-03 23:46:53,2010-06-03 23:46:53
2f13545f3728b89cfe773cc0935080c67ca711b4...4a7cedf9d6d28a655d6b3425b8210181f54af50a,2,5,6,11,5,2010-06-04 00:11:11,2010-06-04 00:11:11
4a7cedf9d6d28a655d6b3425b8210181f54af50a...0b140c7313e400ed96a336c7b6d9c85c893240db,1,1,1,2,1,2010-06-04 00:54:08,2010-06-04 00:54:08
0b140c7313e400ed96a336c7b6d9c85c893240db...bc96f84e6c9ad4bc43b07945929f60ec575ad306,3,12,5,17,5,2010-06-04 13:37:46,2010-06-04 13:37:46
40e862c7b6f86bba51d8cea935bd3a9fdf73f3c0...41132cdd1ae4487bfc5a5a8605dd0e9cf9d32a1e,1,4,4,8,4,2010-06-02 18:54:42,2010-06-02 18:54:42
c0dfa9473b317e0f5103bcf0a43c23fa83cb82df...46d835d6dc542a3c83925f38c782a50e34b408ec,1,9,7,16,4,2010-06-02 18:13:42,2010-06-02 18:13:42
bc96f84e6c9ad4bc43b07945929f60ec575ad306...8a7e9952eb9a6a8ef69cf587450b7f839427c299,1,9,1,10,3,2010-06-04 15:19:40,2010-06-04 15:19:40
bc96f84e6c9ad4bc43b07945929f60ec575ad306...e79e21e2e90209d9e1626ba7ddcac188a8fd4c32,10,156,0,156,10,2010-06-04 14:27:35,2010-06-04 14:25:07
881dd584efc54072bc3897e6d78c8d618f4e3deb...ed66c6013e7f6274061ce99a774018c51b3eb2f4,1,10,1,11,1,2010-06-02 19:03:03,2010-06-02 19:03:03
46d835d6dc542a3c83925f38c782a50e34b408ec...ade56fd7297f976cf750f81b0a5d9330cd70bed7,2,5,3,8,4,2010-06-02 18:25:02,2010-06-02 18:25:02
e79e21e2e90209d9e1626ba7ddcac188a8fd4c32...b45d58e2adf9b5d06cb5dbfad417e5c6b9cb807f,1,17,0,17,1,2010-06-04 19:08:53,2010-06-04 19:08:53
e79e21e2e90209d9e1626ba7ddcac188a8fd4c32...258ac46f3a24fbc811eb8cab63a91f445b65acbb,2,13,7,20,7,2010-06-04 15:34:44,2010-06-04 15:34:44
ed66c6013e7f6274061ce99a774018c51b3eb2f4...456d6a28d3add143def3614982d77c609fa9276e,1,3,1,4,1,2010-06-02 19:14:51,2010-06-02 19:14:51
835a72c4d59e17c14a6fa565ac19e4d4378b9a7d...4d3cc61f45a1ea5eaaa9d330926b438c12b7c1f8,3,91,1,92,8,2010-06-04 18:02:20,2010-06-04 18:02:20
4d3cc61f45a1ea5eaaa9d330926b438c12b7c1f8...fe53cbdbfdfaa8ef5c4b4be3e9f80bc231c5d784,3,26,2,28,4,2010-06-04 18:23:41,2010-06-04 18:23:41
4991e2804b87e2c36a8ad5515f448ee45252ea67...13d410ce1ba6d3d0158f0bb33287c916399ec9e5,1,9,0,9,2,2010-06-04 19:35:51,2010-06-04 19:35:51
456d6a28d3add143def3614982d77c609fa9276e...e90228a360f63736c8e3ca9fca7d5d4d78dcb643,1,5,3,8,2,2010-06-02 20:04:33,2010-06-02 20:04:33
456d6a28d3add143def3614982d77c609fa9276e...8bfc290d809e8e0d1e091e5dd7a390b82291f413,1,16,3,19,4,2010-06-02 20:00:51,2010-06-02 20:00:51
fe53cbdbfdfaa8ef5c4b4be3e9f80bc231c5d784...dc38d171314ec629a29ec7e281c8892795d07041,5,55,10,65,13,2010-06-04 19:37:37,2010-06-04 19:37:37
fe53cbdbfdfaa8ef5c4b4be3e9f80bc231c5d784...d7a8bfbf3ac564dac342ce036a16e430ff69bf6d,2,78,50,128,19,2010-06-04 18:39:12,2010-06-04 18:39:12
d7a8bfbf3ac564dac342ce036a16e430ff69bf6d...8cb6622704406e241051cb21cbd2533e5a7d6cfc,1,8,8,16,4,2010-06-04 19:03:01,2010-06-04 19:01:56
13d410ce1ba6d3d0158f0bb33287c916399ec9e5...80fa0f845036e95f4b12a444d287e505e931824c,1,15,0,15,1,2010-06-04 20:41:21,2010-06-04 20:41:21
42759019925ee83dee727273f60613c380d1a154...f497f61ae28bd4f7fe3f19f94abbe9bba839ff18,1,1,1,2,1,2010-06-02 20:09:36,2010-06-02 20:09:36
f497f61ae28bd4f7fe3f19f94abbe9bba839ff18...c55b81010a06d84619b54860303977d858207d65,1,33,17,50,5,2010-06-02 20:31:01,2010-06-02 20:31:01
c55b81010a06d84619b54860303977d858207d65...2d307fdf81c4f146b6748c510c4fd0bc817baff3,3,29,6,35,9,2010-06-02 20:38:28,2010-06-02 20:38:28
2d307fdf81c4f146b6748c510c4fd0bc817baff3...afd64fa94e291e673d9ad7a74a75d63f71e8cab7,2,3,1,4,2,2010-06-02 20:43:05,2010-06-02 20:43:05
afd64fa94e291e673d9ad7a74a75d63f71e8cab7...ac3a6970756a2f8e6e215507fc8e8b6e158280b9,1,2,2,4,2,2010-06-02 20:45:16,2010-06-02 20:45:16
ac3a6970756a2f8e6e215507fc8e8b6e158280b9...2b732cf4dad79543f866599367f7032fc8940a44,1,7,19,26,7,2010-06-02 20:50:05,2010-06-02 20:50:05
87f5f75e4c5be4cf21b90eb47f971c659950fe45...6e8fafab5871d442318d8deeda57555eae54a797,4,14,7,21,6,2010-06-04 19:54:25,2010-06-04 19:54:25
6e8fafab5871d442318d8deeda57555eae54a797...efe90867ca7602e80934dac03ca979824494f1fd,5,260,157,417,34,2010-06-04 20:14:34,2010-06-04 20:14:34
f753d63e81586a1c813261e961de82e3d14418f7...efde5cf575afd1cb8ffe9493d0452042287f3a99,7,105,23,128,30,2010-06-05 01:38:54,2010-06-04 23:14:59
efde5cf575afd1cb8ffe9493d0452042287f3a99...3fa734901337e5f9515de056256d8a1d3ce880b8,3,63,13,76,11,2010-06-05 03:07:41,2010-06-05 03:07:41
3fa734901337e5f9515de056256d8a1d3ce880b8...28af8e5d49cc340bd805f4c1d43b9a9180d320e9,1,63,2,65,5,2010-06-05 04:15:49,2010-06-05 04:15:49
28af8e5d49cc340bd805f4c1d43b9a9180d320e9...5eae2c9aea278d4b549ec17ac139cd9b4dabf10d,1,2,5,7,1,2010-06-05 04:33:43,2010-06-05 04:33:43
5eae2c9aea278d4b549ec17ac139cd9b4dabf10d...125e11d87a6a47157e9bd771fb0f516efbf5e92c,5,17,1,18,8,2010-06-05 18:48:05,2010-06-05 18:48:05
2b732cf4dad79543f866599367f7032fc8940a44...0606c4947ef5ea5e7bcd87ca63906c962ef32ed1,2,5,1,6,4,2010-06-02 21:01:28,2010-06-02 21:01:28
2b732cf4dad79543f866599367f7032fc8940a44...c0ee1ec9aa58427d2d094d95844a7621692413a1,1,8,4,12,4,2010-06-02 20:57:06,2010-06-02 20:57:06
125e11d87a6a47157e9bd771fb0f516efbf5e92c...931acbf20c50bcfa8006188c6c324968212dbaf7,2,33,29,62,12,2010-06-05 20:37:00,2010-06-05 20:37:00
125e11d87a6a47157e9bd771fb0f516efbf5e92c...e9ac0d3a9f791ee026112e54b2ddf2da05fb09e2,4,157,101,258,23,2010-06-05 20:17:59,2010-06-05 20:17:59
c0ee1ec9aa58427d2d094d95844a7621692413a1...359853498277cbf07e5ef597c23679b33d781cf8,2,29,2,31,7,2010-06-02 21:15:31,2010-06-02 21:15:31
5fc3ff219876a3a09b7847cad79af42823c5b1d2...4bf152cd56b81d61c45d4c91dc036590b3552469,13,504,25,529,18,2010-06-06 00:55:11,2010-06-06 00:55:11
5fc3ff219876a3a09b7847cad79af42823c5b1d2...ef6a47ad092c69f560e12554142f6c9a96ec7743,5,84,4,88,6,2010-06-05 21:54:49,2010-06-05 21:54:49
ef6a47ad092c69f560e12554142f6c9a96ec7743...49784bbb51f8e404f50427377c28260aa3ccd248,1,1,1,2,1,2010-06-05 21:58:09,2010-06-05 21:58:09
49784bbb51f8e404f50427377c28260aa3ccd248...7ef3f9a9e82f5bd4724858342b826d1004d49ac7,2,6,4,10,2,2010-06-05 23:17:11,2010-06-05 23:17:11
7da988488b79e8ea95604d70f6195687048ef2be...572c7439710663a5bdd7a7ecb62bb119aa59abbc,1,19,5,24,7,2010-06-03 18:29:11,2010-06-03 18:29:11
572c7439710663a5bdd7a7ecb62bb119aa59abbc...0ad4e0a9e8beda460eda9272d0a4bd8498cf0f76,1,4,0,4,1,2010-06-03 18:35:13,2010-06-03 18:35:13
0ad4e0a9e8beda460eda9272d0a4bd8498cf0f76...2fb5ba7c3157bbbe3dc615b58f7f8a69d9bebfdb,1,1,1,2,1,2010-06-03 18:42:31,2010-06-03 18:42:31
7da988488b79e8ea95604d70f6195687048ef2be...327ccee4ed1acef16640c8885dfa6a0f11ee0e48,1,5,1,6,1,2010-06-03 14:02:38,2010-06-03 14:02:38
327ccee4ed1acef16640c8885dfa6a0f11ee0e48...796487a5832e745cbc4754950ac3d55a2ecad878,1,1,1,2,1,2010-06-03 14:07:17,2010-06-03 14:07:17
796487a5832e745cbc4754950ac3d55a2ecad878...32dcad0fea3847028dd0e9430d1a697894c98795,1,0,4,4,1,2010-06-03 14:15:44,2010-06-03 14:15:44
7daf495c282f85b1826991ee95920617394e6800...11b243686cba5783507c9fbfa4fb46a2a003cd20,1,6,9,15,7,2010-06-06 01:39:07,2010-06-06 01:39:07
11b243686cba5783507c9fbfa4fb46a2a003cd20...d7bca8d38078a1d69977ef82e97b8835997956f9,2,5,5,10,6,2010-06-06 01:46:53,2010-06-06 01:46:53
d7bca8d38078a1d69977ef82e97b8835997956f9...a3e03d7fe8900f6ea328b3c878e89bad068bc438,6,30,22,52,22,2010-06-06 02:37:59,2010-06-06 02:37:59
0e0ef6000f4a44c35533c3c79ca5ec82c92506b7...89536fd4b1b0c64f9fcc6173d539cf52590a6a95,2,9,1,10,2,2010-06-03 19:00:09,2010-06-03 19:00:09
32dcad0fea3847028dd0e9430d1a697894c98795...9ee37421cd2bb54215630b4cc7e4ed98f5dd5921,1,1,1,2,1,2010-06-03 16:54:38,2010-06-03 16:54:38
32dcad0fea3847028dd0e9430d1a697894c98795...30126d08c8df852e641a7cff53fddc5f174dc428,1,5,2,7,2,2010-06-03 16:35:59,2010-06-02 21:06:51
a3e03d7fe8900f6ea328b3c878e89bad068bc438...3f8da3805a1dbff668b1386df8076ec64ef0522d,11,97,50,147,37,2010-06-06 19:46:55,2010-06-06 19:46:55
a3e03d7fe8900f6ea328b3c878e89bad068bc438...0aa608baa6ce30d2d507b8756de661fa038623d3,2,25,58,83,4,2010-06-06 14:50:39,2010-06-06 14:50:39
89536fd4b1b0c64f9fcc6173d539cf52590a6a95...5e9fb25867a2eb87451e4cb878a4db74e95e82d8,1,6,2,8,3,2010-06-03 19:45:46,2010-06-03 19:45:46
5e9fb25867a2eb87451e4cb878a4db74e95e82d8...e0d5317f6b180a7ee0ff3e2c25b1f9beb4e9a5d4,1,15,0,15,1,2010-06-03 19:54:20,2010-06-03 18:03:10
e0d5317f6b180a7ee0ff3e2c25b1f9beb4e9a5d4...73b955c26718ade1a3fcdc9308774082d4aad03d,4,104,1,105,5,2010-06-03 19:54:20,2010-06-03 19:35:03
73b955c26718ade1a3fcdc9308774082d4aad03d...7fc82df75eceff81b3e99a4e1cea7b9cbb255cf9,1,3,0,3,2,2010-06-03 19:54:20,2010-06-03 19:52:22
1f2c2e8cb69636453838ba7abd6facda1067e603...f7c05f5946a65f5838fd5f45c8ef4f378841bd4f,2,7,7,14,4,2010-06-03 20:50:51,2010-06-03 20:50:51
1f2c2e8cb69636453838ba7abd6facda1067e603...4cd8bf8291b0c6a195a62248cbf8715d72f29934,1,4,6,10,3,2010-06-03 17:10:28,2010-06-03 17:08:28
4cd8bf8291b0c6a195a62248cbf8715d72f29934...79e9558062a2f17caafa7092bf0fd3df7f7520c4,1,8,2,10,2,2010-06-03 18:23:20,2010-06-03 17:15:11
e595edb3f044485bb29dc69ac2daa0efa521ba55...3ac7b057374597b7caab73f7d889683424c43dc6,9,482,385,867,24,2010-06-07 02:19:06,2010-06-07 02:19:06
3ac7b057374597b7caab73f7d889683424c43dc6...ac3c063d9009398edc87810bff1efeba885000e3,2,16,2,18,3,2010-06-07 06:22:43,2010-06-07 06:22:43
ac3c063d9009398edc87810bff1efeba885000e3...370f9a1bd2675a84dc13283bbd501a1d978b3092,7,87,28,115,17,2010-06-07 15:17:08,2010-06-07 15:17:08
ac3c063d9009398edc87810bff1efeba885000e3...a63c019309929b1cfd6ab54a1547e259aebc392a,1,78,12,90,14,2010-06-07 14:04:06,2010-05-25 22:03:14
a63c019309929b1cfd6ab54a1547e259aebc392a...6199f2db33044be45e4a04df4cd8c557a6dbc479,2,80,52,132,22,2010-06-07 14:04:06,2010-06-07 14:03:07
ed7cfda35f0fd281c531eff36ee752eaf7448dfe...9f22a44e0583cb9f50ef039cceb6d90782a3155b,7,134,17,151,12,2010-06-07 19:15:06,2010-06-07 19:15:06
ed7cfda35f0fd281c531eff36ee752eaf7448dfe...d4256a4c9bc6ad1210c5214501ddb3d139fbdd38,5,33,9,42,6,2010-06-07 18:08:55,2010-06-07 18:08:55
d4256a4c9bc6ad1210c5214501ddb3d139fbdd38...8680389bba5b0ea56556957fd2f7e99fc467b1d2,5,44,77,121,15,2010-06-07 19:18:00,2010-06-07 19:18:00
8680389bba5b0ea56556957fd2f7e99fc467b1d2...ef38ae3d50c0578350a31389886520f3acd46a4a,4,35,6,41,7,2010-06-07 21:13:57,2010-06-07 21:13:57
ef38ae3d50c0578350a31389886520f3acd46a4a...7c420d1897ff2944bc4a6276e53e9d2460d78935,3,62,10,72,9,2010-06-08 01:23:59,2010-06-08 01:23:59
7c420d1897ff2944bc4a6276e53e9d2460d78935...1f84e41c344d4ef0e8caa02ed7bf00fcf8cf3b76,2,11,2,13,2,2010-06-08 02:01:46,2010-06-08 02:01:46
1f84e41c344d4ef0e8caa02ed7bf00fcf8cf3b76...15179bc5917f7635293c92c93095e4982d370281,6,71,31,102,18,2010-06-08 07:33:56,2010-06-08 07:33:56
ed7cfda35f0fd281c531eff36ee752eaf7448dfe...a3388501c5ec22402534a753b37a464b42f6642a,1,4,4,8,1,2010-06-07 15:29:02,2010-06-07 15:29:02
6199f2db33044be45e4a04df4cd8c557a6dbc479...11dd486bdb40d950d5b716bbd44befc8e365570f,1,14,11,25,5,2010-06-07 15:01:41,2010-06-07 15:01:41
6199f2db33044be45e4a04df4cd8c557a6dbc479...a4c850a06de9a14f99d1c93c236beab983573f6b,1,14,0,14,1,2010-06-07 14:55:43,2010-06-07 14:55:43
a4c850a06de9a14f99d1c93c236beab983573f6b...8c6a00675f53749ea0ebea1e7027c199e24df7e5,1,1,0,1,1,2010-06-07 14:56:05,2010-06-07 14:56:05
8c6a00675f53749ea0ebea1e7027c199e24df7e5...b9c427ec29891dd62a3a0d6ccbbb46a785f244a6,2,72,5,77,7,2010-06-07 15:06:02,2010-06-07 15:06:02
944ab0744918d50f1aef30c44a0f9db6f5fa75c6...e99f90dad0f28c5a67c87dc6d397d0ee807cf945,1,2,0,2,2,2010-06-07 22:40:37,2010-06-07 22:40:37
e99f90dad0f28c5a67c87dc6d397d0ee807cf945...c0cc46954be09d4973f5450e8884204d73667f6b,2,2,2,4,2,2010-06-07 22:53:04,2010-06-07 22:53:04
c0cc46954be09d4973f5450e8884204d73667f6b...54caa6f78de315191ce587a7348c8cfb25e97ca0,6,1646,1544,3190,13,2010-06-08 00:31:27,2010-06-08 00:31:27
54caa6f78de315191ce587a7348c8cfb25e97ca0...001b28d3f6d188a8806de4ec7e50d54f749bfe62,2,37,24,61,4,2010-06-08 01:38:23,2010-06-08 01:38:23
001b28d3f6d188a8806de4ec7e50d54f749bfe62...4c51a62b5bddf47b8d2592028f1a6a6d834d65af,5,31,16,47,9,2010-06-08 01:50:36,2010-06-08 01:50:36
11dd486bdb40d950d5b716bbd44befc8e365570f...21157295d433d30bcc52144369fd146688d80739,2,76,172,248,21,2010-06-09 17:10:59,2010-06-09 17:10:59
09c18ee468e20fd8704268ad0779c009e6939ec7...353a2315cf8c5c877e911264a7001d85aef75eda,1,3,1,4,1,2010-06-07 20:48:53,2010-06-07 20:48:53
353a2315cf8c5c877e911264a7001d85aef75eda...80a8ec1b4f32f6d524ae81039e072333b4243c90,1,14,5,19,4,2010-06-07 21:28:18,2010-06-07 21:28:18
4c51a62b5bddf47b8d2592028f1a6a6d834d65af...5b85eae44fa42b49535a4cb7e3f5f4fcc5654587,3,64,12,76,11,2010-06-08 12:20:44,2010-06-08 12:20:44
5b85eae44fa42b49535a4cb7e3f5f4fcc5654587...374fdf83e46642de2c042fbfb3483eca085c183e,1,1,1,2,1,2010-06-08 12:52:58,2010-06-08 12:52:58
374fdf83e46642de2c042fbfb3483eca085c183e...164e6e9fb3736681ab50065212b104e41312840a,1,1,1,2,1,2010-06-08 13:06:35,2010-06-08 13:06:35
144919657ecacd719419d486e8fd229bb69c505a...c8e0f33f3f1ef54cfd9fd358dcba3798de700ef0,4,28,21,49,6,2010-06-08 19:29:30,2010-06-08 19:29:30
c8e0f33f3f1ef54cfd9fd358dcba3798de700ef0...05c5af2b40cc840b455dfdd09042c738f872b946,1,15,0,15,1,2010-06-08 19:43:19,2010-06-08 19:43:19
05c5af2b40cc840b455dfdd09042c738f872b946...5be4d78fba6c8ed16aa021f294ea20111029c86a,3,10,8,18,7,2010-06-08 22:55:34,2010-06-08 22:55:34
e1f27699e9ef568c00063a40127875355dd4dc91...a18d67076188ae7288d993a6581daea444ac1cf3,3,32,8,40,6,2010-06-09 20:47:49,2010-06-09 20:47:49
a18d67076188ae7288d993a6581daea444ac1cf3...eabc79c785d7687af057b4d0dd3ee657fa32760d,6,42,12,54,10,2010-06-09 21:43:36,2010-06-09 21:43:36
e1f27699e9ef568c00063a40127875355dd4dc91...24d24011a0eb2b3a331afc84a94c77ec5535b422,1,1,1,2,1,2010-06-09 20:05:08,2010-06-09 20:05:08
21157295d433d30bcc52144369fd146688d80739...315cfe0b5052b267e268a2daf50abae995485853,1,2,0,2,1,2010-06-09 17:25:01,2010-06-09 17:25:01
164e6e9fb3736681ab50065212b104e41312840a...81496c2982ea617bffe75182a2e740c6d36b852c,1,3,2,5,3,2010-06-08 14:23:15,2010-06-08 14:23:15
164e6e9fb3736681ab50065212b104e41312840a...401c573da40fd2775efbaee8cd2a3cfbbc507b39,1,1,2,3,2,2010-06-08 14:15:34,2010-06-08 14:15:34
7ebcd6d133ffdfe8bd46c62f8993192130ce3711...1dd024da17ce2bb42c0e8a4e05c62ec6738b7ebc,3,458,13,471,13,2010-06-09 02:59:58,2010-06-09 02:59:58
faa5d5fdd7c8dc11fdf538d40ebe82a35da268fd...8b0b62887561ae1221d9ab8eb63ce04fc2b73126,1,13,1,14,1,2010-06-09 21:50:08,2010-06-09 21:50:08
8b0b62887561ae1221d9ab8eb63ce04fc2b73126...a8fd0b6ac537541f516c5d80bab6ce7fcc7f0083,4,86,24,110,10,2010-06-10 07:44:24,2010-06-10 07:44:24
a8fd0b6ac537541f516c5d80bab6ce7fcc7f0083...348ce815392d8992fba53ebd6d6ab15da027178e,1,1,0,1,1,2010-06-10 13:20:12,2010-06-10 13:20:12
6837df161a4d6a14235683dccc03e6d9d498fbc4...828ca29ab4e58f3a6e0bc8702006474afda66ac9,4,79,49,128,14,2010-06-09 18:18:56,2010-06-09 18:18:56
6837df161a4d6a14235683dccc03e6d9d498fbc4...820e7a35a942ad88074cddf2ee0c30293026e232,1,1,1,2,1,2010-06-09 18:15:02,2010-06-09 18:15:02
8218be7cbceaa5f104dd7567e333f26464916069...9255178783ad6b3d694947572967d1dc87eeeacf,2,7,2,9,7,2010-06-08 15:37:30,2010-06-08 15:37:30
8218be7cbceaa5f104dd7567e333f26464916069...8bf7e0ddbfea8eb5332a8b514c608533fbc2b999,1,4,1,5,2,2010-06-08 15:06:34,2010-06-08 15:06:34
1dd024da17ce2bb42c0e8a4e05c62ec6738b7ebc...cbb36406f05f64f52d8a6f2c10a2c47d2a9d86d5,7,257,82,339,15,2010-06-09 15:31:30,2010-06-09 15:31:30
1dd024da17ce2bb42c0e8a4e05c62ec6738b7ebc...23882959f5f7a66b39524af8710277ee0dfc29bb,5,35,24,59,20,2010-06-09 15:00:43,2010-06-09 15:00:43
23882959f5f7a66b39524af8710277ee0dfc29bb...276e15708faccdca7747217b8cde109d93a02765,3,6,2,8,4,2010-06-09 15:15:34,2010-06-09 15:15:34
348ce815392d8992fba53ebd6d6ab15da027178e...6512a222f71ba98f3635562b2ac574536742f196,1,3,2,5,3,2010-06-10 15:20:05,2010-06-10 15:20:05
348ce815392d8992fba53ebd6d6ab15da027178e...54a54cbdfd24b962dba27584d6125e3069762ea7,1,9,0,9,2,2010-06-10 14:40:34,2010-06-10 14:40:34
79737538fa5fd1c67d9a974982b2ec1ca00a1bae...87f204e44fb688fc1787028b3b409cca9cd178ef,4,33,13,46,8,2010-06-09 19:34:48,2010-06-09 19:34:48
201d501e391d3096429c1f1ac53033e3562edbdc...dc00413381cd8d6e3d586411aa757044f91edc6b,7,57,35,92,9,2010-06-08 18:50:45,2010-06-08 18:50:45
dc00413381cd8d6e3d586411aa757044f91edc6b...57a2b786e50e22f3f273d9f95442153d43482e21,1,1,1,2,1,2010-06-08 19:07:26,2010-06-08 19:07:26
57a2b786e50e22f3f273d9f95442153d43482e21...88c7f167677b0765e7f0de0ca1476eb5e4078832,1,6,4,10,5,2010-06-08 20:01:52,2010-06-08 20:01:52
88c7f167677b0765e7f0de0ca1476eb5e4078832...21bb8b439c02c9664195b440afef9f70fdcba0f5,1,2,0,2,1,2010-06-08 20:24:39,2010-06-08 20:24:39
21bb8b439c02c9664195b440afef9f70fdcba0f5...93661510e975f9c8a62f315c6a602fecbf50cbfb,2,38,2,40,6,2010-06-08 20:55:22,2010-06-08 20:54:15
93661510e975f9c8a62f315c6a602fecbf50cbfb...8c4533a035cf981b72e48f73d4e33de881b95caa,3,42,0,42,9,2010-06-08 21:15:24,2010-06-08 21:15:24
0aa13e8e62315847c2672025726ae2ae0a50e3b9...04e67973ee009389357b8a3624b5dc5097c099db,1,6,3,9,4,2010-06-09 16:07:15,2010-06-09 16:07:15
04e67973ee009389357b8a3624b5dc5097c099db...3d046e9a94b84fd7c651867a9bc73516791f4689,2,19,8,27,10,2010-06-09 16:07:32,2010-06-09 16:07:32
3d046e9a94b84fd7c651867a9bc73516791f4689...eebb327db819bc0fe16fc32e8f144c2d71ca5a3c,4,16,5,21,5,2010-06-09 16:08:02,2010-06-09 16:08:02
bbc298cb9c97ef3ba6ecebae6e9ada25b76920e2...e6d615c1f4331e883f31fab9cc8b7584f7f758ad,1,1,1,2,1,2010-06-10 16:41:53,2010-06-10 16:41:53
bbc298cb9c97ef3ba6ecebae6e9ada25b76920e2...59fede64e9a829d193a6f26315487e4851b6b39d,1,1,12,13,1,2010-06-10 15:24:52,2010-06-10 15:24:52
eebb327db819bc0fe16fc32e8f144c2d71ca5a3c...a12b7073003b9a1c9d19d7fe8d238952d3141779,3,14,3,17,5,2010-06-09 17:20:35,2010-06-09 17:20:35
eebb327db819bc0fe16fc32e8f144c2d71ca5a3c...dd285bfae648b02afdd8f6439220d65e6b749db7,1,1,0,1,1,2010-06-09 16:54:08,2010-06-09 16:54:08
b9b46615b989787a3b2009a7f445f9dc82aa7727...3a155378c5d89b5f25a4627bb72bc3dd76109935,1,9,0,9,1,2010-06-10 17:27:51,2010-06-10 17:27:51
3a155378c5d89b5f25a4627bb72bc3dd76109935...bae780551a5e03f7e3db6d09d27737ae63d4904a,1,33,32,65,1,2010-06-10 20:23:44,2010-06-10 20:23:44
3a155378c5d89b5f25a4627bb72bc3dd76109935...be7b84c0338250de9266a54b7a4e471c76874f9b,3,17,4,21,9,2010-06-10 20:00:37,2010-06-10 20:00:37
bb4372cd9dfb6555c9c92e37f1d08c5d7d38af09...210f105e496a419dd7050b730321d5658c6192b5,2,4,9,13,6,2010-06-10 21:09:39,2010-06-10 21:09:39
210f105e496a419dd7050b730321d5658c6192b5...dedf707197e0c27e56bb23d3ceee70427a9f37fd,4,180,3,183,10,2010-06-10 22:02:17,2010-06-10 22:02:17
dedf707197e0c27e56bb23d3ceee70427a9f37fd...ec85177ba11bc78fb86abfa906a974cf924001ab,9,102,96,198,15,2010-06-11 04:16:34,2010-06-11 04:16:34
ec85177ba11bc78fb86abfa906a974cf924001ab...4bbfd226944dd8b0ab902ad9457d4be58175a13f,3,17,15,32,4,2010-06-11 12:48:18,2010-06-11 12:48:18
4bbfd226944dd8b0ab902ad9457d4be58175a13f...73d7c86b4aef71d7fcebe711032be834d5b5a7a3,1,10,11,21,4,2010-06-11 16:52:20,2010-06-11 16:52:20
73d7c86b4aef71d7fcebe711032be834d5b5a7a3...228f04390aeeb0306179fead32056db0126ed67e,1,0,1,1,1,2010-06-11 16:57:11,2010-06-11 16:57:11
228f04390aeeb0306179fead32056db0126ed67e...d4cc11852bad2e42fa98a0aaef845934fffe0b35,1,2,8,10,1,2010-06-11 18:02:00,2010-06-11 18:02:00
d4cc11852bad2e42fa98a0aaef845934fffe0b35...37f351d7d55e3eaf72626011526b78b5583f87de,1,16,3,19,3,2010-06-11 19:36:30,2010-06-11 19:36:30
d4cc11852bad2e42fa98a0aaef845934fffe0b35...d36aae49b1edf89a39327c7a2dc8489d50a67c64,1,3,2,5,1,2010-06-11 18:46:33,2010-06-11 18:46:33
d36aae49b1edf89a39327c7a2dc8489d50a67c64...96714119327ddd6690a90c2ac45cdfe8baba5cc9,1,8,2,10,1,2010-06-11 19:05:15,2010-06-11 19:05:15
96714119327ddd6690a90c2ac45cdfe8baba5cc9...8a4778a564951c0a47e03b92e7056382dd5dcade,1,2,1,3,1,2010-06-11 19:11:59,2010-06-11 19:11:59
8a4778a564951c0a47e03b92e7056382dd5dcade...37e6e26d3e3c27517cf2e40476b5f7271cab452c,1,1,1,2,1,2010-06-11 19:12:04,2010-06-11 19:12:04
37e6e26d3e3c27517cf2e40476b5f7271cab452c...951ac0ff465cbf482b70db6e5f5626c6e0a13711,4,85,31,116,9,2010-06-11 19:12:25,2010-06-11 19:12:25
951ac0ff465cbf482b70db6e5f5626c6e0a13711...e9f80086fabb29a49e3a8cc183f6c9320ee83e7d,1,3,3,6,3,2010-06-11 19:26:42,2010-06-11 19:26:42
e9f80086fabb29a49e3a8cc183f6c9320ee83e7d...d94152779d114b609f03c8c8974cf15a4cc5b4f2,1,1,1,2,1,2010-06-11 19:32:51,2010-06-11 19:32:51
d94152779d114b609f03c8c8974cf15a4cc5b4f2...850896f52848c596703cbbf5c85dfcb531e3fc89,2,5,0,5,2,2010-06-11 19:33:47,2010-06-11 19:18:17
5454fd7f46bc3b5d180525237dbf4f50118343ad...5e6851767400dc4bb9da1aa93c7c00bbc331ed8c,1,1,1,2,1,2010-06-11 19:57:08,2010-06-11 19:57:08
5e6851767400dc4bb9da1aa93c7c00bbc331ed8c...80ac07ebcda711009589d9965a9cdd700e3183ea,1,4,3,7,1,2010-06-11 20:09:23,2010-06-11 20:09:23
80ac07ebcda711009589d9965a9cdd700e3183ea...728150d0d5c00f663ceacb367c39f81f54993f77,1,2,1,3,1,2010-06-11 21:01:13,2010-06-11 21:01:13
728150d0d5c00f663ceacb367c39f81f54993f77...b70b4dd7aef752e5f477b17ad25b554d69da11c6,1,2,1,3,2,2010-06-11 21:10:22,2010-06-11 21:10:22
728150d0d5c00f663ceacb367c39f81f54993f77...ff285839dc8294fdd594efa91a8a5eccd8da7d4a,3,133,32,165,20,2010-06-11 21:06:00,2010-06-11 18:17:11
ff285839dc8294fdd594efa91a8a5eccd8da7d4a...58e6ac6b3cf239146d4fce9ed99eae584116b0e4,1,7,2,9,3,2010-06-11 21:06:00,2010-06-11 19:40:02
58e6ac6b3cf239146d4fce9ed99eae584116b0e4...29cff651d4b89e82001dec35b4622ff804554f99,1,9,3,12,4,2010-06-11 21:06:00,2010-06-11 21:05:02
29cff651d4b89e82001dec35b4622ff804554f99...5824c626e749290ce7c5ca7864ab40d8f4bd7fbd,1,0,4,4,1,2010-06-11 21:06:55,2010-06-11 21:06:55
76b74e2223647f76b15847070eceeb79915b821c...cd005b0e587e96360eef620be80588109f0b5cc2,5,240,169,409,14,2010-06-11 21:16:58,2010-06-11 21:16:58
cd005b0e587e96360eef620be80588109f0b5cc2...361417938ce0d6438caf3f409664a0459f4e8e85,5,9,1,10,5,2010-06-11 21:37:24,2010-06-11 21:37:24
5824c626e749290ce7c5ca7864ab40d8f4bd7fbd...6db962ca3b7a7f6863ce1379b5533541c4ad32d4,1,1,1,2,1,2010-06-11 21:43:55,2010-06-11 21:43:55
6db962ca3b7a7f6863ce1379b5533541c4ad32d4...abdc5efc209066600f661b1f1e3252beb696355e,1,1,0,1,1,2010-06-11 22:06:37,2010-06-11 22:06:37
8b56191134ba83b7f3ba6ac2b682273107fbd267...753a74d271c82358ead3fe19b990a51a3cd737b5,1,2,0,2,1,2010-06-11 23:19:38,2010-06-11 23:19:38
753a74d271c82358ead3fe19b990a51a3cd737b5...0437cef453762124bca426df794cff4473d8c0ba,1,4,4,8,2,2010-06-11 23:28:03,2010-06-11 23:28:03
0437cef453762124bca426df794cff4473d8c0ba...73b20d0b258c9a78494f3b77d9ad72de4f6fc8c4,1,14,6,20,6,2010-06-12 03:30:18,2010-06-11 22:03:54
73b20d0b258c9a78494f3b77d9ad72de4f6fc8c4...1829364b730cfcb1dcefd6bf646126b7e1ce9733,1,9,2,11,3,2010-06-12 03:30:52,2010-06-07 23:56:03
1829364b730cfcb1dcefd6bf646126b7e1ce9733...27952c3bbe1c0fb9f69dc23653bb81811d938b9b,1,1,0,1,1,2010-06-12 03:33:49,2010-06-12 00:00:14
1829364b730cfcb1dcefd6bf646126b7e1ce9733...5609a64bf06aefbbdf1ccf19199982d9ced2ad7e,1,2,2,4,1,2010-06-12 03:33:42,2010-06-12 03:33:42
737846704424503b9763c1a431f391b6c5f1bcdd...0fe7ef64f0867efde61b1ed54f4acacf4bdbf0bb,3,98,49,147,13,2010-06-12 21:49:54,2010-06-12 21:49:54
0fe7ef64f0867efde61b1ed54f4acacf4bdbf0bb...f6fe05bf9a90f69cbba3b44ce88b138bdaf9d03a,1,8,2,10,2,2010-06-13 02:45:17,2010-06-13 02:45:17
f6fe05bf9a90f69cbba3b44ce88b138bdaf9d03a...b183c1a4b855e21e2ba3da378fcdd80bce4d7c12,1,3,1,4,2,2010-06-13 03:13:16,2010-06-13 03:13:16
b183c1a4b855e21e2ba3da378fcdd80bce4d7c12...1fe74d9d98b710b45d13ef33925e30d17b50ccd2,1,9,6,15,5,2010-06-13 03:28:23,2010-06-13 03:28:23
1fe74d9d98b710b45d13ef33925e30d17b50ccd2...49122f7d6cdfe9c961e8dc33926fc33facd3a248,2,17,3,20,4,2010-06-13 03:28:38,2010-06-13 03:28:38
49122f7d6cdfe9c961e8dc33926fc33facd3a248...f42e8191219ad311db244a95ec1543078e466d61,2,1,5,6,2,2010-06-14 04:24:30,2010-06-14 04:24:30
49122f7d6cdfe9c961e8dc33926fc33facd3a248...721c6787a6c6ebf8f8480a62145a76ac9d614872,2,14,3,17,6,2010-06-14 03:43:07,2010-06-12 04:05:24
721c6787a6c6ebf8f8480a62145a76ac9d614872...b7b0a7aa2a0ad10958eac7cf3ed6f0cc4498d940,3,45,13,58,12,2010-06-14 03:43:37,2010-06-12 20:37:52
b7b0a7aa2a0ad10958eac7cf3ed6f0cc4498d940...d85697d41187390597ae7a90466dfd873055a88c,1,19,10,29,6,2010-06-14 04:08:25,2010-06-14 03:48:09
9aaada447cc34e39f883e18a8394ad00e6c70271...2f94443140b7f9c0efd862fddf556b9af29008df,3,21,10,31,8,2010-06-14 10:30:19,2010-06-14 10:30:19
2f94443140b7f9c0efd862fddf556b9af29008df...3128f38c853210915f2496281789e789d36443ee,1,98,0,98,1,2010-06-14 12:22:46,2010-06-14 12:22:46
3128f38c853210915f2496281789e789d36443ee...1248f119bd4dfcd2aeaba3e510f91f065bf576ba,1,10,1,11,5,2010-06-14 12:25:25,2010-06-04 20:44:45
1248f119bd4dfcd2aeaba3e510f91f065bf576ba...493cc2654c214b940072c2c54f663b1be7f2e44c,1,7,7,14,3,2010-06-14 12:25:25,2010-06-04 20:46:26
493cc2654c214b940072c2c54f663b1be7f2e44c...c78026c136083d772a5cd641f121e8fb1f0fdfc9,7,40,16,56,18,2010-06-14 16:40:39,2010-06-14 16:40:39
493cc2654c214b940072c2c54f663b1be7f2e44c...01f1c090cdd1f56870bf823947e8b7bfa7a0d18e,1,25,23,48,13,2010-06-14 14:40:48,2010-06-14 14:40:48
493cc2654c214b940072c2c54f663b1be7f2e44c...86a5ca68a57d8c6a54af003c5bf6c9ad0ef532b0,1,1,1,2,1,2010-06-14 14:33:34,2010-06-14 14:33:34
56bdcafd9754c03954bd7bddd056d18a68aaa9de...d900574a09682af109decf7e4ecaf9b290330c40,2,36,37,73,2,2010-06-14 16:47:05,2010-06-14 16:47:05
d900574a09682af109decf7e4ecaf9b290330c40...1a566e5b51617ddee8982efe69be6c60743f3d56,1,7,3,10,4,2010-06-14 17:32:45,2010-06-14 17:32:45
1a566e5b51617ddee8982efe69be6c60743f3d56...04529a1acfcd85a94f54400af0d0f8f065ae1a2c,2,70,60,130,3,2010-06-14 18:07:42,2010-06-14 18:07:42
04529a1acfcd85a94f54400af0d0f8f065ae1a2c...73b55af0296f4343cb33418af5546e886efcd98d,1,1,1,2,1,2010-06-14 18:37:56,2010-06-11 22:39:53
73b55af0296f4343cb33418af5546e886efcd98d...184990c86e9b93203c6651a7c894cf619e3c8215,1,1,1,2,1,2010-06-14 18:37:56,2010-06-14 18:37:16
97a024a47f329404a52e196d91da64bb539f7ebd...cf6bc7c308af65c3c870da83580a4c162718d6ed,1,14,10,24,5,2010-06-14 14:59:57,2010-06-14 14:59:57
97a024a47f329404a52e196d91da64bb539f7ebd...10e83e822012f46431e11c117f31fa84b37518c8,2,12,10,22,5,2010-06-14 14:56:25,2010-06-14 12:38:17
10e83e822012f46431e11c117f31fa84b37518c8...dc95ed05762010809d000354a6a9a251c39066fd,1,47,13,60,9,2010-06-14 14:56:25,2010-06-14 14:28:00
dc95ed05762010809d000354a6a9a251c39066fd...78cb3cfc87981128b50211ba9efd6496ceb7b17c,1,14,1,15,5,2010-06-14 14:56:25,2010-06-14 14:46:28
78cb3cfc87981128b50211ba9efd6496ceb7b17c...b52051be9340e0ddf4b2d0d75339647654a47d9d,1,13,0,13,1,2010-06-14 14:56:25,2010-06-14 14:53:36
184990c86e9b93203c6651a7c894cf619e3c8215...25b63b487d589af36d42a3c2feb5f6853ffebdf6,1,6,4,10,1,2010-06-14 19:15:07,2010-06-14 19:15:07
25b63b487d589af36d42a3c2feb5f6853ffebdf6...c1fb4464240aaff060bb6526cae1b41c24372380,1,2,2,4,2,2010-06-14 19:15:49,2010-06-14 19:15:49
c1fb4464240aaff060bb6526cae1b41c24372380...72ee1b90f070e223e4b62d841538ed9ee0f25290,1,1,0,1,1,2010-06-14 19:29:21,2010-06-14 19:29:21
e24de618c0c0c49b321e311b690c7784d70ae16d...215247c8457731448e455f52da31d3a6ad9c1def,1,1,1,2,2,2010-06-14 15:32:15,2010-06-14 15:32:15
f02560f55b67735dad64a002750612fffef537d3...39fb6baaa5a2b58681f08b5939a82c36891b02a6,2,3,4,7,3,2010-06-14 19:19:41,2010-06-14 19:19:41
39fb6baaa5a2b58681f08b5939a82c36891b02a6...ebd6d55fbb7a93c85ff6ac1bf42233f61438f1a2,3,4,4,8,4,2010-06-14 19:20:45,2010-06-14 19:20:45
215247c8457731448e455f52da31d3a6ad9c1def...9f648dcf5d42b400b6efaf151531cb9546e806b1,1,28,0,28,1,2010-06-14 18:52:14,2010-06-14 18:52:14
215247c8457731448e455f52da31d3a6ad9c1def...efbbcc80beb24896387daecd64a8535f26fc0665,1,25,3,28,5,2010-06-14 15:52:09,2010-06-14 15:51:26
1e4a97089ee436fa1c164d2caa07097559a64cef...d782c98f9cf998eb2bd1dac6850c4c8a54e99fd1,5,34,10,44,9,2010-06-14 22:47:12,2010-06-14 22:47:12
ebd6d55fbb7a93c85ff6ac1bf42233f61438f1a2...5b45fbea908b7ed4511ecc0b451b93bd0eb421e0,1,7,7,14,1,2010-06-14 19:29:42,2010-06-14 19:29:42
92a83fc997c390a1345e4ea88c52dc361a6f4716...a739b8df76503cb3a71d823791d3d859dbb6afda,1,14,3,17,6,2010-06-15 18:39:50,2010-06-15 18:39:50
92a83fc997c390a1345e4ea88c52dc361a6f4716...0b1754585c6d41db8eda7a3299aed3918b47197b,2,4,6,10,5,2010-06-15 02:13:57,2010-06-15 02:13:57
0b1754585c6d41db8eda7a3299aed3918b47197b...f8e8536af1e8c0962cc0a5c4a0a8de144f1f650a,1,10,3,13,1,2010-06-15 02:22:34,2010-06-15 02:22:34
f8e8536af1e8c0962cc0a5c4a0a8de144f1f650a...663e59a8f4c82a0a5687ed03c2cc49239c4c3082,1,3,1,4,1,2010-06-15 05:25:54,2010-06-15 05:25:54
663e59a8f4c82a0a5687ed03c2cc49239c4c3082...1113a12a59214ae0ae624c00af51a64609de2913,5,56,31,87,7,2010-06-15 06:48:09,2010-06-15 06:48:09
8a49ab1ce166a8e1a6d07efc1d064ea1e07c9993...14f272d6722344ec34a76fb50ca47e6170854667,2,55,17,72,13,2010-06-14 20:11:23,2010-06-14 20:11:23
8a49ab1ce166a8e1a6d07efc1d064ea1e07c9993...93fdeab94380b526b60c8a4ff3f3f6a9a4fbf479,6,87,78,165,11,2010-06-14 20:10:23,2010-06-14 20:10:23
5b45fbea908b7ed4511ecc0b451b93bd0eb421e0...76635118f786178abb5a1452ecda195ffe5b5e0b,2,18,7,25,9,2010-06-14 19:32:03,2010-06-14 19:32:03
1f9c1d6a3d88301f13f0e4db9cd368819833dad2...0676284bb13c252782c3f6a9343c6e4140ca799e,1,2,3,5,1,2010-06-15 18:53:07,2010-06-15 18:53:07
0676284bb13c252782c3f6a9343c6e4140ca799e...0715c4db07354dffa7c08b0c2269b1fae5517684,3,16,2,18,6,2010-06-15 19:29:27,2010-06-15 19:29:27
1113a12a59214ae0ae624c00af51a64609de2913...a63cd8add933e88e7a3058901d764c5039b5f893,5,25,5,30,11,2010-06-15 14:31:01,2010-06-15 14:31:01
1113a12a59214ae0ae624c00af51a64609de2913...ecba5ba151e2cbeff1f39b87c6ba1b9b6b2034f8,1,1,1,2,1,2010-06-15 12:52:22,2010-06-15 12:52:22
93fdeab94380b526b60c8a4ff3f3f6a9a4fbf479...4eaaf25da37c8fcb21749892b3d8dcdeda8ef035,2,6,0,6,5,2010-06-14 20:22:11,2010-06-14 20:22:11
e25c1febc1ec2c09d6a0f73b93db3e4e2a6de772...eefddcd5a9948fa4ac29e3c93618fa6e18070fc0,10,173,16,189,24,2010-06-15 21:42:49,2010-06-15 21:42:49
eefddcd5a9948fa4ac29e3c93618fa6e18070fc0...0b780fdcda3f6a7fd1093e610f43b9356e8f680a,2,10,0,10,2,2010-06-16 01:18:55,2010-06-15 22:07:03
0b780fdcda3f6a7fd1093e610f43b9356e8f680a...c5d975b2b52fb093922c2ee5f4661f82b3ffa2cc,1,10,1,11,1,2010-06-16 01:28:26,2010-06-16 01:28:26
c5d975b2b52fb093922c2ee5f4661f82b3ffa2cc...d3481595d2fedb3774574387c06ab70679aae447,1,13,0,13,1,2010-06-16 01:28:52,2010-06-16 01:28:52
d3481595d2fedb3774574387c06ab70679aae447...15aebb07066889ff7fbf459f36d4830be0a925b6,6,42,36,78,18,2010-06-16 03:05:45,2010-06-16 03:05:45
15aebb07066889ff7fbf459f36d4830be0a925b6...bbc51275c0ecf6e9bbfb11a167355a572a42b9c3,1,6,7,13,2,2010-06-16 08:20:46,2010-06-16 08:20:46
bbc51275c0ecf6e9bbfb11a167355a572a42b9c3...9b53b751ab7dff364372dd6e8aa7c3b89cb812f4,1,13,22,35,5,2010-06-16 14:21:13,2010-06-16 14:21:13
9b53b751ab7dff364372dd6e8aa7c3b89cb812f4...3abdc556846b2eef5bbf9fcafc0821153500c2ad,4,8,0,8,4,2010-06-16 15:02:41,2010-06-16 15:02:41
3abdc556846b2eef5bbf9fcafc0821153500c2ad...d48e363d6b9cfd0f0b8c8ee47ba2275bc3746bc2,4,31,5,36,13,2010-06-16 19:10:13,2010-06-16 19:10:13
d48e363d6b9cfd0f0b8c8ee47ba2275bc3746bc2...c15eb9182a1e58cdc6f502675ef30a3b779f0932,2,78,58,136,14,2010-06-16 19:23:03,2010-06-16 19:23:03
c15eb9182a1e58cdc6f502675ef30a3b779f0932...b20cd590ad05cc971a924a4238e47e3d3234e71c,2,41,14,55,10,2010-06-16 19:44:01,2010-06-16 19:44:01
b20cd590ad05cc971a924a4238e47e3d3234e71c...c5a241e6d99cc0fe98085b937c28e593b8c238d5,1,12,3,15,6,2010-06-16 20:56:05,2010-06-16 20:56:05
c5a241e6d99cc0fe98085b937c28e593b8c238d5...aa908fe994e8b155765b219faf99ed6c09a1e5ba,1,1,1,2,1,2010-06-16 21:00:20,2010-06-16 21:00:20
19017be25009e25d9f2f896b5db2f9de9e96ad98...df5a9d8732280fb9080f322c0b4601d406ec6339,3,8,5,13,6,2010-06-15 14:57:17,2010-06-15 14:57:17
df5a9d8732280fb9080f322c0b4601d406ec6339...5cc5efe6337b74baadce4a9c0b58503dcc7cc527,1,2,1,3,2,2010-06-15 15:53:05,2010-06-15 15:52:38
5cc5efe6337b74baadce4a9c0b58503dcc7cc527...19a0eca57a7e8907697a6c0a2acf67822ee55c07,2,21,8,29,9,2010-06-15 17:32:53,2010-06-15 17:32:53
ecba5ba151e2cbeff1f39b87c6ba1b9b6b2034f8...d4d63ed88f71cafa546dfe02e7111a015e2a9b5e,3,361,315,676,4,2010-06-15 14:18:13,2010-06-15 14:18:13
d4d63ed88f71cafa546dfe02e7111a015e2a9b5e...e0431b67f236dbbe66badd05cbd8d0d4d267f87c,4,107,10,117,19,2010-06-15 14:49:47,2010-06-15 14:49:47
e0431b67f236dbbe66badd05cbd8d0d4d267f87c...0b6784ca44301a94fd6a07201fac97f94b4c0143,1,2,2,4,2,2010-06-15 15:38:11,2010-06-15 15:38:11
ecba5ba151e2cbeff1f39b87c6ba1b9b6b2034f8...add5430075393cc841d9f0719584c836005cae34,1,7,5,12,3,2010-06-15 14:06:33,2010-06-14 22:14:24
add5430075393cc841d9f0719584c836005cae34...7a663e0e5b3e76a299e9cb8f4ef9706e41cc0569,1,2,0,2,1,2010-06-15 14:13:14,2010-06-15 14:13:14
d3c26dc5f350719b9b7647516beadc6ae6a6694a...de1ce815b666a6c9c724a462240b3791e49f9f2f,1,1,0,1,1,2010-06-14 22:44:42,2010-06-14 22:44:42
de1ce815b666a6c9c724a462240b3791e49f9f2f...440163fccc7554cf4d059187c5dda22b4817f7d1,4,167,75,242,29,2010-06-14 22:44:51,2010-06-14 22:44:51
aa908fe994e8b155765b219faf99ed6c09a1e5ba...f27cc03eed492f553568c67073f5b3cb7468b760,1,12,5,17,9,2010-06-19 15:23:02,2010-06-19 15:23:02
aa908fe994e8b155765b219faf99ed6c09a1e5ba...e533008b5dea5f95ab69559a9a9a976825eae4cc,4,9,13,22,9,2010-06-17 14:21:04,2010-06-17 14:21:04
e533008b5dea5f95ab69559a9a9a976825eae4cc...8d285b5738075956c38ab1a5eead5f443bfc5f51,1,11,6,17,7,2010-06-17 14:38:09,2010-06-17 14:38:09
8d285b5738075956c38ab1a5eead5f443bfc5f51...8d69487c7857fd73840fe39448190ac6d0b61ac0,14,140,93,233,51,2010-06-17 17:08:06,2010-06-17 17:08:06
8d69487c7857fd73840fe39448190ac6d0b61ac0...0d3bf995dcf9d59f47e5ea4009420a9bb8cb4b54,1,3,2,5,2,2010-06-17 17:10:16,2010-06-17 17:10:16
0d3bf995dcf9d59f47e5ea4009420a9bb8cb4b54...d7f7155c830ba8dba70fe747b8c9bd5d09041747,3,33,10,43,6,2010-06-17 17:46:27,2010-06-17 17:46:27
d7f7155c830ba8dba70fe747b8c9bd5d09041747...741837abfacb3dda608e2e798ffbed1201b11b5e,1,10,4,14,4,2010-06-17 18:08:00,2010-06-17 18:08:00
741837abfacb3dda608e2e798ffbed1201b11b5e...af8f05a0e142b80fd2a9927368c9f7d800298fde,4,7,2,9,6,2010-06-17 18:54:57,2010-06-17 18:54:57
af8f05a0e142b80fd2a9927368c9f7d800298fde...ae6c7a2779bb1eaf942ee1293305cba65b531afc,1,2,2,4,2,2010-06-17 19:02:06,2010-06-17 19:02:06
ae6c7a2779bb1eaf942ee1293305cba65b531afc...2aa0d1fa57a74a884c1eed5552c942629534bb55,1,1,1,2,1,2010-06-17 19:03:36,2010-06-17 19:03:36
2aa0d1fa57a74a884c1eed5552c942629534bb55...1dfde3a6b8d39302fd082fbf012def4a17d57e13,1,4,1,5,1,2010-06-17 19:04:58,2010-06-17 19:04:58
1dfde3a6b8d39302fd082fbf012def4a17d57e13...2170152313ef08c4eb3285f33e0becdabcee15ce,1,1,1,2,1,2010-06-17 22:28:06,2010-06-17 22:28:06
aa908fe994e8b155765b219faf99ed6c09a1e5ba...068efc1b2356430c21a376f8963dd13979566fd4,4,9,3,12,4,2010-06-17 10:49:29,2010-06-17 10:49:29
068efc1b2356430c21a376f8963dd13979566fd4...62b29659338474350c913a85532feb1a6a7c5927,1,0,1,1,1,2010-06-17 10:52:17,2010-06-17 10:52:17
62b29659338474350c913a85532feb1a6a7c5927...42d8985967ce548cb41f632fb84dfba3022e60f9,1,1,0,1,1,2010-06-17 11:27:06,2010-06-17 11:27:06
42d8985967ce548cb41f632fb84dfba3022e60f9...b1ff7063bf8bc2829241c09bc74645ace19a1912,1,1,1,2,1,2010-06-17 18:52:03,2010-06-17 18:52:03
b1ff7063bf8bc2829241c09bc74645ace19a1912...60ac0cf098fa40ee14047ba93aa9bdb51d32874a,1,24,23,47,12,2010-06-17 20:43:14,2010-06-17 20:43:14
0654e8f6dd801c511c50adf80c1cae186538a6f1...6f4ee6e28ecb39fac632f2ab4b8c428855fd4257,1,1,0,1,1,2010-06-17 23:40:50,2010-06-17 19:15:36
6f4ee6e28ecb39fac632f2ab4b8c428855fd4257...53d5511666dc17e1cb723944509f57dee663c799,1,2,1,3,2,2010-06-18 10:36:33,2010-06-18 10:36:33
53d5511666dc17e1cb723944509f57dee663c799...bade1ebe835838aa2175a4d0f3b2cbd47bcb0d4e,1,1,1,2,1,2010-06-18 10:38:44,2010-06-18 10:38:44
bade1ebe835838aa2175a4d0f3b2cbd47bcb0d4e...e72597ecd8b44340389e03556a0c4003d28d393b,1,4,1,5,1,2010-06-18 10:44:11,2010-06-18 10:44:11
e72597ecd8b44340389e03556a0c4003d28d393b...cb3a5f7f9492778904fa7afaa6e76acc435acde0,1,2,2,4,2,2010-06-19 16:45:52,2010-06-19 16:45:52
cb3a5f7f9492778904fa7afaa6e76acc435acde0...0549d3cc2e63147cce8789ade6bada1fc8930efa,2,15,1,16,5,2010-06-19 16:46:10,2010-06-19 16:46:10
0549d3cc2e63147cce8789ade6bada1fc8930efa...4e1f95acabde750699bfb8d49a6fd54698b0ba89,4,23,16,39,10,2010-06-20 00:20:19,2010-06-20 00:20:19
4e1f95acabde750699bfb8d49a6fd54698b0ba89...66bdde32e135bd58748077d192a814724188ad47,1,1,1,2,1,2010-06-20 01:37:53,2010-06-20 01:37:53
462feb5a9fc4388121347e2557c9f30cefe2c222...a38bc950bd720b6b299c0b8e2dd0e319f19daac7,2,9,1,10,2,2010-06-21 22:26:08,2010-06-21 22:26:08
462feb5a9fc4388121347e2557c9f30cefe2c222...38f4332418be56f559de8cb71734490b1149ee03,2,2,1,3,2,2010-06-21 21:57:56,2010-06-21 21:57:56
66bdde32e135bd58748077d192a814724188ad47...a7f063dc2178b6745cca289c68687cf6939805ca,3,90,0,90,5,2010-06-21 15:18:33,2010-06-21 15:18:33
a7f063dc2178b6745cca289c68687cf6939805ca...e42ab7108698af226f3e64d86244596bf5ab3026,5,12,3,15,7,2010-06-21 17:17:05,2010-06-21 17:17:05
e42ab7108698af226f3e64d86244596bf5ab3026...a71cc3cd4bdcfbe3eea41e31840527a03a6e15e9,17,123,92,215,42,2010-06-21 17:41:34,2010-06-21 17:41:34
a434fa5191f9bcf1953bde73b6bbd6e303ae6c0d...e1e111d05ed85d9a9323e9d3ef8251156b1544d8,2,2,2,4,2,2010-06-21 22:28:52,2010-06-21 22:28:52
e1e111d05ed85d9a9323e9d3ef8251156b1544d8...9bc5a77b00b0e2ad6503cbe2dd5853311d3ecedd,1,8,9,17,3,2010-06-22 09:16:30,2010-06-22 09:16:30
9bc5a77b00b0e2ad6503cbe2dd5853311d3ecedd...2b251ff7f626d67b3fc9e6e9de76092985981c20,3,96,6,102,7,2010-06-22 09:16:52,2010-06-22 09:16:52
2b251ff7f626d67b3fc9e6e9de76092985981c20...fd3b8fa7adf62c7833b12a87c8e4693c7e2fec9a,4,38,10,48,11,2010-06-22 09:27:56,2010-06-22 09:27:56
e1e111d05ed85d9a9323e9d3ef8251156b1544d8...ab204d9f24e9ca2320e44e1f2420313fdb3dd29f,5,23,4,27,8,2010-06-21 22:49:49,2010-06-20 20:29:03
ab204d9f24e9ca2320e44e1f2420313fdb3dd29f...2353944ea0a68fd27d33fed05f211546fb51b515,1,12,2,14,3,2010-06-22 01:01:02,2010-06-22 01:01:02
2353944ea0a68fd27d33fed05f211546fb51b515...b543b4a4a8ea7e77a235f15c55afe6e46d15f2af,1,1,1,2,1,2010-06-22 01:13:48,2010-06-22 01:13:48
b543b4a4a8ea7e77a235f15c55afe6e46d15f2af...f46551260ba0340d37138905aac94274bdadb23c,3,43,6,49,8,2010-06-22 03:38:26,2010-06-22 03:38:26
f46551260ba0340d37138905aac94274bdadb23c...8f8a32469c5279d5c847033b1653fd723b7933be,1,47,0,47,1,2010-06-22 03:41:29,2010-06-22 03:41:29
8f8a32469c5279d5c847033b1653fd723b7933be...e657acd9dcc9c0a17498c395836bbe86a3d4eb37,1,1,1,2,1,2010-06-22 08:26:56,2010-06-11 00:29:33
5e802562dcdae3642a672792d8215cb74c7b5510...21ad005a962ce250050761bde167a11fe1ebdd86,2,16,4,20,7,2010-06-22 09:59:44,2010-06-22 09:59:44
21ad005a962ce250050761bde167a11fe1ebdd86...140d8a425488d3df910298749fd25ec7062f69be,4,25,2,27,6,2010-06-22 10:08:28,2010-06-22 10:08:28
140d8a425488d3df910298749fd25ec7062f69be...14344eeea3858c07f627a29ee7a6ad2e06b05d35,5,115,4,119,8,2010-06-22 10:37:49,2010-06-22 10:37:49
14344eeea3858c07f627a29ee7a6ad2e06b05d35...3fe48e37f1f4edd6f914c2332fd154500fe7ed02,2,32,16,48,4,2010-06-25 19:28:49,2010-06-25 19:28:49
3fe48e37f1f4edd6f914c2332fd154500fe7ed02...373172d27262a7dad1628662e9be14d00f33e8ec,1,13,0,13,1,2010-06-25 19:36:46,2010-06-25 19:36:46
373172d27262a7dad1628662e9be14d00f33e8ec...9959f32daab0512b79daa0a00875836d4ae25f97,2,8,4,12,4,2010-06-25 19:43:41,2010-06-25 19:43:41
9959f32daab0512b79daa0a00875836d4ae25f97...1094c428ace873154f4272cdb03a8f383e47bfd9,1,1,1,2,1,2010-06-25 19:45:27,2010-06-25 19:45:27
14344eeea3858c07f627a29ee7a6ad2e06b05d35...a124e197a242051b8267bfbd9df0a254a8a749ed,1,2,2,4,2,2010-06-22 16:05:32,2010-06-22 16:05:32
a124e197a242051b8267bfbd9df0a254a8a749ed...df33cf69bca54e4eb736c245f9f4b33d3f640c11,1,2,2,4,1,2010-06-22 16:08:36,2010-06-22 16:08:36
df33cf69bca54e4eb736c245f9f4b33d3f640c11...fd974724b9c9b52435daf3dc414137854b1cb669,1,1,1,2,1,2010-06-22 16:51:43,2010-06-22 16:51:43
fd974724b9c9b52435daf3dc414137854b1cb669...c2cc43d8cefaf63b7d77e019356ff4f8242bac2d,1,3,1,4,1,2010-06-22 18:04:27,2010-06-22 18:04:27
c2cc43d8cefaf63b7d77e019356ff4f8242bac2d...155e38b679502bfee1a3caf5ca452667353074fc,4,92,26,118,14,2010-06-22 22:07:08,2010-06-22 22:07:08
14344eeea3858c07f627a29ee7a6ad2e06b05d35...7664d8e6196edaa1e220d48bae86e7e4c7d18244,2,4,4,8,3,2010-06-22 14:38:06,2010-06-22 14:38:06
7664d8e6196edaa1e220d48bae86e7e4c7d18244...72c37e610b473cf7ed37e9886619c507be88b7ce,1,34,33,67,2,2010-06-22 18:13:06,2010-06-22 18:13:06
72c37e610b473cf7ed37e9886619c507be88b7ce...68785434eb0142235c01440ec1469c6811cf70bb,2,26,3,29,8,2010-06-22 18:38:43,2010-06-22 18:38:43
68785434eb0142235c01440ec1469c6811cf70bb...37bf31684456d38db23aacc5cc5d39b8c118b849,7,111,66,177,33,2010-06-23 00:05:11,2010-06-23 00:05:11
a3c7ba0c773f3b358dfabb5f2678a64f87258fe6...418a177bfdea85a761cabf50686c598f8ad9ac05,1,3,0,3,1,2010-06-25 20:39:16,2010-06-25 20:39:16
418a177bfdea85a761cabf50686c598f8ad9ac05...7f3d2026d211196b25f975f4bbe464af42588c1e,1,10,0,10,1,2010-06-25 20:46:26,2010-06-25 20:46:26
7f3d2026d211196b25f975f4bbe464af42588c1e...23a6d6a8694a9f6c92fbf7f5347b5860f89a0630,7,75,18,93,16,2010-06-25 21:34:27,2010-06-25 21:32:12
23a6d6a8694a9f6c92fbf7f5347b5860f89a0630...1924e96788d316add476acd7a954c255e3e7f91a,1,17,4,21,2,2010-06-25 21:56:07,2010-06-25 21:56:07
1924e96788d316add476acd7a954c255e3e7f91a...b133d42c47c4254f6cb85db61897bf0e5b29d4f2,1,1,1,2,1,2010-06-26 14:20:00,2010-06-26 14:20:00
155e38b679502bfee1a3caf5ca452667353074fc...bf36eebd4f32728d4ff0de6cc4a3a3605ab0af1d,6,121,31,152,14,2010-06-23 00:53:11,2010-06-23 00:53:11
bf36eebd4f32728d4ff0de6cc4a3a3605ab0af1d...1e61dd92e0a096653f976414f8c2ff985f41adc4,3,43,7,50,7,2010-06-23 02:18:07,2010-06-23 02:18:07
155e38b679502bfee1a3caf5ca452667353074fc...1c9093cee78041996fd1e9aaea7caf74451883cd,1,3,1,4,2,2010-06-23 00:09:49,2010-06-22 23:58:26
b133d42c47c4254f6cb85db61897bf0e5b29d4f2...d6f1c1a6c7251554638156d1a99843f4a3983b3e,2,11,1,12,4,2010-06-26 17:05:32,2010-06-26 17:05:32
d6f1c1a6c7251554638156d1a99843f4a3983b3e...456d52492b2369365b4bbe1c27da2b25f9765fc2,5,7,2,9,7,2010-06-26 17:06:03,2010-06-26 17:06:03
b133d42c47c4254f6cb85db61897bf0e5b29d4f2...82ef71670d8b2ca69c7bf6572de2fbe28cb45c67,2,11,11,22,2,2010-06-26 16:54:42,2010-06-26 16:54:42
82ef71670d8b2ca69c7bf6572de2fbe28cb45c67...8f1f59687e2212427145ecf9a0f60d021023e843,2,385,352,737,15,2010-06-26 18:13:11,2010-06-26 18:13:11
b133d42c47c4254f6cb85db61897bf0e5b29d4f2...e9c784dcd5f5b2c6cfc7630d394f786247b8c413,1,11,1,12,2,2010-06-26 16:34:27,2010-06-26 16:28:17
3ff5fb76124e283795295aecb36ece2b3ee165a4...0d42eb74d2b152ffa4aae8471d83dc6091954b65,2,8,0,8,4,2010-06-23 02:39:16,2010-06-23 02:39:16
0f0f8d932655ca9e3be8ce0ec57b86aa110d8e89...dba012b66501c3049677b077c96534eb47e3892b,1,7,1,8,2,2010-06-23 00:18:30,2010-06-23 00:18:30
ca53f9cf81ad7051f52db8a707acb6116ad7c01e...67ca6192833fab75e3e14a219dd47a40ee3b9621,1,3,0,3,1,2010-06-26 17:13:45,2010-06-26 17:13:45
67ca6192833fab75e3e14a219dd47a40ee3b9621...1e9b37b577efc3498880e7def529ea8ec213a082,1,11,0,11,4,2010-06-26 17:32:19,2010-06-26 17:32:19
1e9b37b577efc3498880e7def529ea8ec213a082...f9c59858083d141f7b90e9602914e9d7793766d8,3,20,1,21,3,2010-06-26 17:32:35,2010-06-26 17:32:35
f9c59858083d141f7b90e9602914e9d7793766d8...9c20d94bd5b6b3a20790d60acb236bdd0e10c251,3,10,5,15,6,2010-06-26 17:45:20,2010-06-26 17:45:20
9c20d94bd5b6b3a20790d60acb236bdd0e10c251...731caf391badb91508ea4b0524c62a1f30b57990,1,1,1,2,1,2010-06-26 18:12:17,2010-06-26 18:12:17
731caf391badb91508ea4b0524c62a1f30b57990...08f817ea2a46510a2669a04da6b7e94748251d70,1,1,1,2,1,2010-06-27 00:29:39,2010-06-27 00:29:39
08f817ea2a46510a2669a04da6b7e94748251d70...c7045ab0031fd9339b54cec3daac92a7d616942b,1,6,2,8,3,2010-06-27 01:29:07,2010-06-27 01:29:07
c7045ab0031fd9339b54cec3daac92a7d616942b...5973ca961bb3f7759ba2f6b6e942f0c2dbb18f20,1,4,1,5,4,2010-06-27 01:30:05,2010-06-27 01:30:05
5973ca961bb3f7759ba2f6b6e942f0c2dbb18f20...c3342b005d221a0f300aa701a0754e4ce97a88f3,10,51,28,79,32,2010-06-27 01:31:17,2010-06-27 01:31:17
c3342b005d221a0f300aa701a0754e4ce97a88f3...219977255c149ff08a10419a50c8f376cd7482ca,1,1,1,2,1,2010-06-27 01:34:33,2010-06-27 01:34:33
219977255c149ff08a10419a50c8f376cd7482ca...c5ab124c450e37e860186f6035358dfa40e81c5c,2,3,1,4,3,2010-06-27 02:32:12,2010-06-27 02:32:12
d4c4631e91235c1d39493cba19fa8eac0a294166...fd7be9ee41f276055923c352738f28aec0cc813e,2,348,0,348,2,2010-06-27 15:54:49,2010-06-27 15:54:49
5a7da23ba5bf109d2699f1b4745164f459a75f9b...5f3b74a454e375a12efa198b9eb81e7baa4fac4a,2,8,1,9,3,2010-06-23 03:02:15,2010-06-23 03:02:15
5f3b74a454e375a12efa198b9eb81e7baa4fac4a...05f319162bf867efc0480290c98f34287a4bb8e3,4,35,18,53,7,2010-06-23 03:44:22,2010-06-23 03:44:22
05f319162bf867efc0480290c98f34287a4bb8e3...c00c7d6d93e9408eb09dfe1a9a68e824f0a024f1,1,1,0,1,1,2010-06-23 05:14:08,2010-06-23 05:14:08
c00c7d6d93e9408eb09dfe1a9a68e824f0a024f1...e881754406b10c1e19b7c33756fbf04b51d73928,2,7,9,16,5,2010-06-23 05:30:52,2010-06-23 05:30:52
e881754406b10c1e19b7c33756fbf04b51d73928...1dc2b9cd17ecae64205ea6e8ad365def7848cdb0,2,17,0,17,2,2010-06-23 14:02:16,2010-06-23 14:02:16
1dc2b9cd17ecae64205ea6e8ad365def7848cdb0...30b1524a7785c12fcfe675ba509007ca6180f78c,8,274,80,354,54,2010-06-24 02:25:03,2010-06-24 02:25:03
dba012b66501c3049677b077c96534eb47e3892b...af1eec7b8c74e6ad10225bfc0929d53f2855051b,1,1,0,1,1,2010-06-23 02:35:23,2010-06-23 02:35:23
fd7be9ee41f276055923c352738f28aec0cc813e...3f6148b89aa16a5a41b9fac3278d93d35a35c347,3,20,12,32,9,2010-06-27 16:10:55,2010-06-27 16:10:55
fd7be9ee41f276055923c352738f28aec0cc813e...d4fdac025ef4c331bc15b93ef418fdb9f3a453c5,2,22,1,23,5,2010-06-27 15:58:55,2010-06-27 15:58:55
30b1524a7785c12fcfe675ba509007ca6180f78c...a5b8c2b7cf2cd8071a316181c4d4ce7425615e66,1,7,0,7,1,2010-06-24 14:49:49,2010-06-24 14:49:49
a5b8c2b7cf2cd8071a316181c4d4ce7425615e66...f8901bec591369af0a4b4588b3978a5239df657e,2,5,3,8,2,2010-06-24 15:23:10,2010-06-24 15:23:10
f8901bec591369af0a4b4588b3978a5239df657e...1026c72507fb6eb7d2bc16d479d2ec86ac7032cd,6,45,37,82,18,2010-06-24 15:24:54,2010-06-24 15:24:54
1026c72507fb6eb7d2bc16d479d2ec86ac7032cd...1f822ee6c680b876fbb439a9ae517225cef4d038,2,17,14,31,4,2010-06-24 15:33:23,2010-06-24 15:33:23
30b1524a7785c12fcfe675ba509007ca6180f78c...0d0b137e2e4e45e880202a22899e1fec28c12b33,1,1,1,2,1,2010-06-24 03:59:16,2010-06-24 03:59:16
8851e9ed48adacf5cdf8dd224ffcec4f73d874e8...331ae13dc14448e5b2d30a1f5154e671222585d9,4,14,0,14,8,2010-06-28 21:29:15,2010-06-28 21:29:15
8851e9ed48adacf5cdf8dd224ffcec4f73d874e8...fa7e909e5e02121043ad14f8027669b69879ab86,1,4,1,5,2,2010-06-28 14:41:29,2010-06-28 14:41:29
fa7e909e5e02121043ad14f8027669b69879ab86...2e6c1584c09c5326faf22e927814d15485fbfd2a,1,5,0,5,1,2010-06-28 15:38:57,2010-06-28 15:37:49
4d7db8ced43fdc5398b60f744064a0596c0f4cc0...d5596001d25f01dd169f01ce4bb025fdd2486cc1,1,3,1,4,1,2010-06-24 21:55:03,2010-06-24 21:55:03
d5596001d25f01dd169f01ce4bb025fdd2486cc1...dd5dd04eb6950d365dea602f1b6b7ddb143feaa9,2,32,0,32,3,2010-06-25 01:35:06,2010-06-25 01:35:06
dd5dd04eb6950d365dea602f1b6b7ddb143feaa9...dd5f5155572bbcab4e166a52a86bf9fce53b6807,1,3,0,3,1,2010-06-25 01:40:13,2010-06-25 01:40:13
dd5f5155572bbcab4e166a52a86bf9fce53b6807...3ea919026f23763cea0f51dbd1be3dbd03fb0565,1,55,20,75,8,2010-06-25 16:11:56,2010-06-25 16:11:56
0d0b137e2e4e45e880202a22899e1fec28c12b33...a85c902ae39620fd7b1ba0155d027be5927a61f5,1,3,5,8,1,2010-06-24 17:42:26,2010-06-24 17:42:26
0d0b137e2e4e45e880202a22899e1fec28c12b33...c6ed1eb85ffa360bc6946cd56e340d7e8a057ce6,6,67,0,67,14,2010-06-24 15:05:10,2010-06-24 15:03:57
8254db5620621dac23d39b9f7d8949d07f71b036...ebdee89db06529edf56e996a122d8c984e595e58,8,28,22,50,20,2010-06-28 22:28:24,2010-06-28 22:28:24
2e6c1584c09c5326faf22e927814d15485fbfd2a...6dd05ca594e4a93fdc827da89e39986e188fed5f,3,75,21,96,19,2010-06-28 19:44:23,2010-06-28 19:44:23
2e6c1584c09c5326faf22e927814d15485fbfd2a...2f9a8039a07018a64e2b15b90875c391adbca36c,1,1,1,2,1,2010-06-28 17:28:15,2010-06-28 17:28:15
2f9a8039a07018a64e2b15b90875c391adbca36c...0589e234d989141ab75d83c64181929ad08635f4,1,1,1,2,1,2010-06-28 17:33:28,2010-06-28 17:33:28
ebdee89db06529edf56e996a122d8c984e595e58...82a04efbef9df2d1bf608f8e0caafe7d7d198e6c,1,4,0,4,1,2010-06-29 02:00:08,2010-06-29 02:00:08
3a60b337b4a21cd78a8944c160c8d15016b27ccc...48a31918c8f041a3b4a7bcc5f4e6a578b3d391f4,3,8,5,13,4,2010-06-28 20:52:44,2010-06-28 20:52:44
3a60b337b4a21cd78a8944c160c8d15016b27ccc...0a8b2c9246b17f5e205fba39e9cfc3afe9bbc508,1,5,0,5,1,2010-06-28 20:10:50,2010-06-28 20:10:23
0a8b2c9246b17f5e205fba39e9cfc3afe9bbc508...8eca8f6f38e2a56f52b6dad44445fcd01e1a40fe,4,43,9,52,12,2010-06-28 20:51:37,2010-06-28 20:51:37
623270348902c81850f45c8bf253da6abcd54c52...1e934132ad096c467d5ab41d0b16f492b0200fb0,3,156,45,201,33,2010-06-29 05:16:07,2010-06-29 05:16:07
8f1c46589e1df82f35bb054dcee441092ccc0cc7...344a92341e7537ca86cd009c92bcbdb1f5e9d344,2,55,0,55,3,2010-06-28 21:06:25,2010-06-28 21:06:25
8eca8f6f38e2a56f52b6dad44445fcd01e1a40fe...d69e7be045b8f1689b4bdafabe157e6c6822b7ca,1,9,9,18,8,2010-06-28 20:52:45,2010-06-28 20:52:45
d9b3333c65e70dc20133e906770ba211f936729b...8095bde2914435f20e2c4a17922eada7abe5c324,1,16,15,31,6,2010-06-29 13:58:20,2010-06-29 13:58:20
df6e399a19a8ecfa37e7537e4cd516dc95323501...2abad27e872f373443c3670775b8c2c49e655c70,1,3,0,3,1,2010-06-29 00:29:47,2010-06-29 00:29:47
4b82270f1cb25b0e19dbfa5011a21996b135c4b8...372aa5f6129425c06f5b55110a474f4da1b48dfc,3,10,10,20,8,2010-06-28 20:59:15,2010-06-28 20:59:15
8095bde2914435f20e2c4a17922eada7abe5c324...df99ec85dff823a6365b2d9de9c3bd1b205f93cb,1,2,2,4,2,2010-06-29 15:28:20,2010-06-29 15:28:20
258cee64e48a0db1dd2f2e1f181ca0b8337bb636...9c97a3fa808396259f2a172bf5995080a6482487,2,20,9,29,6,2010-06-28 21:27:13,2010-06-28 21:27:13
372aa5f6129425c06f5b55110a474f4da1b48dfc...7e6c61f2149c338bd955c8c8cee54c25011cf738,2,1,2,3,2,2010-06-28 21:15:39,2010-06-28 21:15:39
df99ec85dff823a6365b2d9de9c3bd1b205f93cb...6011eee820a7ae693ebb221bf181d89cd57d9b3c,6,17,13,30,12,2010-06-29 17:17:57,2010-06-29 17:17:57
df99ec85dff823a6365b2d9de9c3bd1b205f93cb...7a94a82d7e5e22f0f7ca8753921d48c5b4306545,1,5,6,11,1,2010-06-29 16:49:07,2010-06-29 16:49:07
b62d7743d7a88112d2b25290f711c842239be9a5...8ca831e2722e20a1e787c698a7fa420417915e2f,3,13,8,21,10,2010-06-29 17:42:53,2010-06-29 17:42:53
7a94a82d7e5e22f0f7ca8753921d48c5b4306545...ccf3519c6b67479097671d00674d0f7befd0e9a0,1,26,1,27,5,2010-06-29 17:06:00,2010-06-28 22:21:40
ccf3519c6b67479097671d00674d0f7befd0e9a0...600317543cf2bfa5a273b91049a77b571ff996ba,1,0,4,4,2,2010-06-29 17:06:00,2010-06-29 16:43:15
600317543cf2bfa5a273b91049a77b571ff996ba...951713a508e9898fe1f669165a28844d3db6b9e4,1,1,0,1,1,2010-06-29 17:07:12,2010-06-29 16:43:47
951713a508e9898fe1f669165a28844d3db6b9e4...c678e84a943d2ee78ed2e45fb5044b1c5faac165,1,26,0,26,1,2010-06-29 17:11:04,2010-06-29 17:05:46
8ca831e2722e20a1e787c698a7fa420417915e2f...5d410c4c8cc25043485ba518baf43d21e5130732,1,7,2,9,2,2010-06-29 19:14:00,2010-06-29 19:14:00
5d410c4c8cc25043485ba518baf43d21e5130732...5445c98de1ae72c91bca87ee939d4fb4640a62ef,4,25,8,33,13,2010-06-29 19:14:33,2010-06-29 19:14:33
725358b9173a2a4425389a856d23f10b314f7d1f...56b15870d6a96efe52c4bbbf1d5f73ffefe477af,1,1,1,2,1,2010-06-29 17:44:12,2010-06-29 17:44:12
9664ef713822f5c837a38f82487c5f83fe198518...16f850da21d729f9042421dc76392105d1509fc1,1,2,2,4,2,2010-06-29 19:52:09,2010-06-29 19:52:09
16f850da21d729f9042421dc76392105d1509fc1...804afa9b6a2395becbbdd44a16ff6f57e82ed5da,8,85,69,154,25,2010-06-29 19:52:35,2010-06-29 19:52:35
56b15870d6a96efe52c4bbbf1d5f73ffefe477af...3bb8743e0c5d6f892f5656bd6f29d53bc49fe81a,3,69,60,129,5,2010-06-29 18:49:06,2010-06-29 18:49:06
56b15870d6a96efe52c4bbbf1d5f73ffefe477af...eb1f6017451b9254fc73da0d40707ecaf357417e,1,6,1,7,2,2010-06-29 17:49:07,2010-06-29 17:49:07
eb1f6017451b9254fc73da0d40707ecaf357417e...91f745ac64c3993bb3db743ea415115059a99346,1,2,5,7,2,2010-06-29 17:58:37,2010-06-29 17:58:16
41641885526827d72a68caa315c001fc5705445c...7fb7c94f250059e937abe683aec8d3b459000877,8,60,23,83,27,2010-06-29 22:27:09,2010-06-29 22:27:09
41641885526827d72a68caa315c001fc5705445c...b60539182d2a4dd200b766c0c1c3615f7f0e3ac2,2,11,11,22,7,2010-06-29 20:59:58,2010-06-29 20:59:58
b60539182d2a4dd200b766c0c1c3615f7f0e3ac2...3b778cf4de8139a27dd61774b1875c730e8d72e5,1,3,0,3,2,2010-06-29 21:56:20,2010-06-29 21:56:20
3b778cf4de8139a27dd61774b1875c730e8d72e5...95d59d3dc377d3b158f5cbd459cfea49c9f3f4da,3,105,40,145,28,2010-06-29 21:57:29,2010-06-29 21:57:29
95d59d3dc377d3b158f5cbd459cfea49c9f3f4da...6aa81f6495eb18e2f641cd230b69edacb90f4922,1,4,0,4,1,2010-06-29 21:59:59,2010-06-29 21:59:59
6aa81f6495eb18e2f641cd230b69edacb90f4922...4c20050cf7ac4be9bd6fae558ea125100ad9fc96,3,58,32,90,9,2010-06-29 22:10:40,2010-06-29 22:10:40
85090878c46ccd86dfa8d0cc1d78e17ca1e91822...ea3fd1739cf4dcc6fac1fddae269f4c401e9cf46,2,68,0,68,2,2010-06-29 19:22:36,2010-06-29 19:22:36
ea3fd1739cf4dcc6fac1fddae269f4c401e9cf46...9ed4a2a55f9d74d07f8d8044f02dd416069f2bcc,3,61,1,62,6,2010-06-29 19:34:01,2010-06-29 19:34:01
91f745ac64c3993bb3db743ea415115059a99346...1004452bfd40e054c51a783bc65baa3463a1b584,1,7,3,10,2,2010-06-29 18:18:02,2010-06-29 18:18:02
91f745ac64c3993bb3db743ea415115059a99346...20d5b887dc8195419c45aaf1c5b76f1f3027e12a,3,23,2,25,7,2010-06-29 18:17:42,2010-06-29 18:17:42
5b8ec018415bc5f22c705efe2001ff3f3df22d38...6af4ec3ef32bce3851e6e3d09609945d72c22483,1,3,5,8,3,2010-06-29 23:59:36,2010-06-29 23:59:36
b998ca67f849141679f7cd383e7e73d6fd2242f1...6d77e8f62e53754df018a907f6c9dd6a12bf2c61,3,18,2,20,5,2010-06-29 18:23:55,2010-06-29 18:23:55
6af4ec3ef32bce3851e6e3d09609945d72c22483...084e0b81737cd064948a87ba9f568b574e661305,1,1,1,2,1,2010-06-30 04:01:47,2010-06-30 04:01:47
6af4ec3ef32bce3851e6e3d09609945d72c22483...6a658fef4ec37b12937f654a6ccc0d725516ac24,1,6,0,6,1,2010-06-30 00:07:09,2010-06-29 21:58:44
6a658fef4ec37b12937f654a6ccc0d725516ac24...a95c55925c807aa43aa8013a08bc7408bb96a562,1,3,2,5,2,2010-06-30 00:07:09,2010-06-29 22:00:07
a95c55925c807aa43aa8013a08bc7408bb96a562...0e5ed0a83e43d64cfb77af7e0de91e871e989da0,2,2,2,4,2,2010-06-30 00:07:09,2010-06-29 22:08:07
0e5ed0a83e43d64cfb77af7e0de91e871e989da0...3b37957322b3b00c783c9a90e7afdfeb8f25f4c6,2,10,5,15,8,2010-06-30 00:40:29,2010-06-30 00:40:29
3b37957322b3b00c783c9a90e7afdfeb8f25f4c6...43d5954d08bbc9b154d18184abf74dd278412b86,1,15,26,41,5,2010-06-30 01:08:55,2010-06-30 01:08:55
43d5954d08bbc9b154d18184abf74dd278412b86...c130956e537bc47fc7347aa8acbf20bf2bb914cb,1,7,3,10,1,2010-06-30 01:27:12,2010-06-30 01:27:12
c130956e537bc47fc7347aa8acbf20bf2bb914cb...ed1d2ad1c6b7667707e3be2ebdc5c198b995f65d,1,1,1,2,1,2010-06-30 01:31:44,2010-06-30 01:31:44
ed1d2ad1c6b7667707e3be2ebdc5c198b995f65d...629a3d611586159c1ec1ea407a8136052e29e114,1,12,2,14,7,2010-06-30 01:44:30,2010-06-30 01:44:30
629a3d611586159c1ec1ea407a8136052e29e114...35031d43d717dda19b0b62ab6f97af275717ad30,3,1,12,13,3,2010-06-30 02:17:15,2010-06-30 02:17:15
35031d43d717dda19b0b62ab6f97af275717ad30...d067da6205a151eb2f3e15dfa7975debc4a44278,1,1,0,1,1,2010-06-30 02:22:55,2010-06-30 02:22:55
6d77e8f62e53754df018a907f6c9dd6a12bf2c61...6788a1811111d7c63b9e0250891f4739201c5620,2,17,0,17,2,2010-06-29 18:28:48,2010-06-29 18:28:48
6d77e8f62e53754df018a907f6c9dd6a12bf2c61...037c63728363c6668d4ea07261cf3a8742059f29,1,10,0,10,5,2010-06-29 18:25:29,2010-06-29 18:24:56
47fa4e0fd14ed7a5c138215d8ae530fe492c45b3...6888b8e403a9f890b4a869e0a5fa8a878a546e10,1,3,3,6,3,2010-06-30 04:55:52,2010-06-30 04:55:52
d067da6205a151eb2f3e15dfa7975debc4a44278...e6368b8bebabfb3118265e80c7ca7a25d689b87f,4,74,17,91,16,2010-06-30 04:03:10,2010-06-30 04:03:10
2191487e95e433192221ff838d874017f8b7de07...66d07d51598b0e7d8fb9da99305f223a4df46e85,1,3,0,3,1,2010-06-30 06:27:06,2010-06-30 06:27:06
66d07d51598b0e7d8fb9da99305f223a4df46e85...6fcf0146c735e4639d1488e1539fddd24180a6eb,1,441,441,882,1,2010-06-30 16:51:26,2010-06-30 16:51:26
6fcf0146c735e4639d1488e1539fddd24180a6eb...b54e6e1d40b079d9662311dfe539f5eb1ea8ad6b,1,22,5,27,12,2010-06-30 16:57:36,2010-06-30 16:57:36
b54e6e1d40b079d9662311dfe539f5eb1ea8ad6b...5096cb8b40289c6d1884d3345c8b5e4ddecc6047,1,1,0,1,1,2010-06-30 17:40:50,2010-06-30 17:40:50
5096cb8b40289c6d1884d3345c8b5e4ddecc6047...e3e227686b7099478d737fcfe5ea5f45c1d10195,1,4,0,4,1,2010-06-30 17:50:16,2010-06-30 17:50:16
e3e227686b7099478d737fcfe5ea5f45c1d10195...748619652248bd40a2ab55f56e7ca038f9d14cf3,2,1,6,7,2,2010-06-30 17:57:05,2010-06-30 17:57:05
748619652248bd40a2ab55f56e7ca038f9d14cf3...082a592291e22e6fae7682507371d058e631860f,4,52,3,55,6,2010-06-30 19:56:59,2010-06-30 19:56:59
748619652248bd40a2ab55f56e7ca038f9d14cf3...218972103f2291b6d1b8da834fb2fecbe69c3654,1,54,0,54,1,2010-06-30 18:24:26,2010-06-30 18:24:26
748619652248bd40a2ab55f56e7ca038f9d14cf3...2924ae974febfbef17674d5470b384c0a6ac47a4,1,1,1,2,1,2010-06-30 18:23:08,2010-06-30 18:23:08
fcb81f1aeca7b3ddfd97a3a5b1f8db43dde6191c...119af1013267fff5296901e18e27a99645d51cc1,1,2,2,4,3,2010-06-30 20:08:07,2010-06-30 20:08:07
119af1013267fff5296901e18e27a99645d51cc1...51838da939687102d12f91702dbd5d7b5b4929d8,1,21,28,49,4,2010-06-30 20:11:05,2010-06-30 20:11:05
0a7ce24c4cebd2e0a66fa1331c8b042691eb1a3d...501fca1b02964f24222e0cc93c9eb1816856d4ca,1,5,0,5,1,2010-06-30 18:29:19,2010-06-30 18:29:19
51838da939687102d12f91702dbd5d7b5b4929d8...11a05067f078df9497bd26f090875e88d1bd4261,1,15,15,30,13,2010-06-30 20:52:29,2010-06-30 20:52:29
51838da939687102d12f91702dbd5d7b5b4929d8...97dc2c6b1273b0bdb4b292f77dc6e37c86f4f31d,1,1,1,2,1,2010-06-30 20:13:18,2010-06-30 20:13:18
501fca1b02964f24222e0cc93c9eb1816856d4ca...e3b9118733d6da20c1d03a2bb8f1b8b4934ec113,1,1,1,2,1,2010-06-30 20:32:36,2010-06-30 20:32:36
6aaa45ae24008f269b6b35a38dbbcaea068569ea...12663be3f934feaf4443708188f6c8f2aef37f36,4,42,12,54,16,2010-06-30 21:28:57,2010-06-30 21:28:57
12663be3f934feaf4443708188f6c8f2aef37f36...76bb389d29623358ae803d7cccc5aa29a5ab0632,1,1,1,2,1,2010-06-30 22:05:26,2010-06-30 22:05:26
76bb389d29623358ae803d7cccc5aa29a5ab0632...105ab908e4f696c08f0119f78209580a54fd55dd,4,22,16,38,10,2010-07-01 00:23:38,2010-07-01 00:23:38
105ab908e4f696c08f0119f78209580a54fd55dd...795144c622093ed6bef340bd6b76f5ee90b57d30,2,24,23,47,24,2010-07-01 00:33:58,2010-06-30 17:32:01
795144c622093ed6bef340bd6b76f5ee90b57d30...30e583d1b2fc2f8bcf1bfa13305eeebbc25a8c7c,2,16,19,35,9,2010-07-01 00:33:58,2010-06-30 18:01:47
30e583d1b2fc2f8bcf1bfa13305eeebbc25a8c7c...682a7d714848ebfe72bc3e1f10fed3cd9da4b37e,1,5,2,7,1,2010-07-01 00:33:58,2010-06-30 18:19:27
682a7d714848ebfe72bc3e1f10fed3cd9da4b37e...e9a9b3bf368e1f3d6ddae37f54abfc17ba589812,2,22,32,54,20,2010-07-01 00:33:58,2010-06-30 18:35:23
e9a9b3bf368e1f3d6ddae37f54abfc17ba589812...3e8b09f4e39e68be61a5f230e6f50a30c30dc70f,2,8,3,11,4,2010-07-01 00:33:58,2010-07-01 00:31:17
3e8b09f4e39e68be61a5f230e6f50a30c30dc70f...bf779e5078c13c55e5985965a4c86ebe5092d807,2,3,2,5,3,2010-07-01 01:53:52,2010-07-01 01:53:52
bf779e5078c13c55e5985965a4c86ebe5092d807...a47f13a9af1b8b0f28208eb3f9e3c83d95743de0,1,1,1,2,1,2010-07-01 03:17:49,2010-07-01 03:17:49
a47f13a9af1b8b0f28208eb3f9e3c83d95743de0...6d596a5d6488d01f1e416f129f007fc6ad308b5e,1,1,1,2,2,2010-07-01 03:20:20,2010-07-01 03:20:20
6d596a5d6488d01f1e416f129f007fc6ad308b5e...05de6bdacb29823f76162852b2a283f9e95aad93,5,147,38,185,20,2010-07-01 05:00:21,2010-07-01 05:00:21
05de6bdacb29823f76162852b2a283f9e95aad93...fdced7082a9aa49c09de41e7f63b51fc3bf073ef,2,125,0,125,2,2010-07-01 05:06:13,2010-07-01 05:06:13
fdced7082a9aa49c09de41e7f63b51fc3bf073ef...fd8d8670a694fd4f9dabffd7cec812a6c1155474,2,6,0,6,2,2010-07-01 14:22:00,2010-07-01 14:22:00
fd8d8670a694fd4f9dabffd7cec812a6c1155474...51ad1d3292843f0dbc71fde2c4e4a171a9643a87,1,3,1,4,1,2010-07-01 14:29:31,2010-07-01 14:29:31
51ad1d3292843f0dbc71fde2c4e4a171a9643a87...c2aa43941528b581d61e1b8ab8217ed3e657fed0,3,27,3,30,5,2010-07-01 15:00:53,2010-07-01 15:00:53
c2aa43941528b581d61e1b8ab8217ed3e657fed0...3156ae5402da4b18bfd05e47337f2896eb400449,1,1,1,2,1,2010-07-01 15:24:31,2010-07-01 15:24:31
c2aa43941528b581d61e1b8ab8217ed3e657fed0...efbd83e6ef63d121bdbf83f42c65bb2f1f7c7f2a,2,2,2,4,2,2010-07-01 15:18:11,2010-07-01 15:18:11
c2aa43941528b581d61e1b8ab8217ed3e657fed0...430527b642ad8e424e9b0917429595d0686cae10,1,5,1,6,2,2010-07-01 15:10:32,2010-07-01 15:06:40
430527b642ad8e424e9b0917429595d0686cae10...fdd8e4f20ce59e85de2c13960383491d4edac978,1,2,1,3,1,2010-07-01 15:10:32,2010-07-01 15:08:16
526276664783431844e9f5f7a184d30ac3a5a164...2aa01a059e94b94ac580fd4b33e0201da398b272,1,5,1,6,1,2010-07-01 20:05:27,2010-07-01 20:05:27
2aa01a059e94b94ac580fd4b33e0201da398b272...5f974197778a05ae1450ce4a4d01e368d93b1ead,1,9,1,10,1,2010-07-01 20:05:37,2010-07-01 20:05:37
5f974197778a05ae1450ce4a4d01e368d93b1ead...30d3a841f2af1a3e8bdf10a0e8d9ed41994a10dc,2,2,1,3,2,2010-07-01 21:10:55,2010-07-01 21:10:55
30d3a841f2af1a3e8bdf10a0e8d9ed41994a10dc...2498228f417371da7c18d7bed38be4b3a300a29f,18,328,287,615,93,2010-07-01 21:44:13,2010-07-01 21:44:13
526276664783431844e9f5f7a184d30ac3a5a164...3fd0f2e9a728443615b02d2919213465bd4d2b51,4,51,6,57,19,2010-07-01 16:25:50,2010-07-01 16:25:50
9ca8df5ce157b176f8477a980e05d5193d9bdf1f...4b114fcb0d822298e8cfdcb2109421b2c071810b,2,4,0,4,2,2010-07-01 17:11:16,2010-07-01 17:11:16
1129fbe29872b8077ce71dbbc6507dfd01f02179...1d96219addad2a007375043b06731392fe388bbf,3,9,7,16,7,2010-07-01 19:13:50,2010-07-01 19:13:50
3ba2866586e181a57fb77e79bbe64da23ee6dbce...224ca4aecdde61bea54af48acf58c39994a497ca,3,61,6,67,8,2010-07-01 22:02:25,2010-07-01 21:57:30
1d96219addad2a007375043b06731392fe388bbf...e3d9b61b12c64cddf907eab48dc6873bd50317a2,5,29,29,58,7,2010-07-01 21:52:07,2010-07-01 21:52:07
e3d9b61b12c64cddf907eab48dc6873bd50317a2...1f45ff135584cbf0c712015c2501ddfb610079d7,2,2,2,4,2,2010-07-01 21:54:08,2010-07-01 21:54:08
1f45ff135584cbf0c712015c2501ddfb610079d7...e0318143ff9467479b2f17a6434daadb07235d7c,5,3441,3439,6880,5,2010-07-02 14:33:56,2010-07-02 14:33:56
1d96219addad2a007375043b06731392fe388bbf...b9a4a10a1189f1f583283f215421d4ed080fa277,1,3,2,5,2,2010-07-01 20:54:24,2010-07-01 20:54:24
224ca4aecdde61bea54af48acf58c39994a497ca...92e8ad86faaf3245893f309a7cae44dee9261108,7,41,8,49,16,2010-07-02 04:51:41,2010-07-02 04:51:41
224ca4aecdde61bea54af48acf58c39994a497ca...fe54b5da1f9ca9fd617d09f762e73df22df7b414,2,3,3,6,3,2010-07-02 00:40:37,2010-07-02 00:40:37
fe54b5da1f9ca9fd617d09f762e73df22df7b414...ab4a1e6b292d5afabaf68e44b672441ad97c888a,2,98,24,122,9,2010-07-02 01:05:04,2010-07-02 01:05:04
ab4a1e6b292d5afabaf68e44b672441ad97c888a...a3b17a92ca58cade69fd995af040dbca76ba5d21,1,1,1,2,1,2010-07-02 01:33:57,2010-07-02 01:33:57
2b21e38733ad353f21d2f076336cc1981628b301...f42dd671e49f836788c4d6f946fe012da51f9763,5,1598,1554,3152,8,2010-07-02 15:00:34,2010-07-02 15:00:34
b9a4a10a1189f1f583283f215421d4ed080fa277...b2afadaad843ffc9d6b0d530a6354aca3a3921db,1,4,2,6,3,2010-07-01 21:46:06,2010-07-01 20:26:47
b2afadaad843ffc9d6b0d530a6354aca3a3921db...aa7aeab86dcf63b882b7f3094f0d0c85b825b33d,1,2,1,3,1,2010-07-01 21:46:06,2010-07-01 20:57:48
aa7aeab86dcf63b882b7f3094f0d0c85b825b33d...ae2aa8a24552ab035ead84eb49fcc17270beb522,1,7,5,12,3,2010-07-01 21:46:06,2010-07-01 20:59:59
ae2aa8a24552ab035ead84eb49fcc17270beb522...e4a288e42eac2172f36942539f9d9f2ec817266e,2,5,1,6,4,2010-07-01 21:46:06,2010-07-01 21:12:20
e4a288e42eac2172f36942539f9d9f2ec817266e...08c7d96d3ac8bd174ff82716f5a2a15d077e207a,1,11,8,19,4,2010-07-01 21:46:06,2010-07-01 21:45:14
66c98c95e4218ad82cbb164f05f2989cd47ccb44...b962be5964672b689c00506d8e8b56de30415bb1,1,7,2,9,1,2010-07-02 05:06:35,2010-07-02 05:06:35
b962be5964672b689c00506d8e8b56de30415bb1...5a262db1bd6fcc58c6303cbfeb4d12e7be727d6c,1,1,0,1,1,2010-07-02 05:13:34,2010-07-02 05:13:34
5a262db1bd6fcc58c6303cbfeb4d12e7be727d6c...b232b213bae815783359354fdfff3c22ec5e4125,3,8,2,10,6,2010-07-02 05:49:27,2010-07-02 05:49:27
b232b213bae815783359354fdfff3c22ec5e4125...3612e8ca549953a28d3088d9ee91e44db299647d,1,3,2,5,3,2010-07-02 14:15:21,2010-07-02 14:15:21
3612e8ca549953a28d3088d9ee91e44db299647d...6c7c8236bb7626bc0be1f1a5fea1ac9f25d3d206,1,25,0,25,1,2010-07-02 14:15:31,2010-07-02 14:15:31
6c7c8236bb7626bc0be1f1a5fea1ac9f25d3d206...2b4bb9cb6f0e2930a3411626143ff0fb28855259,1,1,0,1,1,2010-07-02 14:27:35,2010-07-02 14:27:35
2b4bb9cb6f0e2930a3411626143ff0fb28855259...7cab28a61f38cd70c65ee828cf9baf8db283e3c6,2,5,2,7,5,2010-07-02 14:27:49,2010-07-02 14:27:49
49fb7b580115b3db5b1ec05b79631e0864ce25ac...9a847036926d8da49854962025990e6eb157e825,1,2,2,4,2,2010-07-02 14:59:27,2010-07-02 14:59:27
7cab28a61f38cd70c65ee828cf9baf8db283e3c6...dd337cb1d61427044b71a165401194e7fc4d7000,4,9,2,11,6,2010-07-02 14:50:43,2010-07-02 14:50:43
9a847036926d8da49854962025990e6eb157e825...b67d751796cb9fe8e9257a94f2def05947033abb,1,7,1,8,1,2010-07-02 15:07:35,2010-07-02 15:07:35
d58cef225a775ba81c4629656aa9d6044b7ce8f8...01f0d605158fa9942ef0609ff44f2574684e103a,4,27,18,45,14,2010-07-02 15:43:26,2010-07-02 15:43:26
b67d751796cb9fe8e9257a94f2def05947033abb...1abe910d416c847dc055f42c33f1f679db2932c8,2,15,13,28,12,2010-07-02 15:29:33,2010-07-02 15:29:33
01f0d605158fa9942ef0609ff44f2574684e103a...40c4ad7e28c0a92dabf495a244d145a3238afd5d,1,8,6,14,7,2010-07-02 16:44:39,2010-07-02 16:44:39
01f0d605158fa9942ef0609ff44f2574684e103a...ea3208f3ed5926c577e827ffe9b15db556f69782,1,1,0,1,1,2010-07-02 16:01:47,2010-07-02 16:00:30
ea3208f3ed5926c577e827ffe9b15db556f69782...dfedac14db32629868a5ad1484290bec5c5e054f,1,1,1,2,1,2010-07-02 16:01:47,2010-07-02 16:01:32
dfedac14db32629868a5ad1484290bec5c5e054f...3e12f9c33230d8bf5d4632dfcb350b8095980fde,1,1,1,2,1,2010-07-02 16:03:07,2010-07-02 16:03:07
291cefc35cd16e71d09da6114148677de312a45e...c189aeec21fc12ea899fb1e43317becf551be2ca,1,1,0,1,1,2010-07-04 13:16:21,2010-07-04 13:16:21
c189aeec21fc12ea899fb1e43317becf551be2ca...e11533f77bb4dcbfc9433b427880f151c7da177a,2,98,3,101,6,2010-07-04 13:28:11,2010-07-04 13:28:11
291cefc35cd16e71d09da6114148677de312a45e...05646292515f550432d7287dd0b31923d9457a5b,3,87,45,132,4,2010-07-02 18:05:49,2010-07-02 18:05:49
3e12f9c33230d8bf5d4632dfcb350b8095980fde...e3b9c11fde05dd7c14d95093896322b3e1ff2775,1,1,0,1,1,2010-07-02 16:16:06,2010-07-02 16:16:06
e3b9c11fde05dd7c14d95093896322b3e1ff2775...41024f48eba07d5e3a314a65dd64283db435cfd3,1,1,1,2,1,2010-07-02 16:27:30,2010-07-02 16:27:30
3e12f9c33230d8bf5d4632dfcb350b8095980fde...7a713c2a291014136ca98a8c4bcc485c642befb7,1,1,1,2,1,2010-07-02 16:11:08,2010-07-02 16:11:08
2585c42a88bdb0b449da97044085df65b0cd06f4...654f20403673c84e6e30aed8777890f5aad2132d,1,1,1,2,1,2010-07-04 13:28:51,2010-07-04 13:28:51
654f20403673c84e6e30aed8777890f5aad2132d...0325518495ff84eadd4ef0fef78071a292e48756,7,12,1,13,7,2010-07-04 13:36:58,2010-07-04 13:36:58
0325518495ff84eadd4ef0fef78071a292e48756...7cc51e8cd5f49615a1eeea4e859fde019289a815,3,10,2,12,6,2010-07-04 13:48:34,2010-07-04 13:48:34
7cc51e8cd5f49615a1eeea4e859fde019289a815...bd0fb49da5bf6f6232b5da52b1eb98adc2abbaa2,3,24,19,43,7,2010-07-04 15:08:00,2010-07-04 15:08:00
bd0fb49da5bf6f6232b5da52b1eb98adc2abbaa2...d02d79af24b5ec12bdab6fc24155b82dd5f113e7,1,1,1,2,1,2010-07-04 15:30:59,2010-07-04 15:30:59
d02d79af24b5ec12bdab6fc24155b82dd5f113e7...2d37109d0c37f28800fe4c1e3b100419c5f5485f,2,62,0,62,4,2010-07-04 17:36:36,2010-07-04 17:35:44
2d37109d0c37f28800fe4c1e3b100419c5f5485f...a8a738d9f762dfa1917aae7d200410bd88e910c5,1,4,4,8,3,2010-07-04 19:20:58,2010-07-04 19:20:58
a8a738d9f762dfa1917aae7d200410bd88e910c5...090d0c7736e5d5cd518de2f9fc37388d28c93c1c,1,5,10,15,2,2010-07-04 21:55:45,2010-07-04 21:55:45
090d0c7736e5d5cd518de2f9fc37388d28c93c1c...3908a13a6e0dde818e4799ea1347cd669ca54e00,1,4,0,4,1,2010-07-04 22:25:02,2010-07-04 22:25:02
3908a13a6e0dde818e4799ea1347cd669ca54e00...f7288ef41020bcafdb7b1d7ad4da28e8421ecccf,6,48,20,68,20,2010-07-05 04:54:17,2010-07-05 04:54:17
f7288ef41020bcafdb7b1d7ad4da28e8421ecccf...16ae88847abb578f2cc9e6f920f1d66346834887,1,8,13,21,5,2010-07-05 13:26:38,2010-07-05 13:26:38
05646292515f550432d7287dd0b31923d9457a5b...a40cf4509c4e24968640f958097471aea9a87621,1,77,0,77,1,2010-07-02 18:14:47,2010-07-02 18:14:47
05646292515f550432d7287dd0b31923d9457a5b...1614beb706400c3dbbcad75ada929ae42e0b8def,1,12,0,12,8,2010-07-02 18:10:59,2010-07-02 17:43:16
1614beb706400c3dbbcad75ada929ae42e0b8def...542d21c7007f8a52a3832628657241861c857dc9,2,7,5,12,3,2010-07-02 18:10:59,2010-07-02 18:10:13
9ab6ebf2657c9204898b18132df69d0d6905a67e...b98f1008adc4aac833ad2baaee7c3eabc804fd37,1,5,5,10,2,2010-07-02 18:05:37,2010-07-02 18:05:37
b98f1008adc4aac833ad2baaee7c3eabc804fd37...6bd7d29d9985c861c35bf4759c86e67f5505a28c,8,112,55,167,40,2010-07-02 20:48:21,2010-07-02 20:48:21
16ae88847abb578f2cc9e6f920f1d66346834887...6ad4d4cb3208f5df3343d0c89bedb2c4087f174f,1,1,1,2,1,2010-07-05 14:15:56,2010-07-05 14:15:56
16ae88847abb578f2cc9e6f920f1d66346834887...cf9be9599a985ab99171e9258cf4f1899c5d6d94,1,1,3,4,2,2010-07-05 14:12:32,2010-07-05 14:12:32
de6774b603b83278bb76585393f39960ab3abd89...82a1e6b7eb830aff1abe6cdbee4bc01a59f26a62,1,6,3,9,3,2010-07-02 18:57:05,2010-07-02 18:56:45
82a1e6b7eb830aff1abe6cdbee4bc01a59f26a62...9730b99def30b673d05b78302ca062f1c38ce838,2,0,14,14,10,2010-07-02 19:45:17,2010-07-02 19:45:17
9730b99def30b673d05b78302ca062f1c38ce838...a57505d18694f1f5c4545c7b59d7487b878ffd7c,1,2,0,2,2,2010-07-02 19:46:54,2010-07-02 19:46:54
a57505d18694f1f5c4545c7b59d7487b878ffd7c...3d27b6bd3fd535d845ce05690e8b69b6351faef8,2,22,3,25,5,2010-07-02 20:37:47,2010-07-02 20:37:47
3eff98eead2603c0f5f8ff1f394817bde9513c0f...8fd251b2ed3d7985f7c06dd499b248538b4a8429,1,3,1,4,2,2010-07-02 21:23:25,2010-07-02 21:23:25
8fd251b2ed3d7985f7c06dd499b248538b4a8429...4ce84ab192072fd8027b72993f81ac019455df01,2,0,10,10,2,2010-07-02 21:23:52,2010-07-02 21:23:52
4ce84ab192072fd8027b72993f81ac019455df01...6468ece9c373c7eea59141b880399e2a81fd241a,1,1,0,1,1,2010-07-02 21:24:05,2010-07-02 21:24:05
6468ece9c373c7eea59141b880399e2a81fd241a...717117eecdc702e13caa1f60b34f7ea510c72964,1,1,3,4,2,2010-07-02 21:39:43,2010-07-02 21:26:58
717117eecdc702e13caa1f60b34f7ea510c72964...9fa75946a09075da2b0bdb00cf5f6a4f7f2df3ad,1,10,1,11,8,2010-07-02 21:39:43,2010-07-02 21:39:25
9fa75946a09075da2b0bdb00cf5f6a4f7f2df3ad...5306963c75645645a5c1e6002519f5c0b2a31e85,1,1,10,11,8,2010-07-02 22:14:45,2010-07-02 22:14:45
5306963c75645645a5c1e6002519f5c0b2a31e85...d0607abb0007c392bc1c6b9da000bf98c204caf6,1,3,7,10,1,2010-07-02 22:18:01,2010-07-02 22:18:01
d0607abb0007c392bc1c6b9da000bf98c204caf6...45bfdc47d0e9aca14b6c954cfc665b95d56e2569,1,1,1,2,1,2010-07-02 22:23:22,2010-07-02 22:23:22
45bfdc47d0e9aca14b6c954cfc665b95d56e2569...4542b8fb0800275978990b1023f88caaf8ed57cf,1,20,1,21,1,2010-07-02 22:58:42,2010-07-02 22:58:42
4542b8fb0800275978990b1023f88caaf8ed57cf...982332f807c38a261f459b816bf06bb87366d16a,2,15,3,18,6,2010-07-02 23:17:18,2010-07-02 23:17:18
982332f807c38a261f459b816bf06bb87366d16a...1a593ad925831be7d415c8163babdc8db2bed0a1,1,3,1,4,1,2010-07-02 23:53:56,2010-07-02 23:53:56
1a593ad925831be7d415c8163babdc8db2bed0a1...85a8c255b207bc9b390e12822d03a9a1db4d05ac,1,1,1,2,1,2010-07-03 00:14:37,2010-07-03 00:14:37
85a8c255b207bc9b390e12822d03a9a1db4d05ac...08ec1654da0b80bb775bd838cef4ce5dbbca2d1a,1,2,2,4,2,2010-07-03 00:58:08,2010-07-03 00:58:08
08ec1654da0b80bb775bd838cef4ce5dbbca2d1a...6c1361df41d9cabf9026364427a7df44b3c304fd,4,9,3,12,4,2010-07-03 01:00:11,2010-07-03 01:00:11
6c1361df41d9cabf9026364427a7df44b3c304fd...7362bb74b4506aa2e4e62ccdd74cecdc0d9bf37a,1,2,1,3,1,2010-07-03 03:21:50,2010-07-03 03:21:50
7362bb74b4506aa2e4e62ccdd74cecdc0d9bf37a...2a9aa818683950576e2448e9e62876288cf62093,1,1,1,2,1,2010-07-03 04:46:42,2010-07-03 04:46:42
2a9aa818683950576e2448e9e62876288cf62093...8672d8855e54e0c8fc82161aa8426dd19b931401,2,88,13,101,13,2010-07-03 16:46:02,2010-07-03 16:46:02
8672d8855e54e0c8fc82161aa8426dd19b931401...5b86409bf938cc09062595149ecececefafe7a26,1,2,2,4,2,2010-07-03 17:32:03,2010-07-03 17:32:03
5b86409bf938cc09062595149ecececefafe7a26...480e89e582b4b72c6e9db88669a01a166d633cb9,4,10,10,20,11,2010-07-03 18:20:18,2010-07-03 18:20:18
480e89e582b4b72c6e9db88669a01a166d633cb9...812b647228b099457b5fd27002f9a44035ff7067,4,63,12,75,5,2010-07-03 22:29:13,2010-07-03 22:29:13
812b647228b099457b5fd27002f9a44035ff7067...35118b07cebc26a6f415eff618254e56aafe2442,2,5,8,13,2,2010-07-04 02:06:35,2010-07-04 02:06:35
35118b07cebc26a6f415eff618254e56aafe2442...4291eee212a276eb99ab912c04a9552898b10d95,1,1,1,2,1,2010-07-04 02:06:44,2010-07-04 02:06:44
4291eee212a276eb99ab912c04a9552898b10d95...d24e2d0611eb2c2960716453321ce5520962d3eb,1,2,2,4,2,2010-07-04 11:15:10,2010-07-04 11:15:10
d24e2d0611eb2c2960716453321ce5520962d3eb...0c80ee92ac22872458c16783b5639bc68eaac4a0,1,3,3,6,1,2010-07-04 11:15:35,2010-07-04 11:15:35
0c80ee92ac22872458c16783b5639bc68eaac4a0...c62c43e00742793daeee083785c5e7868bb341ad,1,2,1,3,2,2010-07-04 11:17:56,2010-07-04 11:17:56
c62c43e00742793daeee083785c5e7868bb341ad...09031b917fd0578d492a6b57c09405719d4cc35c,2,32,1,33,4,2010-07-04 12:09:19,2010-07-04 12:09:19
cf9be9599a985ab99171e9258cf4f1899c5d6d94...d0cf28370b5edc56a82fcceb583020bdd5045c96,2,95,52,147,30,2010-07-05 16:29:42,2010-07-05 16:29:42
09031b917fd0578d492a6b57c09405719d4cc35c...1d1d36c42444ff1ebc3ed1073fcc64ec0a6c1689,1,1,1,2,1,2010-07-04 12:13:31,2010-07-04 12:13:31
09031b917fd0578d492a6b57c09405719d4cc35c...ac67d14bb060535284fb646903e6d35a7a262603,1,2,1,3,1,2010-07-04 12:12:22,2010-07-04 04:32:56
1f56599845e04ac268dcf1ba0b9f729607327fe0...ed0df3ed3ed8824c9e13aac20a2b037129ef071e,1,1,1,2,1,2010-07-05 16:54:11,2010-07-05 16:53:50
c8d6bc228c51bff7fe2606aacc638cdb971a18e4...8eb88a0f6e0dbeaf624df0648a102e0ca1c55d5a,1,1,1,2,1,2010-07-04 12:18:41,2010-07-04 12:18:41
8eb88a0f6e0dbeaf624df0648a102e0ca1c55d5a...ddd4bd9b9e57af5a4ce640ac8421771c5fab70aa,1,1,1,2,1,2010-07-04 12:28:50,2010-07-04 12:28:50
ddd4bd9b9e57af5a4ce640ac8421771c5fab70aa...85ee9d5f90c3f9c24ef829e78e97c44e65bd5595,1,4,0,4,1,2010-07-04 12:30:59,2010-07-04 12:30:59
85ee9d5f90c3f9c24ef829e78e97c44e65bd5595...1fbccafd5aa184027e491d06739546c4ec5849f5,1,28,8,36,7,2010-07-04 13:02:27,2010-07-04 13:02:27
ed0df3ed3ed8824c9e13aac20a2b037129ef071e...373709a2894716ab4168e45e2d5f9e0de0f7911b,5,16,5,21,13,2010-07-06 03:10:51,2010-07-06 03:10:51
ed0df3ed3ed8824c9e13aac20a2b037129ef071e...425535b9409d84ecd02417f303b4b926661de67a,1,52,22,74,12,2010-07-05 23:46:11,2010-07-05 23:46:11
425535b9409d84ecd02417f303b4b926661de67a...94053aebc8b1b84a8192acc3cdd70ae05bdc4cb2,2,57,8,65,4,2010-07-06 03:08:42,2010-07-05 17:41:07
94053aebc8b1b84a8192acc3cdd70ae05bdc4cb2...e486468edc1cd2facaf6dc392a3a052d35545d73,1,6,5,11,1,2010-07-06 03:08:42,2010-07-05 20:42:18
377d8f5dae9b066106c453cd3416cf72875232b1...e25b514675c9cbb4ba1d3ec1b95391da2a76a3a4,1,1,1,2,1,2010-07-06 14:29:37,2010-07-06 14:23:04
e25b514675c9cbb4ba1d3ec1b95391da2a76a3a4...48d8fdbce1e5ea43e1b10827cd2654d596061d89,2,31,2,33,3,2010-07-06 16:20:03,2010-07-06 16:20:03
e25b514675c9cbb4ba1d3ec1b95391da2a76a3a4...b0422a3a65227bc96ed6a597093cdfa40ecb0336,1,2,2,4,1,2010-07-06 15:50:59,2010-07-06 15:50:59
c6061f8036a1b11592c09741ad0fde9dd5335036...a3ca5c6b328f427345c88e957f982520b2ba2fe4,2,3,2,5,2,2010-07-06 16:48:36,2010-07-06 16:48:36
b0422a3a65227bc96ed6a597093cdfa40ecb0336...c616beb8e25a27fccbe04d89703e7f9a41e97cf4,1,55,0,55,1,2010-07-06 16:37:51,2010-07-06 16:37:51
7384d4d7cb5369b349cf0f577c19be7f018eff35...3fe08e5429622352481a6d3339148271f882fd0a,1,1,1,2,1,2010-07-06 17:00:51,2010-07-06 17:00:51
2944e796e589c71bb4c589ad25dcbedda9c25a2f...07cc7b450b96cb9b0118dd7d10788ac9512cffbb,1,3,6,9,4,2010-07-06 17:04:00,2010-07-06 17:04:00
2944e796e589c71bb4c589ad25dcbedda9c25a2f...d531ce99d6deea9a21fd332a483987bfc050a366,1,5,4,9,3,2010-07-06 16:53:30,2010-07-06 16:53:30
3eb59e746ccbc8bcc733063847fecf8c1453bbda...3d2b3ca6bc05e66f42fce66a80f9a2a0e0d204d3,1,8,3,11,2,2010-07-06 17:30:48,2010-07-06 17:30:48
aa3995d1b5d2e004f529f07d213da5c9b811967f...4798e64b1c66e332030b77cb136b98ba07b26366,11,334,28,362,42,2010-07-07 19:26:20,2010-07-07 19:26:20
4798e64b1c66e332030b77cb136b98ba07b26366...29b86d919d41fcb2a1d908c34645517a42a4b779,1,69,6,75,6,2010-07-07 20:08:53,2010-07-07 20:08:53
29b86d919d41fcb2a1d908c34645517a42a4b779...3e788cf58882dd173daee339444678ea963c8978,1,47,69,116,12,2010-07-07 20:41:35,2010-07-07 20:41:35
284036df90fa27a15838876b808750a5de6739fe...39e30d04bd74e0b626e87ef9775abf5aae73b644,1,2,0,2,2,2010-07-06 20:39:12,2010-07-06 20:39:12
284036df90fa27a15838876b808750a5de6739fe...c103884d09b9810a06b46a8b3e1af51f28a6c331,4,57,8,65,8,2010-07-06 20:11:56,2010-07-06 20:11:56
284036df90fa27a15838876b808750a5de6739fe...3040636830489f5788604957f7fca0499630b94f,1,1,1,2,1,2010-07-06 19:51:04,2010-07-06 19:51:04
ba8a5db089035b818bfaf652c7f0aa2e8a3d8fba...e3a60f43b336a4d16b8f86fa5aa8a159f773951f,1,12,12,24,3,2010-07-07 20:50:09,2010-07-07 20:50:09
77d6ff7f859e472a220f7dfaabc819e415f7c8df...544725a02b5875800dab4f81dfff53b31beb9247,1,3,1,4,1,2010-07-06 20:17:10,2010-07-06 20:17:10
e3a60f43b336a4d16b8f86fa5aa8a159f773951f...f17aefd598b403fe6f83f28861015f7362cf53aa,8,232,116,348,68,2010-07-08 02:35:26,2010-07-08 02:35:26
b03810c020022ee4208a886cb871a3064152d902...47170341084f47c9398f1002e0585cd10db9c7a2,2,90,3,93,6,2010-07-06 23:58:37,2010-07-06 23:58:37
47170341084f47c9398f1002e0585cd10db9c7a2...15fa0470fceb776872302584bd63ed6e8cc41614,1,1,2,3,1,2010-07-07 00:01:21,2010-07-07 00:01:21
15fa0470fceb776872302584bd63ed6e8cc41614...cc37c07bb561c5ad30e7b1a4fb68e88822dd13ec,1,4,1,5,1,2010-07-07 00:33:59,2010-07-07 00:33:59
544725a02b5875800dab4f81dfff53b31beb9247...39dbe97e667221be59a871607df30b99457ab3fc,5,88,2,90,7,2010-07-06 21:49:20,2010-07-06 21:49:20
ba745057e5a0d2b8f544869a4b21f31f22bbcce9...220e5e50a221f4777abb8f5ab66684dc9c284246,2,11,7,18,6,2010-07-07 22:08:16,2010-07-07 22:08:16
ba745057e5a0d2b8f544869a4b21f31f22bbcce9...7755d602c439050b519daf3a8012ab1411ccd9e5,1,2,2,4,1,2010-07-07 21:53:06,2010-07-07 21:53:06
cc37c07bb561c5ad30e7b1a4fb68e88822dd13ec...2ba9153e950c9a66e25f68105632437b040730c2,7,41,16,57,13,2010-07-07 02:16:40,2010-07-07 02:16:40
cc37c07bb561c5ad30e7b1a4fb68e88822dd13ec...62a6e478d619c6ce27cadec5d533ea207d9e0790,1,14,9,23,2,2010-07-07 01:12:17,2010-07-07 01:12:17
cca87c3a703e73af1dad8beb0c6fd8be44f098fb...74b36196e113483f568dddd1d722bbcbf138552d,1,4,2,6,2,2010-07-08 07:55:11,2010-07-08 07:55:11
74b36196e113483f568dddd1d722bbcbf138552d...c6a3e6caf2c3a086e282c8b94c330dd8d42e20fb,2,17,0,17,3,2010-07-08 07:55:42,2010-07-08 07:55:42
c6a3e6caf2c3a086e282c8b94c330dd8d42e20fb...31c9bf6b06eefd89a86507f2b1046c39f2c7e30a,1,31,0,31,1,2010-07-08 08:02:51,2010-07-08 08:02:51
31c9bf6b06eefd89a86507f2b1046c39f2c7e30a...9e5bbc39739e1a6df6430c3bc4b2a938959c5985,1,4,1,5,2,2010-07-08 08:41:46,2010-07-08 08:41:46
9e5bbc39739e1a6df6430c3bc4b2a938959c5985...0545efcdb234a6ba66938d4569afbbaa25619b40,2,16,0,16,2,2010-07-08 13:59:15,2010-07-08 13:59:15
0545efcdb234a6ba66938d4569afbbaa25619b40...9a9e88ad92d70969a2423de04bcf43502a9058ac,1,12,2,14,3,2010-07-08 14:10:41,2010-07-08 14:10:41
9a9e88ad92d70969a2423de04bcf43502a9058ac...fb85e8b40cabaa8b61b053674c7eb5e32f7315c5,3,3,3,6,3,2010-07-08 14:19:54,2010-07-08 12:37:47
4ba50ab28f4e7f6528b14fe717376c25152f5ca6...8242ebd35389109f42bc2514682d1254833d6601,1,8,4,12,4,2010-07-08 01:31:14,2010-07-08 00:01:34
8242ebd35389109f42bc2514682d1254833d6601...1329d93774dfa5154a7ddfcee22c4821e1c84d01,1,9,1,10,3,2010-07-08 01:31:14,2010-07-08 00:17:48
1329d93774dfa5154a7ddfcee22c4821e1c84d01...724228684e1bd1b9c476f662f4a259dbb7f1d5d0,1,4,1,5,4,2010-07-08 01:31:14,2010-07-08 01:07:54
724228684e1bd1b9c476f662f4a259dbb7f1d5d0...0bff6372d29c056b3ae636ec816c63d22603f3b4,1,5,1,6,2,2010-07-08 03:48:14,2010-07-08 03:48:14
0bff6372d29c056b3ae636ec816c63d22603f3b4...2675f2f625e67c96fb34a24a694456cb6a45d96e,1,8,1,9,1,2010-07-08 03:51:43,2010-07-08 03:51:43
2675f2f625e67c96fb34a24a694456cb6a45d96e...85b901c7030f106e31774cae146fe9c297694368,3,44,24,68,15,2010-07-08 04:01:53,2010-07-08 04:01:53
62a6e478d619c6ce27cadec5d533ea207d9e0790...e3a992d4a37c3f05b407faaaa6413a9508521c89,1,1,0,1,1,2010-07-07 02:19:31,2010-07-07 02:19:31
fb85e8b40cabaa8b61b053674c7eb5e32f7315c5...8de293a963047e2470b24f87c776528d4eba8cd6,1,2,2,4,2,2010-07-08 22:45:27,2010-07-08 22:45:27
8de293a963047e2470b24f87c776528d4eba8cd6...7a43996200f1cf1812b419a17c3f6f6d5c4467d7,1,1,0,1,1,2010-07-08 22:45:53,2010-07-08 22:45:53
fb85e8b40cabaa8b61b053674c7eb5e32f7315c5...b97a2c322ecc779fc826911067a0780ca87260af,1,20,0,20,1,2010-07-08 16:26:49,2010-07-08 16:26:49
fb85e8b40cabaa8b61b053674c7eb5e32f7315c5...62d7b02c1e8f25577a56da6d0017ee18a6759230,2,40,24,64,22,2010-07-08 16:09:05,2010-07-08 16:09:05
85b901c7030f106e31774cae146fe9c297694368...ec28a6971bf0b780548b7417bac98fe4b669b542,2,36,5,41,5,2010-07-08 05:25:09,2010-07-08 05:25:09
85b901c7030f106e31774cae146fe9c297694368...5a543ad37c001c03fd4c4d6686942aa7bb0c4083,3,125,62,187,7,2010-07-08 04:27:15,2010-07-08 04:27:15
5a543ad37c001c03fd4c4d6686942aa7bb0c4083...af2c70984e70f94ac7b13a7d79e2ccebe9cc999a,1,1,1,2,1,2010-07-08 04:47:24,2010-07-08 04:47:24
af2c70984e70f94ac7b13a7d79e2ccebe9cc999a...39dd4159501d4eaeb841679f835a5a42bf4fc407,1,12,70,82,1,2010-07-08 04:56:11,2010-07-07 16:00:43
39dd4159501d4eaeb841679f835a5a42bf4fc407...55bd8f78f40123b00a730b9e907e32f8c23ecada,1,16,15,31,1,2010-07-08 04:57:33,2010-07-05 20:01:40
b8d9824bc02c04db72204869266a1a8421672d6e...d62e21a084b61d1a73360eefc069bdd7857c0e88,1,1,1,2,1,2010-07-07 03:51:50,2010-07-07 03:51:50
d62e21a084b61d1a73360eefc069bdd7857c0e88...95fa51a1df4e5965d467b6afa244520288fbc35b,33,89,73,162,62,2010-07-07 04:30:17,2010-07-06 22:17:39
95fa51a1df4e5965d467b6afa244520288fbc35b...d6f971e2d4079c371477179d2abbe1f6da0fdc69,1,3,1,4,1,2010-07-07 04:30:31,2010-07-07 04:23:34
d6f971e2d4079c371477179d2abbe1f6da0fdc69...e7cb7ecb5c8d17c622ca1f701a3ba31d04ff5c1a,1,21,0,21,4,2010-07-07 04:53:13,2010-07-07 04:53:13
e7cb7ecb5c8d17c622ca1f701a3ba31d04ff5c1a...13c6875815fdcb2d677c76905819d99a99a2d5d3,33,73,89,162,61,2010-07-07 05:22:33,2010-07-07 05:21:45
13c6875815fdcb2d677c76905819d99a99a2d5d3...e63f90f9826898874ef911eac45bc6c32e8abbb8,1,3,3,6,1,2010-07-07 12:30:24,2010-07-07 12:30:24
ad0316a434dd3f7195cd72d70800a56e29154c8a...c68695bad937764a97d47052eff8e4555687e0dc,5,104,8,112,14,2010-07-08 18:41:49,2010-07-08 18:41:49
ad0316a434dd3f7195cd72d70800a56e29154c8a...5f9b5ff8d4b627b4d9d630d50dd2d06f76b54a02,1,3,1,4,2,2010-07-08 17:21:44,2010-07-08 17:21:44
5f9b5ff8d4b627b4d9d630d50dd2d06f76b54a02...3e2f49e0048f234540fd18bc2301dba7247f2b5f,1,2,2,4,2,2010-07-08 18:20:58,2010-07-08 18:20:58
3e2f49e0048f234540fd18bc2301dba7247f2b5f...d133a9d6a381856f5f93c6f7d83f6d3794d5f1db,1,19,4,23,4,2010-07-08 18:31:27,2010-07-08 18:31:27
ce24481ba5037fd310cce0f466f6f13cf9bd0412...a84e4a13eb4e9ce2cce7a9509dea60337676db37,1,3,0,3,1,2010-07-08 06:30:53,2010-07-08 06:30:53
e63f90f9826898874ef911eac45bc6c32e8abbb8...eba75c7fd1e62663e5bee2c66912c6a7efed24ac,1,4,4,8,2,2010-07-07 18:26:26,2010-07-07 18:26:26
eba75c7fd1e62663e5bee2c66912c6a7efed24ac...4e073bee84718509e517cd1746c7ff6bbd50f293,1,6,1,7,1,2010-07-07 19:03:12,2010-07-07 19:03:12
e63f90f9826898874ef911eac45bc6c32e8abbb8...08a30732d9206f98479cc0ff00ff9640d6c6407b,4,71,46,117,12,2010-07-07 14:06:04,2010-07-07 14:06:04
08a30732d9206f98479cc0ff00ff9640d6c6407b...1dcdf8305b51b32522ad4fad823a5a284e06c5e0,5,33,11,44,14,2010-07-07 16:18:57,2010-07-07 16:18:57
1dcdf8305b51b32522ad4fad823a5a284e06c5e0...4bccb4792c8649b965fde46bb2c41a825526729f,2,46,15,61,2,2010-07-07 17:55:12,2010-07-07 17:55:12
4bccb4792c8649b965fde46bb2c41a825526729f...13a235bcf39a2610f0314a701ceb75dd6db2aeb8,1,8,3,11,3,2010-07-07 18:53:12,2010-07-07 18:53:12
d133a9d6a381856f5f93c6f7d83f6d3794d5f1db...b5a71dc09db0ea0b04a340f041e485dade844314,1,5,5,10,5,2010-07-08 19:56:39,2010-07-08 19:56:39
7ee4478ea947cea8db5c165f4acf04a666b1098c...16d3dc355ceb24dab5f745ae63ab6650b15594cc,1,1,1,2,1,2010-07-07 19:04:32,2010-07-07 19:04:32
bfeca059e67f29aa011abafd27f7716917ee556f...aa5860c54f21083b2a132076b4bca9c250d6ee0f,1,1,1,2,1,2010-07-11 04:11:38,2010-07-11 04:11:38
aa5860c54f21083b2a132076b4bca9c250d6ee0f...8a15a86dad2ab002d11d052cdce38eabe2547e9b,1,2,1,3,2,2010-07-12 03:05:23,2010-07-12 03:05:23
86fdb792ac61de0abde8337dc5d06f467d396347...65fd137863da72eb135040e3944bf8d1d67ac787,3,51,16,67,16,2010-07-09 15:20:26,2010-07-09 15:20:26
86fdb792ac61de0abde8337dc5d06f467d396347...0e1a5490be64bb82bab5c223bdbd30f38eaa489f,1,1,1,2,1,2010-07-09 14:02:36,2010-07-09 14:02:36
16d3dc355ceb24dab5f745ae63ab6650b15594cc...a5a05a8baea7123299657b5b40cdfb70b40e4c3a,2,44,4,48,4,2010-07-07 21:36:23,2010-07-07 21:36:23
16d3dc355ceb24dab5f745ae63ab6650b15594cc...4ebbbc026dc34df7ba6fb0a90565b058ea423ca7,1,9,17,26,9,2010-07-07 20:12:47,2010-07-07 20:12:16
ae235e896a123d20d51d50de6d82f23fcc125a6f...61ca3b01d4be749314d88f2d506755cf37146713,1,1,2,3,2,2010-07-12 03:13:20,2010-07-12 03:13:20
a9fa60f04ca3511e4940d31ea2fa58119d069c18...5f88b9afffdd887f80a6def411a60503dae5373f,1,3,2,5,2,2010-07-09 17:07:39,2010-07-09 17:07:03
61ca3b01d4be749314d88f2d506755cf37146713...399315f65aef0af385f32a28ad6313915678e626,1,37,0,37,1,2010-07-12 14:38:57,2010-07-12 14:38:57
61ca3b01d4be749314d88f2d506755cf37146713...97a65a10cdb67ba8909e8b1248ba745bbdcd6c57,2,17,1,18,4,2010-07-12 12:19:03,2010-07-12 12:19:03
97a65a10cdb67ba8909e8b1248ba745bbdcd6c57...5eaa7eaf1eaac5fed0506ed024e742e6cda3bcec,4,32,8,40,9,2010-07-12 12:54:37,2010-07-12 12:54:37
5eaa7eaf1eaac5fed0506ed024e742e6cda3bcec...013860f4c33afad581609070ffb5fcf40fcc21f3,1,2,2,4,2,2010-07-12 13:13:23,2010-07-12 13:13:23
013860f4c33afad581609070ffb5fcf40fcc21f3...e2212f4e228f6cc7c289cc029724af811c98b184,3,9,10,19,5,2010-07-12 13:13:38,2010-07-12 13:13:38
e2212f4e228f6cc7c289cc029724af811c98b184...9b157bfd85eff3c18d10f1814d296ac12aaf193b,1,8,4,12,3,2010-07-12 16:00:55,2010-07-12 16:00:55
5f88b9afffdd887f80a6def411a60503dae5373f...f1d731cb65503dd8a0d3ae0629941ecdb556c2cc,2,8,2,10,3,2010-07-09 20:12:06,2010-07-09 20:12:06
5f88b9afffdd887f80a6def411a60503dae5373f...031ef119144ab065b4d3300beed79554e00f2b5a,1,10,4,14,4,2010-07-09 19:52:09,2010-07-09 19:52:09
5dd429d262a4527d6e727d9b905dfe75405ffa66...93137d07918025dae08562e8832b59c143b76beb,3,31,7,38,6,2010-07-12 16:37:27,2010-07-12 16:37:27
5dd429d262a4527d6e727d9b905dfe75405ffa66...1e15c43038da0cf0faef75ee9377e5d3c58e4509,1,1,1,2,1,2010-07-12 16:18:37,2010-07-12 16:18:37
26e9a4d23e8acbc32c6522d5655c0c51e2bb97bc...2619338cac22f78a4bb27744955d18b14bc97d4b,2,2,2,4,2,2010-07-09 21:49:04,2010-07-09 21:47:44
05e03b58050b7afbb2a07936d553dd47d4a90f64...71b32024c4164608f866326400e1e7d92a95f52e,1,1,1,2,1,2010-07-12 16:38:02,2010-07-12 16:38:02
1e15c43038da0cf0faef75ee9377e5d3c58e4509...275fb3f0567e7d4b1b05b5002fdf33d12f6098e2,2,15,0,15,2,2010-07-12 17:06:16,2010-07-12 17:06:16
275fb3f0567e7d4b1b05b5002fdf33d12f6098e2...28418f3ea2f0534baebeb182f168748de65d0819,3,29,7,36,6,2010-07-12 17:17:34,2010-07-12 17:17:34
2619338cac22f78a4bb27744955d18b14bc97d4b...596cfac995b22284196b7e247c8613aee7827679,1,4,4,8,4,2010-07-10 17:11:33,2010-07-10 17:11:33
596cfac995b22284196b7e247c8613aee7827679...f674d14f6ec2d3737badbdd252cd1e85df12ac73,2,86,7,93,8,2010-07-11 03:17:05,2010-07-11 03:17:05
46e6ac0a091ae65206a7f0e786bdf47ae5a00930...c6f48e0cd33ba3f6eea5b54397dac89544cfda6d,3,39,5,44,7,2010-07-12 18:20:53,2010-07-12 18:20:53
c6f48e0cd33ba3f6eea5b54397dac89544cfda6d...e1c000d2637ea66283b6c23e282dc5df030955df,1,2,1,3,2,2010-07-12 19:25:36,2010-07-12 19:25:36
f674d14f6ec2d3737badbdd252cd1e85df12ac73...adb206fcefb10bb2f7bc83e45aae8530bd49faca,2,28,6,34,6,2010-07-11 12:18:50,2010-07-11 12:18:50
adb206fcefb10bb2f7bc83e45aae8530bd49faca...71d51187265f1672a52e2066f879e79e1766c361,2,8,6,14,3,2010-07-11 21:04:30,2010-07-11 21:04:30
e1c000d2637ea66283b6c23e282dc5df030955df...e2ade1ec3f4ad1e3f6e80243fb110131c8fa495e,1,4,0,4,2,2010-07-12 22:04:34,2010-07-12 22:04:34
e2ade1ec3f4ad1e3f6e80243fb110131c8fa495e...0139397922d08e123bebd9c3046547f939ef0ac4,2,13,2,15,7,2010-07-12 23:02:44,2010-07-12 23:02:44
e1c000d2637ea66283b6c23e282dc5df030955df...a41b2a56a30451b72897be7a4bada25f95c86881,2,2,1,3,2,2010-07-12 19:57:37,2010-07-12 16:43:13
a41b2a56a30451b72897be7a4bada25f95c86881...7ea18a86ad39ac68d23d07321c79f20f4a0c24bc,2,5,4,9,4,2010-07-12 19:57:37,2010-07-12 16:53:54
7ea18a86ad39ac68d23d07321c79f20f4a0c24bc...4676c5ac07fe44ae985cfd7fbb0c68c0f90f5f9f,1,6,8,14,4,2010-07-12 19:57:37,2010-07-12 18:27:37
4676c5ac07fe44ae985cfd7fbb0c68c0f90f5f9f...bfb750b83e00afe7edf0abead1b5c0f932930b11,1,10,0,10,3,2010-07-12 19:57:37,2010-07-12 18:29:32
bfb750b83e00afe7edf0abead1b5c0f932930b11...bf391f294954076a7bc8b87bdfacd1a779d1d134,1,4,5,9,2,2010-07-12 19:57:37,2010-07-12 18:37:04
bf391f294954076a7bc8b87bdfacd1a779d1d134...683dc7c0f41109b7c44cd0d54e0ee4f0362a29d6,1,6,5,11,2,2010-07-12 19:57:37,2010-07-12 18:56:20
683dc7c0f41109b7c44cd0d54e0ee4f0362a29d6...b2420ca55ff787d20a848e8b7b7d301fc28bd446,2,16,84,100,11,2010-07-12 19:57:38,2010-07-12 19:25:55
b2420ca55ff787d20a848e8b7b7d301fc28bd446...77622da34748e602c76923556de31fbaffc7c959,2,0,17,17,2,2010-07-12 19:57:38,2010-07-12 19:45:10
77622da34748e602c76923556de31fbaffc7c959...6aff5cd70c88daa99bff4e603afae6065d70d7f9,1,2,2,4,1,2010-07-12 19:57:38,2010-07-12 19:45:37
0fdde00115c7b4c5c1c2da5238f0d10a74caa20e...19f12a3285c415f8084714e6699d3b87bfd0a581,8,19,3,22,11,2010-07-12 23:07:32,2010-07-12 23:07:32
6aff5cd70c88daa99bff4e603afae6065d70d7f9...6cb09e33a267816d5a1c2ae98c30d1bdb3ed6d7d,5,117,33,150,32,2010-07-12 21:48:09,2010-07-12 21:48:09
6aff5cd70c88daa99bff4e603afae6065d70d7f9...27e684c097f332be6252f4375dd7c9659aead0e4,2,33,1,34,2,2010-07-12 20:09:20,2010-07-12 19:51:48
27e684c097f332be6252f4375dd7c9659aead0e4...7e6a0635292857cb303d147504be6a90b4cbf5e7,3,49,11,60,14,2010-07-12 21:06:44,2010-07-12 21:06:44
09ab7568183a45448dd8864a6a4ba340f042c4b2...5371a5e44870d111c730371b9b8aaaec36b27b1d,14,485,208,693,90,2010-07-16 08:49:15,2010-07-16 08:49:15
5371a5e44870d111c730371b9b8aaaec36b27b1d...cde8c8bec7c8ce76cfb60d8ee4cd7c1818be445f,8,104,85,189,26,2010-07-16 10:47:26,2010-07-16 10:47:26
cde8c8bec7c8ce76cfb60d8ee4cd7c1818be445f...5ca4354bd66cbd1b60fef2b7a612beb57faf746e,2,10,3,13,2,2010-07-16 10:57:44,2010-07-16 10:57:44
5ca4354bd66cbd1b60fef2b7a612beb57faf746e...94fab2e73fcdf50033b245ba7a9dd0174f253c27,15,85,71,156,32,2010-07-16 12:09:10,2010-07-16 12:09:10
09ab7568183a45448dd8864a6a4ba340f042c4b2...70fcc18300c923aec7020aab354b64619cb18278,5,40,18,58,18,2010-07-13 02:12:57,2010-07-13 02:12:57
70fcc18300c923aec7020aab354b64619cb18278...8ec52793532033d3722cb934ad31a05aaa23871c,2,12,0,12,2,2010-07-13 04:55:22,2010-07-13 04:55:22
8ec52793532033d3722cb934ad31a05aaa23871c...69251fae55f0eb264bc3115570b16f7a104fa831,1,4,2,6,1,2010-07-13 04:56:01,2010-07-13 04:56:01
69251fae55f0eb264bc3115570b16f7a104fa831...453398b8b2d28b2d84f7c62c19fa68a56f9e2af6,6,65,30,95,14,2010-07-13 04:56:08,2010-07-13 04:56:08
453398b8b2d28b2d84f7c62c19fa68a56f9e2af6...1f3ff9a1c76643205a5fca01a44158b79bfa6eba,3,1724,1709,3433,9,2010-07-13 05:03:15,2010-07-13 05:03:15
1f3ff9a1c76643205a5fca01a44158b79bfa6eba...62737ff9c02edc92182e4781d5edf0d85a5e5b00,2,44,12,56,11,2010-07-13 05:21:08,2010-07-13 05:21:08
62737ff9c02edc92182e4781d5edf0d85a5e5b00...22653fdefeea36317cbe2557b9cb039e64512ce6,1,4,2,6,2,2010-07-13 05:35:14,2010-07-13 05:35:14
22653fdefeea36317cbe2557b9cb039e64512ce6...130f70d3d4113e5d5f04433072dfc3cda560bb35,3,13,81,94,8,2010-07-13 18:50:53,2010-07-13 18:50:53
130f70d3d4113e5d5f04433072dfc3cda560bb35...fb4b8a3ec71f98ec03dd87336355bbc72cc3f202,2,7,1,8,6,2010-07-13 20:42:41,2010-07-13 20:42:41
fb4b8a3ec71f98ec03dd87336355bbc72cc3f202...164efbd0a2138d1612154e857caf90843ed3d697,2,35,1,36,2,2010-07-13 21:02:31,2010-07-13 21:02:31
3895385c868f0594b689d475b45053e4ba5da9c7...5d563d97fee856e23318b76abcb8f08089cd11c0,3,91,1,92,3,2010-07-12 21:50:26,2010-07-12 21:50:26
5d563d97fee856e23318b76abcb8f08089cd11c0...507ae132d074c86e792da7303c13f2699b361abd,4,124,96,220,4,2010-07-12 21:53:02,2010-07-12 21:53:02
507ae132d074c86e792da7303c13f2699b361abd...350d92f7f7e3830fde2d67db3ca1c5be7d90d3ce,2,10,17,27,9,2010-07-12 22:28:22,2010-07-12 21:05:58
350d92f7f7e3830fde2d67db3ca1c5be7d90d3ce...79e1244f06335c5001d83a911c528f33fe09a064,2,6,37,43,10,2010-07-12 22:28:22,2010-07-12 21:31:50
79e1244f06335c5001d83a911c528f33fe09a064...6c160f9a827a787eadbcdc203a064eac63919bb0,1,37,34,71,3,2010-07-12 22:28:22,2010-07-12 22:27:40
7e6a0635292857cb303d147504be6a90b4cbf5e7...f4ef1cf1c789c3c5039f1e9fc15393b1e2f3e40a,1,9,2,11,1,2010-07-12 21:39:01,2010-07-12 21:39:01
7e6a0635292857cb303d147504be6a90b4cbf5e7...746e1e80db9451d91625c47cfb5d36d92ca4e9c8,2,2,2,4,2,2010-07-12 21:38:42,2010-07-12 21:38:42
c2f1a2318d65853da102da5dbe0cfcec5850da35...326babfe6dc5180aef37ab9139e7dc32412c00f5,2,2,2,4,2,2010-07-16 12:36:26,2010-07-16 12:36:26
164efbd0a2138d1612154e857caf90843ed3d697...3f0ab38bec8a51c287f57d5445759ac8ee52a85b,4,71,18,89,20,2010-07-13 21:45:22,2010-07-13 21:45:22
164efbd0a2138d1612154e857caf90843ed3d697...cb91b25d3d745956adc6b05d68dd6ea1ef208266,1,2,1,3,2,2010-07-13 21:11:46,2010-07-13 21:11:11
3e35041c3c59651e284ec309abceba74379a05ca...d0ef8385751cc5e96b03ea4e7ae7ebc80003d60d,2,7,7,14,7,2010-07-12 23:33:02,2010-07-12 23:33:02
746e1e80db9451d91625c47cfb5d36d92ca4e9c8...4226a40814315c804183c96c95623eb3d0d25fec,1,1,1,2,1,2010-07-12 22:36:59,2010-07-12 22:36:59
326babfe6dc5180aef37ab9139e7dc32412c00f5...5e2fa26dd7c429b4747d462426c32a82e304f1d7,3,86,47,133,23,2010-07-16 16:45:59,2010-07-16 16:45:59
326babfe6dc5180aef37ab9139e7dc32412c00f5...d9a83e2d4d834e3ec05746469d6491ab3c3b261c,1,1,1,2,1,2010-07-16 13:42:35,2010-07-16 13:42:35
d9a83e2d4d834e3ec05746469d6491ab3c3b261c...8a91bd65fe74e2427f3e8116e75731431c1f55d3,3,66,9,75,16,2010-07-16 14:00:01,2010-07-16 14:00:01
326babfe6dc5180aef37ab9139e7dc32412c00f5...3a044ab7e9966c05fd5984b4e6438e1e38a4099e,1,11,2,13,3,2010-07-16 13:28:21,2010-07-16 13:28:21
3a044ab7e9966c05fd5984b4e6438e1e38a4099e...e61689c929bd4d4e87bad357a68fcea59c6bcdad,5,24,4,28,10,2010-07-16 13:50:09,2010-07-16 13:50:09
c204e2795342ed1364867b2e63f2bed14d7aecab...50b2c5f9966f53d5c06e1a299c42bbf27458364b,1,9,0,9,1,2010-07-13 22:12:45,2010-07-13 22:12:45
c204e2795342ed1364867b2e63f2bed14d7aecab...9fe16fe586592968d90d5ccbd27358cdda28dbf0,1,1,1,2,1,2010-07-13 21:50:19,2010-07-13 21:50:19
9fe16fe586592968d90d5ccbd27358cdda28dbf0...ae79e7aee9d7e1117296b688e0b0d25d02a1d463,5,25,5,30,8,2010-07-13 22:02:44,2010-07-13 22:02:04
2d8137ae8e9b9a015eca47d0799291e7835310e4...ce25e4589e76da7d3702adad7546d36cdb1cd012,3,4,7,11,7,2010-07-16 14:23:25,2010-07-16 14:23:25
e61689c929bd4d4e87bad357a68fcea59c6bcdad...fc03c2290fe74e42aa81c5367329bfa173f7498c,3,2,2,4,2,2010-07-16 14:16:37,2010-07-16 14:16:37
14d8820c8e60b8d9c5578cba84f06512966c88b5...d4df0245db6757385e0ac6ec32991471c77a38d5,1,4,1,5,3,2010-07-13 22:21:37,2010-07-13 22:21:37
ae79e7aee9d7e1117296b688e0b0d25d02a1d463...3834e8d0355ba9a207547e2955558846a6e238ad,4,1,4,5,4,2010-07-13 22:16:26,2010-07-13 22:16:26
47abd4eeb2b589f823e17c56f83abcd50e5efd6b...fc1707aa992d39d2a65ee070c5e55b559f31061c,6,104,47,151,16,2010-07-19 07:39:16,2010-07-19 07:39:16
47abd4eeb2b589f823e17c56f83abcd50e5efd6b...76b822f6af86934aefd1fa5c7cb9f71c1d7e7056,6,23,5,28,12,2010-07-16 18:42:04,2010-07-16 18:42:04
6043d0c15525fa785d2251b9365788e741b93352...15697cf21678ddac97d22f0383bade81fdc5c076,2,11,5,16,5,2010-07-16 14:32:00,2010-07-16 14:32:00
15697cf21678ddac97d22f0383bade81fdc5c076...a911b2cb077349d2b1ade6e63cf3f74ab62a140a,4,24,42,66,7,2010-07-16 14:36:22,2010-07-16 14:36:22
493ef0e11f5ff2ec201f02fa2614217da8ac5d42...2ac10b237e3681af855096b94a5f4d7068370ad7,5,35,1,36,5,2010-07-16 14:42:53,2010-07-16 14:42:53
6abe760e1b6d18d1d58ec15b7ff591e619a8cdbe...13708352c28278ad45f05b4312113e3ccb0d3d80,2,19,19,38,7,2010-07-14 00:22:25,2010-07-14 00:22:25
6abe760e1b6d18d1d58ec15b7ff591e619a8cdbe...eccb65149d70cb7a4d037780d78b1d3999afa51a,1,4,0,4,4,2010-07-14 00:07:33,2010-07-14 00:07:33
e598a0c2b2495673e58de4a9cc1b39a84628a99a...d0d79d0fbf732f81bf0268be757a03af8864f286,3,3,4,7,4,2010-07-19 13:40:15,2010-07-19 13:40:15
90a40275dbc6792029ba2d10fff02f6cfcdfbfdf...7ba534ce17ad66a19c0221f0dabbdfe64db9bd76,2,27,9,36,6,2010-07-16 19:22:36,2010-07-16 19:22:36
7ba534ce17ad66a19c0221f0dabbdfe64db9bd76...09c6b0568e6f02925282a2b888376e541ed70d73,1,1,1,2,1,2010-07-16 19:23:34,2010-07-16 19:23:34
09c6b0568e6f02925282a2b888376e541ed70d73...e280809c71d8faedd35c30161caa2fb7621dbb4f,1,8,4,12,4,2010-07-16 19:24:56,2010-07-16 19:24:56
22f4c0b1b7b5fbf1fa630ca9a3391385d9da4dd5...dc54ce28609bf39518417b9c60cc2f26c8eb460b,2,3,3,6,3,2010-07-16 18:39:05,2010-07-16 18:39:05
dc54ce28609bf39518417b9c60cc2f26c8eb460b...6d47fb7ea523263597d916b722f09e5924b9689a,1,6,3,9,1,2010-07-16 18:39:14,2010-07-16 18:39:14
a911b2cb077349d2b1ade6e63cf3f74ab62a140a...3cf5e82961f3285a5506a34ac0092982b1d9c3ec,1,2,2,4,2,2010-07-16 14:44:27,2010-07-16 14:44:27
08aedb04ca4ca8e50788c14dcd95359e158d3889...2212743ad5f23ab5d692476dfde989bd88d3ce3a,4,28,4,32,5,2010-07-16 16:51:01,2010-07-16 16:51:01
3bb07b918716da9a2c5b5bf25a45397d59cd57a4...e953d1482e33dfc75016c1b8b1389b864e82b1d2,1,6,2,8,4,2010-07-14 02:45:22,2010-07-14 02:45:22
e953d1482e33dfc75016c1b8b1389b864e82b1d2...2b2354066a3faafa1b5bf6ba9f82c2319a85b039,2,0,80,80,6,2010-07-14 03:21:19,2010-07-13 21:40:00
2b2354066a3faafa1b5bf6ba9f82c2319a85b039...c460e969acda78bf3ee11d0f6c692fd2d0f50ae6,1,15,36,51,8,2010-07-14 03:21:20,2010-07-14 01:28:11
c460e969acda78bf3ee11d0f6c692fd2d0f50ae6...c8992ae056a0cb8804a2443c974aabd90b5e8e02,1,2,10,12,2,2010-07-14 03:21:20,2010-07-14 03:10:27
c8992ae056a0cb8804a2443c974aabd90b5e8e02...f4266aedd22c75d64c0250ecf62d21bcdfd31766,1,1,0,1,1,2010-07-14 03:21:20,2010-07-14 03:16:48
d0d79d0fbf732f81bf0268be757a03af8864f286...4378ad93d13a8a7cffc3e7dc2427a88a5e2ae499,1,1,1,2,1,2010-07-19 14:32:40,2010-07-19 14:32:40
4378ad93d13a8a7cffc3e7dc2427a88a5e2ae499...e3fe9ea6a0e8f1b603c283b47d387a4296b48181,1,17,8,25,4,2010-07-19 14:33:30,2010-07-19 14:33:30
d0d79d0fbf732f81bf0268be757a03af8864f286...f51a4d0669bf413d34e93c9a1c792f94edfdd757,17,176,171,347,68,2010-07-19 13:56:24,2010-07-19 13:56:24
f51a4d0669bf413d34e93c9a1c792f94edfdd757...62c0c861b2a00633d9e5952b1ecb35c75c3c2bf1,1,3,3,6,1,2010-07-19 14:29:51,2010-07-19 14:29:51
ddaaf870cbb15ee4eca1012fb6ce1d700d2df21c...c086fea7b18ab655e39d38739a92b8e20c35b10b,1,1,1,2,1,2010-07-16 19:29:06,2010-07-16 19:29:06
c086fea7b18ab655e39d38739a92b8e20c35b10b...15db784238ae49b0fc9581bb2aeda7333590ae6c,2,2,4,6,2,2010-07-16 19:42:51,2010-07-16 19:29:36
15db784238ae49b0fc9581bb2aeda7333590ae6c...5a2c3aa7ee5ed55b707b0ef2fa60ac320333debd,2,15,3,18,7,2010-07-16 19:42:51,2010-07-16 19:42:28
5a2c3aa7ee5ed55b707b0ef2fa60ac320333debd...8e595ca4eb864855e45e8bcd76c1157956480d51,1,1,1,2,1,2010-07-16 19:48:17,2010-07-16 19:48:17
8e595ca4eb864855e45e8bcd76c1157956480d51...74a15ef9952aa22910bef9f92115b5fd6e07024f,4,9,3,12,4,2010-07-16 19:50:58,2010-07-16 19:50:58
74a15ef9952aa22910bef9f92115b5fd6e07024f...fead64cbc7d1410b372303d7135015dafe47f39f,1,1,1,2,1,2010-07-16 19:57:49,2010-07-16 19:57:49
fead64cbc7d1410b372303d7135015dafe47f39f...1feb386bc1d2e74f0603360bae643a3b2f1e2140,1,3,1,4,1,2010-07-16 20:51:23,2010-07-16 20:51:23
1feb386bc1d2e74f0603360bae643a3b2f1e2140...3b337bd0d310373e343d01c3fcf748d1d322407b,1,1,1,2,1,2010-07-16 22:12:23,2010-07-16 22:12:23
788f3fe47215c423f275ec539e4eaefdb7546a92...b43feb002f8f79e2307d2c2358b7e2e5da1bd6cb,2,4,2,6,2,2010-07-16 19:28:10,2010-07-16 19:27:25
6d47fb7ea523263597d916b722f09e5924b9689a...38eb41bf4a7ab62ac988254607b356e668d92332,1,3,3,6,2,2010-07-16 19:06:20,2010-07-16 19:06:20
8b4b1d51a569bab2fb2dddfd6fd7052595ed4942...8efb5918eba2f99e4e0f5d567e0afacabc8eed1d,3,12,5,17,6,2010-07-16 15:05:59,2010-07-16 15:05:59
f4266aedd22c75d64c0250ecf62d21bcdfd31766...2197e24460e8c73aaf0cf52de1b3f4027d3f9a6b,5,180,69,249,21,2010-07-14 17:28:38,2010-07-14 17:28:38
2197e24460e8c73aaf0cf52de1b3f4027d3f9a6b...7e40a057c7521e0da00a81eacd5b561adb09c6d7,1,18,0,18,3,2010-07-15 22:50:12,2010-07-15 22:50:12
7e40a057c7521e0da00a81eacd5b561adb09c6d7...ccb3b9d1c09424899893cf7deb5c97f02290c5ff,1,2,0,2,2,2010-07-15 22:50:26,2010-07-15 22:50:26
f4266aedd22c75d64c0250ecf62d21bcdfd31766...f09d13a3c88065340b0879a1c2a5a15197a82dd2,9,1856,1773,3629,17,2010-07-14 17:01:31,2010-07-14 17:01:31
f4266aedd22c75d64c0250ecf62d21bcdfd31766...94232e7a59528b2e1cf747028b9f91175b408345,1,6,0,6,1,2010-07-14 14:58:25,2010-07-14 14:58:25
3b337bd0d310373e343d01c3fcf748d1d322407b...671778afa957f14a78214b6c426237e899c2ed14,1,1,1,2,1,2010-07-19 19:36:12,2010-07-19 19:36:12
671778afa957f14a78214b6c426237e899c2ed14...4b50326dbcafb876dacfcaeac13e4a50df345f4e,3,98,44,142,11,2010-07-19 19:37:19,2010-07-19 19:37:19
3b337bd0d310373e343d01c3fcf748d1d322407b...2d0ed7733a13646d9f644aac0adcdccbfbf6ce1a,1,5,0,5,1,2010-07-16 23:21:35,2010-07-16 23:21:35
2d0ed7733a13646d9f644aac0adcdccbfbf6ce1a...f8489f4b0cd04756fae3786975441fb4aa8a70d9,5,91,70,161,14,2010-07-17 16:38:48,2010-07-17 16:38:48
f8489f4b0cd04756fae3786975441fb4aa8a70d9...b7c9a9fc576758ef6e7095ec0fbd2def0deb9b5b,31,105,96,201,94,2010-07-17 18:33:17,2010-07-17 18:33:17
b7c9a9fc576758ef6e7095ec0fbd2def0deb9b5b...daf8c0fbd09f5730adb7511b882c1a5ba671eb08,31,96,105,201,94,2010-07-17 20:07:38,2010-07-17 20:07:38
daf8c0fbd09f5730adb7511b882c1a5ba671eb08...72f2eb24d5f27717b239789e0ad1011407a44363,14,17,25,42,19,2010-07-18 02:11:21,2010-07-18 02:11:21
72f2eb24d5f27717b239789e0ad1011407a44363...867b9c16f10c6b86da89c862902662b70cf61f38,3,8,14,22,8,2010-07-18 15:14:32,2010-07-18 15:14:32
867b9c16f10c6b86da89c862902662b70cf61f38...7f9bd44d4b97c8aba7ba0d48dc15964f69aadb5b,2,90,17,107,9,2010-07-18 15:14:57,2010-07-18 15:14:57
7f9bd44d4b97c8aba7ba0d48dc15964f69aadb5b...94af9c42e4258ec900eaa46c7a544fa38fe2994f,3,20,2,22,3,2010-07-18 15:21:48,2010-07-18 15:21:48
94af9c42e4258ec900eaa46c7a544fa38fe2994f...db607d1f2219becc6481861a4b2910ec30aca914,1,3,5,8,4,2010-07-18 16:53:07,2010-07-18 16:53:07
db607d1f2219becc6481861a4b2910ec30aca914...29a0cb522e5de80f2874424dae7989803b35cfe2,5,38,10,48,5,2010-07-18 16:53:40,2010-07-18 16:53:40
29a0cb522e5de80f2874424dae7989803b35cfe2...7fc85d6c80db5edd5c84d4a265c48499f291c237,1,1745,1745,3490,1,2010-07-18 16:54:45,2010-07-18 16:54:45
7fc85d6c80db5edd5c84d4a265c48499f291c237...46542f495c58da5e87b44c0d736b5cb88619fd8e,18,47,99,146,24,2010-07-18 17:34:16,2010-07-18 17:34:16
46542f495c58da5e87b44c0d736b5cb88619fd8e...3ec88b0c0f79c24a305f59c414e98a2bcafcc0cc,1,75,0,75,1,2010-07-18 17:41:20,2010-07-18 17:41:20
3ec88b0c0f79c24a305f59c414e98a2bcafcc0cc...528ad7a41a490d487b2fc6774ee796ab877f79ea,1,2,2,4,2,2010-07-18 18:18:33,2010-07-18 18:18:33
8efb5918eba2f99e4e0f5d567e0afacabc8eed1d...4882710934ace38610e936792bbd638dea7c8e91,2,78,72,150,4,2010-07-16 16:28:26,2010-07-16 16:28:26
4882710934ace38610e936792bbd638dea7c8e91...2ae0976481dd332dcfb2b022c4a8bba994b6cde5,1,1,1,2,1,2010-07-16 16:30:05,2010-07-16 16:30:05
2ae0976481dd332dcfb2b022c4a8bba994b6cde5...47261779b886fd327530126f2a173213377f2c21,7,111,20,131,23,2010-07-16 16:30:37,2010-07-16 16:30:37
8efb5918eba2f99e4e0f5d567e0afacabc8eed1d...44e3741116d118fc9fc5c82b10aacc07fb713c76,2,21,12,33,11,2010-07-16 15:24:58,2010-07-16 15:24:58
44e3741116d118fc9fc5c82b10aacc07fb713c76...86c01b838c12b4ca7f794b0df2a57e3a00315838,1,2,2,4,2,2010-07-16 15:46:03,2010-07-16 15:46:03
86c01b838c12b4ca7f794b0df2a57e3a00315838...2ea2bb00d639684f6ec40d690f4b0147b4b7eb8c,2,12,12,24,9,2010-07-16 15:49:40,2010-07-16 15:49:40
f26c497470e9601a5332e62510c34e4361fc0ba6...87d061f8e2066a0e8801854ea6daff30db5cc263,1,1,1,2,1,2010-07-15 23:02:58,2010-07-15 23:02:58
f43702ccfdccddf6e566d4ec3551caef8bc6c1ed...6cebdef81db7bc275ede9c30bf1d712e86b901ef,1,2,1,3,1,2010-07-14 17:23:08,2010-07-14 17:23:08
6cebdef81db7bc275ede9c30bf1d712e86b901ef...9c035c362767e448fd9c501c9a1930589841231a,3,11,42,53,10,2010-07-14 17:34:01,2010-07-14 17:34:01
94232e7a59528b2e1cf747028b9f91175b408345...360628a253785d99ab0fc62d673ff74e1b6a7800,1,1,1,2,1,2010-07-14 15:50:42,2010-07-14 15:50:42
360628a253785d99ab0fc62d673ff74e1b6a7800...eafe5d00301c6a239f2d590060515161ec66d0b9,1,14,0,14,1,2010-07-14 15:50:56,2010-07-14 15:50:56
eafe5d00301c6a239f2d590060515161ec66d0b9...115c0975e9e6dc935cff8f952a2540dc50d1226d,1,22,21,43,22,2010-07-14 15:51:05,2010-07-14 15:51:05
94232e7a59528b2e1cf747028b9f91175b408345...28041054014df347973b652c52b1b713db8b6d8c,1,1,1,2,1,2010-07-14 15:27:02,2010-07-14 15:27:02
28041054014df347973b652c52b1b713db8b6d8c...6baaaf605f59fdc82ac33a99bfec1385328e3a85,12,7,4,11,3,2010-07-14 15:35:46,2010-07-14 15:35:12
67500abdf746c48ed494431cc0c17f23be651b3b...d0df24eef09a899d81eeb6aee2866a05ebd06d6f,1,1,1,2,1,2010-07-19 14:41:48,2010-07-19 14:41:48
d0df24eef09a899d81eeb6aee2866a05ebd06d6f...7019539aa6a25ac64b5b0e71d76030ea35d4574c,1,1,1,2,1,2010-07-19 14:44:53,2010-07-19 14:44:53
6a2d44b18c9943ff0702b2f5a88430b9380144a5...2a65e81471d924bd5a163732733c042201278728,1,1745,1745,3490,1,2010-07-19 20:35:33,2010-07-19 20:35:33
2a65e81471d924bd5a163732733c042201278728...f001dea20cf1a13bc4b56af1238fed1a0266c6d9,2,11,2,13,3,2010-07-19 20:44:43,2010-07-19 20:44:43
f001dea20cf1a13bc4b56af1238fed1a0266c6d9...41f0163961815a34317c643f341a9de8efab4a6d,3,65,5,70,10,2010-07-19 20:44:47,2010-07-19 20:44:47
6a2d44b18c9943ff0702b2f5a88430b9380144a5...a6e5331c1b52c4b5118c14ddfb68e5c71963c9f2,1,16,0,16,1,2010-07-19 20:29:20,2010-07-19 20:28:16
528ad7a41a490d487b2fc6774ee796ab877f79ea...b12d4c2aff247986c30a12b9ef4e4c8803739b51,9,73,10,83,20,2010-07-18 19:02:46,2010-07-18 19:02:46
b12d4c2aff247986c30a12b9ef4e4c8803739b51...c3b07d52ce11b5de19cb246c3dd30116da5d36b1,4,23,34,57,15,2010-07-18 19:04:01,2010-07-18 19:04:01
528ad7a41a490d487b2fc6774ee796ab877f79ea...ebc5d5d3e1593dc3f0539c8fc85210aefe44b4bb,3,2,20,22,3,2010-07-18 18:22:36,2010-07-18 18:22:36
ebc5d5d3e1593dc3f0539c8fc85210aefe44b4bb...a36f3ebb6d6ff3b2d90f33730429cb7e6994a781,4,26,19,45,12,2010-07-18 18:35:14,2010-07-18 18:35:14
e5c9de85470139ed25c2d83f1ed96da8f73dafe1...4cea866dd85a67a13b466c3bfc66e28505bf0c36,1,16,16,32,15,2010-07-16 16:47:10,2010-07-16 16:38:15
4cea866dd85a67a13b466c3bfc66e28505bf0c36...49867d033871b20bb21f91f82bdca049c47ef4bd,1,5,0,5,1,2010-07-16 16:47:11,2010-07-16 16:46:17
e5c9de85470139ed25c2d83f1ed96da8f73dafe1...4a15d61ae60b9e08dd61552c38276e2dcbcdd38f,2,4,2,6,2,2010-07-16 16:46:47,2010-07-16 16:46:47
87d061f8e2066a0e8801854ea6daff30db5cc263...135c9d3f2e2d84c3c7d0e1e2f79e1b6edbaff252,3,25,7,32,14,2010-07-16 03:04:36,2010-07-16 03:04:36
87d061f8e2066a0e8801854ea6daff30db5cc263...dade9fc981397ce18e8b7acaf7d4d73e22f3dda5,1,1,1,2,2,2010-07-16 01:02:52,2010-07-16 01:02:52
87d061f8e2066a0e8801854ea6daff30db5cc263...d0662fd5236b6fd434bb9fac06630c15d67d16f8,3,36,12,48,10,2010-07-16 00:31:40,2010-07-15 21:53:10
9c035c362767e448fd9c501c9a1930589841231a...564f6d8f1eb916e35f67a28ac40f079259201c0b,1,1,1,2,1,2010-07-14 18:04:46,2010-07-14 18:04:46
564f6d8f1eb916e35f67a28ac40f079259201c0b...8a840a6cacb6bd56187e051ea836d760052e520d,1,10,0,10,1,2010-07-14 18:05:01,2010-07-14 18:05:01
9c035c362767e448fd9c501c9a1930589841231a...19f4563195e5401e25ec419ade214bcea0ad2148,3,57,21,78,13,2010-07-14 17:36:29,2010-07-14 17:36:29
19f4563195e5401e25ec419ade214bcea0ad2148...00d085ca50c180ce6f7545c8a4e2c6a5ea02b141,1,8,0,8,1,2010-07-14 17:50:39,2010-07-14 17:50:39
7019539aa6a25ac64b5b0e71d76030ea35d4574c...bca3ced2bb52c7ca4ce939e0d0832fe4d00d85b7,1,1,1,2,1,2010-07-19 14:48:47,2010-07-19 14:48:47
7019539aa6a25ac64b5b0e71d76030ea35d4574c...db44042d577fb4369f5dcba9fbd5d2f2932e8a75,1,1,1,2,1,2010-07-19 14:47:17,2010-07-19 14:47:17
87f8eddf5e4db56c9c5b44f986e4e208f461c565...80fbaf2d636e6041cf1a589972a3a6a5526e6094,4,22,8,30,7,2010-07-19 21:23:11,2010-07-19 21:23:11
87f8eddf5e4db56c9c5b44f986e4e208f461c565...6375a242b59d167161b3c3743d04f0a13573a721,1,9,2,11,3,2010-07-19 20:50:16,2010-07-19 20:50:16
6375a242b59d167161b3c3743d04f0a13573a721...ff33ac45c3b487bdb4ce95f01acff92e85ee7e25,1,95,36,131,22,2010-07-19 21:15:53,2010-07-19 21:15:53
96319c70d43e427ad54085cd4f1ec484a4c3940d...d423c6169e7a47137fbf555c24acd32e9c67718b,4,96,4,100,13,2010-07-19 13:29:49,2010-07-19 13:29:49
d423c6169e7a47137fbf555c24acd32e9c67718b...f44c2061f5f02d0650eedfd8ea20674708727d96,1,9,0,9,3,2010-07-19 13:35:13,2010-07-19 13:35:13
96319c70d43e427ad54085cd4f1ec484a4c3940d...6f728ae260ecc6f2d923ffbe2fea9bdc90c4287b,6,12,13,25,13,2010-07-18 19:15:31,2010-07-18 19:15:31
6f728ae260ecc6f2d923ffbe2fea9bdc90c4287b...970ef45329bcfc2fa8ebd8b00ef0dfd8bd00244c,2,2,2,4,2,2010-07-18 19:39:18,2010-07-18 19:39:18
03b476683ba49e6e6e14e56205a080ab5fbe5815...c5d5b0341ccfc393265be645ab7b7955d8732a1c,1,42,29,71,10,2010-07-16 18:31:42,2010-07-16 18:31:42
c5d5b0341ccfc393265be645ab7b7955d8732a1c...70223512f499cdc9469e621e2af8b125e2051e17,2,18,3,21,3,2010-07-16 18:32:23,2010-07-16 18:32:23
70223512f499cdc9469e621e2af8b125e2051e17...0227340cbd1bd51fa23d829db5f0c8528ee16924,3,49,15,64,12,2010-07-16 18:32:37,2010-07-16 18:32:37
1fce17f24825ee38c6b32fceaf18ded3bc4822d2...0e2fd8c149713b8ddd781324bbe8b1cf00101957,2,3,23,26,6,2010-07-16 04:31:43,2010-07-16 04:31:43
0e2fd8c149713b8ddd781324bbe8b1cf00101957...c9acde426f96b2eb1ae19de9224cedbcc458f1db,1,1,1,2,1,2010-07-16 04:32:17,2010-07-16 04:32:17
c9acde426f96b2eb1ae19de9224cedbcc458f1db...cbfcd15433c8eb3699fe9fbea382dac72f48f3c2,1,5,5,10,5,2010-07-16 04:53:47,2010-07-16 04:53:47
cbfcd15433c8eb3699fe9fbea382dac72f48f3c2...0e7de32756f1d8a751a41260ba4b3c570e1abb21,1,0,24,24,1,2010-07-16 05:09:05,2010-07-16 05:09:05
0e7de32756f1d8a751a41260ba4b3c570e1abb21...bdecc98ee964c353688346f8a279c968a3f65ef2,2,13,1,14,4,2010-07-16 05:16:41,2010-07-16 05:16:41
2b87a4ffa8567b4c3fd8bc324bcf7e0938469456...b443d7c0b902cac4b03fa6fefaaf08b0da8bf98d,1,3,0,3,1,2010-07-14 18:06:08,2010-07-14 18:06:08
b443d7c0b902cac4b03fa6fefaaf08b0da8bf98d...aa3b4f274ac6e66897507fefb4bdafb786aa6e38,2,11,5,16,5,2010-07-14 18:15:27,2010-07-14 18:15:27
00d085ca50c180ce6f7545c8a4e2c6a5ea02b141...ffe66e64861888bd402a4f4ca2817dfaaad23028,2,11,1,12,3,2010-07-14 18:16:22,2010-07-14 18:16:22
00d085ca50c180ce6f7545c8a4e2c6a5ea02b141...9891a1d54596d7910d25279bd55ed413394dd263,6,123,26,149,25,2010-07-14 17:58:14,2010-07-14 17:58:14
8309298faf6af3899ec962a4d55c840c696f7852...452a18733905e113aaa50fb1ff8c5058390b421f,4,7,5,12,4,2010-07-19 16:08:02,2010-07-19 16:08:02
df24fa94bc7b71f1282abf7976b3656b6b940bba...dcc152acc75fe87900f10e8464d87203c443a428,4,32,19,51,15,2010-07-19 22:05:44,2010-07-19 22:05:44
dcc152acc75fe87900f10e8464d87203c443a428...da76305d45db6eee51c7c5166956de33561a073e,1,3,0,3,2,2010-07-19 22:09:00,2010-07-19 22:09:00
970ef45329bcfc2fa8ebd8b00ef0dfd8bd00244c...0b72ae6d718785ebcfa983fb281272fcd2e8f733,2,19,1,20,6,2010-07-19 14:30:54,2010-07-19 14:30:54
0b72ae6d718785ebcfa983fb281272fcd2e8f733...1d76780d8a0a6e3e87ba8a4e7e60a41c074ec648,1,14,12,26,7,2010-07-19 14:56:58,2010-07-19 14:56:58
1d76780d8a0a6e3e87ba8a4e7e60a41c074ec648...1d7c6c8b3ad427fe55d5063da5a52a3ad1d55684,1,1,0,1,1,2010-07-19 14:57:04,2010-07-19 14:57:04
1d7c6c8b3ad427fe55d5063da5a52a3ad1d55684...dc9de883bef0fcf90ce03a0d3f45d30e22d9be7b,2,11,0,11,2,2010-07-19 14:57:16,2010-07-19 14:57:16
970ef45329bcfc2fa8ebd8b00ef0dfd8bd00244c...dcd0dbf1b99222f9dd3e63ace95be9387c80d971,1,2,2,4,2,2010-07-19 00:04:25,2010-07-19 00:04:25
aa3b4f274ac6e66897507fefb4bdafb786aa6e38...a69181c96af3ed605ee241678e8b84d3a0b4cdd7,1,1,6,7,2,2010-07-14 18:18:08,2010-07-14 18:18:08
8b2c38f3a02424d95cfe3bae3f3e7f3d45dc8262...db5aafcd116b6fc663aa8f8f0a1b83ec54d237f0,7,60,20,80,19,2010-07-14 19:08:59,2010-07-14 19:08:59
452a18733905e113aaa50fb1ff8c5058390b421f...b2897d86b79623405b9cea33473dc367edc34091,2,6,3,9,3,2010-07-19 16:16:02,2010-07-19 16:16:02
da76305d45db6eee51c7c5166956de33561a073e...5ccda87256bb443759276a926bfa8b02e6d22c7f,2,10,1,11,5,2010-07-20 00:09:00,2010-07-20 00:09:00
da76305d45db6eee51c7c5166956de33561a073e...3764a1f1bcf54588a98a4bd6fedaa9961d28a899,1,21,2,23,6,2010-07-19 22:55:30,2010-07-19 22:54:48
3764a1f1bcf54588a98a4bd6fedaa9961d28a899...0370c1858e3cefc14fd6a747b3065f2816f6a927,1,2,1,3,2,2010-07-19 23:06:41,2010-07-19 23:06:41
b7daa47bf1fd2d7942782fb98019c3883f3e8fb6...b230e696aa8acd96d17a36e166bec3e65c707ca0,1,5,0,5,2,2010-07-19 16:17:41,2010-07-19 16:17:03
b60801d7bbc515dbaf099f41eab8aded0b8a4551...19cef57996575c8ca0ec75751c3587d31579eb29,2,14,2,16,3,2010-07-14 18:31:14,2010-07-14 18:31:14
ec4207bac9516b37a4703d4ebdfdcf1b009aa4e0...9feab8a7d4648766d964258b89f11fadcd586d8c,3,5,1,6,5,2010-07-14 19:50:28,2010-07-14 19:50:28
ec4207bac9516b37a4703d4ebdfdcf1b009aa4e0...dacea7c5aac382393d815a97153db16a3ebb155b,10,0,0,0,0,2010-07-14 19:10:07,2010-07-14 19:07:06
8c91153803124c4490ba685bedc3a16f0efd802e...b651201dbee8ae8218b97ff46caf40426886de5b,4,31,2,33,6,2010-07-19 17:08:24,2010-07-19 17:08:24
8c91153803124c4490ba685bedc3a16f0efd802e...f1146af710f5f5dab69927f4277ee16a72e1d0c0,1,13,0,13,2,2010-07-19 16:35:54,2010-07-19 16:33:11
f1146af710f5f5dab69927f4277ee16a72e1d0c0...d46f9c1bfececec5f40d1dd3f4c67803a8779f32,5,6,6,12,6,2010-07-19 16:39:14,2010-07-19 16:39:14
d46f9c1bfececec5f40d1dd3f4c67803a8779f32...1fcecc58691a8896a0e047a7531a826c1c55aec6,1,1,1,2,1,2010-07-19 17:03:57,2010-07-19 17:03:57
86c2c1c780e7e83edad7c8de8174dd6bece335e6...fe1d205aa8c48ecfaa52d1c975ea60068d535e2f,8,84,9,93,14,2010-07-20 02:32:43,2010-07-20 02:32:43
86c2c1c780e7e83edad7c8de8174dd6bece335e6...e7405c154f79008d7c62d928f614509a5c992ce4,3,9,4,13,6,2010-07-20 01:23:00,2010-07-20 01:23:00
e7405c154f79008d7c62d928f614509a5c992ce4...b392dc43b68bd20ee8ab597c6ec69fdbc4d494d7,1,2,21,23,6,2010-07-20 02:06:29,2010-07-20 02:06:29
19cef57996575c8ca0ec75751c3587d31579eb29...66f8e416da51246d90236cda5065141aadb465f1,4,182,0,182,6,2010-07-14 19:49:21,2010-07-14 19:49:21
19cef57996575c8ca0ec75751c3587d31579eb29...38c27222e78365fec32303fdbf31f75765ffdcbe,1,27,1,28,3,2010-07-14 18:34:43,2010-07-14 16:28:15
38c27222e78365fec32303fdbf31f75765ffdcbe...72bab0e0d279921afcdf3609fbd694ec231672ff,2,16,7,23,4,2010-07-14 18:34:44,2010-07-14 16:30:26
72bab0e0d279921afcdf3609fbd694ec231672ff...4407f188291213589eca97e3c99a34fb470225f8,3,1,37,38,3,2010-07-14 18:34:44,2010-07-14 17:20:33
4407f188291213589eca97e3c99a34fb470225f8...1fd7718267bf2d1be0e4719a08b1665aaa2217b1,1,16,0,16,2,2010-07-14 18:47:16,2010-07-14 18:47:16
96dcc6fb4d6b058bfa7b03c2809d5e54a9e9c39b...08b84d822c7abb27bf20ee5b22580d446d44b5fa,4,1776,1728,3504,4,2010-07-14 20:30:55,2010-07-14 20:30:55
96dcc6fb4d6b058bfa7b03c2809d5e54a9e9c39b...8bcd3e37bcb9f312e085ae4f902bba5551b58529,3,6,4,10,5,2010-07-14 20:13:44,2010-07-14 20:13:44
8bcd3e37bcb9f312e085ae4f902bba5551b58529...ea2286d5e1693bdeeea52fb01da3d655c6e1ac59,3,35,27,62,18,2010-07-14 20:21:39,2010-07-14 20:21:39
0e2409c52a6ce76f4ec9941f07deeda8486f0534...8047e6afb2722a1daca76ab37d883325bde5a0c2,3,42,0,42,4,2010-07-19 17:42:09,2010-07-19 17:28:26
8047e6afb2722a1daca76ab37d883325bde5a0c2...97f90e2586f97afdcb0bf48e4247ed64ddc4b7a8,2,5,25,30,5,2010-07-19 18:08:43,2010-07-02 17:03:58
97f90e2586f97afdcb0bf48e4247ed64ddc4b7a8...832601945f229d689707fdc06cde532dd051fa2f,1,0,13,13,2,2010-07-19 18:34:44,2010-07-19 18:34:44
268264c78d197be5dd59e14077e7e460a78415dd...e0ff2261bfbd4efcb479e74dd4b0423f495382e4,1,1,1,2,1,2010-07-20 02:40:22,2010-07-20 02:40:22
5313628b85dd3825dd2f2ae2119642f60d75e600...aac5fa3764c4bd7a8e1628fe977afa61210063df,1,1,1,2,1,2010-07-14 21:42:11,2010-07-14 21:42:11
aac5fa3764c4bd7a8e1628fe977afa61210063df...16e0a0b65664b63991b0b8d01ecf9bebe449c39b,2,16,0,16,3,2010-07-14 22:15:18,2010-07-14 22:15:18
16e0a0b65664b63991b0b8d01ecf9bebe449c39b...ac6001073f6b411c266fc9ebedd9fd93c128d81f,1,4,0,4,1,2010-07-15 00:08:14,2010-07-14 20:06:00
ac6001073f6b411c266fc9ebedd9fd93c128d81f...09853275e93594547e87cff11227a2b49ab16057,1,1,1,2,1,2010-07-15 00:08:14,2010-07-14 20:24:59
09853275e93594547e87cff11227a2b49ab16057...cfcc881427f845f7e32899839590d5a5f7021930,2,8,11,19,6,2010-07-15 00:08:14,2010-07-14 21:49:08
cfcc881427f845f7e32899839590d5a5f7021930...837ca87103c17dd11629f24c349b958ee616e698,1,7,0,7,1,2010-07-15 00:08:14,2010-07-14 21:58:31
837ca87103c17dd11629f24c349b958ee616e698...69726e894fe3b4104fa95091910a8678bc514823,1,0,3,3,1,2010-07-15 00:17:35,2010-07-15 00:17:35
69726e894fe3b4104fa95091910a8678bc514823...64af09f8148f92ca1ee289bc0053b6fe8c4e470b,1,13,1,14,2,2010-07-15 00:19:11,2010-07-15 00:19:11
64af09f8148f92ca1ee289bc0053b6fe8c4e470b...fb36c680809550850be7d49844a7caaefdf1b632,1,1,1,2,1,2010-07-15 00:28:29,2010-07-15 00:28:29
fb36c680809550850be7d49844a7caaefdf1b632...699903c1f1fa26abfba8e8f7a0c64f888f1136c2,1,1,1,2,1,2010-07-15 02:39:48,2010-07-15 02:39:48
699903c1f1fa26abfba8e8f7a0c64f888f1136c2...34f99e58fd012abe9f65289046b386d3663038f3,2,27,0,27,2,2010-07-15 04:29:28,2010-07-15 04:29:28
34f99e58fd012abe9f65289046b386d3663038f3...1f6827aa10c3d9fb71b5843801669b9a452ffb0e,1,2,2,4,2,2010-07-15 04:29:42,2010-07-15 04:29:42
1f6827aa10c3d9fb71b5843801669b9a452ffb0e...ef19610facb93cd1ed68e11f78a1aa02e55e2d81,1,1,1,2,1,2010-07-15 04:31:39,2010-07-15 04:31:39
ef19610facb93cd1ed68e11f78a1aa02e55e2d81...be0245cc628385f8baabd7de58464f57c8a7a48d,1,1,0,1,1,2010-07-15 05:08:45,2010-07-15 05:08:45
e0ff2261bfbd4efcb479e74dd4b0423f495382e4...381d74eb835cc03cf43c41ff0c8c1e16e7ffe742,7,94,42,136,22,2010-07-20 15:05:27,2010-07-20 15:05:27
e0ff2261bfbd4efcb479e74dd4b0423f495382e4...7456810dad3977e707a12dc0e1f26c99d745dcb0,1,1,1,2,1,2010-07-20 13:57:56,2010-07-20 13:57:56
be0245cc628385f8baabd7de58464f57c8a7a48d...c4f76b5da7bb9e5d0632d32925299e1c66b1f823,1,1,1,2,1,2010-07-15 17:08:34,2010-07-15 17:08:34
be0245cc628385f8baabd7de58464f57c8a7a48d...412814ed6f8222f330ba1e75218240a9ee9d6606,1,1,0,1,1,2010-07-15 13:52:43,2010-07-15 13:52:43
412814ed6f8222f330ba1e75218240a9ee9d6606...3797fc0c29ea15560bf712a8b6b05642aa427bb2,1,3,3,6,1,2010-07-15 13:58:35,2010-07-15 13:58:35
7a89a21ce22c6cd8062b7f9d5890f8ecfeef4892...9ad2b5e696af78f559145ddc5c9f5651845b4b3b,3,5,0,5,3,2010-07-20 15:12:17,2010-07-20 15:12:17
b9600a1e9fa30c5de513ff9be9f7bc59395f5843...6c5feeb1896c0d55d9e353bf192504d0bbec0fa0,4,36,9,45,14,2010-07-15 18:19:25,2010-07-15 18:19:25
b9600a1e9fa30c5de513ff9be9f7bc59395f5843...c5d33d557eeec1f9b1c48564e2a455cb7b227358,2,11,2,13,6,2010-07-15 18:17:33,2010-07-15 18:16:47
3797fc0c29ea15560bf712a8b6b05642aa427bb2...4020fc6acb4645e7fa65a5aa2ab52e09f55f3334,2,17,1,18,9,2010-07-15 15:35:18,2010-07-15 15:35:18
3797fc0c29ea15560bf712a8b6b05642aa427bb2...476de4f3acdac178209369bd7663f3d783830fc7,1,15,4,19,4,2010-07-15 14:37:12,2010-07-15 14:37:12
476de4f3acdac178209369bd7663f3d783830fc7...5724e4aaf59254c6413fce6987bd4ad0c840cfb4,1,33,2,35,3,2010-07-15 15:13:19,2010-07-15 15:13:19
9ad2b5e696af78f559145ddc5c9f5651845b4b3b...e1b3f94e0f5c8f81085bf814e7c54fc8148b3267,5,1760,1753,3513,9,2010-07-20 15:34:23,2010-07-20 15:34:23
9ad2b5e696af78f559145ddc5c9f5651845b4b3b...27dde175e09492bb6230eadbb0e099d3c3a240e8,2,102,122,224,87,2010-07-20 15:15:06,2010-07-20 15:15:06
64800fdb10f0c64a9c2897d4a7eaa01d3891c82f...f995e2db3d33df1db1a25bc974bf71a93c314706,1,52,0,52,4,2010-07-15 20:01:46,2010-07-15 20:01:46
64800fdb10f0c64a9c2897d4a7eaa01d3891c82f...0b89d09b4fb90004c7851f44239bb33efdf32737,1,1,1,2,1,2010-07-15 18:55:20,2010-07-15 18:53:17
c2400e44393678955e7aa9b9640124403d35de0f...4d97315ae6fa4d88f1abefeabc396f87a8932a6c,1,1,1,2,1,2010-07-15 18:14:57,2010-07-15 18:14:57
4d97315ae6fa4d88f1abefeabc396f87a8932a6c...941f06205a421e2bea35f9f80aacaa262e7c4add,2,79,0,79,5,2010-07-15 18:15:09,2010-07-15 18:15:09
941f06205a421e2bea35f9f80aacaa262e7c4add...9d53bc19edd0ee8c4c16d86c528b1231864d73b4,5,272,69,341,29,2010-07-15 18:18:26,2010-07-15 18:18:26
7fa3723453a129ce7d400f83b56ccdf2bec93260...9dcdfcc3321b8f8f276d9431f333e07ffaf60d1a,2,13,9,22,6,2010-07-20 15:42:07,2010-07-20 15:42:07
ec07db22efc8a95567065b5c2a1349bd35bc6be8...c73493e69ea4706b9a12392791ceecf99838d0a3,2,9,1,10,2,2010-07-15 20:28:30,2010-07-15 20:26:59
0a9e2203be81ba5ef971b3aa317587d9bfe3a036...df489393a8adc1579aac4d430ac5e19ead70088b,1,19,3,22,2,2010-07-15 18:48:48,2010-07-15 18:48:48
df489393a8adc1579aac4d430ac5e19ead70088b...a98a6889387091be41817b7cd051c4d1576b32b1,1,0,2,2,1,2010-07-15 19:16:50,2010-07-15 19:16:50
a98a6889387091be41817b7cd051c4d1576b32b1...524705c6c630717595f4ac3d1d4beaa15fce502f,1,1,0,1,1,2010-07-15 21:13:55,2010-07-15 21:13:55
524705c6c630717595f4ac3d1d4beaa15fce502f...a446751e34d92fddc33fd1a63c5df8119d375cf8,3,269,30,299,24,2010-07-15 21:15:15,2010-07-15 21:15:15
9dcdfcc3321b8f8f276d9431f333e07ffaf60d1a...c419b08b347e59681ba685f2a5da2d1fd628abe1,15,86,28,114,42,2010-07-20 17:37:09,2010-07-20 17:37:09
9dcdfcc3321b8f8f276d9431f333e07ffaf60d1a...67097550ed52d2536eb9902eda2a15e7b7366841,3,7,7,14,7,2010-07-20 16:07:14,2010-07-20 16:07:14
67097550ed52d2536eb9902eda2a15e7b7366841...67710484c107d2aac4533e87f1376f5e4638f713,2,2,2,4,2,2010-07-20 16:29:29,2010-07-20 16:29:29
67710484c107d2aac4533e87f1376f5e4638f713...2b14da5f103a3d4e1a95c8d8bfa10a8470839bc1,4,6,6,12,6,2010-07-20 16:39:35,2010-07-20 16:39:35
2b14da5f103a3d4e1a95c8d8bfa10a8470839bc1...5227b6777f27acfac30006e4193033e2b33735bd,3,40,40,80,38,2010-07-20 16:42:07,2010-07-20 16:42:07
5227b6777f27acfac30006e4193033e2b33735bd...ed0081deed460e5733681af5b12c7729dc464412,2,3,3,6,3,2010-07-20 16:57:07,2010-07-20 16:57:07
ed0081deed460e5733681af5b12c7729dc464412...4b2de232c9cf5bf0f227d97fe03c39d17a2e849b,2,2,2,4,2,2010-07-20 16:57:47,2010-07-20 16:57:47
4b2de232c9cf5bf0f227d97fe03c39d17a2e849b...37c9c403de1013c47d3aab5a75abc4b3323d66d9,2,2,2,4,2,2010-07-20 16:58:23,2010-07-20 16:58:23
37c9c403de1013c47d3aab5a75abc4b3323d66d9...5a576ddbe0c79eda812d40b8b80c1344bacb3096,2,2,2,4,2,2010-07-20 16:58:58,2010-07-20 16:58:58
5a576ddbe0c79eda812d40b8b80c1344bacb3096...4ab45012de3f54ca09e4bf6738295d8f9279eef8,3,3,3,6,3,2010-07-20 16:59:47,2010-07-20 16:59:47
f170119a87dcbbd86789bd54c387b60749f1f0aa...9032e015f6d49574e8f991fe49126832ba4d29a3,3,7,7,14,7,2010-07-15 21:54:31,2010-07-15 21:54:31
9032e015f6d49574e8f991fe49126832ba4d29a3...229ec0f7e799f67481b878df6dc95962f198e34a,1,91,0,91,1,2010-07-15 21:54:55,2010-07-15 21:54:55
d6249cdbd8bf46c0c3eafa13f47cde21fa0df67e...12646d15a2b22f3ec5e35d7db322818571a0518a,12,55,29,84,33,2010-07-20 18:58:51,2010-07-20 18:58:51
d6249cdbd8bf46c0c3eafa13f47cde21fa0df67e...9c33f219fb8bdc414089dff8c4dcbc8d65d0ee8f,2,18,14,32,4,2010-07-20 17:44:35,2010-07-20 17:44:35
9c33f219fb8bdc414089dff8c4dcbc8d65d0ee8f...fe2bd79dcb6a4a66f47dc4d1414800c5aac88161,2,3,3,6,2,2010-07-20 17:54:31,2010-07-20 17:53:03
fe2bd79dcb6a4a66f47dc4d1414800c5aac88161...aa547ad8f2859f04a469231b35cb137b4c07fb90,1,3,2,5,1,2010-07-20 18:12:33,2010-07-20 18:12:33
aa547ad8f2859f04a469231b35cb137b4c07fb90...7e0a43212e83989d825b8cb68bb8fb1859acda80,1,17,0,17,1,2010-07-20 18:35:31,2010-07-20 18:35:31
ebe397b3ba7c0e74729d2d0927bd9c80609717eb...4760c024572eda0bba7e456084d099fa9254b74e,1,1,1,2,1,2010-07-20 19:00:06,2010-07-20 19:00:06
4760c024572eda0bba7e456084d099fa9254b74e...decb87e5b7360a963cd0ec4ea3dd7361212e45b1,3,9,3,12,6,2010-07-20 20:58:58,2010-07-20 20:58:58
4760c024572eda0bba7e456084d099fa9254b74e...d24fe4ca576ff6b744f179bf10c89068cb5dcda0,1,15,6,21,6,2010-07-20 19:30:15,2010-07-20 19:30:15
7c38e4edf76fdcc4ff37653294cd3e3c945ca84d...486308ccf5e3814a5008a535128ed35a4b2f0929,2,9,2,11,4,2010-07-20 21:49:36,2010-07-20 21:49:36
d24fe4ca576ff6b744f179bf10c89068cb5dcda0...54b63e374a0e48dc82e709c4bfae8fa2dba3fcbb,1,3,1,4,1,2010-07-20 21:00:40,2010-07-20 21:00:40
d24fe4ca576ff6b744f179bf10c89068cb5dcda0...4e2a494ccb28193f97e3bea081d3cb992cc970fa,1,10,0,10,1,2010-07-20 20:03:03,2010-07-20 20:03:03
4e2a494ccb28193f97e3bea081d3cb992cc970fa...25ac9e3ac3e2c6984e47a5fd8449c13222299f9f,2,9,2,11,3,2010-07-20 20:46:32,2010-07-20 20:46:32
bc615678e076f4d5455814feca73fde4fdd2f2aa...a89d2e154ab31c2979593f40b2e38763a798a87d,2,18,1,19,2,2010-07-20 22:39:49,2010-07-20 22:39:49
a89d2e154ab31c2979593f40b2e38763a798a87d...5f8f07d940a5997eb602e4ec5f4f410dd643e9e1,1,101,100,201,4,2010-07-20 23:10:12,2010-07-20 23:10:12
517d42d17b29c7539f6e5742323d2a2cae3723a9...9a96dd0c4bf0d8eb81cce48115657f9a8290e77d,1,14,0,14,1,2010-07-20 21:17:40,2010-07-20 21:17:40
5f8f07d940a5997eb602e4ec5f4f410dd643e9e1...7782698bb81f2ba6b9cf36c4340e3c416681ac34,2,5,1,6,3,2010-07-21 07:10:10,2010-07-21 07:10:10
9a96dd0c4bf0d8eb81cce48115657f9a8290e77d...cc6641eefdc732f8f75d710038bbef16a46d617a,2,1752,1751,3503,4,2010-07-21 01:11:43,2010-07-21 01:11:43
d7a2002627cf440b0fc202428eb1564fc8b00201...1f8a29ada3d54e0e46e62f0189c992fe21be55d9,5,40,489,529,20,2010-07-21 13:55:46,2010-07-21 13:55:46
515763a9038d1ad1597ae4cbbe2dfb07fc2c6dfb...753264918492eb9a660d0d4aa32100c58e9a69a5,2,19,4,23,4,2010-07-21 03:20:30,2010-07-21 03:20:30
515763a9038d1ad1597ae4cbbe2dfb07fc2c6dfb...6c055169e6d8dba7e69e947bacf0e71c3644166f,2,3,3,6,3,2010-07-21 03:16:33,2010-07-21 03:16:33
6c055169e6d8dba7e69e947bacf0e71c3644166f...9bc4aea8ba3ea9dc539753e8cb9b5046c74badbb,2,27,0,27,3,2010-07-21 03:16:48,2010-07-21 03:16:48
9bc4aea8ba3ea9dc539753e8cb9b5046c74badbb...1727a565e486681beb6851a15b7e54dfdeffc23a,1,20,10,30,6,2010-07-21 03:17:12,2010-07-21 03:17:12
1f8a29ada3d54e0e46e62f0189c992fe21be55d9...39cfa40ed6319c42f867832145949efb8a78c676,5,11,9,20,9,2010-07-21 16:50:03,2010-07-21 16:50:03
1f8a29ada3d54e0e46e62f0189c992fe21be55d9...03b70c6883fda48f79f6c9754496a0c18b3a9634,3,84,37,121,24,2010-07-21 16:17:38,2010-07-21 16:17:38
03b70c6883fda48f79f6c9754496a0c18b3a9634...db31e7bf5060b5c4abcb0c34a52aff83146816b3,1,2,1,3,1,2010-07-21 16:46:33,2010-07-21 16:46:33
86246c53c52f2c007b1658d680e56661f2529d1f...ec9b608c7dcee2ce59b33f0bd153499cb2dd6f68,2,71,2,73,3,2010-07-21 05:45:04,2010-07-21 05:45:04
86246c53c52f2c007b1658d680e56661f2529d1f...88d5717fb62d597104b5776b5fb6976c568e26ed,1,8,0,8,1,2010-07-21 03:43:05,2010-07-21 03:43:05
1727a565e486681beb6851a15b7e54dfdeffc23a...0de85ad5c208b5c15d5dcf18b01ec1207d76f3fe,1,19,1,20,1,2010-07-21 04:04:07,2010-07-21 04:04:07
0de85ad5c208b5c15d5dcf18b01ec1207d76f3fe...552f7abc4f97acdeb0338e2ea87b1572d866787e,1,11,0,11,1,2010-07-21 04:04:56,2010-07-21 04:04:56
4250625e8961e272c1068cf3b2a4a64c78b1c9af...eebffadce1b3b29eaca410a0f80d36953b5214ff,1,2,1,3,1,2010-07-21 17:46:56,2010-07-21 17:46:43
4250625e8961e272c1068cf3b2a4a64c78b1c9af...4c28261430d1570e9e7cea0b5b7a676746448091,4,14,9,23,5,2010-07-21 17:13:36,2010-07-21 17:13:36
4c28261430d1570e9e7cea0b5b7a676746448091...fe36179ebac55283c962c0770ab1671e5ca5f858,5,64,39,103,33,2010-07-21 17:50:53,2010-07-21 17:50:53
db31e7bf5060b5c4abcb0c34a52aff83146816b3...6048738ac9fc63eeff318ab10f7fcf40758e555b,8,76,23,99,20,2010-07-21 18:12:32,2010-07-21 18:12:32
6eff7f45380d9e9774c6249e3ea1b5e1eea9fddc...77a84758b073c6750efab3cc92280ddf5612b2c3,1,1,1,2,1,2010-07-21 05:47:13,2010-07-21 05:47:13
c77b9a913a2f5328b724730fd963853ad057d66e...ac0125de71602f408dd9c8ea0ae05b26dc73b770,1,39,2,41,6,2010-07-21 18:15:48,2010-07-21 18:15:48
169d0e4522986c669c1f81a15fd2073e7c589a1c...092ab485ea68ffc03d877855ec0c94647cac7c33,4,18,25,43,21,2010-07-21 18:47:32,2010-07-21 18:47:32
092ab485ea68ffc03d877855ec0c94647cac7c33...1f96a00d0b0de66ce7ac59870256bba1f918e941,4,177,160,337,41,2010-07-21 20:25:53,2010-07-21 20:25:53
ac0125de71602f408dd9c8ea0ae05b26dc73b770...3b2ede3771e29adf3359086980220bf79a8b3f7a,5,83,27,110,18,2010-07-21 19:39:59,2010-07-21 19:39:59
455e206f7808822ae8f20ad4a567efcfca44d74f...db947047b0231997b0be6ea74ec77f109a2b4fe2,10,68,37,105,25,2010-07-21 20:31:51,2010-07-21 20:31:51
282978081b7102907298c96d358bf51d29c24cd0...3bfc2c009903fa1561b1ffd4a2187b0efd70d0b0,5,7,7,14,7,2010-07-21 20:30:32,2010-07-21 20:30:32
3bfc2c009903fa1561b1ffd4a2187b0efd70d0b0...cad2a695e009f6b773632d611958728bc984d42f,1,35,0,35,1,2010-07-21 20:32:06,2010-07-21 20:22:43
cad2a695e009f6b773632d611958728bc984d42f...742b38337c62b48ee73bcc9733b91381539c5e6e,1,0,0,0,0,2010-07-21 20:32:06,2010-07-21 20:31:54
742b38337c62b48ee73bcc9733b91381539c5e6e...34a36f91af94a87c502467c250fe65f9713ed504,1,1,1,2,1,2010-07-21 20:33:02,2010-07-21 20:33:02
5d15e3494f9ff8161e30b14b7828910cd94d0065...fde8b9a5804b1f722f7df19ca5084e420f4a447d,1,4,3,7,3,2010-07-21 21:30:56,2010-07-21 21:30:56
fde8b9a5804b1f722f7df19ca5084e420f4a447d...fe1e1ce111d083018586a2344ad36ef19e99e609,1,1,1,2,1,2010-07-21 22:08:56,2010-07-21 22:08:56
fe1e1ce111d083018586a2344ad36ef19e99e609...6d7606fd1caedaa2ebb06b242e525d3016d4f0a9,1,21,2,23,6,2010-07-21 22:46:00,2010-07-21 22:01:22
6d7606fd1caedaa2ebb06b242e525d3016d4f0a9...8dd514eecc9f7b90691009b87897867db34c53ff,1,10,9,19,4,2010-07-21 22:46:00,2010-07-21 22:10:37
8dd514eecc9f7b90691009b87897867db34c53ff...cf34f34aaa9a6a9a30309c341f91a8cf0d421d4e,2,16,7,23,7,2010-07-21 22:46:00,2010-07-21 22:45:40
cf34f34aaa9a6a9a30309c341f91a8cf0d421d4e...a976d6ed8800398773259e9a054c15a5749e35f8,4,61,59,120,14,2010-07-21 23:56:18,2010-07-21 23:56:18
a976d6ed8800398773259e9a054c15a5749e35f8...4caf7c6d8413b6166db44eb8698822def834df2c,2,46,1,47,7,2010-07-22 02:20:34,2010-07-22 02:20:34
4caf7c6d8413b6166db44eb8698822def834df2c...c6a1d6a5523dad551a276c29688ecc810f853ab0,1,1,1,2,1,2010-07-22 03:34:16,2010-07-22 03:34:16
c6a1d6a5523dad551a276c29688ecc810f853ab0...47d175d72b29156f30e7b613daa6d57b9fc6a118,1,1,1,2,1,2010-07-22 12:12:05,2010-07-22 12:12:05
c6a1d6a5523dad551a276c29688ecc810f853ab0...fdbb51fae25e4fd5f09778fa35df20e717c15c6d,1,5,5,10,4,2010-07-22 12:00:18,2010-07-22 12:00:18
fdbb51fae25e4fd5f09778fa35df20e717c15c6d...757322804f73aa5e7ba13a10265e3fc9abb8dd2f,1,2,2,4,2,2010-07-22 13:34:36,2010-07-22 13:34:36
757322804f73aa5e7ba13a10265e3fc9abb8dd2f...df2a72efff66cda640403924d6126e7da0ca852b,6,41,16,57,10,2010-07-22 13:51:22,2010-07-22 13:51:22
df2a72efff66cda640403924d6126e7da0ca852b...364bad304eacae81874fbd607b0ec3036f9b4118,2,21,4,25,3,2010-07-22 14:04:17,2010-07-22 14:04:17
364bad304eacae81874fbd607b0ec3036f9b4118...a7be1e3fc1376449c3dd8802c76d9189c337fd94,1,2,2,4,1,2010-07-22 15:33:31,2010-07-22 15:33:31
a7be1e3fc1376449c3dd8802c76d9189c337fd94...3883d31c1d82e4eb6cbaaa6cdf6fc11ab7a3e078,3,87,0,87,3,2010-07-22 16:24:56,2010-07-22 16:24:31
eb00d7ce6e70531035d9b2a649026565ce02002e...a23b97a6907251e7b3849182b1fe9f83878f7677,4,15,5,20,4,2010-07-23 02:38:35,2010-07-23 02:38:35
a23b97a6907251e7b3849182b1fe9f83878f7677...90f70bab3dc82dae880729ea38aeb9e907df371d,5,30,6,36,9,2010-07-23 03:05:02,2010-07-23 03:05:02
90f70bab3dc82dae880729ea38aeb9e907df371d...c11ee404100f63f2de1d8a4bbf55334624f9eb28,1,0,2,2,2,2010-07-23 04:46:36,2010-07-23 04:46:36
c11ee404100f63f2de1d8a4bbf55334624f9eb28...ae3cd4114380bb0d6a3cb9264ba903660b1599fc,1,26,17,43,10,2010-07-23 04:46:53,2010-07-23 04:46:53
ae3cd4114380bb0d6a3cb9264ba903660b1599fc...a4431141fda255bba9982f1492b33504c26d19f0,2,41,9,50,4,2010-07-23 04:47:24,2010-07-23 04:47:24
a4431141fda255bba9982f1492b33504c26d19f0...3b50ea076757febc2b8da025cb796b0086bc7969,1,2,0,2,1,2010-07-23 05:10:18,2010-07-23 05:10:18
3b50ea076757febc2b8da025cb796b0086bc7969...bc06aca3e84f2c5e0ed62bb5e6cbf4758ba0c7e1,1,1,0,1,1,2010-07-23 05:16:57,2010-07-23 05:16:57
3883d31c1d82e4eb6cbaaa6cdf6fc11ab7a3e078...f1d859be454290b4a4127fa76e1fc922e7f80d54,2,19,15,34,11,2010-07-22 17:13:50,2010-07-22 17:13:50
f1d859be454290b4a4127fa76e1fc922e7f80d54...f6229557e8034b77fba6e644e5bfab9cc64eed52,1,1750,1750,3500,1,2010-07-22 17:15:45,2010-07-22 17:15:45
3883d31c1d82e4eb6cbaaa6cdf6fc11ab7a3e078...f8c35c1d960365dd9acba52e3d544acbc94a1304,3,11,3,14,5,2010-07-22 16:45:58,2010-07-22 16:45:58
f8c35c1d960365dd9acba52e3d544acbc94a1304...8593e82df685bc8dabba9a01b8ba06d535f60fb3,1,4,0,4,1,2010-07-22 17:52:22,2010-07-22 17:52:22
8593e82df685bc8dabba9a01b8ba06d535f60fb3...ee12ec39cd619bfe609c135e65f749103da304b3,10,119,25,144,42,2010-07-22 17:52:42,2010-07-22 17:52:42
6533589a0dfcbf2abf321bf75e0c3cbe1644587f...639a1ebc89accc82fd78bbe114fde8c28346f9fa,1,2,2,4,2,2010-07-23 06:33:44,2010-07-23 06:33:44
f6229557e8034b77fba6e644e5bfab9cc64eed52...1ea00cd67704c6034bfbc8bca9dac687ac16dcc1,4,2044,1751,3795,7,2010-07-23 21:11:50,2010-07-23 21:11:50
f6229557e8034b77fba6e644e5bfab9cc64eed52...2219a735a20d8bd02c20e1e76056b9347e4a029b,6,54,8,62,13,2010-07-22 18:20:13,2010-07-22 18:20:13
f6229557e8034b77fba6e644e5bfab9cc64eed52...b0d3fa02f3c62dc13c5501edfaa82029cf19b84c,3,0,3,3,2,2010-07-22 17:23:41,2010-07-22 17:23:06
b0d3fa02f3c62dc13c5501edfaa82029cf19b84c...f9c5b67d117ce2d3383f678d9c1d406e6ae0046f,4,32,2,34,14,2010-07-22 17:48:43,2010-07-22 17:48:43
35642b3f1b2c50f57fdb6883e84099333a807f97...c09bd3b45f8c71f08b4d002ac9ccbfb84b00cc38,2,4,2,6,3,2010-07-22 18:00:14,2010-07-22 18:00:14
639a1ebc89accc82fd78bbe114fde8c28346f9fa...83c9e34df821cf8424cadc8afbec7a243ab33e38,1,5,6,11,4,2010-07-23 14:50:24,2010-07-23 14:50:24
639a1ebc89accc82fd78bbe114fde8c28346f9fa...7a76a9919d15a3a19e0bdc618a7171eb9142617e,1,6,0,6,1,2010-07-23 13:58:43,2010-07-23 13:58:43
c09bd3b45f8c71f08b4d002ac9ccbfb84b00cc38...852eb9b1fa186f7fa31a758c7884e9145b5c32c7,6,9,4,13,7,2010-07-22 18:20:29,2010-07-22 18:20:29
e1eba3dc3ab99c6f59c56b597403feed5c1a3a2d...10e4067b4b9b92ba2f973703364c416e2fefc57e,8,132,35,167,23,2010-07-23 14:51:48,2010-07-23 14:51:48
7a76a9919d15a3a19e0bdc618a7171eb9142617e...4530af27e3394c4710c8c8a5cf831e91274c9ecc,1,1763,1763,3526,1,2010-07-23 14:29:41,2010-07-23 14:29:41
4530af27e3394c4710c8c8a5cf831e91274c9ecc...f5c49c6c314b39d7f9493f668d6edec45d5a4430,5,29,4,33,7,2010-07-23 15:48:07,2010-07-23 15:48:07
7a76a9919d15a3a19e0bdc618a7171eb9142617e...df5d6363d7a8eeff6c93845559a1d516a51d566e,1,17,3,20,7,2010-07-23 14:16:07,2010-07-23 14:15:30
85c298f73d4edaf413c9aa145cd2c36285461aa8...bf45fb5dea447ff10e2af4c3faa8b54e91275d67,1,17,0,17,1,2010-07-23 21:20:53,2010-07-23 21:20:53
bf45fb5dea447ff10e2af4c3faa8b54e91275d67...54f2bfb90ef9004582287026a07fa83bb8e2d4f7,1,2,6,8,1,2010-07-23 21:32:23,2010-07-23 21:32:23
54f2bfb90ef9004582287026a07fa83bb8e2d4f7...09ddf4770f06467902d8dde7ebe37390e2ec8863,1,9,0,9,2,2010-07-23 21:54:32,2010-07-23 21:53:49
09ddf4770f06467902d8dde7ebe37390e2ec8863...b56f9612f99837641433b61f57f5995d03050d5a,2,4,2,6,4,2010-07-23 21:55:56,2010-07-23 21:55:56
b56f9612f99837641433b61f57f5995d03050d5a...5960b04407963188117ffe1addfeb161433db309,1,3,2,5,1,2010-07-23 22:04:13,2010-07-23 22:04:13
5960b04407963188117ffe1addfeb161433db309...d4e59d32b5552b2c73d78817f8824e60c9bdbc3d,2,20,8,28,8,2010-07-23 22:21:54,2010-07-23 22:21:54
d4e59d32b5552b2c73d78817f8824e60c9bdbc3d...b0b5a0c897533d309a19d330453c31025c8b2feb,2,3,6,9,3,2010-07-23 22:29:45,2010-07-23 22:29:04
b0b5a0c897533d309a19d330453c31025c8b2feb...f5503895cf4f6b33b39fc7cd9681d6f7a94c9a07,2,6,5,11,5,2010-07-24 01:13:46,2010-07-24 00:15:06
a55850d845a661f7c8e6c0bfc417fcc79b0c1a45...a27f58a8907f13a7e92742aae6e31303a05c8729,3,67,37,104,10,2010-07-22 19:10:23,2010-07-22 19:10:23
a27f58a8907f13a7e92742aae6e31303a05c8729...5c68591f6424c5493d4cf94cc0cb2feb6f31bccf,1,1,4,5,2,2010-07-22 19:28:02,2010-07-22 19:28:02
a55850d845a661f7c8e6c0bfc417fcc79b0c1a45...d1e96621bc4980536d6060c55ffdc3c0784c09be,1,5,0,5,1,2010-07-22 18:49:33,2010-07-22 18:49:33
d1e96621bc4980536d6060c55ffdc3c0784c09be...aa586edf7eec28b6cffa246a41c9857053693cb6,1,1,1,2,1,2010-07-22 19:07:12,2010-07-22 19:07:12
10e4067b4b9b92ba2f973703364c416e2fefc57e...39b8b842a7a18b5e72830a6eef2951a4ced4c403,3,17,17,34,17,2010-07-23 14:57:50,2010-07-23 14:57:50
10e4067b4b9b92ba2f973703364c416e2fefc57e...b815f6cb70d2f9c2c66d62eefc82cce9bab4fef3,2,3,2,5,2,2010-07-23 14:54:24,2010-07-23 14:53:58
fb3bc7bbc6bf174def4860301690213496d7a760...eecabebc9614a410fc9ef370173f05e415162a5d,2,4,4,8,3,2010-07-23 15:49:57,2010-07-23 15:49:57
f5503895cf4f6b33b39fc7cd9681d6f7a94c9a07...ed3b21d31945e2908a5a78f40e2c48bd379bfda8,1,9,7,16,11,2010-07-24 01:54:53,2010-07-24 01:54:53
f5503895cf4f6b33b39fc7cd9681d6f7a94c9a07...b0a0771dd59941d7c5a42934bb2d414d66feea86,1,13,1,14,4,2010-07-24 01:46:35,2010-07-24 01:46:35
f5503895cf4f6b33b39fc7cd9681d6f7a94c9a07...4aced1b2a44b8c6c25026a103ea396076dd62db1,1,1,1,2,1,2010-07-24 01:34:43,2010-07-24 01:34:43
48e9ea71fb45963ef1affa03aa689b3c97bbf42d...6212e5c2df3d1ddfb342cef43ffabe396bc0d227,9,136,84,220,50,2010-07-22 21:50:54,2010-07-22 21:50:54
6212e5c2df3d1ddfb342cef43ffabe396bc0d227...03d4cf029e3440d60b521db21414b9a99c1519f0,2,59,40,99,15,2010-07-22 22:08:20,2010-07-22 22:08:20
03d4cf029e3440d60b521db21414b9a99c1519f0...e7cb7d2e1d1c71afda703f90e8e771615f1b1995,1,18,9,27,9,2010-07-23 00:15:30,2010-07-23 00:15:30
aa586edf7eec28b6cffa246a41c9857053693cb6...380cdd5bf2c92d0a371f66d17ec3690194294ca7,12,53,16,69,25,2010-07-22 19:39:20,2010-07-22 19:39:20
aa586edf7eec28b6cffa246a41c9857053693cb6...419ba813d304ecf312df9f6988748b6408713526,1,10,0,10,1,2010-07-22 19:25:15,2010-07-22 19:25:15
419ba813d304ecf312df9f6988748b6408713526...36f2ba408298f3ea9e637502970d605daf7eb172,1,45,0,45,1,2010-07-22 19:26:25,2010-07-22 19:26:25
fcfbee1341d2c053c72f3736aeb1be6d768fd8a2...5e07c9e50ca006eed25a999607a47c3bb3a268a0,1,3,0,3,1,2010-07-23 16:06:25,2010-07-23 16:06:25
5e07c9e50ca006eed25a999607a47c3bb3a268a0...5ffa331ac36bbbfab0a901c3159dd83a261d81a9,1,4,4,8,3,2010-07-23 16:06:30,2010-07-23 16:06:30
fcfbee1341d2c053c72f3736aeb1be6d768fd8a2...b8acaef6f1e4aa0a274d7b83ed406c878264f4f7,1,1,1,2,1,2010-07-23 15:20:24,2010-07-23 15:19:56
eecabebc9614a410fc9ef370173f05e415162a5d...7b2b241fb7270cac6f876ec1fa2530221153bf0d,1,2,2,4,2,2010-07-23 16:00:38,2010-07-23 16:00:38
7b2b241fb7270cac6f876ec1fa2530221153bf0d...c98f88675e3d23be762df4fe68a1d2b6bc58d187,1,8,2,10,3,2010-07-23 16:07:40,2010-07-23 16:07:40
a33f287ec6551c6a62ced62094a15ed96fe5e0ca...34a45ffdf02212b172f064fd1e629392d0236809,1,1,1,2,1,2010-07-24 03:14:03,2010-07-24 03:14:03
34a45ffdf02212b172f064fd1e629392d0236809...c9f86b31aa55a024290c9756d13963360aba46a8,2,22,13,35,4,2010-07-24 03:14:37,2010-07-24 03:14:37
a33f287ec6551c6a62ced62094a15ed96fe5e0ca...52449fbbd20d22c86f50c3a5be8d364bd19d41de,2,43,27,70,12,2010-07-24 01:58:32,2010-07-24 01:57:55
d961b842304a2cde90b2f460b32d8ebc11062e69...5b3e32d440acb45a3f445cbc7cac2d72e82c6ab9,1,5,4,9,4,2010-07-23 00:21:23,2010-07-23 00:21:23
5b3e32d440acb45a3f445cbc7cac2d72e82c6ab9...02c4acb22904dc3b94ecc7da502fc59761a093f6,2,4,4,8,3,2010-07-23 00:55:26,2010-07-23 00:55:26
02c4acb22904dc3b94ecc7da502fc59761a093f6...02f8bdd1fe342ff8d109fe0899508f6de3a20090,1,1,1,2,1,2010-07-23 01:00:57,2010-07-23 01:00:57
f8b872344d7fe0ce5ff20982deba1e1bb126d3ce...e09197ddf222bfe4fdd0a09a429a289907e69e15,1,1,1,2,1,2010-07-22 19:40:11,2010-07-22 19:40:11
e09197ddf222bfe4fdd0a09a429a289907e69e15...cd913168fbb1ba8e8fa32e1e577409b8bfc0f39f,1,19,0,19,1,2010-07-22 20:11:49,2010-07-22 20:11:49
cd913168fbb1ba8e8fa32e1e577409b8bfc0f39f...7eaaa12cc64f410687cb98ce5db12f394d80a031,1,4,6,10,3,2010-07-22 20:30:52,2010-07-22 20:30:52
7eaaa12cc64f410687cb98ce5db12f394d80a031...1c2758bf881ebfdebda02185a70709c21da72542,2,58,50,108,11,2010-07-22 20:40:46,2010-07-22 20:40:46
1c2758bf881ebfdebda02185a70709c21da72542...aeb3276abc6ce210a57caf1a2deacc13c9a735dc,2,6,1,7,4,2010-07-22 20:59:57,2010-07-22 20:59:57
aeb3276abc6ce210a57caf1a2deacc13c9a735dc...4308df6f3b8a4e0fa962fa01c3bf73ca9ceca527,5,64,14,78,9,2010-07-22 21:24:51,2010-07-22 21:24:51
4308df6f3b8a4e0fa962fa01c3bf73ca9ceca527...7929f98f43fa39867ca60f1bd622fff6234ca6db,2,3,2,5,3,2010-07-22 22:09:38,2010-07-22 22:09:38
d0b0aefff750f6a92b93380a3c45c9dae0eb64af...3b188186ac159d9d6291783c5db1edf649f0f17b,1,1,0,1,1,2010-07-23 16:18:39,2010-07-23 16:18:39
b0892d32c9f171546df51f1127d82e4fd2eabcb8...956d782243c9c6ac0c619663f1a5dec9129507f1,2,18,8,26,4,2010-07-23 17:35:27,2010-07-23 17:35:27
829d907ff889e6551c802b43254091eecdb4af16...53d5215cc65f5fcdcd1c9d4d8a2197007b9e6520,5,249,211,460,11,2010-07-24 03:20:00,2010-07-24 03:20:00
02f8bdd1fe342ff8d109fe0899508f6de3a20090...1d83bd2e990ed4dc2ef8fabef5767667b61e1622,1,5,0,5,1,2010-07-23 01:19:59,2010-07-23 01:18:28
02f8bdd1fe342ff8d109fe0899508f6de3a20090...bfb5bdb06b4fed14d45b064b15afc2913adfef29,1,5,0,5,1,2010-07-23 01:03:24,2010-07-22 17:25:00
bfb5bdb06b4fed14d45b064b15afc2913adfef29...02978c9b7355b227df678fab611f838c2071e0a9,1,1,1,2,1,2010-07-23 01:03:24,2010-07-22 19:17:34
02978c9b7355b227df678fab611f838c2071e0a9...dd79445bbbdce5b24b3cd51113b4f35d264f9f40,9,233,26,259,23,2010-07-23 01:03:24,2010-07-23 01:00:30
dd79445bbbdce5b24b3cd51113b4f35d264f9f40...ce2bb7ee71b71337185f866b64af3614f580947b,3,1768,1755,3523,6,2010-07-23 01:13:52,2010-07-23 01:13:52
e51d378cfbf1b12f768301299025f3390e6ad136...f383a5afd470d3281902cc15092e06d61b2a3184,1,4,4,8,3,2010-07-23 16:29:30,2010-07-23 16:29:30
1cedf66c567ae7051d13651bf3e55d3d52ca7539...4c6bdd1bb29183e36a6d45f37b5983c5e2662068,1,1,1,2,1,2010-07-23 17:49:20,2010-07-23 17:49:20
fe16a597ad891e5ee7240fa92203693eb0db7d16...401872b5930b8295d600b6f7661f2773d9c1e1a6,3,6,0,6,3,2010-07-24 03:26:27,2010-07-24 03:26:27
f383a5afd470d3281902cc15092e06d61b2a3184...089f471c21343fbb99296a49930b446bb3849831,1,2,1,3,1,2010-07-23 17:01:28,2010-07-23 17:01:28
f383a5afd470d3281902cc15092e06d61b2a3184...dbafe3093b07fa9d9c80f2b86f0d2a055389ba3b,2,31,0,31,5,2010-07-23 16:52:59,2010-07-23 16:52:59
87bfdec86469d6398a86f7cbe76db676751d197c...030009364d91b71bca728b4a4f090f4b3a35cf06,2,28,1,29,3,2010-07-23 20:06:06,2010-07-23 20:06:06
030009364d91b71bca728b4a4f090f4b3a35cf06...6b4e91bef9fc875951d1c4cae0fa0bd821634bcc,4,22,15,37,16,2010-07-23 20:06:24,2010-07-23 20:06:24
6b4e91bef9fc875951d1c4cae0fa0bd821634bcc...43336f601884973020b3869fac6e40fc33c85eb9,1,13,6,19,6,2010-07-23 20:10:00,2010-07-23 20:10:00
401872b5930b8295d600b6f7661f2773d9c1e1a6...e086cade0651609972ad409210e7e4482c594355,3,19,3,22,5,2010-07-24 04:10:34,2010-07-24 04:10:34
401872b5930b8295d600b6f7661f2773d9c1e1a6...be05dbc52b5d4c9c28237d34a700ba3bec3f68f9,2,1,6,7,4,2010-07-24 03:29:53,2010-07-24 03:29:53
be05dbc52b5d4c9c28237d34a700ba3bec3f68f9...91bdfd47c2eb2f7a44400e3ec642d6693585a7e1,1,3,3,6,3,2010-07-24 04:06:38,2010-07-24 04:06:38
cf4bf5490a2581525efeb03647fbf662584ef5d2...0d1975d0d446568a756141ca3be96f97f609a998,1,4,1,5,3,2010-07-23 17:06:24,2010-07-23 17:06:24
dbafe3093b07fa9d9c80f2b86f0d2a055389ba3b...bfe1b888e05be2429a2431c1be23af959fc5dd25,1,0,4,4,1,2010-07-23 17:16:21,2010-07-23 17:16:21
bfe1b888e05be2429a2431c1be23af959fc5dd25...b281c3de710fc447deb9161579c97a055e0485cd,1,3,3,6,2,2010-07-23 17:17:22,2010-07-23 17:17:22
a0b14bd6fa4bcd3c148cec0c691153ea244c3944...a5bd01525a3b9f38ced4141734b722129e14cfa5,1,9,3,12,5,2010-07-23 20:34:48,2010-07-23 20:34:48
a0b14bd6fa4bcd3c148cec0c691153ea244c3944...58bbf8a4d331fea3d4ed463f8a6086573d54a053,5,17,11,28,10,2010-07-23 18:52:14,2010-07-23 18:52:14
58bbf8a4d331fea3d4ed463f8a6086573d54a053...87b68a4ebe6cf65ab22eed911e993aeab7e52972,2,4,4,8,3,2010-07-23 18:56:10,2010-07-23 18:56:10
87b68a4ebe6cf65ab22eed911e993aeab7e52972...30d823b6289a70250e171816d4aec6fa86d46be3,3,51,11,62,13,2010-07-23 19:48:30,2010-07-23 19:48:30
30d823b6289a70250e171816d4aec6fa86d46be3...5eb10576074a6aeb00982a07a65f1c770b3e14d9,2,22,9,31,6,2010-07-23 19:52:52,2010-07-23 19:52:35
d6e70454d3fe0c963f566d425afc782f1bcbfa88...6e2f7ff4be95c3bba1f9a47c664fb5a08c426a2d,1,5,4,9,2,2010-07-23 20:19:39,2010-07-23 20:19:39
e1cdf39dec3383f4153526516f0c0ac59d2c9311...75be526b4ac6c3296de19a0d5ada16fc2e0150e0,1,1,1,2,1,2010-07-24 04:33:50,2010-07-24 04:33:50
75be526b4ac6c3296de19a0d5ada16fc2e0150e0...f2e85afb23070c8e9018a5c5fb14cc49d23f1e6a,1,12,4,16,6,2010-07-24 12:58:36,2010-07-24 12:58:36
f2e85afb23070c8e9018a5c5fb14cc49d23f1e6a...22a21468b50ff90e4900b55038d78eec1e98e1bc,1,2,0,2,1,2010-07-24 13:00:57,2010-07-24 13:00:57
22a21468b50ff90e4900b55038d78eec1e98e1bc...39cdcd202f6377e95f30685098ce14c579670d45,4,9,3,12,4,2010-07-24 15:37:00,2010-07-24 15:37:00
39cdcd202f6377e95f30685098ce14c579670d45...392ce39d91fa574d2f88be89624e3867e305e70e,1,1,1,2,1,2010-07-24 16:02:27,2010-07-24 16:02:27
392ce39d91fa574d2f88be89624e3867e305e70e...098a66e3ccadfa5bf4ac530ee6f92700c8a8b636,1,13,13,26,4,2010-07-24 16:02:35,2010-07-24 16:02:35
098a66e3ccadfa5bf4ac530ee6f92700c8a8b636...add85dc415f9b4dc4b491c17d322c54901b231f3,1,4,1,5,2,2010-07-24 16:02:43,2010-07-24 16:02:43
add85dc415f9b4dc4b491c17d322c54901b231f3...357cb2918e4f8d66e78bbcea410aa2dd21d31feb,3,124,88,212,3,2010-07-24 16:40:07,2010-07-24 16:40:07
357cb2918e4f8d66e78bbcea410aa2dd21d31feb...1284b0b38a06066677b2ec2f768de60d247a445c,1,2,2,4,1,2010-07-24 16:40:19,2010-07-24 16:40:19
1284b0b38a06066677b2ec2f768de60d247a445c...a0841b0171f46e5757da6ada7456c7c969e6e64b,2,26,17,43,10,2010-07-24 16:40:34,2010-07-24 16:40:34
a0841b0171f46e5757da6ada7456c7c969e6e64b...778a6ebce63f857d5a2b078f2c2ed86914dad983,6,12,0,12,6,2010-07-24 21:17:41,2010-07-24 21:17:41
778a6ebce63f857d5a2b078f2c2ed86914dad983...eb194af185f29ca95fc0e4f38df217e27c6f7ca0,6,21,5,26,11,2010-07-25 01:58:39,2010-07-25 01:58:39
eb194af185f29ca95fc0e4f38df217e27c6f7ca0...0ede2776032b5d96ce571152bffede36f497d2cb,1,1,1,2,1,2010-07-25 03:47:33,2010-07-25 03:47:33
0ede2776032b5d96ce571152bffede36f497d2cb...2827add40c6ed96c397605dc0b98ec2a1ffb0889,1,1,1,2,1,2010-07-25 03:54:16,2010-07-25 03:54:16
2827add40c6ed96c397605dc0b98ec2a1ffb0889...2cad9807fda10d87ea287d08dad99159ce4d6319,2,15,8,23,4,2010-07-25 06:41:05,2010-07-25 06:41:05
0d1975d0d446568a756141ca3be96f97f609a998...08b250630b1b97f05b6e2fa2c03440781de89b3b,3,23,25,48,15,2010-07-23 17:41:21,2010-07-23 17:41:21
6de6bd1ddde583353894b3ceb9c76784b3f4593b...296526ce53efbcc9e1cc63d28dd2c2ec0c40c05e,7,73,7,80,14,2010-07-24 02:44:11,2010-07-24 02:44:11
6e2f7ff4be95c3bba1f9a47c664fb5a08c426a2d...98fada99db15ad5b13281cc900cdcc55d80d6d71,2,3,2,5,2,2010-07-23 21:14:49,2010-07-23 21:14:49
98fada99db15ad5b13281cc900cdcc55d80d6d71...13c5f09215360fd975d5c6ab7c55b283a46c3bf4,1,10,4,14,4,2010-07-23 21:15:01,2010-07-23 21:15:01
2cad9807fda10d87ea287d08dad99159ce4d6319...f8d63e3ca0009c45bd6c46766f61ab3ca08dd638,5,114,67,181,35,2010-07-25 20:16:19,2010-07-25 20:16:19
2cad9807fda10d87ea287d08dad99159ce4d6319...416e370718016d0e01a418b4d53690b03a116b01,1,3,3,6,3,2010-07-25 12:32:45,2010-07-25 12:32:45
416e370718016d0e01a418b4d53690b03a116b01...b8bef176d7ffb2c6030726422bceeb8829659da7,3,31,2,33,6,2010-07-25 12:33:03,2010-07-25 12:33:03
b8bef176d7ffb2c6030726422bceeb8829659da7...96913b23294ffab4fa2bdbac06e2da8481fe0fdb,4,46,8,54,12,2010-07-25 15:32:15,2010-07-25 15:32:15
96913b23294ffab4fa2bdbac06e2da8481fe0fdb...672a947cf5cac8774ba744248c39b9dfef51fa0d,1,2,2,4,2,2010-07-25 15:51:23,2010-07-25 15:51:23
672a947cf5cac8774ba744248c39b9dfef51fa0d...4e4a4959a8f2388af94b222128e09da68129111d,3,10,8,18,8,2010-07-25 15:51:34,2010-07-25 15:51:34
4e4a4959a8f2388af94b222128e09da68129111d...5d7a159f5a78f64d2a6f0258cc0b4b55cf6203a3,2,18,5,23,5,2010-07-25 16:08:56,2010-07-25 16:08:56
5d7a159f5a78f64d2a6f0258cc0b4b55cf6203a3...5dbb14804f28a111145c79497f0efc9e7ebc69d0,1,1,1,2,1,2010-07-25 16:16:55,2010-07-25 16:16:55
2af5ce15c1d0641e3630c3461745c7100406d53c...698441ad63fb1c67c704c211c96915260d93fcfc,4,52,108,160,24,2010-07-26 02:50:35,2010-07-26 02:50:35
698441ad63fb1c67c704c211c96915260d93fcfc...54c2450de68755dc14bb92749a796dea3f2416b5,2,6,2,8,4,2010-07-26 13:55:10,2010-07-26 13:55:10
54c2450de68755dc14bb92749a796dea3f2416b5...3083c08000747ec21ed5d723fa444ae698b4108a,3,67,10,77,8,2010-07-26 14:32:13,2010-07-26 14:32:13
3083c08000747ec21ed5d723fa444ae698b4108a...55382a6b8405021883f3a2154d16f3cb27d99ba3,2,16,10,26,10,2010-07-26 15:23:34,2010-07-26 15:23:34
55382a6b8405021883f3a2154d16f3cb27d99ba3...769629c1e43dfb7e539b72146302fb70fcc5eda0,2,3,2,5,2,2010-07-26 16:21:54,2010-07-26 16:21:54
769629c1e43dfb7e539b72146302fb70fcc5eda0...150101e439a2f8d88e3454017159d58a02c7391a,4,135,70,205,35,2010-07-26 19:29:18,2010-07-26 19:29:18
55382a6b8405021883f3a2154d16f3cb27d99ba3...c23a930a46a82e558ab467be1be63e9764d562e6,3,75,7,82,7,2010-07-26 15:51:40,2010-07-26 15:51:40
c23a930a46a82e558ab467be1be63e9764d562e6...9d08a04e8e0faa13ac62c1cc1997822339fb6950,1,0,5,5,1,2010-07-26 15:56:12,2010-07-26 15:56:12
9990a546fdf54d6a46039ac32cb984bb0ab05e6e...66caa37da3f9a5345f3b39ad3de5e1c72568c76d,2,4,0,4,2,2010-07-26 19:50:30,2010-07-26 19:50:30
66caa37da3f9a5345f3b39ad3de5e1c72568c76d...f611c9e68d534d2b5667eb6a35c44e2755d919db,3,31,1,32,5,2010-07-26 20:04:54,2010-07-26 20:04:54
9d08a04e8e0faa13ac62c1cc1997822339fb6950...e94cc361ed088b5cb1f2cfe8ab30fc641c74639e,5,161,57,218,21,2010-07-26 19:08:04,2010-07-26 19:08:04
9d08a04e8e0faa13ac62c1cc1997822339fb6950...d78ed0f030ddccd1cca8df9a14a83d3203c66d96,4,68,7,75,7,2010-07-26 19:01:15,2010-07-26 19:01:15
d78ed0f030ddccd1cca8df9a14a83d3203c66d96...d854b90695cab806d1fb8ab5dc63ded64a0beb63,1,1,0,1,1,2010-07-26 19:05:50,2010-07-26 19:05:50
9d08a04e8e0faa13ac62c1cc1997822339fb6950...401d3ab6b9f3b7f6a2a949074dd05945297f4152,1,43,43,86,2,2010-07-26 17:32:26,2010-07-26 17:32:26
f611c9e68d534d2b5667eb6a35c44e2755d919db...1037a58e167fa06cbe472257d1c85d1310606bb7,2,12,3,15,5,2010-07-26 20:19:08,2010-07-26 20:19:08
f611c9e68d534d2b5667eb6a35c44e2755d919db...e53107eeeb37b391e79ed29671fdf635f3f48abd,3,108,61,169,17,2010-07-26 20:13:36,2010-07-26 20:13:36
4af7fec5313f2b9fa68f783c3fa189bffb4356d5...69a0d45f5cad648b727369b21a0a7fa1b1a5b732,4,111,0,111,5,2010-07-26 22:34:16,2010-07-26 22:34:16
4af7fec5313f2b9fa68f783c3fa189bffb4356d5...f0359e7b545ff5e12cfee479185337e799427fe2,4,111,27,138,11,2010-07-26 20:06:49,2010-07-26 20:06:49
f0359e7b545ff5e12cfee479185337e799427fe2...b4c0b587944672c20652c4d627220607b70ae625,1,2,2,4,2,2010-07-26 20:07:07,2010-07-26 20:07:07
b4c0b587944672c20652c4d627220607b70ae625...4471c919ede23b32c296cf835c5a2ebcbb5772f6,1,16,7,23,5,2010-07-26 20:10:32,2010-07-26 20:10:32
4471c919ede23b32c296cf835c5a2ebcbb5772f6...91cc690bb96ee683116eaf2a25c16bac671d0d91,1,2,1,3,1,2010-07-26 20:10:37,2010-07-26 20:10:37
401d3ab6b9f3b7f6a2a949074dd05945297f4152...c7a38e409d48440c824ad5a5d6f450ba3adc875e,6,22,29,51,16,2010-07-26 18:25:55,2010-07-26 18:25:55
401d3ab6b9f3b7f6a2a949074dd05945297f4152...4fbb3cca67d03327f3145737a1184af2fed93440,1,8,0,8,2,2010-07-26 18:16:20,2010-07-26 18:15:46
34bf652b1bb9c1204118c8ca1d80538f34eb1fe2...cbb44f9adb430c66d91a5823a8ebb81d7ca4ad0b,1,1,1,2,1,2010-07-26 20:12:51,2010-07-26 20:12:51
6be2b2a6236aed923812bf21680bfe817e7766b8...01c71e974612cc10530a593259d9bfdaea2ba649,2,3,5,8,4,2010-07-26 22:45:40,2010-07-26 22:45:40
01c71e974612cc10530a593259d9bfdaea2ba649...0a80030ba9a86eb6a5c5449d188a951078b9d1ac,1,8,7,15,3,2010-07-27 01:09:10,2010-07-27 00:07:56
0a80030ba9a86eb6a5c5449d188a951078b9d1ac...ce531f1481dbdc07a1b3769855faf0a9f6a5a28f,1,12,7,19,2,2010-07-27 01:09:10,2010-07-27 00:40:25
ce531f1481dbdc07a1b3769855faf0a9f6a5a28f...8443231430a20f75b6d44760d87c00fe761b2bc6,1,7,0,7,2,2010-07-27 01:32:46,2010-07-26 16:10:02
8443231430a20f75b6d44760d87c00fe761b2bc6...7740fb4070ad8326c81129d9d9095b556fe5ce13,3,5,7,12,4,2010-07-27 01:36:47,2010-07-27 01:36:47
7740fb4070ad8326c81129d9d9095b556fe5ce13...9007388324bb3f6610c9592facb6131a82e6f9b1,2,27,25,52,2,2010-07-27 01:48:20,2010-07-27 01:48:20
9007388324bb3f6610c9592facb6131a82e6f9b1...6e3522cd56bdbdbcd1600ea22b486fda4e76f7e6,1,8,4,12,5,2010-07-27 02:21:17,2010-07-27 02:21:17
422f9a4f9b6eaecc07ac3187b38079960dc2003c...6caf5bdc0e037cd556cc82d9d9cdb0311df682fa,1,47,0,47,1,2010-07-26 18:31:09,2010-07-26 18:31:09
4fbb3cca67d03327f3145737a1184af2fed93440...b7358a8ea958a14c052cb5ca4ded2a6bcc8cb0e5,1,9,6,15,8,2010-07-26 18:29:30,2010-07-26 18:29:30
bea4ec2483fbd371eeb3a3ecc9fa6ae1a02fa301...d3d978a60187894e6f148ea35a2c7ba2ab6c0345,1,1,2,3,2,2010-07-26 21:03:14,2010-07-26 21:03:14
cbb44f9adb430c66d91a5823a8ebb81d7ca4ad0b...be796737a7782ea62d6d010863256b5172d8e65f,1,2,3,5,3,2010-07-26 20:25:15,2010-07-26 20:25:15
be796737a7782ea62d6d010863256b5172d8e65f...87d7c92d6b2851d6f86fe919e18833d7bb4ed8c6,1,3,0,3,1,2010-07-26 20:25:23,2010-07-26 20:25:23
87d7c92d6b2851d6f86fe919e18833d7bb4ed8c6...1c138b4c77c30c20c9fc9d4e0565d3b4204b2ff4,2,5,5,10,5,2010-07-26 20:25:27,2010-07-26 20:25:27
6e3522cd56bdbdbcd1600ea22b486fda4e76f7e6...6eeeeea25be1944bc667656e6b420639f194f0f9,3,7,5,12,4,2010-07-27 03:17:29,2010-07-27 03:17:29
6e3522cd56bdbdbcd1600ea22b486fda4e76f7e6...8629b25dd186d759aac1f5925073f85c877f6982,1,1,0,1,1,2010-07-27 02:56:22,2010-07-27 02:11:25
8629b25dd186d759aac1f5925073f85c877f6982...5d09b56f0c3f5f9945b797851022b01e31e35fb7,1,2,5,7,1,2010-07-27 02:56:22,2010-07-27 02:55:56
5d09b56f0c3f5f9945b797851022b01e31e35fb7...79d5c94fd79aa2ca1eb2d50f2cc3df7a3fe741a5,3,9,6,15,7,2010-07-27 03:11:09,2010-07-27 03:11:09
5a5e2eccbbbce694d68c7ed636c1ed2585feb14f...57250beeda857a84b4492021bdc837970b872f64,1,1,4,5,1,2010-07-26 18:47:52,2010-07-26 18:47:52
d3d978a60187894e6f148ea35a2c7ba2ab6c0345...a85b659bb6cc722a407e0fea6c39d2a523382a78,2,4,0,4,2,2010-07-26 21:17:20,2010-07-26 21:17:20
d3d978a60187894e6f148ea35a2c7ba2ab6c0345...b9cbee6a54bdc43ac1c4c2bbaa0556f4ebef4987,1,1,1,2,1,2010-07-26 21:09:02,2010-07-26 21:09:02
e5c9d859594e3af78fde7332cfdf8bf968adc9bb...aa02b52c2bf55c3f06af2f183878989cbede8c97,1,1,1,2,1,2010-07-27 04:17:48,2010-07-27 04:17:48
aa02b52c2bf55c3f06af2f183878989cbede8c97...ae37db95d2c2ca6c2b3ab42e71adba96879a3263,1,11,9,20,1,2010-07-27 04:30:56,2010-07-27 04:30:56
e5c9d859594e3af78fde7332cfdf8bf968adc9bb...843835b95d9afc48ddfbdbad514ec9653f52b52c,1,29,0,29,1,2010-07-27 03:35:39,2010-07-27 03:35:39
723c40aee68461599de37cf38060a63601026e51...4a216f149fdeb3a8fcdbd52cceff589462ac6b8d,3,10,12,22,5,2010-07-26 23:45:34,2010-07-26 23:45:34
4a216f149fdeb3a8fcdbd52cceff589462ac6b8d...37b65503656414e9f00ecdb88ac283ff96ca1693,1,7,1,8,1,2010-07-27 00:09:57,2010-07-27 00:09:57
37b65503656414e9f00ecdb88ac283ff96ca1693...eef2a87ab39974a1c1dcc0c6f4e2dc42eb862695,6,32,9,41,14,2010-07-27 01:06:37,2010-07-27 01:06:37
eef2a87ab39974a1c1dcc0c6f4e2dc42eb862695...ad31e3f393e8793fcf2d5ae80be9203e04d33025,3,24,1,25,5,2010-07-27 01:44:17,2010-07-27 01:44:17
ad31e3f393e8793fcf2d5ae80be9203e04d33025...aeb05eaca4a11f0aebbc0c56ffb966b264f50eaa,1,7,1,8,3,2010-07-27 02:03:49,2010-07-27 02:03:49
723c40aee68461599de37cf38060a63601026e51...127558c1c47f8df7fddd6a7408036eccdd3bf9ad,6,29,8,37,14,2010-07-26 21:28:24,2010-07-26 21:28:24
80aa526e5cdafd2382b45e72125df746ddae0993...80f6c1ec51fbb7468c2b0ffc4594add641a8ab23,1,0,1,1,1,2010-07-27 04:38:22,2010-07-27 04:38:22
80f6c1ec51fbb7468c2b0ffc4594add641a8ab23...6e7c9d6836a74ee5fb66ba4aff008726a45985a9,5,54,21,75,8,2010-07-27 04:57:38,2010-07-27 04:57:38
8dd5aadf638c97f55603e3d4e04b597ea3d4a6fe...c3f6084310e75beee25cb365ec723a92858b40f5,1,37,27,64,5,2010-07-27 06:13:13,2010-07-27 06:13:13
127558c1c47f8df7fddd6a7408036eccdd3bf9ad...5af8dd67a82837c32447abdf91d0b72e865b07f4,1,1,1,2,1,2010-07-27 13:18:07,2010-07-27 13:18:07
968d40fd3827092a1cfc70a044013ea050b2fa58...5b7ab6fa0ed3404bef3709d26a3c09850ef2f60d,6,5,11,16,10,2010-07-27 13:59:34,2010-07-27 13:59:34
5b7ab6fa0ed3404bef3709d26a3c09850ef2f60d...a73887f57567ebaec46afde3f879592d611885fb,3,140,9,149,8,2010-07-27 14:55:48,2010-07-27 14:55:48
5b7ab6fa0ed3404bef3709d26a3c09850ef2f60d...d36e4b6e0b264b8ab187dcab519ecab5360de2cd,2,4,1,5,4,2010-07-27 14:37:48,2010-07-27 14:37:48
483f69bcfa54e7e03bc6991072e19009d2493a13...1fc517d53ae9ecd0d02df18a2378e9a6d65ec119,3,27,26,53,14,2010-07-27 15:31:16,2010-07-27 05:34:20
1fc517d53ae9ecd0d02df18a2378e9a6d65ec119...95f84aead55435f9574bec693dea566e95427c1e,2,92,80,172,10,2010-07-27 15:47:48,2010-07-27 15:47:48
95f84aead55435f9574bec693dea566e95427c1e...4a15dba156a2720b809e9f39ce92c3ac75ffc9af,1,1,1,2,1,2010-07-27 15:48:48,2010-07-27 15:48:48
d36e4b6e0b264b8ab187dcab519ecab5360de2cd...eeb86f5ab90e9f8ae3e85b6ab7cf7b715bead021,1,1,1,2,1,2010-07-27 15:49:54,2010-07-27 15:49:54
4a15dba156a2720b809e9f39ce92c3ac75ffc9af...b5ad7702e39bccadf9122308c693ccede3ce1463,3,99,78,177,9,2010-07-27 16:11:04,2010-07-27 16:11:04
ec0b1eadcf3057d0c14d06360a484452b05977aa...b970c7c6d4dbf2f95593c3dfbeb2bee258d5ddaf,1,1,1,2,1,2010-07-27 15:51:37,2010-07-27 14:14:20
b970c7c6d4dbf2f95593c3dfbeb2bee258d5ddaf...1224378fab59215419cdff9247da2c9ce15779f0,1,5,0,5,1,2010-07-27 15:51:37,2010-07-27 14:15:16
11a2d82651c08cf22c9d1daf92344dd23f5fb8d7...18132e81cb12c2b5b90bd556a4f16e233a74e0c9,1,5,5,10,3,2010-07-27 16:48:11,2010-07-27 16:48:11
18132e81cb12c2b5b90bd556a4f16e233a74e0c9...7f05f937e823c9b9081defd39b2b480512c22dc0,1,27,0,27,1,2010-07-27 22:36:44,2010-07-27 22:36:44
18132e81cb12c2b5b90bd556a4f16e233a74e0c9...16ab1bcbe6bc47cd84e7521ea3dcff8a7afdbdcd,1,0,7,7,1,2010-07-27 21:18:43,2010-07-27 15:52:06
16ab1bcbe6bc47cd84e7521ea3dcff8a7afdbdcd...585b3797ff5aa6702e837ed7d87ac09a720e5793,8,30,59,89,23,2010-07-27 21:18:43,2010-07-27 19:33:27
585b3797ff5aa6702e837ed7d87ac09a720e5793...00679b9a2b0303213a5d088c961727e0ebff3168,3,18,2,20,3,2010-07-27 21:18:43,2010-07-27 21:01:45
00679b9a2b0303213a5d088c961727e0ebff3168...99c0d3557ff2cb9c8c5893a61f185730f1a4c691,3,21,8,29,12,2010-07-27 21:18:43,2010-07-27 21:17:46
99c0d3557ff2cb9c8c5893a61f185730f1a4c691...0553e3c38188cba8b12a9387a49cecc6faeff05f,1,8,0,8,1,2010-07-27 22:15:36,2010-07-27 16:56:54
0553e3c38188cba8b12a9387a49cecc6faeff05f...2bc93939b5e4834946efe3a8c0a7bd380b34d2b9,1,8,1,9,3,2010-07-27 22:15:43,2010-07-27 16:59:04
2bc93939b5e4834946efe3a8c0a7bd380b34d2b9...6239b1629aee6563c1d110d709ee1ce1f2c49ca8,3,14,14,28,7,2010-07-27 22:15:48,2010-07-27 17:46:41
3b3edcdb86d5d57a4d2672e51dca5372081f23b7...b1737a41989cf8b7280cfe66674a51c0ac0575ac,1,11,15,26,8,2010-07-28 04:40:01,2010-07-28 04:40:01
b1737a41989cf8b7280cfe66674a51c0ac0575ac...0e49e1196398dc52af9fc95f79627a641b21dc8b,1,9,12,21,9,2010-07-28 04:47:35,2010-07-28 04:47:35
0e49e1196398dc52af9fc95f79627a641b21dc8b...652006804f0b72d05c8530487d2d53cf52552a8c,1,2,0,2,1,2010-07-28 04:55:58,2010-07-28 04:55:58
652006804f0b72d05c8530487d2d53cf52552a8c...df83eb6beb559d64b941c12edd8da854166cb031,1,2,2,4,2,2010-07-28 12:23:25,2010-07-28 12:22:07
df83eb6beb559d64b941c12edd8da854166cb031...10b9b43596265d57b8d46d23060b671a109552a0,1,0,2,2,1,2010-07-28 14:35:24,2010-07-28 14:35:24
df83eb6beb559d64b941c12edd8da854166cb031...cdc48b26f1cf7ecb50c01e0bcc91b916cc2ce54a,2,55,2,57,3,2010-07-28 14:25:31,2010-07-28 14:25:31
df83eb6beb559d64b941c12edd8da854166cb031...fc89ab76e9c65bbe2b422c76bfd755c64354acba,1,86,34,120,4,2010-07-28 14:04:22,2010-07-28 14:04:22
fc89ab76e9c65bbe2b422c76bfd755c64354acba...c3175a2b9bdbff9b6f6d73399d365a4b402485fd,4,244,198,442,7,2010-07-28 14:13:56,2010-07-28 14:13:56
c3175a2b9bdbff9b6f6d73399d365a4b402485fd...c317b30cc1d250c33e3245f57c1c684e0662dab5,1,2,1,3,2,2010-07-28 14:14:39,2010-07-28 14:14:39
c317b30cc1d250c33e3245f57c1c684e0662dab5...a22ab2a7296fb63ae70cb8d8a32b6c7cfcd19122,5,75,19,94,14,2010-07-28 15:09:38,2010-07-28 15:09:38
afecaabce67b3f1e283b079e056be4b5bb4ddc8b...26828e12a959a3d293d11c342f88c2ea90d52000,6,26,29,55,18,2010-07-28 15:06:04,2010-07-28 15:06:04
cdc48b26f1cf7ecb50c01e0bcc91b916cc2ce54a...5eb93a30e6066a6ffbf417f734771c7996db0928,1,4,1,5,1,2010-07-28 14:57:31,2010-07-28 14:57:31
6ef654f43c07c96341571902935ce41eb365c51f...3f68693a61090e97076aa35af77ba8049d088d11,3,179,89,268,19,2010-07-28 16:26:38,2010-07-28 16:26:38
3f68693a61090e97076aa35af77ba8049d088d11...09c2cacddc1310af91d774c0c8fade8190be3101,3,70,58,128,5,2010-07-28 16:33:36,2010-07-28 16:33:36
09c2cacddc1310af91d774c0c8fade8190be3101...5c419679512c1752ce7d48d486d2be60ff62346a,3,82,102,184,15,2010-07-28 16:51:26,2010-07-28 16:51:26
5c419679512c1752ce7d48d486d2be60ff62346a...1965d3b3a987d30e35c5276713bc03b379da4058,3,13,10,23,5,2010-07-28 17:29:17,2010-07-28 17:29:17
1965d3b3a987d30e35c5276713bc03b379da4058...f55497b753d831189daf2437768beefeb69982a4,3,17,6,23,5,2010-07-28 17:29:36,2010-07-28 17:29:36
82fe16a3aa08b5fe7e895b40f1dcbf737b5f2673...bc3f63ebf1304f08406878fcc7f5907ae816e22a,9,66,39,105,20,2010-07-28 15:14:26,2010-07-28 15:14:26
bc3f63ebf1304f08406878fcc7f5907ae816e22a...45223e58c20a8320f9429cefa9aa4b8a4feff21e,1,1,1,2,1,2010-07-28 15:28:11,2010-07-28 15:28:11
45223e58c20a8320f9429cefa9aa4b8a4feff21e...8d6a597d6285541266c37e9a4956e7ed9da6870e,1,1,1,2,1,2010-07-28 16:24:34,2010-07-28 16:24:34
8d6a597d6285541266c37e9a4956e7ed9da6870e...6656bcd61dfdc1daaafb070fa58e81777c15f5ae,1,5,6,11,3,2010-07-28 16:35:57,2010-07-28 16:35:57
f27b7ba4f71957b576a7bf42407ae032c266cea9...6ef1fe833d0d481b2f3d7345adbc9345a229ac48,1,15,13,28,2,2010-07-28 17:42:23,2010-07-28 17:42:23
6656bcd61dfdc1daaafb070fa58e81777c15f5ae...afd32fcceff38811b918e47dd1aaba3aaf0184c2,2,8,6,14,7,2010-07-28 18:02:26,2010-07-28 18:02:26
6ef1fe833d0d481b2f3d7345adbc9345a229ac48...0053bd98336ddd7f44c584fd217c7c17bbc2b835,1,5,1,6,1,2010-07-28 18:10:25,2010-07-28 18:10:25
0053bd98336ddd7f44c584fd217c7c17bbc2b835...4b488f8a8abebe1c4961eb1386a19a1e56fce4ec,1,16,2,18,5,2010-07-28 18:10:33,2010-07-28 18:10:33
6ef1fe833d0d481b2f3d7345adbc9345a229ac48...b12d168c081519295bc7202ac3a8e868114b43a7,2,4,0,4,2,2010-07-28 17:57:50,2010-07-28 17:57:50
0e82f323cc1be77401021486f459e14cef359faa...bceacf2544acfb6c3509ca8db791e90fe41c8599,11,339,273,612,18,2010-07-28 18:24:55,2010-07-28 18:24:55
bceacf2544acfb6c3509ca8db791e90fe41c8599...684486e7e0ada96a56ec601aa0b5ca24aacffc9e,6,21,2,23,10,2010-07-28 18:46:13,2010-07-28 18:46:13
684486e7e0ada96a56ec601aa0b5ca24aacffc9e...bed8c99ab7885878a6c7630be30c325af28f278b,2,6,2,8,2,2010-07-28 20:01:28,2010-07-28 20:01:28
bed8c99ab7885878a6c7630be30c325af28f278b...4f04c6dd9442b05c17cde2ee465eb6146a3d350e,4,10,0,10,6,2010-07-28 20:30:42,2010-07-28 20:30:42
4f04c6dd9442b05c17cde2ee465eb6146a3d350e...b2822cffe956ada70d2c2ed1cc8d911f299dc4f5,6,32,16,48,14,2010-07-29 00:24:21,2010-07-29 00:24:21
b2822cffe956ada70d2c2ed1cc8d911f299dc4f5...2088a68e9a72070b4ea50baa0338c3ac9cae1f1b,1,1,1,2,1,2010-07-29 00:39:09,2010-07-29 00:39:09
2088a68e9a72070b4ea50baa0338c3ac9cae1f1b...c46d3ef193a9045a6a0b988dd94de9952b28afcc,2,11,2,13,8,2010-07-29 00:57:56,2010-07-29 00:57:56
c46d3ef193a9045a6a0b988dd94de9952b28afcc...09bc1738e8adb6206c7d772a2b99782f5e5d30d1,3,8,3,11,4,2010-07-29 02:02:15,2010-07-29 02:02:15
684486e7e0ada96a56ec601aa0b5ca24aacffc9e...44aadcec4af2af6100d3f9897fa424b56c7aa40c,1,2,1,3,1,2010-07-28 19:08:25,2010-07-28 19:08:25
44aadcec4af2af6100d3f9897fa424b56c7aa40c...861fb36234350bfa137e0c77561887bd401afaa5,1,4,1,5,2,2010-07-28 20:03:32,2010-07-28 20:03:32
861fb36234350bfa137e0c77561887bd401afaa5...8740436757ac82673fbcfdf3d38923add03a2948,4,57,20,77,13,2010-07-28 20:59:38,2010-07-28 20:59:38
8740436757ac82673fbcfdf3d38923add03a2948...fc2f3d541f14d8ddda3bd85a32f12b4c5a8b488c,2,1,3,4,2,2010-07-28 21:14:13,2010-07-28 19:02:52
fc2f3d541f14d8ddda3bd85a32f12b4c5a8b488c...3711be466ece2cb5ea5cdf54da094f481a30add8,1,3,2,5,2,2010-07-28 21:23:49,2010-07-28 21:23:49
3711be466ece2cb5ea5cdf54da094f481a30add8...afedeecec47025f265b2b1e5512c20bb0114cbe4,1,3,1,4,1,2010-07-28 21:25:36,2010-07-28 21:25:36
afedeecec47025f265b2b1e5512c20bb0114cbe4...4e8a758021a0f6b930d3470b1aba7cd588a03d74,1,1,1,2,1,2010-07-28 21:26:09,2010-07-28 21:26:09
4e8a758021a0f6b930d3470b1aba7cd588a03d74...01fd336313ca2a9174d6d45a7465f7c76a42ed3c,1,4,4,8,2,2010-07-28 21:28:47,2010-07-28 21:28:47
01fd336313ca2a9174d6d45a7465f7c76a42ed3c...3ba454f1680cbd77375c4e16807888328447a3e7,1,4,1,5,1,2010-07-28 21:33:05,2010-07-28 21:33:05
b20567ad8a1d402ffdee1a00c43a55d11e006909...ccadb776a019ef8ce0e1138afad36791ce43e96e,1,1764,1764,3528,1,2010-07-29 04:17:59,2010-07-29 04:17:59
3ba454f1680cbd77375c4e16807888328447a3e7...3068aaeba482d8de13f9fed3977976258c362a9b,1,1,1,2,1,2010-07-29 02:37:04,2010-07-29 02:37:04
3068aaeba482d8de13f9fed3977976258c362a9b...02a8ce101f6724f0a9b4fb9a80b81ab117b9466a,1,1,1,2,1,2010-07-29 02:37:09,2010-07-29 02:37:09
02a8ce101f6724f0a9b4fb9a80b81ab117b9466a...babe893b8ae7949a434c381bf2a37ef2248805b9,2,4,8,12,3,2010-07-29 02:48:51,2010-07-29 02:48:51
a8c671e058ee0e128a84b79305107d90757c3a20...421ff509756da8fe40c748d7a096575703b7d66a,1,16,0,16,1,2010-07-29 05:07:22,2010-07-29 05:07:22
421ff509756da8fe40c748d7a096575703b7d66a...9c95e894eecfd2b42d8fa44162f9f7adc2d76117,5,102,7,109,12,2010-07-29 05:08:20,2010-07-29 05:08:20
a8c671e058ee0e128a84b79305107d90757c3a20...835cd44d8051081617ec0d8b4aad33befe4485ae,1,4,1,5,2,2010-07-29 03:06:57,2010-07-29 03:05:47
835cd44d8051081617ec0d8b4aad33befe4485ae...aae8637f5b1a493944c829901051d5f8af332aae,1,1,2,3,1,2010-07-29 03:29:57,2010-07-29 03:29:24
aae8637f5b1a493944c829901051d5f8af332aae...747c54b804c88df3a4baab5b428684c987db7903,2,10,10,20,9,2010-07-29 03:29:57,2010-07-28 21:28:21
747c54b804c88df3a4baab5b428684c987db7903...ee257b964843a148e3f53ea8a898524e64d7da71,1,43,13,56,10,2010-07-29 03:29:57,2010-07-28 23:20:00
ee257b964843a148e3f53ea8a898524e64d7da71...f27bc16a32cf9d62de3fa9f496fa4a3b20289d82,1,2,9,11,4,2010-07-29 03:29:57,2010-07-28 23:29:24
f27bc16a32cf9d62de3fa9f496fa4a3b20289d82...5c0fe6cf44977367ba74be793d54d27af7aa9668,1,1,1,2,1,2010-07-29 03:29:57,2010-07-29 01:06:58
5c0fe6cf44977367ba74be793d54d27af7aa9668...819e2b08278c0608a978e89174c83ad9b084665d,2,52,6,58,10,2010-07-29 03:29:57,2010-07-29 01:18:30
819e2b08278c0608a978e89174c83ad9b084665d...684cf1c0b1c4bf56991e06238bb529409690a3ee,2,24,2,26,3,2010-07-29 03:29:57,2010-07-29 02:50:49
d16c71725ed8b450727acdb237a3df0284fbf10f...43b6582c3c3256c38b8879e5f839e5cdbfd523b9,1,0,1,1,1,2010-07-29 05:26:03,2010-07-29 05:26:03
43b6582c3c3256c38b8879e5f839e5cdbfd523b9...cd2d06fa73d0dd9394a72e41c48ca1e7984e6cff,1,1,1,2,1,2010-07-29 13:43:36,2010-07-29 13:43:36
cd2d06fa73d0dd9394a72e41c48ca1e7984e6cff...733eaafc61a0356d9e25a7bc73ae52f132bc1086,1,0,2,2,1,2010-07-29 14:38:37,2010-07-29 14:38:37
733eaafc61a0356d9e25a7bc73ae52f132bc1086...397c58b347b51fb5d3f0d1a49c62886a00d3cfb5,1,27,1,28,4,2010-07-29 15:18:41,2010-07-29 15:18:41
733eaafc61a0356d9e25a7bc73ae52f132bc1086...28fc116721a0ddd4c9cf7f612a102d66e843fa6f,1,2,1,3,2,2010-07-29 15:11:05,2010-07-29 15:10:18
86a5eab28260d8509377080c0418b3b8927d39eb...cfc079484225a90a4dfbbf0429854ced4d599fff,1,1,0,1,1,2010-07-29 15:32:03,2010-07-29 15:32:03
cfc079484225a90a4dfbbf0429854ced4d599fff...0b0d78f594960f2cc182d6259a331f7abdb35b62,1,1,6,7,2,2010-07-29 15:32:11,2010-07-29 15:32:11
0b0d78f594960f2cc182d6259a331f7abdb35b62...ec556338b0f340d7e611096d973d7a734be5d750,1,2,2,4,4,2010-07-29 15:40:36,2010-07-29 15:40:36
28fc116721a0ddd4c9cf7f612a102d66e843fa6f...f6d74dfaf9f5bca2631e764464aa9f8c7c528fe6,1,1,1,2,1,2010-07-29 15:19:54,2010-07-29 15:19:54
47f3d34997aaa0209735ae6c2f5c03daddf14756...f92ba7725b1c3558b529656f1caa15a472275d4c,3,1825,1764,3589,3,2010-07-29 16:41:02,2010-07-29 16:41:02
f92ba7725b1c3558b529656f1caa15a472275d4c...2bb009d2663f4e9113b791f6baa13baf17a7a640,3,1764,1825,3589,3,2010-07-29 16:48:34,2010-07-29 16:48:34
2bb009d2663f4e9113b791f6baa13baf17a7a640...cd405d67b69894da5b43c7350c37a1adc63262e9,2,61,0,61,2,2010-07-29 16:52:46,2010-07-29 16:52:46
cd405d67b69894da5b43c7350c37a1adc63262e9...c3bab209014401cb265934d253c0972b50e614d2,2,52,50,102,2,2010-07-29 17:31:39,2010-07-29 17:31:39
c3bab209014401cb265934d253c0972b50e614d2...bc9ffb8e0dc857eb25d0ca2e4920acfad300d5e7,1,16,2,18,2,2010-07-29 17:45:20,2010-07-29 17:45:20
c3bab209014401cb265934d253c0972b50e614d2...bce9ccd0e759921932d2e47b31d9b8b43b631039,1,1,0,1,1,2010-07-29 17:42:39,2010-07-29 17:42:12
57216c509936456a6b7c7402b2d9645481a0bb47...1d02bf780d9946e21dea0cc62e4a53f06f781034,1,13,21,34,8,2010-07-29 18:05:25,2010-07-29 18:05:25
57216c509936456a6b7c7402b2d9645481a0bb47...aedb4a8bbddb79a3c2b53bb5e6374f44af170428,1,1,0,1,1,2010-07-29 17:49:45,2010-07-29 17:49:45
aedb4a8bbddb79a3c2b53bb5e6374f44af170428...fb1e07e3639ed3aa1e977a3562c1c796f180da5f,1,1,1,2,1,2010-07-29 17:59:47,2010-07-29 17:59:47
fb1e07e3639ed3aa1e977a3562c1c796f180da5f...77222bf10fd07a533de64f974dffbfd1839c1c21,1,1,1,2,1,2010-07-29 18:00:25,2010-07-29 18:00:25
1ee1094adfcb6ffb492462976696c97440dd2548...5b3f5cbbdaa3cf709dbc3c75be840a80612f8d72,2,114,51,165,3,2010-07-29 18:29:20,2010-07-29 18:29:20
1ee1094adfcb6ffb492462976696c97440dd2548...d28fb4689d45ebb9fd3a6b2217be874a1878e5d6,1,7,2,9,2,2010-07-29 18:17:54,2010-07-29 18:17:54
77222bf10fd07a533de64f974dffbfd1839c1c21...b5ba4cff0fc96f8d461a08a6fc6e7b73ccf07c5c,2,2,2,4,2,2010-07-29 18:29:37,2010-07-29 18:29:37
f8efcbce97b1f5221217639ca9474d4fa3d80fc8...26098c0e43dc50a4293d548ff06f1aa3beda6b3e,4,15,5,20,6,2010-07-29 19:44:10,2010-07-29 19:44:10
d28fb4689d45ebb9fd3a6b2217be874a1878e5d6...3386a0a300197b6c2311781d229f9d6e656c7b1c,1,86,0,86,1,2010-07-29 21:04:49,2010-07-29 21:04:49
d28fb4689d45ebb9fd3a6b2217be874a1878e5d6...abd17d10df6a4b9363a1cfc924bf7cf33321b108,4,24,7,31,10,2010-07-29 19:01:41,2010-07-29 19:01:41
abd17d10df6a4b9363a1cfc924bf7cf33321b108...19e76968bc4bd815ced4c528581a2eac2aabd8f6,1,11,1,12,1,2010-07-29 19:08:38,2010-07-29 19:08:38
fbd6ebc48f552923a587f94f8ab244a4edcc0e17...0aecc0bfd34ff9a9f7fae568555723781b1ea429,4,25,6,31,13,2010-07-29 20:31:41,2010-07-29 20:31:41
0aecc0bfd34ff9a9f7fae568555723781b1ea429...be9891dd18abbe1c6ed0d59ac514022ef04eb2fe,1,1,1,2,1,2010-07-29 20:33:42,2010-07-29 19:33:29
be9891dd18abbe1c6ed0d59ac514022ef04eb2fe...6baeb71caf3b06ceecade2b55274b33d927993d8,2,34,13,47,8,2010-07-29 20:34:38,2010-07-29 20:32:42
6baeb71caf3b06ceecade2b55274b33d927993d8...6afb2abd7d5d6e80a5cb880dd9f426a262a97510,2,26,26,52,12,2010-07-29 20:49:43,2010-07-29 20:49:43
3256b83ac67ec4c4ee4d8fe7fd7f9c0c3a7539e9...0dcf866711d88e7782314c6919551e2aa655811a,1,3,3,6,1,2010-07-29 19:11:18,2010-07-29 19:11:18
0dcf866711d88e7782314c6919551e2aa655811a...8118364603357825f289e30f23d3d01ba70e3625,3,31,2,33,10,2010-07-29 19:35:32,2010-07-29 19:35:32
84752a719ec495d93ac4fde4d4a8e8d604daaee0...9cd0f9ec6b89ac6b8a602f075aa6ae019536148b,1,47,9,56,9,2010-07-29 21:27:48,2010-07-29 21:27:48
9cd0f9ec6b89ac6b8a602f075aa6ae019536148b...3751dd4382057b6e0448606d2a211f59ed5805f6,1,1,1,2,1,2010-07-29 22:41:18,2010-07-29 20:55:15
8118364603357825f289e30f23d3d01ba70e3625...b11475947dd85adb50e41c4b3d9fdb989ccb83a7,3,1801,1764,3565,7,2010-07-29 21:21:50,2010-07-29 21:21:50
b11475947dd85adb50e41c4b3d9fdb989ccb83a7...26058ab4a266be85cb2a4518bea115b1d9581d2d,3,10,10,20,9,2010-07-29 21:35:09,2010-07-29 21:35:09
26058ab4a266be85cb2a4518bea115b1d9581d2d...f13fb3f96e25fb9de85dcdfbea6f283af1bce413,1,1,1,2,1,2010-07-29 21:36:24,2010-07-29 21:36:24
f13fb3f96e25fb9de85dcdfbea6f283af1bce413...0cc0b603168a1d883ff4e766c72417ecfe664480,1,4,4,8,1,2010-07-29 21:44:08,2010-07-29 21:44:08
db8bd901d8be3eaeabc3a25646c3deb56e523d6d...24b98746ca1e2d20e3a998f553e5f98d6e74b76a,4,61,1,62,4,2010-07-30 14:57:21,2010-07-30 14:57:21
db8bd901d8be3eaeabc3a25646c3deb56e523d6d...ad83e5b3042f49d06ef064796b16e3630b8b712f,1,7,5,12,3,2010-07-30 14:44:43,2010-07-30 14:44:43
ad83e5b3042f49d06ef064796b16e3630b8b712f...e8cbbe629b669b7c562c9b1487fcd7a4a62700f2,1,1,1,2,1,2010-07-30 14:45:15,2010-07-30 14:45:15
e8cbbe629b669b7c562c9b1487fcd7a4a62700f2...4c7452ee14979a1209440287d473df136eb9883d,3,3,3,6,3,2010-07-30 14:45:48,2010-07-30 14:45:48
db8bd901d8be3eaeabc3a25646c3deb56e523d6d...0e12d1012f489e38153ab43b16e9441c082ea805,2,2,2,4,2,2010-07-30 14:09:47,2010-07-30 14:09:47
0e12d1012f489e38153ab43b16e9441c082ea805...96d7b5a19e8657725b89ce63a516274d22e6b165,1,1,1,2,1,2010-07-30 14:26:34,2010-07-30 14:26:34
5774d1e79bafbc8220639e358756eb5c70d30126...9300d2156b4ded29d7b877de7fa297d1670d384a,1,1,1,2,1,2010-07-30 15:04:34,2010-07-30 15:04:34
9300d2156b4ded29d7b877de7fa297d1670d384a...d58547d90bb3322fb7abbdf40fb960df14b5f737,1,5,3,8,3,2010-07-30 15:08:30,2010-07-30 15:08:30
d58547d90bb3322fb7abbdf40fb960df14b5f737...78fc92c7bcf7ca04427f8f049e6f8581fc7f26a5,1,1,1,2,1,2010-07-30 15:08:47,2010-07-30 15:08:47
5774d1e79bafbc8220639e358756eb5c70d30126...8b637b1b79db3a1df95d4b92e9a399c30000884c,1,45,0,45,1,2010-07-30 14:49:55,2010-07-30 14:49:55
2b8634ff6e9414bf22f1812f624d8925f369b939...f3fbd835d92f5bff7bf5df0294192bd98c473797,3,1778,1765,3543,5,2010-07-30 15:35:28,2010-07-30 15:35:28
f3fbd835d92f5bff7bf5df0294192bd98c473797...27c027913fd5dfc56818067ae6558c342a15f55f,2,6,3,9,4,2010-07-30 15:57:30,2010-07-30 15:57:30
2b8634ff6e9414bf22f1812f624d8925f369b939...12aa34d0fa969e7e59efc4f23357456373d3eac1,5,55,93,148,18,2010-07-30 15:20:33,2010-07-30 15:20:33
b508f62fdff2e819df9271422d98aa95543b1e95...7572badd921a2dfbcb7eb954cdb16c92ba9e92be,1,10,2,12,2,2010-07-30 16:30:34,2010-07-30 16:30:34
7572badd921a2dfbcb7eb954cdb16c92ba9e92be...44e6792db6432c80009d15f217d3ced5a0b0ab49,1,1,1,2,1,2010-07-30 16:35:01,2010-07-30 16:35:01
12aa34d0fa969e7e59efc4f23357456373d3eac1...ceda65cb2d1171a759a0d08cd185b5213f87acf5,1,9,15,24,3,2010-07-30 15:40:29,2010-07-30 15:40:29
44e6792db6432c80009d15f217d3ced5a0b0ab49...ee8252f22fb8f0a927b84d7519715b0067d8e156,2,33,10,43,9,2010-07-30 17:26:53,2010-07-30 17:26:53
44e6792db6432c80009d15f217d3ced5a0b0ab49...96ab07a306bd871915d56e77f5f7c5d96d223c8a,2,5,5,10,5,2010-07-30 17:10:22,2010-07-30 15:33:49
96ab07a306bd871915d56e77f5f7c5d96d223c8a...e07b71d91bf2d634265c613f68343f92091b23b0,2,53,13,66,6,2010-07-30 17:10:23,2010-07-30 17:09:17
5bfecc88d0ac9cc1da5e59f0cae6a8e112385efd...62310262e6f4db58d175c131ed51d8e9ebd897b4,1,28,23,51,5,2010-07-30 17:19:04,2010-07-30 17:19:04
62310262e6f4db58d175c131ed51d8e9ebd897b4...5a69c45341c23f654832f948febf793c6896e6b4,4,61,3,64,10,2010-07-30 17:21:39,2010-07-30 17:21:39
b2f7468f97c034fb97d648baa1022949f07857b8...d0bddbf88739ff9414f4ebd720cf3584a1508d04,1,4,1,5,1,2010-08-02 15:39:44,2010-08-02 15:39:44
3c2c4928c648872bf99fa9e755d83d4818a83eb6...7ce719b61ab63c96a7e09c283d52484fd90f7435,1,5,1,6,1,2010-07-30 17:56:03,2010-07-30 17:56:03
3c2c4928c648872bf99fa9e755d83d4818a83eb6...5461e05726180a40c142544cb6ec9de91a5fd0d6,1,7,7,14,8,2010-07-30 17:41:41,2010-07-30 17:41:29
a56117f97d8609e1fd061f4d95a0f961f50c65c5...6a355fc327e0c6e85af1d79b314b2e96a97c44d6,1,16,2,18,4,2010-08-02 16:16:01,2010-08-02 16:16:01
a56117f97d8609e1fd061f4d95a0f961f50c65c5...57b9d10710db98fc1750260cf97f2bc29a71aa6a,1,5,1,6,2,2010-08-02 15:48:48,2010-08-02 15:48:48
57b9d10710db98fc1750260cf97f2bc29a71aa6a...0df9b62d4c5ed00d69d6fe414d1289b5c7bbf6df,1,2,2,4,2,2010-08-02 16:05:43,2010-08-02 16:05:43
b5611894f0d8dd6730df65dce8dbd746f04d8e79...d008ee9825739da7405cfd15a614bfbfc61a4bc1,1,36,0,36,1,2010-07-30 18:47:34,2010-07-30 18:47:34
b5611894f0d8dd6730df65dce8dbd746f04d8e79...2c9fbfbcd6eb101303681891efd5bd6826f72c36,2,53,0,53,2,2010-07-30 18:02:37,2010-07-30 18:02:27
5461e05726180a40c142544cb6ec9de91a5fd0d6...67f4da9b329a48619aad048d069cafaf85253746,6,239,249,488,85,2010-07-30 18:30:02,2010-07-30 18:30:02
609ee9cc8ee5fc5932d88dc64884d55f0f44d17b...f0d3292e915a09a304c85ee5573899484472cda6,2,3,5,8,6,2010-08-02 16:27:05,2010-08-02 16:27:05
f0d3292e915a09a304c85ee5573899484472cda6...03049d854981839a671acb1af2d32db98d12dc2a,1,16,13,29,5,2010-08-02 16:27:46,2010-08-02 16:27:46
2c9fbfbcd6eb101303681891efd5bd6826f72c36...b07eeee2f1d2e1d74928f2867837ed40bd61f0f5,4,36,10,46,13,2010-07-30 19:00:19,2010-07-30 19:00:19
24d9585f9fc0b9056a0545ff961d998eccdcf57c...9b12951db2b6a3414d9637c7a9e921576b9ca3a2,2,57,3,60,7,2010-07-30 18:51:28,2010-07-30 18:51:28
03049d854981839a671acb1af2d32db98d12dc2a...4cfddfc05370cd8c0e56c7aa2566cd4b13b00354,1,2,1,3,1,2010-08-02 16:45:34,2010-08-02 16:45:34
4cfddfc05370cd8c0e56c7aa2566cd4b13b00354...11bd217ddb2b3010963c490e073727b5ab41b013,2,7,3,10,3,2010-08-02 17:19:18,2010-08-02 17:19:18
11bd217ddb2b3010963c490e073727b5ab41b013...fb86e95b068c78ca0ec58bb0f6d3a2893cd49921,1,2,1,3,2,2010-08-02 17:25:28,2010-08-02 17:25:28
8a6850bfbedede595e9431790e0529e4e6b00fcd...b6524e098654996ee613a3b7b5f1c41b6aad348a,2,6,2,8,2,2010-07-30 19:01:12,2010-07-30 19:01:12
266a499c5821383d80be7c3a3dea46c63e16259d...6a5c95a8d350f6a6b93cace865b18eca4112cf7f,1,1,1,2,1,2010-07-30 19:01:03,2010-07-30 19:01:03
fb86e95b068c78ca0ec58bb0f6d3a2893cd49921...6271b3721436679a0f3d6aef2630d6d214408309,2,38,0,38,2,2010-08-02 18:04:33,2010-08-02 18:04:33
6271b3721436679a0f3d6aef2630d6d214408309...9fe88675c552745f44438932f47531e8fe2e0a51,3,6,1,7,3,2010-08-02 18:49:51,2010-08-02 18:49:51
9fe88675c552745f44438932f47531e8fe2e0a51...d25088f9c313e1c0f33fe16dec618a92e1d529f2,5,84,2,86,20,2010-08-02 18:50:12,2010-08-02 18:50:12
fb86e95b068c78ca0ec58bb0f6d3a2893cd49921...0803b34ff6546e91efeceddb79ab3172e615fe7a,2,18,3,21,5,2010-08-02 17:49:20,2010-08-02 17:49:20
a003db68839fa7d161ace0fed91aa2c8b81448da...7d5861a7c65eab57f725e9bea9a1532e48835a66,1,2,3,5,3,2010-07-30 19:11:19,2010-07-30 19:11:19
16a8abcec1f612be9952d8f7c83fb1166cef515c...fbf29ae5fdf303573bc6b2f6a7abb7e32500b1b5,2,29,28,57,2,2010-08-02 19:00:47,2010-08-02 19:00:47
fbf29ae5fdf303573bc6b2f6a7abb7e32500b1b5...85c5f3f72fde6b10b74e8f3bbb7c336c239fc6c0,1,3,0,3,3,2010-08-02 19:05:41,2010-08-02 19:05:41
767be19281d186f7e42d506be7e1cd50e09d47e9...ead8bad5b2b2b95d6a63a40783bf3fdaa215ef65,5,137,2,139,7,2010-08-02 21:26:14,2010-08-02 21:26:14
767be19281d186f7e42d506be7e1cd50e09d47e9...5c9384185838ed68282079688439f883cac31bbb,1,1,1,2,1,2010-08-02 18:14:52,2010-08-02 18:14:52
5c9384185838ed68282079688439f883cac31bbb...d949b32d3ca9f492d486a9dc1b42752a987b690a,1,6,1,7,3,2010-08-02 18:21:44,2010-08-02 18:21:44
d949b32d3ca9f492d486a9dc1b42752a987b690a...c43462c6b06a49a4319f2483829b34979e09334a,4,29,7,36,9,2010-08-02 18:37:10,2010-08-02 18:37:10
c43462c6b06a49a4319f2483829b34979e09334a...08eaec0599ef06a4f0db5b05ebbc051617d01a76,9,17,5,22,12,2010-08-02 18:44:53,2010-08-02 18:44:53
08eaec0599ef06a4f0db5b05ebbc051617d01a76...4c243706fab61f8e6ea0d99e16cc4b2a1fb1e75a,1,1,0,1,1,2010-08-02 18:48:38,2010-08-02 18:48:38
7d5861a7c65eab57f725e9bea9a1532e48835a66...91f671ea537a7c6f15ef44148dc4171380550532,2,5,2,7,2,2010-07-30 19:41:54,2010-07-30 19:41:54
7d5861a7c65eab57f725e9bea9a1532e48835a66...14482d8cc191644a554ce8bd2da2927b2e3e6f01,1,10,8,18,4,2010-07-30 19:34:11,2010-07-30 19:34:11
78516cc53b3c2e6c8b30b0229321bb149306b933...a954509488bbc78ac963086565b66b3bd76aa582,1,2,1,3,1,2010-08-02 19:10:08,2010-08-02 19:10:08
8d19dceb1f7c39116adda1ebd4ad84f93a5131ad...1ec6fb1d4bad345763c23f1dc7b700f1d51b51e4,10,50,40,90,23,2010-08-02 19:21:26,2010-08-02 19:21:26
45f9479547d6ca0f263e1d266914a2d113723e65...e6ad6ecb02f38864b2952b44d64a060829ab2776,7,23,19,42,20,2010-08-02 22:43:53,2010-08-02 22:43:53
4c243706fab61f8e6ea0d99e16cc4b2a1fb1e75a...3865b25743dc371206efd887e40e43eb637239e6,1,1,1,2,1,2010-08-02 19:00:00,2010-08-02 19:00:00
a991965b633476e93ed02b417fdc419279b9d4fa...7ac57c56e42c0235d20e836025cd35d404a9c759,3,15,1,16,6,2010-07-30 20:21:28,2010-07-30 20:21:28
14482d8cc191644a554ce8bd2da2927b2e3e6f01...272755d255e29b9951bb20c9c947736b1a0bc6ef,1,2,0,2,1,2010-07-30 20:04:54,2010-07-30 20:04:54
a954509488bbc78ac963086565b66b3bd76aa582...e53c67abab75e803dbab22d7a132321a722d32b9,3,23,4,27,5,2010-08-02 19:17:24,2010-08-02 19:17:24
a954509488bbc78ac963086565b66b3bd76aa582...07d12c233647a34c72486fa03f38a787d3d4c0c6,1,29,5,34,7,2010-08-02 19:13:27,2010-08-02 19:13:27
0a0de87f9da023af1ae29fd043698e8e4298d0a1...44d39a27af7230f3c8a014598101d748e9bffb68,1,1,1,2,1,2010-08-02 19:22:42,2010-08-02 19:22:42
37b38182b30086f44cfb75ddbcbc65aab1bcbf0f...705cd42057d69837e148d89e5ae3628176a10841,1,7,1,8,1,2010-08-02 23:39:10,2010-08-02 23:39:10
378a39aba36032d154696c3de190a16a4f710d50...3f0ebaf81fdfa6308359d5eebcfe8a73b3aea4f9,1,7,7,14,5,2010-08-02 21:52:33,2010-08-02 21:52:33
a02aa2b76dabdf6de397fabb2731871822e36c44...07a26b5dfa916518727ba7c539dff1357743a7b3,1,8,0,8,2,2010-08-02 22:14:04,2010-08-02 22:14:04
39a3e9f4a1b209014d4384b8a74f79d37fed1708...6a2409d5d2b150a3a72aa1e6f717f9f47be79f7b,2,15,3,18,4,2010-07-31 14:46:52,2010-07-31 14:46:52
39a3e9f4a1b209014d4384b8a74f79d37fed1708...f4578edbe534d2f2c27e9d5dc7f840752881570c,2,51,7,58,6,2010-07-30 20:41:42,2010-07-30 20:22:54
81139cb6668d88f43a26900a13aaa591f08a785c...66ca3f3c73a0798a1f9acec9976c9132925ef120,1,11,1,12,6,2010-07-30 20:11:00,2010-07-30 20:11:00
5b32824eb60536ac892666dc39d12aa40ffa6654...6fb8034fc91467050881cd62305bb03ff0aeee73,1,1,0,1,1,2010-08-02 20:41:03,2010-08-02 20:41:03
44d39a27af7230f3c8a014598101d748e9bffb68...f7f1fa26c27dc794f62ec5a0f7e82dd7361dcec4,1,22,17,39,6,2010-08-02 19:45:58,2010-08-02 19:45:58
44d39a27af7230f3c8a014598101d748e9bffb68...24c14d3a812be8f1ae57934f17a7b39dba099736,1,2,1,3,2,2010-08-02 19:42:46,2010-08-02 19:42:46
44d39a27af7230f3c8a014598101d748e9bffb68...0747434366d5db752732596fe3a1318c65f0d8f4,1,2,0,2,1,2010-08-02 19:34:54,2010-08-02 19:26:22
5a52bca5dd9952119aad7e8ba3395535f7deec30...86c72c061a597dc03f0605abeff829b262d1b908,4,23,0,23,6,2010-08-03 05:27:53,2010-08-03 05:27:53
5a52bca5dd9952119aad7e8ba3395535f7deec30...fd600969e0eccdfce48bb93fadaecc5daed64129,1,6,0,6,1,2010-08-03 03:23:53,2010-08-03 03:23:53
fd600969e0eccdfce48bb93fadaecc5daed64129...41e7ed783c3cc5b6e46483a3024e2278a76a537a,2,7,8,15,8,2010-08-03 04:07:34,2010-08-03 04:07:34
41e7ed783c3cc5b6e46483a3024e2278a76a537a...1ca78f4813095d8a454be49d8472ffd3aaaa2fcd,1,17,17,34,1,2010-08-03 04:35:44,2010-08-03 04:35:44
1ca78f4813095d8a454be49d8472ffd3aaaa2fcd...dde3464141b636123cff33ea45479ac9e6c9fe7d,3,103,8,111,7,2010-08-03 05:18:12,2010-08-03 05:18:12
2daef961134202b866a580551e17c6985393656b...58faef15a156e554dd5c4a60b14ec28e0b219d30,2,90,5,95,3,2010-08-02 23:26:50,2010-08-02 23:26:50
3f0ebaf81fdfa6308359d5eebcfe8a73b3aea4f9...33015eed5f2ae9b9dc0ff61a68385e4dc0a0ad19,1,3,3,6,3,2010-08-02 22:07:55,2010-08-02 22:07:55
404c66e76fb7e8c746277a74a89a794669126160...781ff20ee66371a5342bc86e7cbb2cdf2e01f8b3,2,129,113,242,7,2010-07-31 16:34:35,2010-07-31 16:34:35
781ff20ee66371a5342bc86e7cbb2cdf2e01f8b3...f05157439cd90b76f1ab840aac3478037e32bfe4,1,1,1,2,1,2010-07-31 17:56:03,2010-07-31 17:56:03
f05157439cd90b76f1ab840aac3478037e32bfe4...27e404fa08fcc86cd54f3e3e29ef2e34bf579b13,2,12,3,15,8,2010-08-01 05:02:51,2010-08-01 05:02:51
27e404fa08fcc86cd54f3e3e29ef2e34bf579b13...5b97b6241e95c446e1cd1f51ffc63bd47266832b,1,7,0,7,1,2010-08-01 05:36:17,2010-08-01 05:36:17
5b97b6241e95c446e1cd1f51ffc63bd47266832b...6aab3be154c3f995270d6adb4fbe206f50a74d23,1,28,0,28,1,2010-08-01 06:02:10,2010-08-01 06:02:10
f74379b4d26de400fd438968fd5443650c29d13e...5b667e49b1c88f201cdd3912b3d1d1c1098a25b4,4,11,3,14,4,2010-07-30 20:22:38,2010-07-30 20:22:38
5b667e49b1c88f201cdd3912b3d1d1c1098a25b4...4478f8c9c11159a38a81acb4c846e3c160675b64,1,1,1,2,1,2010-07-30 22:55:54,2010-07-30 22:55:54
4478f8c9c11159a38a81acb4c846e3c160675b64...dba5ecbdb6683758d09a5984f56075ba03f4ee6e,1,16,8,24,4,2010-07-30 22:56:05,2010-07-30 22:56:05
dba5ecbdb6683758d09a5984f56075ba03f4ee6e...18ff2014651c88aa0cabcd6fd652026d00f60918,3,65,25,90,13,2010-07-30 23:55:56,2010-07-30 23:55:56
18ff2014651c88aa0cabcd6fd652026d00f60918...80a3a932536f115a2ccc35db8f1a7d40ea4d6172,1,5,0,5,2,2010-07-31 02:38:18,2010-07-30 22:44:17
80a3a932536f115a2ccc35db8f1a7d40ea4d6172...59674dfb56fd4a8aa8295c4b6b6cb059cafb8ce6,2,12,4,16,5,2010-07-31 02:38:18,2010-07-30 22:45:14
59674dfb56fd4a8aa8295c4b6b6cb059cafb8ce6...21b3abe03b6741b0d291f37a84d37a13c179e492,1,59,0,59,1,2010-07-31 02:38:18,2010-07-30 22:45:41
21b3abe03b6741b0d291f37a84d37a13c179e492...2e41c3387c88301efde1bf8cb38a89d7b2610ee5,1,33,0,33,6,2010-07-31 02:38:18,2010-07-31 02:16:31
2e41c3387c88301efde1bf8cb38a89d7b2610ee5...c226367562e0192007ab91d6082fb8cd7ec83486,1,0,33,33,6,2010-07-31 05:56:38,2010-07-31 05:56:38
c226367562e0192007ab91d6082fb8cd7ec83486...71382e7fad89c0187817e108055647ce9a92d2ba,1,5,1,6,4,2010-07-31 06:18:56,2010-07-31 06:18:56
71382e7fad89c0187817e108055647ce9a92d2ba...4fc09de4b7c4d68341dc2a14a3d9677a12643fc4,1,1,1,2,1,2010-07-31 06:19:21,2010-07-31 06:19:21
4fc09de4b7c4d68341dc2a14a3d9677a12643fc4...6af11e163bb744d29c2c12c97ed1024bfdf73ef9,1,5,1,6,2,2010-07-31 13:45:54,2010-07-31 13:45:54
6af11e163bb744d29c2c12c97ed1024bfdf73ef9...55a26fdcfcb0e1decff638e4972eedda53716639,2,13,5,18,5,2010-07-31 13:50:07,2010-07-31 13:50:07
d524776cf6878dbcac66ed9d14ff0adda570400e...a5c5f23701d7ae950985bfe519c9ac6f61031f23,2,8,0,8,3,2010-08-02 20:14:09,2010-08-02 20:14:09
d524776cf6878dbcac66ed9d14ff0adda570400e...67e97645bd0a12587954675d9b9f5b0407de86b0,1,71,0,71,1,2010-08-02 20:06:06,2010-08-02 20:05:29
5240b2c0ff2b0f0f3999e456ac0b493d77153735...701dc65282b7e154aca20ae1882ae7962c11e0b2,16,197,73,270,74,2010-08-04 03:09:16,2010-08-04 03:09:16
5240b2c0ff2b0f0f3999e456ac0b493d77153735...8a05c6d4e2b87872ffaab5afefed79756d076a8b,2,2,1,3,2,2010-08-03 13:29:08,2010-08-03 13:29:08
8a05c6d4e2b87872ffaab5afefed79756d076a8b...bc3fb228b18a3bfc6b0db399fdea88d91f2a62db,1,1,1,2,1,2010-08-03 13:39:22,2010-08-03 13:39:22
5240b2c0ff2b0f0f3999e456ac0b493d77153735...d85c39b69df89a59bedfdc1f933e2925a1212737,3,65,57,122,7,2010-08-03 13:13:53,2010-08-03 13:13:53
d85c39b69df89a59bedfdc1f933e2925a1212737...4dbf25dba0f4b55f9e3f1aea3e28ccac1603b1d3,2,2,2,4,2,2010-08-03 13:29:58,2010-08-03 13:29:58
4dbf25dba0f4b55f9e3f1aea3e28ccac1603b1d3...7207fe34dcb37bf0e284fa3d451ae6e858659b16,4,24,6,30,12,2010-08-03 13:47:03,2010-08-03 13:47:03
08553995db551f0080c5d611c7b704ef9ac4d43f...1fc830e7ba4cf8fd96192a9eb5a8c65134ce493a,2,17,1,18,3,2010-08-02 22:48:24,2010-08-02 22:48:24
08553995db551f0080c5d611c7b704ef9ac4d43f...c546c6e51276130d8fff5b023987e70e0f5d2e7d,2,6,16,22,3,2010-08-02 22:08:37,2010-08-02 21:54:40
c546c6e51276130d8fff5b023987e70e0f5d2e7d...8c8070a6fc71b3766bb6fac47b81130d0ae1dfb8,3,6,4,10,5,2010-08-02 22:08:37,2010-08-02 22:07:41
6aab3be154c3f995270d6adb4fbe206f50a74d23...8a95b40c90ed32259a94de6434e55630552e8bd0,2,3,1,4,2,2010-08-01 08:05:14,2010-08-01 08:05:14
6aab3be154c3f995270d6adb4fbe206f50a74d23...5b35e31bc6fef0f195448202f02a714e09663eaf,1,1,1,2,1,2010-08-01 06:40:57,2010-08-01 06:40:57
5b35e31bc6fef0f195448202f02a714e09663eaf...e722328b99c295eaef6e47eceb6bda0ca4747ea7,1,2,2,4,2,2010-08-01 07:00:23,2010-08-01 07:00:23
e722328b99c295eaef6e47eceb6bda0ca4747ea7...b9702d2b7673a0c53567d89ed150f796a21e7397,1,3,3,6,2,2010-08-01 07:47:53,2010-08-01 07:47:53
b92904a8d1efb711bf67a00ce4f3934e90aaf072...16ff280c3f5bb0e9a539651d240706a86fc1cfeb,1,29,3,32,6,2010-08-02 17:38:01,2010-08-02 17:38:01
ac6da0f2e0ce36a9927f8b83964af5388b0498fa...4d2d1c4fb43312a858583bf1bb21733cac2b1eb8,1,8,3,11,2,2010-08-02 21:52:13,2010-08-02 21:52:13
e1e43116a60ac6dd1435e3d58e35953a8d9ddb73...cafe5555c97eb1d37df7a0147058d14018edab2a,4,38,14,52,5,2010-08-02 20:21:14,2010-08-02 20:21:14
e66ae485e90fb1b11df82f21f71a761b0ba9571b...efd0f7459b7ecb45ce1371ae46768370d44ddc92,1,1,1,2,1,2010-08-04 13:38:55,2010-08-04 13:38:55
bc3fb228b18a3bfc6b0db399fdea88d91f2a62db...c6841017ac1c410749ff04a26ecf2e9ec6d9b191,1,0,1,1,1,2010-08-03 14:40:35,2010-08-03 14:40:35
bc3fb228b18a3bfc6b0db399fdea88d91f2a62db...10ddb86f5ffdb98b801cb839a00e795d1cdeaba3,1,7,0,7,1,2010-08-03 13:44:42,2010-08-03 13:44:42
c01bef0ef1b8bce7977e0896830210f104a7d86a...68e46ada1573f6515e2687acaa887a8e385691d7,1,11,4,15,3,2010-08-03 14:01:15,2010-08-03 14:01:15
c01bef0ef1b8bce7977e0896830210f104a7d86a...9086cd331d6d6f42f71b6c1f8fd4a71e7a6a32c3,3,13,14,27,10,2010-08-03 13:58:15,2010-08-03 13:58:15
b9702d2b7673a0c53567d89ed150f796a21e7397...537260a657c5b1199894e6e5bdd6ea303c533cd4,2,13,1,14,3,2010-08-01 08:08:36,2010-08-01 08:08:36
5285a91815538649742edc16786937efe9656d3f...dbc11f0fdfd943fbf7bdb21a9040be799a9b4f8e,2,24,2,26,12,2010-08-02 21:15:44,2010-08-02 21:15:44
cafe5555c97eb1d37df7a0147058d14018edab2a...37be79e22469ed1632c95290fc5269cdc989bcdb,2,6,3,9,5,2010-08-02 20:54:09,2010-08-02 20:54:09
cafe5555c97eb1d37df7a0147058d14018edab2a...c625aa099d9404573ec47ae25cfd02230dfd8d88,5,28,20,48,7,2010-08-02 20:38:38,2010-08-02 20:38:38
efd0f7459b7ecb45ce1371ae46768370d44ddc92...8781354dd7a4180a40c77b429935ddda2702e52b,3,1787,1768,3555,4,2010-08-04 16:19:16,2010-08-04 16:19:16
efd0f7459b7ecb45ce1371ae46768370d44ddc92...07b29e2099c205f50a7d3beb161d5bf8aef0d81f,1,1,0,1,1,2010-08-04 14:25:06,2010-08-04 14:25:06
efd0f7459b7ecb45ce1371ae46768370d44ddc92...33b7eb758b5cff2e35ee21e639e3bd7166d94e7b,1,12,3,15,5,2010-08-04 14:11:49,2010-08-04 14:11:49
33b7eb758b5cff2e35ee21e639e3bd7166d94e7b...0c7255753d2cdbefed6edf777e0b784bfb2834a9,1,1,0,1,1,2010-08-04 14:19:45,2010-08-04 14:19:45
989d740a75f72e85d75b9b54b2627dacade590c9...7620a8d7b3eced9900c6161b9bff09255051b42b,1,59,14,73,16,2010-08-03 14:56:05,2010-08-03 14:56:05
7620a8d7b3eced9900c6161b9bff09255051b42b...4cb2fac206b4d11b7f3f6cf734319488db872d52,1,1,2,3,1,2010-08-03 15:03:36,2010-08-03 15:03:36
87f261a9955b36dd0334c336ac6edbf6c9d81ec9...285e6e9e655122906a11b0065cad370652393312,1,1,1,2,1,2010-08-03 14:06:00,2010-08-03 14:06:00
285e6e9e655122906a11b0065cad370652393312...ca2a95aaf3a1bd7aa1c67203143469ea4b17172d,1,1,1,2,1,2010-08-03 14:11:11,2010-08-03 14:11:11
cad51920ecf8252125f10d0612855dc90849a32a...9cd46ae5fa99ce71e51164e831840a9de0c7191d,3,121,107,228,13,2010-08-01 14:58:12,2010-08-01 14:58:12
9cd46ae5fa99ce71e51164e831840a9de0c7191d...76bd2b46454ff6a9261ef3d02ce63d0b1ae8714c,4,25,11,36,12,2010-08-01 15:42:16,2010-08-01 15:42:16
76bd2b46454ff6a9261ef3d02ce63d0b1ae8714c...f1472cea7c1847289c60aa0abd66cb491084e436,2,15,7,22,7,2010-08-01 16:05:50,2010-08-01 16:05:50
dbc11f0fdfd943fbf7bdb21a9040be799a9b4f8e...96e86cf883d9458b6c39c343008c2a51643c1593,1,0,2,2,2,2010-08-02 21:26:28,2010-08-02 21:26:28
bdc79d0963c7fb8109b3797d713114bb1584c342...ac5914b66f01fdbcbbfdc77dcf90a816b1d27914,1,7,6,13,2,2010-08-02 20:58:17,2010-08-02 20:58:17
c625aa099d9404573ec47ae25cfd02230dfd8d88...f76fe95f0d03df3c1d297f35f7401ef7989a26f0,2,15,5,20,5,2010-08-02 20:56:11,2010-08-02 20:56:11
c625aa099d9404573ec47ae25cfd02230dfd8d88...638973cfa5112518212acdb38cabe55e1c1c082e,1,46,0,46,1,2010-08-02 20:52:37,2010-08-02 20:52:00
742752771af93e04258a0bee8b81db9ade34c0fd...e1bc087231460b2984fd75da3b0d1f12eaf6af9e,3,11,5,16,7,2010-08-04 14:50:53,2010-08-04 14:50:53
742752771af93e04258a0bee8b81db9ade34c0fd...53ac46bf46f74f26b6fb67e5a9a139c5f3391278,1,0,5,5,1,2010-08-04 14:33:05,2010-08-04 14:32:26
0c7255753d2cdbefed6edf777e0b784bfb2834a9...3e285b5d682dce36921145d7fe8567fb257d3429,1,3,3,6,3,2010-08-04 15:50:03,2010-08-04 15:50:03
3e285b5d682dce36921145d7fe8567fb257d3429...51ac96b84420846af5dc6e5ca8d142e48834bbb8,2,73,4,77,4,2010-08-04 15:50:15,2010-08-04 15:50:15
4cb2fac206b4d11b7f3f6cf734319488db872d52...a67fc0b576096f363420ff2ac236512d9239da23,2,2,2,4,2,2010-08-03 15:19:19,2010-08-03 15:19:19
4cb2fac206b4d11b7f3f6cf734319488db872d52...c8ae18d4b4118443bd084be51d75669113eb79dc,6,50,43,93,11,2010-08-03 15:08:08,2010-08-03 15:08:08
f1472cea7c1847289c60aa0abd66cb491084e436...32e38c18cb304c7d49fe18b59c37772bbc4af870,10,136,26,162,24,2010-08-02 18:03:33,2010-08-02 18:03:33
32e38c18cb304c7d49fe18b59c37772bbc4af870...59629331f9aa96e6610ddbe6163777a039d197f0,1,6,1,7,2,2010-08-02 15:03:01,2010-08-02 15:03:01
f1472cea7c1847289c60aa0abd66cb491084e436...d09e8b190e58a422dfb76e350d7116fdd3b22c3d,1,1,1,2,1,2010-08-01 18:34:14,2010-08-01 18:34:14
d09e8b190e58a422dfb76e350d7116fdd3b22c3d...5d8c217a5655d4d20a492023227b2396febc070e,1,79,34,113,23,2010-08-01 18:54:06,2010-08-01 18:54:06
5d8c217a5655d4d20a492023227b2396febc070e...89bdf674ea231241ee0263cb2fc99f5f0eb9d3a6,1,1,0,1,1,2010-08-01 20:58:59,2010-08-01 20:58:59
89bdf674ea231241ee0263cb2fc99f5f0eb9d3a6...1f153334dd4f2dde0416f567c67f6776f6443843,2,4,3,7,3,2010-08-01 23:53:25,2010-08-01 23:53:25
1f153334dd4f2dde0416f567c67f6776f6443843...74a6d11e6b7a74293f4b70aa9e36ca0bb6c317de,3,6,16,22,7,2010-08-02 02:22:14,2010-08-02 02:22:14
74a6d11e6b7a74293f4b70aa9e36ca0bb6c317de...cd0cd9912db7a0945a316f04e31e221be5c0d3ea,1,6,2,8,4,2010-08-02 02:44:45,2010-08-02 02:44:45
cd0cd9912db7a0945a316f04e31e221be5c0d3ea...3f77dcec4399617febcb44f1160ac2049a5e656f,1,2,2,4,2,2010-08-02 03:17:07,2010-08-02 03:17:07
3f77dcec4399617febcb44f1160ac2049a5e656f...9cc9c1d2a0c46f90fd7e960ae86d8906b41efa62,2,23,4,27,4,2010-08-02 13:25:20,2010-08-02 13:25:20
b7462314c472a16d11684084144b05ddff313146...c8f11dff74ca5f9dc02c142ab31be84bf48566e9,4,27,15,42,15,2010-08-04 17:28:11,2010-08-04 17:28:11
b7462314c472a16d11684084144b05ddff313146...b83039e74423a5d628fe87ee4799c71cef694ba6,1,2,1,3,1,2010-08-04 17:04:49,2010-08-04 17:00:41
b83039e74423a5d628fe87ee4799c71cef694ba6...08849578eca41e600b0e8018fa25160abc2762c3,1,14,0,14,1,2010-08-04 17:04:49,2010-08-04 17:00:53
5168e9cbebfebd9c5ec327521f7e174c7d46ca62...660d4132eec26161c934345b1c47e1dfe90a05d9,3,3,5,8,4,2010-08-04 14:55:11,2010-08-04 14:55:11
660d4132eec26161c934345b1c47e1dfe90a05d9...c5ca6d00eec9d6b5c636fcd6e9fc85ee3b5a5aa9,4,41,15,56,14,2010-08-04 15:42:20,2010-08-04 15:42:20
e093f4639851d44cffbe03c7e5161724fdecbae5...de136efe0342afc9851cec12a0aa4ab99181d533,1,3,3,6,3,2010-08-04 16:09:36,2010-08-04 16:09:36
fd10e8b430ee42cda42c5706440c6dffe2078a1f...2ee5f5272073155d0e1996f4bc8ee37d233c510a,1,33,34,67,14,2010-08-03 15:34:16,2010-08-03 15:34:16
fd10e8b430ee42cda42c5706440c6dffe2078a1f...625115721c13c93c2b17bab9bc0d686322fa9546,2,8,5,13,4,2010-08-03 15:26:39,2010-08-03 15:26:39
4165ecaf7b46c9033ac18514759f4dfffa98437a...8e84776ef89efba36383868267c5ad3ce93d0b06,1,1,1,2,1,2010-08-02 15:13:45,2010-08-02 15:13:45
9cc9c1d2a0c46f90fd7e960ae86d8906b41efa62...513fe21fc3c38782476ee4c4d6225629591161fe,2,2,1,3,2,2010-08-02 13:45:19,2010-08-02 13:45:19
513fe21fc3c38782476ee4c4d6225629591161fe...cf576485f418d3c2eb5f223507d4f0b1267d4dd3,1,1,1,2,1,2010-08-02 15:01:36,2010-08-02 15:01:36
cf576485f418d3c2eb5f223507d4f0b1267d4dd3...1b194a97c571b0c901ed0ca9d8935d0565000f59,3,63,15,78,22,2010-08-02 15:02:16,2010-08-02 15:02:16
486f3267b4a3795a936b4e9b96004392d310c305...cf34ed8daf306a26879c033a06a17c2e332b7d2a,2,10,0,10,2,2010-08-04 19:15:10,2010-08-04 19:15:10
c5ca6d00eec9d6b5c636fcd6e9fc85ee3b5a5aa9...9c19c738a489e3dd50f2a3f7d6db6b2a49579b7d,2,30,8,38,6,2010-08-04 16:13:22,2010-08-04 16:13:22
ec84f261d14c70072075757abc33ed646f0e4fc5...bed0983cc0a94b219eff1f058119cf6169dc2ee4,1,20,0,20,6,2010-08-04 16:32:44,2010-08-04 16:32:44
fe32e94cf76fd3a642b467403a4b2939eb666445...bf8be2f5e3dafdddaa1bd14ce9d47e8e7b275e0f,1,147,0,147,1,2010-08-03 16:05:46,2010-08-03 16:05:46
bf8be2f5e3dafdddaa1bd14ce9d47e8e7b275e0f...7c48f85a2b806030edd38cbde286d564d24be14d,1,3,1,4,1,2010-08-03 16:06:50,2010-08-03 16:06:50
625115721c13c93c2b17bab9bc0d686322fa9546...c970eb624fde1691e3e48e926565003829ac527b,2,5,2,7,3,2010-08-03 15:47:47,2010-08-03 15:47:47
8e84776ef89efba36383868267c5ad3ce93d0b06...de53ef23702a747d12617c62d60d2cf71f71f53a,1,7,2,9,4,2010-08-02 15:56:41,2010-08-02 15:56:41
1b194a97c571b0c901ed0ca9d8935d0565000f59...4d6f5306c59d80af7e87c6293ab993c9845d88e1,1,2,1,3,2,2010-08-02 15:28:09,2010-08-02 15:28:09
cf34ed8daf306a26879c033a06a17c2e332b7d2a...9a0ca34b357fd01000d976bef6dd0ec2cec0daf2,2,13,3,16,3,2010-08-04 19:43:43,2010-08-04 19:43:43
cf34ed8daf306a26879c033a06a17c2e332b7d2a...4dd6fa47f15a542f33206060b287e92521031162,1,1,0,1,1,2010-08-04 19:37:14,2010-08-04 19:36:53
880b9ac32f8d023013f2b18f11d0e5f0f82085c3...ccb1bee3d9325562e95cd3a747460858898db17d,1,27,6,33,9,2010-08-03 17:02:08,2010-08-03 17:02:08
c970eb624fde1691e3e48e926565003829ac527b...53f0ff18bbd45e18f9c377d0c954358eb8c9b05a,1,4,1,5,1,2010-08-03 15:49:10,2010-08-03 15:49:10
53f0ff18bbd45e18f9c377d0c954358eb8c9b05a...1d3ae44cf1af8035a0488f0808da6aedd512a5e9,1,2,1,3,1,2010-08-03 15:49:21,2010-08-03 15:49:21
1d3ae44cf1af8035a0488f0808da6aedd512a5e9...69207258a19b68fbbbc1377f61b00a9124d78c90,2,115,12,127,8,2010-08-03 16:21:56,2010-08-03 16:21:56
8f172e8262b6a4175c3536c56ff4f2135662ab74...dde04ae363ffecf976b9574f48af5cae91f28670,2,4,4,8,4,2010-08-04 19:56:38,2010-08-04 19:56:38
dde04ae363ffecf976b9574f48af5cae91f28670...1cec02512773b02cbb3b2b857b125d6504e30ed4,1,1,1,2,1,2010-08-04 19:58:22,2010-08-04 19:58:22
1cec02512773b02cbb3b2b857b125d6504e30ed4...8fc8c8c31516dd7062cab857886520c74ec87147,1,6,4,10,2,2010-08-04 20:02:49,2010-08-04 20:02:49
4dd6fa47f15a542f33206060b287e92521031162...a78d339bb8f984f8a35ea8e78f348bc008ccb39d,1,1,1,2,1,2010-08-04 21:02:43,2010-08-04 21:02:43
e8898377a92c44b6d248d921d2e3e221c84cd1c2...ad89486dfb39e0d2bf5936aa3950a974da4de762,1,5,0,5,3,2010-08-03 17:03:43,2010-08-03 17:03:43
ad89486dfb39e0d2bf5936aa3950a974da4de762...9701370edf60e8864403a21e4fc357552e84ccd2,1,1,1,2,1,2010-08-03 17:04:17,2010-08-03 17:04:17
9701370edf60e8864403a21e4fc357552e84ccd2...b21a7bbfddebd96575d6eebd8e45d20751b89d10,1,5,1,6,3,2010-08-03 17:10:43,2010-08-03 17:10:43
cb23634f39f008a4ef8f769f1a5cd13ff9a89fc9...b1cc79ccc9ef6efe23ef5556b19a6a1f27a1f3d0,4,9,3,12,4,2010-08-03 16:23:28,2010-08-03 16:23:28
b1cc79ccc9ef6efe23ef5556b19a6a1f27a1f3d0...f35d46318b2dc91e38a3c566f89e382f6c03b2c9,1,4,2,6,1,2010-08-03 16:52:18,2010-08-03 16:52:18
4c3c94e705e833f93dd6a2f0ebc4b4067cd0e816...7b9d5bc04b4fe21466a41c2fe228716b0d6e7b5f,2,2,2,4,2,2010-08-04 22:55:58,2010-08-04 22:55:58
7b9d5bc04b4fe21466a41c2fe228716b0d6e7b5f...c116e1b3950471a3cd3a8c97614a71c432e30500,1,1,1,2,1,2010-08-05 13:39:32,2010-08-05 13:39:32
b21a7bbfddebd96575d6eebd8e45d20751b89d10...c74017704115788be868058ec0e1b8ce055561be,5,83,12,95,14,2010-08-03 18:13:53,2010-08-03 18:13:53
c74017704115788be868058ec0e1b8ce055561be...c23fc0b083ffa6e6190e2c5038d0d4c4156deb64,2,33,4,37,4,2010-08-03 18:32:01,2010-08-03 18:32:01
c23fc0b083ffa6e6190e2c5038d0d4c4156deb64...beaf89b124fadf8f63e2077346039880ab6eac81,3,30,4,34,6,2010-08-03 19:00:56,2010-08-03 19:00:56
f35d46318b2dc91e38a3c566f89e382f6c03b2c9...6b3335aea5e5ca1ee0fdca8bbdc54c37b178bd64,2,12,7,19,5,2010-08-03 18:01:12,2010-08-03 18:01:12
c116e1b3950471a3cd3a8c97614a71c432e30500...c00eb76269a9cc474b54904e4e6b2ff4ae26af22,2,2,2,4,2,2010-08-05 15:52:42,2010-08-05 15:52:42
c116e1b3950471a3cd3a8c97614a71c432e30500...fd94900d91769a454efff73e755d62da45a8e508,2,22,20,42,7,2010-08-05 15:52:14,2010-08-05 15:52:14
26ee075b04e3d88bbb299b0d205717c2171dccac...00ca6aed55f523bec23ab60c5682387328d84c7a,2,19,7,26,4,2010-08-03 19:19:34,2010-08-03 19:19:34
53e72def83fbed38bef3f3eead43a307a37d8f09...d151179723a3d8a1f86b1a99a383e5ea1999e9ce,1,1,1,2,1,2010-08-03 18:51:30,2010-08-03 18:51:30
d151179723a3d8a1f86b1a99a383e5ea1999e9ce...0f1e1e2c267a1b10c894e0048b9a523970841500,1,1,0,1,1,2010-08-03 19:18:47,2010-08-03 19:18:47
a409e6571f6197020650144fc731e26dc27b0f6b...89dd76f2796a92d563cec36a5afc3a733cae11bc,1,5,0,5,1,2010-08-06 14:42:26,2010-08-06 14:42:26
a409e6571f6197020650144fc731e26dc27b0f6b...bb664cd49e8f4dfd30c1603d39d60797edbff07c,1,1,1,2,1,2010-08-06 14:14:24,2010-08-06 14:13:51
bb664cd49e8f4dfd30c1603d39d60797edbff07c...5d307a6bba596e28f40a55d0ddcdafa1c24d7597,1,10,10,20,3,2010-08-06 14:40:17,2010-08-06 14:40:17
847378d22be6f72ab7d7e507e9e651921326fce2...3427b84dd236c4d0ef6f612107874e3fa306e1e7,1,1,1,2,1,2010-08-03 19:23:49,2010-08-03 19:23:49
d952ecbab3f31fa4a227e2a11389830def534206...38a4979c8304c8fe1ec60277cc67d2565b80ba41,1,10,10,20,3,2010-08-06 17:13:49,2010-08-06 17:13:49
38a4979c8304c8fe1ec60277cc67d2565b80ba41...f1a8c6ef54745bcf18e3af11c20152e8646431da,7,53,6,59,14,2010-08-06 17:24:59,2010-08-06 17:24:59
f1a8c6ef54745bcf18e3af11c20152e8646431da...0dd9c00ad2e68742c4affc732b79389ac1165fa8,1,7,34,41,17,2010-08-06 18:14:25,2010-08-06 18:14:25
0dd9c00ad2e68742c4affc732b79389ac1165fa8...b4636218357869d22a790d986498b27cc6cddffb,1,40,15,55,9,2010-08-06 22:20:54,2010-08-06 22:20:54
b4636218357869d22a790d986498b27cc6cddffb...e7c3af37ab3dda9e8689a56b8164e763f93c6358,1,10,1,11,3,2010-08-07 18:14:51,2010-08-07 18:14:51
e7c3af37ab3dda9e8689a56b8164e763f93c6358...8460ae83c70487a3060ed56539d06925cfc2ffc4,3,43,4,47,11,2010-08-07 20:59:09,2010-08-07 20:59:09
3427b84dd236c4d0ef6f612107874e3fa306e1e7...ebeeb8167999c342e576bc9fb5cb70a814957723,1,2,2,4,1,2010-08-03 21:37:34,2010-08-03 21:37:34
ebeeb8167999c342e576bc9fb5cb70a814957723...87645966131702d79888e6c60956028366ca2c95,1,1,1,2,1,2010-08-03 21:37:59,2010-08-03 21:37:59
87645966131702d79888e6c60956028366ca2c95...9078eba70f6e459c960a2c6b7c988a83947c2506,1,6,4,10,1,2010-08-03 21:38:16,2010-08-03 21:38:16
9078eba70f6e459c960a2c6b7c988a83947c2506...c1a0ce0228d75d62a10eeab6aa8aa0ee65b64958,7,47,23,70,19,2010-08-03 22:12:04,2010-08-03 22:12:04
3427b84dd236c4d0ef6f612107874e3fa306e1e7...1cbc8284a36138ddf524641fe7f3f2a9d6c9a610,1,2,0,2,1,2010-08-03 21:35:28,2010-08-03 21:35:28
1cbc8284a36138ddf524641fe7f3f2a9d6c9a610...7dba76ccc67c92242be32b68e06031be3e1803ed,1,1,1,2,1,2010-08-03 22:01:14,2010-08-03 21:21:54
7dba76ccc67c92242be32b68e06031be3e1803ed...33c33be7576f0dac9059b30a1fca9d03ae1a7b5e,1,60,0,60,1,2010-08-03 22:01:14,2010-08-03 22:00:07
8460ae83c70487a3060ed56539d06925cfc2ffc4...ea19123612710d68bab930a336095e05ac98f4c3,1,8,0,8,1,2010-08-08 00:29:48,2010-08-08 00:29:48
8460ae83c70487a3060ed56539d06925cfc2ffc4...527b059518e1e1233266b0c714b308f9fcaa4b0f,1,3,3,6,3,2010-08-07 22:24:05,2010-08-07 22:24:05
82af423af6afb9b21afed478a18d816d87a92928...240f550d7a9ba268bb6e5ca58ead567b5ef3f033,1,1,1,2,1,2010-08-03 22:22:11,2010-08-03 22:22:11
240f550d7a9ba268bb6e5ca58ead567b5ef3f033...1a5c0a6723eb67b1e4f1c3d6f043ffeca6c7a6c7,1,11,5,16,3,2010-08-04 01:56:51,2010-08-04 01:56:51
1a5c0a6723eb67b1e4f1c3d6f043ffeca6c7a6c7...ab2193ee82aeb2b986fa78040525c509a8ccf953,1,4,2,6,1,2010-08-04 02:11:26,2010-08-04 02:11:26
568b70305a7ee42c110b92d7f071108ca8f21da3...84a864505767effcc6fc0511587daad7b0c0b020,5,98,30,128,15,2010-08-08 14:21:39,2010-08-08 14:21:39
84a864505767effcc6fc0511587daad7b0c0b020...cd5160eed5fa03f7c8afd6c00b8ff1c1483e5ea7,2,4,4,8,2,2010-08-08 14:26:09,2010-08-08 14:26:09
cd5160eed5fa03f7c8afd6c00b8ff1c1483e5ea7...0735d3e45e11afc71e98dda04328f820d08a5cfb,1,0,3,3,1,2010-08-08 17:00:00,2010-08-08 17:00:00
0735d3e45e11afc71e98dda04328f820d08a5cfb...db2dfba94c421d64193b1067f8b6ed881e237479,3,33,20,53,11,2010-08-08 17:53:48,2010-08-08 17:53:48
db2dfba94c421d64193b1067f8b6ed881e237479...2b0879f93cd3a3aeda614ed96ac952f7d79aeed2,1,14,1,15,2,2010-08-08 22:02:12,2010-08-08 22:02:12
2b0879f93cd3a3aeda614ed96ac952f7d79aeed2...9dd3b210022427ccc431ce372e5fcc76a674516b,3,43,10,53,5,2010-08-09 03:39:09,2010-08-09 03:39:09
9dd3b210022427ccc431ce372e5fcc76a674516b...0b975c9734120532e2868da9ab0a5a6687d70032,1,2,2,4,1,2010-08-09 04:28:06,2010-08-09 04:28:06
0b975c9734120532e2868da9ab0a5a6687d70032...3d9d505e4c218962b7049d0bc6e2a5dd022bc86b,1,2,1,3,1,2010-08-09 12:13:07,2010-08-09 12:13:07
3d9d505e4c218962b7049d0bc6e2a5dd022bc86b...a902556f80e34da3c641aebf9eeb58dc94643395,2,42,0,42,4,2010-08-09 13:31:00,2010-08-09 13:29:55
a902556f80e34da3c641aebf9eeb58dc94643395...d862d565e4aa953db70d7717975fc2e77971b740,2,2,7,9,4,2010-08-09 13:42:33,2010-08-09 13:42:33
d862d565e4aa953db70d7717975fc2e77971b740...d79d98a2ef9c5c50a920b3f537b7d934b283079e,1,6,4,10,4,2010-08-09 14:00:13,2010-08-09 14:00:13
ab2193ee82aeb2b986fa78040525c509a8ccf953...a432ac592e4a7895777d283d18f0c7c46546098b,1,1,1,2,1,2010-08-04 02:18:44,2010-08-04 02:18:44
a432ac592e4a7895777d283d18f0c7c46546098b...b5ce278c18496bc0d180b8d9ab976fdcf743f9a7,1,1,1,2,1,2010-08-04 13:39:16,2010-08-04 13:38:55
b5ce278c18496bc0d180b8d9ab976fdcf743f9a7...c542dbd78a75511491596a427b67dbca62716a50,1,12,3,15,5,2010-08-04 14:17:17,2010-08-04 14:11:49
c542dbd78a75511491596a427b67dbca62716a50...2c3d88336e95a91ff16b202faf921c5398b93a82,1,1,0,1,1,2010-08-04 14:20:16,2010-08-04 14:19:45
2c3d88336e95a91ff16b202faf921c5398b93a82...63f894763de77a0be4a67d665b87298736604ba3,2,73,4,77,4,2010-08-04 15:53:36,2010-08-04 15:50:15
63f894763de77a0be4a67d665b87298736604ba3...cb661f73fd8822d3c64cc1879793007f03b8484d,4,41,15,56,14,2010-08-04 15:53:44,2010-08-04 15:42:20
cb661f73fd8822d3c64cc1879793007f03b8484d...2e6aeb0229cca1f7588c8a6ac487b30fe62e7954,3,3,5,8,4,2010-08-04 15:53:52,2010-08-04 14:55:11
2e6aeb0229cca1f7588c8a6ac487b30fe62e7954...8c095b2cb2c55982a76a074d52a63ba1994baf62,3,11,5,16,7,2010-08-04 15:53:56,2010-08-04 14:50:53
8c095b2cb2c55982a76a074d52a63ba1994baf62...8947d06986b3a1762a70fbd18b195456e0e9cd5b,1,0,5,5,1,2010-08-04 15:54:00,2010-08-04 14:32:26
8947d06986b3a1762a70fbd18b195456e0e9cd5b...55937a8f3e506d7ce87bbc288d3fe713482c5b04,1,1,0,1,1,2010-08-04 16:11:18,2010-08-04 14:25:06
55937a8f3e506d7ce87bbc288d3fe713482c5b04...6f6aa20e92072940d55308be4c8e4b2e70e579fc,2,30,8,38,6,2010-08-04 16:13:38,2010-08-04 16:13:22
6f6aa20e92072940d55308be4c8e4b2e70e579fc...fd26b536e9fedd84f661f23957d860081878cac1,1,20,0,20,6,2010-08-04 16:33:13,2010-08-04 16:32:44
fd26b536e9fedd84f661f23957d860081878cac1...50b7bbe9341084d24534a954277b1429d544610e,1,14,0,14,1,2010-08-04 17:30:47,2010-08-04 17:00:53
50b7bbe9341084d24534a954277b1429d544610e...ae1e0804da17f2fbc3a38f89c090de2ed6101888,2,10,0,10,2,2010-08-04 19:15:30,2010-08-04 19:15:10
ae1e0804da17f2fbc3a38f89c090de2ed6101888...7abf0580caff987caac8e8d7b1dad8c44dccfcab,2,5,3,8,4,2010-08-04 20:00:06,2010-08-04 20:00:06
7abf0580caff987caac8e8d7b1dad8c44dccfcab...e4fcc800f73e641854697fa63b684d7e7d7064ed,1,6,4,10,2,2010-08-04 20:03:32,2010-08-04 20:02:49
e4fcc800f73e641854697fa63b684d7e7d7064ed...53d1c8bbad28c567707bedc4a58e5b5961142fa8,2,2,2,4,2,2010-08-05 04:16:50,2010-08-04 22:55:58
53d1c8bbad28c567707bedc4a58e5b5961142fa8...2c7f164b653f0d703947572ede064aed41cc2185,4,8,3,11,4,2010-08-05 13:32:06,2010-08-05 13:32:06
2c7f164b653f0d703947572ede064aed41cc2185...ba166df4124aca1fdb6429dfbb64170b699ce72a,1,1,1,2,1,2010-08-05 15:34:06,2010-08-05 15:34:06
ba166df4124aca1fdb6429dfbb64170b699ce72a...dcfab78c4b797995c01f4ac4208a882cb9539cc4,2,22,20,42,7,2010-08-05 17:41:01,2010-08-05 15:52:14
dcfab78c4b797995c01f4ac4208a882cb9539cc4...3cc86177ceaa37aaeb1e2680194639842c8f81c1,7,53,6,59,14,2010-08-06 17:25:52,2010-08-06 17:24:59
3cc86177ceaa37aaeb1e2680194639842c8f81c1...b59584f3dd6d47bfe3549075554a36f25d1e3306,1,0,3,3,2,2010-08-09 17:38:43,2010-08-09 17:32:29
b59584f3dd6d47bfe3549075554a36f25d1e3306...0e8ef6bca07f48096b50ad02682e74cb62dda1d0,1,5,1,6,2,2010-08-09 18:45:03,2010-08-09 17:57:30
0e8ef6bca07f48096b50ad02682e74cb62dda1d0...edffe867a5cb254fc958769cf3696f129a4efe79,1,3,6,9,3,2010-08-09 18:45:12,2010-08-09 18:42:24
edffe867a5cb254fc958769cf3696f129a4efe79...af35eebfb65fc2754a8e5b2236a370857125f414,1,12,4,16,2,2010-08-11 18:43:16,2010-08-11 18:26:44
af35eebfb65fc2754a8e5b2236a370857125f414...edb14c522b35005ebed293a854e490a49b85738b,1,67,63,130,4,2010-08-11 18:43:26,2010-08-11 18:31:45
edb14c522b35005ebed293a854e490a49b85738b...2ba8ac25f13c1d097f43f65d2468c88e7e4144ec,1,4,2,6,1,2010-08-12 20:12:02,2010-08-12 20:12:02
2ba8ac25f13c1d097f43f65d2468c88e7e4144ec...b58d62a194768ec8c228a45d863b2523dd6fc6ee,1,7,1,8,1,2010-08-16 18:16:58,2010-08-16 15:09:03
b58d62a194768ec8c228a45d863b2523dd6fc6ee...0c8f696e79dc38df2a5c63744701280ce85a0608,1,2,1,3,1,2010-08-16 18:25:59,2010-08-04 17:00:41
0c8f696e79dc38df2a5c63744701280ce85a0608...2800a96e56fbc13a33b8848faab5ff36414ca4b0,4,27,15,42,15,2010-08-16 18:26:12,2010-08-04 17:28:11
2800a96e56fbc13a33b8848faab5ff36414ca4b0...356eeb5a627d14419d4c8bf7767fc4a754dde728,3,43,10,53,5,2010-08-16 18:27:29,2010-08-09 03:39:09
356eeb5a627d14419d4c8bf7767fc4a754dde728...f1f53ef3c13a14bdc4d9c3f9bd2e9013190472f1,1,2,1,3,1,2010-08-16 18:27:43,2010-08-09 12:13:07
f1f53ef3c13a14bdc4d9c3f9bd2e9013190472f1...1d7dfe2868fd1458fcfde8fbb0356b3f015a57ee,2,10,0,10,3,2010-08-16 18:28:02,2010-08-09 16:16:21
1d7dfe2868fd1458fcfde8fbb0356b3f015a57ee...54239a3676a10a82df96dc49cc61d2580d74623e,1,3,3,6,2,2010-08-16 18:28:12,2010-08-09 17:49:09
54239a3676a10a82df96dc49cc61d2580d74623e...3de268fcaeba9cada5df377773e307981b31437e,1,3,1,4,2,2010-08-16 18:28:53,2010-08-12 07:15:18
3de268fcaeba9cada5df377773e307981b31437e...d3b427b96f9162c26b915a1967ed85a7ff51ed07,1,8,3,11,5,2010-08-16 18:29:29,2010-08-15 00:03:01
d3b427b96f9162c26b915a1967ed85a7ff51ed07...aa5d314ae93d71ba49328a5327f97a39ee22f5c0,1,2,2,4,2,2010-08-16 18:29:39,2010-08-15 00:08:57
aa5d314ae93d71ba49328a5327f97a39ee22f5c0...2976396903c863a076e0cef49894930c4c477446,1,2,0,2,2,2010-08-16 18:29:48,2010-08-15 04:37:08
2976396903c863a076e0cef49894930c4c477446...c3855123b576317a6a07a3978f96ea5f51032c36,1,2,0,2,2,2010-08-16 18:29:59,2010-08-15 05:08:53
c3855123b576317a6a07a3978f96ea5f51032c36...1948efc6a4cd6be3ab83284936efe6efad3e3258,1,1,1,2,1,2010-08-16 18:30:11,2010-08-16 05:01:35
1948efc6a4cd6be3ab83284936efe6efad3e3258...d1c3edcf331929b12b8a90e01002f0693dbe51cf,1,1,1,2,1,2010-08-16 19:48:08,2010-08-16 19:47:40
d1c3edcf331929b12b8a90e01002f0693dbe51cf...4454a8a0a0d2ceb01ba26c76baf8caa176f6a583,1,1,1,2,1,2010-08-16 20:57:23,2010-08-04 21:02:43
4454a8a0a0d2ceb01ba26c76baf8caa176f6a583...415c2641235ea4f8770c5377687e650749d66560,1,2,0,2,1,2010-08-16 21:02:33,2010-08-11 21:12:35
415c2641235ea4f8770c5377687e650749d66560...81da9cda7f7bf5396d4a6988421fc4dc96f28321,1,2,1,3,1,2010-08-16 21:03:38,2010-08-12 20:13:07
81da9cda7f7bf5396d4a6988421fc4dc96f28321...67159d2583670da3b299a29d6e96e1afd119d31e,1,2,3,5,2,2010-08-16 21:04:22,2010-08-16 21:04:22
67159d2583670da3b299a29d6e96e1afd119d31e...3770916e055c5760c7410bc580ca3ce1e8c8f9f2,1,10,6,16,6,2010-08-16 21:07:08,2010-08-16 21:07:08
3770916e055c5760c7410bc580ca3ce1e8c8f9f2...1a30dad111e80233928a2cf5f1721accb59eb56a,1,2,2,4,1,2010-08-17 13:34:29,2010-08-09 04:28:06
1a30dad111e80233928a2cf5f1721accb59eb56a...e280c561f1f1211a96f43d7d7cc5b7cb61d8990a,1,5,0,5,1,2010-08-17 13:57:17,2010-08-06 14:42:26
e280c561f1f1211a96f43d7d7cc5b7cb61d8990a...31d81b823dae4d0b55ecde4bb51d41a1a2f35e38,4,9,3,12,4,2010-08-17 14:04:43,2010-08-17 14:04:43
31d81b823dae4d0b55ecde4bb51d41a1a2f35e38...19b587d9254dd79dbaaddffabe82771fb3cd108b,1,1,1,2,1,2010-08-17 15:49:07,2010-08-12 18:22:01
19b587d9254dd79dbaaddffabe82771fb3cd108b...c5f5f9a4f3b515dfd5272d373093fd4fd58c95d9,1,2,0,2,2,2010-08-17 16:28:19,2010-08-17 16:27:53
c5f5f9a4f3b515dfd5272d373093fd4fd58c95d9...7093e6e5855d962d2d3c83ad249b667ce279ad0d,1,1,1,2,1,2010-08-17 20:02:25,2010-08-17 20:02:25
7093e6e5855d962d2d3c83ad249b667ce279ad0d...f6aad0935e263eb05d451e288f14c23f25db7e1c,4,4,41,45,7,2010-08-19 14:14:01,2010-08-17 21:01:33
d79d98a2ef9c5c50a920b3f537b7d934b283079e...926bf4bd0ed5370b0bc8dd3f07b37f63011dcdc7,7,29,5,34,12,2010-08-09 16:01:27,2010-08-09 16:01:27
d79d98a2ef9c5c50a920b3f537b7d934b283079e...472780d00216497cf97c325c37eb121e638e99f9,1,10,6,16,2,2010-08-09 15:09:07,2010-08-09 15:09:07
f6aad0935e263eb05d451e288f14c23f25db7e1c...70406d6afba62b6037fc9b6a8cf8e6d22657b8c3,2,10,15,25,10,2010-09-12 16:08:15,2010-09-12 16:03:50
f6aad0935e263eb05d451e288f14c23f25db7e1c...f0d0aad23de0c30ab9597551403c873df4d9cb3f,1,6,1,7,4,2010-08-20 15:53:19,2010-08-20 15:53:19
f0d0aad23de0c30ab9597551403c873df4d9cb3f...00e90402361da9334e9e4216dc48a0c9cc3d6aa1,1,1,1,2,1,2010-08-20 18:12:40,2010-08-20 18:12:14
00e90402361da9334e9e4216dc48a0c9cc3d6aa1...7b02bf761dc8c3a6e749f44064009da82286a7c8,1,5,5,10,4,2010-08-22 01:24:09,2010-08-22 01:23:33
7b02bf761dc8c3a6e749f44064009da82286a7c8...6122c120c3e82b2e00a6d032cd12c10599c7538e,1,1,0,1,1,2010-08-23 17:20:50,2010-08-23 17:20:29
6122c120c3e82b2e00a6d032cd12c10599c7538e...0e78196fd59c067933b36aa4f0021b73158ef545,1,3,3,6,3,2010-08-23 17:37:13,2010-08-23 17:36:49
0e78196fd59c067933b36aa4f0021b73158ef545...aaae92dedbd41733fd8043efa2882c0fcebb86f4,2,25,8,33,3,2010-08-26 17:54:32,2010-08-26 17:53:54
aaae92dedbd41733fd8043efa2882c0fcebb86f4...92d5eb42af2e25ac549d7489d90261c7f6a0e767,2,23,0,23,3,2010-08-28 16:01:22,2010-08-27 16:07:06
92d5eb42af2e25ac549d7489d90261c7f6a0e767...b620e3327e6e924acc667a06c6b2ed3cac51f9d1,1,2,2,4,2,2010-08-31 15:18:51,2010-08-31 15:17:58
b620e3327e6e924acc667a06c6b2ed3cac51f9d1...5c6f0dcfbd95caa799509460e7b8a60f967da8c3,1,5,2,7,1,2010-08-31 21:15:31,2010-08-31 13:43:39
5c6f0dcfbd95caa799509460e7b8a60f967da8c3...4099bc52ccb0370000191f20bd6b84c892b44bfe,1,1,1,2,1,2010-08-31 21:15:44,2010-08-31 13:42:52
4099bc52ccb0370000191f20bd6b84c892b44bfe...625b4c4378337435e059e3226ffe64421068f6b1,1,1,1,2,1,2010-08-31 21:16:23,2010-08-31 04:42:53
625b4c4378337435e059e3226ffe64421068f6b1...bdfefa42c5ebed0f6c93e7680507889189e860dc,1,7,0,7,1,2010-08-31 21:17:52,2010-08-28 06:19:06
bdfefa42c5ebed0f6c93e7680507889189e860dc...4a65b51c575229c4f2b1b0a8601a698e7fad64a8,1,8,1,9,2,2010-08-31 21:21:23,2010-08-25 06:42:25
4a65b51c575229c4f2b1b0a8601a698e7fad64a8...a3dd77e7ec4cd5b9f16d18a8288e80d0659540a5,3,4,4,8,3,2010-08-31 21:22:30,2010-08-23 16:54:02
a3dd77e7ec4cd5b9f16d18a8288e80d0659540a5...0840daf31aca42268146318ae5552207000e2601,3,28,11,39,10,2010-08-31 21:25:16,2010-08-18 13:48:02
0840daf31aca42268146318ae5552207000e2601...964b3436ef03cfffa12c677a48ea648144fc46eb,1,3,1,4,1,2010-08-31 21:25:26,2010-08-20 20:36:19
964b3436ef03cfffa12c677a48ea648144fc46eb...921dbd018b0e02c6d59736060d723826cf594199,1,32,0,32,1,2010-08-31 21:26:42,2010-08-23 05:25:17
921dbd018b0e02c6d59736060d723826cf594199...e070747d94e0dccfcab5ba2e385eb699c6993796,8,101,33,134,37,2010-08-31 21:26:45,2010-08-23 15:12:35
e070747d94e0dccfcab5ba2e385eb699c6993796...66befc517c516a11408713b02dfc575cccf7cc29,3,5,7,12,3,2010-08-31 21:26:56,2010-08-23 15:24:34
66befc517c516a11408713b02dfc575cccf7cc29...baa4cb9c04bfb61a3c3c106a5cc76e17e555648c,1,0,7,7,1,2010-08-31 21:27:04,2010-08-23 15:25:12
baa4cb9c04bfb61a3c3c106a5cc76e17e555648c...79b5c8023bb1b0328455035806c35d0065e4b024,1,3,3,6,2,2010-08-31 21:27:14,2010-08-23 15:27:47
79b5c8023bb1b0328455035806c35d0065e4b024...38da020af03d6fbc4ab7a8107039b8ccc193c118,1,1,1,2,1,2010-08-31 21:27:28,2010-08-23 15:31:06
38da020af03d6fbc4ab7a8107039b8ccc193c118...c9feeb823d3da7218003568bc239071acef3fd3c,2,12,5,17,7,2010-08-31 21:28:08,2010-08-23 16:45:31
c9feeb823d3da7218003568bc239071acef3fd3c...2b869d6dfa0a5b63666bc7b33414f04599f08c72,1,2,2,4,2,2010-08-31 21:33:58,2010-08-31 21:33:58
2b869d6dfa0a5b63666bc7b33414f04599f08c72...cd47c92322d63fb891c0a2f3ef51c3bb04733b41,1,1,1,2,1,2010-08-31 21:36:10,2010-08-31 21:36:10
cd47c92322d63fb891c0a2f3ef51c3bb04733b41...9ff3ddc94431010bda13547efde375a81fc11bf4,2,32,12,44,7,2010-08-31 21:38:05,2010-08-27 15:48:16
9ff3ddc94431010bda13547efde375a81fc11bf4...f93b0d654f4854205c5fea7546a1a83edb68c63c,3,0,0,0,0,2010-09-01 00:18:05,2010-08-23 16:49:48
f93b0d654f4854205c5fea7546a1a83edb68c63c...0af2db40cf5ca32da02f3c487ad9e45bb83a1ff8,1,1,1,2,1,2010-09-01 01:16:07,2010-09-01 01:16:07
0af2db40cf5ca32da02f3c487ad9e45bb83a1ff8...4a9135c3b66afd655ddf1a350b0b824090741167,1,1,0,1,1,2010-09-01 01:17:31,2010-08-27 20:39:43
4a9135c3b66afd655ddf1a350b0b824090741167...0fda3ce40f54400643d3bf59edb73d7148f6cb8a,1,4,0,4,1,2010-09-01 01:20:16,2010-08-27 20:43:26
0fda3ce40f54400643d3bf59edb73d7148f6cb8a...19a0f996fab7cfc2e4d1520d36e930e460c4fad7,2,60,5,65,9,2010-09-01 01:20:58,2010-08-27 19:25:21
19a0f996fab7cfc2e4d1520d36e930e460c4fad7...3c1fa57776518a6126e77a35cd515cf3b52a8014,4,57,32,89,17,2010-09-01 01:21:06,2010-08-27 22:48:22
3c1fa57776518a6126e77a35cd515cf3b52a8014...0260ce050b3c7b73fe9257ef057c2393082fa85d,2,48,9,57,7,2010-09-01 01:21:18,2010-08-28 00:23:38
0260ce050b3c7b73fe9257ef057c2393082fa85d...5b66c47327b93dcbec5c0310833d48a5e094c800,1,1,1,2,1,2010-09-01 03:41:17,2010-08-27 21:33:08
5b66c47327b93dcbec5c0310833d48a5e094c800...aef371ecf5d2a824f16ccdc3b745f3702165602f,4,12,3,15,4,2010-09-01 12:50:38,2010-09-01 12:50:38
aef371ecf5d2a824f16ccdc3b745f3702165602f...16de891bba79aaee4a7e52ece99cbbbb03c087cf,1,1,1,2,1,2010-09-01 17:29:35,2010-09-01 17:29:35
16de891bba79aaee4a7e52ece99cbbbb03c087cf...cbed9de254d72c44bc540453f48ff491b05d9a74,1,1,1,2,1,2010-09-07 16:12:08,2010-09-07 14:29:22
cbed9de254d72c44bc540453f48ff491b05d9a74...81d318339fedb1f91fc48baa21e262e0cfddf58a,1,1,1,2,1,2010-09-07 16:12:16,2010-09-07 16:11:24
81d318339fedb1f91fc48baa21e262e0cfddf58a...ded8b8a3a498135ec4f84bcdaf98a80c8f04479b,2,10,1,11,5,2010-09-07 16:12:22,2010-09-07 16:11:36
ded8b8a3a498135ec4f84bcdaf98a80c8f04479b...0c2d72f109a117587c1bbc1249e22dcf8e0186a3,1,6,1,7,1,2010-09-07 17:00:30,2010-09-07 17:00:30
0c2d72f109a117587c1bbc1249e22dcf8e0186a3...97b74a1f3379ef5a8e92a0cbc6c92b38fbc0df15,1,12,4,16,1,2010-09-07 17:50:01,2010-09-07 17:50:01
97b74a1f3379ef5a8e92a0cbc6c92b38fbc0df15...0dfea63e888f96a81bd099027d5b966fafdc6e3e,3,22,11,33,8,2010-09-07 18:55:20,2010-09-03 01:34:41
0dfea63e888f96a81bd099027d5b966fafdc6e3e...caa2025d77a9e2a1e2bbd41ac63efa6ce852d3c2,1,1,5,6,2,2010-09-07 18:56:43,2010-09-03 19:06:50
caa2025d77a9e2a1e2bbd41ac63efa6ce852d3c2...017247b3ddf432be2484e8c1c3118b4cfcb9612a,1,5,1,6,3,2010-09-07 23:03:19,2010-09-07 23:02:36
017247b3ddf432be2484e8c1c3118b4cfcb9612a...2f89b7af2ee28259b56e6f4c666b9aa6a7e9dfaa,4,31,26,57,13,2010-09-08 16:42:09,2010-08-29 04:20:19
472780d00216497cf97c325c37eb121e638e99f9...a4dc5281d8deb94ee88d0cf1b0bce9f91973ffc4,2,10,0,10,3,2010-08-09 16:16:21,2010-08-09 16:16:21
bf3f03bd8968e4df6e4d333170df3de204ab50b1...d5793fa9a8281b349e0fc1ddd09acc9d1a084055,3,63,5,68,12,2010-09-14 19:03:30,2010-08-24 05:25:45
d5793fa9a8281b349e0fc1ddd09acc9d1a084055...668e149311b9caa66835792d3114dbc04aa52642,1,1,1,2,1,2010-09-14 21:35:52,2010-09-03 01:24:18
668e149311b9caa66835792d3114dbc04aa52642...1393545a61acbaecbebc741b9b4900729165bf12,2,1,10,11,4,2010-09-15 01:50:39,2010-09-15 01:51:13
1393545a61acbaecbebc741b9b4900729165bf12...d37c43f6239e3ce7e41edb28c6ea33598de570f4,2,5,5,10,2,2010-09-15 02:03:38,2010-08-24 05:39:38
d37c43f6239e3ce7e41edb28c6ea33598de570f4...2fe3e06391ceb6426a98aaf5ae8289b438a1da67,3,43,4,47,11,2010-09-15 14:42:35,2010-08-07 20:59:09
2fe3e06391ceb6426a98aaf5ae8289b438a1da67...d0b03a10309d1bbc715571e954b8a265327fb724,1,3,3,6,3,2010-09-15 14:43:20,2010-08-07 22:24:05
d0b03a10309d1bbc715571e954b8a265327fb724...e88837024299e75365f9b259debcd5921470029e,1,11,1,12,1,2010-09-15 14:44:44,2010-08-08 00:29:48
e88837024299e75365f9b259debcd5921470029e...ff818c4f6118cf13ac0f638120e678d104683802,5,97,21,118,14,2010-09-15 14:46:49,2010-08-08 14:21:39
ff818c4f6118cf13ac0f638120e678d104683802...047ccb6d071cdd6fb6f99c62d16974c70bfebd02,1,0,3,3,1,2010-09-15 14:47:18,2010-08-08 17:00:00
047ccb6d071cdd6fb6f99c62d16974c70bfebd02...6fb9fbe207d1c7849b1eae0b650991e8109b0752,3,32,28,60,12,2010-09-15 14:48:08,2010-08-08 17:53:48
6fb9fbe207d1c7849b1eae0b650991e8109b0752...2f91eaad4401e5f2b59ea807881f34bdfb1f448a,1,14,1,15,2,2010-09-15 14:48:20,2010-08-08 22:02:12
2f91eaad4401e5f2b59ea807881f34bdfb1f448a...bc3b8aa4ac7c7abe52c95e6bf96f5e8d6b58afe1,1,6,4,10,4,2010-09-15 14:48:48,2010-08-09 14:00:13
bc3b8aa4ac7c7abe52c95e6bf96f5e8d6b58afe1...c9d23ed9f75f18c54bbfac5056424f240f85b816,1,7,2,9,1,2010-09-15 14:48:56,2010-08-09 15:09:07
c9d23ed9f75f18c54bbfac5056424f240f85b816...db296d0ef86944a02164696cbafa8ff0a001cdf0,7,29,5,34,12,2010-09-15 14:49:05,2010-08-09 16:01:27
db296d0ef86944a02164696cbafa8ff0a001cdf0...f068efcf5e9067d107878d8fbfa7ac7a7873754c,1,1,1,2,1,2010-09-15 14:49:15,2010-08-09 18:30:51
f068efcf5e9067d107878d8fbfa7ac7a7873754c...52081d1b814d948d43e42b56d3bfa14df0014db3,2,19,8,27,9,2010-09-15 14:49:33,2010-08-09 19:17:11
52081d1b814d948d43e42b56d3bfa14df0014db3...04a61434dd67794277761846bb2469036e152490,3,29,2,31,6,2010-09-15 14:49:57,2010-08-09 20:15:41
04a61434dd67794277761846bb2469036e152490...644472299974e24e05e41700872fdf0ff81cbf7b,1,1,0,1,1,2010-09-15 14:50:21,2010-08-09 20:43:06
644472299974e24e05e41700872fdf0ff81cbf7b...22dd4e68b4f9dcfd384ee2d54aa02fddb518fb4f,1,3,2,5,3,2010-09-15 14:51:15,2010-08-10 17:31:13
22dd4e68b4f9dcfd384ee2d54aa02fddb518fb4f...e228949faadb682e4a0e3739a18ac9457127de62,3,1786,1768,3554,3,2010-09-15 14:52:49,2010-08-04 16:19:16
e228949faadb682e4a0e3739a18ac9457127de62...a69bfe2c25b467373abf326a489b9437c65fdf92,2,80,4,84,5,2010-09-15 14:53:04,2010-08-10 17:31:42
a69bfe2c25b467373abf326a489b9437c65fdf92...c60bbc9a396ddeb23b85b571efc56c422eaae3b4,1,76,73,149,2,2010-09-15 14:59:05,2010-08-10 20:25:22
c60bbc9a396ddeb23b85b571efc56c422eaae3b4...ed3fe3f011ce03f0f73a5abadf154282bcdd7b0c,1,1,1,2,1,2010-09-15 14:59:24,2010-08-10 20:28:50
ed3fe3f011ce03f0f73a5abadf154282bcdd7b0c...62ea5606d0d0b6116b5cc9b5b367760b3ba25c7a,1,2,2,4,1,2010-09-15 15:02:33,2010-08-11 02:51:07
62ea5606d0d0b6116b5cc9b5b367760b3ba25c7a...bc8021e5938073dafe532d632e5aa43675b8ea9c,1,1,1,2,1,2010-09-15 15:03:03,2010-08-11 20:41:03
bc8021e5938073dafe532d632e5aa43675b8ea9c...82ef5dd32f6941182c8eb6ff60339ab1aa8146a3,1,2,1,3,1,2010-09-15 15:03:08,2010-08-11 20:44:31
82ef5dd32f6941182c8eb6ff60339ab1aa8146a3...71bedc0c8ebacc6e233f7d2001319eeea05bd91d,2,4,2,6,2,2010-09-15 15:03:27,2010-08-11 20:48:54
71bedc0c8ebacc6e233f7d2001319eeea05bd91d...e59f0335c7bb7e09af77bb476bbff87fde152a19,1,2,0,2,1,2010-09-15 15:04:52,2010-08-12 13:50:29
e59f0335c7bb7e09af77bb476bbff87fde152a19...51405ddcffd1534333e47c1fc34346d3194bcfb0,1,14,0,14,2,2010-09-15 15:05:50,2010-08-12 17:13:25
51405ddcffd1534333e47c1fc34346d3194bcfb0...eeb99ee970628b86844c723fff160b034a0b8c5c,1,1,1,2,1,2010-09-15 15:06:25,2010-08-12 18:33:53
eeb99ee970628b86844c723fff160b034a0b8c5c...287bb91a7ab9e8c0b8a50002734f0e9916cd8899,1,25,0,25,1,2010-09-15 15:09:03,2010-08-13 22:16:03
287bb91a7ab9e8c0b8a50002734f0e9916cd8899...b624760d6540ca0abbf3ca7d9df2b5426da59e7a,6,28,5,33,9,2010-09-15 15:13:11,2010-08-12 20:06:16
b624760d6540ca0abbf3ca7d9df2b5426da59e7a...78ad0339dc45600904c0df0babb2bf8d193d7c14,5,19,15,34,8,2010-09-15 15:13:17,2010-08-13 22:21:32
78ad0339dc45600904c0df0babb2bf8d193d7c14...96c9f99504370f19862057bd0c0a223fc34ee45d,1,16,8,24,2,2010-09-15 15:16:13,2010-08-16 12:57:28
96c9f99504370f19862057bd0c0a223fc34ee45d...4e398824a35bd4a47167d686c8884075ba9bb4d3,4,5,27,32,8,2010-09-15 15:16:22,2010-08-16 13:00:58
4e398824a35bd4a47167d686c8884075ba9bb4d3...a033a4645bda7a121bd3b73ebbf9def463446dcc,2,30,6,36,7,2010-09-15 15:16:35,2010-08-16 13:17:14
a033a4645bda7a121bd3b73ebbf9def463446dcc...e0595a5837e9527fed52a609c555f6f477e56488,2,47,5,52,6,2010-09-15 15:17:32,2010-08-16 13:39:28
e0595a5837e9527fed52a609c555f6f477e56488...4b714a0b6dc767f41b6c58cf40e6bae039b884e7,3,10,4,14,5,2010-09-15 15:17:38,2010-08-16 14:01:26
4b714a0b6dc767f41b6c58cf40e6bae039b884e7...d832e39d724ee50d02720746af8df241cf5fccb7,2,9,4,13,4,2010-09-15 15:18:27,2010-08-16 14:22:41
d832e39d724ee50d02720746af8df241cf5fccb7...ad3ae36a408b7536331fd41b76db3570d151fd7c,2,14,1,15,3,2010-09-15 15:18:37,2010-08-16 14:26:07
ad3ae36a408b7536331fd41b76db3570d151fd7c...d80362c555087576954514071c126da4285bd5af,2,75,29,104,9,2010-09-15 15:19:18,2010-08-16 16:21:49
d80362c555087576954514071c126da4285bd5af...4b78560deb5310123c6a3696a476222370c80916,1,19,0,19,1,2010-09-15 15:19:37,2010-08-16 16:44:36
4b78560deb5310123c6a3696a476222370c80916...9c481f7bbea1f429324f9db9edef9cf86bd40f44,1,1,2,3,2,2010-09-15 15:19:48,2010-08-16 16:51:31
9c481f7bbea1f429324f9db9edef9cf86bd40f44...ccaa3b6c55c73b6e85bb12acf4becb1d564a0ce8,1,15,4,19,3,2010-09-15 15:22:40,2010-08-16 19:29:40
ccaa3b6c55c73b6e85bb12acf4becb1d564a0ce8...ec643451f5a4d09303085d1cd88fcfd55172070f,1,14,14,28,3,2010-09-15 15:27:33,2010-08-17 04:29:17
ec643451f5a4d09303085d1cd88fcfd55172070f...fc2281d043ca8b0d38434568929d6ec5df4d4b80,1,18,1,19,3,2010-09-15 15:27:41,2010-08-17 04:35:45
fc2281d043ca8b0d38434568929d6ec5df4d4b80...07294457f58dfd55b567535ad56a7c3ff46b51fe,1,2,6,8,1,2010-09-15 15:28:47,2010-08-16 19:51:37
07294457f58dfd55b567535ad56a7c3ff46b51fe...117c58998235e7eb7fe67412f6f3d5c62b42e578,1,25,5,30,18,2010-09-15 15:29:01,2010-08-17 00:39:01
117c58998235e7eb7fe67412f6f3d5c62b42e578...3d758307ca032fe9d0aa843eef967cd82f4a9d83,1,8,3,11,1,2010-09-15 15:29:59,2010-08-17 14:19:40
3d758307ca032fe9d0aa843eef967cd82f4a9d83...a498e97f5f2d01f3c1c968316b9f978527b01a70,2,22,8,30,5,2010-09-15 15:30:14,2010-08-17 16:42:50
a498e97f5f2d01f3c1c968316b9f978527b01a70...0fb0054bc01c3695bbef7673fe60345bdcf42a13,2,31,29,60,25,2010-09-15 15:30:24,2010-08-17 20:31:21
0fb0054bc01c3695bbef7673fe60345bdcf42a13...49c62c630e48f1e73bc35181ac538ebe1cf96606,2,5,3,8,4,2010-09-15 15:30:44,2010-08-12 22:56:09
49c62c630e48f1e73bc35181ac538ebe1cf96606...e0f4e8fa11c9aee26aa3dde8091b561fb1bccab8,2,8,4,12,3,2010-09-15 15:30:59,2010-08-17 20:41:17
e0f4e8fa11c9aee26aa3dde8091b561fb1bccab8...ed0310bb6fcb243398b09c99e9dfb44ada83a412,2,13,8,21,8,2010-09-15 15:31:09,2010-08-17 21:23:00
ed0310bb6fcb243398b09c99e9dfb44ada83a412...1bf1802939eb155508123fc63e88e06e92c6ad37,4,28,16,44,8,2010-09-15 15:31:16,2010-08-17 22:23:40
1bf1802939eb155508123fc63e88e06e92c6ad37...c665b2d59e857ca52b6344b9356637a15371a3bd,3,181,170,351,10,2010-09-15 15:31:45,2010-08-18 02:24:35
c665b2d59e857ca52b6344b9356637a15371a3bd...32dab38dacce7d5144539a2bdab330409ce76101,1,10,10,20,4,2010-09-15 15:32:08,2010-08-18 03:27:13
32dab38dacce7d5144539a2bdab330409ce76101...b70c0d7f07ef8308ed8e01373886adeec4fbfe9b,1,188,188,376,3,2010-09-15 15:32:21,2010-08-18 03:29:54
b70c0d7f07ef8308ed8e01373886adeec4fbfe9b...833d720d2d76158572866b651afc12c41a92c017,5,18,4,22,11,2010-09-15 15:32:28,2010-08-18 03:35:53
833d720d2d76158572866b651afc12c41a92c017...c84d2e1b66fa2069228a95e34ec32f5eec25a526,1,21,5,26,4,2010-09-15 15:32:47,2010-08-18 14:23:56
c84d2e1b66fa2069228a95e34ec32f5eec25a526...fb8bbac5d13cac8da8844e52cd127056dc72f47a,1,3,1,4,1,2010-09-15 15:33:03,2010-08-18 14:24:10
fb8bbac5d13cac8da8844e52cd127056dc72f47a...05e38f62715416e47171b74c9afbd43f7eda010b,5,15,7,22,10,2010-09-15 15:33:12,2010-08-18 15:37:17
05e38f62715416e47171b74c9afbd43f7eda010b...8414f8b66fe80dfc72f33ba0df716536d5736a7d,3,9,7,16,8,2010-09-15 15:33:18,2010-08-18 15:50:52
8414f8b66fe80dfc72f33ba0df716536d5736a7d...d18284ddc7b8f9d8b6e35916e887b3b2dc9769b8,1,1,1,2,1,2010-09-15 15:34:04,2010-08-18 16:07:21
d18284ddc7b8f9d8b6e35916e887b3b2dc9769b8...33517de687b40fba5086a2f6d967704086b49d37,2,38,4,42,8,2010-09-15 15:36:55,2010-08-18 18:11:42
33517de687b40fba5086a2f6d967704086b49d37...ddcf03445a3b4424efa34f3c1592b19c9def89ad,2,3,3,6,3,2010-09-15 15:37:00,2010-08-18 18:29:04
ddcf03445a3b4424efa34f3c1592b19c9def89ad...6ebcef02008dad034df7824212b73cc0953ad92f,1,2,2,4,2,2010-09-15 15:37:14,2010-08-18 18:39:50
6ebcef02008dad034df7824212b73cc0953ad92f...a2248dc0b4cc81ff1ef01a31aae65836cff40d64,1,3,2,5,2,2010-09-15 15:37:24,2010-08-18 18:42:21
a2248dc0b4cc81ff1ef01a31aae65836cff40d64...914d81bd12f5a2a4fcec6638344a8d3b2981d95c,1,123,110,233,2,2010-09-15 15:37:40,2010-08-18 19:15:26
914d81bd12f5a2a4fcec6638344a8d3b2981d95c...7b3339ae9a5b0a16ce9f90584bafcf383ac21923,4,13,3,16,5,2010-09-15 15:37:55,2010-08-18 20:46:13
7b3339ae9a5b0a16ce9f90584bafcf383ac21923...caef13fc810e9c229f07580bcae3a92e3d1d1a9b,1,1,1,2,1,2010-09-15 15:38:20,2010-08-19 14:15:04
caef13fc810e9c229f07580bcae3a92e3d1d1a9b...bccaaa9c1706e78074a8e520f83ec4cc51aaad36,1,1,1,2,1,2010-09-15 15:38:46,2010-08-19 15:51:04
bccaaa9c1706e78074a8e520f83ec4cc51aaad36...6c83a4649522115778ccffcacf25edf768cb3a47,3,24,19,43,5,2010-09-15 15:38:57,2010-08-19 16:25:10
6c83a4649522115778ccffcacf25edf768cb3a47...25261d2b2b1733fc5630e8ca6c9793e94b3cac75,1,2,2,4,1,2010-09-15 15:39:05,2010-08-19 16:26:33
25261d2b2b1733fc5630e8ca6c9793e94b3cac75...2172f62c3328841497e4e32158f6329d36e4bcce,1,4,2,6,2,2010-09-15 15:40:14,2010-08-20 18:05:11
2172f62c3328841497e4e32158f6329d36e4bcce...b4a811fd014d7550cc7cb1604f18cd9ccc594d12,1,1,1,2,1,2010-09-15 15:42:35,2010-08-21 20:02:51
b4a811fd014d7550cc7cb1604f18cd9ccc594d12...404e66bc8573035b67a1c27b90a3502324d9a72b,1,44,0,44,1,2010-09-15 15:43:01,2010-08-22 01:32:14
404e66bc8573035b67a1c27b90a3502324d9a72b...b777de943ff81cf86bc798196bf24e1225e3de65,3,24,5,29,5,2010-09-15 15:43:16,2010-08-22 04:52:06
b777de943ff81cf86bc798196bf24e1225e3de65...c0f01316befc3ee071afbc3bdb93c7cf2a1c0420,1,1,1,2,1,2010-09-15 15:43:23,2010-08-22 12:05:20
c0f01316befc3ee071afbc3bdb93c7cf2a1c0420...bb57c7b545ccc8e195ad4741c849b9abf347bb5c,1,0,9,9,2,2010-09-15 15:45:55,2010-08-18 19:20:09
bb57c7b545ccc8e195ad4741c849b9abf347bb5c...e9c6dd49aeb28e3a694d366b3710668b11eaf601,3,8,8,16,7,2010-09-15 15:46:14,2010-08-23 15:45:32
e9c6dd49aeb28e3a694d366b3710668b11eaf601...8d97af482910a484d61a94ca832047a6415b000c,1,7,2,9,3,2010-09-15 15:46:40,2010-08-23 16:48:21
8d97af482910a484d61a94ca832047a6415b000c...b810c290aa55235ec2df3f66db804b9662aebb7c,1,12,7,19,3,2010-09-15 15:47:15,2010-08-23 19:03:34
b810c290aa55235ec2df3f66db804b9662aebb7c...7b0733b872791e21dadd8fbbe6384be9c5b81bc7,1,2,9,11,1,2010-09-15 15:47:24,2010-08-23 19:04:00
7b0733b872791e21dadd8fbbe6384be9c5b81bc7...7ed2ca4ae6b0023894376bfa6a406f70c94ad2a6,4,209,12,221,10,2010-09-15 15:59:51,2010-08-23 19:48:13
7ed2ca4ae6b0023894376bfa6a406f70c94ad2a6...a043fc1b7a7e3fd4c364c3db701009b680cbc720,2,6,1,7,3,2010-09-15 15:59:57,2010-08-23 19:58:30
a043fc1b7a7e3fd4c364c3db701009b680cbc720...05c3b4d8e45ad655a1775956ae10cbbb204476b4,1,12,2,14,5,2010-09-15 16:00:04,2010-08-23 20:09:04
05c3b4d8e45ad655a1775956ae10cbbb204476b4...290973e49a40c2b88400d7049b1f6ed7fac4c687,1,4,0,4,2,2010-09-15 16:00:11,2010-08-23 20:17:42
290973e49a40c2b88400d7049b1f6ed7fac4c687...546403b83c7902d7a2191d07f01b178a4451873d,1,1,1,2,1,2010-09-15 16:01:31,2010-08-19 22:15:00
546403b83c7902d7a2191d07f01b178a4451873d...656fb5d308d9ed62345c8fd10f0f19d85df4904e,1,4,0,4,2,2010-09-15 16:01:58,2010-08-24 20:39:39
656fb5d308d9ed62345c8fd10f0f19d85df4904e...6b5292d0214c48ff61a80476e0a12fdea0100ea7,1,24,0,24,1,2010-09-15 16:04:13,2010-08-25 03:59:33
6b5292d0214c48ff61a80476e0a12fdea0100ea7...d299a732d591033f5242bc320150836060299f22,4,4,4,8,4,2010-09-15 16:04:19,2010-08-25 03:59:51
d299a732d591033f5242bc320150836060299f22...1732fe4bdd88991262bc13349b63e17c740fb0c8,2,11,1,12,3,2010-09-15 16:04:23,2010-08-25 06:10:12
1732fe4bdd88991262bc13349b63e17c740fb0c8...09e5bce602b6d9b95759a5ac8b9dae81004f87d8,1,1,1,2,1,2010-09-15 16:04:28,2010-08-25 13:43:04
09e5bce602b6d9b95759a5ac8b9dae81004f87d8...185713ea36e77e12e2ce4650fda9b03451967784,2,3,3,6,2,2010-09-15 16:04:33,2010-08-25 13:52:06
185713ea36e77e12e2ce4650fda9b03451967784...5c5de2a56d737ec7729d3d37bec91df82dcee8bd,1,6,1,7,1,2010-09-15 16:06:16,2010-08-25 17:51:41
5c5de2a56d737ec7729d3d37bec91df82dcee8bd...96371079d80d3a26d05c13cfa743b4ab00b572b2,1,4,5,9,4,2010-09-15 17:59:21,2010-08-25 17:51:57
96371079d80d3a26d05c13cfa743b4ab00b572b2...2b229bfa802678c973acce02180f26968a298ceb,1,1,1,2,2,2010-09-15 17:59:26,2010-08-25 18:13:32
2b229bfa802678c973acce02180f26968a298ceb...01228574ab2258c37c63aaca8502d9ef2f3a8824,1,179,177,356,1,2010-09-15 17:59:37,2010-08-25 18:20:19
01228574ab2258c37c63aaca8502d9ef2f3a8824...24f373dc2728d87a65f0e04fe3eae1537f3c306e,2,28,1,29,2,2010-09-15 18:01:29,2010-08-26 04:28:35
24f373dc2728d87a65f0e04fe3eae1537f3c306e...56260ff39d03ac634f5ff91ba8e98d97369357bf,1,1,1,2,1,2010-09-15 18:01:40,2010-08-26 11:37:37
56260ff39d03ac634f5ff91ba8e98d97369357bf...d92825979d60d6e05281bc2102608809d66f0c41,1,22,10,32,6,2010-09-15 18:02:53,2010-08-26 13:50:22
d92825979d60d6e05281bc2102608809d66f0c41...eb1a934896ad2a5c62751dedf0a994bd2c08b947,1,12,3,15,1,2010-09-15 18:03:02,2010-08-26 14:07:13
eb1a934896ad2a5c62751dedf0a994bd2c08b947...524eec4c688783a245693554caa04f828384eeff,1,2,3,5,2,2010-09-15 18:03:12,2010-08-26 14:28:35
524eec4c688783a245693554caa04f828384eeff...8af8d5c04e9fcbd55ad6d58c6eef185b76184a94,2,15,2,17,5,2010-09-15 18:03:56,2010-08-26 16:13:08
8af8d5c04e9fcbd55ad6d58c6eef185b76184a94...4c0e61c92269ff4ca173489d3e0e6ee5bbaada21,1,14,10,24,3,2010-09-15 18:06:02,2010-08-26 17:33:26
4c0e61c92269ff4ca173489d3e0e6ee5bbaada21...6d0e9e7cdd1e7b8c9d7ade4606342e91255f42ae,2,5,4,9,5,2010-09-15 18:06:07,2010-08-26 17:47:27
6d0e9e7cdd1e7b8c9d7ade4606342e91255f42ae...e95fda9ab83b9d1dd099262498789d303ccbc912,1,3,2,5,3,2010-09-15 18:06:15,2010-08-26 17:50:34
e95fda9ab83b9d1dd099262498789d303ccbc912...534d062d76264aa83a3cd97ac61ade4d4c359952,1,1,1,2,1,2010-09-15 18:06:20,2010-08-26 17:56:55
534d062d76264aa83a3cd97ac61ade4d4c359952...ba964b908b2180d7a0dae7286ea9a8c6a68b5276,1,2,1,3,1,2010-09-15 18:12:43,2010-08-27 19:00:00
ba964b908b2180d7a0dae7286ea9a8c6a68b5276...ad4eae22db50885c8dbff17b4e5398cd544d983b,3,15,12,27,14,2010-09-15 18:14:22,2010-08-27 17:53:55
ad4eae22db50885c8dbff17b4e5398cd544d983b...ce4693ad09f8d8ae4a86d0c2b2f200bca07f37d4,1,3,2,5,2,2010-09-15 18:14:27,2010-08-27 18:39:28
ce4693ad09f8d8ae4a86d0c2b2f200bca07f37d4...eb06f746735b5726f46bf4b3af6c5ad29ba10106,2,9,6,15,5,2010-09-15 18:18:42,2010-08-25 20:10:31
eb06f746735b5726f46bf4b3af6c5ad29ba10106...955cb0426883b49f818e7e8ca0460917564321db,1,31,0,31,1,2010-09-15 18:19:42,2010-08-10 22:14:20
955cb0426883b49f818e7e8ca0460917564321db...7a36dfe91027b49f5686aa957a662d78a82a609a,3,26,13,39,11,2010-09-15 18:19:42,2010-08-26 19:55:24
7a36dfe91027b49f5686aa957a662d78a82a609a...9f1f49e60be5a171647e9914f0a6043672edfdf2,1,1,1,2,1,2010-09-15 18:19:50,2010-08-26 21:17:05
9f1f49e60be5a171647e9914f0a6043672edfdf2...6c795a18b9cc8d12c6ab8604367c1f89b83954c9,3,14,6,20,7,2010-09-15 18:20:00,2010-08-27 20:38:56
6c795a18b9cc8d12c6ab8604367c1f89b83954c9...598dc752408cbd50dff9f5cf3c66efc8eed7a887,2,8,5,13,6,2010-09-15 18:23:00,2010-08-25 17:40:01
598dc752408cbd50dff9f5cf3c66efc8eed7a887...0a455c09786cae42f9d0c0ab6349dd0c7c138be7,3,114,5,119,9,2010-09-15 18:25:12,2010-08-29 20:03:17
0a455c09786cae42f9d0c0ab6349dd0c7c138be7...7e94f7b7129ab04ede112bb3f780c2bd2c9d6e89,1,8,2,10,1,2010-09-15 18:25:18,2010-08-30 01:20:54
7e94f7b7129ab04ede112bb3f780c2bd2c9d6e89...b02155fdb50e5f74f2ce189a446395bfd8fe546a,2,1,2,3,2,2010-09-15 18:25:24,2010-08-30 01:24:15
b02155fdb50e5f74f2ce189a446395bfd8fe546a...9e1347233b8939f6fbfc0449208631933b2defcf,1,53,53,106,1,2010-09-15 18:25:30,2010-08-30 01:27:59
9e1347233b8939f6fbfc0449208631933b2defcf...a21c781af0dadfe29e69337ebef334f756dba0a1,3,23,11,34,5,2010-09-15 18:25:36,2010-08-30 02:17:22
a21c781af0dadfe29e69337ebef334f756dba0a1...cdca1fa67dd76def53045b73fa6f64de4570b918,1,1,1,2,1,2010-09-15 18:25:42,2010-08-30 03:54:48
cdca1fa67dd76def53045b73fa6f64de4570b918...89561cea6154dc3cf77ca6fb4c9bd6797d89fd08,1,5,2,7,1,2010-09-15 18:25:49,2010-08-30 04:14:03
89561cea6154dc3cf77ca6fb4c9bd6797d89fd08...5f26f5b4ab5d8bed2e19c365cdcf84a6993dfa25,1,8,2,10,1,2010-09-15 18:25:57,2010-08-30 04:16:39
5f26f5b4ab5d8bed2e19c365cdcf84a6993dfa25...59aa16c9da1fe9550e59f11dbec5c47ca09f8a26,1,5,0,5,1,2010-09-15 18:26:05,2010-08-30 14:20:02
59aa16c9da1fe9550e59f11dbec5c47ca09f8a26...c533ddf1699eae72a7e52ea5706d1da1b70db8e4,2,35,22,57,8,2010-09-15 18:26:32,2010-08-30 14:56:17
c533ddf1699eae72a7e52ea5706d1da1b70db8e4...760fd054e396e17b0071429174959143b7f5f4a2,1,1,1,2,1,2010-09-15 18:26:42,2010-08-30 16:36:39
760fd054e396e17b0071429174959143b7f5f4a2...bb7759ebf8b8bf14757218981d08cdb0973b81b6,1,2,3,5,2,2010-09-15 18:27:15,2010-08-30 22:37:08
bb7759ebf8b8bf14757218981d08cdb0973b81b6...b6f400ef69dc683289edd03340f6794088b91507,2,43,36,79,3,2010-09-15 18:40:43,2010-08-22 17:54:03
b6f400ef69dc683289edd03340f6794088b91507...5191e5f0f5d4b1905a4775657b9cdf6bc1daf58e,1,9,15,24,4,2010-09-15 18:40:53,2010-08-22 21:23:50
5191e5f0f5d4b1905a4775657b9cdf6bc1daf58e...4c677b4759a289c22b6b945d8b1d9ad65d3face2,3,14,20,34,15,2010-09-15 18:41:05,2010-08-26 16:18:03
4c677b4759a289c22b6b945d8b1d9ad65d3face2...2bd429278f1a9d7bd7d54fb5e9b9094a09196952,1,2,1,3,1,2010-09-15 18:45:13,2010-08-19 18:54:01
2bd429278f1a9d7bd7d54fb5e9b9094a09196952...0c434ca442aec92f878d97dfb149c67de42bd5f8,5,17,0,17,5,2010-09-15 18:50:58,2010-08-23 17:55:34
0c434ca442aec92f878d97dfb149c67de42bd5f8...5c512c70a08a62e6e8949708f1033acc068e8c0f,4,8,23,31,16,2010-09-15 18:51:00,2010-08-25 17:01:36
5c512c70a08a62e6e8949708f1033acc068e8c0f...cdd8ed43923b89cef742173e317c8c2d0be4a36a,4,17,11,28,11,2010-09-15 18:51:02,2010-08-31 04:20:31
cdd8ed43923b89cef742173e317c8c2d0be4a36a...f808dc9cdcad915cccd27b1761e24541a534b62f,1,42,28,70,1,2010-09-15 18:51:14,2010-08-31 08:23:10
f808dc9cdcad915cccd27b1761e24541a534b62f...8448c4bdc18c76cbd0affed4e4ab57370e68cbe3,1,2,2,4,1,2010-09-15 18:51:22,2010-08-31 08:29:48
8448c4bdc18c76cbd0affed4e4ab57370e68cbe3...559e348e4280d7e02b6c2eed85e3b16cba3fbd78,1,5,3,8,1,2010-09-15 18:51:29,2010-08-31 08:30:08
559e348e4280d7e02b6c2eed85e3b16cba3fbd78...e317820a56f16318df58db5f367da1970177f618,4,14,10,24,10,2010-09-15 18:52:12,2010-08-29 18:54:33
e317820a56f16318df58db5f367da1970177f618...b4007cc5610d8fba8fd7427c8441cca1c31bb9d5,1,211,205,416,7,2010-09-15 18:52:21,2010-08-31 07:02:59
b4007cc5610d8fba8fd7427c8441cca1c31bb9d5...a215c88d23996fbcef8b70d9491e69683fe1cb5d,1,1,1,2,1,2010-09-15 18:53:20,2010-08-31 07:03:09
a215c88d23996fbcef8b70d9491e69683fe1cb5d...c0a629af4eb2c0ee5dd550fd6074c2124619cac7,2,4,3,7,3,2010-09-15 18:53:26,2010-08-31 09:06:53
c0a629af4eb2c0ee5dd550fd6074c2124619cac7...d9a5ccd44404d92e302a55a0b8d51e623f1942aa,1,4,2,6,2,2010-09-15 18:53:32,2010-08-31 09:18:34
d9a5ccd44404d92e302a55a0b8d51e623f1942aa...072042ff1ce6a472bf8d6f288c05680d14fc23cf,2,3,2,5,3,2010-09-15 18:53:41,2010-08-31 09:31:46
072042ff1ce6a472bf8d6f288c05680d14fc23cf...66d2187dc9eb2d1c9536ec6716892e9b0e256b66,1,1,1,2,1,2010-09-15 18:54:21,2010-08-31 15:16:18
66d2187dc9eb2d1c9536ec6716892e9b0e256b66...95cffc932f8ada7f0481fdc590fb185385cfbcae,1,0,5,5,4,2010-09-15 18:57:15,2010-09-02 14:04:27
95cffc932f8ada7f0481fdc590fb185385cfbcae...5dfac589ee408ac16b7f94f6c201f588da208723,1,3,11,14,3,2010-09-15 18:57:34,2010-09-02 14:12:07
5dfac589ee408ac16b7f94f6c201f588da208723...46df3e603cf7c8d33727933846fbccf8830ce0f2,1,4,0,4,1,2010-09-15 18:57:40,2010-09-02 14:16:52
46df3e603cf7c8d33727933846fbccf8830ce0f2...20b546ae70f1a1a45776acec123b3483b4265c9d,1,13,13,26,2,2010-09-15 18:57:47,2010-09-02 14:17:48
20b546ae70f1a1a45776acec123b3483b4265c9d...5ecb7b97d214415387fed085a6b903b03fe91862,4,15,4,19,6,2010-09-15 18:57:55,2010-09-02 15:26:38
5ecb7b97d214415387fed085a6b903b03fe91862...cfeb9c90fd34ce92f8e054245825aacf10b3c20f,1,22,30,52,9,2010-09-15 19:00:54,2010-08-10 21:44:38
cfeb9c90fd34ce92f8e054245825aacf10b3c20f...f6c66f106cfb8fee5907d0aa7f0316be2966de52,2,4,1,5,3,2010-09-15 19:01:18,2010-08-12 15:28:27
f6c66f106cfb8fee5907d0aa7f0316be2966de52...53c38f0c8ccadae8c8612baf792f4ebea3b435f8,1,29,0,29,1,2010-09-15 21:18:47,2010-09-08 14:36:10
53c38f0c8ccadae8c8612baf792f4ebea3b435f8...4b18b7d113084021f1789e63c96baa570229405c,1,3,0,3,1,2010-09-15 21:20:23,2010-09-08 14:36:21
4b18b7d113084021f1789e63c96baa570229405c...61259ea0a3742f7ced106f9642d9247c2fd6c4b7,1,15,1,16,2,2010-09-16 02:05:16,2010-09-16 02:04:39
61259ea0a3742f7ced106f9642d9247c2fd6c4b7...45d71a84645c47f9a5945b5ee8bed9257aa8cb0f,1,1,1,2,1,2010-09-17 05:26:03,2010-09-17 05:25:33
45d71a84645c47f9a5945b5ee8bed9257aa8cb0f...417dd24161f3f97f6c18bc9dd06967be14954eef,1,1,1,2,1,2010-09-17 15:49:59,2010-09-17 15:46:59
417dd24161f3f97f6c18bc9dd06967be14954eef...268a8a39dfa9ddb0401c3ab82c01ff01d28cee86,2,18,27,45,8,2010-09-18 03:55:41,2010-09-18 03:55:41
268a8a39dfa9ddb0401c3ab82c01ff01d28cee86...0f4ecabbe42eb92289b3b354d978895607db11ca,1,5,2,7,1,2010-09-19 03:42:06,2010-09-19 03:41:47
0f4ecabbe42eb92289b3b354d978895607db11ca...278bd2ac2f2efbee556f32c13c1b6803224d1c01,4,11,3,14,4,2010-09-23 14:32:26,2010-09-23 14:32:26
278bd2ac2f2efbee556f32c13c1b6803224d1c01...0d2fbaf50a1a97994dbfafa7df5684653e5813d7,2,2,2,4,2,2010-09-23 18:04:43,2010-09-23 18:04:43
0d2fbaf50a1a97994dbfafa7df5684653e5813d7...ae8f18e9216e42aa2eca9fb837908f4c2af7ce6d,1,9,7,16,1,2010-09-27 12:33:42,2010-09-23 14:30:27
ae8f18e9216e42aa2eca9fb837908f4c2af7ce6d...d260bd608659d0a4610cdcec3ca9e355b18bf9b2,3,7,6,13,7,2010-09-27 12:36:25,2010-09-25 11:21:25
d260bd608659d0a4610cdcec3ca9e355b18bf9b2...6e47ce2fe75fc871d11bef53c5b930dda9c07e52,1,10,4,14,5,2010-09-27 13:41:22,2010-08-30 14:26:20
6e47ce2fe75fc871d11bef53c5b930dda9c07e52...4e9c160741f9d85ffcedc75c039c6f1c80d4b7a8,1,5,2,7,3,2010-09-27 13:43:04,2010-09-19 04:26:35
4e9c160741f9d85ffcedc75c039c6f1c80d4b7a8...a39f3a59e9dce108c7e69c8f48c11f26db52a817,1,1,1,2,1,2010-10-01 17:20:54,2010-08-19 21:04:49
dc1796d7d4097166ff0cd16c5962926c160d776c...8efddce12cf99a4b2f3b6c9403b2ef61489b2ade,1,0,3,3,2,2010-08-09 17:33:00,2010-08-09 17:32:29
8efddce12cf99a4b2f3b6c9403b2ef61489b2ade...7d96c8df49a173d96ce14f8e8ffab21f352cfacd,1,3,3,6,2,2010-08-09 17:49:09,2010-08-09 17:49:09
7d96c8df49a173d96ce14f8e8ffab21f352cfacd...f1f93a4b10cfa65e4d66ad8827b837964e507a90,1,5,1,6,2,2010-08-09 18:43:16,2010-08-09 17:57:30
f1f93a4b10cfa65e4d66ad8827b837964e507a90...3841707c32910441dda23ca9a3a82e0255287cfa,1,3,6,9,3,2010-08-09 18:43:16,2010-08-09 18:42:24
3841707c32910441dda23ca9a3a82e0255287cfa...22057840db7c2c74fc3fa30a30b7dcd34149b92a,1,1,1,2,1,2010-08-09 18:43:16,2010-08-09 18:30:51
22057840db7c2c74fc3fa30a30b7dcd34149b92a...a1f8c3698397b9fa395578e901250eea7b312060,2,19,8,27,9,2010-08-09 19:17:11,2010-08-09 19:17:11
a39f3a59e9dce108c7e69c8f48c11f26db52a817...2905ea2e195d0c4cd74322cb7057becbd2c51440,1,2,2,4,1,2010-10-08 21:03:39,2010-09-10 18:25:37
a39f3a59e9dce108c7e69c8f48c11f26db52a817...37063ffd261dee90cc53298ac8c0f7a8b9388331,1,4,2,6,1,2010-10-08 02:54:40,2010-10-08 02:53:59
a1f8c3698397b9fa395578e901250eea7b312060...d5953b39fce0ab26c2e9d7d8effafab0875f37f3,3,5,0,5,3,2010-08-09 20:41:36,2010-08-09 20:41:36
a1f8c3698397b9fa395578e901250eea7b312060...4a0c8053f2ec64b28b48e91d334386582a362b59,1,5,4,9,3,2010-08-09 19:25:06,2010-08-09 19:25:06
4a0c8053f2ec64b28b48e91d334386582a362b59...b12c0a79fecde4ec53dc9fadaf518b56fc3aee4d,3,29,2,31,6,2010-08-09 20:15:41,2010-08-09 20:15:41
136024a59fcaf2044d8b95c1a77437bd1f01f908...6f0c76a552e60f2768796f61e55088dfda66784d,2,8,1,9,2,2010-10-12 06:49:10,2010-10-02 19:25:35
6f0c76a552e60f2768796f61e55088dfda66784d...13d28aae02cab41679bf09074fefd2b28bbe30c8,2,16,18,34,3,2010-10-12 06:49:23,2010-10-03 21:29:49
13d28aae02cab41679bf09074fefd2b28bbe30c8...ebb7c7f70586ddfea6ea6d8b8ec9d0af1c5eb7fc,1,4,0,4,1,2010-10-13 14:37:17,2010-09-09 21:55:20
ebb7c7f70586ddfea6ea6d8b8ec9d0af1c5eb7fc...8d79226466632ca8a57a3b140cf3b0f0f2e60f19,1,43,25,68,8,2010-10-20 23:14:08,2010-10-18 18:33:24
8d79226466632ca8a57a3b140cf3b0f0f2e60f19...ee5a18c6ce6da9bcb2b1fbc0c5830ff4a77dd683,1,1,1,2,1,2010-10-25 22:45:03,2010-08-06 14:13:51
ee5a18c6ce6da9bcb2b1fbc0c5830ff4a77dd683...1f57383462db6a754c99abb3208a1fb985f67918,1,2,0,2,1,2010-10-26 04:32:52,2010-10-22 22:10:52
1f57383462db6a754c99abb3208a1fb985f67918...954574cff3cfd26ae598098f5b9b890699e665d8,1,18,0,18,2,2010-10-26 05:19:18,2010-10-26 04:21:04
954574cff3cfd26ae598098f5b9b890699e665d8...e9429566d75a8aaac3b8fdf70f174dca964d04b7,1,10,2,12,6,2010-10-26 05:19:18,2010-10-26 04:44:46
e9429566d75a8aaac3b8fdf70f174dca964d04b7...1dcc81e34eba2f590b387358a25643aa5d12d274,1,33,4,37,7,2010-10-26 05:19:18,2010-10-26 04:46:46
1dcc81e34eba2f590b387358a25643aa5d12d274...b41a9f678c72ecaa2f509df00ef79c67d216d662,4,11,3,14,4,2010-10-26 19:05:55,2010-10-26 19:05:55
b41a9f678c72ecaa2f509df00ef79c67d216d662...0737ad69095b8d0d036805705f989f76ca81bc86,1,3,3,6,3,2010-10-26 19:51:25,2010-10-20 20:19:56
0737ad69095b8d0d036805705f989f76ca81bc86...4f5c02f8d92ff213b71b88f5eb643b7f62b50abc,1,4,2,6,1,2010-10-26 19:51:25,2010-09-22 23:22:27
4f5c02f8d92ff213b71b88f5eb643b7f62b50abc...9514cc8ce75fbc81870b5821bbdb483fcd57b81b,1,1,1,2,1,2010-10-27 02:57:40,2010-10-27 02:57:40
9514cc8ce75fbc81870b5821bbdb483fcd57b81b...6c5553c4c9ef89e5c4b31e84ac9a7cc7100653a8,1,3,3,6,3,2010-11-02 21:13:15,2010-11-02 19:29:31
6c5553c4c9ef89e5c4b31e84ac9a7cc7100653a8...e1ef4d5c551f376b7302e12bda6cc11c20954a60,3,18,7,25,8,2010-11-03 21:30:07,2010-11-03 21:30:07
e1ef4d5c551f376b7302e12bda6cc11c20954a60...0c92fea8d7cb5c2807ec5ccad140b18d04cdee10,2,98,8,106,4,2010-11-03 21:30:33,2010-08-26 19:17:41
0c92fea8d7cb5c2807ec5ccad140b18d04cdee10...7d31376cc33c2971b3866609afd9703fddd44b9c,1,28,0,28,1,2010-11-03 21:30:44,2010-08-26 20:30:10
7d31376cc33c2971b3866609afd9703fddd44b9c...ea90c5d3540e6d5cf8759e48eedaad48a425a191,1,6,4,10,5,2010-11-08 15:52:41,2010-10-09 01:26:57
ea90c5d3540e6d5cf8759e48eedaad48a425a191...6f827308eb8f2dd59a0fc278bc968835f950a657,1,12,1,13,2,2010-11-08 15:58:03,2010-11-07 21:31:53
6f827308eb8f2dd59a0fc278bc968835f950a657...bdf4a9adfe39376de0ef4f5f88f7c0bb61cd2eb3,1,1,1,2,1,2010-11-08 15:58:22,2010-11-07 23:12:05
bdf4a9adfe39376de0ef4f5f88f7c0bb61cd2eb3...8956ac99d0f374b0653776c18c15ca84d497165d,1,8,0,8,1,2010-11-08 15:58:41,2010-11-08 05:17:09
8956ac99d0f374b0653776c18c15ca84d497165d...2dd7f54687dc034b39098728d49238c65f4e44fa,1,65,0,65,1,2010-11-08 15:59:07,2010-11-08 05:17:40
2dd7f54687dc034b39098728d49238c65f4e44fa...6280a732012821396ee8432470884b2d38fb48c3,1,4,2,6,3,2010-11-08 15:59:21,2010-11-08 14:41:35
6280a732012821396ee8432470884b2d38fb48c3...d7b885a44f4816874cdb69e6962f483147f9ed43,1,5,0,5,2,2010-11-09 15:56:09,2010-09-03 22:41:22
d7b885a44f4816874cdb69e6962f483147f9ed43...6d97633a36e2fb589ab68cdefe6ea727d4f3f2aa,2,26,14,40,22,2010-11-15 17:14:54,2010-11-15 17:14:54
6d97633a36e2fb589ab68cdefe6ea727d4f3f2aa...94559a6985f6b6bb3875da1bc366a299601415cb,2,12,1,13,3,2010-11-19 18:35:47,2010-08-25 02:16:00
94559a6985f6b6bb3875da1bc366a299601415cb...07f27e6d8f05c1372559fdaf3f53d3a08b55dc5c,1,1,1,2,1,2010-11-19 18:52:53,2010-08-25 02:23:19
07f27e6d8f05c1372559fdaf3f53d3a08b55dc5c...41bbcdab002e17a0b0a13e0b219c25cf6926fddc,4,9,3,12,4,2010-11-19 18:54:24,2010-11-19 18:54:24
41bbcdab002e17a0b0a13e0b219c25cf6926fddc...e624de4c5121a174d66fb3d372d8a3097af6d54d,1,2,2,4,1,2010-11-20 00:51:04,2010-10-29 19:04:22
e624de4c5121a174d66fb3d372d8a3097af6d54d...17338d81b063812938d656074d4ab0138a260155,1,8,1,9,1,2010-11-20 04:30:46,2010-10-30 19:41:35
17338d81b063812938d656074d4ab0138a260155...e6161d10ceb6e4cc826782d00a566166eb5a5add,2,6,2,8,3,2010-11-20 04:31:37,2010-11-17 04:15:50
e6161d10ceb6e4cc826782d00a566166eb5a5add...3d0d33f1a9545e9292ec63bf2d8ac545c7094378,1,15,3,18,1,2010-11-20 05:00:49,2010-09-28 16:54:00
3d0d33f1a9545e9292ec63bf2d8ac545c7094378...30e604c3ccd325f8ec0502fd0830bbc90df860de,2,14,14,28,12,2010-11-20 05:00:54,2010-10-28 14:38:24
30e604c3ccd325f8ec0502fd0830bbc90df860de...c0044d58a7c43adb1456b676456c4f63aaed309b,4,24,8,32,8,2010-11-20 05:01:20,2010-10-28 14:50:39
c0044d58a7c43adb1456b676456c4f63aaed309b...cdbc4eba5950b8ae2572845c4206e841cb309672,4,4,4,8,4,2010-11-20 05:03:20,2010-11-20 05:03:20
cdbc4eba5950b8ae2572845c4206e841cb309672...64fd91d00ff3b9919421427d2152f29d4826e5fd,1,2,1,3,1,2010-11-20 05:16:58,2010-11-18 20:17:11
64fd91d00ff3b9919421427d2152f29d4826e5fd...e1570627aac10200317b211542546ca8ac2ab28b,1,1,1,2,1,2010-11-20 05:31:57,2010-10-17 21:09:07
e1570627aac10200317b211542546ca8ac2ab28b...269c53e84b5e37597b013edadb93ba028ddb3ee3,1,13,0,13,2,2010-11-20 05:34:19,2010-10-27 21:21:21
269c53e84b5e37597b013edadb93ba028ddb3ee3...119dba996e6fb00ac00ec9f446e503c09ec26e99,1,1,8,9,1,2010-11-20 05:45:54,2010-11-20 05:45:54
119dba996e6fb00ac00ec9f446e503c09ec26e99...eb66a29554f56fd2dd858affa033be090c968355,1,8,1,9,1,2010-11-20 06:02:26,2010-10-30 19:41:35
eb66a29554f56fd2dd858affa033be090c968355...3f469b555721c37ecd989d7b7d86e122d5daca4d,1,1,1,2,1,2010-11-20 06:08:56,2010-11-17 15:30:22
3f469b555721c37ecd989d7b7d86e122d5daca4d...ad8c021c546b687e4bf9327aad50854fa0f0d19c,4,8,8,16,7,2010-11-20 07:37:38,2010-09-07 21:04:35
ad8c021c546b687e4bf9327aad50854fa0f0d19c...65ee827e74b22331d596e6d51082d58613c18e09,1,1,1,2,1,2010-11-21 14:45:50,2010-11-20 13:03:33
b12c0a79fecde4ec53dc9fadaf518b56fc3aee4d...5bc311ba10fa1266854e096968abb914dea78523,1,1,0,1,1,2010-08-09 20:43:06,2010-08-09 20:43:06
65ee827e74b22331d596e6d51082d58613c18e09...0eb017e9b2828155a67c5612183337b89e12e291,4,5,5,10,5,2010-12-07 22:16:42,2010-12-07 22:16:42
0eb017e9b2828155a67c5612183337b89e12e291...8351914c35437fed4a279a428caaf0133204b7b2,2,2,2,4,2,2010-12-08 14:33:20,2010-12-08 14:33:20
65ee827e74b22331d596e6d51082d58613c18e09...74df9ddc88d47f850d86b496b14ea4d47059fa80,1,196,196,392,1,2010-11-28 04:41:50,2010-09-10 15:25:28
4162c6ff2acc98258b9d7de9adcd022c754b3ba5...790d8851b3c8ff73e2b4e7c3e0038e4eeae28431,5,210,18,228,11,2010-08-10 00:20:11,2010-08-10 00:19:00
790d8851b3c8ff73e2b4e7c3e0038e4eeae28431...c227068d0d45ac2131551070d240e2f1fa88e58b,1,2,2,4,2,2010-08-10 01:02:39,2010-08-10 01:02:39
c227068d0d45ac2131551070d240e2f1fa88e58b...b2569f1650e5486ab201bf13ba086d86820a8f3c,2,50,33,83,20,2010-08-10 02:14:06,2010-08-10 02:14:06
b2569f1650e5486ab201bf13ba086d86820a8f3c...dd152a0686abf1af5894231b292b6dcdd16b19ea,3,0,39,39,4,2010-08-10 02:23:43,2010-08-10 02:23:43
dd152a0686abf1af5894231b292b6dcdd16b19ea...d607f3dcdcf97b1dc7fca59f94b36d8f21e1ee53,1,39,9,48,5,2010-08-10 13:40:33,2010-08-10 13:40:33
d607f3dcdcf97b1dc7fca59f94b36d8f21e1ee53...c629c8e2c2e414961c141d1b3ca22a627dd9cc65,1,9,39,48,5,2010-08-10 13:48:27,2010-08-10 13:48:27
c629c8e2c2e414961c141d1b3ca22a627dd9cc65...011e22c0646d118aa3908a96ba5ef6170d273e4e,1,29,0,29,2,2010-08-10 15:07:41,2010-08-10 15:07:41
aa9b13636f892a0f3a1cb8ffc5e5d719af7cc788...efee57d51b028496e42da288ed2b7b420118ceea,1,3,0,3,1,2010-12-22 05:24:34,2010-12-22 05:24:34
efee57d51b028496e42da288ed2b7b420118ceea...113c5e3108a4b421532f20a3fab86c12da5ba480,2,39,3,42,5,2010-12-24 18:33:39,2010-12-24 18:31:46
113c5e3108a4b421532f20a3fab86c12da5ba480...c71a9ee13b2f1c405f736433724cd3b57374112a,1,1,1,2,1,2010-12-25 07:02:59,2010-12-25 07:02:59
c71a9ee13b2f1c405f736433724cd3b57374112a...87912f1b190736d215b203e11eed80c8383c97be,1,1,1,2,1,2010-12-25 07:19:03,2010-12-25 07:19:03
87912f1b190736d215b203e11eed80c8383c97be...2f0f69fb6568f0a923740bb469b2e158a3f6e8e6,3,3,0,3,3,2010-12-25 07:28:21,2010-12-25 07:28:21
2f0f69fb6568f0a923740bb469b2e158a3f6e8e6...ada376198a7d5a3004d95c76f8a4fe58e9058da3,1,17,4,21,3,2010-12-29 17:43:14,2010-10-20 20:32:49
ada376198a7d5a3004d95c76f8a4fe58e9058da3...5ab2e7d77a54a05b3df4c4936511fec9b9d09795,1,5,1,6,2,2010-12-29 18:12:47,2010-12-27 19:59:58
5ab2e7d77a54a05b3df4c4936511fec9b9d09795...5cfe1eb716e35f6b0815ac346e168750d0868d63,1,1,0,1,1,2011-01-03 01:30:15,2011-01-03 01:30:15
5cfe1eb716e35f6b0815ac346e168750d0868d63...136ad2616695b02eb7e8e8c67cb3598ec677b7fd,1,3,1,4,2,2011-01-21 22:17:20,2011-01-21 22:17:20
136ad2616695b02eb7e8e8c67cb3598ec677b7fd...eaf37fcd7fc483fd62f2c3bd92e8bc577b2b486a,1,1,1,2,1,2011-01-21 22:23:21,2011-01-21 22:23:21
eaf37fcd7fc483fd62f2c3bd92e8bc577b2b486a...5865515aa11e731dbe265bdefa8faf8c5bb21f6f,1,3,2,5,3,2011-01-21 23:57:29,2011-01-21 23:57:29
5865515aa11e731dbe265bdefa8faf8c5bb21f6f...de11476677e159fd6043b803c03a32d1d8e67332,1,2,4,6,1,2011-01-22 06:33:27,2011-01-22 06:33:27
de11476677e159fd6043b803c03a32d1d8e67332...a1810524d6ecd22250b97369c58a9d2bd090702e,1,11,1,12,1,2011-02-18 00:56:29,2011-02-18 00:56:29
a1810524d6ecd22250b97369c58a9d2bd090702e...3047651c7f342b4a3ad994a3301918446aa9edfd,1,2,0,2,1,2011-02-28 23:41:44,2011-02-28 23:41:44
3047651c7f342b4a3ad994a3301918446aa9edfd...ca84e8ebf79d7272a6cfc535c88f154cb00136ec,1,11,2,13,1,2011-03-06 02:30:37,2011-03-06 02:30:37
011e22c0646d118aa3908a96ba5ef6170d273e4e...47ede6c63e23ba8f2eda07aadca062a47fc5e7a1,1,31,0,31,1,2010-08-10 22:14:20,2010-08-10 22:14:20
011e22c0646d118aa3908a96ba5ef6170d273e4e...4d42a72c3d24a3102e35c55aaf495cb999e134b6,1,3,2,5,3,2010-08-10 17:31:13,2010-08-10 17:31:13
4d42a72c3d24a3102e35c55aaf495cb999e134b6...b3f64d75e761c8badf2f9f9da0729f0224178963,2,80,4,84,5,2010-08-10 17:31:42,2010-08-10 17:31:42
011e22c0646d118aa3908a96ba5ef6170d273e4e...f800c20958ba03e25e85732783a754595a433e5f,1,11,3,14,5,2010-08-10 17:17:45,2010-08-10 17:17:45
3872624664f1d96d9d50e55300ae58b4f35a4d45...b322f7610762c5471f163d0c13b01bf1c8c195ca,1,1,1,2,1,2010-08-11 00:55:21,2010-08-11 00:55:21
e095921c9f0bc4c0fb5d17933b62fe0ed90d1715...64210308ba3a00377d211ae2e3499f65b0962591,1,1,1,2,1,2010-08-10 17:56:55,2010-08-10 17:56:55
64210308ba3a00377d211ae2e3499f65b0962591...06cb7f821feeab260946303600db56681d1bb07b,8,16,15,31,14,2010-08-10 18:44:10,2010-08-10 17:29:52
06cb7f821feeab260946303600db56681d1bb07b...e8e772181a01d77efd988c27ad4418271f440e56,5,61,70,131,26,2010-08-10 18:44:10,2010-08-10 18:35:02
e8e772181a01d77efd988c27ad4418271f440e56...787f22717fe74e78adde57679e3dbbdcd5006b8d,3,39,0,39,4,2010-08-10 18:44:10,2010-08-10 18:38:26
787f22717fe74e78adde57679e3dbbdcd5006b8d...c8e3f80a25862ef578c67946a00fe5223a6da590,1,1,1,2,1,2010-08-10 18:44:10,2010-08-10 18:43:40
c8e3f80a25862ef578c67946a00fe5223a6da590...1b6885b5b20cc02a499a17d5ff804aa6d1510697,1,3053,1856,4909,1,2010-08-10 18:49:12,2010-08-10 18:49:12
1b6885b5b20cc02a499a17d5ff804aa6d1510697...ed8cb2783753e93c196fae28aca50a9cf1b4f93c,1,1,1,2,1,2010-08-10 19:00:08,2010-08-10 19:00:08
ed8cb2783753e93c196fae28aca50a9cf1b4f93c...d32a6f827a78bc33da9eedf1419743fe1a08dcad,1,1,1,2,1,2010-08-10 19:03:25,2010-08-10 19:03:25
d32a6f827a78bc33da9eedf1419743fe1a08dcad...c534b26997dbd8afc9cccd8753d64c85d3f69891,1,1,0,1,1,2010-08-10 19:04:30,2010-08-10 19:04:30
98a60023ac579faa626d00ffdcf2d0af3bede46d...bb0aee5059fc952b5a99cedb9f8eb1290af93d22,1,2,2,4,2,2010-08-11 12:38:25,2010-08-11 12:38:25
bb0aee5059fc952b5a99cedb9f8eb1290af93d22...f240474fdd11551ea32bc9aa161de680553d2052,1,1,1,2,1,2010-08-11 15:37:46,2010-08-11 15:37:46
f240474fdd11551ea32bc9aa161de680553d2052...89ae78967d3b94369b71977af48d33d89e9b7dd9,1,12,4,16,2,2010-08-11 18:40:25,2010-08-11 18:26:44
89ae78967d3b94369b71977af48d33d89e9b7dd9...e1c99a3fd7edce75fd8d22f38a13293220e43c71,1,67,63,130,4,2010-08-11 18:40:25,2010-08-11 18:31:45
e1c99a3fd7edce75fd8d22f38a13293220e43c71...cde18d621b62c8eb53a2bbcfa20648502396532d,1,1,1,2,1,2010-08-11 20:41:03,2010-08-11 20:41:03
cde18d621b62c8eb53a2bbcfa20648502396532d...44dda48aca02e84c6e2810b6a93fc951c3ff76d6,1,2,1,3,1,2010-08-11 20:44:31,2010-08-11 20:44:31
c534b26997dbd8afc9cccd8753d64c85d3f69891...b7cb28363a559e1f2e6a41ca007e62aa9bad3f4d,2,0,13,13,2,2010-08-10 19:23:23,2010-08-10 19:23:23
c534b26997dbd8afc9cccd8753d64c85d3f69891...36134dafaf221743bbf706017617b7136ef705f7,2,9,7,16,4,2010-08-10 19:15:59,2010-08-10 19:15:59
44dda48aca02e84c6e2810b6a93fc951c3ff76d6...6d613cd65f8f1f073089e5a7448c22e357893630,2,4,2,6,2,2010-08-11 20:48:54,2010-08-11 20:48:54
44dda48aca02e84c6e2810b6a93fc951c3ff76d6...0bb812151e6bb47bd67108a6d658c93f66c18add,1,22,8,30,13,2010-08-11 20:46:37,2010-08-11 20:46:37
2beeab996f05962c766329b8a352103a9883db98...17d553904fa95bf69537ebcfd7f3fbcfefab3178,3,13,6,19,9,2010-08-10 19:28:16,2010-08-10 19:28:16
f023b2c48742d7fde596f44fec933efa4e5f5949...a1a03bf71ba049082111e584b249eb30413f87fb,2,58,56,114,16,2010-08-11 21:08:48,2010-08-11 21:08:48
a1a03bf71ba049082111e584b249eb30413f87fb...69e92f803d6132ef1f00c320880f743d27dc1f2d,1,2,0,2,1,2010-08-11 21:12:35,2010-08-11 21:12:35
69e92f803d6132ef1f00c320880f743d27dc1f2d...39cfee21a367812962c1137e67bd7e50bb54b874,1,5,3,8,3,2010-08-11 23:38:13,2010-08-11 23:24:27
39cfee21a367812962c1137e67bd7e50bb54b874...3fcfa3ba16bffa681a21e863b270b5cf31797472,2,11,1,12,2,2010-08-11 23:38:13,2010-08-11 23:37:09
3fcfa3ba16bffa681a21e863b270b5cf31797472...5922debdd39d713c8542068055b1d8aae31aac4d,1,6,6,12,6,2010-08-12 00:18:30,2010-08-12 00:18:30
5922debdd39d713c8542068055b1d8aae31aac4d...26677a17a47f89a1b53322f7baffe2396c0219c7,1,1,1,2,1,2010-08-12 00:23:28,2010-08-12 00:22:58
26677a17a47f89a1b53322f7baffe2396c0219c7...5d91a354ade2a67cc69b85c5daa0d03d3498c7b8,1,1,1,2,1,2010-08-12 00:25:36,2010-08-12 00:25:36
5d91a354ade2a67cc69b85c5daa0d03d3498c7b8...480205ff388f0340e4b479e06f263221719fddac,1,7,3,10,2,2010-08-12 03:05:50,2010-08-12 03:05:50
480205ff388f0340e4b479e06f263221719fddac...5efe14b0293f7e39ffdf955096a689730478b909,1,3,1,4,2,2010-08-12 07:15:18,2010-08-12 07:15:18
5efe14b0293f7e39ffdf955096a689730478b909...de1d87c88572cd6eb6e0486fd57510aa7931c5ae,1,2,0,2,1,2010-08-12 13:50:29,2010-08-12 13:50:29
de1d87c88572cd6eb6e0486fd57510aa7931c5ae...812d855db21e353516fbd45fb46eb9c920577ae6,1,2,2,4,1,2010-08-12 14:06:07,2010-08-12 14:06:07
17d553904fa95bf69537ebcfd7f3fbcfefab3178...c7e11b85c0d0d9decba51360aa878f6434750740,1,76,73,149,2,2010-08-10 20:25:22,2010-08-10 20:25:22
17d553904fa95bf69537ebcfd7f3fbcfefab3178...04d9cfb67ca224cb7c9fcaced746a4ad559c9518,1,6,1,7,2,2010-08-10 19:36:29,2010-08-10 19:36:29
812d855db21e353516fbd45fb46eb9c920577ae6...b32759ab8575f12d31ea59401f3bfceca0bcaa7e,2,4,1,5,3,2010-08-12 15:28:27,2010-08-12 15:28:27
812d855db21e353516fbd45fb46eb9c920577ae6...d2f718eac5635552d64939875efc62f1157e37a5,1,7,7,14,5,2010-08-12 15:21:34,2010-08-12 15:21:34
7c7633de41e03df6ec47a300ba1b0fa9be80d7b3...46d312cde057e615a2b2258f7a0c6a303c2c38d7,1,1,1,2,1,2010-08-10 20:28:50,2010-08-10 20:28:50
46d312cde057e615a2b2258f7a0c6a303c2c38d7...7b726a7168cd005643eb4b0e502739bc7ee8c0d3,2,28,36,64,15,2010-08-10 21:44:38,2010-08-10 21:44:38
df72bc232e688e4a4f6d60e85f1a6d948bdbf063...3cc9a574eda6b49395bb1f34b565881925076110,1,14,0,14,2,2010-08-12 17:13:25,2010-08-12 17:13:25
3cc9a574eda6b49395bb1f34b565881925076110...b375f2aacc4af711e3990fb358cf43bac48fba9e,1,3,2,5,2,2010-08-12 17:22:39,2010-08-12 17:22:39
7b726a7168cd005643eb4b0e502739bc7ee8c0d3...0bcaf126d7761750a9301fbb254895e8f9b2d657,1,2,2,4,1,2010-08-11 02:51:07,2010-08-11 02:51:07
7b726a7168cd005643eb4b0e502739bc7ee8c0d3...057e211f0e9accda319edce9528e073b0d7004b0,2,14,2,16,5,2010-08-10 21:56:33,2010-08-10 21:56:33
b375f2aacc4af711e3990fb358cf43bac48fba9e...c0255fa04a92ddfd3994e6ea22f19f578b4556b7,1,1,1,2,1,2010-08-12 18:33:53,2010-08-12 18:33:53
b375f2aacc4af711e3990fb358cf43bac48fba9e...1a88b2038c5d279a29fc40cbd76373064b37791f,1,1,1,2,1,2010-08-12 18:22:01,2010-08-12 18:22:01
b9b82de160732d7d24cbe03c2a4672861d46bb80...0130af002cadca8d28a61d0b03897ae73b2f00e4,6,30,6,36,9,2010-08-12 20:06:16,2010-08-12 20:06:16
0130af002cadca8d28a61d0b03897ae73b2f00e4...953f7938c3310cb6b5b9c108375d5960c8f6c2c5,1,3,2,5,1,2010-08-12 20:09:18,2010-08-12 20:09:18
953f7938c3310cb6b5b9c108375d5960c8f6c2c5...1da6a0d35bf4645609bece3d24ad59aec19f1f96,1,2,1,3,1,2010-08-12 20:13:07,2010-08-12 20:13:07
1da6a0d35bf4645609bece3d24ad59aec19f1f96...df5b89004b24b60d698075588cdaedbe4ee27ee2,2,5,3,8,4,2010-08-12 22:56:09,2010-08-12 22:56:09
df5b89004b24b60d698075588cdaedbe4ee27ee2...25cd9964a7de1ae4978a10d22226f725e16cdd8b,1,2,0,2,1,2010-08-13 14:24:00,2010-08-13 14:24:00
25cd9964a7de1ae4978a10d22226f725e16cdd8b...38cf4f81f1fe36a2fb5ab839d6114989130abe0b,2,22,28,50,15,2010-08-13 18:47:47,2010-08-13 18:47:47
38cf4f81f1fe36a2fb5ab839d6114989130abe0b...a2d882e300a4ab661be6e1b9614d65dfddec245a,4,9,4,13,6,2010-08-13 19:30:00,2010-08-13 19:30:00
a2d882e300a4ab661be6e1b9614d65dfddec245a...1f7751a776fbb25afa9b4dc1b588202fef02780f,2,3,6,9,2,2010-08-13 19:33:33,2010-08-13 19:33:33
1f7751a776fbb25afa9b4dc1b588202fef02780f...1bf648b529e51dea9f686745e66038b674d11a1b,1,2,2,4,2,2010-08-13 19:34:58,2010-08-13 19:34:58
1bf648b529e51dea9f686745e66038b674d11a1b...02cbcfa464ee569f3948d020e46f40224b244a43,1,25,0,25,1,2010-08-13 22:16:03,2010-08-13 22:16:03
02cbcfa464ee569f3948d020e46f40224b244a43...6604772cf035261797f6cfc74dd088a7f2596674,5,19,15,34,8,2010-08-13 22:21:32,2010-08-13 22:21:32
6604772cf035261797f6cfc74dd088a7f2596674...76698bd5afb968f02ac4465f934dea3686ed23a2,1,9,5,14,3,2010-08-14 19:32:38,2010-08-14 19:32:38
6604772cf035261797f6cfc74dd088a7f2596674...f78f97061b8f7e7bf1e182d04905fb9c636f90e2,1,1,1,2,1,2010-08-14 02:30:57,2010-08-14 02:30:57
f78f97061b8f7e7bf1e182d04905fb9c636f90e2...dd07bb418e59f85590543af0595f37a4f8c5184e,3,5,43,48,8,2010-08-14 03:27:09,2010-08-14 03:27:09
dd07bb418e59f85590543af0595f37a4f8c5184e...7877247c04b71dccb3f9f0a4e6e97e09370b59eb,1,9,3,12,3,2010-08-14 04:09:26,2010-08-14 04:09:26
7877247c04b71dccb3f9f0a4e6e97e09370b59eb...7d278318b39f78e63726be42ac803e66c3d2b8c7,1,8,3,11,5,2010-08-15 00:03:01,2010-08-15 00:03:01
f0a2fcec788e4b49f7dc881de84c5e537831f58e...2f3f6780199012e3330530bddcd51f04af375d68,1,2,2,4,2,2010-08-15 00:08:57,2010-08-15 00:08:57
2f3f6780199012e3330530bddcd51f04af375d68...befdfdd44ec44e2ab61fef13374dc16d7fd14be1,1,2,0,2,2,2010-08-15 04:37:08,2010-08-15 04:37:08
befdfdd44ec44e2ab61fef13374dc16d7fd14be1...87b6b56813cdb327c896434d5c422abded5115c5,1,2,0,2,2,2010-08-15 05:08:53,2010-08-15 05:08:53
87b6b56813cdb327c896434d5c422abded5115c5...7e9509fd1fadef26627285f6f2657a5c3655d12d,1,1,1,2,1,2010-08-15 21:01:58,2010-08-15 21:01:58
7e9509fd1fadef26627285f6f2657a5c3655d12d...e9043f2f7adf37bdc8ac846b06583d668099b39e,1,1,1,2,1,2010-08-16 05:01:35,2010-08-16 05:01:35
7e9509fd1fadef26627285f6f2657a5c3655d12d...d40cac6f1b197181c1312b6b27540e020f4de6e1,4,9,2,11,7,2010-08-16 02:21:26,2010-08-16 02:21:26
d40cac6f1b197181c1312b6b27540e020f4de6e1...95313f7d4af8d6b1cdd7c8bb89ee96dce5113056,1,3,2,5,2,2010-08-16 03:10:36,2010-08-16 03:10:36
db3f203d3f57343b8d51011eb3d569ddc7c0c6ad...16ce34f24180a7b820ddc548a30896c4c2f5760c,1,7,1,8,1,2010-08-16 15:09:03,2010-08-16 15:09:03
16ce34f24180a7b820ddc548a30896c4c2f5760c...ab4c0fe09ef4326cd5b56a0a77de2f2a8ba7b2bd,2,18,0,18,4,2010-08-16 15:33:41,2010-08-16 15:33:41
db3f203d3f57343b8d51011eb3d569ddc7c0c6ad...0912b46aa7effef22f577945918691fbd8bf2d74,1,16,8,24,2,2010-08-16 12:57:28,2010-08-16 12:57:28
0912b46aa7effef22f577945918691fbd8bf2d74...b7e8c057871f66b1e05c458e48b593521423c179,4,5,27,32,8,2010-08-16 13:00:58,2010-08-16 13:00:58
b7e8c057871f66b1e05c458e48b593521423c179...23df1acdd1a39784ae18efc97c42f6337ac20b5f,2,30,6,36,7,2010-08-16 13:17:14,2010-08-16 13:17:14
23df1acdd1a39784ae18efc97c42f6337ac20b5f...edd36ed056a9b955f522f64d54f0e46a3afbce61,2,47,5,52,6,2010-08-16 13:39:28,2010-08-16 13:39:28
edd36ed056a9b955f522f64d54f0e46a3afbce61...065e21ac3b4817d459c47a615f35f52fdd235845,3,10,4,14,5,2010-08-16 14:01:26,2010-08-16 14:01:26
065e21ac3b4817d459c47a615f35f52fdd235845...206dee7ad9f355d87b7338425e8c9d9625a022c5,2,9,4,13,4,2010-08-16 14:22:41,2010-08-16 14:22:41
206dee7ad9f355d87b7338425e8c9d9625a022c5...cdd00d5e73ad9716f83f188054090f6c6f1ccdc6,2,14,1,15,3,2010-08-16 14:26:07,2010-08-16 14:26:07
ac851a4a42b08333624d5a8017faf8710edb5cdb...14bc66a7e989404f15254d3fd9451608b0123bfd,1,8,1,9,1,2010-08-16 15:57:54,2010-08-16 15:57:54
14bc66a7e989404f15254d3fd9451608b0123bfd...c8aa3a6c9d05dab2f34c7fcb0f9bddcd65a4dfe9,3,75,72,147,15,2010-08-16 15:58:02,2010-08-16 15:58:02
c8aa3a6c9d05dab2f34c7fcb0f9bddcd65a4dfe9...0dfb2d2f33453a948aa6fbd915309fc34a22e40c,2,75,29,104,9,2010-08-16 16:21:49,2010-08-16 16:21:49
0dfb2d2f33453a948aa6fbd915309fc34a22e40c...0a000453f303e204417d3b53ae4bece4a0a9e51e,1,19,0,19,1,2010-08-16 16:44:36,2010-08-16 16:44:36
0a000453f303e204417d3b53ae4bece4a0a9e51e...4d7319d82fe11cf9b79b06e931ac68bf550576f5,2,16,0,16,3,2010-08-16 18:06:12,2010-08-16 18:06:12
0a000453f303e204417d3b53ae4bece4a0a9e51e...0956eeb3a969277f0429be0f82006e84c7494f82,1,1,2,3,2,2010-08-16 16:51:31,2010-08-16 16:51:31
51740d5eb4c01717a462f4ae0a8785a656a9dd75...5cfa013077c4a4d4f59dbbff6ec00f8bf6024713,3,16,7,23,4,2010-08-16 20:59:08,2010-08-16 20:59:08
51740d5eb4c01717a462f4ae0a8785a656a9dd75...25b69559eb677fce24cc742036094650d94e6d65,1,1,1,2,1,2010-08-16 19:47:40,2010-08-16 19:47:40
0956eeb3a969277f0429be0f82006e84c7494f82...99ac3f8fcbb968c1fbfb10215dec98ad92f351a5,4,14,12,26,10,2010-08-16 17:45:52,2010-08-16 17:45:52
0956eeb3a969277f0429be0f82006e84c7494f82...d27b1646a179f4b2afd950a079c12967e90fd226,5,30,17,47,10,2010-08-16 17:17:11,2010-08-16 17:16:19
20b2089bfc4b3a87245805d34c77da55e9b469fe...fef8cb5de84145b5eee7281d41e351832af02633,1,25,5,30,18,2010-08-17 00:39:01,2010-08-17 00:39:01
fef8cb5de84145b5eee7281d41e351832af02633...fe7a8dfaf48e167a5cfeed4aa1b27ae803623688,15,174,70,244,72,2010-08-18 18:42:58,2010-08-18 18:42:58
20b2089bfc4b3a87245805d34c77da55e9b469fe...b07f1dacedd7498216e16a9339764e66c0b1770d,4,145,2,147,5,2010-08-17 00:03:54,2010-08-17 00:03:54
b07f1dacedd7498216e16a9339764e66c0b1770d...153ae78ee1b920534b148f04bb0a3d97d01a5221,1,5,2,7,3,2010-08-17 00:26:30,2010-08-17 00:26:30
153ae78ee1b920534b148f04bb0a3d97d01a5221...9d52009086bcb9eb7c2ac22583a4b9675b9a3875,2,2,2,4,2,2010-08-17 00:27:34,2010-08-17 00:27:34
9d52009086bcb9eb7c2ac22583a4b9675b9a3875...4b8ca5f9bd2ed54cc76aa27293a2a825fad0a8ad,1,17,7,24,6,2010-08-17 00:55:20,2010-08-17 00:55:20
4b8ca5f9bd2ed54cc76aa27293a2a825fad0a8ad...1c51f40d02ba67d27c3ca8b7395a13ff348870ab,1,3,2,5,2,2010-08-17 02:08:55,2010-08-17 02:08:55
17fde699d25aaf1a4027de40db8e7d444d801518...0e61f0b5a40d14eb363fb7823210eee769569cbc,1,2,6,8,1,2010-08-16 19:51:37,2010-08-16 19:51:37
973f4247ec11602e5a7e88d6636736838f983276...01258c4e63a02d79d9cc07b256e75eb4525b2e81,1,1,1,2,1,2010-08-16 17:55:37,2010-08-16 17:55:37
973f4247ec11602e5a7e88d6636736838f983276...2c85bee437d564d3fc83a64948b6ac02cc5fdb68,1,0,4,4,4,2010-08-16 17:53:29,2010-08-16 17:53:29
1c51f40d02ba67d27c3ca8b7395a13ff348870ab...b8d7093c4767aeb3b987bd1c06c969eb7d38297e,1,8,3,11,1,2010-08-17 14:19:40,2010-08-17 14:19:40
1c51f40d02ba67d27c3ca8b7395a13ff348870ab...3f63ac712ba912ee7f81835a3749101a5ea5d357,1,1,1,2,1,2010-08-17 03:31:22,2010-08-17 03:31:22
3f63ac712ba912ee7f81835a3749101a5ea5d357...8c5d4000e7ffa3341e0e59b597980bc9eccc777e,1,14,14,28,3,2010-08-17 04:29:17,2010-08-17 04:29:17
8c5d4000e7ffa3341e0e59b597980bc9eccc777e...6cf2720b37dbfe53b9c355dba765851f1ef02b4e,1,18,1,19,3,2010-08-17 04:35:45,2010-08-17 04:35:45
6cf2720b37dbfe53b9c355dba765851f1ef02b4e...c4453ff3b9cd802f6f3fa8c489aff609fc502bd6,1,2,1,3,1,2010-08-17 13:28:29,2010-08-17 13:28:29
454c04e43e37b4d02cde479f0b7393e34a475c09...b1e95d9bee1b14993d56564648c5d54ed1507d58,1,5,0,5,1,2010-08-16 20:30:16,2010-08-16 20:30:16
d450ea2643972dc31e0ea10609e08ecc3b25c920...951a0ea4d86a7758b3035bc28ce86b741843968d,1,15,4,19,3,2010-08-16 19:29:40,2010-08-16 19:29:40
951a0ea4d86a7758b3035bc28ce86b741843968d...df4b31b8bbe3847038be650cac025e65e5d8c03d,1,13,5,18,6,2010-08-16 19:32:14,2010-08-16 19:32:14
d1658d7d972c799112b2c120b66e7a1e83fbab2e...460bd516ea15c803a3bbde5fb55c51c49336fee4,4,13,3,16,5,2010-08-18 20:46:13,2010-08-18 20:46:13
d1658d7d972c799112b2c120b66e7a1e83fbab2e...4c31fe49e71fdcce993a964f0246aa78927b0a85,1,12,10,22,2,2010-08-18 20:03:27,2010-08-18 20:03:27
fb986efbe62fefdcb725dea4a347133e2a53eb7e...53ba584a157d87970390a927806d1e7e496a3224,1,7,6,13,5,2010-08-17 15:30:01,2010-08-17 15:30:01
53ba584a157d87970390a927806d1e7e496a3224...573e9682e3982d0ae54c3b635bb0b00077cc3cd2,1,7,0,7,2,2010-08-17 15:48:45,2010-08-17 15:48:45
573e9682e3982d0ae54c3b635bb0b00077cc3cd2...635eb5c9d2b900fe201f2f728ea6cdef285829a1,4,13,1,14,9,2010-08-17 16:25:39,2010-08-17 16:25:39
c4453ff3b9cd802f6f3fa8c489aff609fc502bd6...1d5a67454a0c858cfaf076390f7b0271a6300062,1,2,0,2,2,2010-08-17 16:27:53,2010-08-17 16:27:53
94d01292273a38b1346e44b3260eda6750adf6a7...13c38d8b0041af0207bfa1f6f20aa8a66c6c87c6,1,1,1,2,1,2010-08-19 15:51:04,2010-08-19 15:51:04
4c31fe49e71fdcce993a964f0246aa78927b0a85...c69b560a82fada4bb4f7f3f7276cd71a17a4dc41,1,4,2,6,2,2010-08-20 18:05:11,2010-08-20 18:05:11
635eb5c9d2b900fe201f2f728ea6cdef285829a1...6645c3f520e96b69c078455f2b087187b70d0f41,2,22,8,30,5,2010-08-17 16:45:22,2010-08-17 16:42:50
a5a764463cd59812c08ca4a76c42b1e21fc767aa...b0ce5f26f729d0d10f19bba614f2e4976229bafa,3,24,19,43,5,2010-08-19 16:25:10,2010-08-19 16:25:10
b0ce5f26f729d0d10f19bba614f2e4976229bafa...1b52a001b9a696bfe9590bd4ca6e59f0af847ecf,1,2,2,4,1,2010-08-19 16:26:33,2010-08-19 16:26:33
3a455a39abbb08d906e1996d206c93b5e26741d7...7a7cc4adfaa9e8647c8e51f9ff69c7cfd24038e8,17,43,51,94,40,2010-08-18 22:12:31,2010-08-18 22:12:31
7a7cc4adfaa9e8647c8e51f9ff69c7cfd24038e8...8360e22198ebd0edee7deeb686ff3366b1588acf,2,42,26,68,20,2010-08-19 00:21:37,2010-08-18 23:44:27
8360e22198ebd0edee7deeb686ff3366b1588acf...bb5c545e79c3db7f8749d8f8ba3fda606a3bde8d,2,53,2,55,3,2010-08-19 00:21:37,2010-08-19 00:19:47
bb5c545e79c3db7f8749d8f8ba3fda606a3bde8d...6d67ec37d06a3b6c39c032cc93c6965409bd2a81,1,1,1,2,1,2010-08-19 14:15:04,2010-08-19 14:15:04
6d67ec37d06a3b6c39c032cc93c6965409bd2a81...806092f847ef1c7f1f2a02e523c4f4d35897fb6d,3,96,1,97,3,2010-08-19 15:26:07,2010-08-19 15:26:07
dcaa9cbdcede26975c0db14bcb49fbed6e2c5560...8212b877f69ad3781e4c18e388ec5eb66304102c,2,9,2,11,3,2010-08-20 18:14:12,2010-08-20 18:14:12
dcaa9cbdcede26975c0db14bcb49fbed6e2c5560...c3a6d174f48429f53450c210a25b386cb8dd8201,1,1,1,2,1,2010-08-20 18:12:14,2010-08-20 18:12:14
ab8b7c90be501139717d909d304fccebd8bc0b00...8b56c14d3856b97ada7ec9553487ab43f25197c4,2,31,29,60,25,2010-08-17 20:31:21,2010-08-17 20:31:21
8b56c14d3856b97ada7ec9553487ab43f25197c4...a5b9a6c0f89e78a2c806e827627551196ea7869b,2,8,4,12,3,2010-08-17 20:41:17,2010-08-17 20:41:17
a5b9a6c0f89e78a2c806e827627551196ea7869b...8e0f827c55694b63213ad3ea48529337c6cca489,4,4,41,45,7,2010-08-17 21:01:33,2010-08-17 21:01:33
8e0f827c55694b63213ad3ea48529337c6cca489...75f728bb628bb3ed5e5f95512bf7fec95f6eb7ad,2,13,8,21,8,2010-08-17 21:23:00,2010-08-17 21:23:00
75f728bb628bb3ed5e5f95512bf7fec95f6eb7ad...22be11b4c2000f8876fe7681c8e58415b7755ef9,4,28,16,44,8,2010-08-17 22:23:40,2010-08-17 22:23:40
22be11b4c2000f8876fe7681c8e58415b7755ef9...cb001794d44e4adb95b7ce03ecc09d61ed9b212e,2,4,4,8,2,2010-08-17 22:27:30,2010-08-16 18:18:32
cb001794d44e4adb95b7ce03ecc09d61ed9b212e...37298e61426141cfc2d26d708d1a637bac9b0e1f,1,1,5,6,1,2010-08-17 22:27:30,2010-08-17 22:00:43
37298e61426141cfc2d26d708d1a637bac9b0e1f...b082b63f752c5b158d0167505d1bb570021cb91f,5,20,37,57,6,2010-08-17 22:27:30,2010-08-17 22:09:53
b082b63f752c5b158d0167505d1bb570021cb91f...d0cfce8c583e5a9bec745bade8f06037be2da905,3,181,170,351,10,2010-08-18 02:24:35,2010-08-18 02:24:35
1b52a001b9a696bfe9590bd4ca6e59f0af847ecf...a595aaec8970adfd4ea703616fdaf91772c570c2,1,2,1,3,1,2010-08-19 18:54:01,2010-08-19 18:54:01
1b52a001b9a696bfe9590bd4ca6e59f0af847ecf...c703c0bac32c5655f1881dca73aecc695056995c,1,24,8,32,3,2010-08-19 16:54:28,2010-08-19 16:54:28
c3a6d174f48429f53450c210a25b386cb8dd8201...53e07c3bf7997f869470703a16f9feb41c748e64,1,3,1,4,1,2010-08-20 20:36:19,2010-08-20 20:36:19
d0cfce8c583e5a9bec745bade8f06037be2da905...7841b07d5e274c8e4a9603ab71c2f47ffcef3b9c,1,188,188,376,3,2010-08-18 03:29:54,2010-08-18 03:29:54
7841b07d5e274c8e4a9603ab71c2f47ffcef3b9c...bc9997faef19bdcb145365ce34bdf7aeaa4b37d8,5,18,4,22,11,2010-08-18 03:35:53,2010-08-18 03:35:53
d0cfce8c583e5a9bec745bade8f06037be2da905...850ee8a42f6774261177048acc31699d11caf50c,1,1,1,2,1,2010-08-18 02:41:46,2010-08-18 02:41:46
850ee8a42f6774261177048acc31699d11caf50c...a4374a22eb7d13a216b87da85592f5611e38b021,1,10,10,20,4,2010-08-18 03:27:13,2010-08-18 03:27:13
df2b3292a1d49419c6e029860a9e26ea5eeff83d...eb191debd2c5117025814a7e937dce5bf1ddb60a,2,122,39,161,15,2010-08-19 20:47:53,2010-08-19 20:47:32
eb191debd2c5117025814a7e937dce5bf1ddb60a...05ef205a92e4df1be73e73cfad8233b781857ae3,1,1,1,2,1,2010-08-19 21:04:49,2010-08-19 21:04:49
05ef205a92e4df1be73e73cfad8233b781857ae3...0e49d544eb2bacb3242f347b3caf51a1c88e06c5,2,108,108,216,80,2010-08-19 21:59:16,2010-08-19 21:59:16
6e89794320118f1866b9a526e215605784ab3331...37ae0dbd3ff2e8cff2d913ef11243c5e63413e31,5,100,86,186,10,2010-08-20 22:40:44,2010-08-20 22:40:44
37ae0dbd3ff2e8cff2d913ef11243c5e63413e31...0f4039b4d2c8041e560f87cff0d5ad04bfba15ee,1,4,3,7,4,2010-08-20 22:40:53,2010-08-08 03:25:08
0f4039b4d2c8041e560f87cff0d5ad04bfba15ee...48ac2df48f886ad57e86cc5e3d8d1ffe037e6348,1,1,2,3,1,2010-08-20 23:52:39,2010-08-20 23:52:39
48ac2df48f886ad57e86cc5e3d8d1ffe037e6348...d504248032ce214f015880b697bcce29971a3d26,1,1,3,4,2,2010-08-21 15:53:30,2010-08-21 15:12:03
d504248032ce214f015880b697bcce29971a3d26...1783eb7219f440cfc8fb0028ab1ade6384ea2477,1,4,1,5,1,2010-08-21 16:00:21,2010-08-21 16:00:21
1783eb7219f440cfc8fb0028ab1ade6384ea2477...087a79e4bec58311292d5a61d60e29f8d9df6603,1,1,1,2,1,2010-08-21 20:02:51,2010-08-21 20:02:51
087a79e4bec58311292d5a61d60e29f8d9df6603...a2f53c7ec9833c0a410fcb61807ed1204689744c,1,5,5,10,4,2010-08-22 01:23:33,2010-08-22 01:23:33
a2f53c7ec9833c0a410fcb61807ed1204689744c...6b9d67d4afc3ced5e9a55b57c9c4c66698d48d0f,1,44,0,44,1,2010-08-22 01:32:14,2010-08-22 01:32:14
6b9d67d4afc3ced5e9a55b57c9c4c66698d48d0f...fa8b9a8c734c673c62c447bfb1db8a497f2fa5d8,3,24,5,29,5,2010-08-22 04:52:06,2010-08-22 04:52:06
fa8b9a8c734c673c62c447bfb1db8a497f2fa5d8...dd86eeec6517e4b5403300ef8e32ad26689814fd,1,1,1,2,1,2010-08-22 12:05:20,2010-08-22 12:05:20
5b555406751bdc265f08ad6e0c6fa0a12c873ff8...13957e61fe90f8a2f5ac3320ebd73eee35afb22b,2,9,1,10,2,2010-08-22 14:30:26,2010-08-22 14:30:26
13957e61fe90f8a2f5ac3320ebd73eee35afb22b...06bbde97dc37f7f7055e6e3309e7f169b2342f70,1,2,0,2,1,2010-08-22 14:32:00,2010-08-22 14:32:00
06bbde97dc37f7f7055e6e3309e7f169b2342f70...db34126eb9ced005851f4de0142676802d7a3b32,1,2,0,2,1,2010-08-22 14:35:12,2010-08-22 14:35:12
db34126eb9ced005851f4de0142676802d7a3b32...933735036bc62d4a17af6cdf9f89c1698626cefb,1,89,0,89,1,2010-08-22 16:42:34,2010-08-22 16:42:34
5b555406751bdc265f08ad6e0c6fa0a12c873ff8...a054706d1ec4e351d8f3c7e993e2e0f3a3f683b3,1,21,0,21,1,2010-08-18 13:47:51,2010-08-18 13:47:51
a054706d1ec4e351d8f3c7e993e2e0f3a3f683b3...70f3d4fc31ab7bf2e834f66522fe3e1ce9728270,3,28,11,39,10,2010-08-18 13:48:02,2010-08-18 13:48:02
70f3d4fc31ab7bf2e834f66522fe3e1ce9728270...5663169f5fd6f0f1dbff0911455540ba7ca25400,1,0,10,10,1,2010-08-18 14:03:08,2010-08-18 14:03:08
6fcacfcd2d570bfcc3560d177c8afb14054448c5...a0973cd10eee73c58f26d92b76441d5a59de57fe,2,43,36,79,3,2010-08-22 17:54:03,2010-08-22 17:54:03
5663169f5fd6f0f1dbff0911455540ba7ca25400...ff4dd59c5d101e34fb6447835b70d5d334fcb372,1,3,9,12,1,2010-08-18 14:52:49,2010-08-18 14:52:20
ff4dd59c5d101e34fb6447835b70d5d334fcb372...5ff14eeb1eec6c4d00ff0ea661b3f644c20cb7db,5,15,7,22,10,2010-08-18 15:37:34,2010-08-18 15:37:17
5ff14eeb1eec6c4d00ff0ea661b3f644c20cb7db...f70ac573c8421e969a18f7560e56d39b74e78f7e,3,9,7,16,8,2010-08-18 15:50:52,2010-08-18 15:50:52
5663169f5fd6f0f1dbff0911455540ba7ca25400...39d0346def0c77ad56dd651baa6293475ae21be2,1,21,5,26,4,2010-08-18 14:23:56,2010-08-18 14:23:56
39d0346def0c77ad56dd651baa6293475ae21be2...c862acf33d1a12e8fb676dbc88ef4c8b9e773962,1,3,1,4,1,2010-08-18 14:24:10,2010-08-18 14:24:10
a0973cd10eee73c58f26d92b76441d5a59de57fe...763ab8f09f25bbdfb43ec6f3f20ecae79c8cf456,1,7,2,9,3,2010-08-22 20:11:38,2010-08-22 20:11:38
a0973cd10eee73c58f26d92b76441d5a59de57fe...595247506716a06e49eb56784691f75aae32f963,1,36,36,72,1,2010-08-22 19:21:07,2010-08-22 19:21:07
595247506716a06e49eb56784691f75aae32f963...4c6cc21fa92989e90ab3802433313bda8f3d8d1b,2,4,2,6,3,2010-08-22 19:23:45,2010-08-22 19:23:45
f70ac573c8421e969a18f7560e56d39b74e78f7e...dac2ff3ce71ecbacedd2c4c3b623c32a7baee502,2,38,4,42,8,2010-08-18 18:12:14,2010-08-18 18:11:42
dac2ff3ce71ecbacedd2c4c3b623c32a7baee502...dde78c8e6621d062b2218c269cfef9a0e2d97233,2,3,3,6,3,2010-08-18 18:29:04,2010-08-18 18:29:04
bc85ef3d8d772c76b69ac3f3745c491b1e30aa37...697bd7ff42370fa669caabb11db40ee6b15365ac,1,1,1,2,1,2010-08-18 16:07:21,2010-08-18 16:07:21
697bd7ff42370fa669caabb11db40ee6b15365ac...7719fd049d7ffce6d560f4bbb8f3963d44a06358,1,7,0,7,1,2010-08-18 18:20:21,2010-08-18 18:20:21
0d2fd645e9ab92a2eb978a86b1a28a5d50fcb6a8...414a062529ba37417f0be315a61b51a558682eb8,1,39,0,39,1,2010-08-22 21:09:46,2010-08-22 21:09:46
414a062529ba37417f0be315a61b51a558682eb8...183edd5552abcff417ab142180adedf75a6eb25f,1,5,1,6,3,2010-08-22 21:17:30,2010-08-22 21:17:02
183edd5552abcff417ab142180adedf75a6eb25f...94a94ff14b10fa953d3fa2c0f51d5746df15b93c,1,9,15,24,4,2010-08-22 21:23:50,2010-08-22 21:23:50
4c6cc21fa92989e90ab3802433313bda8f3d8d1b...e3ff8becf39191006e69d3ae5b05d5f939c6208e,1,8,1,9,3,2010-08-22 20:32:14,2010-08-22 20:32:14
b4230f1e00e53909686a36a944029fc97e79c9f2...b9e7b49f71b0bc965eacbf177fd69e07a180ffb9,1,123,110,233,2,2010-08-18 19:15:26,2010-08-18 19:15:26
b4230f1e00e53909686a36a944029fc97e79c9f2...62c81c93caf111ebbdd8d6dc4930216be71b0b19,1,2,2,4,2,2010-08-18 18:39:50,2010-08-18 18:39:50
62c81c93caf111ebbdd8d6dc4930216be71b0b19...44d70c63272476eaac5927249624058f4248b220,1,3,2,5,2,2010-08-18 18:42:21,2010-08-18 18:42:21
dbfac915f2a8bf04563e41a4897f4f8a3f029fba...7911cdcab89daad6ab4005a95f0e8df61a55a190,1,1,1,2,1,2010-08-22 22:04:42,2010-08-22 22:04:42
dbfac915f2a8bf04563e41a4897f4f8a3f029fba...a856ac5445c65c506edc9a52d8490395b4a1332d,1,2,1,3,1,2010-08-22 21:38:32,2010-08-22 21:38:32
44d70c63272476eaac5927249624058f4248b220...b1c3371ad73540066ba7d4d445f1fde88444fe9d,1,3,1,4,2,2010-08-18 21:26:57,2010-08-18 21:26:57
e92be658b18ea22e134a1b26cbc831738e6498bb...88a241009134c2e957bcdb82fc69c14019306e46,1,32,0,32,1,2010-08-23 05:25:17,2010-08-23 05:25:17
88a241009134c2e957bcdb82fc69c14019306e46...d368769ad19b7d7872c29d1f3c496cb6ea41905e,1,11,1,12,1,2010-08-23 12:37:26,2010-08-23 12:37:26
d368769ad19b7d7872c29d1f3c496cb6ea41905e...c073cafa962fe98e25cc1fd1dc53931cdc17d117,8,101,33,134,37,2010-08-23 15:12:35,2010-08-23 15:12:35
c073cafa962fe98e25cc1fd1dc53931cdc17d117...61e7998a22245a12ca579406427d345d6a7b8865,3,5,7,12,3,2010-08-23 15:24:34,2010-08-23 15:24:34
61e7998a22245a12ca579406427d345d6a7b8865...a2307fa518f02b02bcb1ac4da3e9feb8ad1e9003,1,0,7,7,1,2010-08-23 15:25:12,2010-08-23 15:25:12
a2307fa518f02b02bcb1ac4da3e9feb8ad1e9003...4be061b5e3fafcc9d11b4212c871fe3768ae660d,1,3,3,6,2,2010-08-23 15:27:47,2010-08-23 15:27:47
4be061b5e3fafcc9d11b4212c871fe3768ae660d...05d7807ceabd7cc750702a11c9018cf85a77726e,1,1,1,2,1,2010-08-23 15:31:06,2010-08-23 15:31:06
05d7807ceabd7cc750702a11c9018cf85a77726e...22aa421d980e85a2e4eb87fb7a6a04ac6d128817,2,0,4,4,2,2010-08-23 15:37:11,2010-08-23 15:37:11
22aa421d980e85a2e4eb87fb7a6a04ac6d128817...857bd9b4dc29312c2851893aa14531f49eba770a,3,8,8,16,7,2010-08-23 15:45:32,2010-08-23 15:45:32
22aa421d980e85a2e4eb87fb7a6a04ac6d128817...9b8a7788ab7fe1d2ece7aaf6958b8d7de9110628,1,0,9,9,2,2010-08-23 15:38:39,2010-08-18 19:20:09
9b8a7788ab7fe1d2ece7aaf6958b8d7de9110628...52163efb4dedd001900aacefd087ff19d5344a61,1,2,2,4,2,2010-08-23 15:38:39,2010-08-15 16:44:08
ee902a53efc666c77d60f418e0fc599c151a3e6e...6f12a64f54120bc3ac54850e92dd581a3d4bdacf,3,16,40,56,23,2010-08-23 15:53:49,2010-08-23 15:53:49
6f12a64f54120bc3ac54850e92dd581a3d4bdacf...afa28ddd8ab8de64af680da0e129f1f734a253aa,2,8,1,9,3,2010-08-23 16:44:40,2010-08-23 16:44:40
afa28ddd8ab8de64af680da0e129f1f734a253aa...1c85bd156e9ce1fd8b25f421e1451d37cd66fde0,2,12,5,17,7,2010-08-23 16:45:31,2010-08-23 16:45:31
1c85bd156e9ce1fd8b25f421e1451d37cd66fde0...cfd0ac0fa47afe8b5ec19e3bfaac52f9ecc5abb6,3,0,0,0,0,2010-08-23 16:49:48,2010-08-23 16:49:48
1c85bd156e9ce1fd8b25f421e1451d37cd66fde0...4910de3b195f9be1251036379493605a02917157,1,7,2,9,3,2010-08-23 16:48:21,2010-08-23 16:48:21
4910de3b195f9be1251036379493605a02917157...68bfb883e96d3d9decc22994ac302a952346edc9,1,79,0,79,1,2010-08-23 16:48:33,2010-08-23 16:48:33
cfd0ac0fa47afe8b5ec19e3bfaac52f9ecc5abb6...727bf4a9361c53f08b59b9af62d8f92573177135,3,4,4,8,3,2010-08-23 16:54:02,2010-08-23 16:54:02
b431221c305055b02e28d5752fa1251d19ad63db...10c01ce576cd820188096f456afe4650d97547ce,1,1,0,1,1,2010-08-23 17:20:29,2010-08-23 17:20:29
e3fb2bd739a37768a9be9e4a5252e438ee3ea680...2f1b077bb5343eb418193aba58fef57fa3233c5c,5,17,0,17,5,2010-08-23 17:55:34,2010-08-23 17:55:34
d61f5b516943c33784c1b8f8ade14b38a99c502c...32a30aa221e3ddf8500b0c5c033b51a5c8edd787,1,3,3,6,3,2010-08-23 17:36:49,2010-08-23 17:36:49
50cb743634de0f84fc17d332cf7f23fa6a63df4b...2f05a4caea0a10052f8db95b736e77628414715d,1,12,7,19,3,2010-08-23 19:03:34,2010-08-23 19:03:34
32a30aa221e3ddf8500b0c5c033b51a5c8edd787...94c729f866747e31902bd3016bfaf542fe6127c8,1,2,9,11,1,2010-08-23 19:04:00,2010-08-23 19:04:00
2f05a4caea0a10052f8db95b736e77628414715d...240aaf588b707e63fd75929a1c5a58c7cf6adda1,1,3,0,3,1,2010-08-23 19:45:57,2010-08-23 19:45:57
240aaf588b707e63fd75929a1c5a58c7cf6adda1...8fb5af818d059ba20a4b6db133f4f4639532430d,4,209,12,221,10,2010-08-23 19:48:13,2010-08-23 19:48:13
1c5a91576dca79170ca3e843b2be50fdcfc33a8e...235865fc24b459ee8eaea2cd3f3be1257ff9249a,2,6,1,7,3,2010-08-23 19:58:30,2010-08-23 19:58:30
235865fc24b459ee8eaea2cd3f3be1257ff9249a...7029641c97ff8de49b7b7fab9d11de54b4e4da59,1,12,2,14,5,2010-08-23 20:09:04,2010-08-23 20:09:04
7029641c97ff8de49b7b7fab9d11de54b4e4da59...9611d7028316c0d0129f8b52fa7493b76fb370f6,1,4,0,4,2,2010-08-23 20:17:42,2010-08-23 20:17:42
9611d7028316c0d0129f8b52fa7493b76fb370f6...4bcf64d3d132acaf61580743a5d121bf4d90a002,1,9,2,11,4,2010-08-23 23:42:14,2010-08-23 23:42:14
4bcf64d3d132acaf61580743a5d121bf4d90a002...2af7fa477c6a0764e0af9def5ed7a2fdd0cdfe47,1,2,5,7,3,2010-08-24 00:00:14,2010-08-24 00:00:14
2af7fa477c6a0764e0af9def5ed7a2fdd0cdfe47...cd9d7218227cebb8220c09aa6a78ac4cb0d2fd94,1,5,2,7,2,2010-08-24 01:06:41,2010-08-24 01:06:41
cd9d7218227cebb8220c09aa6a78ac4cb0d2fd94...9e951e98b44c7da200d60cc200735e6213d8ebe8,3,36,15,51,9,2010-08-24 02:53:14,2010-08-24 02:53:14
9e951e98b44c7da200d60cc200735e6213d8ebe8...9a9eb885349ea4644a30adebcb82f995764a9e88,3,63,5,68,12,2010-08-24 05:25:45,2010-08-24 05:25:45
9a9eb885349ea4644a30adebcb82f995764a9e88...24908ed66fe38cfaa846b863b2e50f55f11ebd5a,2,5,5,10,2,2010-08-24 05:39:38,2010-08-24 05:39:38
24908ed66fe38cfaa846b863b2e50f55f11ebd5a...06917cf3bc9ae981268a8bb63f7327eb8af2ff60,1,7,2,9,2,2010-08-24 05:53:54,2010-08-24 05:53:54
06917cf3bc9ae981268a8bb63f7327eb8af2ff60...c6bae28ff63d65d5ff903cefe99652e8be425d3e,1,3,4,7,2,2010-08-24 05:58:21,2010-08-24 05:58:21
c6bae28ff63d65d5ff903cefe99652e8be425d3e...b0f696520a2ca9c1dd5189271b6dc7c0ec658c1a,1,81,80,161,9,2010-08-24 13:37:01,2010-08-24 13:37:01
b0f696520a2ca9c1dd5189271b6dc7c0ec658c1a...02da00ab0fa1a5c925a4fa7b2a7c3901d050b079,1,8,5,13,3,2010-08-24 15:53:37,2010-08-24 15:53:37
02da00ab0fa1a5c925a4fa7b2a7c3901d050b079...fc0545df142e22cf89843e21c348c44927f5e60a,1,15,6,21,7,2010-08-24 16:36:06,2010-08-24 16:36:06
fc0545df142e22cf89843e21c348c44927f5e60a...61b0d6917d95e4d1afa9da5f26ce6b7b6646ab64,1,3,3,6,3,2010-08-24 17:09:13,2010-08-24 17:09:13
fc0545df142e22cf89843e21c348c44927f5e60a...02a087cad256b92724fb14756cdd490cadc9ec65,1,1,1,2,1,2010-08-24 16:41:22,2010-08-24 16:41:22
8c5500cfc87a4e934be7023cfa2f5a75c58c2d74...b2d2951968a58572b074448b3a282df738edf4ed,1,4,0,4,2,2010-08-24 20:39:39,2010-08-24 20:39:39
02a087cad256b92724fb14756cdd490cadc9ec65...0801252fb726ff5f9aa0d664d1e3620c93913553,1,1,1,2,1,2010-08-24 17:18:47,2010-08-24 17:18:47
4e0a8bb705283475247ac084b489a2e9ba255c11...fb20d56b31713c13aeebae17e03f910de864cee4,4,18,20,38,12,2010-08-24 21:57:00,2010-08-24 20:12:32
fb20d56b31713c13aeebae17e03f910de864cee4...933288b522250a68c722b0d9257f918b7d0d9719,1,5,0,5,1,2010-08-24 21:57:00,2010-08-24 21:56:39
933288b522250a68c722b0d9257f918b7d0d9719...4e7a761d16b9c802fa42a7f768ca5f19cb07a69c,2,12,1,13,3,2010-08-25 02:16:00,2010-08-25 02:16:00
4e7a761d16b9c802fa42a7f768ca5f19cb07a69c...9fdbbb570c0b1d4f6cbb30695d3c4e444ef05312,1,1,1,2,1,2010-08-25 02:23:19,2010-08-25 02:23:19
9fdbbb570c0b1d4f6cbb30695d3c4e444ef05312...29f89df7754143b94e48737ae9c00b7e306b0f67,1,24,0,24,1,2010-08-25 05:57:48,2010-08-25 03:59:33
29f89df7754143b94e48737ae9c00b7e306b0f67...e2c5acbe4b511ca74b9db4ec556e6dc488263b2e,4,4,4,8,4,2010-08-25 05:57:48,2010-08-25 03:59:51
e2c5acbe4b511ca74b9db4ec556e6dc488263b2e...ce47d4e4321605f39cc81d0796848556630ec32d,2,11,1,12,3,2010-08-25 06:10:12,2010-08-25 06:10:12
ce47d4e4321605f39cc81d0796848556630ec32d...97ee21e23207575493e186bf9e009fbce9d0ed3b,1,8,1,9,2,2010-08-25 06:42:25,2010-08-25 06:42:25
97ee21e23207575493e186bf9e009fbce9d0ed3b...9298bb1f38de942963cb58cb3d647b5e6bb0d5c0,1,1,1,2,1,2010-08-25 13:43:04,2010-08-25 13:43:04
9298bb1f38de942963cb58cb3d647b5e6bb0d5c0...da6e4186cf301ab1768ab230657a2fcb326bf375,2,3,3,6,2,2010-08-25 13:52:06,2010-08-25 13:52:06
da6e4186cf301ab1768ab230657a2fcb326bf375...f6d50d513880d6bf0f9e6aae03d7cd303c22e97c,1,3,0,3,3,2010-08-25 13:54:20,2010-08-25 13:54:20
fa004db722fcda71debb9ce9adfe65e37951b2bb...7845a6ebfe66eccd402c9f24f27a0347d346e7f4,1,1,1,2,1,2010-08-24 17:28:00,2010-08-19 22:15:00
7845a6ebfe66eccd402c9f24f27a0347d346e7f4...0fabb0e31d58d85e09f0f51ec61447c5c0772026,1,9,1,10,3,2010-08-24 17:28:00,2010-08-24 17:26:59
f6d50d513880d6bf0f9e6aae03d7cd303c22e97c...cdb89ad7cbf81160c1e48b39bd03f31797fb6a81,1,18,5,23,7,2010-08-25 15:47:28,2010-08-25 15:47:28
f6d50d513880d6bf0f9e6aae03d7cd303c22e97c...95b93e4119d97f6329949eece3f2055e82a190c4,2,38,2,40,5,2010-08-25 15:36:41,2010-08-25 15:35:44
0fabb0e31d58d85e09f0f51ec61447c5c0772026...a61f143e2f2276ce21c288aad23ae00559944af9,3,14,8,22,7,2010-08-30 21:06:32,2010-08-30 21:06:32
a61f143e2f2276ce21c288aad23ae00559944af9...3b6de560b8862660f0da57b631de77731c316248,5,75,11,86,15,2010-08-30 21:09:01,2010-08-30 21:09:01
0fabb0e31d58d85e09f0f51ec61447c5c0772026...8fb5e7c70ddb3be889beb1975ab630524f5dc885,2,108,108,216,80,2010-08-24 18:01:04,2010-08-24 18:01:04
8fb5e7c70ddb3be889beb1975ab630524f5dc885...7fcab1a137de67e1db70f9c73027ba9ffcc8b81f,1,45,20,65,15,2010-08-24 18:06:47,2010-07-28 16:42:11
7fcab1a137de67e1db70f9c73027ba9ffcc8b81f...b1ce5fa9b80367acc14ad094855d9e94022b64c6,1,13,10,23,6,2010-08-24 18:06:47,2010-08-16 19:07:13
b1ce5fa9b80367acc14ad094855d9e94022b64c6...7798dfdc3753f7762336f819f31be25e9fccfeea,1,5,2,7,2,2010-08-24 18:06:47,2010-08-16 19:22:51
7798dfdc3753f7762336f819f31be25e9fccfeea...e5ef00a5150169925122d312859475e59a2ebb8d,1,3,2,5,2,2010-08-24 18:06:47,2010-08-16 19:27:37
e5ef00a5150169925122d312859475e59a2ebb8d...54572e15b6c8f0484932da032ff9a3b1db8a9a7d,1,1,1,2,1,2010-08-24 18:06:47,2010-08-16 22:52:57
54572e15b6c8f0484932da032ff9a3b1db8a9a7d...4e234c4959e379e2b1ad43745a7a98df32a2b17b,5,170,3,173,9,2010-08-24 18:06:47,2010-08-17 00:15:31
4e234c4959e379e2b1ad43745a7a98df32a2b17b...5fd62e8edb11dd8a7954420bad78e498b71cd7c7,2,63,24,87,17,2010-08-24 18:28:09,2010-08-24 18:28:09
f433d80d5a25922fc80cf5331366430a68f5defb...ac725563a884cb0d840ff5c1f2a8d4963e88451c,1,8,5,13,2,2010-08-25 15:50:32,2010-08-25 15:50:32
ac725563a884cb0d840ff5c1f2a8d4963e88451c...d4ce606125da6c9e3f62f8076c943a3ed99f8d55,1,6,5,11,5,2010-08-25 16:18:38,2010-08-25 16:18:38
d4ce606125da6c9e3f62f8076c943a3ed99f8d55...95252f6b100055792d75bae86faede0bc716e7b7,1,1,1,2,1,2010-08-25 16:18:57,2010-08-25 16:18:57
95252f6b100055792d75bae86faede0bc716e7b7...e52542e5865217cf78c27c64b51b4a8b2e110ccc,4,8,23,31,16,2010-08-25 17:01:36,2010-08-25 17:01:36
e52542e5865217cf78c27c64b51b4a8b2e110ccc...20155ad7fbd6289481a7a06929efb36f42c76d00,4,15,6,21,8,2010-08-25 17:40:01,2010-08-25 17:40:01
ed02fb1230025770d0a66c5a9c28534e553245fa...efc06b3a6c456935a613c58dbcfe90ec7d9dfeed,2,5,3,8,2,2010-08-30 21:49:52,2010-08-30 21:49:52
efc06b3a6c456935a613c58dbcfe90ec7d9dfeed...fccae83a3ca86869bbd767facc061779d7180cc0,1,2,3,5,2,2010-08-30 22:37:25,2010-08-30 22:37:08
fccae83a3ca86869bbd767facc061779d7180cc0...30c59fa55079088d1d60a318e5e3f526f600856e,5,19,24,43,8,2010-08-31 03:11:00,2010-08-31 03:11:00
30c59fa55079088d1d60a318e5e3f526f600856e...387e0e4fcdb3498fc84f3f5386a15e450ea4c5f1,1,1,1,2,1,2010-08-31 04:42:53,2010-08-31 04:42:53
20155ad7fbd6289481a7a06929efb36f42c76d00...1b170096a2cd6f21130f760776e1f71e96dfcfc5,1,6,1,7,1,2010-08-25 17:51:41,2010-08-25 17:51:41
20155ad7fbd6289481a7a06929efb36f42c76d00...e04806ebd290626ba801e1ba718f089ebd31865a,1,4,4,8,3,2010-08-25 17:50:58,2010-08-25 17:50:58
64fd5585b8052f55580a77b5e572a0a1ed4d998d...cfb9944f7c4d53558fa171f5cc3192b3672d761c,1,4,2,6,2,2010-08-31 09:18:34,2010-08-31 09:18:34
cfb9944f7c4d53558fa171f5cc3192b3672d761c...67339465783e58e8ddf19ebc172c11c52f21b06b,2,3,2,5,3,2010-08-31 09:31:46,2010-08-31 09:31:46
67339465783e58e8ddf19ebc172c11c52f21b06b...015aef247d41b38b2c5c5e117d43da570f27a5a5,1,1,1,2,1,2010-08-31 13:42:52,2010-08-31 13:42:52
015aef247d41b38b2c5c5e117d43da570f27a5a5...9505276f7b65a4658403f70fe12f852015c7c2d2,1,5,2,7,1,2010-08-31 13:43:39,2010-08-31 13:43:39
9505276f7b65a4658403f70fe12f852015c7c2d2...aaf53bb797488f91047c04a5e07d400995ed7b2d,1,5,1,6,4,2010-08-31 13:47:01,2010-08-31 13:47:01
aaf53bb797488f91047c04a5e07d400995ed7b2d...0845e6c517c2f1a2065287252e149d7efffef13c,5,16,7,23,6,2010-08-31 14:46:05,2010-08-31 14:46:05
0845e6c517c2f1a2065287252e149d7efffef13c...bde8261ffb60ec7a93ea6ecb46913fc1f54f75a1,1,1,1,2,1,2010-08-31 15:16:18,2010-08-31 15:16:18
bde8261ffb60ec7a93ea6ecb46913fc1f54f75a1...96724b51594a008e7cada04525919652d0b9b206,1,2,2,4,2,2010-08-31 15:17:58,2010-08-31 15:17:58
96724b51594a008e7cada04525919652d0b9b206...ee65b0cc858ffc1ef68ab1a8850f658602b85926,2,16,3,19,4,2010-08-31 16:05:39,2010-08-31 16:05:39
ee65b0cc858ffc1ef68ab1a8850f658602b85926...dbdf9d595a17e9a98313833e9538f38679a7261b,1,2,2,4,1,2010-08-31 16:46:12,2010-08-31 16:41:06
dbdf9d595a17e9a98313833e9538f38679a7261b...c296e87903f1235917102bb5ce96734c5596d325,1,1,1,2,1,2010-08-31 16:51:11,2010-08-31 16:51:11
c296e87903f1235917102bb5ce96734c5596d325...a6e3b04263d32885d4462d4b34c7f77badef820e,2,71,3,74,6,2010-09-01 03:33:58,2010-09-01 03:33:58
a6e3b04263d32885d4462d4b34c7f77badef820e...b416e09061258dcb0af8ab30147b0eb0dcb0cbf1,6,63,2,65,8,2010-09-01 05:32:35,2010-09-01 05:32:04
b416e09061258dcb0af8ab30147b0eb0dcb0cbf1...06825dfc011ef622deb4a2762960e2d68bc7704d,1,1,0,1,1,2010-09-01 05:32:35,2010-09-01 05:32:18
06825dfc011ef622deb4a2762960e2d68bc7704d...c3d1c6d43bc5dd69469d3076bdc7b0f9b6a19790,1,11,13,24,4,2010-09-01 14:13:50,2010-08-30 19:02:18
c3d1c6d43bc5dd69469d3076bdc7b0f9b6a19790...64ec65b4b12d465ef6c82be22b231a05183bc367,1,16,0,16,1,2010-09-01 15:54:58,2010-09-01 15:54:58
64ec65b4b12d465ef6c82be22b231a05183bc367...465566855dd88b84ed7b18c1de0bf9ebd7cfb5b9,1,13,11,24,4,2010-09-01 15:57:02,2010-09-01 15:57:02
465566855dd88b84ed7b18c1de0bf9ebd7cfb5b9...0920dbf99171829b2c3561931c28ea9147973e32,1,11,13,24,4,2010-09-01 20:35:51,2010-09-01 20:35:51
0920dbf99171829b2c3561931c28ea9147973e32...562f58d9a1219e58b8da76b55bfb69bfe2fc43dd,1,1,1,2,1,2010-09-01 21:48:57,2010-09-01 21:48:57
562f58d9a1219e58b8da76b55bfb69bfe2fc43dd...88edf8f4394bbd05ea354e44b836435477d44a5f,1,1,1,2,1,2010-09-01 23:35:45,2010-09-01 23:35:45
88edf8f4394bbd05ea354e44b836435477d44a5f...0f5e389c3e171d2cf9943545306bf3a6acf4ba91,1,1,1,2,1,2010-09-02 01:15:16,2010-09-02 01:15:16
d3ffc1a7bbb9d7f3e25efd368417c4fedb406ca1...1e62cdc5744614f24c0b3c05701325b64560bb11,1,4,5,9,4,2010-08-25 17:52:19,2010-08-25 17:51:57
1e62cdc5744614f24c0b3c05701325b64560bb11...075ac2c2a9581e85564b3c39e047dee34522cae1,1,1,1,2,2,2010-08-25 18:13:32,2010-08-25 18:13:32
075ac2c2a9581e85564b3c39e047dee34522cae1...1928d2a260c74519555c46c499902183f80b4c32,1,179,177,356,1,2010-08-25 18:20:19,2010-08-25 18:20:19
0f5e389c3e171d2cf9943545306bf3a6acf4ba91...b6321840dd39f96febef4e82de70dc2bb71075e5,1,1,1,2,1,2010-09-02 15:02:17,2010-09-02 15:02:17
b6321840dd39f96febef4e82de70dc2bb71075e5...1d7d0baa59878dd7377dac32d863c3d639b8f838,1,3,2,5,1,2010-09-02 20:07:42,2010-09-02 20:07:42
1d7d0baa59878dd7377dac32d863c3d639b8f838...d5c6331a7ef09184316bdb918e8a771dfdb87788,1,1,1,2,1,2010-09-02 20:08:19,2010-09-02 20:08:19
d5c6331a7ef09184316bdb918e8a771dfdb87788...fd4de41e4fe08b1308f95a315843fe80bf3baa06,1,4,5,9,5,2010-09-03 00:12:37,2010-08-26 18:17:15
fd4de41e4fe08b1308f95a315843fe80bf3baa06...0b0fbe7ebae5c315e9ce9767940271860d7aab53,1,70,35,105,24,2010-09-03 00:12:37,2010-08-26 20:15:07
0b0fbe7ebae5c315e9ce9767940271860d7aab53...c6a123f3e8483f4afc563275648a9a26e57fa5a1,1,10,0,10,4,2010-09-03 00:12:37,2010-08-26 20:52:02
c6a123f3e8483f4afc563275648a9a26e57fa5a1...0acaa65fc7c1302ee7711dbaaecc3f91fbadd38b,1,11,7,18,5,2010-09-03 00:12:37,2010-08-26 21:28:08
0acaa65fc7c1302ee7711dbaaecc3f91fbadd38b...dc7a33093c49d8902adcd7fdb43b6d32284c9d98,1,22,6,28,7,2010-09-03 00:12:37,2010-08-27 21:04:03
dc7a33093c49d8902adcd7fdb43b6d32284c9d98...5b6cca5c4a68e0b649b12cba709bc36e25e44115,1,6,6,12,6,2010-09-03 00:12:37,2010-08-27 21:28:09
5b6cca5c4a68e0b649b12cba709bc36e25e44115...73dc0ce638999d103c35cbd465cf38c1894c018b,1,11,5,16,8,2010-09-03 00:12:37,2010-09-02 18:34:00
73dc0ce638999d103c35cbd465cf38c1894c018b...0fe45dce90be8a3414e962460071a5e52afb0d2f,2,14,2,16,3,2010-09-03 00:12:37,2010-09-02 18:58:10
0fe45dce90be8a3414e962460071a5e52afb0d2f...0f7906c1e56d65872fdbb32dddc400222efcaa54,1,13,2,15,6,2010-09-03 00:12:37,2010-09-02 22:05:46
0f7906c1e56d65872fdbb32dddc400222efcaa54...f107692b4bb523e788a3d4d83571e5f2dec45439,6,154,0,154,6,2010-09-03 00:19:00,2010-09-03 00:11:46
f107692b4bb523e788a3d4d83571e5f2dec45439...2543ea4f76d077b5d71a4b237ad2c0812f73d1d7,1,4,4,8,4,2010-09-03 00:19:08,2010-09-03 00:18:28
2543ea4f76d077b5d71a4b237ad2c0812f73d1d7...6cc10ef09e3ceb5e21de53626ae8af0aa81a3d49,1,11,4,15,1,2010-09-03 01:11:53,2010-09-03 01:11:53
6cc10ef09e3ceb5e21de53626ae8af0aa81a3d49...e4db8da0161fe74d39d0d743eb0d057fa181574d,1,1,1,2,1,2010-09-03 01:24:18,2010-09-03 01:24:18
e4db8da0161fe74d39d0d743eb0d057fa181574d...4131dd3679f161e5d41962f0129c7300a25a6999,3,22,11,33,8,2010-09-03 01:46:38,2010-09-03 01:34:41
4131dd3679f161e5d41962f0129c7300a25a6999...8b24b1e719fbfe4c7ace9e42f6535fa7fd948462,3,14,22,36,8,2010-09-03 14:23:31,2010-09-03 14:23:31
8b24b1e719fbfe4c7ace9e42f6535fa7fd948462...25eb3f0c37cfc4e736bc47b25c47d4b22c6a7175,4,11,3,14,5,2010-09-03 15:13:35,2010-09-03 15:13:35
0f5e389c3e171d2cf9943545306bf3a6acf4ba91...e1766ce5e5f5faade12a46a21c23b13546e6646b,1,0,5,5,4,2010-09-02 14:04:27,2010-09-02 14:04:27
e1766ce5e5f5faade12a46a21c23b13546e6646b...34704e7bd5495bf74e30f64037c44b45b3e4c4e9,1,3,11,14,3,2010-09-02 14:12:07,2010-09-02 14:12:07
34704e7bd5495bf74e30f64037c44b45b3e4c4e9...86a1bf2878f814fd2474c384ad4459b80ef81e05,1,4,0,4,1,2010-09-02 14:16:52,2010-09-02 14:16:52
86a1bf2878f814fd2474c384ad4459b80ef81e05...62cfac2a57779d3ca4dbffb41d227c6a11e445b5,1,13,13,26,2,2010-09-02 14:17:48,2010-09-02 14:17:48
62cfac2a57779d3ca4dbffb41d227c6a11e445b5...f9e013eb4d0afe5f892eab354dbe7b7b07e4b257,4,15,4,19,6,2010-09-02 15:26:38,2010-09-02 15:26:38
1928d2a260c74519555c46c499902183f80b4c32...84909e910dcfb5cbf3e457f0a0c1c31766c769b5,2,10,8,18,5,2010-08-25 18:39:04,2010-08-25 18:39:04
1928d2a260c74519555c46c499902183f80b4c32...6dbd8594e56135347fca75f15ba08578cfacbe1a,1,6,1,7,3,2010-08-25 18:34:03,2010-08-25 18:32:20
25eb3f0c37cfc4e736bc47b25c47d4b22c6a7175...cbc4f28938fec3348c2a009b763587590d513198,2,19,17,36,4,2010-09-03 15:58:53,2010-09-03 15:58:53
cbc4f28938fec3348c2a009b763587590d513198...2e8bb745dc58bbd12389fcef7e982324e4628974,1,2,2,4,1,2010-09-03 15:59:01,2010-09-03 15:59:01
2e8bb745dc58bbd12389fcef7e982324e4628974...1c0d685f9a22c8e4acba957dba99feda69bc12be,2,4,1,5,3,2010-09-03 15:59:13,2010-09-03 15:59:13
25eb3f0c37cfc4e736bc47b25c47d4b22c6a7175...c58ddb10d4cd63e3fe21ee439b1595459ab1e3b9,1,0,2,2,1,2010-09-03 15:56:31,2010-09-03 15:56:07
4c570bcada7d0d9c5a91a56ba62cf09f3ad95ff1...0c95910af2d71fc3cefd6a245704f67666db86f3,1,4,4,8,1,2010-09-05 06:06:29,2010-09-05 06:06:29
0c95910af2d71fc3cefd6a245704f67666db86f3...3dde3a83d3d2600e5ab3859ddfc2aebb4d56d4cc,2,3,3,6,3,2010-09-05 13:58:28,2010-09-05 13:58:28
3dde3a83d3d2600e5ab3859ddfc2aebb4d56d4cc...403ccba9982ef27e2880d8f9733ffa1a6335eb34,2,28,28,56,2,2010-09-05 14:10:23,2010-09-05 14:10:23
403ccba9982ef27e2880d8f9733ffa1a6335eb34...a2baa445873a3100f0f810639f5cd33486828fef,2,5,7,12,5,2010-09-05 16:06:06,2010-09-05 16:06:06
a2baa445873a3100f0f810639f5cd33486828fef...c32c1b19ee717f95e1bcc143f67f9215beddecb4,1,10,9,19,4,2010-09-05 16:16:37,2010-09-05 16:16:37
c32c1b19ee717f95e1bcc143f67f9215beddecb4...edcac99f06a95970528013ff5901bef2883c371d,1,1,2,3,1,2010-09-05 16:21:14,2010-09-05 16:21:14
edcac99f06a95970528013ff5901bef2883c371d...32d9a4cb4796dfbc9e289972e49a6a1534dba9ea,2,6,2,8,2,2010-09-07 09:30:27,2010-09-07 09:30:27
32d9a4cb4796dfbc9e289972e49a6a1534dba9ea...8fca8f6b9a531927c7e45a5a6d272c696efab469,5,84,0,84,8,2010-09-07 09:31:31,2010-09-07 09:31:31
0ee09016f612af1fbeb691522cd755ac5117beb6...deec63fa246a536cba6b887f06b8bb3d8e10cb48,3,17,33,50,9,2010-08-25 18:52:36,2010-08-25 18:52:36
deec63fa246a536cba6b887f06b8bb3d8e10cb48...6c71ce88ffe42e1c44d175a2cb3705632c81f7e6,1,3,3,6,3,2010-08-25 18:59:34,2010-08-25 18:59:34
2e4b7c409593e4884981f617b04665d9a7cb1dac...d1efe8cafc2db880e7e6beee36633d467eb7f7d9,1,10,25,35,7,2010-09-03 17:12:36,2010-09-03 17:12:36
d1efe8cafc2db880e7e6beee36633d467eb7f7d9...b5e57bae310b4f097fcb4c7230cbe3de42477dab,1,1,1,2,1,2010-09-03 17:28:10,2010-09-03 17:16:25
b5e57bae310b4f097fcb4c7230cbe3de42477dab...fe341ea9e06d7103cf4efbdaf30844582b02bcb5,5,37,3,40,5,2010-09-03 17:28:10,2010-09-03 17:27:37
8fca8f6b9a531927c7e45a5a6d272c696efab469...a8f72608549817cf911588855a1c1fe7d6482c35,1,27,27,54,2,2010-09-07 16:15:10,2010-09-07 16:15:10
a8f72608549817cf911588855a1c1fe7d6482c35...0c50daeb55c91836e01827bebac45965e5a0c98b,5,7,7,14,6,2010-09-07 16:15:35,2010-09-07 16:15:35
0c50daeb55c91836e01827bebac45965e5a0c98b...e9d0762ed5f5c724d14f1772a2493556f07a6ab6,4,6,6,12,6,2010-09-07 16:18:44,2010-09-07 16:18:44
8fca8f6b9a531927c7e45a5a6d272c696efab469...8fdabc70d9eb3f9d276eb67084c08655909c3b5c,1,1,1,2,1,2010-09-07 14:29:22,2010-09-07 14:29:22
8fdabc70d9eb3f9d276eb67084c08655909c3b5c...4a6398df844cc7836d467be75b7022c2c0d3a26c,1,1,1,2,1,2010-09-07 16:11:24,2010-09-07 16:11:24
4a6398df844cc7836d467be75b7022c2c0d3a26c...780ca826e221f9f77dc6606c762be519e05a185a,2,10,1,11,5,2010-09-07 16:11:36,2010-09-07 16:11:36
6c71ce88ffe42e1c44d175a2cb3705632c81f7e6...6f15b6f62dc9d91b7e832a2f9ad0040df2884e2e,1,2,0,2,1,2010-08-25 20:01:32,2010-08-25 20:01:32
6c71ce88ffe42e1c44d175a2cb3705632c81f7e6...259dc007d7a97410fd7ccc85d1ef70f4f806024d,4,14,2,16,8,2010-08-25 19:26:20,2010-08-25 19:25:54
fe341ea9e06d7103cf4efbdaf30844582b02bcb5...29691a07c5c04a38294fb043cc80c33a3be841c1,2,24,30,54,15,2010-09-04 12:20:14,2010-09-04 12:20:14
fe341ea9e06d7103cf4efbdaf30844582b02bcb5...08ca5c8cb70e9ea41aeedd47a3e06b19d57c8b29,1,2,15,17,3,2010-09-03 19:56:45,2010-09-03 19:56:45
fe341ea9e06d7103cf4efbdaf30844582b02bcb5...3c8722269e8d49100babb969f07251d84dd54794,1,3,4,7,1,2010-09-03 18:57:36,2010-09-03 18:57:36
3c8722269e8d49100babb969f07251d84dd54794...8567338619100d160767d95933185874b26912b1,1,1,5,6,2,2010-09-03 19:10:06,2010-09-03 19:06:50
ba37286deda76210e9e975f892e700185e6a8fcd...583ea163120d7172ad620c77460904afd6561a27,8,80,68,148,20,2010-09-07 16:47:11,2010-09-07 16:47:11
ba37286deda76210e9e975f892e700185e6a8fcd...c1cc61f19b7191742a4c5007e3c10d3897f0b8e7,1,5,1,6,1,2010-09-07 16:46:49,2010-09-07 16:45:10
fe6dba14c7fc05b5fbe23bf8d5b5e2c2bf82d624...62cfaf245eb5051dcf1ec2e43216f84db714db14,3,11,8,19,6,2010-08-25 20:10:31,2010-08-25 20:10:31
62cfaf245eb5051dcf1ec2e43216f84db714db14...053d5cd3851868e20b82f460cfe7eca7988f714a,1,3,3,6,2,2010-08-25 20:55:33,2010-08-25 20:55:33
053d5cd3851868e20b82f460cfe7eca7988f714a...666af2a1b9c4d948b45cbd86337c1f2dffe45bea,1,2,2,4,1,2010-08-25 20:56:27,2010-08-25 20:56:27
666af2a1b9c4d948b45cbd86337c1f2dffe45bea...c78415729edb31d87133637113e976962bed584b,3,18,7,25,8,2010-08-25 22:30:51,2010-08-25 22:30:51
35bb2d11540f40e948ac1018047ce6138f4f7d65...946b78eaad3d71312874b35e92baf6f25fc6ad69,1,5,4,9,4,2010-09-04 16:04:03,2010-09-04 16:04:03
946b78eaad3d71312874b35e92baf6f25fc6ad69...cc78340d4283f733c220b6d323930c6e41b6d327,2,2,2,4,2,2010-09-04 16:21:35,2010-09-04 16:21:35
cc78340d4283f733c220b6d323930c6e41b6d327...b55730f69b2e572a9e3aea98687c202ed3d7a6f1,1,1,1,2,1,2010-09-04 16:31:36,2010-09-04 16:31:36
b7ac0e7ff424556c6b1293a8ec38445af9ccde48...1ae46abb18968047e6432361f1933ca724413467,1,8,2,10,3,2010-09-03 20:53:54,2010-09-03 20:53:54
1ae46abb18968047e6432361f1933ca724413467...02013802f63d6cbe41bf814b2bc30d82e436d48f,1,1,1,2,1,2010-09-04 03:24:57,2010-09-04 03:24:57
84353dfeb78469ebce10e9aa445144a9bfd4b429...4e35b51517cc45d0a2eaf02dbceb2bfadb16e6b5,2,14,13,27,4,2010-09-07 16:51:30,2010-09-07 16:51:30
c1cc61f19b7191742a4c5007e3c10d3897f0b8e7...459e4f745029eac03229c50e9a13552b328e6643,1,23,10,33,7,2010-09-07 16:50:13,2010-09-07 16:50:13
c78415729edb31d87133637113e976962bed584b...8bbf74107e9e617b654a1d15c1d23f5b18920d81,2,7,1,8,2,2010-08-26 02:43:45,2010-08-26 02:43:45
c78415729edb31d87133637113e976962bed584b...6e3ad16e6f056ec7677f74756bece460663128ac,1,4,0,4,2,2010-08-26 01:59:24,2010-08-26 01:59:24
6e3ad16e6f056ec7677f74756bece460663128ac...ccdb5dd86d463f3fb6af86569c6947072295ef48,1,1,1,2,1,2010-08-26 01:59:32,2010-08-26 01:59:32
ba7f710726694872207d2f2de6f17a9ca5710382...cfbbf9629a911f5959b734cf20ba81314a56b358,1,1,2,3,2,2010-09-08 05:32:08,2010-09-08 05:32:08
ba7f710726694872207d2f2de6f17a9ca5710382...494366f5c13f539295013784a19c2f2017886474,5,12,7,19,8,2010-09-07 17:01:21,2010-09-07 17:00:33
494366f5c13f539295013784a19c2f2017886474...ebc391a645dc105f274df0c9c4262a8030d74ba8,1,6,1,7,1,2010-09-07 17:01:06,2010-09-07 17:00:30
ebc391a645dc105f274df0c9c4262a8030d74ba8...4487eaf5c9bc125181a9faece4f7eaf3929e5d43,1,12,4,16,1,2010-09-07 17:51:43,2010-09-07 17:50:01
4487eaf5c9bc125181a9faece4f7eaf3929e5d43...00adc3d0d5b4c6c63bcc19a76ca346f10278cef6,1,10,16,26,9,2010-09-07 18:30:29,2010-09-07 18:30:24
00adc3d0d5b4c6c63bcc19a76ca346f10278cef6...543357ec31c3333bd40b8f1dedf62d7af4b15e31,1,1,0,1,1,2010-09-07 18:42:07,2010-09-07 18:41:46
543357ec31c3333bd40b8f1dedf62d7af4b15e31...4aa83fac62ff5162d76beba9d62f5da6d1513d13,1,9,0,9,2,2010-09-07 20:26:30,2010-09-07 20:26:30
ccdb5dd86d463f3fb6af86569c6947072295ef48...b5893b906f077b2dd7c51e8fdabc611b44fb0088,1,1,1,2,1,2010-08-26 02:44:05,2010-08-26 02:44:05
c3c11afeaab435c8b83e6cc9d428cf838247e6ab...14296b4338483612e97e553b683174c6bd4d5dc8,1,55,76,131,19,2010-09-08 11:13:27,2010-09-08 11:13:27
14296b4338483612e97e553b683174c6bd4d5dc8...b904b0dd1d6999a6f88cd710ccbf8b604ae9bb1d,14,265,92,357,64,2010-09-09 11:12:17,2010-09-09 11:12:17
c3c11afeaab435c8b83e6cc9d428cf838247e6ab...e1d0a0fec21a976a54b14543feeab52f9dfcdb16,1,1,1,2,1,2010-09-08 05:51:43,2010-09-08 05:51:43
e1d0a0fec21a976a54b14543feeab52f9dfcdb16...81ea67e1fd67559f95ad7808f8434448a11acaa2,1,29,0,29,1,2010-09-08 14:36:10,2010-09-08 14:36:10
81ea67e1fd67559f95ad7808f8434448a11acaa2...495fabb953068dbf7930cdbaaa79920d1dbb7116,2,6,0,6,2,2010-09-08 14:36:21,2010-09-08 14:36:21
495fabb953068dbf7930cdbaaa79920d1dbb7116...75acd56feaf14f0181d0c867105e34ff41cad82f,2,19,3,22,11,2010-09-08 16:41:53,2010-09-08 16:41:53
75acd56feaf14f0181d0c867105e34ff41cad82f...cfb4c808c74cc5d1db16037a66813af13dde3425,1,14,8,22,10,2010-09-08 17:25:56,2010-09-08 17:25:56
cfb4c808c74cc5d1db16037a66813af13dde3425...323cb15d9a09ed8c238ee9e246455447cd923c24,2,4,21,25,5,2010-09-08 17:27:00,2010-09-08 17:16:02
323cb15d9a09ed8c238ee9e246455447cd923c24...d8d9c80000b80bfc698642d6eef1542279a35213,2,12,2,14,4,2010-09-08 17:27:00,2010-09-08 17:25:49
d8d9c80000b80bfc698642d6eef1542279a35213...c2b7bce08158ede33e1b613ae9d95cd64a942131,1,1,1,2,1,2010-09-08 18:27:16,2010-09-08 18:27:16
c2b7bce08158ede33e1b613ae9d95cd64a942131...967f617aa7992e889d514d5e7fd60709dd14bfa3,1,5,0,5,2,2010-09-08 19:40:39,2010-09-08 19:40:21
967f617aa7992e889d514d5e7fd60709dd14bfa3...ad131f80962abf9701a3672bae4b00c2af156f76,1,1,0,1,1,2010-09-08 21:40:08,2010-09-08 21:40:08
ad131f80962abf9701a3672bae4b00c2af156f76...7c3493d6520b78c2a733555d80bce559a50edd00,3,10,1,11,4,2010-09-09 05:56:25,2010-09-09 05:56:25
7c3493d6520b78c2a733555d80bce559a50edd00...df463cc254a5d2ba89d4f152617cd31596a6c222,1,1,1,2,1,2010-09-09 06:05:29,2010-09-09 06:05:29
df463cc254a5d2ba89d4f152617cd31596a6c222...9221b81acb863672eef708d052ad68c9d7aa83f0,1,17,15,32,3,2010-09-09 06:31:17,2010-09-09 06:30:25
9221b81acb863672eef708d052ad68c9d7aa83f0...d16ac9d54d9595710ad8288ccdd742d9242a6fc3,1,96,0,96,1,2010-09-09 06:49:19,2010-09-09 06:49:08
4aa83fac62ff5162d76beba9d62f5da6d1513d13...8d11f130ede389f39fdeeb75b9cc700ed300de4c,1,12,8,20,2,2010-09-07 23:46:08,2010-09-07 23:46:08
4aa83fac62ff5162d76beba9d62f5da6d1513d13...eca02a4eeccfa8251e6da0fe7fc016d6348370e1,4,8,8,16,7,2010-09-07 22:50:39,2010-09-07 21:04:35
eca02a4eeccfa8251e6da0fe7fc016d6348370e1...f23ba41ffa20ed398e83348a278bb02500b0c9f5,1,37,6,43,5,2010-09-07 22:50:39,2010-09-07 22:45:23
f23ba41ffa20ed398e83348a278bb02500b0c9f5...3ee76fe750adebf3bb2a27145b9f8e99cc4ba1d6,1,1,0,1,1,2010-09-07 23:03:05,2010-09-07 20:51:39
3ee76fe750adebf3bb2a27145b9f8e99cc4ba1d6...cd92ee466adb7df4927777a96849d159fecc73cd,1,5,1,6,3,2010-09-07 23:03:05,2010-09-07 23:02:36
cd92ee466adb7df4927777a96849d159fecc73cd...3d1faf35fc53e9265838341a8ff2bfc17c75ff7e,1,6,37,43,5,2010-09-07 23:09:46,2010-09-07 23:08:33
fcd177448bf0c37fafb07406c65f40025d8fdcf6...c48de7b65552c56b5f147ca91d0a7ab8f68f4c18,1,7,3,10,3,2010-08-26 12:43:11,2010-08-26 12:43:11
fcd177448bf0c37fafb07406c65f40025d8fdcf6...65078c15cbbc4f4ca44a25eda7d619abd37ee447,2,28,1,29,2,2010-08-26 04:28:35,2010-08-26 04:28:35
65078c15cbbc4f4ca44a25eda7d619abd37ee447...253125754a6173a7ff659312d24276926a91d195,1,1,1,2,1,2010-08-26 11:37:37,2010-08-26 11:37:37
c8401a237f0cb21f29bbe6772cff612d23b94ece...72a9a42bdb6411bf2167a7d6095abf3b3574e791,5,7,7,14,7,2010-09-09 11:46:22,2010-09-09 11:46:22
72a9a42bdb6411bf2167a7d6095abf3b3574e791...0562697eea8740854f6cc7ae7d3d2229cdb4ecef,1,5,2,7,1,2010-09-09 11:55:47,2010-09-09 11:55:47
0562697eea8740854f6cc7ae7d3d2229cdb4ecef...b2e6ff04bce27e09eabba0d0c8ca19b52b9c5d54,3,7,6,13,3,2010-09-09 14:17:02,2010-09-09 14:17:02
b2e6ff04bce27e09eabba0d0c8ca19b52b9c5d54...6a3c756e94e809ec85d7f55aa6a0c32754bcb6e4,6,102,13,115,18,2010-09-09 16:01:28,2010-09-09 16:01:28
6a3c756e94e809ec85d7f55aa6a0c32754bcb6e4...bf4baadc3799f40517b3f9b973cbaab9dee2c754,1,1,1,2,1,2010-09-09 16:05:08,2010-09-09 16:05:08
bf4baadc3799f40517b3f9b973cbaab9dee2c754...0f8fc0fca041bdd93b97ffd78ff4cb00b8d1866d,1,1,1,2,1,2010-09-09 16:10:33,2010-09-09 16:10:33
0f8fc0fca041bdd93b97ffd78ff4cb00b8d1866d...10f750fa617e7499a89e9a140d89ddb4a7427ad6,2,66,3,69,12,2010-09-09 18:16:07,2010-09-09 18:16:07
10f750fa617e7499a89e9a140d89ddb4a7427ad6...2584ba0ae486a9e78183ba196c7fe0239f69a005,8,1,379,380,12,2010-09-09 21:07:23,2010-09-09 21:07:23
2584ba0ae486a9e78183ba196c7fe0239f69a005...cc3ffa4b1a9c362b6737bbf94c3e1fc0e8b42407,3,17,4,21,5,2010-09-09 21:30:40,2010-09-09 21:30:40
cc3ffa4b1a9c362b6737bbf94c3e1fc0e8b42407...6766569f9acdd80e27d957906f61dd7a14425d0d,1,4,0,4,1,2010-09-09 21:55:20,2010-09-09 21:55:20
6766569f9acdd80e27d957906f61dd7a14425d0d...96d348821d11c20636a6cbfa6f3a075d6ad899a8,1,4,1,5,2,2010-09-10 14:14:04,2010-09-10 14:14:04
96d348821d11c20636a6cbfa6f3a075d6ad899a8...b87ec3ea859c33b33f108b84c88917f45a817449,1,196,196,392,1,2010-09-10 15:25:28,2010-09-10 15:25:28
b87ec3ea859c33b33f108b84c88917f45a817449...159230918ba14062e76dee7909df5bb4080852e6,1,3,3,6,2,2010-09-10 17:14:58,2010-09-10 17:14:58
159230918ba14062e76dee7909df5bb4080852e6...906bf017669748318ab21831e72ee06dcd03efd7,1,31,0,31,1,2010-09-10 17:21:41,2010-09-10 17:21:41
906bf017669748318ab21831e72ee06dcd03efd7...bb241685891ba499cc81d032228bbe7f3abdbf2a,1,5,0,5,2,2010-09-10 18:02:44,2010-09-10 18:02:44
bb241685891ba499cc81d032228bbe7f3abdbf2a...d2b8621fa35f1fb25e7180ab4b3f68e2e3d7c781,1,2,2,4,1,2010-09-10 18:25:37,2010-09-10 18:25:37
d2b8621fa35f1fb25e7180ab4b3f68e2e3d7c781...6273e13e4842cffab8be3b7a23945b5f301927fc,1,1,1,2,1,2010-09-10 18:27:22,2010-09-10 18:26:54
6273e13e4842cffab8be3b7a23945b5f301927fc...a462a8af4c33fd7251b633037d0505f5e2532fe3,3,9,5,14,6,2010-09-10 18:27:22,2010-09-10 18:27:01
a462a8af4c33fd7251b633037d0505f5e2532fe3...437fb131dc090dcc6eec52a0c64d0f0937880db5,1,8,1,9,1,2010-09-10 18:27:42,2010-09-10 18:26:34
437fb131dc090dcc6eec52a0c64d0f0937880db5...9e4b1298ccb8faccd23e7050d7534661e4e588df,2,4,2,6,2,2010-09-10 20:22:17,2010-09-10 18:30:57
9e4b1298ccb8faccd23e7050d7534661e4e588df...164ef1656a25ff9e24a778d2a4d05537ece0af41,3,11,2,13,4,2010-09-10 20:22:17,2010-09-10 20:20:50
164ef1656a25ff9e24a778d2a4d05537ece0af41...22ecccf502805e6c8672c7469b8b690ba69da40b,1,2,0,2,1,2010-09-10 20:22:17,2010-09-10 20:21:06
22ecccf502805e6c8672c7469b8b690ba69da40b...5013a1539af07b27c372f5a6bed10cb03cd71a72,2,41,28,69,13,2010-09-10 20:22:17,2010-09-10 20:21:22
5013a1539af07b27c372f5a6bed10cb03cd71a72...40bcd07cbf88a9b248821504ca69a963db9bf29f,1,4,0,4,2,2010-09-10 22:48:32,2010-09-10 22:48:32
40bcd07cbf88a9b248821504ca69a963db9bf29f...9dc8c7d0086da36c488afb333bb6621f32faa6c8,1,37,6,43,5,2010-09-10 23:00:32,2010-09-10 19:06:22
9dc8c7d0086da36c488afb333bb6621f32faa6c8...84abe861b180c42f11d1921ec4c1e642ed4320bf,9,72,75,147,20,2010-09-10 23:00:32,2010-09-10 20:12:16
84abe861b180c42f11d1921ec4c1e642ed4320bf...4697d9328275b3ba52fb735550657a1e9fbb98a4,6,30,1,31,8,2010-09-10 23:00:32,2010-09-10 22:56:46
4697d9328275b3ba52fb735550657a1e9fbb98a4...03f252a3ad41beca9a3540f83612b975105c5941,1,10,0,10,1,2010-09-10 23:00:32,2010-09-10 22:58:23
03f252a3ad41beca9a3540f83612b975105c5941...5f5e84796eb312fdc7d4a10ce864384d7f98ad5a,1,4,0,4,1,2010-09-10 23:00:32,2010-09-10 22:59:29
5f5e84796eb312fdc7d4a10ce864384d7f98ad5a...c153bf3c7f21790c823002cdb8ad3ffd0e8733bf,1,1,1,2,1,2010-09-11 01:00:08,2010-09-11 01:00:08
c153bf3c7f21790c823002cdb8ad3ffd0e8733bf...05a07f98be0ab78d5f0bc3c8887de1df2f77482f,1,1,1,2,1,2010-09-11 01:05:15,2010-09-11 01:05:15
05a07f98be0ab78d5f0bc3c8887de1df2f77482f...0069c093f15a9c66c12a035d233c645c475a25b7,1,0,9,9,2,2010-09-11 03:27:10,2010-09-11 03:27:10
0069c093f15a9c66c12a035d233c645c475a25b7...4d77f5e86a4cd8fcdb2070f4e6132da608eeec01,1,1,1,2,1,2010-09-11 03:35:54,2010-09-11 03:35:54
4d77f5e86a4cd8fcdb2070f4e6132da608eeec01...fc92d29a2528f1119fc27595921792ac3538783c,1,8,9,17,8,2010-09-11 03:37:06,2010-09-11 03:37:06
ca0177e81c0a57eae60b3de3c3ee61d13984f32f...f4fd753e08058b0d44fc101bb899008cf09f94e3,2,2,2,4,2,2010-09-08 02:54:35,2010-09-08 02:52:37
f4fd753e08058b0d44fc101bb899008cf09f94e3...296ddbb6b8855dfbb3f42dc73cf437a179e6185a,3,17,5,22,5,2010-09-08 03:02:23,2010-09-08 03:02:02
296ddbb6b8855dfbb3f42dc73cf437a179e6185a...e53c867908f30eff6b7129307f45129acc8a3fc3,5,72,53,125,34,2010-09-08 04:32:46,2010-09-08 04:32:14
e53c867908f30eff6b7129307f45129acc8a3fc3...ff23b4ea3986dad42eaad92ac9362df01aba68f7,1,1,1,2,1,2010-09-08 04:43:34,2010-09-08 04:43:19
c3374940d9574391c9c1570c9bfce962dca6e8c0...1bbea389ef6591880924b1a273587e4ebe71358e,1,1,1,2,1,2010-08-26 13:34:30,2010-08-26 13:34:30
fc92d29a2528f1119fc27595921792ac3538783c...bf55a4240ada82a2c11cb8df33b8a5f9261783d1,2,15,11,26,6,2010-09-12 14:33:18,2010-09-12 14:33:18
fc92d29a2528f1119fc27595921792ac3538783c...e0a7a139caf36b8a5cdd74a75570519fa0433135,1,2,1,3,1,2010-09-11 13:42:29,2010-09-11 13:42:29
e0a7a139caf36b8a5cdd74a75570519fa0433135...dd8b17f014cc4fc15055004291d4a7ec986ad367,1,9,7,16,8,2010-09-11 17:14:40,2010-09-11 17:14:40
dd8b17f014cc4fc15055004291d4a7ec986ad367...f5af7eb1ac7cdc346b97a2d093c88a924259aefa,1,2,0,2,2,2010-09-11 21:55:54,2010-09-11 21:55:54
f5af7eb1ac7cdc346b97a2d093c88a924259aefa...7b4729ff9b0d69b5e3f890e72fd8fbe05ee5c986,1,1,1,2,1,2010-09-12 04:59:29,2010-09-12 04:58:55
1bbea389ef6591880924b1a273587e4ebe71358e...251d1b2a804a38ecc3f6565712b5080052f27f5a,1,22,10,32,6,2010-08-26 13:50:22,2010-08-26 13:50:22
251d1b2a804a38ecc3f6565712b5080052f27f5a...b7e0bd448dee7a3c0364831dcd7ca2ede9a640df,1,12,3,15,1,2010-08-26 14:07:13,2010-08-26 14:07:13
1bbea389ef6591880924b1a273587e4ebe71358e...653d2e588d9975e2cc2be44ace4c7f4d82a694e7,1,2,4,6,2,2010-08-26 13:43:28,2010-08-26 13:43:28
d5454d558932fc642ef8c03ad2c0a99de47b7d85...87ac860b31b0614edf8bd1dfd407145fbe75aa13,1,1,2,3,3,2010-09-12 15:03:20,2010-09-12 15:03:20
fb72d4b0e361dee77889df200e963fdb1933b829...d11ec32d5e19cb067d477787f475162b51a7b553,2,15,2,17,5,2010-08-26 16:13:08,2010-08-26 16:13:08
fb72d4b0e361dee77889df200e963fdb1933b829...dd95851093716fa93857ed657d466ad0a18362b2,1,2,3,5,2,2010-08-26 14:28:35,2010-08-26 14:28:35
dd95851093716fa93857ed657d466ad0a18362b2...92f0779172a9e11663794ffa3a3493445cb58190,6,36,31,67,16,2010-08-26 14:42:07,2010-08-26 14:42:07
92f0779172a9e11663794ffa3a3493445cb58190...38462a23b89dd0f2beda2deea6762fd1b1409409,3,12,15,27,11,2010-08-26 15:03:31,2010-08-26 15:03:31
38462a23b89dd0f2beda2deea6762fd1b1409409...36566550f047d0aebbf94e1e2263f36871794a99,1,6,5,11,2,2010-08-26 15:59:30,2010-08-26 15:59:30
36566550f047d0aebbf94e1e2263f36871794a99...ed718fdf5d86b72ec3e87c40071bb1660b7b8513,1,2,1,3,2,2010-08-26 16:02:56,2010-08-26 16:02:56
ed718fdf5d86b72ec3e87c40071bb1660b7b8513...c9f6f7b02eb420036e003d1115276b602636af82,3,14,12,26,10,2010-08-26 16:11:47,2010-08-26 16:11:47
87ac860b31b0614edf8bd1dfd407145fbe75aa13...c7417ff16ccfaffe40564c16973bb30c7b054cd0,2,11,5,16,5,2010-09-13 12:29:18,2010-09-13 12:29:18
c7417ff16ccfaffe40564c16973bb30c7b054cd0...d48a16161eac5f462e4e0b453dc9bdd9c5683070,2,11,3,14,3,2010-09-13 12:31:28,2010-09-13 12:31:28
87ac860b31b0614edf8bd1dfd407145fbe75aa13...620b4c98055c30546773c3c2d213f9a88f6849a1,1,2,2,4,3,2010-09-12 15:09:11,2010-09-12 15:09:11
620b4c98055c30546773c3c2d213f9a88f6849a1...227acd8528b23a6cd4fcf3fe3943872f418ed51f,2,10,15,25,10,2010-09-12 16:03:50,2010-09-12 16:03:50
227acd8528b23a6cd4fcf3fe3943872f418ed51f...f70b0594a55a794de26f12a493ac276fd9e576a1,3,8,8,16,4,2010-09-12 17:01:05,2010-09-12 17:01:05
c9f6f7b02eb420036e003d1115276b602636af82...6d694cef86ade1e9a8aaa97528a99f2243d8378d,3,14,20,34,15,2010-08-26 16:18:03,2010-08-26 16:18:03
c9f6f7b02eb420036e003d1115276b602636af82...4b6447bdcb5c1934c15925c8e7212597de5bcb04,1,3,3,6,3,2010-08-26 16:16:22,2010-08-26 16:16:10
7709c273590194d14bdeb5f903537224b3f0d81e...161ab16e36e5dc3efa3dc478841de7fa3f83d405,1,1,1,2,1,2010-09-13 12:33:01,2010-09-13 12:33:01
161ab16e36e5dc3efa3dc478841de7fa3f83d405...323543df3663689d02047c171cdda04977c55e38,2,1,2,3,2,2010-09-13 13:02:33,2010-09-13 13:02:33
323543df3663689d02047c171cdda04977c55e38...59b346006959b93c9d5ef75c4d52e29d0cd65780,1,1,1,2,1,2010-09-13 14:16:20,2010-09-13 14:16:20
59b346006959b93c9d5ef75c4d52e29d0cd65780...0b0247d5188c99e70f8939aaeb563d0f52ef6597,1,18,5,23,5,2010-09-13 14:27:11,2010-09-13 14:27:11
0b0247d5188c99e70f8939aaeb563d0f52ef6597...f412a116af8f1082e83c95d2dda65038c5a4e966,3,12,16,28,9,2010-09-13 15:35:14,2010-09-13 15:35:14
f412a116af8f1082e83c95d2dda65038c5a4e966...5a4bfedb88fe94ed1a8de5eeeaf0b4985c22b4d8,1,16,6,22,5,2010-09-13 16:50:33,2010-09-13 16:50:33
5a4bfedb88fe94ed1a8de5eeeaf0b4985c22b4d8...e70006635a4335589fefacabcf4838bb665e1950,1,5,6,11,1,2010-09-13 16:51:34,2010-09-13 16:51:34
e70006635a4335589fefacabcf4838bb665e1950...77955627fac376c72012e1700e4e7df51c108fc2,3,32,2,34,7,2010-09-13 17:19:28,2010-09-13 17:19:28
77955627fac376c72012e1700e4e7df51c108fc2...9607ad40ce6b2417ddfe6bfea679f223a854f44d,1,3,7,10,6,2010-09-13 20:05:12,2010-09-13 20:05:12
f70b0594a55a794de26f12a493ac276fd9e576a1...98dcdbe9db360d4c06cf926f80a60f8e108c2ec0,1,1,1,2,1,2010-09-12 20:59:57,2010-09-12 20:59:57
f70b0594a55a794de26f12a493ac276fd9e576a1...e35a30f2b40ee9de42eef3c02e863d42b6b3b824,1,8,11,19,7,2010-09-12 17:18:08,2010-09-12 17:17:44
9366d32461132464083c61da96ada6afaae36d6d...5ce8ea40deccf7a2765142ad4cc38a5749fba724,1,9,2,11,2,2010-08-26 16:34:51,2010-08-26 16:34:51
5ce8ea40deccf7a2765142ad4cc38a5749fba724...e3d6d6da230d725c54dec749fbde327f6bfdb5c9,1,18,11,29,5,2010-08-26 16:37:53,2010-08-26 16:37:53
e3d6d6da230d725c54dec749fbde327f6bfdb5c9...ea6c0c033e5f3abced63651442b18dab0d359c2e,1,8,9,17,4,2010-08-26 16:49:04,2010-08-26 16:49:04
ea6c0c033e5f3abced63651442b18dab0d359c2e...a4dd56477e898dfe796473e605f0aeee42cc2d87,1,14,10,24,3,2010-08-26 17:33:26,2010-08-26 17:33:26
a4dd56477e898dfe796473e605f0aeee42cc2d87...222a8c5589752f6229b53f7294290985dba9deab,2,5,4,9,5,2010-08-26 17:47:27,2010-08-26 17:47:27
222a8c5589752f6229b53f7294290985dba9deab...57c0c6a057d3890c22366e06cd77c8568da30e86,1,3,2,5,3,2010-08-26 17:50:34,2010-08-26 17:50:34
22b2a2988cd158ab13eed6653bc4ac173c3b1204...61cf36b823aa5499d31dfe237a45692b75e5b6fb,1,2,1,3,1,2010-08-26 16:22:23,2010-08-26 16:22:23
9607ad40ce6b2417ddfe6bfea679f223a854f44d...ffd42e6a1ce476c453f566929a9aa92485ba5aa5,3,12,7,19,6,2010-09-13 21:16:42,2010-09-13 21:16:42
9607ad40ce6b2417ddfe6bfea679f223a854f44d...b70150a83b92b44e56392c6255347e186d64fdb2,1,8,2,10,6,2010-09-13 20:35:33,2010-09-13 20:34:51
a964a29aa1b98d65cab52e3dfaf7b3e3cac5928e...61efd254b0ec1079bcb197dde736c0a138216849,1,2,2,4,2,2010-09-12 21:51:38,2010-09-12 17:41:03
61efd254b0ec1079bcb197dde736c0a138216849...41ccdb7ca15939623a7bf6a71f67f955cd5ef66d,1,1,1,2,1,2010-09-12 21:51:38,2010-09-12 17:41:21
41ccdb7ca15939623a7bf6a71f67f955cd5ef66d...e172d7d74fd5c5872d77ff18b48f693c2b2cf3d9,1,7,8,15,4,2010-09-12 21:51:39,2010-09-12 18:17:01
e172d7d74fd5c5872d77ff18b48f693c2b2cf3d9...34e04d266b6f69ba893da07ce843a3933cf57081,2,20,12,32,3,2010-09-12 21:51:39,2010-09-12 18:22:27
34e04d266b6f69ba893da07ce843a3933cf57081...b409a59980822f16543deed8be615aa8b7cc9821,2,5,5,10,5,2010-09-12 21:51:39,2010-09-12 21:51:09
b409a59980822f16543deed8be615aa8b7cc9821...2418da510eaf2fc5d1661ba816942086dfc9090e,3,54,18,72,12,2010-09-12 22:23:27,2010-09-12 22:23:27
2418da510eaf2fc5d1661ba816942086dfc9090e...3cb246e5737ef785c80828f921023dffe179e7a8,2,44,0,44,4,2010-09-13 04:34:31,2010-09-13 04:34:31
3cb246e5737ef785c80828f921023dffe179e7a8...47f19103ac122f1491b18746ca7131759ae5980a,2,12,3,15,3,2010-09-13 04:51:54,2010-09-13 04:51:54
47f19103ac122f1491b18746ca7131759ae5980a...dd1a25d458f723b241c1af54f236afdfb4e454c2,2,57,33,90,9,2010-09-13 05:21:20,2010-09-13 05:21:20
dd1a25d458f723b241c1af54f236afdfb4e454c2...370af4c9aa4a47459f73641c76f46cf62dbae8e3,1,2,5,7,3,2010-09-13 05:24:36,2010-09-13 05:24:36
370af4c9aa4a47459f73641c76f46cf62dbae8e3...22f5633e2d45c0deca7a99812bf7f8f5a4a7d9ac,2,74,41,115,12,2010-09-13 05:40:29,2010-09-13 05:40:29
22f5633e2d45c0deca7a99812bf7f8f5a4a7d9ac...03a596e18b839a452b935141c329e4a1a6fa9b9f,2,42,13,55,11,2010-09-13 05:50:05,2010-09-13 05:50:05
57c0c6a057d3890c22366e06cd77c8568da30e86...d6e2576ef79d81c0689c038b4f377fbbb00a1cc1,1,1,1,2,1,2010-08-26 17:56:55,2010-08-26 17:56:55
57c0c6a057d3890c22366e06cd77c8568da30e86...003041031a8a05d83c65f58e66773f3bd32e4863,2,25,8,33,3,2010-08-26 17:54:10,2010-08-26 17:53:54
c68227521db649b37b231b9c2023444e88c0ebfb...e47687bd03132c4c526ff61754eb8634fd9661a1,2,17,3,20,6,2010-09-13 21:23:13,2010-09-13 21:22:54
e47687bd03132c4c526ff61754eb8634fd9661a1...2a2586a226d4b1c26937dfa811f864df4954a390,1,1,1,2,1,2010-09-13 21:28:20,2010-09-13 19:07:36
2a2586a226d4b1c26937dfa811f864df4954a390...edfd50c611d0918de6d7bedc03db50ab6cb4fdc7,1,0,10,10,1,2010-09-13 21:28:20,2010-09-13 19:07:38
edfd50c611d0918de6d7bedc03db50ab6cb4fdc7...a50ff726212360718dc812bab297c5eef31ba487,6,1,30,31,8,2010-09-13 21:28:20,2010-09-13 19:07:40
a50ff726212360718dc812bab297c5eef31ba487...9324ba3b770d247082f96a8248c5125f9bfca6de,9,75,71,146,20,2010-09-13 21:28:20,2010-09-13 19:09:55
9324ba3b770d247082f96a8248c5125f9bfca6de...e481f0f5d14f7743474e5c3c0a29d236f8db8e6c,1,6,37,43,5,2010-09-13 21:28:20,2010-09-13 19:10:12
e481f0f5d14f7743474e5c3c0a29d236f8db8e6c...86f511ead098c9d8512a61b70dad906a9a864779,1,100,2,102,5,2010-09-13 22:43:56,2010-09-13 21:27:53
86f511ead098c9d8512a61b70dad906a9a864779...4fada3fc467c47bb3766ea694d1796d46929b7cb,1,9,0,9,2,2010-09-13 23:13:32,2010-09-13 23:13:32
4fada3fc467c47bb3766ea694d1796d46929b7cb...9a59b1642dfcb6e4cafac2f16445eb0ba4ee5fd4,2,12,1,13,2,2010-09-14 04:00:20,2010-09-14 01:45:13
9a59b1642dfcb6e4cafac2f16445eb0ba4ee5fd4...d983964bf103bb7c1ebae3743aed8621e7c0aedd,3,15,1,16,5,2010-09-14 04:00:20,2010-09-14 03:10:27
d983964bf103bb7c1ebae3743aed8621e7c0aedd...8b6e19c98e597469bc85d09a22c84a53682126b3,1,2,1,3,1,2010-09-14 14:06:06,2010-09-14 14:05:52
8b6e19c98e597469bc85d09a22c84a53682126b3...a53ff9a810e2d6162c7e801bb7a3b8a845813e54,3,17,17,34,11,2010-09-14 14:06:06,2010-09-14 14:05:58
a53ff9a810e2d6162c7e801bb7a3b8a845813e54...c83aa636114e0bf2e3ca796b2bac601cdbcb63d8,1,12,3,15,7,2010-09-14 14:18:04,2010-09-14 14:18:04
c83aa636114e0bf2e3ca796b2bac601cdbcb63d8...0e41d66fe2555d7c715cb629c51726d9f692289e,1,7,20,27,10,2010-09-14 14:24:35,2010-09-08 20:11:53
0e41d66fe2555d7c715cb629c51726d9f692289e...863ca9f6971e7154b84bb239e6a22be927e1baac,1,1,1,2,1,2010-09-14 14:24:35,2010-09-08 20:32:03
863ca9f6971e7154b84bb239e6a22be927e1baac...2b2e185ed32753522aa3dce3f18e7cb2303912d2,1,1,1,2,1,2010-09-14 14:24:35,2010-09-14 14:24:30
2b2e185ed32753522aa3dce3f18e7cb2303912d2...ceb1bc7f04724a3b006301736f985293ba773011,1,1,3,4,2,2010-09-14 15:07:23,2010-09-14 14:38:48
ceb1bc7f04724a3b006301736f985293ba773011...7944c002f87b233ce30a9badc9752b093c30ad7c,1,16,11,27,4,2010-09-14 15:07:23,2010-09-14 15:06:54
7944c002f87b233ce30a9badc9752b093c30ad7c...524e633748a24b5a1e753373ba63e5c267964576,2,15,6,21,9,2010-09-14 15:07:24,2010-09-14 15:07:09
524e633748a24b5a1e753373ba63e5c267964576...af62d45cf739abd8947c18dba497fef6a2863d1c,1,2,0,2,2,2010-09-14 16:18:27,2010-09-14 16:18:27
af62d45cf739abd8947c18dba497fef6a2863d1c...c4f9d7d67d79a82113b419cfc52bc6534649717c,3,221,0,221,3,2010-09-14 16:25:54,2010-09-14 16:25:54
c4f9d7d67d79a82113b419cfc52bc6534649717c...71cc035f6013595e80f51b7194aec3739537c4b4,2,67,58,125,8,2010-09-14 16:48:18,2010-09-14 16:48:18
ca17d8fced6c82fa356d85a0acbfba28f4c69e82...9aac39189e67a0abcb84a2c311c981f435c3ffbd,1,30,0,30,7,2010-08-26 19:08:26,2010-08-26 19:08:26
9aac39189e67a0abcb84a2c311c981f435c3ffbd...135549ec78e6b7f01c50aacca080d75af9df5b12,2,98,8,106,4,2010-08-26 19:26:26,2010-08-26 19:17:41
135549ec78e6b7f01c50aacca080d75af9df5b12...7bbe2939e91337615999ac9cba003158629bc6e8,3,26,13,39,11,2010-08-26 19:55:38,2010-08-26 19:55:24
7bbe2939e91337615999ac9cba003158629bc6e8...306b9cbaa7fe5ff59e1deb3c28c96d4b55ecc58b,2,119,119,238,76,2010-08-26 20:01:46,2010-08-26 18:33:41
306b9cbaa7fe5ff59e1deb3c28c96d4b55ecc58b...7012f9a6ff22c9c466933ce67a4a140782e1da38,2,30,22,52,21,2010-08-26 20:01:46,2010-08-26 20:01:24
7012f9a6ff22c9c466933ce67a4a140782e1da38...18daedd25c03ffb042ccae9075d7d8fe939bb01e,2,30,9,39,9,2010-08-26 20:06:26,2010-08-26 20:06:26
18daedd25c03ffb042ccae9075d7d8fe939bb01e...47114280a49ac50ad4afa3ab942ad28722036da9,1,28,0,28,1,2010-08-26 20:31:29,2010-08-26 20:30:10
47114280a49ac50ad4afa3ab942ad28722036da9...1001ea17774f8a0471b1fa6fe72e39d1d925bd72,1,17,31,48,3,2010-08-26 20:34:07,2010-08-26 20:34:00
1001ea17774f8a0471b1fa6fe72e39d1d925bd72...b5495c7d825b3be18ebe642aea944a27b28cd446,1,1,0,1,1,2010-08-26 20:35:42,2010-08-26 20:34:30
b5495c7d825b3be18ebe642aea944a27b28cd446...aed53aef9960d7238d5f801f33c4939634936c15,1,1,1,2,1,2010-08-26 21:23:48,2010-08-26 21:17:05
aed53aef9960d7238d5f801f33c4939634936c15...585718e60f8d4156d1c0d346bdcd62c941f03010,2,101,67,168,14,2010-08-26 21:23:48,2010-08-26 21:23:34
585718e60f8d4156d1c0d346bdcd62c941f03010...553c778780348543d75c1884e71dbdba9dce7b1e,2,10,14,24,8,2010-08-26 21:31:23,2010-08-26 21:31:23
553c778780348543d75c1884e71dbdba9dce7b1e...c29e819207d21457cffa9969697b968736953d50,1,1,1,2,1,2010-08-26 21:44:55,2010-08-26 21:44:55
c29e819207d21457cffa9969697b968736953d50...86f42e62f1de65cc7cea09faf6fea0c5fc9fb672,1,2,3,5,2,2010-08-26 21:45:46,2010-08-26 21:45:46
86f42e62f1de65cc7cea09faf6fea0c5fc9fb672...dae8c2de8b94a042baa7439674643d4850864b3c,1,5,3,8,1,2010-08-26 21:51:18,2010-08-26 21:51:18
dae8c2de8b94a042baa7439674643d4850864b3c...c59b38288f03ab75e67a7f8158ac5a78b5650ca6,2,20,1,21,2,2010-08-26 22:26:47,2010-08-26 22:24:57
c59b38288f03ab75e67a7f8158ac5a78b5650ca6...b8efa65bfcd373a400dd6f6d5c6489ebd626dfe5,4,6,8,14,8,2010-08-27 01:09:51,2010-08-27 01:09:51
b8efa65bfcd373a400dd6f6d5c6489ebd626dfe5...246cc9851e2c5d1b0b5528ab1dc97bf47857f2ce,2,0,4,4,2,2010-08-27 01:12:53,2010-08-27 01:12:53
246cc9851e2c5d1b0b5528ab1dc97bf47857f2ce...f248d531773b12f057a0d3d7a8a7492475f938fb,2,14,7,21,8,2010-08-27 02:10:13,2010-08-27 02:10:13
f248d531773b12f057a0d3d7a8a7492475f938fb...948b3ad552579f4dfaae50c30d89bad71766f8d0,2,7,0,7,2,2010-08-27 03:51:03,2010-08-27 03:51:03
71cc035f6013595e80f51b7194aec3739537c4b4...6e38892903746119ee4cc640f01f8bead056a811,3,20,7,27,5,2010-09-14 19:38:14,2010-09-14 19:38:14
6e38892903746119ee4cc640f01f8bead056a811...3e2a6590b2a8e5b4db384996c92f1eda0f338bf9,3,137,0,137,3,2010-09-14 19:38:46,2010-09-14 19:38:46
71cc035f6013595e80f51b7194aec3739537c4b4...a1dd86846687c75020b44f30d95fbd70234db6f6,1,63,0,63,1,2010-09-14 17:03:58,2010-09-14 17:03:58
a1dd86846687c75020b44f30d95fbd70234db6f6...b97c1d90c17b1f92ecc888420b227a9b39cb2697,2,33,38,71,15,2010-09-14 18:11:15,2010-09-14 18:11:15
b97c1d90c17b1f92ecc888420b227a9b39cb2697...3cd49a8b0fac89c9d006ca86025cc6e2ac915bb9,2,2,2,4,2,2010-09-14 18:59:13,2010-09-14 18:03:52
948b3ad552579f4dfaae50c30d89bad71766f8d0...3c0f8b9ff3e263b6a6495952b443251e9ddb0cef,3,15,12,27,14,2010-08-27 17:53:55,2010-08-27 17:53:55
948b3ad552579f4dfaae50c30d89bad71766f8d0...862b77d3dea038d9461b2d70d4ca2478dd2707dd,1,1,1,2,1,2010-08-27 14:44:23,2010-08-27 14:44:23
862b77d3dea038d9461b2d70d4ca2478dd2707dd...0206ce9041d5cbba2cd6ffec210356043747d404,2,32,12,44,7,2010-08-27 15:48:16,2010-08-27 15:48:16
0206ce9041d5cbba2cd6ffec210356043747d404...4d200a752d333c1e9b1fffafd04d1d79cd08ea71,2,23,0,23,3,2010-08-27 16:07:22,2010-08-27 16:07:06
b468961b76495b70d7b1a6d5be6a69362206f482...27ff50615e00d8b781d499a8934df5a6be889c23,1,11,0,11,2,2010-09-14 19:51:23,2010-09-14 19:51:23
e4ce03e8eef5ba334b181573de50a4b50b46944d...b08b0b6e9f949e566b0d4271f70474223aab6761,1,3,2,5,2,2010-08-27 18:39:28,2010-08-27 18:39:28
b08b0b6e9f949e566b0d4271f70474223aab6761...449fbabe26b62250b4974aaec2633cb591e36f28,1,2,1,3,1,2010-08-27 19:00:25,2010-08-27 19:00:00
449fbabe26b62250b4974aaec2633cb591e36f28...f7932bcc15fce8bba17b20c33ce2e00278320be6,2,60,5,65,9,2010-08-27 19:25:36,2010-08-27 19:25:21
27ff50615e00d8b781d499a8934df5a6be889c23...0c6d1a34c1024fd8396ac7b71f8fa8a379a89eeb,1,5,0,5,1,2010-09-14 20:48:31,2010-09-14 20:48:31
27ff50615e00d8b781d499a8934df5a6be889c23...36e14406ef837f95defd92f4df68706960a2479c,1,3,1,4,1,2010-09-14 20:23:00,2010-09-14 19:50:07
36e14406ef837f95defd92f4df68706960a2479c...8e5e584be426cfb5a6e8bebd5483bbaae4cf834d,1,5,8,13,4,2010-09-14 20:23:00,2010-09-14 19:55:41
8e5e584be426cfb5a6e8bebd5483bbaae4cf834d...3326c8e257dc493581c6faccdc25280535ae7342,1,0,2,2,1,2010-09-14 20:23:00,2010-09-14 20:01:09
3326c8e257dc493581c6faccdc25280535ae7342...92eae23284fc4bfa2c648a6b603b16e37a4f635d,1,5,3,8,3,2010-09-14 20:42:27,2010-09-14 20:42:27
f7932bcc15fce8bba17b20c33ce2e00278320be6...b56b1850b55c5b7c7d4a633f0e84fb203d4b3712,1,1,0,1,1,2010-08-27 20:39:43,2010-08-27 20:39:43
b56b1850b55c5b7c7d4a633f0e84fb203d4b3712...8cecc5386966c8bfb239cebe3d4fd61f3dd1826f,1,4,0,4,1,2010-08-27 20:43:26,2010-08-27 20:43:26
f7932bcc15fce8bba17b20c33ce2e00278320be6...f0234a1fbb1d024a6e05615791aa0fa47c0f8ca7,3,14,6,20,7,2010-08-27 20:38:56,2010-08-27 20:38:56
5361ed8b1d7cbfec0044a7f9f3e8c25ffcd6977a...57c2cf9b0138e2a6e1f5a51506778b2822deadce,6,207,119,326,130,2010-09-14 21:30:18,2010-09-14 21:29:58
57c2cf9b0138e2a6e1f5a51506778b2822deadce...3db3cb13dc1c522db8b59745d6c74b0967f1611c,3,183,1,184,5,2010-09-14 22:53:21,2010-09-14 22:53:09
3db3cb13dc1c522db8b59745d6c74b0967f1611c...8c82a9c5c62966093acd4e2a29572fa48fef707b,7,89,13,102,20,2010-09-15 00:01:01,2010-09-15 00:00:46
8c82a9c5c62966093acd4e2a29572fa48fef707b...8d53011001891a36d5f7abf6b5c2117bda5be889,2,1,10,11,4,2010-09-15 01:51:13,2010-09-15 01:51:13
8d53011001891a36d5f7abf6b5c2117bda5be889...165b3d70fd5e2d780454f0b39d8e61530df979bb,1,2,0,2,1,2010-09-15 19:38:55,2010-09-15 19:38:55
165b3d70fd5e2d780454f0b39d8e61530df979bb...9495380f77a88cb050024d1bc0e2b660d433b577,1,8,0,8,2,2010-09-15 20:56:16,2010-09-15 20:56:16
9495380f77a88cb050024d1bc0e2b660d433b577...87d78a3ac45f38cc0b512b0c49d4cce6f9102a10,1,1,1,2,1,2010-09-15 21:17:57,2010-09-15 21:17:57
87d78a3ac45f38cc0b512b0c49d4cce6f9102a10...85cdf5bfed44e1119b91a3e95a3f7b13c77fad0a,1,15,1,16,2,2010-09-16 02:04:39,2010-09-16 02:04:39
7b849bd6c6f5152993647cb816525669e19ec6eb...805346d1e1ad7c8c041cf87450170e8ed4cc895c,1,1,1,2,1,2010-08-27 21:33:08,2010-08-27 21:33:08
805346d1e1ad7c8c041cf87450170e8ed4cc895c...76751df6b5a7893b08b551fcedec6626fc734574,4,57,32,89,17,2010-08-27 22:48:22,2010-08-27 22:48:22
76751df6b5a7893b08b551fcedec6626fc734574...994836639ea1ebbba64cdee477e366280557a17a,2,48,9,57,7,2010-08-28 00:23:38,2010-08-28 00:23:38
994836639ea1ebbba64cdee477e366280557a17a...8328a485bf6e0f2ff636a0d4b8c0f6f2626faab4,1,1,1,2,1,2010-08-28 00:38:49,2010-08-28 00:38:49
8328a485bf6e0f2ff636a0d4b8c0f6f2626faab4...189291f8a6fdc948ed241890a3ce04108b52bd3c,1,7,0,7,1,2010-08-28 06:19:06,2010-08-28 06:19:06
189291f8a6fdc948ed241890a3ce04108b52bd3c...09facd3ff5dd24a09d65a598f74e598f8457faa7,1,14,0,14,1,2010-08-28 16:31:26,2010-08-28 16:31:26
09facd3ff5dd24a09d65a598f74e598f8457faa7...e8eae32094eb3463fa63e93989ca0584c31c8471,1,3,3,6,2,2010-08-28 22:08:43,2010-08-28 22:08:43
e8eae32094eb3463fa63e93989ca0584c31c8471...f382ca50d435a77ea22b637bd8d4e35bdbb68312,1,1,0,1,1,2010-08-28 22:25:06,2010-08-28 22:25:06
f382ca50d435a77ea22b637bd8d4e35bdbb68312...8585f0d9f6b336b978483a686845544e6f3d989c,1,9,4,13,1,2010-08-28 22:27:34,2010-08-28 22:27:34
8585f0d9f6b336b978483a686845544e6f3d989c...8864cfafffefdb73c2cc317c42a458cf347e5b07,2,60,57,117,3,2010-08-28 22:27:50,2010-08-28 22:27:50
8864cfafffefdb73c2cc317c42a458cf347e5b07...b42dd5c67e9d9e86b0a62736fb8fda324a1d1806,4,31,26,57,13,2010-08-29 04:27:59,2010-08-29 04:20:19
b42dd5c67e9d9e86b0a62736fb8fda324a1d1806...9d93038c8e364ef9950734edd59dac7e88adb455,2,36,1,37,4,2010-08-29 04:37:20,2010-08-29 04:37:20
9d93038c8e364ef9950734edd59dac7e88adb455...b23b4cadd3af87ce64a3e99ae5d6d4c41ec00bd0,4,14,10,24,10,2010-08-29 18:54:33,2010-08-29 18:54:33
b23b4cadd3af87ce64a3e99ae5d6d4c41ec00bd0...3701f69ddf093fa9b1e8a20d10b414f29b166e8b,3,114,5,119,9,2010-08-29 20:03:17,2010-08-29 20:03:17
3701f69ddf093fa9b1e8a20d10b414f29b166e8b...0a780284ffc30b115211c2ee0ef945a33f63eca1,1,8,2,10,1,2010-08-30 01:20:54,2010-08-30 01:20:54
0a780284ffc30b115211c2ee0ef945a33f63eca1...a5818c40a75add9239115505fe35cda9d202888f,2,1,2,3,2,2010-08-30 01:24:15,2010-08-30 01:24:15
a5818c40a75add9239115505fe35cda9d202888f...47fcae0af0d1288ad0e398ff03962a0b2278b190,1,53,53,106,1,2010-08-30 01:27:59,2010-08-30 01:27:59
47fcae0af0d1288ad0e398ff03962a0b2278b190...a08d9422aae2592172a1f1286ec0590d9ca44d64,3,23,11,34,5,2010-08-30 02:17:22,2010-08-30 02:17:22
a08d9422aae2592172a1f1286ec0590d9ca44d64...c1f6628ac1e93820665a0fe1a9c873d820b80bc9,1,1,1,2,1,2010-08-30 03:54:48,2010-08-30 03:54:48
c1f6628ac1e93820665a0fe1a9c873d820b80bc9...49333a5f56ca1a02b7da9a7fdac9fceacc0eedda,1,5,2,7,1,2010-08-30 04:14:03,2010-08-30 04:14:03
49333a5f56ca1a02b7da9a7fdac9fceacc0eedda...b604f18d96ebcc62a3b04bf308fa0abef9b480d9,1,8,2,10,1,2010-08-30 04:16:39,2010-08-30 04:16:39
85cdf5bfed44e1119b91a3e95a3f7b13c77fad0a...24746abcc235cc9ce4d18c07633834df255e5929,1,2,2,4,2,2010-09-16 13:43:26,2010-09-16 13:43:26
85cdf5bfed44e1119b91a3e95a3f7b13c77fad0a...5f7500bf01d04732cd83d76a8852baaf98d185c5,17,243,163,406,24,2010-09-16 13:18:46,2010-09-16 13:18:46
5f7500bf01d04732cd83d76a8852baaf98d185c5...25095b1a330533637844039464582f6369fd4b1d,1,1,0,1,1,2010-09-16 13:35:22,2010-09-16 13:35:22
b604f18d96ebcc62a3b04bf308fa0abef9b480d9...b3118b904fc48efdba5f354394bb57fc505661f7,4,17,11,28,11,2010-08-31 04:20:31,2010-08-31 04:20:31
b3118b904fc48efdba5f354394bb57fc505661f7...f85097753008215cf7f67e4c7f4f9631ada69e8f,1,42,28,70,1,2010-08-31 08:23:10,2010-08-31 08:23:10
f85097753008215cf7f67e4c7f4f9631ada69e8f...36fa015ac97476f5e48f49c2f1b7e52f01c624f4,1,2,2,4,1,2010-08-31 08:29:48,2010-08-31 08:29:48
36fa015ac97476f5e48f49c2f1b7e52f01c624f4...6c28ed10cac1225b9ad4e001a51256ddc847b35f,1,5,3,8,1,2010-08-31 08:30:08,2010-08-31 08:30:08
6c28ed10cac1225b9ad4e001a51256ddc847b35f...7358999b68cb8bac3d5f92c22d8e729679ea4167,1,211,205,416,7,2010-08-31 07:02:59,2010-08-31 07:02:59
7358999b68cb8bac3d5f92c22d8e729679ea4167...5ab160eba7c3371558fa4bae7e45fc228ac56feb,1,1,1,2,1,2010-08-31 07:03:09,2010-08-31 07:03:09
5ab160eba7c3371558fa4bae7e45fc228ac56feb...d5cc6edf4f4edcc1d368973426796bb612d0b593,2,4,3,7,3,2010-08-31 09:06:53,2010-08-31 09:06:53
b604f18d96ebcc62a3b04bf308fa0abef9b480d9...cf5470b58e34f79542a3788de82be5f46e2f4aa8,1,5,0,5,1,2010-08-30 14:20:12,2010-08-30 14:20:02
bb9e90d97abacdc6d9e7c4b03e510434563057ca...61bd48da535ecd20e3b37c8bb18e64d790c8571d,1,1,1,2,1,2010-09-22 06:38:16,2010-09-22 06:38:16
bb9e90d97abacdc6d9e7c4b03e510434563057ca...d55c4af16108788e056ce2cd17360426d7820626,4,93,27,120,30,2010-09-16 22:21:59,2010-09-16 22:21:59
bb9e90d97abacdc6d9e7c4b03e510434563057ca...f20a9cd291936ebfaf9df2aea2a52a78c57f432a,1,7,2,9,2,2010-09-16 15:22:12,2010-09-16 15:22:12
f20a9cd291936ebfaf9df2aea2a52a78c57f432a...1c778d93edb541dad7a0c4100a04393446feb7e4,5,98,21,119,32,2010-09-16 20:57:08,2010-09-16 20:57:08
1c778d93edb541dad7a0c4100a04393446feb7e4...bf65cab0f86b794e948a991a7636dcd2f47021bd,1,1,0,1,1,2010-09-16 21:13:58,2010-09-16 21:13:58
cf5470b58e34f79542a3788de82be5f46e2f4aa8...494530e5d279ef3091ae8c110b0df368688458d1,2,35,22,57,8,2010-08-30 14:56:17,2010-08-30 14:56:17
cf5470b58e34f79542a3788de82be5f46e2f4aa8...7550b02cecc503351456e171c0ff0e2d2e7ad97e,1,7,3,10,5,2010-08-30 14:26:33,2010-08-30 14:26:20
9183168f8c0d15357e4d247f0686f5a2bebb561b...3f41bf1c714177601e7bc4e4a9067704d79a41dd,4,112,44,156,15,2010-09-22 15:16:44,2010-09-22 15:16:44
3f41bf1c714177601e7bc4e4a9067704d79a41dd...0f3b16781c364533e58c4018348766c2e69b0a64,4,10,1,11,6,2010-09-22 15:58:55,2010-09-22 15:58:55
0f3b16781c364533e58c4018348766c2e69b0a64...91e52c41d81f6be3f6d6ba79c34b82769cf9fa76,2,8,7,15,6,2010-09-22 15:56:57,2010-09-22 15:54:46
91e52c41d81f6be3f6d6ba79c34b82769cf9fa76...34d3220b6c22186182df2012aad48ed1d5774702,1,52,0,52,1,2010-09-22 15:56:57,2010-09-22 15:56:42
34d3220b6c22186182df2012aad48ed1d5774702...4f5c998561f208b11334cc8b3c61cb1ca36a63de,1,4,1,5,2,2010-09-22 18:21:53,2010-09-22 16:38:14
4f5c998561f208b11334cc8b3c61cb1ca36a63de...8a29068d1c67eeb607af57f26c5909a3dd8fb5af,1,60,1,61,2,2010-09-22 18:21:53,2010-09-22 18:21:01
7043dd9ec5e2952c3bb71fdde8616859e4a4bd0c...de7b12520be8be985b3e495e9172854e73fc2ea7,1,1,1,2,1,2010-09-17 05:25:33,2010-09-17 05:25:33
de7b12520be8be985b3e495e9172854e73fc2ea7...662ffe1dcd2aa6ff67542a32d5ecfb79ec6851b2,2,67,0,67,2,2010-09-17 12:40:57,2010-09-17 12:40:57
662ffe1dcd2aa6ff67542a32d5ecfb79ec6851b2...ec4fbd6c657bc4974afecbded22a62caeb2d8d63,1,0,0,0,0,2010-09-17 14:01:55,2010-09-17 14:01:55
ec4fbd6c657bc4974afecbded22a62caeb2d8d63...690804eeb24e6a42cd1385820ed754d48edbca1c,2,0,0,0,0,2010-09-17 14:08:22,2010-09-17 14:08:22
690804eeb24e6a42cd1385820ed754d48edbca1c...d78667f289c6a336b100b629b3feb126d6954d90,1,4,0,4,4,2010-09-17 15:16:32,2010-09-17 15:16:32
d78667f289c6a336b100b629b3feb126d6954d90...9783a7fd3da8659a05f3aa7060a8470002f1f096,1,1,1,2,1,2010-09-17 15:46:59,2010-09-17 15:46:59
d3a929bf1e75aec781e8d52db85c6cfd0ec078b4...ea07af3968b4f6f48fa7c28660ab9fc0fbb34b2d,1,1,1,2,1,2010-08-30 16:36:39,2010-08-30 16:36:39
d3a929bf1e75aec781e8d52db85c6cfd0ec078b4...29596f5f9681595b515469c8bc5a2d8bc8d8c0f5,1,1,6,7,3,2010-08-30 15:22:34,2010-08-30 15:22:34
29596f5f9681595b515469c8bc5a2d8bc8d8c0f5...2eb1ac7c193e7c0f1234f1facb732b199d5fc037,2,10,1,11,3,2010-08-30 15:30:06,2010-08-30 15:30:06
2eb1ac7c193e7c0f1234f1facb732b199d5fc037...28d16fc227fa5dca94a6ba7d4af901dd30c23d83,2,12,14,26,8,2010-08-30 15:50:18,2010-08-30 15:50:18
8a29068d1c67eeb607af57f26c5909a3dd8fb5af...d1c483349f337dc6f94ff595845f4c0160794056,1,2,1,3,1,2010-09-22 21:46:15,2010-09-22 21:46:15
8a29068d1c67eeb607af57f26c5909a3dd8fb5af...a6555c8c3643bfeac9cd9d54e73a8be8a459263e,2,29,0,29,3,2010-09-22 18:56:55,2010-09-22 18:55:57
a6555c8c3643bfeac9cd9d54e73a8be8a459263e...ac505f9786327487ff7a7c78133f03bdc4e60a2c,4,197,43,240,16,2010-09-22 18:56:55,2010-09-22 18:56:10
ac505f9786327487ff7a7c78133f03bdc4e60a2c...cef1820140c2e52292f6a7f0d7c1e47ff721a059,1,2,1,3,1,2010-09-22 21:27:07,2010-09-22 21:25:49
cef1820140c2e52292f6a7f0d7c1e47ff721a059...461aa87d0cf278da8017d79e0c56a97b44d251cf,1,6,1,7,1,2010-09-22 21:37:22,2010-09-22 21:37:22
9783a7fd3da8659a05f3aa7060a8470002f1f096...caf9a5fda2cb67a6d632895f47607ae459355238,1,1,0,1,1,2010-09-17 19:03:11,2010-09-17 19:03:11
caf9a5fda2cb67a6d632895f47607ae459355238...27de55b448ceb0a31216f84863013d57a5eabb99,6,12,0,12,6,2010-09-17 19:03:22,2010-09-17 19:03:22
9783a7fd3da8659a05f3aa7060a8470002f1f096...6775d994775c3200904b72922785f2f492b2c56c,1,1,0,1,1,2010-09-17 15:55:41,2010-09-17 15:55:41
6775d994775c3200904b72922785f2f492b2c56c...79387b7ac82bcbe825892a069e1452e2ab22fef5,1,3,0,3,1,2010-09-17 15:55:51,2010-09-17 15:55:51
79387b7ac82bcbe825892a069e1452e2ab22fef5...684f67d21f8fd5e9eb12b39467367115cd45a97b,1,3,3,6,2,2010-09-17 16:18:50,2010-09-17 16:18:50
684f67d21f8fd5e9eb12b39467367115cd45a97b...8847592479d4b3cb925d395c833458d2731396b9,3,9,0,9,3,2010-09-17 17:35:31,2010-09-17 17:34:43
8847592479d4b3cb925d395c833458d2731396b9...eeefefccfb86f84044934750605706f997a9378f,1,1,0,1,1,2010-09-17 18:35:37,2010-09-17 18:35:37
eeefefccfb86f84044934750605706f997a9378f...6f95b432442c379c94a236c59fdd8c88788d922b,1,9,2,11,3,2010-09-17 19:04:18,2010-09-17 19:04:18
2136d1e970a2540463643d524b19b4d2f85be95f...e82816917dbccc3d4a99ecaa62f19eb50c8c6e59,1,25,43,68,11,2010-08-30 17:11:28,2010-08-30 17:11:21
e82816917dbccc3d4a99ecaa62f19eb50c8c6e59...1ae2c584dff17fe5b105aec433b55d91044eee74,1,6,13,19,6,2010-08-30 17:34:19,2010-08-30 17:34:19
1ae2c584dff17fe5b105aec433b55d91044eee74...e4752ead1f0c86ec4015c6638d5be90e05ecf7f9,1,10,11,21,2,2010-08-30 20:43:35,2010-08-30 20:43:35
461aa87d0cf278da8017d79e0c56a97b44d251cf...456493083e22b6e1e81f25f57a8962d9716fcf82,3,80,58,138,5,2010-09-22 21:50:50,2010-09-22 20:39:23
456493083e22b6e1e81f25f57a8962d9716fcf82...48723d6e10b0d1fde6d5ad5b1da8c0861690e450,1,30,0,30,3,2010-09-22 21:50:50,2010-09-22 21:50:28
fadfe4682a987aa48025cb721b44a4bca4371dc2...629f3a4c1c9c10ea0d5a1ce74d8b64b85e925f8b,2,8,2,10,5,2010-09-17 20:06:02,2010-09-17 20:06:02
629f3a4c1c9c10ea0d5a1ce74d8b64b85e925f8b...03552dd7df70fcaaadf824686eca74f0773e48b7,1,0,0,0,0,2010-09-17 20:50:32,2010-09-17 20:49:07
03552dd7df70fcaaadf824686eca74f0773e48b7...e1fddece97b6c7c2704c968e6a045e77ea4ae266,1,1,1,2,1,2010-09-17 20:50:32,2010-09-17 20:49:28
e1fddece97b6c7c2704c968e6a045e77ea4ae266...d5bd13f7a64ad717c65cf752f9e3dbbcab9305b4,2,41,2,43,5,2010-09-17 20:50:32,2010-09-17 20:49:53
d5bd13f7a64ad717c65cf752f9e3dbbcab9305b4...f5d055953cfac77e41cd5dc66abba9b1e0b0f0d6,2,13,4,17,8,2010-09-17 21:02:28,2010-09-17 21:02:28
f5d055953cfac77e41cd5dc66abba9b1e0b0f0d6...384693b5948879ee866dd6c13cf3dbe1972b5198,1,1,1,2,1,2010-09-18 02:02:14,2010-09-18 02:02:14
384693b5948879ee866dd6c13cf3dbe1972b5198...54d982725d5ae29608b39905b4c89b4f373d294b,2,15,20,35,7,2010-09-18 03:39:51,2010-09-18 03:39:51
54d982725d5ae29608b39905b4c89b4f373d294b...669870840d9442a3d09188a3630d9030b0dfd867,2,4,0,4,4,2010-09-18 03:48:16,2010-09-18 03:48:16
669870840d9442a3d09188a3630d9030b0dfd867...8180bde25c810a1fec1709417e8f5754362e18a6,1,5,2,7,1,2010-09-19 03:41:47,2010-09-19 03:41:47
8180bde25c810a1fec1709417e8f5754362e18a6...ac0b1d8a7e87ce62deb255f66d90f51f69c57486,1,3,2,5,3,2010-09-19 04:26:35,2010-09-19 04:26:35
ae573df437827c2f9ed35d5c451c59d14de58d63...d97fd357f711e101f6af31152c3e5c368a85db73,1,5,3,8,1,2010-09-22 23:29:58,2010-09-22 22:39:14
d97fd357f711e101f6af31152c3e5c368a85db73...65b31a0ba67a479340e3f5e3ca243dcc932b2b0d,1,4,2,6,1,2010-09-22 23:29:58,2010-09-22 23:22:27
65b31a0ba67a479340e3f5e3ca243dcc932b2b0d...d3d719c3aa72d63fe838f1e5eae7098e3bffe721,1,5,2,7,1,2010-09-23 04:29:07,2010-09-23 04:29:07
d3d719c3aa72d63fe838f1e5eae7098e3bffe721...76910b959305b7b44c943c628c1afd507a019317,1,9,7,16,1,2010-09-23 14:30:27,2010-09-23 14:30:27
76910b959305b7b44c943c628c1afd507a019317...4c51c1bf133c5809585f8b86d9fb78a7a1ec3662,2,3,3,6,4,2010-09-23 18:40:46,2010-09-23 18:38:30
4c51c1bf133c5809585f8b86d9fb78a7a1ec3662...cd96b28f0c9fecbad2d16462a684eec845f29501,1,1,1,2,1,2010-09-23 19:03:02,2010-09-23 19:03:02
cd96b28f0c9fecbad2d16462a684eec845f29501...50ce0e05395c7dabde0008559561e581fb8e9da3,2,16,3,19,6,2010-09-23 20:52:19,2010-09-23 20:52:19
50ce0e05395c7dabde0008559561e581fb8e9da3...c088ca1af8b410248aea7cfdda58c17550215f5e,1,7,5,12,2,2010-09-23 21:00:53,2010-09-23 21:00:53
c088ca1af8b410248aea7cfdda58c17550215f5e...8d77298f6126f950492dffb996c5c25c53a7dd76,2,35,9,44,6,2010-09-23 21:51:01,2010-09-23 21:51:01
8d77298f6126f950492dffb996c5c25c53a7dd76...7f8ea97135b4d7c462cef9ccf3e6475794a9f2a2,2,21,12,33,6,2010-09-23 22:07:45,2010-09-23 22:07:45
7f8ea97135b4d7c462cef9ccf3e6475794a9f2a2...d2249cdf68eef2c954630b9cfd24643d06b4d8be,12,301,80,381,69,2010-09-23 22:42:24,2010-09-23 21:36:04
d2249cdf68eef2c954630b9cfd24643d06b4d8be...5d9149a33ae066d08fb1a46671163bb3f9cad9de,1,1,1,2,1,2010-09-23 22:42:24,2010-09-23 22:25:09
5d9149a33ae066d08fb1a46671163bb3f9cad9de...d2ba8a5579a2f7a1876f315afc42902382458a8e,3,16,14,30,5,2010-09-23 23:08:00,2010-09-23 22:59:01
d2ba8a5579a2f7a1876f315afc42902382458a8e...5c2e25e81c161c8f3b0f5b0df585fb62ac197a5b,1,12,2,14,3,2010-09-23 23:38:07,2010-09-23 23:36:51
5c2e25e81c161c8f3b0f5b0df585fb62ac197a5b...a329d4a4b9e7ca1e7cba8afceca861a67ae90fe9,1,0,14,14,1,2010-09-24 00:22:06,2010-09-24 00:22:06
a329d4a4b9e7ca1e7cba8afceca861a67ae90fe9...13ff47ad1fe7842b8d580df5257e8dc6e80e74cf,1,4,1,5,1,2010-09-24 00:27:51,2010-09-24 00:27:51
13ff47ad1fe7842b8d580df5257e8dc6e80e74cf...b0185b2c680d77e94f09c9ada6c8c4fb87800593,1,2,1,3,1,2010-09-24 00:28:25,2010-09-24 00:28:25
b0185b2c680d77e94f09c9ada6c8c4fb87800593...f3b6f4dd8d90e0c9e10548b5b46dc8f9095282b0,2,8,2,10,4,2010-09-24 04:39:48,2010-09-24 04:39:48
f3b6f4dd8d90e0c9e10548b5b46dc8f9095282b0...507389045b252b7ce16bac661839ead3ba7fb185,1,2,2,4,1,2010-09-24 05:13:24,2010-09-24 05:13:24
507389045b252b7ce16bac661839ead3ba7fb185...bf118721fa2e1ed9fdc9bff5d60c7464ee5f4c5d,1,2,1,3,2,2010-09-24 15:56:11,2010-09-24 15:56:11
bf118721fa2e1ed9fdc9bff5d60c7464ee5f4c5d...829a5e94a7fae2cd3f2a4ff38b7829a70da50f17,1,1,1,2,1,2010-09-24 15:56:28,2010-09-24 15:56:28
829a5e94a7fae2cd3f2a4ff38b7829a70da50f17...f8da5e06860a0d5e0fd7b5637fcc748127cfbcc3,1,38,0,38,1,2010-09-24 19:14:15,2010-09-24 19:14:15
f8da5e06860a0d5e0fd7b5637fcc748127cfbcc3...0d8b5981ff7a3df062cfa5839e292718b61911c2,3,16,3,19,4,2010-09-24 19:40:59,2010-09-24 19:40:59
0d8b5981ff7a3df062cfa5839e292718b61911c2...193fbaf47a67db4602814f2a1f1cb8468b362d90,3,48,8,56,6,2010-09-24 19:57:20,2010-09-24 19:57:20
193fbaf47a67db4602814f2a1f1cb8468b362d90...2735160f15fa448e79e317b1ba6bdba7b8109765,2,19,1,20,4,2010-09-24 20:05:17,2010-09-03 19:59:11
2735160f15fa448e79e317b1ba6bdba7b8109765...d0a3512190764f1d7bfdca741987e7a7fa0128bc,1,5,0,5,2,2010-09-24 20:05:17,2010-09-03 22:41:22
d0a3512190764f1d7bfdca741987e7a7fa0128bc...f5863ea0c40363f2da4bb91c9e1e655f839609f8,3,12,7,19,8,2010-09-24 20:05:17,2010-09-04 01:16:31
f5863ea0c40363f2da4bb91c9e1e655f839609f8...54a0c78fdeb8e48531c3b967b252080a7544700c,1,0,6,6,1,2010-09-24 22:29:21,2010-09-24 22:29:21
ac0b1d8a7e87ce62deb255f66d90f51f69c57486...fe529143dd554fb01ea0401ae88eb5b8700a5627,1,1,2,3,1,2010-09-20 17:15:24,2010-09-20 17:15:24
fe529143dd554fb01ea0401ae88eb5b8700a5627...090d0d09ae94145427a8813ff56c11299b4f065a,1,40,5,45,5,2010-09-20 17:20:25,2010-09-20 17:20:25
090d0d09ae94145427a8813ff56c11299b4f065a...56d8f75f9dcc130b42ec1152c21a0bbb6b69b635,1,4,1,5,2,2010-09-20 17:43:20,2010-09-20 17:43:20
56d8f75f9dcc130b42ec1152c21a0bbb6b69b635...f8897d2e651cc11fb9d67f1a295b60835a6ebc97,1,5,5,10,1,2010-09-20 19:11:43,2010-09-20 19:11:43
f8897d2e651cc11fb9d67f1a295b60835a6ebc97...44a681a83607812a6e063d557f2f9fd245020e19,1,9,9,18,3,2010-09-20 19:35:20,2010-09-20 19:35:20
44a681a83607812a6e063d557f2f9fd245020e19...1a69db26cf28718458ed5c9f4b00f26ea37de48a,1,3,2,5,2,2010-09-20 19:51:39,2010-09-20 19:51:39
1a69db26cf28718458ed5c9f4b00f26ea37de48a...6109b95dc6677073c59183a51da72f596f18697b,1,4,0,4,2,2010-09-20 20:39:53,2010-09-20 20:39:53
6109b95dc6677073c59183a51da72f596f18697b...bfb2e634611962d40125f0ad34f47d145658d78d,1,1,0,1,1,2010-09-20 20:49:14,2010-09-20 20:49:14
bfb2e634611962d40125f0ad34f47d145658d78d...8b8e4882afc8febe523ff572002f6b45073f02c3,3,8,9,17,7,2010-09-21 04:24:52,2010-09-21 04:23:33
8b8e4882afc8febe523ff572002f6b45073f02c3...ab48745937e9dc670baf9421ce53663442db5751,1,1,1,2,1,2010-09-21 13:44:23,2010-09-21 13:44:23
ab48745937e9dc670baf9421ce53663442db5751...a3986b4040198fab9253791bb45a514f0ee283cc,6,202,145,347,8,2010-09-21 13:53:34,2010-09-21 13:53:34
a3986b4040198fab9253791bb45a514f0ee283cc...68df06feab125fd92f0853eb052ea86599b75bff,5,35,12,47,15,2010-09-21 14:43:28,2010-09-21 14:43:28
68df06feab125fd92f0853eb052ea86599b75bff...18bc7dc36e77949cb3edd042cd5c65d090bf9940,1,4,4,8,4,2010-09-21 15:40:04,2010-09-21 15:40:04
ac0b1d8a7e87ce62deb255f66d90f51f69c57486...57aa5b4d16f63d86690e8b325e27e6997729483e,1,28,27,55,2,2010-09-19 21:32:06,2010-09-19 21:32:06
57aa5b4d16f63d86690e8b325e27e6997729483e...c1b68a13dea69fce069eec237901cf3511052cf5,27,401,205,606,137,2010-09-27 16:35:22,2010-09-27 16:35:22
54a0c78fdeb8e48531c3b967b252080a7544700c...e8f0119c5546f9133709ef82b42a1947f66aa494,3,5,7,12,7,2010-09-25 11:21:25,2010-09-25 11:21:25
54a0c78fdeb8e48531c3b967b252080a7544700c...cc4f1da77885ecfd7a14bf0f9c90dbbef4a3d0bc,1,2,0,2,1,2010-09-25 09:08:21,2010-09-25 09:08:21
cc4f1da77885ecfd7a14bf0f9c90dbbef4a3d0bc...37c08311fdec6ba19ddc90eb1d90966188a0a1f0,1,6,2,8,3,2010-09-25 09:08:57,2010-09-25 09:08:57
18bc7dc36e77949cb3edd042cd5c65d090bf9940...7d3945a8bebcfd5c1895d8d2eb36465e7b6131a9,2,31,1,32,2,2010-09-21 17:54:23,2010-09-21 17:54:23
18bc7dc36e77949cb3edd042cd5c65d090bf9940...20bf2e66fde7074eb3b83a421a07f599fad1d138,1,4,3,7,3,2010-09-21 16:30:08,2010-09-21 16:30:08
20bf2e66fde7074eb3b83a421a07f599fad1d138...b356a7fc8a203eb23147658dcd60fc4c275e3091,2,26,15,41,10,2010-09-21 17:34:12,2010-09-21 17:34:12
05ef187841a2dbedf8d689ab833737ad15f873f5...0591d865250400e374090f7c732df938e1819f42,1,1,1,2,1,2010-09-27 17:22:40,2010-09-27 17:22:40
0591d865250400e374090f7c732df938e1819f42...6309d60b49739fdd22c70b8d255399b3281812be,1,1,1,2,1,2010-09-27 20:06:44,2010-09-27 20:06:44
e8f0119c5546f9133709ef82b42a1947f66aa494...4b56d14a15baf9853df4c74a5fcfa0c32845842b,1,4,0,4,1,2010-09-27 20:52:54,2010-09-27 20:52:54
eb74c84814a1f0aceb7cd335e1296d419550ae23...5a5d766199cd952c868484d4c1e3fd880092c291,1,40,0,40,1,2010-09-27 15:46:03,2010-09-27 15:46:03
f1afbf0f4e52d0b4fc487d41b1c8bc8743d89092...bde74e641390db642e6a81d4ca701081eac4f1fd,2,22,2,24,2,2010-09-27 21:04:40,2010-09-27 21:04:15
bde74e641390db642e6a81d4ca701081eac4f1fd...14baf5f3c95b0be9057fece5e0380a1627d2f9f6,1,39,28,67,6,2010-09-27 21:11:15,2010-09-27 21:11:00
14baf5f3c95b0be9057fece5e0380a1627d2f9f6...604d1718284d947c00a641a02053b1c7619a442e,1,15,3,18,1,2010-09-28 16:54:00,2010-09-28 16:54:00
14baf5f3c95b0be9057fece5e0380a1627d2f9f6...1cefd8cc5dbd9901b9de21c3e07dcefdca172d3e,2,17,1,18,2,2010-09-27 22:23:33,2010-09-22 17:18:27
1cefd8cc5dbd9901b9de21c3e07dcefdca172d3e...aab1fcff76c2374692f8c56bfefea3e6203a6eb4,1,1,1,2,1,2010-09-27 22:23:33,2010-09-22 17:58:57
aab1fcff76c2374692f8c56bfefea3e6203a6eb4...8f6b5ab3d2fade6a6f6b37af48f55b5a204a6401,2,18,17,35,3,2010-09-27 22:23:33,2010-09-27 22:21:36
739b48a404b01d771778c2fc6f1a100f2f15efcb...75a6688cd7821c4a19b48c7954b1dc21a761a0f9,2,2,2,4,2,2010-09-28 17:59:48,2010-09-28 14:55:37
75a6688cd7821c4a19b48c7954b1dc21a761a0f9...1b1cb57e50ddfd4a274291d47b81b25bf1f71a18,1,15,12,27,8,2010-09-28 17:59:48,2010-09-28 14:56:19
1b1cb57e50ddfd4a274291d47b81b25bf1f71a18...2e9da85b5631f3a875e1e7ca15808458f03820ff,1,0,45,45,1,2010-09-28 17:59:48,2010-09-28 14:56:36
8f6b5ab3d2fade6a6f6b37af48f55b5a204a6401...db4116162b46403d8ff1d233adc405f7fbfa2ed7,1,5,4,9,1,2010-09-28 05:01:12,2010-09-28 05:01:03
db4116162b46403d8ff1d233adc405f7fbfa2ed7...cee2d0d6816a704126c283401db24c949d5f52a3,4,11,3,14,4,2010-09-28 14:09:03,2010-09-28 14:09:03
8f6b5ab3d2fade6a6f6b37af48f55b5a204a6401...be0e007608eb08ace73a87e97218faec21a98e6f,2,2,1,3,2,2010-09-28 02:21:31,2010-09-28 02:21:31
be0e007608eb08ace73a87e97218faec21a98e6f...de2ba924c87372679edebcc6601cc7ea5ac308f6,2,2,2,4,2,2010-09-28 03:49:30,2010-09-28 03:49:30
e81cd95716d7d59a008272ae2855e7c68be8ecdc...0b5235b87fcc3ec3c8c25ead8257f7e2782fe55f,1,1,1,2,1,2010-09-28 18:02:27,2010-09-28 18:02:27
c9885b8d8b30f72e268076c1f8a366baa23bd4a6...dbd32482a6ef5b4e305126bd30a329c63aa973b9,10,59,59,118,44,2010-09-28 21:18:36,2010-09-28 21:18:36
c9885b8d8b30f72e268076c1f8a366baa23bd4a6...7c5b9daeda4063c4f9b3be8627c39302c3424195,2,48,2,50,2,2010-09-28 20:26:16,2010-09-28 20:26:16
7c5b9daeda4063c4f9b3be8627c39302c3424195...838c92ad1b45166d0b6a8b9e3d55a8ca5ec90035,1,27,0,27,1,2010-09-28 20:35:57,2010-09-28 20:35:57
cee2d0d6816a704126c283401db24c949d5f52a3...f01789027bb622fc61fb2f992d4524534b96741d,7,49,18,67,20,2010-09-28 18:01:54,2010-09-28 18:01:54
3ba7ca34724b923c7aa0ce398227513ce7327efb...da10c9799cd02b17032e5393be48d9f2b45cd1c3,3,8,4,12,5,2010-09-30 12:38:40,2010-09-30 12:38:40
da10c9799cd02b17032e5393be48d9f2b45cd1c3...9e8f16ebc020d571efe48cd91a755846d28f1d22,1,11,2,13,3,2010-09-30 13:13:07,2010-09-30 13:13:07
9e8f16ebc020d571efe48cd91a755846d28f1d22...f442f7e712ebb4a16f1f832138a51447999578e5,1,2,0,2,1,2010-09-30 14:07:07,2010-09-30 14:07:07
f442f7e712ebb4a16f1f832138a51447999578e5...33dc9a2d29795c9c316aa826c088e5c5356af081,4,28,12,40,6,2010-09-30 14:07:17,2010-09-30 14:07:17
33dc9a2d29795c9c316aa826c088e5c5356af081...1d25159679f474e0c3225d95c9a53e11a9b5ab21,1,30,0,30,1,2010-09-30 15:05:41,2010-09-30 15:05:41
1d25159679f474e0c3225d95c9a53e11a9b5ab21...e69d6d51dd5b583904d4c22b5d9b233a91d152e1,3,0,8,8,4,2010-09-30 15:58:26,2010-09-30 15:58:26
52cfae0accf094daf7d2ad8fbcce23afab4d99fd...c595bf62aab72db689edc8e70e1ebaef71b09bd2,4,17,11,28,9,2010-09-28 21:49:40,2010-09-28 21:49:40
c595bf62aab72db689edc8e70e1ebaef71b09bd2...e414e72d5a629cef1a5f73d1c1999107bf2a65cc,1,2,1,3,1,2010-09-28 21:55:08,2010-09-28 21:55:08
e69d6d51dd5b583904d4c22b5d9b233a91d152e1...6bb65c908d92c480c84279c38a3130e5437e93cc,2,53,3,56,6,2010-09-30 18:32:15,2010-09-30 18:32:15
e69d6d51dd5b583904d4c22b5d9b233a91d152e1...807d6a5d44b78e1d3070532c0bd3e8577c06c4ad,6,59,51,110,16,2010-09-30 16:19:35,2010-09-30 16:19:09
e414e72d5a629cef1a5f73d1c1999107bf2a65cc...47a3115e8beeffcc97bf3a3b46c155e357a3cc2d,2,20,1,21,3,2010-09-28 22:37:15,2010-09-28 22:37:00
47a3115e8beeffcc97bf3a3b46c155e357a3cc2d...b6716766b52e6563a133e7ef2f728e282d84694e,1,1,0,1,1,2010-09-29 01:04:27,2010-09-29 01:04:27
b6716766b52e6563a133e7ef2f728e282d84694e...4e1692b74ff4b64b4f2180efc090d62f672a1751,2,16,1,17,2,2010-09-29 04:56:22,2010-09-29 04:55:53
4e1692b74ff4b64b4f2180efc090d62f672a1751...41fc0385e1a98a8fc4d5c8eb29e875a030173f25,1,2,1,3,2,2010-09-29 11:17:32,2010-09-29 11:17:32
e414e72d5a629cef1a5f73d1c1999107bf2a65cc...a0e977c8c1b86346c0d570beb806417a298cf528,2,26,14,40,3,2010-09-28 22:08:44,2010-09-28 22:08:44
a0e977c8c1b86346c0d570beb806417a298cf528...7edb8c3f659e278f58a115f0753c90e9b08b7919,9,74,25,99,20,2010-09-29 14:18:11,2010-09-29 14:18:11
b49aec13a42717015a2912804d5f7140dee506cf...5b0b5d7eb64e405815320badab9f499a579b4bdc,6,30,100,130,33,2010-09-30 19:14:10,2010-09-30 19:14:10
5b0b5d7eb64e405815320badab9f499a579b4bdc...fc41a8a04de9e3fc04b0410933f0b270c1d0c705,1,1,1,2,1,2010-09-30 19:39:44,2010-09-30 19:39:44
fc41a8a04de9e3fc04b0410933f0b270c1d0c705...b0162588055f0dd8e009ca98740ae297d3c65b32,14,13,1085,1098,26,2010-09-30 19:42:04,2010-09-30 19:42:04
b0162588055f0dd8e009ca98740ae297d3c65b32...d73a18dec8708a728fd85ead6b279ba4c12cbe17,3,6,43,49,4,2010-09-30 19:46:32,2010-09-30 19:46:32
d73a18dec8708a728fd85ead6b279ba4c12cbe17...07c7c19a4dd4f6c3792c19bc2ec912a56be270b2,8,5,195,200,11,2010-09-30 19:55:20,2010-09-30 19:55:20
07c7c19a4dd4f6c3792c19bc2ec912a56be270b2...cddcb6d1649855ba61a96e215db27c2df00244e7,5,94,5,99,9,2010-09-30 21:27:40,2010-09-30 21:27:40
cddcb6d1649855ba61a96e215db27c2df00244e7...f550177b1a1e743df0d9cc90f96f1aa758639ff6,5,278,226,504,4,2010-09-30 21:37:19,2010-09-30 21:37:08
f550177b1a1e743df0d9cc90f96f1aa758639ff6...8a0dcd7f9c9a70c340b02117aff639bb7ae17cab,1,1,1,2,1,2010-09-30 21:45:40,2010-09-30 21:45:40
8a0dcd7f9c9a70c340b02117aff639bb7ae17cab...9c752abe2558bb796fb10cbe5705c5f491b08c17,1,10,10,20,1,2010-09-30 21:47:44,2010-09-30 21:47:44
9e655e81ffeef75427d5c5f1279a7e71f1073e2a...49c775f025a45e0dbecd73a3ba9bad915d126332,1,2,2,4,2,2010-09-29 15:22:07,2010-09-29 15:22:07
49c775f025a45e0dbecd73a3ba9bad915d126332...6a931d5e050f4553032e0dbbb77504e119e0c66c,3,50,12,62,11,2010-09-29 17:24:33,2010-09-29 17:24:33
6a931d5e050f4553032e0dbbb77504e119e0c66c...809d102b5e295e5e36a8ea1544cc7a8cebae7d80,3,16,2,18,4,2010-09-29 17:51:33,2010-09-29 17:51:33
809d102b5e295e5e36a8ea1544cc7a8cebae7d80...ff2da86deca52dfc0864a8b18b8be5a05b572ec7,2,4,1,5,4,2010-09-29 18:02:55,2010-09-29 18:02:55
ff2da86deca52dfc0864a8b18b8be5a05b572ec7...1549d5295ab6a1d96b2f692c2f11006f16e82f89,1,1,1,2,1,2010-09-29 18:03:37,2010-09-29 18:03:37
9c752abe2558bb796fb10cbe5705c5f491b08c17...b5e3087817a7c8e0954bde0ff019fec1a27ea7ba,8,106,32,138,24,2010-10-01 13:06:58,2010-10-01 13:06:58
9c752abe2558bb796fb10cbe5705c5f491b08c17...41324983019b358d1c9e7f5f11a49edeb685271c,1,4,3,7,3,2010-10-01 13:05:05,2010-10-01 13:05:05
41324983019b358d1c9e7f5f11a49edeb685271c...356f4cc5a2e695214f51464bfdb9bb224c2071d3,2,15,4,19,5,2010-10-01 13:09:50,2010-10-01 13:09:50
1549d5295ab6a1d96b2f692c2f11006f16e82f89...d316fc41a153ab709e92ba1835675e0bf2dd95d9,2,7,0,7,2,2010-09-29 20:47:19,2010-09-29 20:47:19
1549d5295ab6a1d96b2f692c2f11006f16e82f89...2a4c95a3f44b12968f819e77799c8b0af9434625,1,12,0,12,2,2010-09-29 18:14:53,2010-09-29 17:09:08
2a4c95a3f44b12968f819e77799c8b0af9434625...5e538ccb8ab0d99129c3b5c9316f2b25e877d3cf,6,354,14,368,35,2010-09-29 18:16:25,2010-09-29 17:10:10
5e538ccb8ab0d99129c3b5c9316f2b25e877d3cf...2895525cc3550f87e0d67840dd30c99e6ddca4a4,1,2,2,4,2,2010-09-29 18:16:25,2010-09-29 17:23:19
2895525cc3550f87e0d67840dd30c99e6ddca4a4...e74fae251d4b2d581c00e10163c01a4c0ee267bc,4,35,39,74,13,2010-09-29 18:16:25,2010-09-29 18:14:35
e74fae251d4b2d581c00e10163c01a4c0ee267bc...eb8927dd5b1cb51d70f94b5d1de67f0da8c36863,1,8,2,10,3,2010-09-29 18:28:23,2010-09-29 18:28:23
eb8927dd5b1cb51d70f94b5d1de67f0da8c36863...d13858dbb70c094f8c5539ed610f1eb98b1ec5d7,1,1,1,2,1,2010-09-29 18:29:00,2010-09-29 18:29:00
75006ce5389594d847d94fcf3d1cb3affa577c7a...45a7620aac38282eaa10b81a13b5ae6bc7e089fb,12,196,96,292,46,2010-10-01 20:14:36,2010-10-01 20:14:36
75006ce5389594d847d94fcf3d1cb3affa577c7a...9076c182ecfeea0985ba0fa3ae736092a2e81b6d,6,241,162,403,12,2010-10-01 16:45:36,2010-10-01 16:45:36
9076c182ecfeea0985ba0fa3ae736092a2e81b6d...a6b0eee2c0632e326ec1929d28be1645ee94d455,9,189,133,322,19,2010-10-01 17:28:19,2010-10-01 17:28:19
a6b0eee2c0632e326ec1929d28be1645ee94d455...9eb2e8c2baa1f3a8a248a5b49c948f3e4e701a3d,1,1,1,2,1,2010-10-01 17:41:18,2010-10-01 17:40:37
9eb2e8c2baa1f3a8a248a5b49c948f3e4e701a3d...7b17586c5bc7ad65c44f3b66264e9b42e9941e09,1,4,4,8,2,2010-10-01 17:41:18,2010-10-01 17:40:54
7b17586c5bc7ad65c44f3b66264e9b42e9941e09...9d0b787f0d695cd3432ba445278273d10608553c,1,6,4,10,2,2010-10-01 17:41:18,2010-10-01 17:41:03
9d0b787f0d695cd3432ba445278273d10608553c...e161357e637943207ef5358ed34b4414c3d40d46,1,14,3,17,3,2010-10-01 19:00:19,2010-10-01 19:00:19
ac98f10a3d35618d326a92981684aa3c1af03073...47b6945cf0c43cb3db5ef6d762d911a42d201786,6,12,8,20,10,2010-10-01 20:30:19,2010-10-01 20:30:19
47b6945cf0c43cb3db5ef6d762d911a42d201786...5369650ebb7902dd386df6db82dda206b35478a2,4,10,2,12,5,2010-10-01 20:33:15,2010-10-01 20:33:15
5369650ebb7902dd386df6db82dda206b35478a2...3989baa6fbaf090cb78339aa697e40e3ab1d25eb,1,1,1,2,1,2010-10-01 20:34:16,2010-10-01 20:34:16
e161357e637943207ef5358ed34b4414c3d40d46...70d9fb3fd20f44ceab08169c06c10a405f824772,1,9,5,14,5,2010-10-01 20:51:09,2010-10-01 20:51:09
2684cb9464caf9467ce5ae41b0bffed959fd6c8b...627246489bef46a81a75cdf485680ba4370f20ce,1,12,11,23,10,2010-10-01 20:45:18,2010-10-01 20:45:04
627246489bef46a81a75cdf485680ba4370f20ce...a16d5cc4d674d295bdf6ff36773400412bbd02e3,2,139,14,153,4,2010-10-01 22:02:44,2010-10-01 22:02:03
a16d5cc4d674d295bdf6ff36773400412bbd02e3...75351ec80f2beefe6f39f3535719e8b51654e002,4,41,18,59,12,2010-10-02 00:42:35,2010-10-02 00:42:35
75351ec80f2beefe6f39f3535719e8b51654e002...d3b2dddd7400f0efec97e3d5913847ee5c5a20a0,2,8,1,9,2,2010-10-02 19:25:35,2010-10-02 19:25:35
d3b2dddd7400f0efec97e3d5913847ee5c5a20a0...41b422b789dd8ce8c9ae57063bc6fcca29182912,2,16,18,34,3,2010-10-03 21:29:49,2010-10-03 21:29:49
41b422b789dd8ce8c9ae57063bc6fcca29182912...cb5bfad605bfc5d08a6b004910026b74cf9c2f56,1,6,0,6,1,2010-10-04 15:22:40,2010-10-04 15:22:40
cb5bfad605bfc5d08a6b004910026b74cf9c2f56...eedcd0f469a95427865634441fc81ed9018d3e71,1,11,11,22,5,2010-10-04 15:23:10,2010-10-04 15:23:10
eedcd0f469a95427865634441fc81ed9018d3e71...322b2ab6c60f89c87366a51ec29ac53066b5e5f4,1,3,1,4,1,2010-10-04 16:20:12,2010-10-04 16:20:12
322b2ab6c60f89c87366a51ec29ac53066b5e5f4...47e170fb0d7b306ef7c32cc79f511d11e49900df,1,77,53,130,1,2010-10-04 18:02:44,2010-10-04 18:02:44
47e170fb0d7b306ef7c32cc79f511d11e49900df...d8a8c354ffc05ae752994521be23d53ca155269e,6,49,35,84,26,2010-10-04 18:02:52,2010-10-04 18:02:52
d8a8c354ffc05ae752994521be23d53ca155269e...8c166a0db7bb68d4294d70145f9f75e979590e03,3,7,6,13,5,2010-10-04 19:02:15,2010-10-04 19:02:15
d8a8c354ffc05ae752994521be23d53ca155269e...291b5228dd06e35241aa668064676bb0d25308d2,1,4,5,9,3,2010-10-04 18:20:26,2010-10-04 18:20:14
291b5228dd06e35241aa668064676bb0d25308d2...b01f4c93662dfc72f9aa51a786a9eb645d9aeece,2,107,1,108,2,2010-10-04 18:52:20,2010-10-04 18:52:20
2b09e1e25b95ce13962137c2e68516f2faabdc55...8f4566dad42e0bed8b19f7f3fc480ca49a0784e9,5,69,11,80,6,2010-10-04 19:12:56,2010-10-04 19:12:56
8f4566dad42e0bed8b19f7f3fc480ca49a0784e9...9b1589a4a8e25246eadf50688b139764d9839eea,3,43,75,118,26,2010-10-04 19:26:30,2010-10-04 19:26:30
9b1589a4a8e25246eadf50688b139764d9839eea...381fb1524927baf9b35dd00a34d05d03a22429fd,2,4,1,5,2,2010-10-04 20:02:50,2010-10-04 20:02:50
381fb1524927baf9b35dd00a34d05d03a22429fd...c3fb79d805db792f85d1b2646fcb954de0d5a325,6,33,11,44,13,2010-10-04 20:46:17,2010-10-04 20:46:17
c3fb79d805db792f85d1b2646fcb954de0d5a325...f12513199296f487e3f4a7b37e040e7afb6cf098,2,8,2,10,3,2010-10-04 20:52:51,2010-10-04 20:52:51
f12513199296f487e3f4a7b37e040e7afb6cf098...77ba80066c5ca38ec7f90f802d08b21b9b7e4811,2,11,8,19,8,2010-10-04 21:00:48,2010-10-04 21:00:48
77ba80066c5ca38ec7f90f802d08b21b9b7e4811...9d00c0c7e9d6cf5b04a4a6dc19b9827651170016,2,8,0,8,3,2010-10-04 21:05:31,2010-10-04 21:05:31
9d00c0c7e9d6cf5b04a4a6dc19b9827651170016...92a5d51100a5b45d06ffafe38af7de43e6502915,3,15,1,16,5,2010-10-04 21:44:42,2010-10-04 21:44:11
92a5d51100a5b45d06ffafe38af7de43e6502915...8e21c18985786352355c89ffef4d4ee2bfabc290,1,90,68,158,2,2010-10-05 00:09:41,2010-10-05 00:09:41
8e21c18985786352355c89ffef4d4ee2bfabc290...4a7a23a29c2daca9eff29d252b3a4fa35b2b05e8,4,79,31,110,14,2010-10-05 05:29:44,2010-10-05 03:53:48
4a7a23a29c2daca9eff29d252b3a4fa35b2b05e8...7b24925eb9a94cbd9bb2652cf304b51e3ca48d0a,1,1,1,2,1,2010-10-05 05:29:44,2010-10-05 04:31:50
7b24925eb9a94cbd9bb2652cf304b51e3ca48d0a...e0590db4d1f2ab389ca589109eaa386007b1d2ca,5,61,3,64,7,2010-10-05 05:29:44,2010-10-05 05:10:58
e0590db4d1f2ab389ca589109eaa386007b1d2ca...acee25a02a3ddfbf71fc3c230f2b671e290494b0,1,10,5,15,3,2010-10-05 05:29:45,2010-10-05 05:29:14
acee25a02a3ddfbf71fc3c230f2b671e290494b0...043f94b25e1e94b5be8b6d08cbeda36b0bd538ca,1,1,1,2,1,2010-10-05 17:05:30,2010-10-05 17:05:30
043f94b25e1e94b5be8b6d08cbeda36b0bd538ca...ae26ad05ac3b12e36f1ae71934895af4570a644a,1,0,29,29,7,2010-10-05 19:18:19,2010-10-05 19:18:19
ae26ad05ac3b12e36f1ae71934895af4570a644a...ac7d7286e7b2e9ec03b636fe811d4ab98302ea9a,1,3,1,4,1,2010-10-05 19:16:52,2010-10-05 18:39:13
ac7d7286e7b2e9ec03b636fe811d4ab98302ea9a...f9110a035573de9395059456dc4285bd728a683d,3,38,2,40,4,2010-10-05 19:16:53,2010-10-05 19:16:35
f9110a035573de9395059456dc4285bd728a683d...50f34527a348d2e3be6716e761c892c7e60d691f,2,44,72,116,24,2010-10-06 01:01:40,2010-10-06 01:01:40
f9110a035573de9395059456dc4285bd728a683d...f85a9391eedcec4caf3df09579b08e6bf688f04f,1,1,1,2,1,2010-10-05 20:20:44,2010-10-05 20:20:44
6ad06267ddaea9eaf0db758f4a320296ccb5cfe8...1e90166fc7d720017d1878ca085b2c9856d85f9c,1,5,0,5,3,2010-10-06 04:49:38,2010-10-06 04:49:21
1e90166fc7d720017d1878ca085b2c9856d85f9c...43458732d357d7e920f71cef51e4079a5b670dbd,1,21,16,37,6,2010-10-06 05:48:52,2010-10-06 05:48:52
43458732d357d7e920f71cef51e4079a5b670dbd...7ba14c225cce48a238ddab9bca99bcf8645f6074,1,3,2,5,2,2010-10-06 07:02:16,2010-10-06 07:02:16
7ba14c225cce48a238ddab9bca99bcf8645f6074...16cdfae7d8311229aec5ab2842e30746183a5255,3,28,0,28,4,2010-10-06 07:03:02,2010-10-06 07:03:02
16cdfae7d8311229aec5ab2842e30746183a5255...f53fd79ecb7349b37063dba4dc2e90aaaf6a9704,1,1,0,1,1,2010-10-06 07:10:33,2010-10-06 07:10:33
f53fd79ecb7349b37063dba4dc2e90aaaf6a9704...2c041513a0bdbbfd696d43bd58e95adbc946c9bc,1,0,4,4,1,2010-10-06 07:17:02,2010-10-06 07:17:02
2c041513a0bdbbfd696d43bd58e95adbc946c9bc...e593c1fe4cee859464f35559cac2b6d38615505c,2,5,5,10,4,2010-10-06 07:33:09,2010-10-06 07:33:09
e593c1fe4cee859464f35559cac2b6d38615505c...35d37b51998af709371356c25a5ba14917752b03,8,23,37,60,20,2010-10-06 15:19:43,2010-10-06 15:19:43
e593c1fe4cee859464f35559cac2b6d38615505c...b372e20ec85ae4fa9100942c8829501c1737d5be,6,197,161,358,8,2010-10-06 14:40:28,2010-10-06 14:40:07
7159d9104e5f4ae9cb625c21c7a425e027063b12...eee0080d7783932a0d679fc072801caacda28b2d,3,7,25,32,9,2010-10-06 16:06:34,2010-10-06 16:06:34
7159d9104e5f4ae9cb625c21c7a425e027063b12...655a76b8fa2ec18aeb93df5ceb803690f0ed9f20,1,3,0,3,2,2010-10-06 15:33:04,2010-10-06 15:32:33
b372e20ec85ae4fa9100942c8829501c1737d5be...ddb16cb7e47806406592a49155e223f5132fd993,1,54,0,54,1,2010-10-06 20:08:34,2010-10-06 20:08:34
fb74e1c8949fd28a37f0dfdd02916a88f33fb817...b0821d4e713c6df523604aa1a50e2612a19159b1,4,9,7,16,6,2010-10-06 18:09:30,2010-10-06 18:09:30
b0821d4e713c6df523604aa1a50e2612a19159b1...0b5f10dd21432c04ad02fa00540d465dc0c72ec0,1,87,0,87,1,2010-10-06 18:09:53,2010-10-06 18:09:53
d5efa6c49deed2e0a8087b433e6d3ee63edbead9...ebc0ca5400a4dd1bb3c706971ee1e9996863e663,2,23,2,25,2,2010-10-06 23:14:47,2010-10-06 23:14:26
ebc0ca5400a4dd1bb3c706971ee1e9996863e663...265c172b3a2c04c132b36b9554af74cb5e1e7c46,1,1,0,1,1,2010-10-07 03:45:31,2010-10-07 03:45:31
265c172b3a2c04c132b36b9554af74cb5e1e7c46...f0616e7f2eb3ce22cde615a491d4835db985af7e,1,2,2,4,2,2010-10-07 04:10:18,2010-10-07 04:10:18
f0616e7f2eb3ce22cde615a491d4835db985af7e...3c50843ca7b34b48adcbfeaa6533835639f2245d,3,198,171,369,7,2010-10-07 04:12:32,2010-10-07 04:12:32
3c50843ca7b34b48adcbfeaa6533835639f2245d...2c8ce154171648faee3b225033a953f03cda60a4,4,19,10,29,10,2010-10-07 04:56:12,2010-10-07 04:56:12
2c8ce154171648faee3b225033a953f03cda60a4...5eca987eea5fe6d84293ac66323792dffc321055,1,2,2,4,1,2010-10-07 13:27:06,2010-10-07 13:27:06
5eca987eea5fe6d84293ac66323792dffc321055...6ee4b25a148f1b3806adadaadcd995287b904c47,1,4,0,4,3,2010-10-10 14:47:15,2010-10-10 14:47:15
5eca987eea5fe6d84293ac66323792dffc321055...c113be1957d4a0c6ccaf42d026d41bd27c94f09d,3,3,0,3,3,2010-10-07 13:39:33,2010-10-07 13:39:03
fb0e0352fec0e0dc9e9eedc7ba959b826369d159...254f15a958760b3a0643dde403a8de3933b95b54,1,70,101,171,18,2010-10-12 01:35:11,2010-10-12 01:35:11
254f15a958760b3a0643dde403a8de3933b95b54...d454e6e3dacf41dadc48f6568df57a8cffd626af,1,1,1,2,1,2010-10-12 01:51:07,2010-10-12 01:51:07
d454e6e3dacf41dadc48f6568df57a8cffd626af...b03b7878884dcf12f53bbeefbd3fabd9cea3b2f3,1,10,16,26,9,2010-10-12 01:51:30,2010-10-12 01:51:30
b03b7878884dcf12f53bbeefbd3fabd9cea3b2f3...7922967fc78c851b41b82fb9a005a6e304cf8f0c,4,160,42,202,22,2010-10-17 00:10:47,2010-10-17 00:10:47
fb0e0352fec0e0dc9e9eedc7ba959b826369d159...7066dcd21a77d187eae57c1cf552e1fabb7bce8f,1,10,0,10,4,2010-10-10 18:59:30,2010-10-10 18:59:30
7066dcd21a77d187eae57c1cf552e1fabb7bce8f...5260d63898ed23dacf2756c96ccfdd41e9b0af83,2,16,2,18,5,2010-10-10 22:09:40,2010-10-10 22:08:34
5260d63898ed23dacf2756c96ccfdd41e9b0af83...78044d147a7f0fd9379d1af089d587ff604d07b6,2,9,15,24,12,2010-10-10 22:09:40,2010-10-10 22:09:13
78044d147a7f0fd9379d1af089d587ff604d07b6...61ab457c34cf1ddd0ece169eff1053ae9c082883,2,28,0,28,2,2010-10-10 22:48:29,2010-10-10 22:47:32
61ab457c34cf1ddd0ece169eff1053ae9c082883...f6141d9bac74be42762c234769b44a661cc1f77c,2,7,2,9,2,2010-10-11 00:01:17,2010-10-11 00:00:09
f6141d9bac74be42762c234769b44a661cc1f77c...d3c3b8a9032e3cd125ebb09bec967441f1451753,15,39,36,75,21,2010-10-11 00:01:17,2010-10-11 00:00:30
d3c3b8a9032e3cd125ebb09bec967441f1451753...3b1aee171b90ef1e5b72ca060f7fba01de75c5c8,1,6,2,8,1,2010-10-11 02:48:19,2010-10-11 02:48:19
3b1aee171b90ef1e5b72ca060f7fba01de75c5c8...403ecdf336a00aaafcb92a62849713863fb62bf8,1,5,3,8,1,2010-10-11 02:48:33,2010-10-11 02:48:33
403ecdf336a00aaafcb92a62849713863fb62bf8...902a963933bebd298374e7acad43dae930c8c443,1,1,1,2,1,2010-10-11 05:12:22,2010-10-11 05:12:22
902a963933bebd298374e7acad43dae930c8c443...54e30b4c5bb56bbdee19fe81d281786159489c22,1,4,2,6,2,2010-10-11 05:12:29,2010-10-11 05:12:29
54e30b4c5bb56bbdee19fe81d281786159489c22...53a0d295e32505a12d844ffc49fa5a07c8c9081c,11,21,18,39,18,2010-10-11 15:26:41,2010-10-11 15:26:41
53a0d295e32505a12d844ffc49fa5a07c8c9081c...b357c3ea89ef9374dd775c326f75d404bebe7f68,1,1,1,2,1,2010-10-12 01:56:16,2010-10-12 01:56:16
b357c3ea89ef9374dd775c326f75d404bebe7f68...72a85a065e927d4813b3ae04ca17bfca0cfb5214,1,3,2,5,2,2010-10-12 17:21:36,2010-10-12 17:21:36
72a85a065e927d4813b3ae04ca17bfca0cfb5214...da51257c3b9d2dd7621fc2491d043c59e230c1fc,3,38,27,65,24,2010-10-12 17:57:24,2010-10-12 17:57:24
da51257c3b9d2dd7621fc2491d043c59e230c1fc...2a7f26cc8ff63a453215fa217869626ed8a7e0eb,2,6,5,11,5,2010-10-12 18:41:48,2010-10-12 18:41:48
2a7f26cc8ff63a453215fa217869626ed8a7e0eb...c77a4e59301206f74d4e6c8fc101fe0bc2d4fcda,1,2,1,3,1,2010-10-13 14:14:37,2010-10-13 14:14:37
c77a4e59301206f74d4e6c8fc101fe0bc2d4fcda...8d9b3cf6e92b6dabc3927d3b4a7bb31e19fe3376,1,9,2,11,4,2010-10-13 14:42:34,2010-10-13 14:42:18
8d9b3cf6e92b6dabc3927d3b4a7bb31e19fe3376...838fd6ff7659228d73baf27ad933bd40032aee62,5,20,14,34,13,2010-10-13 15:13:54,2010-10-13 15:13:54
c113be1957d4a0c6ccaf42d026d41bd27c94f09d...8e923e738de38779652fcaaf507a4a692913c8c3,2,9,6,15,4,2010-10-08 18:30:56,2010-10-08 18:30:56
c113be1957d4a0c6ccaf42d026d41bd27c94f09d...67bfb7e9f684bb552a3279620d6702429a0fdd88,2,12,3,15,4,2010-10-07 14:38:35,2010-10-07 14:38:35
67bfb7e9f684bb552a3279620d6702429a0fdd88...e6d6f5f5e971c472c5d670d00fe9958166b57fec,1,2,2,4,1,2010-10-07 16:39:46,2010-10-07 16:39:46
f1b5ccc321efc0419519c9047af93f8dbf45ef75...7325bae86f118850d5a61d8e85417a157bb54f2d,1,1,1,2,1,2010-10-17 23:18:41,2010-10-17 23:18:41
f1b5ccc321efc0419519c9047af93f8dbf45ef75...7542f49bd9dd4d2518dab08b8f6710875e831a98,1,1,1,2,1,2010-10-17 15:58:08,2010-10-17 15:57:35
ce908e523d35eb0335b8b72920af99eea0a54909...3140bef60cc6512316c967309647151f81fdea17,1,46,35,81,1,2010-10-14 17:32:30,2010-10-14 17:32:30
3140bef60cc6512316c967309647151f81fdea17...52fc08fb5dee411e710ed7a5f659c2d0d6ef85ee,4,26,16,42,11,2010-10-14 17:32:40,2010-10-14 17:32:40
ce908e523d35eb0335b8b72920af99eea0a54909...3d0fb7c5cdfcf93e9b9a235a8e9346fb643d2beb,1,1,1,2,1,2010-10-13 20:11:15,2010-10-13 20:11:15
3d0fb7c5cdfcf93e9b9a235a8e9346fb643d2beb...1eee8692b97b5e3a5bebb212fe08b00d909898b7,1,1,1,2,1,2010-10-13 20:11:32,2010-10-13 20:11:32
1eee8692b97b5e3a5bebb212fe08b00d909898b7...876b17b344e0c46fd59713a0268eab2928dffafb,2,29,9,38,6,2010-10-13 20:11:50,2010-10-13 20:11:50
876b17b344e0c46fd59713a0268eab2928dffafb...f7c6b8caae6ed1158210a9268f7eff53c9afde36,1,1,1,2,1,2010-10-13 21:27:55,2010-10-13 21:27:55
f7c6b8caae6ed1158210a9268f7eff53c9afde36...465896350e7a6fe0f508a1a73247e05c20950ff2,15,273,143,416,56,2010-10-13 21:38:09,2010-10-13 21:38:09
465896350e7a6fe0f508a1a73247e05c20950ff2...6d3cccb53dc1858b782504b43f1cb18a1c140e8d,1,1,1,2,2,2010-10-13 21:43:57,2010-10-13 21:43:57
6d3cccb53dc1858b782504b43f1cb18a1c140e8d...eda4afef5dfeda9f5d6f3ece887ebfd33ffdcc3e,1,1,1,2,1,2010-10-14 13:48:50,2010-10-14 13:48:50
2c727780018cfeebc01648ae0e96e761731473ee...55f33c6a427d456c0d93f1426c9e371e10127499,2,1,2,3,2,2010-10-08 19:48:36,2010-10-08 19:48:36
e6d6f5f5e971c472c5d670d00fe9958166b57fec...a71647e66db33e3c1abe4b151f9d086f146580ac,1,2,1,3,1,2010-10-07 18:33:13,2010-10-07 18:33:13
e6d6f5f5e971c472c5d670d00fe9958166b57fec...88f04aaf7228b9ed324ff4d243baa700086271d9,1,3,7,10,1,2010-10-07 18:30:01,2010-10-07 18:29:15
af976c80b4aff1836f9532c5793718c9036c6f12...3660e1906e7e8e573ce1b19b4d34d181e7685022,1,2,1,3,1,2010-10-17 23:22:46,2010-10-17 23:22:46
3660e1906e7e8e573ce1b19b4d34d181e7685022...24e69084c3a294a76c51393d39be34801db58306,1,1,1,2,1,2010-10-18 02:29:04,2010-10-18 02:29:04
24e69084c3a294a76c51393d39be34801db58306...738b686c1210f1435fa1dc1bf4252565c9eb2e8a,1,4,0,4,2,2010-10-18 02:29:12,2010-10-18 02:29:12
738b686c1210f1435fa1dc1bf4252565c9eb2e8a...8b29ca04e5cbd71ea855d4b94c69c6ae764e2227,1,1,4,5,2,2010-10-18 02:44:31,2010-10-18 02:44:31
8b29ca04e5cbd71ea855d4b94c69c6ae764e2227...527b3afb737930f32b91745178790f9632daa316,1,7,4,11,4,2010-10-18 02:59:27,2010-10-18 02:59:27
527b3afb737930f32b91745178790f9632daa316...0e2f0db9a7b102b7e8cdb1fc87e6ea0af217a50e,1,2,2,4,2,2010-10-18 13:40:16,2010-10-18 13:40:16
0e2f0db9a7b102b7e8cdb1fc87e6ea0af217a50e...d344f95e6e841bb0c296baff03af527ba5dc6545,1,1,1,2,1,2010-10-18 15:02:08,2010-10-18 15:02:08
d344f95e6e841bb0c296baff03af527ba5dc6545...ad76936753c4eeec789bd1f4a15fa504bd1fce26,1,1,1,2,1,2010-10-18 15:56:45,2010-10-18 15:56:45
3ae6e0acab554502cea05f323a282835f8e60430...542d2452624187062a39587c1541a10ead174614,2,14,7,21,3,2010-10-14 18:06:39,2010-10-14 18:06:39
542d2452624187062a39587c1541a10ead174614...31719a2914826bd38bf42ce1d833c4c636099776,1,5,6,11,2,2010-10-14 18:07:36,2010-10-14 18:07:36
31719a2914826bd38bf42ce1d833c4c636099776...5a93445cb07a2507e04eedde03bdca1117ba45b0,1,61,56,117,19,2010-10-14 18:59:45,2010-10-14 18:59:45
5a93445cb07a2507e04eedde03bdca1117ba45b0...6240bac27cc46bb7f3703ad9c70a39417ec91689,2,161,29,190,14,2010-10-14 20:04:14,2010-10-14 20:04:14
6240bac27cc46bb7f3703ad9c70a39417ec91689...50cad63cc1f00a5ae2f3c7a01069339ed000cafd,2,216,136,352,2,2010-10-14 21:02:21,2010-10-14 21:02:21
50cad63cc1f00a5ae2f3c7a01069339ed000cafd...de7e99dcf5bd825e6128164a33a7f75aacd42c2c,4,6,5,11,4,2010-10-14 21:14:23,2010-10-14 21:14:05
de7e99dcf5bd825e6128164a33a7f75aacd42c2c...3348a25a3d8c6a1db8bc68f84ab363df026c03cc,2,0,8,8,2,2010-10-14 23:54:51,2010-10-14 23:54:51
3348a25a3d8c6a1db8bc68f84ab363df026c03cc...2ad85ece41927c25f477e0a18614d6a319754f8e,1,17,0,17,1,2010-10-15 00:35:24,2010-10-15 00:35:24
2ad85ece41927c25f477e0a18614d6a319754f8e...7b51d7111d5246d4612c561abcbef3dc42d15e89,2,10,7,17,7,2010-10-15 14:33:20,2010-10-15 14:33:20
7b51d7111d5246d4612c561abcbef3dc42d15e89...5e7c7b630c032ed9e3dfbdd873cf17e89311cca9,1,0,2,2,1,2010-10-15 14:37:10,2010-10-15 14:37:10
55f33c6a427d456c0d93f1426c9e371e10127499...c90054b26ddaedd69b6136b2510c4ddcdf91de71,4,25,28,53,8,2010-10-13 17:06:49,2010-10-13 17:06:49
55f33c6a427d456c0d93f1426c9e371e10127499...8da0347c5595496a73ef0e2b39e7a36e6343bfde,1,44,0,44,1,2010-10-08 20:46:27,2010-10-08 20:46:27
8da0347c5595496a73ef0e2b39e7a36e6343bfde...56226d80bbf8fc3b23d772e5e4218c29f0453e4e,2,2,2,4,2,2010-10-08 20:58:34,2010-10-08 20:58:34
56226d80bbf8fc3b23d772e5e4218c29f0453e4e...400cb48a83dd349d432136eb8fca2ed2d92c1ec5,1,6,4,10,5,2010-10-09 01:26:57,2010-10-09 01:26:57
400cb48a83dd349d432136eb8fca2ed2d92c1ec5...ce0671dd61f9f37ad2e4c122a298dce269320694,1,2,2,4,2,2010-10-09 03:36:28,2010-10-09 03:36:28
ce0671dd61f9f37ad2e4c122a298dce269320694...e3e3a22e8d9ab86a5020150763e0b6177d7a03b4,1,2,2,4,2,2010-10-09 15:01:50,2010-10-09 15:01:50
e3e3a22e8d9ab86a5020150763e0b6177d7a03b4...09d965b418586591c98dbcb9268a0f98b9572b88,1,1,0,1,1,2010-10-10 01:57:57,2010-10-10 01:57:57
09d965b418586591c98dbcb9268a0f98b9572b88...7a429535ff61a410b1cf3d7d0045759fe4a4c24f,1,17,4,21,5,2010-10-10 01:58:07,2010-10-10 01:58:07
7a429535ff61a410b1cf3d7d0045759fe4a4c24f...be57a79298deee9366579d0f3c8fa35777a8d4fb,1,2,0,2,1,2010-10-10 02:19:09,2010-10-10 02:19:09
7f4f43d8671b8d2d334a1118b3d7a566f3d6624c...9ac87ee8431481be11edac0b2c5a674c34d6f505,3,64,20,84,16,2010-10-07 21:25:06,2010-10-07 21:24:42
9ac87ee8431481be11edac0b2c5a674c34d6f505...7a21313631aa998bf6456310882b9ba75be8679d,1,4,2,6,1,2010-10-08 02:53:59,2010-10-08 02:53:59
7a21313631aa998bf6456310882b9ba75be8679d...0bb165f589ce8b813df149f309e080e200497911,5,76,0,76,5,2010-10-08 15:23:23,2010-10-08 15:23:08
0bb165f589ce8b813df149f309e080e200497911...4accb330447e9443e2ec04af030abaa0c0f1a4c7,1,21,18,39,6,2010-10-08 17:00:09,2010-10-08 17:00:09
ad76936753c4eeec789bd1f4a15fa504bd1fce26...3e32ba710fa5694f3838d8c787f286e37061cc6f,1,1,2,3,2,2010-10-18 16:13:11,2010-10-18 16:13:11
ad76936753c4eeec789bd1f4a15fa504bd1fce26...8574f8f377043740ce558a8f398c09b8b2e9ba2b,1,1,1,2,1,2010-10-18 15:59:51,2010-10-17 21:09:07
8574f8f377043740ce558a8f398c09b8b2e9ba2b...5ac3449393034a941a143aee2fcf32c0358cec83,2,119,0,119,2,2010-10-18 15:59:51,2010-10-18 15:59:23
5e7c7b630c032ed9e3dfbdd873cf17e89311cca9...c88c149eb9150560158d8f755a9f68621df92b4d,3,27,22,49,8,2010-10-15 17:46:44,2010-10-15 17:46:44
5e7c7b630c032ed9e3dfbdd873cf17e89311cca9...d432ea51c55faabe6c673856f6a54996fb0954ea,1,14,15,29,3,2010-10-15 15:04:44,2010-10-15 15:04:44
d432ea51c55faabe6c673856f6a54996fb0954ea...069e56b8b311515492710ef3edca92ba22559143,1,30,1,31,3,2010-10-15 15:20:04,2010-10-15 15:20:04
507c5c53388420b7f1395a1339b52168b4658aca...015faa0b605a2de0c05460aa8822ea11b10d99a8,4,58,10,68,15,2010-10-19 17:38:56,2010-10-19 17:38:56
507c5c53388420b7f1395a1339b52168b4658aca...fd21745be12478e1722d649176e9e1c44206f009,1,2,0,2,2,2010-10-18 18:12:58,2010-10-18 18:12:58
fd21745be12478e1722d649176e9e1c44206f009...b902ee404623407ba3eca55954882afbe389f9aa,1,44,26,70,7,2010-10-18 18:37:00,2010-10-18 18:33:24
b902ee404623407ba3eca55954882afbe389f9aa...cac8c7894724acc4189206b4fddf2c4713779dff,1,3,0,3,1,2010-10-18 19:24:18,2010-10-18 19:24:18
cac8c7894724acc4189206b4fddf2c4713779dff...41f97ca8501319f9da99d0b0ba498cdc8827b042,1,173,6,179,5,2010-10-18 19:44:56,2010-10-18 19:44:56
41f97ca8501319f9da99d0b0ba498cdc8827b042...ad958daea9d34f99f7cc37ce1764ba0dbcb965d2,1,1,0,1,1,2010-10-18 23:28:01,2010-10-18 23:28:01
ad958daea9d34f99f7cc37ce1764ba0dbcb965d2...de2e29a93405e65762d13329b2130bd9963a2351,3,10,7,17,5,2010-10-19 00:43:21,2010-10-19 00:43:21
de2e29a93405e65762d13329b2130bd9963a2351...2d4cf480d585df76dac2f1f0e669408a78be14c2,3,18,38,56,14,2010-10-19 03:25:56,2010-10-19 03:25:56
693e7915f79efc2374c4349e3466b75e0698cb76...505a7ef8e4a07ad3b25321d31bb8ee43bfe48514,1,46,8,54,8,2010-10-15 17:56:50,2010-10-15 17:56:40
505a7ef8e4a07ad3b25321d31bb8ee43bfe48514...087fac1385c7c793bf6bf3f318948db36d9711d9,6,9,2,11,6,2010-10-15 19:45:57,2010-10-15 19:45:57
087fac1385c7c793bf6bf3f318948db36d9711d9...bd4ecbd3c988bdc109a301ae98ffdb53d080dfea,1,1,1,2,1,2010-10-15 19:46:09,2010-10-15 19:46:09
bd4ecbd3c988bdc109a301ae98ffdb53d080dfea...7493a4ed4b76bc0b6cb05a64aa0c9f34d9b7fb0d,1,1,1,2,1,2010-10-15 19:50:41,2010-10-15 19:50:41
7493a4ed4b76bc0b6cb05a64aa0c9f34d9b7fb0d...6002434b928d6e38a45e91212c49153a82cdbad5,3,10,6,16,6,2010-10-15 19:59:22,2010-10-15 19:59:22
6002434b928d6e38a45e91212c49153a82cdbad5...f222057f5358c91e5ec002ad4d3bf262c1303fc7,3,36,5,41,6,2010-10-15 20:13:41,2010-10-15 20:13:41
f222057f5358c91e5ec002ad4d3bf262c1303fc7...25dbc0c12e646557d4da1a1cad989707230746bd,1,2,0,2,1,2010-10-15 20:16:11,2010-10-15 20:16:11
25dbc0c12e646557d4da1a1cad989707230746bd...ad421070f584bb82f3aa1d13339649627b12643b,1,1,0,1,1,2010-10-15 20:18:03,2010-10-15 20:18:03
0f38c2376d4015584dd3bd6ed90242a7f11cd440...d61ccd8d67d77162837954ed00887a8e290a4d11,1,1,1,2,1,2010-10-19 19:15:23,2010-10-19 19:15:23
d61ccd8d67d77162837954ed00887a8e290a4d11...dc650dbe374f786c27dca12c7f31d3390c345c21,1,2,2,4,2,2010-10-19 21:59:28,2010-10-19 21:59:28
dc650dbe374f786c27dca12c7f31d3390c345c21...515192a80636a026db86264fa9fce0b1fc53e957,1,4,4,8,2,2010-10-20 01:53:58,2010-10-20 01:53:58
515192a80636a026db86264fa9fce0b1fc53e957...68d6aa0b41d36b2324246c2e3758b2c49e7def98,1,4,4,8,2,2010-10-20 03:22:57,2010-10-20 03:22:57
68d6aa0b41d36b2324246c2e3758b2c49e7def98...94f15f18f40c1fe8a5204d18e3a96d1caa240fee,1,2,1,3,1,2010-10-20 03:23:06,2010-10-20 03:23:06
94f15f18f40c1fe8a5204d18e3a96d1caa240fee...60d5afda88b93626b58eb2427de54bfb14ebb401,1,0,1,1,1,2010-10-20 03:25:46,2010-10-20 03:25:46
60d5afda88b93626b58eb2427de54bfb14ebb401...9e57fb0c3fea4f5f344c84c977f31dd8bb74affc,1,17,24,41,4,2010-10-20 14:30:05,2010-10-20 14:30:05
9e57fb0c3fea4f5f344c84c977f31dd8bb74affc...0f88bf0ae1a3c7674724b88456827cf852c7ceeb,1,4,2,6,3,2010-10-20 15:01:35,2010-10-20 15:01:35
0f88bf0ae1a3c7674724b88456827cf852c7ceeb...b6fd57882e516cce98a6f516790d0d35c306a3e8,1,3,3,6,3,2010-10-20 20:19:56,2010-10-20 20:19:56
b6fd57882e516cce98a6f516790d0d35c306a3e8...d1ff952a416144050064c376d5bc2c7412017f58,1,16,3,19,2,2010-10-20 20:32:49,2010-10-20 20:32:49
d1ff952a416144050064c376d5bc2c7412017f58...45b08e54aac4d40c5f52802ad95c33beaaef79ea,5,149,3,152,7,2010-10-20 20:35:01,2010-10-20 20:34:08
45b08e54aac4d40c5f52802ad95c33beaaef79ea...26a7046b24e3b0ed535ea9f513452fcaa7ae39bc,2,39,27,66,12,2010-10-20 21:06:25,2010-10-20 21:06:25
26a7046b24e3b0ed535ea9f513452fcaa7ae39bc...39d768653ee9ea24945d1e4ace80eb3b30eed852,1,92,0,92,1,2010-10-20 21:30:34,2010-10-20 19:42:46
39d768653ee9ea24945d1e4ace80eb3b30eed852...04a889eb0572c32c34fad9f97c0915340f5ac490,1,13,1,14,1,2010-10-20 21:33:39,2010-10-18 22:21:05
04a889eb0572c32c34fad9f97c0915340f5ac490...cb185e4c84d961049f9a2f85325c5484c8409aec,1,3,3,6,3,2010-10-20 21:33:54,2010-10-20 21:04:02
cb185e4c84d961049f9a2f85325c5484c8409aec...23952f412edf43dfc875aa1a3d68e02aef03b40b,3,89,6,95,5,2010-10-20 21:33:54,2010-10-20 21:29:55
23952f412edf43dfc875aa1a3d68e02aef03b40b...dcf3f876c9b5d32ca2062e1b93dd5898073c6bbe,1,1,1,2,1,2010-10-21 14:11:26,2010-10-21 14:11:26
dcf3f876c9b5d32ca2062e1b93dd5898073c6bbe...9266002d96ed110b0b164a433f223a9f60e90a32,2,81,29,110,15,2010-10-21 18:11:48,2010-10-21 18:11:48
9266002d96ed110b0b164a433f223a9f60e90a32...ea3a9e3f6eef91eb579682e44054ab34643a55eb,2,71,11,82,7,2010-10-21 19:39:16,2010-10-21 19:39:16
ea3a9e3f6eef91eb579682e44054ab34643a55eb...507c15a10c87f31b6dcb84c0398e10fe40b1b2c1,1,9,2,11,3,2010-10-21 19:55:15,2010-10-21 19:55:15
507c15a10c87f31b6dcb84c0398e10fe40b1b2c1...a652b69e139ac11d3c4a9e0a1a9c5803a03528f7,1,2,8,10,3,2010-10-21 20:10:45,2010-10-21 19:49:21
a652b69e139ac11d3c4a9e0a1a9c5803a03528f7...57aecc7f77f848935c4fd946eb16cf55bb77993b,5,49,8,57,13,2010-10-21 20:10:45,2010-10-21 20:10:27
57aecc7f77f848935c4fd946eb16cf55bb77993b...c017195103d9df92ece6ba22e571f0650862bf18,6,6,6,12,6,2010-10-21 20:52:51,2010-10-21 19:58:00
c017195103d9df92ece6ba22e571f0650862bf18...98a84c219dfa6ccae569fdcdea8f918f3273b5de,1,12,4,16,2,2010-10-21 20:52:51,2010-10-21 20:51:46
98a84c219dfa6ccae569fdcdea8f918f3273b5de...af434bb4352d1499de69417322f5353650ec6084,2,26,4,30,9,2010-10-21 21:47:37,2010-10-21 21:47:37
af434bb4352d1499de69417322f5353650ec6084...79dc60c12fb3e3c6cd88dc80c920e5c32fa24cac,1,35,26,61,6,2010-10-21 22:14:22,2010-10-21 22:14:22
79dc60c12fb3e3c6cd88dc80c920e5c32fa24cac...f84d0586eeddb472fe815f7ca1334ab0e4748fe1,1,3,2,5,2,2010-10-21 22:52:40,2010-10-21 22:51:24
f84d0586eeddb472fe815f7ca1334ab0e4748fe1...0b621a207995286ba01a6df183f3e37564d601ab,8,86,134,220,41,2010-10-22 13:38:36,2010-10-22 13:38:36
0b621a207995286ba01a6df183f3e37564d601ab...9034a61ca2989b5945182720433d705beb9d8b51,2,29,1,30,2,2010-10-22 14:38:23,2010-10-22 14:38:23
9034a61ca2989b5945182720433d705beb9d8b51...9be032d535dec7ab58016ccd3d6644411de07a56,1,2,1,3,2,2010-10-22 16:04:37,2010-10-22 16:04:37
9be032d535dec7ab58016ccd3d6644411de07a56...4f1a41872ffbbb4728c1b1ae609a838b5d377ea7,1,84,23,107,12,2010-10-22 20:44:37,2010-10-22 20:44:37
4f1a41872ffbbb4728c1b1ae609a838b5d377ea7...d0bf058422cba4914a8c3f39acddf9d93ad514c9,1,18,8,26,5,2010-10-22 21:07:07,2010-10-22 21:04:26
d0bf058422cba4914a8c3f39acddf9d93ad514c9...0c1d98a2dad163cdbd2ad75d32be6b597c262c01,1,45,20,65,11,2010-10-22 21:07:07,2010-10-22 21:06:55
0c1d98a2dad163cdbd2ad75d32be6b597c262c01...14201b26ebe94d612835933b8382791e4102ce2e,1,2,0,2,2,2010-10-22 21:47:07,2010-10-22 21:45:05
14201b26ebe94d612835933b8382791e4102ce2e...0cf16a382f906714697e25270cc37ed60a0f8419,1,2,0,2,1,2010-10-22 22:11:07,2010-10-22 22:10:52
0cf16a382f906714697e25270cc37ed60a0f8419...3a8d363fd4f6be12e703a8ec19cd82685550b024,2,59,28,87,15,2010-10-22 23:15:48,2010-10-22 23:15:48
3a8d363fd4f6be12e703a8ec19cd82685550b024...e8019f7aee7abbed552043022bb85c55fcda1ddb,1,2,2,4,1,2010-10-23 13:52:39,2010-10-23 13:52:39
e8019f7aee7abbed552043022bb85c55fcda1ddb...bede67f19d77cca3bffcff01352b246ed39c0690,3,10,12,22,5,2010-10-23 14:02:30,2010-10-23 14:02:30
bede67f19d77cca3bffcff01352b246ed39c0690...57507b03ef70b66df8835758b21c628cea593765,1,1,1,2,1,2010-10-23 14:08:32,2010-10-23 14:08:32
57507b03ef70b66df8835758b21c628cea593765...18938d62ec3e04470de9d555056534e92ef4069d,2,17,6,23,6,2010-10-23 14:40:10,2010-10-23 14:40:10
18938d62ec3e04470de9d555056534e92ef4069d...abccecb42a186da0a899d4755066a4d05b0e538a,1,30,19,49,21,2010-10-23 15:23:58,2010-10-23 15:23:58
abccecb42a186da0a899d4755066a4d05b0e538a...334b692807ec19f8fef6058ab1a13b4538205b5c,1,3,2,5,2,2010-10-23 21:40:36,2010-10-23 21:40:36
334b692807ec19f8fef6058ab1a13b4538205b5c...ea9cce21e7639ba7567768ab8d9540d1bb4a11d2,1,1,1,2,1,2010-10-23 21:40:48,2010-10-23 21:40:48
ea9cce21e7639ba7567768ab8d9540d1bb4a11d2...9923c7b63676271e09b2cbe7689e3c476116d80a,1,12,5,17,3,2010-10-23 21:40:58,2010-10-23 21:40:58
9923c7b63676271e09b2cbe7689e3c476116d80a...f1d5aae215ca47f94ee232420900007dc48d08be,1,2,2,4,1,2010-10-23 21:59:36,2010-10-23 21:59:36
f1d5aae215ca47f94ee232420900007dc48d08be...31984c056bc372b0cffbf008bdbf8fdddf55a4e2,1,4,3,7,2,2010-10-24 05:52:44,2010-10-24 05:52:44
31984c056bc372b0cffbf008bdbf8fdddf55a4e2...09ed0ed5b4f6a0b12050b420432783ef4bab3218,1,1,1,2,1,2010-10-24 14:16:11,2010-10-24 14:16:11
09ed0ed5b4f6a0b12050b420432783ef4bab3218...d927c4f1bc57c1a4003da43ca1b98fa5faeeb0fc,1,2,0,2,2,2010-10-24 14:24:47,2010-10-24 14:24:47
d927c4f1bc57c1a4003da43ca1b98fa5faeeb0fc...8f4624a917b97787270b43ebe24aa7e1db9c10b1,2,4,1,5,3,2010-10-24 14:36:38,2010-10-24 14:36:38
8f4624a917b97787270b43ebe24aa7e1db9c10b1...7237cd308dd0050389fc44ca021dd8f262af0505,1,1,0,1,1,2010-10-24 14:40:25,2010-10-24 14:40:25
7237cd308dd0050389fc44ca021dd8f262af0505...2c6d8c8fe825b41bc94f95984e5cff77d8e5241e,2,22,13,35,13,2010-10-24 15:47:00,2010-10-24 15:47:00
2c6d8c8fe825b41bc94f95984e5cff77d8e5241e...c53135c44759d7f35a9b82a433616e8a9b1307e3,1,11,13,24,6,2010-10-24 21:19:20,2010-10-24 21:19:20
c53135c44759d7f35a9b82a433616e8a9b1307e3...f54e4a512b022d56ac155087183453adc8178a4f,1,3,3,6,3,2010-10-24 21:25:20,2010-10-24 21:25:20
f54e4a512b022d56ac155087183453adc8178a4f...5a99b00eeea09dd1023403a8e294ff04e9921ccd,1,9,7,16,4,2010-10-24 22:10:27,2010-10-24 22:10:27
5a99b00eeea09dd1023403a8e294ff04e9921ccd...5b17695af78298980412e2902ea0aaf86343fb77,1,1,1,2,1,2010-10-24 22:10:59,2010-10-24 22:10:59
5b17695af78298980412e2902ea0aaf86343fb77...d31fdaef0238fc69bcc148fef51f8dd8937a120e,2,12,8,20,8,2010-10-24 22:51:43,2010-10-24 22:51:43
d31fdaef0238fc69bcc148fef51f8dd8937a120e...13703038d3a0575c9dfddceb86ceec78af7d4547,4,66,19,85,10,2010-10-25 00:32:19,2010-10-25 00:32:19
13703038d3a0575c9dfddceb86ceec78af7d4547...36328b202026547bc92586c1e5572175f17c7a8f,1,20,3,23,5,2010-10-25 06:14:48,2010-10-25 06:14:48
36328b202026547bc92586c1e5572175f17c7a8f...0dbcd449c62404f46320e2e1a09039d688f9f121,1,10,2,12,2,2010-10-25 06:41:57,2010-10-25 06:41:57
0dbcd449c62404f46320e2e1a09039d688f9f121...e8cc3182d087a3670fef54b4d855526d329aa56d,1,4,1,5,1,2010-10-25 14:38:19,2010-10-25 14:38:19
e8cc3182d087a3670fef54b4d855526d329aa56d...01e494c5e623baf6f3126cccd216d5ee6bbbb07c,1,15,3,18,2,2010-10-25 15:55:29,2010-10-25 15:55:29
01e494c5e623baf6f3126cccd216d5ee6bbbb07c...9364b46e8356cabf1fb0cb0ad2635063c1ce67c9,1,3,0,3,3,2010-10-25 15:57:38,2010-10-25 15:57:38
9364b46e8356cabf1fb0cb0ad2635063c1ce67c9...86b62402265e4a11927227c7cc11d064d43e4153,4,9,9,18,9,2010-10-25 16:28:13,2010-10-25 16:28:13
86b62402265e4a11927227c7cc11d064d43e4153...ebfc1c32c2fab856cf9f66295f1dd69f69d95edb,1,4,0,4,1,2010-10-25 16:58:31,2010-10-25 16:58:31
ebfc1c32c2fab856cf9f66295f1dd69f69d95edb...be3ca8e084deb0491a5298a0440c3063ea751e20,1,8,6,14,2,2010-10-25 18:02:46,2010-10-25 18:02:46
be3ca8e084deb0491a5298a0440c3063ea751e20...7e074d00e4b049cf4075fee05365f2c5d0550bf9,2,14,1,15,2,2010-10-25 19:38:22,2010-10-25 19:38:22
7e074d00e4b049cf4075fee05365f2c5d0550bf9...64f2740b5497f440590be735e130acecdf34968d,1,1,1,2,1,2010-10-25 20:21:34,2010-10-25 20:21:34
64f2740b5497f440590be735e130acecdf34968d...5b1d4d2b75b356b5fb131d702699bca35cd44e7b,3,109,17,126,20,2010-10-25 21:50:06,2010-10-25 21:49:36
5b1d4d2b75b356b5fb131d702699bca35cd44e7b...ef0d1d8ecb43da504d954f7197abfee53b7aa298,1,0,0,0,0,2010-10-25 22:10:34,2010-10-25 22:10:34
ef0d1d8ecb43da504d954f7197abfee53b7aa298...15b31f767b61746c84c5954f08ff513d3c522160,1,1,1,2,1,2010-10-26 00:43:34,2010-10-26 00:43:34
15b31f767b61746c84c5954f08ff513d3c522160...68edc8aa37a856260f7f72bc04f8218314991c7a,1,1,1,2,1,2010-10-26 04:17:38,2010-10-26 04:17:38
68edc8aa37a856260f7f72bc04f8218314991c7a...88782349c243f63ad180e219d32703308fa36441,1,8,6,14,2,2010-10-26 04:17:45,2010-10-26 04:17:45
88782349c243f63ad180e219d32703308fa36441...4e5c46df588084198a777d34e18c62de2910ca72,1,43,4,47,6,2010-10-26 11:56:28,2010-10-26 11:56:28
4e5c46df588084198a777d34e18c62de2910ca72...664cd5f069596f1aa40f666cbd1dc8a1c000f29b,1,3,3,6,3,2010-10-26 11:57:44,2010-10-26 11:57:44
664cd5f069596f1aa40f666cbd1dc8a1c000f29b...5615486e98aad8859dfbe7b2bb4c8a71fa6cd419,1,12,4,16,5,2010-10-26 13:52:50,2010-10-26 13:52:50
5615486e98aad8859dfbe7b2bb4c8a71fa6cd419...522303d060fd5628c59f4c1b3caf2f750751f986,1,5,5,10,6,2010-10-26 14:42:07,2010-10-26 14:42:07
522303d060fd5628c59f4c1b3caf2f750751f986...ac2dc245b272e3d84a110b3f7120416d52ee26d5,1,105,0,105,1,2010-10-26 16:11:03,2010-10-26 16:11:03
2d4cf480d585df76dac2f1f0e669408a78be14c2...c897083b63933ff3f09adce4263f592c672daaaf,1,2,2,4,1,2010-10-19 13:13:42,2010-10-19 13:13:42
c897083b63933ff3f09adce4263f592c672daaaf...c34a3100fe31ccf90063a0194bb51f2b06b0f3b1,5,29,28,57,20,2010-10-19 13:13:57,2010-10-19 13:13:57
2d4cf480d585df76dac2f1f0e669408a78be14c2...a1cee4c9d6a52e177ae709e9427f56e79e13ba1f,2,7,77,84,8,2010-10-19 11:47:12,2010-10-19 11:47:12
a1cee4c9d6a52e177ae709e9427f56e79e13ba1f...1aaa0ec557d046a7d979f28d38e19897a13ff6fc,2,33,3,36,5,2010-10-19 13:09:36,2010-10-19 13:09:36
ad421070f584bb82f3aa1d13339649627b12643b...01a6722a25216005fbe5f1977a1a6b00a7ff596f,5,54,9,63,8,2010-10-15 21:00:34,2010-10-15 21:00:34
ad421070f584bb82f3aa1d13339649627b12643b...95ab9d32b2f34a25654f97e2652b62a0d8952666,1,3,1,4,3,2010-10-15 20:39:44,2010-10-15 20:39:24
ac2dc245b272e3d84a110b3f7120416d52ee26d5...c11fceb8f1b8c1f2df5c0a6735dd6d7109c275f5,2,14,10,24,5,2010-10-26 22:42:14,2010-10-26 22:42:14
ac2dc245b272e3d84a110b3f7120416d52ee26d5...8cac4cab874f33c98f8e8bb62afa535af34a8fbb,1,7,5,12,5,2010-10-26 18:43:33,2010-10-19 18:21:18
8cac4cab874f33c98f8e8bb62afa535af34a8fbb...5963d0e4549ffa4b91e246ed73631875da310bc1,4,729,23,752,33,2010-10-26 18:43:33,2010-10-26 18:42:06
5963d0e4549ffa4b91e246ed73631875da310bc1...0b1282baff7caebf75555fcd372f05268322d88a,1,2,2,4,1,2010-10-26 19:08:40,2010-10-26 19:08:40
0b1282baff7caebf75555fcd372f05268322d88a...3df26f878771d27432cac29700ff9da44a7fa640,1,4,0,4,1,2010-10-26 19:09:27,2010-10-26 19:09:27
3df26f878771d27432cac29700ff9da44a7fa640...9c7814ffcdad9bae86d3661a123c4bb769dd1f19,1,9,4,13,3,2010-10-26 19:25:26,2010-10-26 19:25:26
9c7814ffcdad9bae86d3661a123c4bb769dd1f19...1c56011bf5b390204014b67d28c5e629ba0a2735,1,3,1,4,1,2010-10-26 21:06:12,2010-10-26 21:06:12
1c56011bf5b390204014b67d28c5e629ba0a2735...ba7cfbbd8c11683b3ff936a24c863fbc4dcf9e6b,1,2,2,4,1,2010-10-26 22:24:55,2010-10-26 22:24:55
36f3e3b09d74c393271d537e6a83f2551d3568fa...9c1914dfb9fce5b2a6198690a6d0e87565e37037,1,16,1,17,1,2010-10-19 13:29:22,2010-10-19 13:29:22
9c1914dfb9fce5b2a6198690a6d0e87565e37037...4c4349c69613d06926bf5c44c76565fd0538a111,3,36,33,69,17,2010-10-19 17:01:46,2010-10-19 17:01:46
813bd2dd5bbd048d0e54348ee6a024c16a23a589...470fe4812f3dc624926399f44748fafaccbe77da,1,4,2,6,2,2010-10-15 21:06:23,2010-10-15 21:06:23
c860a13f9a7392c53e94ecf3deb6b6c6c3fe7852...39b45bf3992e76f29edeb5c3ed1919515f8abf97,1,2,18,20,1,2010-10-27 01:52:22,2010-10-27 01:52:22
ba7cfbbd8c11683b3ff936a24c863fbc4dcf9e6b...a22cc7e48d666b0c8b5cdcaa4321addbd5f08653,2,10,4,14,6,2010-10-27 16:19:15,2010-10-27 16:19:15
4c4349c69613d06926bf5c44c76565fd0538a111...80ee773a16e4bf549796b16a2facebd5fad05575,3,18,15,33,15,2010-10-19 17:25:23,2010-10-19 17:25:23
4c4349c69613d06926bf5c44c76565fd0538a111...1e450f7b005c6d3b6ef0e4f25cc18be490bc3329,2,58,6,64,9,2010-10-19 17:12:28,2010-10-19 17:12:28
bad51fbd549f03c84ebe6bab124f61105a9207ee...e6e25269c22e7148054008e46a27afe0af2972b3,2,18,21,39,7,2010-10-27 16:39:00,2010-10-27 16:39:00
e6e25269c22e7148054008e46a27afe0af2972b3...690970bae1324bb2937494972a533c3c3a591830,1,1,1,2,1,2010-10-27 17:07:08,2010-10-27 17:06:51
690970bae1324bb2937494972a533c3c3a591830...7a83a6fb21c38689917581e786f96818291837c2,2,14,11,25,6,2010-10-27 17:14:48,2010-10-27 14:27:37
7a83a6fb21c38689917581e786f96818291837c2...cf53a963615bb7b04e0e301cc6a812af2786c6ae,1,1,1,2,1,2010-10-27 17:14:48,2010-10-27 17:14:25
cf53a963615bb7b04e0e301cc6a812af2786c6ae...34f629fe2792f85ce7189d177f1db6977c078834,1,3,1,4,1,2010-10-27 17:21:22,2010-10-27 17:21:02
1e450f7b005c6d3b6ef0e4f25cc18be490bc3329...4579ad9e43a3cda34c26c51dad71fa4cf4c758a7,1,28,0,28,1,2010-10-19 17:25:28,2010-10-19 17:25:28
34f629fe2792f85ce7189d177f1db6977c078834...292cf88eb19c9e2e7d70dedebaef176283d83701,1,3,2,5,3,2010-10-27 22:17:26,2010-10-27 22:17:26
34f629fe2792f85ce7189d177f1db6977c078834...6ee5d0ce16d4dd6443ad60f7d34b00a20099c7dd,1,1,1,2,1,2010-10-27 18:05:19,2010-10-27 18:05:19
6ee5d0ce16d4dd6443ad60f7d34b00a20099c7dd...2998c9f313af005edec0c115bdc1ce8641b916ba,1,2,2,4,2,2010-10-27 18:45:15,2010-10-27 18:45:05
2998c9f313af005edec0c115bdc1ce8641b916ba...d5985242144afdd8b6ea0d662d3c899a36dd0df5,1,3,7,10,1,2010-10-27 20:42:02,2010-10-27 20:41:54
d5985242144afdd8b6ea0d662d3c899a36dd0df5...816ec3eeece9c62fbe4d372470638a7ba76b9392,1,2,2,4,1,2010-10-27 20:44:51,2010-10-27 20:44:40
816ec3eeece9c62fbe4d372470638a7ba76b9392...8a50d05676e65343e4cb2cb43d1fdc3d5aee7751,1,2,2,4,1,2010-10-27 20:48:16,2010-10-27 20:48:16
8a50d05676e65343e4cb2cb43d1fdc3d5aee7751...910044f28a4c3c2a896fc7bd35e08c4f8c75063b,3,12,10,22,9,2010-10-27 21:13:47,2010-10-27 21:13:47
910044f28a4c3c2a896fc7bd35e08c4f8c75063b...231219f1e8ecc0c28be4057b515d6ebc73ec8bd8,1,1,1,2,1,2010-10-27 21:23:56,2010-10-27 21:03:17
231219f1e8ecc0c28be4057b515d6ebc73ec8bd8...60b24f50eebe1596728e5d8e16b2ba8428032da5,1,13,0,13,2,2010-10-27 21:23:56,2010-10-27 21:21:21
60b24f50eebe1596728e5d8e16b2ba8428032da5...36c2946d58d053a3c2a2c28827b02cc3fcd9ba53,1,1,1,2,1,2010-10-27 21:37:44,2010-10-27 21:37:37
398b2aac8fe2354a2c6727c79bfcee4a9cbfe823...259b1a24f3605185efa3eab4280cbed960135630,3,2,2,4,2,2010-10-28 00:13:45,2010-10-28 00:13:45
259b1a24f3605185efa3eab4280cbed960135630...2884252fef1d09a395312c4a67ba4d72c2236623,2,14,14,28,12,2010-10-28 14:38:24,2010-10-28 14:38:24
2884252fef1d09a395312c4a67ba4d72c2236623...681a993dd1c00f8f327267af2e875e005f396a47,1,8,4,12,4,2010-10-28 14:38:36,2010-10-28 14:38:36
681a993dd1c00f8f327267af2e875e005f396a47...4307d8b1999de1cd95c4524fd8ff6838e9a49804,4,24,8,32,8,2010-10-28 14:50:39,2010-10-28 14:50:39
681a993dd1c00f8f327267af2e875e005f396a47...32a9f2d21726a38984519dc07213ee5e7ce0100f,1,1,1,2,1,2010-10-28 14:42:07,2010-10-28 14:42:01
13ca96d77c4d4d8d619a7b7077421ea4217eab5d...0b140039bcb7702812ac94a98a9de9e6816b8d46,4,30,43,73,16,2010-10-29 17:40:42,2010-10-29 17:40:42
32a9f2d21726a38984519dc07213ee5e7ce0100f...876dae7981e1ec1141fd1b155429274b83a1f99c,2,9,10,19,7,2010-10-28 17:38:03,2010-10-28 17:38:03
876dae7981e1ec1141fd1b155429274b83a1f99c...db4569cc56dec17e2630a18c68baee254da7c597,2,10,3,13,3,2010-10-28 17:47:30,2010-10-28 17:47:02
db4569cc56dec17e2630a18c68baee254da7c597...39279bd5a70b1ce794332588d26ca5f9079701db,1,1,1,2,1,2010-10-28 17:47:30,2010-10-28 17:47:08
602acdfd0c9796809838ac2c6a6ccc71a0d22c00...30c8eb920abac1a43931f9e7dab6c0e9aef71448,2,12,9,21,6,2010-10-29 17:53:10,2010-10-29 17:53:10
39279bd5a70b1ce794332588d26ca5f9079701db...92d0ac477de0b7fc032d6fa0ec1f88623d44cd1f,1,1,3,4,2,2010-10-28 19:51:14,2010-10-28 19:51:14
39279bd5a70b1ce794332588d26ca5f9079701db...56f7de6acd4b1a675276a2298bafe9ffdf906d8d,1,14,13,27,5,2010-10-28 19:39:09,2010-10-28 19:39:09
56f7de6acd4b1a675276a2298bafe9ffdf906d8d...5350cd1b36c36be2a62755f32b340006d5430883,1,2,1,3,1,2010-10-28 20:16:38,2010-10-28 20:16:38
5350cd1b36c36be2a62755f32b340006d5430883...1110b4270418986fabfeffa80c8cb37eee424059,2,3,4,7,4,2010-10-29 04:49:08,2010-10-29 04:49:08
1110b4270418986fabfeffa80c8cb37eee424059...fa89431e6c97e88a5adf6d09cfb66394cec4ecb4,1,4,6,10,4,2010-10-29 05:13:26,2010-10-29 05:13:26
d227755c3f6c70bae574e91f4db985dcf86a4289...59aa76e3bc59cfeec1673dba5e514b8e614c6f51,2,2,2,4,2,2010-10-29 22:06:48,2010-10-29 22:06:48
59aa76e3bc59cfeec1673dba5e514b8e614c6f51...f0d69affe8ce262be9a5a3dff06f01c6fc4e04cd,1,11,6,17,4,2010-10-29 22:23:44,2010-10-29 22:23:44
f0d69affe8ce262be9a5a3dff06f01c6fc4e04cd...d05001e79d4769acab45d70558ea55c684148a63,2,0,196,196,6,2010-10-29 22:28:28,2010-10-29 22:28:28
d05001e79d4769acab45d70558ea55c684148a63...c1d77b6396ba3fe4d95493aae877565f8b618e32,2,3,12,15,8,2010-10-29 22:41:32,2010-10-29 22:41:32
c1d77b6396ba3fe4d95493aae877565f8b618e32...4d976275764f6bd7d9c48885725d0a24e1bfabc3,1,1,1,2,1,2010-10-29 22:53:27,2010-10-29 22:53:27
4d976275764f6bd7d9c48885725d0a24e1bfabc3...827aa54bc013f2235141f695f9ee258619314090,1,5,8,13,3,2010-10-29 23:45:08,2010-10-29 23:45:08
827aa54bc013f2235141f695f9ee258619314090...9796d42d3f861e5dbd73b11653f6cc59fa3891cb,1,1,1,2,1,2010-10-30 13:05:18,2010-10-30 13:05:18
9796d42d3f861e5dbd73b11653f6cc59fa3891cb...2328fdc8e06626eb2a9134eaa421aa606fe8c4b3,1,4,0,4,1,2010-10-30 17:22:21,2010-10-30 17:22:21
2328fdc8e06626eb2a9134eaa421aa606fe8c4b3...8285a45f0889e25d7c17150f396bf5e51c323136,1,25,5,30,11,2010-10-30 17:27:09,2010-10-30 17:23:39
8285a45f0889e25d7c17150f396bf5e51c323136...b94120dc539a768381b5f9df3e3da879aff753fa,1,38,38,76,21,2010-10-30 17:27:09,2010-10-30 17:26:56
dab6e79b37dcdf2d1b58e935370c43e4c91004b4...6157d16b47d62294b94295ce45308a693471cc81,6,155,122,277,72,2010-10-29 15:00:38,2010-10-29 15:00:38
6157d16b47d62294b94295ce45308a693471cc81...fc15fa95207ae9e340992ef17f23bbde08252cf6,1,2,1,3,2,2010-10-29 15:06:52,2010-10-29 15:06:52
fc15fa95207ae9e340992ef17f23bbde08252cf6...454d128fe6e44f12993e978e0e462d3279bcb058,1,1,1,2,1,2010-10-29 16:08:13,2010-10-29 16:08:13
454d128fe6e44f12993e978e0e462d3279bcb058...96b737b47ed6fa2983fea065b90d48387cf564d1,1,2,3,5,2,2010-10-29 17:24:40,2010-10-29 17:24:40
96b737b47ed6fa2983fea065b90d48387cf564d1...6b1e3d2328ccaedec8821d09ca1070ca57ad562c,1,1,1,2,1,2010-10-29 17:38:13,2010-10-29 17:38:13
b94120dc539a768381b5f9df3e3da879aff753fa...4a6b9257b8e2b22a535cb01385e6c1d9a06340a4,2,17,14,31,10,2010-10-30 18:41:49,2010-10-30 18:41:49
b94120dc539a768381b5f9df3e3da879aff753fa...c30a1b9a8f03f0c88e845d8a2bf43edffb52188b,2,8,24,32,7,2010-10-30 18:21:35,2010-10-30 18:21:35
6b1e3d2328ccaedec8821d09ca1070ca57ad562c...d8565915c5a6e7815c3916ba22789120e557e2fb,4,11,3,14,4,2010-10-29 17:43:48,2010-10-29 17:43:48
d8565915c5a6e7815c3916ba22789120e557e2fb...1e2c723b24addad64b122fcf81b6ec5d1e59c121,1,2,2,4,1,2010-10-29 19:04:22,2010-10-29 19:04:22
f54eccc69e797c1c8411a6eee1ef7124ebec2e2c...0bb17dfae165f88e3a486420c608eb3ecce9b1f8,1,5,1,6,1,2010-10-30 18:49:57,2010-10-30 18:49:57
0bb17dfae165f88e3a486420c608eb3ecce9b1f8...8e027b4f36fdfe6fbe9c1949e2aaef19b64224cc,2,24,16,40,8,2010-10-30 18:56:56,2010-10-30 18:56:56
8e027b4f36fdfe6fbe9c1949e2aaef19b64224cc...412e4c3233fe34a632407ecacce116437cffc62b,1,1,2,3,1,2010-10-30 18:57:49,2010-10-30 18:57:49
412e4c3233fe34a632407ecacce116437cffc62b...0679009d1126855ef9dfe8efe03ccd6bfa3bc2b6,1,0,1,1,1,2010-10-30 19:40:50,2010-10-30 19:40:50
0679009d1126855ef9dfe8efe03ccd6bfa3bc2b6...e20f638e8c888634722cbaa7fa5dcc3bf372edfb,1,8,1,9,1,2010-10-30 19:41:35,2010-10-30 19:41:35
e20f638e8c888634722cbaa7fa5dcc3bf372edfb...9142523c9f01663a4854c377757a0eb619589c26,1,9,1,10,2,2010-10-30 19:54:34,2010-10-30 19:54:34
9142523c9f01663a4854c377757a0eb619589c26...e7914f205b6c4dbfb120c13f209d3d772e4dcff9,1,0,4,4,1,2010-10-30 20:10:43,2010-10-30 20:10:43
e7914f205b6c4dbfb120c13f209d3d772e4dcff9...4bff76ac56d142b5431a13f89bf83d91f4746e17,1,1,0,1,1,2010-10-31 15:11:04,2010-10-31 15:11:04
e7914f205b6c4dbfb120c13f209d3d772e4dcff9...cdc33d7490c84e908b6b27296a81d599669d22e6,1,10,10,20,1,2010-10-31 00:58:41,2010-10-31 00:58:41
cdc33d7490c84e908b6b27296a81d599669d22e6...e5f10858805e79e290007f1341780abb442e285f,1,2,2,4,2,2010-10-31 01:12:34,2010-10-31 01:12:34
e5f10858805e79e290007f1341780abb442e285f...d6295508f6bc40f7038fe95815b33ad8363bd831,1,1,0,1,1,2010-10-31 02:08:59,2010-10-31 02:08:59
d6295508f6bc40f7038fe95815b33ad8363bd831...3904ca23350773aff13f08a52a7cd24209315b75,1,2,2,4,2,2010-10-31 02:09:10,2010-10-31 02:09:10
b0396b9855eebe26fa3bd0f44679696d1821c329...609206e965ddefbeb60acd8d1b183639ec4c514f,1,4,0,4,2,2010-10-31 15:45:06,2010-10-31 15:45:06
609206e965ddefbeb60acd8d1b183639ec4c514f...00fa1a1278ddd513aa94bbb9e795c2321a71a923,4,15,9,24,7,2010-10-31 16:11:38,2010-10-31 16:11:38
00fa1a1278ddd513aa94bbb9e795c2321a71a923...d7bf5edcacedfad79397e808270b59c46e5a4892,1,4,4,8,2,2010-10-31 17:53:22,2010-10-31 17:53:22
d7bf5edcacedfad79397e808270b59c46e5a4892...846d748e4aba05115315ec4db7f74beb274d5313,2,55,51,106,5,2010-10-31 18:42:08,2010-10-31 18:42:08
846d748e4aba05115315ec4db7f74beb274d5313...50d72f3f01ffa05772b154bf23bc1069fd58cb98,1,7,2,9,2,2010-10-31 22:08:48,2010-10-31 22:08:48
50d72f3f01ffa05772b154bf23bc1069fd58cb98...279d33bee6d8dbc3c35e5cb43fccc8ddf7a230fe,6,53,23,76,19,2010-10-31 23:12:12,2010-10-31 23:12:12
279d33bee6d8dbc3c35e5cb43fccc8ddf7a230fe...53973d365f4276c918d10c1337fc492201fd305d,1,1,1,2,1,2010-11-01 02:25:31,2010-11-01 02:25:31
53973d365f4276c918d10c1337fc492201fd305d...89197e9518f82bc422e67b17c44aebb1467917cf,1,8,1,9,1,2010-11-02 15:53:37,2010-11-02 15:53:37
89197e9518f82bc422e67b17c44aebb1467917cf...17a148278e65886bdad5796718e21b844f553d5e,1,1,1,2,1,2010-11-02 16:08:03,2010-11-02 16:08:03
17a148278e65886bdad5796718e21b844f553d5e...3aee3633a87e8a3d79246ea6e481dcf094f9078d,3,18,5,23,9,2010-11-02 16:12:29,2010-11-02 16:12:29
53973d365f4276c918d10c1337fc492201fd305d...93c1fa3cedb937d4ad7a67f6b83286e81434d832,1,2,0,2,1,2010-11-02 00:05:25,2010-11-02 00:05:25
53973d365f4276c918d10c1337fc492201fd305d...d1b5bad7511bfcc0d4d7dacb387ab2c4acbbe8cd,1,3,1,4,2,2010-11-01 17:39:57,2010-11-01 17:39:57
d1b5bad7511bfcc0d4d7dacb387ab2c4acbbe8cd...389333b5d01e4ded01624589f08e5375f411ed9d,1,11,3,14,5,2010-11-01 19:11:31,2010-11-01 19:11:31
389333b5d01e4ded01624589f08e5375f411ed9d...fa9f51da855645c7778ca2745277284b1a2248d3,1,6,3,9,2,2010-11-01 20:19:51,2010-11-01 20:19:51
7828104e0f923e9112c5e2d0c9833f3d19351284...78c6e21862d07ce93bd17af018024f8dcb2522a0,5,42,41,83,35,2010-11-02 17:54:01,2010-11-02 17:54:01
78c6e21862d07ce93bd17af018024f8dcb2522a0...30320637af3b21aba8a0093ec6bb1af308ea9136,1,48,24,72,8,2010-11-02 18:11:55,2010-11-02 18:11:55
d4dfeca04c7faf7d8ff088a7e1c4f8a9f751403d...a66eba2a5289a6482cdeb0fc07cb636122859151,2,84,122,206,15,2010-11-02 03:59:00,2010-11-02 03:59:00
fa9f51da855645c7778ca2745277284b1a2248d3...8c0fa5aa5e3dd093fa214d5f77346aa7c327e78e,1,3,1,4,2,2010-11-02 00:27:07,2010-11-02 00:27:07
8c0fa5aa5e3dd093fa214d5f77346aa7c327e78e...4785ef619fe142a9f994eaa9b47937f705437bf8,1,1,1,2,1,2010-11-02 00:27:12,2010-11-02 00:27:12
4785ef619fe142a9f994eaa9b47937f705437bf8...b0140357afdf61a6e7fe52659bc749935e27da0b,1,1,1,2,1,2010-11-02 01:22:09,2010-11-02 01:22:09
b0140357afdf61a6e7fe52659bc749935e27da0b...2dd5f90b5d2ae403abbf895316f08262600df380,2,16,3,19,3,2010-11-02 03:38:17,2010-11-02 03:38:17
2dd5f90b5d2ae403abbf895316f08262600df380...02d2d60cafb4c13f66abba97ce93b5630ecc664c,2,16,0,16,2,2010-11-02 03:43:57,2010-11-02 03:43:57
30320637af3b21aba8a0093ec6bb1af308ea9136...4c2cbc74a84fd4290ef3020ea5830aced68f1278,1,1,1,2,1,2010-11-02 18:46:58,2010-11-02 18:46:58
30320637af3b21aba8a0093ec6bb1af308ea9136...787309befbbf85777c188a45373c72e3d31b1eb6,2,16,29,45,14,2010-11-02 18:45:00,2010-11-02 18:45:00
c1d5c25e887c4c30040f26fb097317cc2c1b6cf4...a93c3300ce328a5837ffb52468d182e479ee12d2,2,122,84,206,15,2010-11-02 04:18:10,2010-11-02 04:18:10
c1d5c25e887c4c30040f26fb097317cc2c1b6cf4...9c312facc65d207a0bcceaa025b2a1e529354a62,2,19,16,35,3,2010-11-02 04:02:08,2010-11-02 03:58:00
9c312facc65d207a0bcceaa025b2a1e529354a62...5f0427fdd8a466f073c5ae15d6dbbea2701b19a7,2,19,0,19,2,2010-11-02 04:09:00,2010-11-02 04:09:00
c8f2ccb9d178139930f5a0ccbb0bf4e7d4c9142c...f3c8c24e0efa5e6ec9e59773856af2f518b3f71e,2,0,19,19,2,2010-11-02 18:54:44,2010-11-02 18:54:44
7b72c942975c9b4bb9a361f88c67441cfa0496e4...4760fa86acee9b20012797ecd19a24bdd9ced336,3,5,1,6,4,2010-11-02 04:21:14,2010-11-02 04:21:14
4760fa86acee9b20012797ecd19a24bdd9ced336...ca779aa4aebd322982ed586c9bee68e7b0919807,3,18,13,31,8,2010-11-02 14:49:43,2010-11-02 14:49:43
ca779aa4aebd322982ed586c9bee68e7b0919807...5e25ec65b78c4d96c2b5384b76e282faa96c967a,3,27,14,41,13,2010-11-02 15:15:57,2010-10-26 19:51:32
5e25ec65b78c4d96c2b5384b76e282faa96c967a...959e62f1b29dfe326065292183ffeddae392fdd8,2,0,22,22,2,2010-11-02 15:15:57,2010-10-26 19:56:11
959e62f1b29dfe326065292183ffeddae392fdd8...892a22331adbcc6e4bc2cba27108a87d4d475846,1,1,0,1,1,2010-11-02 15:15:57,2010-10-26 20:31:32
892a22331adbcc6e4bc2cba27108a87d4d475846...f47683b1a9672138a2826650718f58d1b9b8c99f,1,1,1,2,1,2010-11-02 15:15:57,2010-10-27 15:41:47
f47683b1a9672138a2826650718f58d1b9b8c99f...1c90eaadb668a538fc44119dd62c41ac7297f97a,1,2,1,3,1,2010-11-02 15:17:19,2010-11-02 15:17:19
f3c8c24e0efa5e6ec9e59773856af2f518b3f71e...55ae7c7e2f2e5b53ea126815a8896e136fb0950a,2,5,1,6,3,2010-11-03 17:59:44,2010-11-03 17:59:44
f3c8c24e0efa5e6ec9e59773856af2f518b3f71e...73a614ccec09564be081a55c99e1b3e0dfb673ec,2,39,114,153,10,2010-11-02 20:34:46,2010-11-02 20:34:46
73a614ccec09564be081a55c99e1b3e0dfb673ec...0f6f7a615374461e897fe83e0255d09c9de8873f,1,0,5,5,1,2010-11-02 20:51:57,2010-11-02 20:51:57
0f6f7a615374461e897fe83e0255d09c9de8873f...0f118c6b82f561975d38d9ceff1a79ec1a56cdc9,1,3,3,6,3,2010-11-02 21:02:44,2010-11-02 19:29:31
0f118c6b82f561975d38d9ceff1a79ec1a56cdc9...db3fe0df38624a64b2e593f2881a2b80e7339fc6,1,7,0,7,1,2010-11-02 22:11:43,2010-11-02 22:10:24
db3fe0df38624a64b2e593f2881a2b80e7339fc6...b089cc3d986f093a1c8b089ea2d0abdabb2669e6,1,26,20,46,2,2010-11-02 22:47:04,2010-11-02 22:47:04
b089cc3d986f093a1c8b089ea2d0abdabb2669e6...d74d8d153a368efebf9e97709d02b236fb0928ce,2,18,40,58,10,2010-11-03 00:15:31,2010-11-03 00:15:31
d74d8d153a368efebf9e97709d02b236fb0928ce...d278ed658243f37d90d5f2d7616d43a714a09806,1,3,3,6,3,2010-11-03 01:50:06,2010-11-03 01:50:06
1f012a2e88839d7caaace67045d1381a39da7e3d...77a0cb7662edca4a66a2efd022380e8ee810d19c,1,0,1,1,1,2010-11-03 18:14:00,2010-11-02 21:50:33
77a0cb7662edca4a66a2efd022380e8ee810d19c...c74c0f9e28c0b813ada9035afa3c2ad1602727c3,1,29,8,37,3,2010-11-03 18:14:00,2010-11-03 18:10:13
c74c0f9e28c0b813ada9035afa3c2ad1602727c3...04b64a6b32cb453216c21b2ad1d4b472d52a2d36,2,11,1,12,4,2010-11-03 19:10:56,2010-11-03 19:08:50
04b64a6b32cb453216c21b2ad1d4b472d52a2d36...12e7b9913b5d24a4340c74587a563e1f67c91d5c,1,4,3,7,2,2010-11-03 20:23:40,2010-11-03 20:23:40
12e7b9913b5d24a4340c74587a563e1f67c91d5c...891198796fd078b2e0943d2e7e7d7d9ebb95b762,2,6,6,12,6,2010-11-03 22:42:24,2010-11-03 22:42:24
891198796fd078b2e0943d2e7e7d7d9ebb95b762...2dce387d96b7edf2e920bf235fa5f6ec5422c063,1,127,33,160,21,2010-11-03 22:57:19,2010-11-03 22:23:01
2dce387d96b7edf2e920bf235fa5f6ec5422c063...b741e68528ecfc6bb06f82355db1d9d8d0c4c43a,1,19,8,27,7,2010-11-03 22:57:19,2010-11-03 22:28:12
b741e68528ecfc6bb06f82355db1d9d8d0c4c43a...d8bcfc55a937249b6782e40d92340586ae710c47,1,34,0,34,1,2010-11-03 22:57:19,2010-11-03 22:37:31
d278ed658243f37d90d5f2d7616d43a714a09806...65571e0f265985195a1428f4646d8c874725d565,1,1,1,2,2,2010-11-03 13:44:10,2010-11-03 13:44:10
d278ed658243f37d90d5f2d7616d43a714a09806...b022e1aab56e989eca70a7cd6ef641ae5e63197c,1,2,1,3,1,2010-11-03 02:39:54,2010-11-03 02:39:54
1d6f39d646b6a4425aee33cbde881aa025e3c66b...edeb5cc71d9d03553fb8b93bc8a303e660c2debe,9,266,147,413,128,2010-11-04 03:25:33,2010-11-04 00:55:28
edeb5cc71d9d03553fb8b93bc8a303e660c2debe...3dd0c135e93d257768dd8792f5b3d8c334f0c6aa,1,1,1,2,1,2010-11-04 03:25:33,2010-11-04 01:03:28
3dd0c135e93d257768dd8792f5b3d8c334f0c6aa...91b15ad20a34bd4ad93fffb6cf77c2f2e581c2a3,2,32,23,55,3,2010-11-04 03:25:34,2010-11-04 01:13:05
91b15ad20a34bd4ad93fffb6cf77c2f2e581c2a3...69fdc69948999b3a7923390dd49c611c123b6427,1,1,1,2,1,2010-11-04 03:25:34,2010-11-04 01:21:06
b069296ad78306c90ef2213018e2b2b5ed965d45...506a0f9b403d17d9291e0f390a082ebae4fbebb4,3,80,78,158,24,2010-11-03 14:06:58,2010-11-03 14:06:58
69fdc69948999b3a7923390dd49c611c123b6427...71f8a44720f38d723a9adde5a261a9925877a55e,2,3,0,3,2,2010-11-06 02:50:04,2010-11-06 02:50:04
69fdc69948999b3a7923390dd49c611c123b6427...15802fea83bd79e603ca93511adab25a1e4d49e6,1,2,1,3,1,2010-11-04 06:45:03,2010-11-04 06:45:03
15802fea83bd79e603ca93511adab25a1e4d49e6...0648d6128810097abb50c4e080d4439c9c96dfaf,16,16,16,32,16,2010-11-04 13:00:39,2010-11-04 13:00:39
0648d6128810097abb50c4e080d4439c9c96dfaf...48ae1fddafc05abaa7530d3de6ee717c187b0180,15,15,15,30,15,2010-11-04 13:07:28,2010-11-04 13:07:28
48ae1fddafc05abaa7530d3de6ee717c187b0180...0c94060e9f418cd47df5323a2a31294e61064822,1,6,20,26,8,2010-11-04 14:27:40,2010-11-04 14:27:40
0c94060e9f418cd47df5323a2a31294e61064822...5deb6b1f6cce5604a54a5bcbe2fa234737f10456,1,3,3,6,3,2010-11-04 14:29:42,2010-11-04 14:29:42
5deb6b1f6cce5604a54a5bcbe2fa234737f10456...c5ca01e648f5b381a75db5dcb4eb05d906a3e1f8,13,132,35,167,33,2010-11-04 21:43:02,2010-11-04 21:43:02
506a0f9b403d17d9291e0f390a082ebae4fbebb4...f57baafce2234f20edd52aa42225fbcdb277bf70,3,54,0,54,3,2010-11-04 02:17:15,2010-11-04 02:17:15
506a0f9b403d17d9291e0f390a082ebae4fbebb4...6672ae03887ed19f94acc716098f12739e0760bd,2,145,5,150,6,2010-11-03 16:28:04,2010-11-03 16:28:04
6672ae03887ed19f94acc716098f12739e0760bd...de76474392f467d627423932a57be8687b4868df,1,5,0,5,1,2010-11-03 16:38:34,2010-11-03 16:38:34
f45d4451579c6a7dffcb1f25de3ae5936040d912...98e56dde4a284c50c82fbfdad5e0b2971fbb5cd4,2,102,0,102,2,2010-11-06 02:50:59,2010-11-06 02:50:59
98e56dde4a284c50c82fbfdad5e0b2971fbb5cd4...0ca797e907c62a174a90f48954bb55c09a1ee475,1,1,1,2,1,2010-11-06 03:00:01,2010-11-06 03:00:01
0ca797e907c62a174a90f48954bb55c09a1ee475...38e29744b8e49207659c8a6d5a01db706d4253a0,1,2,0,2,1,2010-11-06 14:28:43,2010-11-06 14:28:43
38e29744b8e49207659c8a6d5a01db706d4253a0...585aac97983e622cabadb9a07f322bc8f679bb2d,1,15,15,30,3,2010-11-06 14:35:57,2010-11-06 14:35:57
585aac97983e622cabadb9a07f322bc8f679bb2d...0066473ae37042803d5c4ad91343e3043cbd2f48,1,2,2,4,2,2010-11-06 18:53:09,2010-11-06 18:53:09
0066473ae37042803d5c4ad91343e3043cbd2f48...8a7dd4f6c445bf5644c492b830b246d49d6d60b2,2,14,12,26,10,2010-11-06 19:37:45,2010-11-06 19:37:45
8a7dd4f6c445bf5644c492b830b246d49d6d60b2...4f1b0c3f850ed7973bfd8a796421164ca632a751,2,2,4,6,4,2010-11-06 19:50:35,2010-11-06 19:50:35
4f1b0c3f850ed7973bfd8a796421164ca632a751...b56cba0c7eebe12692fee7bbb767b63866f7f471,4,189,0,189,6,2010-11-07 01:29:49,2010-11-07 01:29:49
c5ca01e648f5b381a75db5dcb4eb05d906a3e1f8...ee5399cfea3ba082d8db2127654ae326bd8eab25,4,54,22,76,26,2010-11-05 21:15:39,2010-11-05 21:15:39
c5ca01e648f5b381a75db5dcb4eb05d906a3e1f8...a2265492345dca2a3281d21b0ca676cd68ad5751,3,81,1,82,3,2010-11-04 22:28:43,2010-11-04 22:28:43
a2265492345dca2a3281d21b0ca676cd68ad5751...5e927a1a30f0bf720c785049d6742c010a10e09c,2,0,11,11,3,2010-11-05 15:03:55,2010-11-05 15:03:55
5e927a1a30f0bf720c785049d6742c010a10e09c...ef1c263192bd4adf5a95df4b12b5f31aa68801c8,1,2,4,6,5,2010-11-05 19:14:55,2010-11-05 19:14:05
ef1c263192bd4adf5a95df4b12b5f31aa68801c8...b9cb6ea9773d162973f40d5800ade49af56ac146,1,4,0,4,1,2010-11-05 20:05:47,2010-11-05 20:05:47
b9cb6ea9773d162973f40d5800ade49af56ac146...b6ae12f022df4828a9fc072fcc654c01c302d5c0,1,5,4,9,3,2010-11-05 20:27:15,2010-11-05 20:27:15
b56cba0c7eebe12692fee7bbb767b63866f7f471...fbe3aefafe4d4ff1916d7eef8d7f3743ec2ea246,1,3,0,3,1,2010-11-07 19:48:58,2010-11-07 19:48:58
fbe3aefafe4d4ff1916d7eef8d7f3743ec2ea246...623dfec394207f5332b1b24125a90da174871c90,1,2,2,4,2,2010-11-07 19:49:20,2010-11-07 19:49:20
623dfec394207f5332b1b24125a90da174871c90...c7fa677e12cdc3ad93b38c2fc25d0be0669a23b2,3,8,13,21,8,2010-11-07 20:02:48,2010-11-07 20:02:48
b56cba0c7eebe12692fee7bbb767b63866f7f471...93edd125bb447a3e3b1b7d0264a72102eb93a86f,1,1,1,2,1,2010-11-07 01:34:04,2010-11-07 01:34:04
1d1ad0e26048fea32e942fd73ef2383ebd6adb8c...151470e7b9395df04534e38f493f592c45869b41,1,0,1,1,1,2010-11-05 21:26:29,2010-11-05 21:26:29
151470e7b9395df04534e38f493f592c45869b41...cb6be477b34b05a3fea025007c909a06974bb095,1,1,1,2,1,2010-11-05 23:51:10,2010-11-05 23:50:42
cb6bcf59be5862db6d893bdf993896451e46b040...0ede22a20826a852a62040fc5f323278256dc2b0,1,12,1,13,2,2010-11-07 21:31:53,2010-11-07 21:31:53
0ede22a20826a852a62040fc5f323278256dc2b0...f95f7a44c3628b87e37a853bb2e7dd725845359f,1,1,1,2,1,2010-11-07 23:12:05,2010-11-07 23:12:05
f95f7a44c3628b87e37a853bb2e7dd725845359f...b741da2a0ed581d27af8318a6337d2ace9654f44,1,8,0,8,1,2010-11-08 05:17:09,2010-11-08 05:17:09
b741da2a0ed581d27af8318a6337d2ace9654f44...3fcb3616f201f15eaeb63a5dfb73e767de445be1,1,65,0,65,1,2010-11-08 05:17:40,2010-11-08 05:17:40
3fcb3616f201f15eaeb63a5dfb73e767de445be1...2d3e8a8b73f55f74efaf0d0a49cd4b6a9fc1d815,1,16,0,16,1,2010-11-08 05:25:55,2010-11-08 05:25:11
93edd125bb447a3e3b1b7d0264a72102eb93a86f...c24d82a1ae787c2869550ee30d9910cb6514d594,2,45,31,76,16,2010-11-08 14:21:33,2010-11-08 14:21:33
b8c102939b674d1bc55a86fb1f3d78536fe0c7e0...8d306011efc3813c85dff0a0f60141c56835eadd,1,4,2,6,3,2010-11-08 14:41:35,2010-11-08 14:41:35
8d306011efc3813c85dff0a0f60141c56835eadd...3e53f369fe2db23e3dedf798a1a5f15035fdcc15,1,1,1,2,1,2010-11-08 15:05:14,2010-11-08 15:05:03
3e53f369fe2db23e3dedf798a1a5f15035fdcc15...cee846b21f68568a0fc26fa8f5b5a8b18fd8ea4a,1,0,1,1,1,2010-11-08 15:37:44,2010-11-08 15:37:44
cee846b21f68568a0fc26fa8f5b5a8b18fd8ea4a...3198769ad5591deed329b0930515455f4ef0f22f,3,46,2,48,4,2010-11-08 23:04:15,2010-11-08 23:04:15
cee846b21f68568a0fc26fa8f5b5a8b18fd8ea4a...1e15c2a36360599c7b6a6ca3d9b714367d85d301,3,35,20,55,16,2010-11-08 20:22:03,2010-11-08 20:22:03
cee846b21f68568a0fc26fa8f5b5a8b18fd8ea4a...d0456e59b289a56c18f324ad6740cd2ce1f71ddf,1,7,1,8,1,2010-11-08 18:29:42,2010-11-08 18:29:42
d0456e59b289a56c18f324ad6740cd2ce1f71ddf...d0612401f2c81b311bda075a590813b1a1722435,1,3,0,3,1,2010-11-08 19:18:36,2010-11-08 19:18:36
82eda84caf92aec08dc85cc4faec50c41c5759e6...5edab00f7c85d54cb0fde85dbd44545e659b20be,2,66,2,68,3,2010-11-09 20:49:12,2010-11-09 20:48:43
5edab00f7c85d54cb0fde85dbd44545e659b20be...7cc161c6a53144f90a612da5bf17118a9580b614,5,27,3,30,11,2010-11-09 22:01:58,2010-11-09 22:01:58
7cc161c6a53144f90a612da5bf17118a9580b614...558cb4a9c8b71452e3a39ec6387efaa02cf5f02f,1,37,1,38,2,2010-11-09 22:02:15,2010-11-09 22:02:15
558cb4a9c8b71452e3a39ec6387efaa02cf5f02f...8e348439b2b6f0960627c322948b2ab1ec313fea,2,43,26,69,10,2010-11-09 22:02:50,2010-11-09 22:02:50
8e348439b2b6f0960627c322948b2ab1ec313fea...2683812ba8b59cc73db0c9826444cdc2b3fdc19d,7,331,25,356,21,2010-11-09 22:29:27,2010-11-09 22:28:32
2683812ba8b59cc73db0c9826444cdc2b3fdc19d...3e9d6752f023fb54bd570fa0ba0e3f2886e40738,1,3,1,4,2,2010-11-09 22:29:27,2010-11-09 22:28:54
3e9d6752f023fb54bd570fa0ba0e3f2886e40738...e982a191b68776cc89acb5613bd5a2319821fccd,1,2,0,2,1,2010-11-09 22:38:08,2010-11-09 22:37:42
e982a191b68776cc89acb5613bd5a2319821fccd...31a3c0bc0f41db8b9146ca5af019d7da91675dab,2,7,0,7,2,2010-11-09 23:36:56,2010-11-09 23:36:25
31a3c0bc0f41db8b9146ca5af019d7da91675dab...d14cb30a7a1041e7e3f57f3837cf270f0bbd86d2,1,21,0,21,1,2010-11-09 23:40:10,2010-11-09 23:40:10
d14cb30a7a1041e7e3f57f3837cf270f0bbd86d2...774bb188f63a00b9936d3334edd56cafb16ffb8d,2,7,5,12,7,2010-11-10 00:01:39,2010-11-10 00:01:39
774bb188f63a00b9936d3334edd56cafb16ffb8d...2bc8f5e0ade8476be7992194c3ed0899eb41572e,3,59,14,73,11,2010-11-10 01:28:21,2010-11-10 01:28:21
2bc8f5e0ade8476be7992194c3ed0899eb41572e...b8fe9a96694423e77ff83c30f875db723a6cb444,1,5,5,10,5,2010-11-10 02:00:11,2010-11-10 02:00:11
b8fe9a96694423e77ff83c30f875db723a6cb444...ce9673398d713ecfd34e3afc23d2d3b0106b66f4,1,15,8,23,5,2010-11-10 06:57:26,2010-11-10 06:57:26
ce9673398d713ecfd34e3afc23d2d3b0106b66f4...203a76fa05afb148b25755d13e1a64b189accfde,5,34,48,82,24,2010-11-10 16:49:28,2010-11-10 16:49:28
203a76fa05afb148b25755d13e1a64b189accfde...3e6e773ee430b61ebb0cbc060fe8e8517ba2398c,3,43,7,50,8,2010-11-10 17:09:30,2010-11-10 17:09:16
b2e2b7efebdb0625a54d3eecbd8eb76df6143265...9bfffc98e6a13954a1699ea0ab58b7feefb9939f,1,19,14,33,6,2010-11-08 21:27:24,2010-11-08 21:27:24
9bfffc98e6a13954a1699ea0ab58b7feefb9939f...f0392cec58901088dc332a0f07f531aeb88a5a49,2,39,0,39,3,2010-11-08 23:00:02,2010-11-08 23:00:02
f0392cec58901088dc332a0f07f531aeb88a5a49...d53114396a774cbc1cde769a96e2bf20fca0ee1f,1,1,1,2,1,2010-11-09 01:45:19,2010-11-09 01:45:19
d53114396a774cbc1cde769a96e2bf20fca0ee1f...dd56085dbee13e12c91e994f6196fc58aef06304,3,85,4,89,7,2010-11-09 04:53:10,2010-11-09 04:53:10
dd56085dbee13e12c91e994f6196fc58aef06304...0c7e7101a6fabe05ab72a09e686e7ae0b736df3b,8,54,12,66,24,2010-11-09 05:15:14,2010-11-09 05:14:52
0c7e7101a6fabe05ab72a09e686e7ae0b736df3b...591dfb74fe2c245e66a535eeb37ac17d1e41e1fc,1,2,2,4,2,2010-11-09 05:18:32,2010-11-09 05:18:32
591dfb74fe2c245e66a535eeb37ac17d1e41e1fc...b169ad86d9caaa89ae1ea1b015fa0702a28033b2,1,32,1,33,2,2010-11-09 05:34:47,2010-11-09 05:34:47
b169ad86d9caaa89ae1ea1b015fa0702a28033b2...918b551f11aeedd5df1349478746319434b27c4e,1,2,0,2,1,2010-11-09 05:38:13,2010-11-09 05:38:13
918b551f11aeedd5df1349478746319434b27c4e...8878022b77a759cd1bdb8b3526931a2f632e73bb,1,6,5,11,1,2010-11-09 12:47:23,2010-11-09 12:47:06
8878022b77a759cd1bdb8b3526931a2f632e73bb...1469e3b2583e51c32e12debe84d891f2a709e570,1,8,7,15,4,2010-11-09 12:59:16,2010-11-09 12:59:16
1469e3b2583e51c32e12debe84d891f2a709e570...c5f3d8fb82101f8d38cedaf7448c77a44dc80bf0,3,0,95,95,10,2010-11-09 15:54:32,2010-11-09 15:54:32
c5f3d8fb82101f8d38cedaf7448c77a44dc80bf0...b4f5ffa3a4ef36ef1cfdf06ef46ebe02c9233efd,1,7,0,7,1,2010-11-09 16:50:01,2010-11-09 16:50:01
3e6e773ee430b61ebb0cbc060fe8e8517ba2398c...0acda4e6d781d1ff81a8fedf9b51a8ed958ac3d5,1,9,9,18,2,2010-11-10 18:42:08,2010-11-10 18:42:08
3e6e773ee430b61ebb0cbc060fe8e8517ba2398c...dbf5897d45846ec019c5847328aaa485a5dc7a48,1,2,2,4,1,2010-11-10 18:35:55,2010-11-10 18:35:55
dbf5897d45846ec019c5847328aaa485a5dc7a48...82fbc63e7cd13d287147389132b4fe6f62fb798c,1,1,1,2,1,2010-11-10 18:37:41,2010-11-10 18:37:41
eed0ed13cf3e2f397a6d63f79f377d2e55d0656a...5a9526231e9a541adfae8e03b33dc1ba33cc76de,4,44,19,63,19,2010-11-10 21:03:32,2010-11-10 21:03:32
5a9526231e9a541adfae8e03b33dc1ba33cc76de...af8370b1e2ff5681858b855f0cb816e9197b1230,2,36,39,75,14,2010-11-10 21:22:04,2010-11-10 21:22:04
af8370b1e2ff5681858b855f0cb816e9197b1230...c9e24c3b67c7bd3ba224df49047a007351881b57,2,7,5,12,6,2010-11-11 00:14:54,2010-11-11 00:14:05
c9e24c3b67c7bd3ba224df49047a007351881b57...21bed454ab2486c9b4017d6f568675189fae270b,1,2,2,4,1,2010-11-11 01:39:18,2010-11-11 01:39:18
21bed454ab2486c9b4017d6f568675189fae270b...57e5be0251452e86258d49aae0ad6ec8d725730f,1,1,1,2,1,2010-11-11 02:41:45,2010-11-11 02:41:45
57e5be0251452e86258d49aae0ad6ec8d725730f...b337c99bedb463a630983caabf4bef23f57a8115,1,1,1,2,1,2010-11-11 02:44:07,2010-11-11 02:44:07
b337c99bedb463a630983caabf4bef23f57a8115...483db509ab777168e9e7b635ba93d90c29489039,1,1,1,2,1,2010-11-11 04:12:54,2010-11-11 04:12:54
483db509ab777168e9e7b635ba93d90c29489039...1a499bf7dcb6b74e6f1ff98e0936683cb773924b,1,8,4,12,2,2010-11-11 06:30:02,2010-11-11 06:30:02
1a499bf7dcb6b74e6f1ff98e0936683cb773924b...885c0fc039d4a911cf459797e0f988b32a5a1bec,2,26,1,27,2,2010-11-11 06:30:21,2010-11-11 06:30:21
885c0fc039d4a911cf459797e0f988b32a5a1bec...5d50b728f8a6646b3079d3f7bbb360b2b03d83a6,6,16,14,30,12,2010-11-11 06:47:15,2010-11-11 06:47:15
5d50b728f8a6646b3079d3f7bbb360b2b03d83a6...e071f68739aed3f26832e0a9a4a2afb75167fc22,1,4,0,4,2,2010-11-11 06:54:37,2010-11-11 06:54:37
e071f68739aed3f26832e0a9a4a2afb75167fc22...500c043e5476bb01c24950c9403a8e1166e5aa35,2,7,1,8,2,2010-11-11 14:02:43,2010-11-11 14:02:43
500c043e5476bb01c24950c9403a8e1166e5aa35...9792696d00226f33765277be7a9150bf08ef9ee8,2,27,5,32,7,2010-11-11 17:44:20,2010-11-11 17:44:20
9792696d00226f33765277be7a9150bf08ef9ee8...6af410dde7ede94643e9cd291ac43ee873729c69,1,22,9,31,4,2010-11-11 19:35:26,2010-11-11 19:35:18
6af410dde7ede94643e9cd291ac43ee873729c69...4802735f52f8df858fe3296a8699608eb2a5d839,1,5,0,5,2,2010-11-11 20:38:14,2010-11-11 20:36:15
4802735f52f8df858fe3296a8699608eb2a5d839...1d7b115d8e4914cb3c65f1ad34b379a7b1b9389f,1,1,1,2,1,2010-11-11 20:38:14,2010-11-11 20:37:36
1d7b115d8e4914cb3c65f1ad34b379a7b1b9389f...e99ab8716ac95e3b6497cde4ab76dfbe55bea109,2,9,3,12,4,2010-11-11 20:53:26,2010-11-11 20:53:26
e99ab8716ac95e3b6497cde4ab76dfbe55bea109...ee4177546994b7170de0a702f482e2e85e575286,3,44,35,79,20,2010-11-12 04:09:20,2010-11-12 04:09:04
ee4177546994b7170de0a702f482e2e85e575286...5ab5378895f27c487094db1187d79400ca3830e0,2,3,2,5,4,2010-11-12 14:20:09,2010-11-12 14:20:09
ee4177546994b7170de0a702f482e2e85e575286...6d13b136767cb84d92fa22d7ad8138164c8cdbef,1,6,2,8,3,2010-11-12 14:12:00,2010-11-12 14:11:48
361208f1e68055a3f49a826cde3366a3a551c237...ae7920654387186866eb78a0507b1e7aef368253,3,5,5,10,3,2010-11-12 15:56:00,2010-11-12 15:49:12
ae7920654387186866eb78a0507b1e7aef368253...8d3642f2348faa78fdc0d575ae9026a1abd6b46a,1,5,5,10,2,2010-11-12 20:50:54,2010-11-12 20:50:54
8d3642f2348faa78fdc0d575ae9026a1abd6b46a...8c11db14876737c871cf3600b8dbb2ee2dca9a91,5,28,12,40,7,2010-11-12 21:09:14,2010-11-12 21:09:14
ae7920654387186866eb78a0507b1e7aef368253...50fb799a72703a1d23587d7234401b0e496e40ae,4,13,9,22,10,2010-11-12 20:33:30,2010-11-12 20:33:30
0b6368da8854ffb5860c4fcc08628773a2c797af...f5f012c46d02e4dac2202605c3444f4c6c6eaf4c,6,36,4,40,14,2010-11-12 23:03:06,2010-11-12 23:03:06
f5f012c46d02e4dac2202605c3444f4c6c6eaf4c...195b62c1e86fc00b05b5711886afabca43a48b51,2,18,16,34,16,2010-11-12 23:08:51,2010-11-12 23:08:51
195b62c1e86fc00b05b5711886afabca43a48b51...c0b32b52fdf63b0cf6d7468efa9f24efdc18c741,2,124,121,245,72,2010-11-12 23:16:49,2010-11-12 23:16:49
c0b32b52fdf63b0cf6d7468efa9f24efdc18c741...1dde63e9b19cb311734c29300058f0b9a4b05c32,2,88,86,174,50,2010-11-12 23:22:19,2010-11-12 23:22:19
1dde63e9b19cb311734c29300058f0b9a4b05c32...50216bd217c8f3d6972dd26583092c89b16079c8,4,16,9,25,12,2010-11-13 01:35:36,2010-11-13 01:35:36
50216bd217c8f3d6972dd26583092c89b16079c8...57e6a4f575eb2a08dcf6f0f6c665d7fb2a3f91f0,1,3,2,5,1,2010-11-13 01:39:51,2010-11-13 01:39:51
57e6a4f575eb2a08dcf6f0f6c665d7fb2a3f91f0...786801bb70fb56374c1661f825418fafe5a4652a,2,38,22,60,2,2010-11-13 01:46:02,2010-11-13 01:46:02
786801bb70fb56374c1661f825418fafe5a4652a...dc0aff562c04d63bbfab780bb8076dea01a7fe6e,1,1,1,2,1,2010-11-13 01:53:25,2010-11-13 01:53:25
dc0aff562c04d63bbfab780bb8076dea01a7fe6e...9f5e46b49246ea5c887c39e8aae8806e2a692173,5,131,81,212,8,2010-11-13 03:45:19,2010-11-13 03:45:03
9f5e46b49246ea5c887c39e8aae8806e2a692173...e58d6da4041c6950edf2fc63920b6877069578c2,1,4,0,4,1,2010-11-13 04:41:41,2010-11-13 04:41:41
e58d6da4041c6950edf2fc63920b6877069578c2...4598eae43f65f749d12f676d13cf2d9d13516603,1,2,0,2,2,2010-11-13 06:25:05,2010-11-13 06:25:05
4598eae43f65f749d12f676d13cf2d9d13516603...5ec52a8161f4616095edbfaabed679e1b9697058,2,9,19,28,9,2010-11-13 18:02:48,2010-11-13 18:02:48
5ec52a8161f4616095edbfaabed679e1b9697058...dad0b0bb254e03dad46e72e331fd0f6a4eaab9c3,4,6,1,7,4,2010-11-13 18:03:47,2010-11-13 18:03:47
dad0b0bb254e03dad46e72e331fd0f6a4eaab9c3...62d48d63dd1381d10b0d8601152e2e6c94c14f85,6,37,19,56,21,2010-11-13 18:04:48,2010-11-13 18:04:48
4598eae43f65f749d12f676d13cf2d9d13516603...483a3b9bb70917f77570dc0859b67b576f0c6932,1,2,0,2,1,2010-11-13 18:00:53,2010-11-13 17:59:13
9a192134e6f2946ac07d2c530a3f00bf5856e632...ae26b3329ed8fdd4afe74e37679a76ba9639c570,4,8,0,8,4,2010-11-13 18:12:26,2010-11-13 18:12:26
ae26b3329ed8fdd4afe74e37679a76ba9639c570...eaec449b9e2e7a93a84baed86cf8a509c3066a3a,7,165,81,246,30,2010-11-13 22:42:41,2010-11-13 22:42:41
ae26b3329ed8fdd4afe74e37679a76ba9639c570...1a4326a49d7f75ffacda357fa7c5660070dbfe53,1,9,1,10,1,2010-11-13 19:27:10,2010-11-13 19:26:52
1a4326a49d7f75ffacda357fa7c5660070dbfe53...64298fd32068b3382bb2852b70b620cd0a7c978c,2,4,4,8,2,2010-11-13 21:16:12,2010-11-13 21:16:12
be441eef860e873382582e6f2dff84b1b2538fa3...718a1407d709333781475695a0ce6131a11bf789,2,28,7,35,7,2010-11-13 23:32:41,2010-11-13 23:32:41
718a1407d709333781475695a0ce6131a11bf789...a69a19c88d2ea2069b82a9cb943e53cd7f1391c4,1,3,9,12,2,2010-11-14 21:30:49,2010-11-14 21:30:49
a69a19c88d2ea2069b82a9cb943e53cd7f1391c4...8b49740bf9f86ef0b399994c7392f7b3e1185a08,9,449,111,560,62,2010-11-15 03:28:04,2010-11-15 03:28:04
718a1407d709333781475695a0ce6131a11bf789...6b65de25979668b060b66a5beb498c0e2664bd9e,1,1,1,2,1,2010-11-14 04:29:00,2010-11-14 04:29:00
6b65de25979668b060b66a5beb498c0e2664bd9e...8450572c054a19aace4b962b97fafc0c58eacfe2,2,49,3,52,6,2010-11-14 06:15:19,2010-11-14 06:15:19
8450572c054a19aace4b962b97fafc0c58eacfe2...2c9fe6b42795a126a5bc24d9810e4e25b8e98a82,4,56,15,71,13,2010-11-14 06:42:36,2010-11-14 06:42:36
2c9fe6b42795a126a5bc24d9810e4e25b8e98a82...2ce44e8c85960ec6fb6635840e46048adf7bf319,4,73,18,91,9,2010-11-14 06:57:27,2010-11-14 06:57:27
2ce44e8c85960ec6fb6635840e46048adf7bf319...fdf88415c25ebac57b17e9a6cd4a200a49d09b10,1,9,3,12,5,2010-11-14 12:45:25,2010-11-14 12:44:57
fdf88415c25ebac57b17e9a6cd4a200a49d09b10...dce045af12ae97aad31ec50e1029ae43b5e91801,2,11,2,13,4,2010-11-15 01:40:46,2010-11-15 01:40:46
dce045af12ae97aad31ec50e1029ae43b5e91801...f46bea25575879496cc53ae2ed1569088cbd18f9,1,41,0,41,1,2010-11-15 01:55:17,2010-11-15 01:55:17
f46bea25575879496cc53ae2ed1569088cbd18f9...3e418683caf82178378f5eee5540343bf95b2462,2,5,5,10,5,2010-11-15 02:12:41,2010-11-15 02:12:41
1abddd0ccad6f68e7510239185cd2078398b16ae...b683f36c7dbb006a853b6002188926337db0c5b4,3,14,11,25,7,2010-11-15 15:22:08,2010-11-15 15:22:08
b683f36c7dbb006a853b6002188926337db0c5b4...999ae136296ea187092c561be1d3081d3ca2e88a,6,19,0,19,9,2010-11-15 15:22:20,2010-11-15 15:22:20
999ae136296ea187092c561be1d3081d3ca2e88a...9730ebd66f1e386fe4bae6b969a06927d9bcaf22,2,24,14,38,22,2010-11-15 17:05:49,2010-11-15 17:05:40
9730ebd66f1e386fe4bae6b969a06927d9bcaf22...3e55d0d0cc4136dc949cc4325952e93c9ab75306,1,22,0,22,1,2010-11-15 17:15:02,2010-11-15 17:14:37
3e55d0d0cc4136dc949cc4325952e93c9ab75306...0813c481afb6f6d8f9736df84351e237ef31ee5f,1,6,5,11,3,2010-11-15 19:22:00,2010-11-15 19:22:00
0813c481afb6f6d8f9736df84351e237ef31ee5f...04bd362cd6bd5ac6fd331ab3218481d399e8acbc,2,6,5,11,6,2010-11-15 21:03:56,2010-11-15 21:03:56
0813c481afb6f6d8f9736df84351e237ef31ee5f...56f4efb5dde5664071dd5016fe40f74ae4521ec2,1,17,3,20,4,2010-11-15 21:00:41,2010-11-15 21:00:41
0813c481afb6f6d8f9736df84351e237ef31ee5f...b577363aee00670bcffa5870708ab534ec4bf886,3,0,62,62,5,2010-11-15 19:39:56,2010-11-15 19:10:17
b577363aee00670bcffa5870708ab534ec4bf886...1bb47c4a9289e24cb9593b274540b1d7640f53f6,1,43,6,49,5,2010-11-15 19:39:56,2010-11-15 19:10:28
1bb47c4a9289e24cb9593b274540b1d7640f53f6...1cafbccecade5457bb9a637619a34055c2936fbf,2,343,277,620,54,2010-11-15 19:39:56,2010-11-15 19:39:42
1cafbccecade5457bb9a637619a34055c2936fbf...94ba794b852279ac73c40b4c924f8b4487b2da8b,4,168,36,204,31,2010-11-15 20:10:31,2010-11-15 20:10:31
94ba794b852279ac73c40b4c924f8b4487b2da8b...c220a4a7679b9ffc6e920bd023742b41107cfcba,1,0,18,18,1,2010-11-15 20:26:06,2010-11-15 20:26:06
16d9785166314fbfb31ea2ede0f06f2951b4b027...62eaedd3d21e9778c220e022f28eb67d67e81d8d,4,163,9,172,14,2010-11-16 03:13:48,2010-11-16 03:13:48
16d9785166314fbfb31ea2ede0f06f2951b4b027...48ad70487a5e0e4ba5b6399e01dedcb1702e235d,4,54,5,59,11,2010-11-15 21:36:01,2010-11-15 21:19:10
48ad70487a5e0e4ba5b6399e01dedcb1702e235d...a0de8044927534fcd80aa6f66f0be344a1c8505d,7,294,250,544,8,2010-11-15 21:36:02,2010-11-15 21:23:56
a0de8044927534fcd80aa6f66f0be344a1c8505d...62878d24b7b99c13f914f8d992d38f246f0bbb57,6,26,26,52,24,2010-11-15 21:36:04,2010-11-15 21:35:46
62878d24b7b99c13f914f8d992d38f246f0bbb57...8f0e8a2eb16b788ea805de1cc4299a6dc67075c4,3,27,24,51,9,2010-11-15 21:43:04,2010-11-15 21:43:04
8f0e8a2eb16b788ea805de1cc4299a6dc67075c4...35386e6fd93d712abd6c122c81200695a3a99a26,1,9,3,12,4,2010-11-15 21:45:51,2010-11-15 21:45:51
35386e6fd93d712abd6c122c81200695a3a99a26...8f726a40b832928200c147b963378a9a52d00cac,2,6,1,7,2,2010-11-15 22:23:28,2010-11-15 22:23:28
8f726a40b832928200c147b963378a9a52d00cac...b717404a1aca89d6dd75fc9c8c3f08277b4c19cb,1,1,1,2,1,2010-11-15 23:49:11,2010-11-15 23:47:52
a4a1c54181f79f04addfbe1e9588051f123ee4d0...80f2d635e05eb93d9d6907e3278606ede384f6b6,4,23,18,41,10,2010-11-16 03:55:19,2010-11-16 03:55:19
80f2d635e05eb93d9d6907e3278606ede384f6b6...62206631c02076f6c0537e4f6b63c4c836a8458c,2,147,147,294,2,2010-11-16 03:58:09,2010-11-16 03:58:09
62206631c02076f6c0537e4f6b63c4c836a8458c...df434530b2417ca9f4277d3218994084df04f539,2,4,0,4,2,2010-11-16 03:59:48,2010-11-16 03:59:48
df434530b2417ca9f4277d3218994084df04f539...ff803376640491d2b89b6dd11239be120404c8e8,1,2,2,4,1,2010-11-16 04:05:39,2010-11-16 04:05:39
ff803376640491d2b89b6dd11239be120404c8e8...92a84418550cf3e4d928d477613d505ad7f47145,1,6,5,11,6,2010-11-16 15:22:26,2010-11-16 15:22:26
ff803376640491d2b89b6dd11239be120404c8e8...fb109a067073d86dbf51baf093cf1820559e3674,3,161,9,170,9,2010-11-16 08:10:57,2010-11-16 08:10:22
fb109a067073d86dbf51baf093cf1820559e3674...8bf24aae947f8799fbd4fc6bbccff972d62f525d,1,1,1,2,1,2010-11-16 12:30:22,2010-11-16 12:30:22
8bf24aae947f8799fbd4fc6bbccff972d62f525d...b31047a12f2f92b656f2d17fc3789fb5bf635955,1,2,2,4,1,2010-11-16 14:56:00,2010-11-16 14:56:00
81efeaa56661998e0c891fed6ab50e7f488d923d...c9b2c8fd58a1c209016c3891b694c17802b940b9,1,2,4,6,4,2010-11-16 18:43:27,2010-11-16 18:43:27
c9b2c8fd58a1c209016c3891b694c17802b940b9...316dc20e0226ce73a1ca597f8ea75ecbc798e432,2,4,0,4,4,2010-11-16 18:43:40,2010-11-16 18:43:40
316dc20e0226ce73a1ca597f8ea75ecbc798e432...87be2c5e2a03b89adcd38a483bbb0fd8aed2c359,1,1,1,2,1,2010-11-16 19:19:23,2010-11-16 19:19:23
87be2c5e2a03b89adcd38a483bbb0fd8aed2c359...f8cc8e608efdf1fd685c823cfb06c6cd2be88218,2,6,14,20,3,2010-11-16 21:27:26,2010-11-16 21:27:26
f8cc8e608efdf1fd685c823cfb06c6cd2be88218...416127768f33f1945a70698f8cfcc648c750f7cd,4,33,27,60,10,2010-11-16 21:40:56,2010-11-16 21:40:56
87be2c5e2a03b89adcd38a483bbb0fd8aed2c359...7f0b3ac99cf014112ff261a92b88c30616ca61d4,1,6,4,10,3,2010-11-16 19:44:39,2010-11-16 16:15:47
7f0b3ac99cf014112ff261a92b88c30616ca61d4...598af81eaa74d1ee0a398b48f3c8174c7e643098,2,36,1,37,4,2010-11-16 19:44:39,2010-11-16 16:24:44
598af81eaa74d1ee0a398b48f3c8174c7e643098...7a16417a8d925f38a56c8e4ded8597508552ffd5,1,2,1,3,1,2010-11-16 19:44:39,2010-11-16 19:44:31
7a16417a8d925f38a56c8e4ded8597508552ffd5...27fa38022550de89b2b2d61a308fa6270fb32e76,1,0,15,15,1,2010-11-16 20:01:31,2010-11-16 20:01:31
27fa38022550de89b2b2d61a308fa6270fb32e76...778d26e20c75ade65dc8b3a57d60d61651947df6,1,1,1,2,1,2010-11-16 21:11:38,2010-11-16 21:11:38
778d26e20c75ade65dc8b3a57d60d61651947df6...2603a9632c21f9e56e780f57b15313ed9d8810ff,3,67,9,76,13,2010-11-16 21:11:43,2010-11-16 21:11:43
2603a9632c21f9e56e780f57b15313ed9d8810ff...5835366b459f77c0135438837ab298c3f3483154,2,43,4,47,4,2010-11-24 22:15:37,2010-11-24 22:15:37
2603a9632c21f9e56e780f57b15313ed9d8810ff...dabefb051409d8c1045aa669668a3059ceb1d0e3,1,0,4,4,3,2010-11-16 21:58:14,2010-11-16 21:58:14
5a5ac5bc7d4a36b0da86c8e72a1a8c8e11ac386b...86a7618917f29504edec584c34397fa3c663a7b6,6,45,12,57,16,2010-11-17 18:59:29,2010-11-17 18:59:29
86a7618917f29504edec584c34397fa3c663a7b6...f8cd15152b2a7d50c24b98f502144a4fad60a336,1,58,18,76,12,2010-11-17 19:15:22,2010-11-17 19:15:22
f8cd15152b2a7d50c24b98f502144a4fad60a336...ec5f5befbecf4285dd5324225efa08a7baa6129c,1,1,0,1,1,2010-11-17 19:26:51,2010-11-17 19:26:51
ec5f5befbecf4285dd5324225efa08a7baa6129c...4c11954523aeac6f3036df8f2fe4e9348c295a7f,1,1,0,1,1,2010-11-17 19:58:35,2010-11-17 19:58:35
746be4b0fb997c9c95daa4ad2c11d71a13d67495...2382b5281059aabdd5c95d54f26a5bb8ceceaebb,1,2,2,4,2,2010-11-24 23:49:19,2010-11-24 23:49:19
2382b5281059aabdd5c95d54f26a5bb8ceceaebb...45b8d2394386e0d9d28fcb4b56b9cda0eff42434,2,4,43,47,4,2010-11-25 02:41:31,2010-11-25 02:41:31
dabefb051409d8c1045aa669668a3059ceb1d0e3...a2e439faac56aac4ddc08e61fe7d63884ff600b7,1,3,1,4,2,2010-11-17 00:08:08,2010-11-17 00:08:08
a2e439faac56aac4ddc08e61fe7d63884ff600b7...fcb5790e7528a101a49c52e442ded0e2b7a043d6,4,11,3,14,4,2010-11-17 00:09:43,2010-11-17 00:09:43
fcb5790e7528a101a49c52e442ded0e2b7a043d6...7721712824c580c3a95184009d23dd7c7e6d7a78,2,147,105,252,5,2010-11-17 04:15:00,2010-11-17 04:15:00
7721712824c580c3a95184009d23dd7c7e6d7a78...dc5673fd7603f761e771622365eaf5a7237baf60,2,6,2,8,3,2010-11-17 04:15:50,2010-11-17 04:15:50
dc5673fd7603f761e771622365eaf5a7237baf60...e39c0ca392916eb23fd84ee512e7625cd03d186b,1,6,0,6,1,2010-11-17 04:18:32,2010-11-17 04:18:32
e39c0ca392916eb23fd84ee512e7625cd03d186b...70d2689d231e49b2ba4a3071925408b4fda0970a,5,58,24,82,20,2010-11-17 06:53:52,2010-11-17 06:53:52
4c11954523aeac6f3036df8f2fe4e9348c295a7f...ba41e4bec26ef4c0c9722db6eec9641c093cbb2e,1,23,1,24,2,2010-11-18 03:30:37,2010-11-18 03:30:37
ba41e4bec26ef4c0c9722db6eec9641c093cbb2e...6d53776029ef1711772fcc5d41fbfde5c75b97b6,8,154,62,216,33,2010-11-18 03:31:38,2010-11-18 03:31:38
4c11954523aeac6f3036df8f2fe4e9348c295a7f...05218bfa2730d6c0aff8f84aeb46139b928703e5,4,160,20,180,11,2010-11-17 23:30:24,2010-11-17 23:30:24
05218bfa2730d6c0aff8f84aeb46139b928703e5...8a0def48bb352e8c8d3b6f9f74bccc5f9bb7cfed,2,126,3,129,2,2010-11-17 23:44:32,2010-11-17 23:44:32
8a0def48bb352e8c8d3b6f9f74bccc5f9bb7cfed...0ea9f6dd85ee90ed3c3bfb5260eef5c5b6e2f7f6,1,1,1,2,1,2010-11-17 23:46:40,2010-11-17 23:46:40
0ea9f6dd85ee90ed3c3bfb5260eef5c5b6e2f7f6...65c309a9e59448cbc82a1ad9307442d417d5f076,4,855,176,1031,106,2010-11-18 03:20:45,2010-11-18 03:18:54
45b8d2394386e0d9d28fcb4b56b9cda0eff42434...b4de35c84f5b75d0fbdbda21d5e28e04dd0c5221,1,3,3,6,2,2010-11-25 12:20:39,2010-11-25 12:20:25
45b8d2394386e0d9d28fcb4b56b9cda0eff42434...2ad5b875ded00c77222a520cbe3195718f5d281f,2,45,25,70,15,2010-11-25 03:19:31,2010-11-25 03:19:31
2ad5b875ded00c77222a520cbe3195718f5d281f...b1983295bcb365ab81058e431ca887431833f9a4,1,1,1,2,1,2010-11-25 16:08:44,2010-11-25 16:08:44
b1983295bcb365ab81058e431ca887431833f9a4...76f0389f8c2ede8f4b775b33588b49ac145e23b6,4,17,5,22,12,2010-11-25 16:09:18,2010-11-25 16:09:18
70d2689d231e49b2ba4a3071925408b4fda0970a...cdbdd562f2a1648a684a9547f9b097c1c80ef4c2,1,1,1,2,1,2010-11-17 15:30:22,2010-11-17 15:30:22
70d2689d231e49b2ba4a3071925408b4fda0970a...df1ff6f2b4b9db8d06948ee7acf8afa2f80779ce,2,2,2,4,2,2010-11-17 07:06:54,2010-11-17 07:06:48
c052000bc2de73b6c355a3ef043a3a2ac36f20d2...a409d5c67a5e62056462488249339c0204aae9ec,1,2,0,2,2,2010-11-18 03:55:49,2010-11-18 03:55:49
c052000bc2de73b6c355a3ef043a3a2ac36f20d2...1f7363d8dde4d4bb94a8774dd7b3ce0f8c5a1f7a,2,2,8,10,2,2010-11-18 03:40:31,2010-11-18 03:40:08
1f7363d8dde4d4bb94a8774dd7b3ce0f8c5a1f7a...41f945cb6158ef753fe963fe7b8eb26e0ea2de5d,1,1,1,2,1,2010-11-18 03:43:54,2010-11-18 03:43:54
4020d30e52b9a40e61730a8645e6687662dad6bd...3d2a3d2e5a5d3cd347cfda142398c199c9febf0f,1,1,0,1,1,2010-11-25 16:27:33,2010-11-25 16:27:33
3d2a3d2e5a5d3cd347cfda142398c199c9febf0f...df3077d5aa985e4f5e32b49cfa11b81968da0f2a,1,5,3,8,2,2010-11-25 16:27:56,2010-11-25 16:27:56
df3077d5aa985e4f5e32b49cfa11b81968da0f2a...c0bc0ccf7c3edfad1b29580c2d08af69c8283b70,2,7,2,9,4,2010-11-25 16:32:32,2010-11-25 16:32:32
c0bc0ccf7c3edfad1b29580c2d08af69c8283b70...20f630656c9917b17cb8e1e7afe91cc65691e7b5,2,16,19,35,8,2010-11-25 16:56:20,2010-11-25 16:56:20
20f630656c9917b17cb8e1e7afe91cc65691e7b5...3e6f66004657fd76e890a6cc433a93f80ec6315f,2,4,0,4,2,2010-11-25 17:00:47,2010-11-25 17:00:47
3e6f66004657fd76e890a6cc433a93f80ec6315f...5e970e64bd21b01d9a77cb9c16f3c180d4054456,1,18,17,35,12,2010-11-25 17:17:07,2010-11-25 17:17:07
5e970e64bd21b01d9a77cb9c16f3c180d4054456...fa436b02241f982a435221778efd6ca0512d9173,1,3,2,5,2,2010-11-25 17:34:20,2010-11-25 17:34:20
c5f3c9d8def9680ea7f766c72b16d3f74112a61f...4cbbaffeadbc8f98a36501dffaa7a7432da83567,1,5,5,10,4,2010-11-18 04:38:11,2010-11-18 04:38:11
4cbbaffeadbc8f98a36501dffaa7a7432da83567...1922082d61c0e063985f8768d7ced9056c49670c,1,1,1,2,1,2010-11-18 07:59:28,2010-11-18 07:59:28
1922082d61c0e063985f8768d7ced9056c49670c...cd93cf90c778712a47026ab5ddc1418060bd8bd9,1,2,1,3,1,2010-11-18 08:18:07,2010-11-18 08:18:07
cd93cf90c778712a47026ab5ddc1418060bd8bd9...8e4acff269f3827b924191ab4b073959c69b424e,2,29,14,43,5,2010-11-18 14:56:21,2010-11-18 14:56:21
8e4acff269f3827b924191ab4b073959c69b424e...a836da437baa104fef7e9ae818d5bbe0643f8bae,1,56,16,72,13,2010-11-18 14:57:01,2010-11-18 14:57:01
a836da437baa104fef7e9ae818d5bbe0643f8bae...57b800c6e5b6491efec53b580bbccedbf510501a,1,28,16,44,9,2010-11-18 15:10:59,2010-11-18 15:10:50
57b800c6e5b6491efec53b580bbccedbf510501a...0ec17697cbafabb8a82eec469c44a60a103e4dc3,2,34,22,56,13,2010-11-18 15:58:31,2010-11-18 15:58:31
0ec17697cbafabb8a82eec469c44a60a103e4dc3...1864335cc16917e6a836916a23c839aa1ef011c5,1,16,6,22,6,2010-11-18 17:19:08,2010-11-18 17:19:08
1864335cc16917e6a836916a23c839aa1ef011c5...2478a98d7992a79b783250efe64647d8fd1374cf,1,3,1,4,2,2010-11-18 17:35:31,2010-11-18 17:35:31
2478a98d7992a79b783250efe64647d8fd1374cf...7cc92cce7457d4915e1b65e9809130e8a79007a6,2,7,4,11,3,2010-11-18 18:05:02,2010-11-18 18:05:02
7cc92cce7457d4915e1b65e9809130e8a79007a6...f8069a47f0732ef04f8f467bf6663ee1f032e198,1,9,1,10,1,2010-11-18 19:34:51,2010-11-18 19:34:37
f8069a47f0732ef04f8f467bf6663ee1f032e198...53f4dce28957654dfcd3ab5e000b003616ed7ee2,1,2,1,3,1,2010-11-18 20:17:32,2010-11-18 20:17:11
53f4dce28957654dfcd3ab5e000b003616ed7ee2...f9d7cdab637002f13e6209192de0599b83dd4afd,9,123,91,214,23,2010-11-18 22:59:20,2010-11-18 22:58:57
f9d7cdab637002f13e6209192de0599b83dd4afd...e23fab42009c21351d97171ff0bec8de15c1bd98,1,21,5,26,5,2010-11-19 09:31:24,2010-11-19 09:30:45
e23fab42009c21351d97171ff0bec8de15c1bd98...348f12125c9303e1e2c8f439459bd97e57646641,6,28,27,55,26,2010-11-19 10:33:12,2010-11-19 10:32:57
348f12125c9303e1e2c8f439459bd97e57646641...8b4deb5e8f3202b85110e5a30423d100f31c5b76,3,10,5,15,6,2010-11-19 16:05:29,2010-11-19 16:05:29
8b4deb5e8f3202b85110e5a30423d100f31c5b76...a1a2b5dec4f9a986b139a88a0c0fbabf620068f4,3,7,7,14,5,2010-11-19 16:15:35,2010-11-19 16:15:35
a1a2b5dec4f9a986b139a88a0c0fbabf620068f4...5a49494a9c2ebb44fc7dbefae08e50e2fa9c2a97,1,9,4,13,1,2010-11-19 16:24:21,2010-11-19 16:24:14
fa436b02241f982a435221778efd6ca0512d9173...78e92c49fed71f98bce8f67aedaa038b9a7569fe,2,28,6,34,6,2010-11-26 14:28:32,2010-11-26 14:28:17
78e92c49fed71f98bce8f67aedaa038b9a7569fe...b4be994a8e71777e3618cde219ec6c8220d40239,1,1,1,2,1,2010-11-26 15:10:50,2010-11-26 15:10:50
b4be994a8e71777e3618cde219ec6c8220d40239...a1fe753a64c254db978ed36a141cb8863fad1170,1,1,0,1,1,2010-11-26 15:15:11,2010-11-26 15:14:49
fa436b02241f982a435221778efd6ca0512d9173...99196081b21c6cfa6281728939b1cfc4e123b79a,1,6,6,12,2,2010-11-25 19:33:24,2010-11-25 19:33:24
99196081b21c6cfa6281728939b1cfc4e123b79a...ce93e7c824b5c3c6d68daca29c87af77cba3a224,20,614,203,817,95,2010-11-26 23:18:24,2010-11-26 23:18:24
5a49494a9c2ebb44fc7dbefae08e50e2fa9c2a97...43a59f220aa24624a02b4682c7c3574de03cf508,2,38,20,58,12,2010-11-20 19:46:28,2010-11-20 19:46:28
43a59f220aa24624a02b4682c7c3574de03cf508...8c6075dc6123816a1426c593d02836e0dbdbeed7,8,197,126,323,52,2010-11-20 20:29:49,2010-11-20 20:29:49
5a49494a9c2ebb44fc7dbefae08e50e2fa9c2a97...43003e02356aa4b3f0c20e2f8a93d9cfc63a0160,1,9,3,12,3,2010-11-19 20:43:27,2010-11-19 20:43:13
43003e02356aa4b3f0c20e2f8a93d9cfc63a0160...45d8f685e59901edac5dcffc1083bdf6fb6c7e3b,1,13,8,21,1,2010-11-19 23:03:03,2010-11-19 23:02:48
45d8f685e59901edac5dcffc1083bdf6fb6c7e3b...e89e9932e890061fa3c8712f629b919e75f58263,1,36,0,36,1,2010-11-20 06:15:38,2010-11-20 06:15:38
a4f1749c1acdee3576c723471211d182dc514e24...6c3eb1ddd4c07414c922504132fcb8c689e10c08,18,200,99,299,71,2010-11-27 20:25:08,2010-11-27 20:25:08
6c3eb1ddd4c07414c922504132fcb8c689e10c08...fedd8734b171f3a5999a472fd985edd44ef514ad,3,8,0,8,5,2010-11-27 20:37:16,2010-11-27 20:37:16
fedd8734b171f3a5999a472fd985edd44ef514ad...fe11f8506b4230b07600d50621f57c0b0c5a573e,2,7,8,15,3,2010-11-27 20:40:57,2010-11-27 20:40:57
fe11f8506b4230b07600d50621f57c0b0c5a573e...278fba2dd480bee6f5cc2c4e4e2a97297230ef14,8,14,8,22,13,2010-11-27 21:14:47,2010-11-27 21:14:47
278fba2dd480bee6f5cc2c4e4e2a97297230ef14...8b848b1b21134772863143ed21c60a66df4bacea,1,4,2,6,3,2010-11-27 22:30:43,2010-11-27 22:30:43
8b848b1b21134772863143ed21c60a66df4bacea...bf532c4638a2b066632fd327fd842da6a4a5710c,4,59,3,62,7,2010-11-27 22:30:51,2010-11-27 22:30:51
bf532c4638a2b066632fd327fd842da6a4a5710c...edd80da26bdf9df17dfb764f593fde443c86ca2b,1,5,0,5,1,2010-11-27 22:39:16,2010-11-27 22:39:16
edd80da26bdf9df17dfb764f593fde443c86ca2b...090f393f2b275bc70b0adc70ac51e8ea6a56d36b,1,1,1,2,1,2010-11-27 22:49:26,2010-11-27 22:49:26
090f393f2b275bc70b0adc70ac51e8ea6a56d36b...8b391b1e378cbe3b7b06a62a97a6bf58f553f3a3,1,94,93,187,1,2010-11-27 23:10:59,2010-11-27 23:10:59
e89e9932e890061fa3c8712f629b919e75f58263...fe9ffe854fd8fa7b4c0e7e22cd8cca978bd1c71f,1,2,4,6,1,2010-11-20 21:20:23,2010-11-20 21:20:23
8b391b1e378cbe3b7b06a62a97a6bf58f553f3a3...83a58aa700ad04d428240328e893f7c5d26cb893,13,59,17,76,25,2010-11-28 15:13:01,2010-11-28 15:13:01
8b391b1e378cbe3b7b06a62a97a6bf58f553f3a3...1dd7b70255ddfce6305a059257ebf40728e39d88,1,1,0,1,1,2010-11-28 04:48:14,2010-11-28 04:48:14
1dd7b70255ddfce6305a059257ebf40728e39d88...d6d1539385ce86265b3d111fa7a16c3fe79c103b,1,1,1,2,1,2010-11-28 04:48:28,2010-11-28 04:48:28
d6d1539385ce86265b3d111fa7a16c3fe79c103b...d20dc464bf2edbfa5ff54cc478b0e3100b1213d5,2,8,8,16,7,2010-11-28 04:48:42,2010-11-28 04:48:42
d20dc464bf2edbfa5ff54cc478b0e3100b1213d5...38e3a493f47c76ad36a5109ce01ff8591244bef9,1,4,4,8,2,2010-11-28 05:07:55,2010-11-28 05:07:55
38e3a493f47c76ad36a5109ce01ff8591244bef9...c7de5247bfc410f2ec3b4fc9092e87491f826602,2,1,1,2,2,2010-11-28 07:07:25,2010-11-28 07:07:25
c7de5247bfc410f2ec3b4fc9092e87491f826602...3d067a99fe383091044d84a4b93b7d9a29ca9252,5,22,15,37,8,2010-11-28 07:07:38,2010-11-28 07:07:38
3d067a99fe383091044d84a4b93b7d9a29ca9252...9a0966901568bdf9aa145beac7321a042a46cbd4,1,29,7,36,13,2010-11-28 07:27:45,2010-11-28 07:27:45
9a0966901568bdf9aa145beac7321a042a46cbd4...d4ab06dc8739dc558c576fb296530c91893ec3f7,1,0,5,5,3,2010-11-28 07:34:47,2010-11-28 07:34:47
d4ab06dc8739dc558c576fb296530c91893ec3f7...f3fe0ba50857a97119b0267d86a7d7848af2f83e,1,10,1,11,2,2010-11-28 07:35:14,2010-11-28 07:35:14
f3fe0ba50857a97119b0267d86a7d7848af2f83e...d4774cef292e8ba01c77e99426b2a5c74bcd2a1d,1,3,2,5,3,2010-11-28 08:14:43,2010-11-28 08:14:43
d4774cef292e8ba01c77e99426b2a5c74bcd2a1d...2016fe2e3da8becf4a463ca8464c803efa99e773,1,10,2,12,1,2010-11-28 08:35:44,2010-11-28 08:35:44
2016fe2e3da8becf4a463ca8464c803efa99e773...108401044ce1d7a2ee23a398d4b46d4f602733a6,1,1,1,2,1,2010-11-28 08:36:56,2010-11-28 08:36:56
108401044ce1d7a2ee23a398d4b46d4f602733a6...a8115022f0dc2e437c16695d12faf284ae544f8e,2,15,0,15,3,2010-11-28 08:40:02,2010-11-28 08:40:02
a8115022f0dc2e437c16695d12faf284ae544f8e...f23797cba72900e6e675ac3d644848cbe15ad6c3,1,2,1,3,2,2010-11-28 08:43:19,2010-11-28 08:43:19
f9c798ba761eed0541be22e51834aad7a2564433...11e47198208ae2cc22cf01084209c57100a8d843,3,51,22,73,10,2010-11-21 19:02:13,2010-11-21 19:02:13
11e47198208ae2cc22cf01084209c57100a8d843...b8555c9f52288ee8417dcfe2f1dc7eee98dab205,8,162,70,232,44,2010-11-22 00:36:40,2010-11-22 00:36:40
b8555c9f52288ee8417dcfe2f1dc7eee98dab205...aa27925a6034ab8e2848aad732c74b10a626b09f,2,3,4,7,2,2010-11-22 13:42:39,2010-11-22 13:42:39
fe9ffe854fd8fa7b4c0e7e22cd8cca978bd1c71f...1bdc2ebc3c2fbfb4519eb6cb227ce189a42543d9,2,35,2,37,3,2010-11-20 21:37:33,2010-11-19 13:33:02
1bdc2ebc3c2fbfb4519eb6cb227ce189a42543d9...ef59e0e3e6996b9364c242d60d3e0b3690e93c07,1,32,23,55,7,2010-11-20 22:07:53,2010-11-20 22:07:53
ef59e0e3e6996b9364c242d60d3e0b3690e93c07...f496b7f7f12593baab36a7466297c5f6dfeb984c,1,4,3,7,2,2010-11-20 22:08:57,2010-11-20 22:08:57
f496b7f7f12593baab36a7466297c5f6dfeb984c...e55fa7eb47873abe3236b3e1686d2a337dd6a86a,4,75,4,79,14,2010-11-20 23:02:59,2010-11-20 23:02:59
e55fa7eb47873abe3236b3e1686d2a337dd6a86a...e869a8e02c1209536edd3af6856084ddd2101274,1,21,0,21,1,2010-11-21 04:24:09,2010-11-21 04:24:09
e869a8e02c1209536edd3af6856084ddd2101274...c77901134c84f0a2720ec062841599a291642940,1,2,1,3,2,2010-11-21 06:52:10,2010-11-21 06:52:10
c77901134c84f0a2720ec062841599a291642940...ce28849411d0436c25e7f3d1c32669655919a02f,1,3,2,5,2,2010-11-21 14:44:59,2010-11-21 14:44:59
ce28849411d0436c25e7f3d1c32669655919a02f...33c79655ab44085865b2210a4196978449140f38,2,5,8,13,4,2010-11-21 18:39:14,2010-11-21 18:39:14
33c79655ab44085865b2210a4196978449140f38...6ad12a6bea3ce8468e5d3fadaadefc7697ed756a,1,1,1,2,1,2010-11-22 02:03:06,2010-11-22 02:03:06
6ad12a6bea3ce8468e5d3fadaadefc7697ed756a...99647ebeb059a830da004fbba74fc3a99bc42c21,2,12,4,16,5,2010-11-22 05:53:00,2010-11-22 05:53:00
99647ebeb059a830da004fbba74fc3a99bc42c21...c3c7a22e6370a6099196df87c1a96ab9c00a7068,1,25,1,26,7,2010-11-22 06:03:19,2010-11-22 06:03:19
c3c7a22e6370a6099196df87c1a96ab9c00a7068...a47cae76249e2a2f679a853782d6988d99793471,3,20,11,31,12,2010-11-22 06:10:35,2010-11-22 06:10:35
a47cae76249e2a2f679a853782d6988d99793471...ab7fa6504ce5ff9b3b4ad47f13a1f9aaf2598d3a,1,5,4,9,3,2010-11-22 13:28:38,2010-11-22 13:28:27
fb27aabd1a9d770f777218927f96a05e3d4e5db0...3669bdab40587ab4ed318fc265dfe76ec5ed6eaf,3,4,4,8,4,2010-11-28 15:22:17,2010-11-28 15:22:17
3669bdab40587ab4ed318fc265dfe76ec5ed6eaf...a639200e21ba42700bf23b9952edc05e4d2c882b,3,16,1,17,5,2010-11-28 16:33:00,2010-11-28 16:33:00
a639200e21ba42700bf23b9952edc05e4d2c882b...255040094fec3c32b4574d967966ee3632d8a2bc,2,30,8,38,7,2010-11-28 20:48:54,2010-11-28 20:48:54
255040094fec3c32b4574d967966ee3632d8a2bc...5016bf9d2c7e85e99626d62bdd30532195e935bd,3,6,4,10,6,2010-11-29 00:26:17,2010-11-29 00:26:17
3c4012011c51b2d6755f3f6cf62066528d2c8aa2...02865179be638f0a90d321923b26e9a6656585a8,2,3,1,4,3,2010-11-22 15:35:30,2010-11-22 15:35:30
02865179be638f0a90d321923b26e9a6656585a8...8d368e768dc03b552f526d493fdd17b4388ca561,1,5,1,6,3,2010-11-22 15:38:37,2010-11-22 15:38:37
5016bf9d2c7e85e99626d62bdd30532195e935bd...4d51fefdd85c74a9b13ad0d2ebe837a662d04ed9,1,4,0,4,1,2010-11-29 02:27:57,2010-11-29 02:27:57
5016bf9d2c7e85e99626d62bdd30532195e935bd...f76b8550111ffa926dd39e2cf88763e3b6423862,2,2,2,4,2,2010-11-29 01:23:49,2010-11-29 01:23:33
8d368e768dc03b552f526d493fdd17b4388ca561...eba21ba317f511e51d5d8596c4f1d54a1c0dd08f,7,155,12,167,12,2010-11-23 15:12:31,2010-11-23 15:12:31
8d368e768dc03b552f526d493fdd17b4388ca561...4caaba75371b12885d5410f8b7445948e9dd331d,2,3,3,6,3,2010-11-22 19:11:39,2010-11-22 19:11:39
4caaba75371b12885d5410f8b7445948e9dd331d...6466cb75f3f95fc0c0f0bb3c2e0e8750d6d0ec68,2,28,28,56,11,2010-11-22 20:37:05,2010-11-22 20:37:05
6466cb75f3f95fc0c0f0bb3c2e0e8750d6d0ec68...05873579c2cf45c5f01b2095c5c2509d96d4f0cf,2,9,20,29,6,2010-11-22 20:48:33,2010-11-22 20:48:33
05873579c2cf45c5f01b2095c5c2509d96d4f0cf...4ee5cd3fb20a7e17a56902f6d92b2b8500941ba2,2,172,177,349,72,2010-11-22 21:30:13,2010-11-22 21:30:13
4ee5cd3fb20a7e17a56902f6d92b2b8500941ba2...0553f2eeffbd0e4c19cef5562230b4bc8c8d0f97,1,9,3,12,4,2010-11-22 21:42:00,2010-11-22 21:42:00
0553f2eeffbd0e4c19cef5562230b4bc8c8d0f97...6d745c7834558a030ebcc9e3ea9fc604f744987d,2,14,5,19,6,2010-11-23 00:52:44,2010-11-23 00:52:44
6d745c7834558a030ebcc9e3ea9fc604f744987d...55579ea13671c81508dea967a8053a73f3d03856,1,8,0,8,1,2010-11-23 04:19:18,2010-11-23 04:19:18
55579ea13671c81508dea967a8053a73f3d03856...1608e1497b887f1342aa24692d3fff2a13e9128a,2,69,0,69,2,2010-11-23 07:51:36,2010-11-23 07:51:36
1608e1497b887f1342aa24692d3fff2a13e9128a...95517ebb6850029455a5a3caea953f805e7c9ddc,1,32,22,54,6,2010-11-23 09:15:19,2010-11-23 09:15:19
95517ebb6850029455a5a3caea953f805e7c9ddc...f6a923ca3f54b141b984be622da196ec6ea52b09,8,104,59,163,24,2010-11-23 09:16:04,2010-11-23 09:16:04
f6a923ca3f54b141b984be622da196ec6ea52b09...eb4c54bf5a33c9e4a83c52e5e477393cda0ce5ed,1,1,1,2,1,2010-11-23 13:18:37,2010-11-23 13:18:37
eb4c54bf5a33c9e4a83c52e5e477393cda0ce5ed...b08dcf6e6d1d6118d242845004bcacb0bc168095,1,4,1,5,1,2010-11-23 14:25:24,2010-11-23 14:24:29
62d861d10d5b6b0aa297074112f0f7e019110674...b3e58fe03502ce222cef612db152d5b6831f297a,2,265,265,530,2,2010-11-29 03:49:17,2010-11-29 03:49:17
b3e58fe03502ce222cef612db152d5b6831f297a...b315b239def6098c126df2847a78f5c0c7c7cde0,2,102,102,204,2,2010-11-29 03:50:43,2010-11-29 03:50:43
b315b239def6098c126df2847a78f5c0c7c7cde0...e58e80b7089735dd7eb75b79715ad5b88242e23c,5,58,43,101,13,2010-11-29 04:28:04,2010-11-29 04:28:04
e58e80b7089735dd7eb75b79715ad5b88242e23c...a4728be3a9de01747dfebb4031a9334336c197b9,5,43,58,101,13,2010-11-29 04:41:10,2010-11-29 04:41:10
b08dcf6e6d1d6118d242845004bcacb0bc168095...b82faa5421ae0868c9f0752587f6e3853b6c4a65,1,0,4,4,1,2010-11-23 16:17:45,2010-11-23 16:17:45
b82faa5421ae0868c9f0752587f6e3853b6c4a65...dce215638af6d10c0cec032d9e3f3612e09fd546,4,41,3,44,7,2010-11-23 16:28:49,2010-11-23 16:28:49
dce215638af6d10c0cec032d9e3f3612e09fd546...6905714a1509af0bed788e0adc0a0c6cd4aee773,2,60,2,62,5,2010-11-23 16:56:51,2010-11-23 16:56:51
6905714a1509af0bed788e0adc0a0c6cd4aee773...596b75709acf65f3a6f143ea21cdeb28b8e1742f,3,106,38,144,18,2010-11-23 17:22:10,2010-11-23 17:22:10
a4728be3a9de01747dfebb4031a9334336c197b9...66f0e7c4b0605a61e3548557c96f398cdfc3acde,1,2,2,4,1,2010-11-29 04:44:09,2010-11-29 04:44:09
66f0e7c4b0605a61e3548557c96f398cdfc3acde...631d98fedefc3011339b028caad17ffd77efce57,1,1,1,2,1,2010-11-29 04:44:23,2010-11-29 04:44:23
a4728be3a9de01747dfebb4031a9334336c197b9...9a55939da3cd1b8e01a4b1490592b6b0b481d994,1,2,2,4,2,2010-11-29 04:42:19,2010-11-29 04:41:59
e563770b27d81eb90f2d97c646efa76c7b34064a...1f8009d8d9e0614afa879591c94398a4cf1d612d,2,6,1,7,3,2010-11-23 19:21:19,2010-11-23 19:21:19
1f8009d8d9e0614afa879591c94398a4cf1d612d...d4a2f13447579caccd4e3b0be19da3e6746dec5a,1,2,1,3,1,2010-11-23 19:58:28,2010-11-23 19:58:28
d4a2f13447579caccd4e3b0be19da3e6746dec5a...05c10db550c7a279dd65acb67f1a0fde2aabbe87,3,201,22,223,32,2010-11-23 20:31:30,2010-11-23 20:31:16
05c10db550c7a279dd65acb67f1a0fde2aabbe87...0fc437f55982b3c2b00b3e3ed4b00caedd07c971,3,101,95,196,5,2010-11-24 05:42:19,2010-11-24 05:42:19
0fc437f55982b3c2b00b3e3ed4b00caedd07c971...8b930cb852f4b9eb68036fb3db2ec21568cdb943,3,3,2,5,3,2010-11-24 15:20:34,2010-11-24 15:20:34
8b930cb852f4b9eb68036fb3db2ec21568cdb943...82dbe74c873c0b66252ba85bcb1a082a3b4cc652,1,4,1,5,1,2010-11-24 15:42:22,2010-11-24 15:42:06
82dbe74c873c0b66252ba85bcb1a082a3b4cc652...3a9c12fd7ace36187e0cbba01e27a4c6442841f2,2,3,3,6,3,2010-11-24 15:48:18,2010-11-24 15:47:58
3a9c12fd7ace36187e0cbba01e27a4c6442841f2...d01490797ff684fcd1e07eaf4fbb4e0d15a99dd2,1,15,22,37,1,2010-11-24 18:01:27,2010-11-24 18:01:09
d01490797ff684fcd1e07eaf4fbb4e0d15a99dd2...cda009c77bdd1ef39e5001d003e2e4d0bd9142ad,2,4,0,4,2,2010-11-24 20:01:24,2010-11-24 20:01:24
4da350d1f6704d15e2e3596ee706af85e1990efb...32573ea7aadce6db2ab46e8c235330d60633f8fd,4,94,50,144,26,2010-11-29 15:21:18,2010-11-29 15:21:18
4da350d1f6704d15e2e3596ee706af85e1990efb...4e51d779c611fb9bef4671a01c917cd9c8bf197a,4,19,12,31,5,2010-11-29 06:50:57,2010-11-29 06:50:57
4e51d779c611fb9bef4671a01c917cd9c8bf197a...876a13513b79394de5840e098210c774d9a0201c,1,13,0,13,3,2010-11-29 07:36:54,2010-11-29 07:36:54
3a8ce142a45835fff1122063bab30cc3c9c3961a...e5bd2b123edbdd5c33d2e31238484977c5e36f84,1,3,0,3,1,2010-11-29 15:26:36,2010-11-29 15:26:36
e5bd2b123edbdd5c33d2e31238484977c5e36f84...24e1e55e5e045ffc5f597d264fcc1e40e916a2a7,2,2,2,4,2,2010-11-29 15:45:47,2010-11-29 15:45:47
24e1e55e5e045ffc5f597d264fcc1e40e916a2a7...f51b389f4904ba1ad748e49be76aba96c96ae7ca,1,2,1,3,1,2010-11-29 15:55:21,2010-11-29 15:55:21
f51b389f4904ba1ad748e49be76aba96c96ae7ca...1319d64c6a3d81986202d6fbf64e29894875d586,1,11,11,22,4,2010-11-29 15:57:16,2010-11-29 15:57:16
1319d64c6a3d81986202d6fbf64e29894875d586...21c146794d880a7e3227ef59b5d2d35629c3e291,1,1,1,2,1,2010-11-29 16:02:27,2010-11-29 16:02:27
21c146794d880a7e3227ef59b5d2d35629c3e291...bf3cc2aa0d998f80136394d9d4a03ddea747f2b7,3,6,0,6,4,2010-11-29 16:07:13,2010-11-29 16:07:13
bf3cc2aa0d998f80136394d9d4a03ddea747f2b7...7dd6713944a4d72c05c73b5a4bb195fcad5b3f08,2,16,7,23,7,2010-11-29 18:06:48,2010-11-29 18:06:48
7dd6713944a4d72c05c73b5a4bb195fcad5b3f08...d698cfbbe3beb2045f27f5d47eb6ecdfb86a51db,4,0,4472,4472,4,2010-11-29 18:18:17,2010-11-29 18:18:17
d698cfbbe3beb2045f27f5d47eb6ecdfb86a51db...bfdffff0a4a1f487c2240931963c1682274a6a00,9,131,62,193,16,2010-11-29 19:08:31,2010-11-29 19:08:31
bfdffff0a4a1f487c2240931963c1682274a6a00...a63c9b4ccc65e911f8fa5018192527b45817bfcf,1,2,7,9,3,2010-11-29 19:14:20,2010-11-29 19:14:20
e5bd2b123edbdd5c33d2e31238484977c5e36f84...63cbdf9b3d8eeb91fd4c13abcf53341ca6770c07,1,1,1,2,1,2010-11-29 15:39:28,2010-11-29 15:39:28
a63c9b4ccc65e911f8fa5018192527b45817bfcf...df1ce3043a4911496c8914f367eb95c665daaecd,3,4,3,7,3,2010-11-29 21:05:17,2010-11-29 21:05:17
a63c9b4ccc65e911f8fa5018192527b45817bfcf...5eb70c007216908dbc72298916e26565e20a7ab9,1,1,0,1,1,2010-11-29 19:47:44,2010-11-29 19:42:55
5eb70c007216908dbc72298916e26565e20a7ab9...c83071685f298074c6e18d11803bf6aa3dcc286b,2,7,3,10,3,2010-11-29 19:47:44,2010-11-24 19:27:36
c83071685f298074c6e18d11803bf6aa3dcc286b...e36f6fc8ba0bea1cb5d3bf1b4ed05dd69ed86407,2,35,0,35,3,2010-11-29 19:47:44,2010-11-29 18:50:10
e36f6fc8ba0bea1cb5d3bf1b4ed05dd69ed86407...efa0e8ab4135b55a39af2fed5c4af4455dfdd3e0,2,111,5,116,15,2010-11-29 19:47:44,2010-11-29 19:32:10
efa0e8ab4135b55a39af2fed5c4af4455dfdd3e0...39f598c605c68a88d51e4e2eb136981521d383d4,1,1,1,2,1,2010-11-29 19:47:44,2010-11-29 19:47:08
39f598c605c68a88d51e4e2eb136981521d383d4...f74a27345d154901f0dae0f3de32d8a903a54641,2,56,28,84,7,2010-11-29 20:53:08,2010-11-29 20:53:08
a38d9a4da158e91b7270d40e99dedfdb590dec08...7523f20d84e33b8e22e2643ed1387cd948cf0400,1,1,2,3,1,2010-11-30 02:54:04,2010-11-30 02:54:04
7523f20d84e33b8e22e2643ed1387cd948cf0400...d5c4aad051de7977d3601a0b568b23cf4dbc8b64,1,2,1,3,1,2010-11-30 03:09:07,2010-11-30 03:09:07
d5c4aad051de7977d3601a0b568b23cf4dbc8b64...6e34d849bb6ad27b3cd14e2590738136d30c1d15,1,116,280,396,27,2010-11-30 03:34:42,2010-11-30 03:34:42
6e34d849bb6ad27b3cd14e2590738136d30c1d15...37512ba1818b2881f69f297c3be6439537a303f3,1,37,1,38,3,2010-11-30 03:48:31,2010-11-30 03:48:31
37512ba1818b2881f69f297c3be6439537a303f3...1808b5693904a2e89bfa96dcafdbea5e9d491987,3,21,12,33,15,2010-11-30 04:09:59,2010-11-30 04:09:59
1808b5693904a2e89bfa96dcafdbea5e9d491987...e183f5d1447741fa0c5d9bbb0b82fb6ea9d6bdd5,2,47,22,69,11,2010-11-30 04:50:20,2010-11-30 04:50:20
e183f5d1447741fa0c5d9bbb0b82fb6ea9d6bdd5...47b43cea4188bfa7582e3fbe125f0b10856dd1dd,2,21,16,37,2,2010-11-30 13:21:50,2010-11-30 13:21:50
47b43cea4188bfa7582e3fbe125f0b10856dd1dd...7ca8b464eb4892fc361d6c59cd0bb2e32be1fdc6,1,1,1,2,1,2010-11-30 13:36:00,2010-11-30 13:36:00
7ca8b464eb4892fc361d6c59cd0bb2e32be1fdc6...eb5ac64eeb1b2782cbd3918bc59ad9cdb4996088,2,9,3,12,3,2010-11-30 13:46:51,2010-11-30 13:46:51
eb5ac64eeb1b2782cbd3918bc59ad9cdb4996088...08897a56a74291c04c4970eac3fb16e249390f6e,1,1,0,1,1,2010-11-30 13:51:40,2010-11-30 13:51:40
d0e33a85d7288250b674599f59a4b675a255eb71...6836d1fd52e71e47040b8b7cdf25983c4836fdc9,3,12,11,23,9,2010-11-29 21:09:34,2010-11-29 21:08:58
6836d1fd52e71e47040b8b7cdf25983c4836fdc9...6307bbfb26c01033b6ac688683324e69709f9664,1,0,1,1,1,2010-11-29 21:13:09,2010-11-29 21:13:09
6307bbfb26c01033b6ac688683324e69709f9664...a4eef074ec92dbd46617e287d737779658646ce4,1,5,5,10,3,2010-11-29 21:26:18,2010-11-29 21:26:18
08897a56a74291c04c4970eac3fb16e249390f6e...64bc8df4af845a2d43ecda91049986c49de8bade,2,18,8,26,2,2010-11-30 18:55:29,2010-11-30 18:55:29
08897a56a74291c04c4970eac3fb16e249390f6e...5ff1b641402e88a59f6683a0fde646d711aff1cd,1,10,0,10,2,2010-11-30 17:00:27,2010-11-30 17:00:27
5ff1b641402e88a59f6683a0fde646d711aff1cd...93ec2e1c107be886b975a873a060deb07a496ecb,1,0,1,1,1,2010-11-30 17:02:16,2010-11-30 17:02:16
08897a56a74291c04c4970eac3fb16e249390f6e...243574df74b4d8cda943a8f8ae12751d5bb06205,1,1,1,2,1,2010-11-30 16:10:29,2010-11-30 16:10:29
4b6ae6901a7913d37d308988a9ed8b1b7a41d25f...54eedf9aa4b215e21cc0be989f09d261cb54ee00,2,7,1,8,4,2010-11-30 19:04:48,2010-11-30 19:04:48
54eedf9aa4b215e21cc0be989f09d261cb54ee00...9ccab7add232ba4771581823ced34126262a5c92,3,23,1,24,5,2010-11-30 19:46:18,2010-11-30 19:46:18
9ccab7add232ba4771581823ced34126262a5c92...cf0a35acd42fba3ff4b0287e271078730218ac3b,3,343,30,373,33,2010-11-30 21:29:41,2010-11-30 21:29:41
cf0a35acd42fba3ff4b0287e271078730218ac3b...6395e385fe7072eeb1c6766bf2b333c3063159b9,2,2,2,4,2,2010-12-01 03:58:54,2010-12-01 03:58:54
e818ca30116c768c223619315cfe4b45850dd6d0...7ca96e68babdb0bf990c4b4f0d0d5ddb66aa35c2,1,7,4,11,4,2010-12-01 14:52:37,2010-12-01 14:52:37
7ca96e68babdb0bf990c4b4f0d0d5ddb66aa35c2...d45f04894761f65ae93fdbb69c74bebe540c26b5,4,68,8,76,6,2010-12-01 16:12:28,2010-12-01 16:12:28
d45f04894761f65ae93fdbb69c74bebe540c26b5...6a95937332a6988169d1a9b0224e9ef85febac8c,3,100,27,127,13,2010-12-01 21:22:59,2010-12-01 21:22:42
6a95937332a6988169d1a9b0224e9ef85febac8c...53c8e5e3665e5650aaba28f45d5bd2c6fba96e4b,1,1,1,2,1,2010-12-01 21:39:16,2010-12-01 21:38:43
53c8e5e3665e5650aaba28f45d5bd2c6fba96e4b...28b1cff00dcfa91cc69a3928bae48d840f287714,4,50,7,57,13,2010-12-02 05:29:34,2010-12-02 04:53:52
28b1cff00dcfa91cc69a3928bae48d840f287714...c8fd4df6998e787896af48fd9348dee78390c801,2,2,2,4,2,2010-12-02 18:09:27,2010-12-02 18:09:27
c8fd4df6998e787896af48fd9348dee78390c801...e27946f49ff3faf3d4038502338c934aa2602b6b,3,126,8,134,12,2010-12-03 01:20:11,2010-12-03 01:20:11
e27946f49ff3faf3d4038502338c934aa2602b6b...40db43b6ca5110af97c7d4fafdcaa3f13476f8fd,2,2,3,5,2,2010-12-03 15:37:25,2010-12-03 15:37:25
40db43b6ca5110af97c7d4fafdcaa3f13476f8fd...3ac987d336306cb44416a539f01d69569ff88765,1,12,2,14,3,2010-12-03 16:33:54,2010-12-03 16:33:54
3ac987d336306cb44416a539f01d69569ff88765...c62815187c0ea90ec580412eef05a10df8b800df,1,0,6,6,1,2010-12-03 16:36:10,2010-12-03 16:36:10
c62815187c0ea90ec580412eef05a10df8b800df...4a9a5f19759e58b60c47d870d07d62db9fe767ec,1,7,4,11,2,2010-12-03 19:36:07,2010-12-03 19:36:07
4a9a5f19759e58b60c47d870d07d62db9fe767ec...433f5cb57fbe21a5aefc9fab4380e6d4b66240a9,2,91,3,94,4,2010-12-03 20:40:51,2010-12-03 20:40:51
433f5cb57fbe21a5aefc9fab4380e6d4b66240a9...4adaffa7b35b1b5a6df7a314243e63d2cb86dd94,1,5,4,9,5,2010-12-03 20:55:40,2010-12-03 20:55:40
4adaffa7b35b1b5a6df7a314243e63d2cb86dd94...2f081442997bc039333a35c58644c523ca30f237,2,84,1,85,4,2010-12-03 22:39:58,2010-12-03 22:39:43
2f081442997bc039333a35c58644c523ca30f237...7579d6bbfb4625457e250c2268e804486092f429,4,39,29,68,14,2010-12-04 18:36:26,2010-12-04 18:36:26
7579d6bbfb4625457e250c2268e804486092f429...76979b238090e5b87ff8c50f8bfb7aa1d3da4652,1,4,0,4,1,2010-12-04 19:43:07,2010-12-04 19:43:07
76979b238090e5b87ff8c50f8bfb7aa1d3da4652...b9c944466f229e687f994632400d112eb3878810,6,146,118,264,57,2010-12-04 19:49:09,2010-12-04 19:49:09
e818ca30116c768c223619315cfe4b45850dd6d0...65f426f218859085b631e9b0f024ba62ba957b7c,2,14,6,20,5,2010-12-01 14:48:29,2010-12-01 14:48:29
65f426f218859085b631e9b0f024ba62ba957b7c...984e62f5508ca5dde907cfd1fda92276629dcc91,1,3,1,4,1,2010-12-01 14:52:19,2010-12-01 14:52:19
984e62f5508ca5dde907cfd1fda92276629dcc91...e77e3090947750f9fd5baaff9ffdf002eb821462,2,52,44,96,23,2010-12-01 16:17:50,2010-12-01 16:17:50
e77e3090947750f9fd5baaff9ffdf002eb821462...a57d30f6e34f63b87ff2d72d4b82b0182f5978d2,1,49,30,79,18,2010-12-01 16:18:11,2010-12-01 16:18:11
a57d30f6e34f63b87ff2d72d4b82b0182f5978d2...cdeb62b371aa0e866f6cf6b78cb534a4241c0342,3,52,11,63,14,2010-12-01 18:16:37,2010-12-01 18:16:37
cdeb62b371aa0e866f6cf6b78cb534a4241c0342...37b57e98efb2d5f3b434f29b3e5c43d9898e67fe,6,41,165,206,19,2010-12-05 21:53:39,2010-12-05 21:53:39
37b57e98efb2d5f3b434f29b3e5c43d9898e67fe...ece71ea21fdf9d87cdd4bbf0f6fcfbdba1277e5e,1,4,1,5,1,2010-12-05 22:10:51,2010-12-05 22:10:51
ece71ea21fdf9d87cdd4bbf0f6fcfbdba1277e5e...4a5a00525b669e895993e74155deb85312bedce0,14,184,89,273,22,2010-12-06 01:56:51,2010-12-06 01:56:51
4a5a00525b669e895993e74155deb85312bedce0...b0433dd55c09a6470bdbdf4f3418fdc2acc76e1d,1,1,0,1,1,2010-12-06 02:00:03,2010-12-06 02:00:03
2cf810007de7214097a6bffd3245c5fb3b37913f...82d8139eadec847e3bb64cd33b63eddd24b1af00,1,0,2,2,1,2010-12-06 02:18:42,2010-12-06 02:18:42
82d8139eadec847e3bb64cd33b63eddd24b1af00...14d95e7f37686f165f09afaceec9930ff927fda0,1,15,4,19,5,2010-12-06 02:30:46,2010-12-06 02:30:46
14d95e7f37686f165f09afaceec9930ff927fda0...827aa21f86f789c0dba84c9a86d0fea67bee0153,2,4,4,8,3,2010-12-06 02:30:58,2010-12-06 02:30:58
827aa21f86f789c0dba84c9a86d0fea67bee0153...ca07060ce4ae689de0fa4901fa07b4ce2bdebfd6,1,1,1,2,1,2010-12-06 03:23:01,2010-12-06 03:23:01
ca07060ce4ae689de0fa4901fa07b4ce2bdebfd6...1f02e078caf8adf86c651130977454cbddcb5be9,1,27,4,31,7,2010-12-06 13:59:35,2010-12-02 23:44:07
1f02e078caf8adf86c651130977454cbddcb5be9...b7eaac286e4798c3f38250d2fe1b4baf84e221c3,1,2,1,3,2,2010-12-06 14:32:17,2010-12-06 14:32:17
b7eaac286e4798c3f38250d2fe1b4baf84e221c3...8769a247042eef14501355f25084d9a1c867fee8,1,1,1,2,1,2010-12-06 15:04:54,2010-12-06 14:47:10
8769a247042eef14501355f25084d9a1c867fee8...eab7ad8dd57bcaa1d8af72fa3284bf5bb7bffc40,1,1,1,2,1,2010-12-06 17:10:57,2010-12-06 17:10:57
eab7ad8dd57bcaa1d8af72fa3284bf5bb7bffc40...93f7ef1e34ecc4cba99e44f2f07e1d4e28b4efd0,1,5,1,6,2,2010-12-06 17:13:28,2010-12-06 17:13:28
93f7ef1e34ecc4cba99e44f2f07e1d4e28b4efd0...2d2998722b39ff1d149febf0ec2746f41ac0d1db,2,5,5,10,3,2010-12-06 17:22:39,2010-12-06 17:22:39
2d2998722b39ff1d149febf0ec2746f41ac0d1db...9110e6fe2c4cfb06f5fa89f3a10650fe5fe01294,2,4,4,8,4,2010-12-06 19:51:19,2010-12-06 19:51:19
9110e6fe2c4cfb06f5fa89f3a10650fe5fe01294...be87ea36e9c194dbe5a713741ca18941ae7481e8,1,1,0,1,1,2010-12-06 22:12:40,2010-12-06 22:12:40
be87ea36e9c194dbe5a713741ca18941ae7481e8...eca622a2360faa8357ddd9dec7bd673cc01681e2,7,36,19,55,20,2010-12-06 22:24:30,2010-12-06 22:22:56
eca622a2360faa8357ddd9dec7bd673cc01681e2...6ce540eb86b17a5ca0728198e74eed72f6697bda,2,22,22,44,20,2010-12-06 22:39:13,2010-12-06 22:39:05
6ce540eb86b17a5ca0728198e74eed72f6697bda...ae7a69a0063edc0f816c65fe5fbf1568f0935ae9,2,7,3,10,4,2010-12-07 00:30:34,2010-12-07 00:30:34
6ce540eb86b17a5ca0728198e74eed72f6697bda...5f833f09455ff487167aa957edb550525aa5410b,2,5,5,10,4,2010-12-07 00:12:05,2010-12-06 21:00:15
5f833f09455ff487167aa957edb550525aa5410b...1edfc563030b6553612306e63de4bde36c3afbf1,1,2,0,2,1,2010-12-07 00:12:33,2010-12-06 22:26:59
1edfc563030b6553612306e63de4bde36c3afbf1...6ab0fa5b5dd2a262d2e98d04a17f8cae4e746a7a,1,3,0,3,2,2010-12-07 00:12:33,2010-12-06 23:17:34
6ab0fa5b5dd2a262d2e98d04a17f8cae4e746a7a...a17393bd908d5f9d07eaff57d030eb25ae779a35,1,0,3,3,1,2010-12-07 00:12:33,2010-12-07 00:08:54
7763af21dce66d180d09cd81342faae2598bb645...03984ad0df27b6d9f2c739cadea26ecb803af0bd,4,14,13,27,11,2010-12-07 01:25:20,2010-12-07 01:25:20
03984ad0df27b6d9f2c739cadea26ecb803af0bd...00484e8a323ea5c1052beaa007408293e23086c9,1,10,0,10,2,2010-12-07 01:36:05,2010-12-07 01:36:05
00484e8a323ea5c1052beaa007408293e23086c9...b0f9b1a4d27da5b80676a1a2605dfc0942f7fd3e,1,9,1,10,1,2010-12-07 01:55:16,2010-12-07 01:55:16
00484e8a323ea5c1052beaa007408293e23086c9...b2e46b3793d35a3c48c6b5ca4ee05b91244b5874,1,1,7,8,2,2010-12-07 01:52:43,2010-12-07 01:52:43
9b0c90c670b725515415486c2378f4df9b26d8cd...20897e334b47071ddb93f4429566ab4c83477bfe,1,1,1,2,1,2010-12-07 03:39:04,2010-12-07 03:39:04
20897e334b47071ddb93f4429566ab4c83477bfe...58f453b2432d517ced21851ba5b21c160475d20c,2,7,5,12,4,2010-12-07 04:16:23,2010-12-07 04:16:23
58f453b2432d517ced21851ba5b21c160475d20c...42db2e8ff85a888dada252d75c427b3cf6f4d14e,1,1,1,2,1,2010-12-07 04:31:26,2010-12-07 04:31:26
42db2e8ff85a888dada252d75c427b3cf6f4d14e...af13012f31d7b745a339e63d205a8be6e66a6569,2,55,56,111,26,2010-12-07 05:09:10,2010-12-07 05:02:42
af13012f31d7b745a339e63d205a8be6e66a6569...c595bb37cca860832e96b37947cbf6c890a0f9c1,1,6,8,14,2,2010-12-07 05:09:10,2010-12-07 05:07:51
c595bb37cca860832e96b37947cbf6c890a0f9c1...60f61df8a6141abc542cc797720b6f7d095b4722,1,1,1,2,1,2010-12-07 15:10:22,2010-12-07 15:10:22
60f61df8a6141abc542cc797720b6f7d095b4722...1daf6ca7090b6bd6039cf5ace140c6c218393101,3,13,5,18,6,2010-12-07 15:26:13,2010-12-07 15:26:07
1daf6ca7090b6bd6039cf5ace140c6c218393101...b9132391e0c6603a874ae82fc469a09bc9701829,1,2,1,3,2,2010-12-07 19:58:07,2010-12-07 19:58:07
1daf6ca7090b6bd6039cf5ace140c6c218393101...c6c546828524462b7e7135ce6bf41ade0cabcd5a,1,1,1,2,1,2010-12-07 18:25:37,2010-12-07 17:45:55
c6c546828524462b7e7135ce6bf41ade0cabcd5a...490966d8ee9aeacff1b7e4cd54604b373ac2dcaa,1,9,9,18,7,2010-12-07 18:25:38,2010-12-07 18:24:22
99d266d950e3caddd90de045bfc5e75ec2cf6290...61563d24a541dd8dae12f7c93f06f0242ea180a8,1,6,2,8,3,2010-12-07 20:16:00,2010-12-07 20:16:00
61563d24a541dd8dae12f7c93f06f0242ea180a8...24cf03c6549afdba42b0685dbedafa8e61b52dd4,3,10,4,14,5,2010-12-17 00:18:22,2010-12-17 00:18:22
61563d24a541dd8dae12f7c93f06f0242ea180a8...646b27bfb21c842f254548cf32398fbdcd8a2108,1,11,8,19,4,2010-12-08 05:27:04,2010-12-08 05:27:04
77b66479d1bf6adb83b7d14f4a9cd4064155156f...31eadf03e2d00dab56af92570efcb3e12bf984cf,3,22,5,27,8,2010-12-17 01:33:02,2010-12-17 01:32:38
31eadf03e2d00dab56af92570efcb3e12bf984cf...0053e71ff9942f607a63861396e6460936694ac0,3,9,6,15,4,2010-12-17 04:05:25,2010-12-17 04:05:25
0053e71ff9942f607a63861396e6460936694ac0...16f57612b7d1f7f0772b4dbfdff8e68bb4a2f94d,1,9,5,14,7,2010-12-17 04:21:02,2010-12-17 04:21:02
16f57612b7d1f7f0772b4dbfdff8e68bb4a2f94d...bb94161851e3222a95a1455e08c8b6d11d2615c3,1,1,1,2,1,2010-12-17 04:50:11,2010-12-17 04:50:04
bb94161851e3222a95a1455e08c8b6d11d2615c3...d3911e0e674f6bb89a38e7b0e27f932e7e71bec1,1,0,4,4,1,2010-12-17 05:22:03,2010-12-17 05:22:03
d3911e0e674f6bb89a38e7b0e27f932e7e71bec1...f2a61623cd95b89cc607288d057117e945c22c52,1,1,1,2,1,2010-12-17 05:22:10,2010-12-17 05:22:10
f2a61623cd95b89cc607288d057117e945c22c52...e634287abfe57ff0bde9dc704465ef301a2de503,5,4,80,84,12,2010-12-17 05:22:20,2010-12-17 05:22:20
e634287abfe57ff0bde9dc704465ef301a2de503...08bfb0143eea87c2a1b3478f06cb7578e247a3e9,1,1,1,2,1,2010-12-17 05:31:15,2010-12-17 05:30:56
08bfb0143eea87c2a1b3478f06cb7578e247a3e9...7512156d5a49af0bce17abe483210d56f08caf08,4,14,5,19,6,2010-12-17 05:59:55,2010-12-17 05:59:55
7512156d5a49af0bce17abe483210d56f08caf08...28904fa7ae991355a1043da387328ad98bb0ac84,2,21,1,22,3,2010-12-17 08:12:16,2010-12-17 08:11:24
28904fa7ae991355a1043da387328ad98bb0ac84...4efaae056697c024920bfe387cf31d6ec37c749f,6,98,56,154,32,2010-12-17 13:00:06,2010-12-17 12:59:45
4efaae056697c024920bfe387cf31d6ec37c749f...55cd8ae9d4390ff732095e73191e2a3f99a3efeb,1,82,82,164,19,2010-12-17 14:31:55,2010-12-17 06:01:50
55cd8ae9d4390ff732095e73191e2a3f99a3efeb...e82bd0b1767a4f88d38b7284a0bffe6cae1f19f6,7,8,7,15,7,2010-12-17 14:31:55,2010-12-17 06:34:10
e82bd0b1767a4f88d38b7284a0bffe6cae1f19f6...2e3b3e52e719df787b1b46924be5275bc5b35369,1,1,1,2,1,2010-12-17 16:00:39,2010-12-17 16:00:39
2e3b3e52e719df787b1b46924be5275bc5b35369...5801ff1cda884e8469b79637d4119251b56490c9,2,14,7,21,3,2010-12-17 16:07:10,2010-12-17 16:07:10
5801ff1cda884e8469b79637d4119251b56490c9...0ce38b53393a074dd15099793e5648dae106f17b,1,0,3,3,1,2010-12-17 16:29:05,2010-12-17 15:55:02
0ce38b53393a074dd15099793e5648dae106f17b...afb0d2203279c6d1843526c48e7eafb4ab1a6d41,8,74,31,105,12,2010-12-17 16:52:42,2010-12-17 16:52:42
afb0d2203279c6d1843526c48e7eafb4ab1a6d41...1dc486db7d321e39bc353193b2c537dd0d65d535,6,38,0,38,10,2010-12-17 17:13:50,2010-12-17 17:13:50
646b27bfb21c842f254548cf32398fbdcd8a2108...f7f59bec3e05fd6b2b7a84e4e48b7f63607351f2,1,3,1,4,2,2010-12-08 07:17:50,2010-12-08 07:17:50
646b27bfb21c842f254548cf32398fbdcd8a2108...bbfcf22e2239bd08de55046c09ffa1a45228495c,1,3,6,9,2,2010-12-08 07:01:40,2010-12-08 06:59:36
bbfcf22e2239bd08de55046c09ffa1a45228495c...80bfc4b182a430d380c48660b77f84f08c38ced6,6,70,26,96,10,2010-12-08 07:01:40,2010-12-08 07:01:19
1dc486db7d321e39bc353193b2c537dd0d65d535...1fb5ac5453ebeeb77edec5cf863e1fbcf231f97f,16,652,229,881,84,2010-12-19 15:54:45,2010-12-19 15:54:45
1dc486db7d321e39bc353193b2c537dd0d65d535...4f10562afc2e8aed5b978ed858c223325c45e907,1,29,3,32,4,2010-12-17 18:55:31,2010-12-17 18:54:26
4f10562afc2e8aed5b978ed858c223325c45e907...4a80555f226690d3d009333d391cfc0820635703,5,363,303,666,6,2010-12-17 19:08:24,2010-12-17 19:08:07
4a80555f226690d3d009333d391cfc0820635703...a3b3c83f96e0642c0faed97c06e4ada2a74fe584,3,30,4,34,9,2010-12-17 22:49:47,2010-12-17 22:49:37
a3b3c83f96e0642c0faed97c06e4ada2a74fe584...6aa403b260a34089bf5df1e00b2ba471fb3453e9,2,16,0,16,2,2010-12-17 23:32:16,2010-12-17 23:32:16
6aa403b260a34089bf5df1e00b2ba471fb3453e9...dce63e952cbbfb1486e356cfc1bb2c5dc4663104,1,1,1,2,1,2010-12-17 23:53:50,2010-12-16 22:15:07
dce63e952cbbfb1486e356cfc1bb2c5dc4663104...7740e42328795fb09f1d1ea230a2ec8f3075bd4b,2,6,8,14,7,2010-12-17 23:53:50,2010-12-16 21:34:05
7740e42328795fb09f1d1ea230a2ec8f3075bd4b...a076624f2eda0f537987a4eee461bae1060cffca,3,17,3,20,9,2010-12-17 23:53:50,2010-12-16 22:15:50
a076624f2eda0f537987a4eee461bae1060cffca...ddbf7adfac08bea3f2f7eced247e87906f9ebc44,1,2,3,5,2,2010-12-17 23:59:50,2010-12-17 23:59:50
ddbf7adfac08bea3f2f7eced247e87906f9ebc44...d3d11d686328505c69bddb76e4abcc01443b33a6,2,50,18,68,13,2010-12-18 20:13:52,2010-12-18 20:13:52
d3d11d686328505c69bddb76e4abcc01443b33a6...7e18aeaa8348b0b9b5f5a3eee6d0318a62483487,2,0,16,16,2,2010-12-18 22:32:13,2010-12-18 22:32:13
7e18aeaa8348b0b9b5f5a3eee6d0318a62483487...12764d61a0afb025a49b871ec19dfa1d45d35bc3,3,5,22,27,8,2010-12-18 22:32:47,2010-12-18 22:32:47
12764d61a0afb025a49b871ec19dfa1d45d35bc3...34613b0bde4992bb5c82df55197c5d94c90e744e,2,8,8,16,5,2010-12-18 23:38:43,2010-12-18 23:38:43
34613b0bde4992bb5c82df55197c5d94c90e744e...bfdf4ba06e770bc22389be1676b292bf9143ce1c,2,13,7,20,3,2010-12-19 01:33:09,2010-12-19 01:33:09
bfdf4ba06e770bc22389be1676b292bf9143ce1c...b72a85ac2beae5339a78d4335a0f3e253fa25529,3,58,0,58,3,2010-12-19 02:47:22,2010-12-19 02:38:11
b72a85ac2beae5339a78d4335a0f3e253fa25529...208b86c09ef1210f5f870aaf6e058047a40ba038,2,340,193,533,44,2010-12-19 02:47:22,2010-12-19 02:38:19
208b86c09ef1210f5f870aaf6e058047a40ba038...fba685096f26d37d73155a20e97cc85cc21035ab,7,0,34,34,8,2010-12-19 02:47:22,2010-12-19 02:42:57
fba685096f26d37d73155a20e97cc85cc21035ab...fadf89d82409085cfa20d7f6360a932fa5932c13,2,21,0,21,3,2010-12-19 04:34:26,2010-12-19 04:34:26
fadf89d82409085cfa20d7f6360a932fa5932c13...46cce4595c3d377e33ff8001a9f82ccfb992ad29,3,109,13,122,14,2010-12-19 04:54:29,2010-12-19 04:54:29
46cce4595c3d377e33ff8001a9f82ccfb992ad29...e6dc75b1250fcfb3141a0a4142f9d7ddbe2e20f0,1,3,3,6,3,2010-12-19 05:00:48,2010-12-19 05:00:48
e6dc75b1250fcfb3141a0a4142f9d7ddbe2e20f0...c4ea46b1e709e69bf08257f6e10473ef55df5781,2,37,8,45,4,2010-12-19 05:11:23,2010-12-19 05:11:23
c4ea46b1e709e69bf08257f6e10473ef55df5781...166e3df9286542d5718239ea437b3a11e97c7a98,3,24,6,30,8,2010-12-19 05:56:44,2010-12-19 05:56:44
166e3df9286542d5718239ea437b3a11e97c7a98...3344ead0958a0162fa43bd365af936c4c006b9d5,1,1,1,2,1,2010-12-19 06:18:50,2010-12-19 06:18:50
3344ead0958a0162fa43bd365af936c4c006b9d5...5276c0002230b625d17ffbc2ce7457c53f48b0fb,1,4,4,8,1,2010-12-19 06:25:32,2010-12-19 06:25:32
5276c0002230b625d17ffbc2ce7457c53f48b0fb...aed49ae7154431ed505eadc9706e41513209ca7a,3,16,1,17,4,2010-12-19 06:36:41,2010-12-19 06:36:41
aed49ae7154431ed505eadc9706e41513209ca7a...ff541b1edda0a17931ff1710962dbd21d768c6e9,1,1,1,2,1,2010-12-19 14:17:45,2010-12-19 14:17:45
ff541b1edda0a17931ff1710962dbd21d768c6e9...bba46ee7eb764560a9d07aa6e42092fdf3768350,17,670,232,902,92,2010-12-19 16:47:39,2010-12-19 16:47:39
191a96cffcc36aab4eb8528774c43b883d6c1030...df0c9ad070a339c47973755ef250750e80046a97,2,2,2,4,2,2010-12-08 08:32:56,2010-12-08 07:30:14
df0c9ad070a339c47973755ef250750e80046a97...d749e8a4383f057acdf37850e8c6860b7e91f8f6,1,9845,1274,11119,62,2010-12-08 08:32:56,2010-12-08 08:32:08
d749e8a4383f057acdf37850e8c6860b7e91f8f6...0b97deb52745f7da9464ddaf11ea2f85f211fa26,5,7,7,14,7,2010-12-08 08:32:56,2010-12-08 08:32:35
0b97deb52745f7da9464ddaf11ea2f85f211fa26...23e46b19cab1c4d0b656005f615c6db3c6a15c43,3,60,52,112,45,2010-12-08 13:16:29,2010-12-08 13:16:29
23e46b19cab1c4d0b656005f615c6db3c6a15c43...b8b9d6691f0be2733df8ead854d54432e2b68bd9,1,32,0,32,1,2010-12-08 13:16:42,2010-12-08 13:16:42
aed2d9d33dcc56f36c54fe121ae07abd130f9db5...622f93bce918ffbadeae79a1bf0c6ab116caae77,4,12,0,12,5,2010-12-19 17:02:12,2010-12-19 17:02:12
622f93bce918ffbadeae79a1bf0c6ab116caae77...38122cae7a4857ede37873cc772891cebf9d43ee,1,1,1,2,1,2010-12-19 17:09:58,2010-12-19 17:09:58
38122cae7a4857ede37873cc772891cebf9d43ee...fcb9bb88d5a764b5db362ee7d5eb43fea18fb971,2,2,2,4,2,2010-12-19 17:19:00,2010-12-19 17:18:42
fcb9bb88d5a764b5db362ee7d5eb43fea18fb971...4cdf39537eae38554b0ae4c8ac8cc14c6096b431,1,6,5,11,6,2010-12-19 17:55:16,2010-12-19 17:55:16
4cdf39537eae38554b0ae4c8ac8cc14c6096b431...302beeb7e1535518d5edbcb3ffc55f2e2898c273,1,38,28,66,2,2010-12-19 18:11:43,2010-12-19 18:11:43
302beeb7e1535518d5edbcb3ffc55f2e2898c273...ac212cf08175e6fb8e215b72fea9a0490b2020cc,1,2,11,13,1,2010-12-19 18:19:39,2010-12-19 18:19:39
ac212cf08175e6fb8e215b72fea9a0490b2020cc...a3f04b6bc0d74f55b78a9e7ca91927ceb8109e73,4,12,3,15,6,2010-12-19 18:37:46,2010-12-19 18:37:46
a3f04b6bc0d74f55b78a9e7ca91927ceb8109e73...a71790e3cbd5bdab27fb6e95ccb164cbe4b56a00,1,20,20,40,14,2010-12-19 19:05:08,2010-12-19 19:05:08
a71790e3cbd5bdab27fb6e95ccb164cbe4b56a00...cc8cb49a18cc4f3057e7910999ff37ad288f7c7e,4,392,1055,1447,13,2010-12-19 19:15:32,2010-12-19 19:15:32
cc8cb49a18cc4f3057e7910999ff37ad288f7c7e...604e51117ec52e10a745aab0723efe8e7c114aa0,1,11,6,17,3,2010-12-19 19:29:40,2010-12-19 19:29:40
604e51117ec52e10a745aab0723efe8e7c114aa0...6b2f71b0b17b804886bbdc254faa414076428855,1,2,1,3,1,2010-12-19 19:33:38,2010-12-19 19:33:38
6b2f71b0b17b804886bbdc254faa414076428855...3c5c64a54344cc0934d537c5ebf5bc866f1cafd3,6,124,90,214,17,2010-12-19 20:31:11,2010-12-19 20:31:11
b8b9d6691f0be2733df8ead854d54432e2b68bd9...b2378d6b5fc8560f46060c01f583bbb485413c3d,2,10,4,14,4,2010-12-09 17:36:08,2010-12-09 17:36:08
b8b9d6691f0be2733df8ead854d54432e2b68bd9...5e90fb163a439949033586178e6bbd7930fb78c8,4,2215,1964,4179,258,2010-12-08 17:50:15,2010-12-08 17:50:01
5e90fb163a439949033586178e6bbd7930fb78c8...cfea72ebf345ae39e7a19b8bcbafdee6221e8875,2,20,20,40,13,2010-12-08 21:23:21,2010-12-08 21:23:21
cfea72ebf345ae39e7a19b8bcbafdee6221e8875...c6016d1ac76f36058066a401442dfd39eb59d938,1,1,1,2,1,2010-12-08 21:16:29,2010-12-08 21:16:19
3c5c64a54344cc0934d537c5ebf5bc866f1cafd3...fe370eb97b01837c6e77ca99053d7ab24824b513,1,85,78,163,3,2010-12-19 21:14:51,2010-12-19 21:14:51
3c5c64a54344cc0934d537c5ebf5bc866f1cafd3...63c23a23597031d248389ca229f8d75ad62c4ef9,2,38,12,50,11,2010-12-19 21:04:45,2010-12-19 21:04:30
4f435aadb650fd26d7d86c39210703a7a59a9bde...5e6a72e7c6512581f4c64fdadea90717e3449b85,1,54,9,63,10,2010-12-09 20:12:27,2010-12-09 20:12:27
5e6a72e7c6512581f4c64fdadea90717e3449b85...a83ad16ce73fc188e7e4b9f667a44c99982dd8f9,3,6,2,8,5,2010-12-09 20:12:58,2010-12-09 20:12:58
4f435aadb650fd26d7d86c39210703a7a59a9bde...081eba66b9c3e72cfc21f75e627f5858e658e88e,1,1,1,2,1,2010-12-09 19:59:36,2010-12-09 19:59:27
99afebe8d507215381cda8a84a91d40055ef0582...900177367656f3ddb327ff3fa44f491c56940793,1,36,32,68,2,2010-12-19 21:20:23,2010-12-19 21:20:23
08be14dd9f122bea42ef52c143173461d9cc24f3...c59538bc73772ab7c814050c610d94bffdaacd13,2,5,4,9,5,2010-12-09 20:15:24,2010-12-09 20:15:24
c59538bc73772ab7c814050c610d94bffdaacd13...2d44cc04200fb1cd80f3d2255148aa3120ebbd3c,1,28,0,28,1,2010-12-09 20:16:29,2010-12-09 20:16:29
2d44cc04200fb1cd80f3d2255148aa3120ebbd3c...29d9dab034c6f7df497b76f543ba467e687a9063,2,39,1,40,2,2010-12-09 21:59:10,2010-12-09 21:59:10
29d9dab034c6f7df497b76f543ba467e687a9063...2205f047194bb50b9923f8395acad2fe4b6d59a6,1,9,4,13,6,2010-12-10 03:59:28,2010-12-10 03:59:28
2205f047194bb50b9923f8395acad2fe4b6d59a6...2575b23b9d823be9a6b76d6c9e9bf2083187771d,1,4,2,6,3,2010-12-10 03:59:34,2010-12-10 03:59:34
2575b23b9d823be9a6b76d6c9e9bf2083187771d...96656759e7370cc1bea42d08941c0bb116089f99,1,1,1,2,1,2010-12-10 14:38:36,2010-12-10 14:38:17
96656759e7370cc1bea42d08941c0bb116089f99...5db8692c4255f925b31b1334ffe3d2d9b2addc43,1,4,2,6,3,2010-12-10 21:02:27,2010-12-10 21:02:27
5db8692c4255f925b31b1334ffe3d2d9b2addc43...0182bd5c984928868fe54b5ba992dcaee5889688,1,3,3,6,3,2010-12-10 21:15:47,2010-12-10 21:15:39
0182bd5c984928868fe54b5ba992dcaee5889688...e11b00d440fe6b47bbfaee68bb81b80f3a23755b,3,104,0,104,5,2010-12-10 21:19:18,2010-12-10 21:19:18
e11b00d440fe6b47bbfaee68bb81b80f3a23755b...1f0c57ec7f3fb1d7acfae782ddcb54d05587ba21,1,1,1,2,1,2010-12-10 22:32:21,2010-12-10 22:31:48
1f0c57ec7f3fb1d7acfae782ddcb54d05587ba21...0b23cc1bc38f5fa29c65b6b9f18876d53d240aab,1,42,0,42,1,2010-12-10 22:33:16,2010-12-10 22:33:16
900177367656f3ddb327ff3fa44f491c56940793...e36a722dafdcc11a419b484f297128db916b7d49,1,14,10,24,3,2010-12-19 21:49:53,2010-12-19 21:49:53
e36a722dafdcc11a419b484f297128db916b7d49...ec5ff12c530c99439a7b925349916f2868e45735,12,100,33,133,38,2010-12-20 00:42:28,2010-12-20 00:42:28
900177367656f3ddb327ff3fa44f491c56940793...fc38980536ae53a4901f35dbd460dd6c69881cfa,1,1,0,1,1,2010-12-19 21:11:01,2010-12-19 21:10:27
fc38980536ae53a4901f35dbd460dd6c69881cfa...47364fd49ae6f08fc99c5ae4f470562780c3479f,1,1,1,2,1,2010-12-19 22:55:32,2010-12-19 22:55:32
47364fd49ae6f08fc99c5ae4f470562780c3479f...bf56f218e8c0cfcd5b9929831f42855f6078cbcc,3,3,3,6,3,2010-12-19 22:55:42,2010-12-19 22:55:42
bf56f218e8c0cfcd5b9929831f42855f6078cbcc...6c3aac4b9a32a786886bf2e4da0c079bbafa3054,1,9,10,19,7,2010-12-19 22:55:36,2010-12-19 22:55:02
0b23cc1bc38f5fa29c65b6b9f18876d53d240aab...2e76be1c6c7f0de4f40f451427f6a4b1bfe66869,1,106,106,212,2,2010-12-11 05:39:23,2010-12-11 05:39:23
2e76be1c6c7f0de4f40f451427f6a4b1bfe66869...4700e3e7e9e03be14eb133d78a2f0b098ac259d2,2,8,37,45,5,2010-12-11 05:39:57,2010-12-11 05:39:57
0b23cc1bc38f5fa29c65b6b9f18876d53d240aab...5b663b9898ce026175112b7bc2e0bf01cf3b87fd,1,1,1,2,1,2010-12-11 00:20:42,2010-12-11 00:19:54
5b663b9898ce026175112b7bc2e0bf01cf3b87fd...8c38b329f038a1809f883237c6e398843bce2589,1,6,4,10,1,2010-12-11 00:20:43,2010-12-07 22:54:38
8c38b329f038a1809f883237c6e398843bce2589...cde5c05c09713f66935861d45e315cf91b09cd50,5,19,19,38,13,2010-12-11 00:20:43,2010-12-07 23:24:23
cde5c05c09713f66935861d45e315cf91b09cd50...3469206c4bebd4ee66529bb34deaf3ad9cdcfbb3,1,1,1,2,1,2010-12-11 00:20:43,2010-12-09 22:08:40
3469206c4bebd4ee66529bb34deaf3ad9cdcfbb3...1c17cece76f77fa00e643ce5e4fa85ccebc9f990,19,191,163,354,111,2010-12-11 00:20:43,2010-12-09 19:44:08
1c17cece76f77fa00e643ce5e4fa85ccebc9f990...cfb8db7d1c86f1ad9763ea0c84125188413a40d3,1,7,2,9,3,2010-12-11 00:20:43,2010-12-10 23:49:07
cfb8db7d1c86f1ad9763ea0c84125188413a40d3...d53c412a29b5d7892f81b71a9a0e97661d696473,5,56,14,70,14,2010-12-11 00:20:43,2010-12-10 23:54:19
933d9a03ab5f51dc90f15c820025b8e603c65308...4282c0617096b58243e2522ee4f0e58709907496,1,2,2,4,2,2010-12-20 02:01:13,2010-12-20 02:01:13
4282c0617096b58243e2522ee4f0e58709907496...5580398632b6ef133b47bebe59e5d07956b548d3,2,4,4,8,3,2010-12-20 02:08:04,2010-12-20 02:08:04
5580398632b6ef133b47bebe59e5d07956b548d3...174f0635359ecaa1adf8144c7cf77c3c69e79241,3,2,3,5,3,2010-12-20 02:16:37,2010-12-20 02:16:37
174f0635359ecaa1adf8144c7cf77c3c69e79241...87e7d1d096442e8ed954db0bd01ebd524b046f3b,3,12,4,16,4,2010-12-20 06:27:41,2010-12-20 06:27:41
87e7d1d096442e8ed954db0bd01ebd524b046f3b...04f1acae78af320a8f5ba52e83cb37254a07dd8a,2,102,4,106,16,2010-12-20 06:28:10,2010-12-20 06:28:10
04f1acae78af320a8f5ba52e83cb37254a07dd8a...b4ba7fab49092bdfb90b6aa9245fedc1330265cb,3,19,0,19,3,2010-12-20 06:28:20,2010-12-20 06:28:20
b4ba7fab49092bdfb90b6aa9245fedc1330265cb...576ff830dc20afad70fd1131377a91294e715689,1,50,0,50,1,2010-12-20 06:29:46,2010-12-20 06:29:46
576ff830dc20afad70fd1131377a91294e715689...18fce96ec2dfa4d844db245da07ee956a33751b6,2,8,0,8,2,2010-12-20 07:21:33,2010-12-20 07:21:33
18fce96ec2dfa4d844db245da07ee956a33751b6...2f7ab64d70c2be4561b976252c43d6b719541ec7,3,48,4,52,7,2010-12-20 07:21:41,2010-12-20 07:21:41
2f7ab64d70c2be4561b976252c43d6b719541ec7...2d7f0ad37803a91b2d1012786025b89fa3a4302a,1,2,2,4,3,2010-12-20 08:53:15,2010-12-20 08:53:15
2d7f0ad37803a91b2d1012786025b89fa3a4302a...d9307addab35b2262f283183177fd260a1ad2ac3,1,34,0,34,2,2010-12-20 08:59:28,2010-12-20 08:59:28
d9307addab35b2262f283183177fd260a1ad2ac3...8d1b7c0ee352e362bd6119b66f2c2bdd4f685251,9,28,89,117,29,2010-12-20 14:28:19,2010-12-20 14:28:19
8d1b7c0ee352e362bd6119b66f2c2bdd4f685251...ae0d2eaa35865febeed1464bbaf224c60017d8ac,2,0,4,4,2,2010-12-20 15:29:55,2010-12-20 15:29:55
ae0d2eaa35865febeed1464bbaf224c60017d8ac...9fcb46f038e26facf084de980287f950b49383a2,9,52,271,323,37,2010-12-20 18:29:58,2010-12-20 18:29:58
9fcb46f038e26facf084de980287f950b49383a2...4f61307a921a45dbc417801eefbd7cd47229f11c,1,1,1,2,1,2010-12-20 18:33:39,2010-12-20 15:43:31
4f61307a921a45dbc417801eefbd7cd47229f11c...98bde47e0343a5665da7a8853c976edfb97ef0dc,1,1,1,2,1,2010-12-20 18:35:24,2010-12-20 18:35:24
98bde47e0343a5665da7a8853c976edfb97ef0dc...5a3296db37de7d9e1a1a158fec56eeddbe8850f6,7,125,32,157,26,2010-12-20 19:10:43,2010-12-20 19:10:43
76b3d52798a849474c86a62283d0329c791bb021...0d7ae20b995914d47f18ce547d020e8fa746a0c7,3,13,12,25,3,2010-12-11 20:25:45,2010-12-11 20:25:45
76b3d52798a849474c86a62283d0329c791bb021...32ebd1e00320768356428ec3069b90912ac36334,1,1,2,3,1,2010-12-11 20:02:45,2010-12-11 20:02:30
5a3296db37de7d9e1a1a158fec56eeddbe8850f6...9784832fda380a42a980db30de5754c5046355b8,1,3,3,6,3,2010-12-20 20:03:44,2010-12-20 20:03:44
5a3296db37de7d9e1a1a158fec56eeddbe8850f6...bdc22dc85437222823ab84eca3a1fc2aa273f9a2,5,12,20,32,11,2010-12-20 19:17:44,2010-12-20 17:52:31
bdc22dc85437222823ab84eca3a1fc2aa273f9a2...fcf9fbe6c275a2f31a059b03d1657de1fd71910e,2,4,2,6,3,2010-12-20 19:28:46,2010-12-20 19:28:46
fcf9fbe6c275a2f31a059b03d1657de1fd71910e...30dc89337b46d28b302e3e28939b4d95afa05961,1,14,7,21,6,2010-12-20 19:36:30,2010-12-20 19:34:52
459681b81323f2edc1247a5f41612e1d7b017a8c...37ffe755ebe3c257f0e9ccc5f5da74ebab232cb5,1,1,0,1,1,2010-12-11 20:47:43,2010-12-11 20:47:43
37ffe755ebe3c257f0e9ccc5f5da74ebab232cb5...d2e9c8586994fb33c07324177914b943e0d52d84,1,118,32,150,6,2010-12-11 21:17:57,2010-12-11 21:17:57
d2e9c8586994fb33c07324177914b943e0d52d84...4597deb9d436d31892633b1a3391bb41c3b5b675,1,1,1,2,1,2010-12-11 21:25:44,2010-12-11 21:25:44
4597deb9d436d31892633b1a3391bb41c3b5b675...665bf1326a934c397ead5888a879e752a70d4be4,1,9,0,9,1,2010-12-11 21:42:41,2010-12-11 21:42:31
03c932859379011a6fb2d16e029a7f0d3485a9e0...3dfc3dd42ba60004edc6212f4ada20cd603b7957,5,105,17,122,17,2010-12-20 20:17:02,2010-12-19 06:03:16
3dfc3dd42ba60004edc6212f4ada20cd603b7957...8590efc3a87919b0ecee2d5b2acda894e9582ba6,3,140,0,140,3,2010-12-20 21:07:08,2010-12-20 21:07:08
8590efc3a87919b0ecee2d5b2acda894e9582ba6...d070edd9a43870a1a3c83833cf528913b60efebd,1,1,1,2,1,2010-12-20 21:08:58,2010-12-20 21:08:58
665bf1326a934c397ead5888a879e752a70d4be4...fea1d90e27e26688929629e2a1cea90c2ffd2abd,1,1,1,2,1,2010-12-12 00:47:21,2010-12-12 00:47:21
fea1d90e27e26688929629e2a1cea90c2ffd2abd...60447a06f3c3bf4867c343d568d37daf47544bfe,1,2,2,4,1,2010-12-12 02:57:06,2010-12-12 02:56:48
665bf1326a934c397ead5888a879e752a70d4be4...2d6d8c39b8acf428557f8776d315943da77baf92,1,2,1,3,1,2010-12-11 22:25:37,2010-12-11 22:25:37
2d6d8c39b8acf428557f8776d315943da77baf92...c853e9a2068cb8f1fae94965fc85971fdba4a5c3,6,22,20,42,10,2010-12-12 15:59:16,2010-12-12 15:59:16
d070edd9a43870a1a3c83833cf528913b60efebd...bc59cfb9a500876dd16172651ab42d57fbf03f78,1,4,1,5,1,2010-12-20 21:53:20,2010-12-20 21:53:20
d070edd9a43870a1a3c83833cf528913b60efebd...dc079d3ba7459cb325f42f54f5ec3d07e79a136d,1,1,1,2,1,2010-12-20 21:25:29,2010-12-20 21:24:51
dc079d3ba7459cb325f42f54f5ec3d07e79a136d...d3e7af93ea7924d81e81838a50621ced0f635ceb,1,57,18,75,14,2010-12-20 21:25:29,2010-12-20 21:25:04
d3e7af93ea7924d81e81838a50621ced0f635ceb...885dbae1c651f5d5d26f04c9fd845b8876075d49,1,2,0,2,1,2010-12-20 21:18:58,2010-12-20 21:18:51
885dbae1c651f5d5d26f04c9fd845b8876075d49...e87ba2fefa55ee9ad63e873837a8d0cfbb0f7dbd,1,7,0,7,1,2010-12-20 21:29:03,2010-12-20 21:29:03
60447a06f3c3bf4867c343d568d37daf47544bfe...47d2007d88f9f8f93bb7c8af269246e94e22f76d,4,11,56,67,15,2010-12-12 16:19:50,2010-12-12 16:19:50
41d4448a34fec069c561eed4a58392c0fe65f5da...9065c175bde43c3f1172dc00c14a478e17cf48da,1,18,9,27,7,2010-12-20 21:55:16,2010-12-20 21:55:16
9065c175bde43c3f1172dc00c14a478e17cf48da...e1a1b0c586835ffc6c3d5b80ecae80e4b331bb45,1,10,15,25,8,2010-12-20 22:03:10,2010-12-20 22:03:10
e1a1b0c586835ffc6c3d5b80ecae80e4b331bb45...abedfa9c914637e47515f018248b24c256a194fa,2,30,0,30,2,2010-12-20 23:14:28,2010-12-20 23:14:28
abedfa9c914637e47515f018248b24c256a194fa...0670df6a8762e97458f0dba2d786e2833efc32e7,1,4,10,14,3,2010-12-20 23:33:29,2010-12-20 21:36:37
0670df6a8762e97458f0dba2d786e2833efc32e7...cf7a7b7f3baf33541de2340ff66c7c44f483909c,1,1,1,2,1,2010-12-20 23:33:29,2010-12-20 22:02:09
cf7a7b7f3baf33541de2340ff66c7c44f483909c...3d53cd2b45f1cc76ad1dfb36dfe2ca02b9164489,2,47,53,100,18,2010-12-20 23:33:29,2010-12-20 22:33:33
3d53cd2b45f1cc76ad1dfb36dfe2ca02b9164489...90b4b4abc8659ee130ffb5646cb2c191ae334ef2,1,1,1,2,1,2010-12-21 00:09:41,2010-12-21 00:09:41
90b4b4abc8659ee130ffb5646cb2c191ae334ef2...5c0a44409d2312ebe75bd2685d195a63d511ceab,4,11,3,14,4,2010-12-21 00:12:44,2010-12-21 00:12:44
1d84a99851950c98f41f0a1c79dffb21d9fee096...982bf3f59536808975723a81f5915b9d01f18854,2,5,5,10,4,2010-12-12 17:14:44,2010-12-12 17:14:44
982bf3f59536808975723a81f5915b9d01f18854...6dea71aa524d23a5eb2075b633d39862c56a6f6b,2,9,3,12,3,2010-12-12 17:28:39,2010-12-12 17:28:39
6dea71aa524d23a5eb2075b633d39862c56a6f6b...cc66c8abf0fb7ca1f29f16657fccaff9a6554bf2,3,31,6,37,13,2010-12-12 21:05:21,2010-12-12 21:05:21
cc66c8abf0fb7ca1f29f16657fccaff9a6554bf2...f8abd55da069bf94d8e5fbb0b76bf5618110e75f,2,102,7,109,6,2010-12-12 21:05:50,2010-12-12 21:05:50
f8abd55da069bf94d8e5fbb0b76bf5618110e75f...9b2fcc78b8c164cacf221e61ea78218ccfb42daf,1,4,2,6,1,2010-12-12 21:12:16,2010-12-12 21:12:16
9b2fcc78b8c164cacf221e61ea78218ccfb42daf...f5f6c23c68fe16eb575859d28401413085f42af3,1,35,14,49,7,2010-12-12 21:42:55,2010-12-12 21:42:55
f5f6c23c68fe16eb575859d28401413085f42af3...488dd8b82fa51fd7885e7dea7d65b9d1453d3227,2,2,3,5,5,2010-12-12 21:46:38,2010-12-12 21:46:38
488dd8b82fa51fd7885e7dea7d65b9d1453d3227...e39c6994308b3c091984e2d08136311aeed12277,2,0,4,4,2,2010-12-12 22:15:06,2010-12-12 22:15:06
e39c6994308b3c091984e2d08136311aeed12277...f89bc9e3a5f289adba92a2ace25861acf46dacef,1,2,1,3,1,2010-12-12 22:38:23,2010-12-12 22:38:23
f89bc9e3a5f289adba92a2ace25861acf46dacef...09a8ea22167df0f7ff4c9482c3cccd359409d0cb,2,45,45,90,8,2010-12-13 00:45:25,2010-12-13 00:45:25
09a8ea22167df0f7ff4c9482c3cccd359409d0cb...c3b29eda605cfdddfaf887b397c8f8db56801cdd,1,4,2,6,3,2010-12-13 00:45:47,2010-12-13 00:45:47
c3b29eda605cfdddfaf887b397c8f8db56801cdd...87d8e45df98ae25f9599496973162315cf1cb434,1,4,4,8,3,2010-12-13 00:46:12,2010-12-13 00:46:12
87d8e45df98ae25f9599496973162315cf1cb434...51bc5608031ac1abd364484c32a58e3421a7fbf4,12,130,15,145,35,2010-12-13 00:47:10,2010-12-13 00:47:10
51bc5608031ac1abd364484c32a58e3421a7fbf4...83c6b3616c425ed97519b381a0e6218be2f96410,1,114,0,114,1,2010-12-13 00:58:27,2010-12-13 00:58:27
83c6b3616c425ed97519b381a0e6218be2f96410...90a1ae58e4df3fe466707a3742f802c4693922c7,3,78,70,148,11,2010-12-13 01:18:16,2010-12-13 01:18:16
90a1ae58e4df3fe466707a3742f802c4693922c7...6006f86b6c0646f394ba792d6346683c40007d1a,1,12,8,20,2,2010-12-13 02:15:31,2010-12-13 02:15:31
6006f86b6c0646f394ba792d6346683c40007d1a...22f4bb269cac5d42d2d8e5bfcd6854403cbbb81d,2,2,1,3,2,2010-12-13 03:46:06,2010-12-13 03:46:06
22f4bb269cac5d42d2d8e5bfcd6854403cbbb81d...d4042c9c502d930e6064409d1aea5683e89ed5df,4,41,3,44,7,2010-12-13 03:56:00,2010-12-13 03:56:00
d4042c9c502d930e6064409d1aea5683e89ed5df...d7a05a90da0827cf4dfcc1dd7fafc0cfe2893948,9,212,168,380,36,2010-12-13 05:21:08,2010-12-13 05:21:08
d7a05a90da0827cf4dfcc1dd7fafc0cfe2893948...9c3f0bf9d32ea501df9739d706e9d86d1bc5c6c3,3,162,163,325,29,2010-12-13 05:40:13,2010-12-13 05:40:13
9c3f0bf9d32ea501df9739d706e9d86d1bc5c6c3...59f8903026875485b71494fc5343fd772489f415,1,112,106,218,5,2010-12-13 05:46:57,2010-12-13 05:46:57
59f8903026875485b71494fc5343fd772489f415...0317b34be5dab9dea1b99610b4c68f3c3cfd3895,3,11,4,15,5,2010-12-13 07:23:50,2010-12-13 07:23:50
0317b34be5dab9dea1b99610b4c68f3c3cfd3895...7a6d5219a62cf136982ed96620b054f88541d96e,1,1,1,2,1,2010-12-13 07:25:49,2010-12-13 07:25:49
7a6d5219a62cf136982ed96620b054f88541d96e...95c795fba056af024f7cce22adbb41f96a71f869,1,1,1,2,1,2010-12-13 07:26:35,2010-12-13 07:26:35
95c795fba056af024f7cce22adbb41f96a71f869...66c7a5611bfd429e6f58d3c91e1fff0b909e7c02,2,36,30,66,6,2010-12-13 07:32:52,2010-12-13 07:32:52
66c7a5611bfd429e6f58d3c91e1fff0b909e7c02...6dfa99a573f3cdee8deb8ca076036282918e1a64,3,22,12,34,8,2010-12-13 17:35:27,2010-12-13 17:35:27
5c0a44409d2312ebe75bd2685d195a63d511ceab...f2f05704052602febca18c3f95dec3f696a3d2e6,1,0,2,2,1,2010-12-21 02:42:01,2010-12-21 02:42:01
f2f05704052602febca18c3f95dec3f696a3d2e6...6e02963e9c165b0f72bd154f70be4a41755f3920,1,12,9,21,4,2010-12-21 04:02:56,2010-12-21 04:02:56
6e02963e9c165b0f72bd154f70be4a41755f3920...fecf14def3bd51b91e0af55d61e9de2b9f918dcf,1,8,8,16,8,2010-12-21 06:23:31,2010-12-21 06:23:31
5c0a44409d2312ebe75bd2685d195a63d511ceab...9666cbe80700900283679cae88b1c3fdd6431e01,3,8,9,17,4,2010-12-21 01:24:43,2010-12-21 01:24:43
9666cbe80700900283679cae88b1c3fdd6431e01...9da5f09605762c8b8767c26927cd10d8a04892de,1,0,2,2,1,2010-12-21 03:23:02,2010-12-21 03:23:02
9da5f09605762c8b8767c26927cd10d8a04892de...678a2602835a24f08567a291e3d9e4a9a3af0bd7,5,74,2,76,17,2010-12-21 03:49:37,2010-12-21 03:49:37
678a2602835a24f08567a291e3d9e4a9a3af0bd7...14f1a87ddcf15fc487d6107a2d5f8ef119d71809,1,22,5,27,4,2010-12-21 06:21:22,2010-12-21 06:21:22
14f1a87ddcf15fc487d6107a2d5f8ef119d71809...89d2e5366eae2fb299e885d2e5fd08dd7b296100,1,96,0,96,1,2010-12-21 06:38:44,2010-12-21 06:38:44
89d2e5366eae2fb299e885d2e5fd08dd7b296100...6b3bf8eb223a764c60cda68f6ad24397cbc95db0,5,25,13,38,10,2010-12-21 06:59:33,2010-12-21 06:59:33
6b3bf8eb223a764c60cda68f6ad24397cbc95db0...cace711d09ee15ab887541c9f984bedd9aa642a7,2,0,4,4,2,2010-12-21 07:05:18,2010-12-21 07:05:18
cace711d09ee15ab887541c9f984bedd9aa642a7...cd8b0b6c35dc825e30a0e9e638bed9f6c340b113,1,16,5,21,4,2010-12-21 07:23:31,2010-12-21 07:23:31
cd8b0b6c35dc825e30a0e9e638bed9f6c340b113...166014aafe0fdde8551f4e9641b7837a25342990,1,20,1,21,3,2010-12-21 07:52:18,2010-12-21 07:52:18
6dfa99a573f3cdee8deb8ca076036282918e1a64...11a95d82574d9932f0176a403b12050903a04451,2,31,0,31,4,2010-12-13 18:45:55,2010-12-13 18:45:55
6dfa99a573f3cdee8deb8ca076036282918e1a64...d8b24cc6a8d360793400f28408458528a98d7d0f,1,2,0,2,1,2010-12-13 18:13:22,2010-12-13 18:13:14
e4cd5b0b7a6ff54075032863801e8253c7258ed3...4a41d3577658b0e01e76a536f9e36442b0720b4f,1,1,3,4,2,2010-12-21 14:49:19,2010-12-21 14:49:19
4a41d3577658b0e01e76a536f9e36442b0720b4f...24ed065ef0384677a792b84a14f173a64503e319,1,30,12,42,17,2010-12-21 14:49:29,2010-12-21 14:49:29
24ed065ef0384677a792b84a14f173a64503e319...e45adc40ae0f5e7811da867634c16d4a73118502,2,5,3,8,3,2010-12-21 14:56:36,2010-12-21 14:56:36
70eb3f35edbad3b4597c934e4153aa6afbe5cb77...1578e56b28793c3a38ec79acfb08327974367d1d,1,6,4,10,2,2010-12-13 19:40:15,2010-12-13 19:40:15
70eb3f35edbad3b4597c934e4153aa6afbe5cb77...d7b6d8b62a3acdc78bb3831b9b4d24c1c45c1a13,1,24,3,27,4,2010-12-13 19:03:20,2010-12-13 19:03:13
e45adc40ae0f5e7811da867634c16d4a73118502...674364953991504f1b569989fa5993a0a6661f2c,1,9,3,12,3,2010-12-21 17:03:37,2010-12-21 17:03:37
674364953991504f1b569989fa5993a0a6661f2c...b670860174c3490a1d66bedc45084cee89689474,2,129,0,129,4,2010-12-21 17:06:53,2010-12-21 17:06:53
b670860174c3490a1d66bedc45084cee89689474...6250ccaa93a834246d24bc4571d5a14d965231b1,1,17,11,28,7,2010-12-21 17:23:41,2010-12-21 17:23:41
6250ccaa93a834246d24bc4571d5a14d965231b1...97ab6fa1af10fa2deb7e20f8954d7d202b5bc987,4,58,6,64,16,2010-12-21 17:52:59,2010-12-21 17:52:59
e45adc40ae0f5e7811da867634c16d4a73118502...8861c047f5895ba7d0437d170894347aee93da8f,2,2,2,4,2,2010-12-21 16:54:40,2010-12-21 16:54:40
8861c047f5895ba7d0437d170894347aee93da8f...a0aa342175590d31537651f4e6bc0a5420923ce4,1,9,3,12,3,2010-12-21 16:54:46,2010-12-21 16:54:46
952909891a06c0dcc587b0c84df28e28aaa92189...fd899470c165374afbe05548b4ad5760e086ccc9,1,5,0,5,1,2010-12-13 19:32:58,2010-12-13 19:32:30
fd899470c165374afbe05548b4ad5760e086ccc9...4a437cc8b861ca7f02fd6f93ad03dd149ba7bc26,2,22,0,22,4,2010-12-13 19:53:49,2010-12-13 19:53:49
4a437cc8b861ca7f02fd6f93ad03dd149ba7bc26...c7f9beba4452fb0f99206aca2352bfca14d0b299,1,17,3,20,1,2010-12-13 20:30:26,2010-12-13 20:30:26
c7f9beba4452fb0f99206aca2352bfca14d0b299...4ccfed22b1945bf42e06c1dc0fac8d08e92950e5,1,12,6,18,2,2010-12-13 20:36:34,2010-12-13 20:36:34
4ccfed22b1945bf42e06c1dc0fac8d08e92950e5...eb77acc4fca2692fe47e74433fa10ddf65c0a66c,7,31,13,44,11,2010-12-13 20:51:53,2010-12-13 20:51:53
eb77acc4fca2692fe47e74433fa10ddf65c0a66c...1a4ec9228290149805e77b634f8fbf815ced95aa,4,29,1,30,4,2010-12-13 21:06:13,2010-12-13 21:06:13
1a4ec9228290149805e77b634f8fbf815ced95aa...85502d3bd8ac10f215f2695a06d9eef19ca0d8b2,1,2,0,2,2,2010-12-13 21:08:40,2010-12-13 21:08:40
85502d3bd8ac10f215f2695a06d9eef19ca0d8b2...98f5d5396a9eadb7e9ccb88875e8213fc0a51607,1,1,1,2,1,2010-12-13 21:11:04,2010-12-13 21:11:04
98f5d5396a9eadb7e9ccb88875e8213fc0a51607...22242889332ff65589ecea6262e33016b98cc8f2,2,84,36,120,17,2010-12-13 21:11:16,2010-12-13 21:11:05
22242889332ff65589ecea6262e33016b98cc8f2...2b5c8d876a81629e64836a29c3cf5fa1fdc0156e,2,16,17,33,2,2010-12-13 21:42:12,2010-12-13 21:42:12
2b5c8d876a81629e64836a29c3cf5fa1fdc0156e...74149fa1e2b8e11f34cc3557b3305afd9c85dd30,1,1,1,2,1,2010-12-13 21:42:57,2010-12-13 21:42:57
74149fa1e2b8e11f34cc3557b3305afd9c85dd30...c7c5a57b1fa9f32c5a5072e0fbe80ed32dbccd18,16,5,66,71,31,2010-12-13 23:03:32,2010-12-13 23:03:32
c7c5a57b1fa9f32c5a5072e0fbe80ed32dbccd18...bd8b5fe801c3adbecad090bb82832e75f9dd4d5d,3,14,14,28,10,2010-12-13 23:54:53,2010-12-13 19:47:11
bd8b5fe801c3adbecad090bb82832e75f9dd4d5d...54a40fe790e9e33fa014eb86998fc5d35d81848e,1,1,0,1,1,2010-12-13 23:54:53,2010-12-13 19:47:46
54a40fe790e9e33fa014eb86998fc5d35d81848e...02572f806f3d35ec4fb4daa01996c37ac5d01621,2,11,5,16,7,2010-12-13 23:54:53,2010-12-13 20:17:38
02572f806f3d35ec4fb4daa01996c37ac5d01621...f2a3be8596e180affe60e8c8adfeae319059433d,3,6,6,12,6,2010-12-13 23:54:53,2010-12-13 21:40:21
f2a3be8596e180affe60e8c8adfeae319059433d...2198a6d2669d79c1f524e3433930c52a6ddc84ca,3,6,6,12,3,2010-12-13 23:54:53,2010-12-13 21:43:44
2198a6d2669d79c1f524e3433930c52a6ddc84ca...e1bcc6b3a2893342f6e23d781c3d5fcc39af38e5,1,20,20,40,5,2010-12-14 00:02:27,2010-12-13 23:31:54
e1bcc6b3a2893342f6e23d781c3d5fcc39af38e5...623ad9da1ad8495e9324cc95ee6fff8fb05a7ee9,2,2,2,4,2,2010-12-14 00:02:27,2010-12-13 23:51:31
623ad9da1ad8495e9324cc95ee6fff8fb05a7ee9...a774b9c5d3b89ebfbfc70ee1122787e0c4dd92d9,1,1,1,2,1,2010-12-14 01:07:40,2010-12-14 01:07:40
a774b9c5d3b89ebfbfc70ee1122787e0c4dd92d9...7ee635b2a2b0d4114ba67519f43c42ce5c57c11c,1,2,1,3,1,2010-12-14 01:09:00,2010-12-14 01:09:00
7ee635b2a2b0d4114ba67519f43c42ce5c57c11c...166adfc64dfb1cd171599ca91b12b9b7f789cc6e,1,1,1,2,1,2010-12-14 01:22:54,2010-12-14 01:22:54
166adfc64dfb1cd171599ca91b12b9b7f789cc6e...6691b05e5b7596c7f004cfd81bed7267ee526200,1,3,1,4,1,2010-12-14 01:29:58,2010-12-14 01:29:58
6691b05e5b7596c7f004cfd81bed7267ee526200...8f98101ecb5293a1c28f09d7be4540b2f67bd920,1,4,9,13,1,2010-12-14 01:45:16,2010-12-14 01:45:16
8f5ad4af9481d63e194ee3966d76f73d62988db7...fd01984a7bb84020d0e3ede9960e24ab77698bbe,1,4,4,8,3,2010-12-21 18:05:53,2010-12-21 18:05:53
fd01984a7bb84020d0e3ede9960e24ab77698bbe...da7949e46b6123f4ae25525ea5ced9651a76b8d6,1,1,1,2,1,2010-12-21 19:20:22,2010-12-21 19:19:05
da7949e46b6123f4ae25525ea5ced9651a76b8d6...0489b80ed2c2009cc706ae13cd83bc465d4283e2,1,38,1,39,5,2010-12-21 19:20:23,2010-12-21 19:20:05
0489b80ed2c2009cc706ae13cd83bc465d4283e2...c754cd2ebbd1003e938927484ea849bed09e4726,1,1,1,2,1,2010-12-21 21:56:04,2010-12-21 21:56:04
c754cd2ebbd1003e938927484ea849bed09e4726...b043cc1272e7901561b85980cf302b8ec5a2cdc0,2,2,5,7,3,2010-12-21 21:56:18,2010-12-21 21:56:18
b043cc1272e7901561b85980cf302b8ec5a2cdc0...0df080d06db64e3275c64cf57f4b1d98c3d27a6b,1,2,1,3,2,2010-12-21 22:31:12,2010-12-21 20:10:15
0df080d06db64e3275c64cf57f4b1d98c3d27a6b...3f2c6d4011e3d76b15004d3bb339ca72db0e6b53,1,6,3,9,5,2010-12-21 22:31:12,2010-12-21 20:32:05
3f2c6d4011e3d76b15004d3bb339ca72db0e6b53...6dfed5cf8cc38aa1623668e991d74846592752d1,1,1,1,2,1,2010-12-21 22:31:12,2010-12-21 20:37:37
6dfed5cf8cc38aa1623668e991d74846592752d1...3540eed391ad35294748c731d5b44db1a97932fe,1,1,1,2,1,2010-12-21 22:31:13,2010-12-21 20:37:52
3540eed391ad35294748c731d5b44db1a97932fe...bcd54eb09c424e9b88e857ed17c35a73ee56aa53,1,26,6,32,6,2010-12-21 22:31:13,2010-12-21 22:30:46
bcd54eb09c424e9b88e857ed17c35a73ee56aa53...a0151972c16a9b30b3dbca7609d1a58792664d71,1,3,0,3,2,2010-12-22 02:23:52,2010-12-22 00:18:41
a0151972c16a9b30b3dbca7609d1a58792664d71...63cbf0d152ebbf26100d5a50c8a927338994a52b,2,42,30,72,3,2010-12-22 02:23:52,2010-12-21 23:11:45
63cbf0d152ebbf26100d5a50c8a927338994a52b...011fb119d2c72f4c5f8846420b055f823e3c644d,1,2,2,4,3,2010-12-22 02:23:52,2010-12-21 23:12:55
011fb119d2c72f4c5f8846420b055f823e3c644d...cebdea321dafc414ec713c33de1dbc00115d37cd,2,8,2,10,4,2010-12-22 02:23:53,2010-12-21 23:22:04
cebdea321dafc414ec713c33de1dbc00115d37cd...2e8dac2878b255770bce5ea020cf47dfd921e846,2,16,3,19,8,2010-12-22 02:23:53,2010-12-21 23:55:08
2e8dac2878b255770bce5ea020cf47dfd921e846...42466ac48c2d6b88d21f79142e564645d3b30eb1,3,15,7,22,10,2010-12-22 02:23:53,2010-12-22 00:35:15
42466ac48c2d6b88d21f79142e564645d3b30eb1...175e40aa9252af56c3fef7a7ff85be3abf9f6ba7,1,10,0,10,4,2010-12-22 02:23:53,2010-12-22 01:11:37
175e40aa9252af56c3fef7a7ff85be3abf9f6ba7...b2a5fb0d9ca9405570a027111a1b24d58fbf384f,1,0,2,2,2,2010-12-22 02:23:53,2010-12-22 01:42:06
b2a5fb0d9ca9405570a027111a1b24d58fbf384f...13eb7b696108df05a7fcc2e99db49108888fbc32,1,5,0,5,2,2010-12-22 02:23:53,2010-12-22 02:21:16
13eb7b696108df05a7fcc2e99db49108888fbc32...34c097a9b56425e8c141cba19edd31d86e73c81e,1,39,37,76,6,2010-12-22 04:27:19,2010-12-22 04:22:15
34c097a9b56425e8c141cba19edd31d86e73c81e...94094cf0d34764563cfa1b6035014b1ccc4e9d67,1,35,0,35,1,2010-12-22 05:38:50,2010-12-22 05:38:50
94094cf0d34764563cfa1b6035014b1ccc4e9d67...86216e47f9268954b12d4c6ef979209c85400263,2,30,20,50,18,2010-12-22 06:42:52,2010-12-22 06:42:52
86216e47f9268954b12d4c6ef979209c85400263...c76a27e18dd95a58cf70f27ab2ab75f20e456710,1,1,7,8,2,2010-12-22 07:24:01,2010-12-22 06:57:35
c76a27e18dd95a58cf70f27ab2ab75f20e456710...af55128c2be5c9207d8e6ea6c326bc5883d01cba,1,1,2,3,2,2010-12-22 07:46:17,2010-12-22 07:44:40
af55128c2be5c9207d8e6ea6c326bc5883d01cba...d9c438f7f1b0639a0df2fc43f196eee0cde7c9fe,1,7,2,9,3,2010-12-22 07:47:28,2010-12-22 07:10:15
d9c438f7f1b0639a0df2fc43f196eee0cde7c9fe...b0845cb442f8da28d244b77936b61ea9d40a0a1c,3,5,5,10,5,2010-12-22 07:48:47,2010-12-22 07:48:47
b0845cb442f8da28d244b77936b61ea9d40a0a1c...cf3ab4db730c1b891b57fb4f47e9f03b4c6be896,1,1,1,2,1,2010-12-22 14:38:11,2010-12-22 14:38:11
cf3ab4db730c1b891b57fb4f47e9f03b4c6be896...e7fee1e5e6e1202efe95d51df0c097f383f5f667,4,26,27,53,20,2010-12-22 14:44:32,2010-12-22 14:44:32
e7fee1e5e6e1202efe95d51df0c097f383f5f667...1f9e8fcad6851c828ba4a91a5f3aa5bcab3e4691,1,1,1,2,1,2010-12-22 14:50:28,2010-12-22 14:50:28
1f9e8fcad6851c828ba4a91a5f3aa5bcab3e4691...8247227d7404f24c122b88d204dda8d370b4b485,1,3,0,3,1,2010-12-22 14:54:17,2010-12-22 14:54:17
8247227d7404f24c122b88d204dda8d370b4b485...9a4661620538960f5ef0b6475655664c73ef1518,1,1,1,2,1,2010-12-22 15:17:52,2010-12-22 15:17:52
9a4661620538960f5ef0b6475655664c73ef1518...8cf2e8f751518b7b2eaed173e3a7605e742b2131,8,95,5,100,10,2010-12-22 17:30:46,2010-12-22 17:29:30
8cf2e8f751518b7b2eaed173e3a7605e742b2131...27d2053cddbc0080ec43ed468f2a9987701aa1da,1,0,1,1,1,2010-12-22 17:39:12,2010-12-22 17:39:12
27d2053cddbc0080ec43ed468f2a9987701aa1da...7de690cc96dc195ec721d3a081f94bcc7bac12fa,1,6,6,12,2,2010-12-22 17:42:35,2010-12-22 17:42:35
7de690cc96dc195ec721d3a081f94bcc7bac12fa...6821e09a571f743e36eca217e464e178274cedda,1,1,1,2,1,2010-12-22 17:43:46,2010-12-22 17:43:46
6821e09a571f743e36eca217e464e178274cedda...1a1b3326e084e1f62b17ca321a730840a7e8ef55,1,1,1,2,1,2010-12-22 18:32:03,2010-12-22 18:26:54
1a1b3326e084e1f62b17ca321a730840a7e8ef55...cbe4a9a8d24ed56e9c0c748a18d825e027040054,2,18,3,21,4,2010-12-22 18:32:03,2010-12-22 18:27:06
cbe4a9a8d24ed56e9c0c748a18d825e027040054...4acc8e75d93a4f1709297b8a73aebfef0eb9f456,1,6,7,13,1,2010-12-22 18:32:03,2010-12-22 18:31:52
4acc8e75d93a4f1709297b8a73aebfef0eb9f456...b47d8326864a496ed091dd72f42ff0198dd7ca98,1,1,1,2,1,2010-12-22 19:52:25,2010-12-22 19:22:03
b47d8326864a496ed091dd72f42ff0198dd7ca98...fef14e03cdabace9fb635607b3dbe5ba8e834989,1,8,1,9,3,2010-12-22 19:52:27,2010-12-22 19:23:36
fef14e03cdabace9fb635607b3dbe5ba8e834989...0ba5c6073f909cd0c205a7d0a2c50d3e58e41666,1,99,0,99,1,2010-12-22 19:52:28,2010-12-22 19:50:55
0ba5c6073f909cd0c205a7d0a2c50d3e58e41666...f68ffd9becb4d360f7105cab50d90453256f0118,1,1,1,2,1,2010-12-22 19:52:29,2010-12-22 19:51:21
f68ffd9becb4d360f7105cab50d90453256f0118...effea651a56baa613d0eb07e14a090ca986af7f6,1,0,97,97,1,2010-12-22 19:52:31,2010-12-22 19:51:32
effea651a56baa613d0eb07e14a090ca986af7f6...b1c49b247b4f673e772d0bea3106de896bbfb9c5,2,23,8,31,8,2010-12-22 20:12:26,2010-12-22 20:12:26
b1c49b247b4f673e772d0bea3106de896bbfb9c5...e81705343be3e972078ebf6e1578f892518a6e8d,1,1,1,2,1,2010-12-22 20:55:23,2010-12-22 20:55:23
e81705343be3e972078ebf6e1578f892518a6e8d...48d3c2dff552f42a8b29a81490102638f6af5d22,1,8,6,14,5,2010-12-22 21:42:02,2010-12-22 21:41:52
48d3c2dff552f42a8b29a81490102638f6af5d22...dcffbd661ddb37d9b9b53dd1ef2693edbf5326a0,1,2,4,6,2,2010-12-22 21:52:47,2010-12-22 17:33:55
dcffbd661ddb37d9b9b53dd1ef2693edbf5326a0...82d46601e1283d7140523a800b77a2af0957e44b,3,24,24,48,14,2010-12-22 21:52:47,2010-12-22 19:20:45
82d46601e1283d7140523a800b77a2af0957e44b...0bd4f7db8d750438722048eb9cc46d95e71be82e,3,12,9,21,9,2010-12-22 21:52:47,2010-12-22 19:26:01
0bd4f7db8d750438722048eb9cc46d95e71be82e...340c10a7d5127e8740600b72f2d00b27df1485a9,3,17,14,31,10,2010-12-22 21:52:47,2010-12-22 21:29:48
340c10a7d5127e8740600b72f2d00b27df1485a9...9c0a214851cc4af82c93f15a03676a4b264bd073,1,2,2,4,2,2010-12-22 22:44:40,2010-12-22 21:33:53
9c0a214851cc4af82c93f15a03676a4b264bd073...a1c70486b90da64965a9c0cddac8779f7d6c8eb8,1,10,1,11,1,2010-12-22 22:48:54,2010-12-22 22:48:54
a1c70486b90da64965a9c0cddac8779f7d6c8eb8...0c14ad831cb7578eb0402015d845f4e77c374c1b,2,2,2,4,2,2010-12-22 23:01:44,2010-12-22 23:01:30
0c14ad831cb7578eb0402015d845f4e77c374c1b...52a46867c7b862edf871df4a27f49858ff535802,3,180,40,220,15,2010-12-22 23:43:08,2010-12-22 23:42:08
52a46867c7b862edf871df4a27f49858ff535802...67149434be8fc407bc84fa62cc624c36f550104e,1,1,1,2,1,2010-12-23 01:29:02,2010-12-23 01:29:02
67149434be8fc407bc84fa62cc624c36f550104e...f3376694022769a6c4d55bc410c45caf39d86e8d,5,104,17,121,9,2010-12-23 02:58:54,2010-12-23 02:58:54
f3376694022769a6c4d55bc410c45caf39d86e8d...ee95e4c7677b9b0a1d2084ad8336d788163030e6,1,15,0,15,3,2010-12-23 03:17:18,2010-12-23 03:17:18
ee95e4c7677b9b0a1d2084ad8336d788163030e6...d0adeb9a40ca7eb30516751e34fdb4826460040d,1,2,2,4,2,2010-12-23 04:17:42,2010-12-23 04:17:42
d0adeb9a40ca7eb30516751e34fdb4826460040d...1b422f863c38dfa32ee62c752f23963bb96b2b72,2,14,4,18,4,2010-12-23 04:37:30,2010-12-23 04:37:12
1b422f863c38dfa32ee62c752f23963bb96b2b72...dc64d5399e1b29c9d37a0c30277be93f42dbdd35,1,2,2,4,2,2010-12-23 04:39:47,2010-12-23 04:39:47
dc64d5399e1b29c9d37a0c30277be93f42dbdd35...12a51ef1caa31060748c6208a45097a313214c2e,1,3,5,8,2,2010-12-23 04:53:38,2010-12-23 04:53:38
8f98101ecb5293a1c28f09d7be4540b2f67bd920...eb70ed360d89041950f084dbcc57c6f92717a386,1,5,2,7,1,2010-12-14 03:12:15,2010-12-14 03:12:15
eb70ed360d89041950f084dbcc57c6f92717a386...cd49f778d9a3093ace050d6d2683a7035712e740,1,1,1,2,1,2010-12-14 03:13:03,2010-12-14 03:13:03
8f98101ecb5293a1c28f09d7be4540b2f67bd920...de9b3527e7bae5dbb4383ce92a5e757276fe6a25,1,1,1,2,1,2010-12-14 01:59:16,2010-12-14 01:58:36
12a51ef1caa31060748c6208a45097a313214c2e...2cbebcb827a86bbc231140d0568abc7bfed65534,1,12,0,12,1,2010-12-23 19:50:22,2010-12-23 19:50:22
2cbebcb827a86bbc231140d0568abc7bfed65534...53e0374e57e60c59b8cb47a7b9b6f6c4a1b63bdf,1,1,1,2,2,2010-12-23 19:50:49,2010-12-23 19:50:49
53e0374e57e60c59b8cb47a7b9b6f6c4a1b63bdf...4f6f8c823973fe080d8461e61a4d93352c695b4a,2,26,11,37,8,2010-12-23 19:51:18,2010-12-23 19:51:18
4f6f8c823973fe080d8461e61a4d93352c695b4a...b3e392624fc6a1291f6992290a8c488c20ec8bb0,1,8,1,9,2,2010-12-23 19:57:31,2010-12-23 19:57:31
12a51ef1caa31060748c6208a45097a313214c2e...9361b7cf9b049a609227cd08bb6e96348816f142,1,13,2,15,2,2010-12-23 17:38:30,2010-12-23 17:07:24
9361b7cf9b049a609227cd08bb6e96348816f142...569b3b0199dd00c074b41d338f5fac46f7d6529b,3,149,23,172,16,2010-12-23 18:51:46,2010-12-23 18:51:25
0a854688dfc9e769b2399053a8eb00ac9b6b2a48...e97dddd66b732bd296c547f985b1c2bf62cb1edf,1,2,2,4,2,2010-12-14 05:26:46,2010-12-14 05:26:46
e97dddd66b732bd296c547f985b1c2bf62cb1edf...573dcb41e4a0fbf5f711a5f4c82136964f3b2d75,2,20,0,20,3,2010-12-14 07:40:27,2010-12-14 07:40:27
573dcb41e4a0fbf5f711a5f4c82136964f3b2d75...d7569703d957e5a6a8021d0911dd4e75e655d864,2,2,10,12,3,2010-12-14 07:40:37,2010-12-14 07:40:37
d7569703d957e5a6a8021d0911dd4e75e655d864...f477e690d308e795b864d7100621e9a871cae11a,1,14,0,14,1,2010-12-14 07:43:34,2010-12-14 07:43:34
f477e690d308e795b864d7100621e9a871cae11a...394455bba933af4515ba76113618a2fbf93eb7fc,1,2,2,4,1,2010-12-14 11:51:42,2010-12-14 11:51:42
394455bba933af4515ba76113618a2fbf93eb7fc...1e196fb8518a6ff3c82a25f520ec954de80f8e39,1,5,0,5,1,2010-12-14 15:09:43,2010-12-14 15:09:31
1e196fb8518a6ff3c82a25f520ec954de80f8e39...efac81dc3953834ec4605517df93688f84348d25,1,335,335,670,31,2010-12-14 16:23:51,2010-12-14 16:21:05
efac81dc3953834ec4605517df93688f84348d25...a6127a617b7fe129bc66e98db202b4f64cedf105,2,297,175,472,84,2010-12-14 16:23:51,2010-12-14 16:23:40
a6127a617b7fe129bc66e98db202b4f64cedf105...d2092adc167ef848dec73708a393e664c49d8e0a,2,10,1,11,2,2010-12-14 18:52:32,2010-12-14 18:47:22
d2092adc167ef848dec73708a393e664c49d8e0a...9c14510e648868e5e544599a17d7b0f7006d9907,2,25,1,26,2,2010-12-14 18:52:32,2010-12-14 18:48:52
9c14510e648868e5e544599a17d7b0f7006d9907...3b5f19c5871af7f038fb1b5bb757c50f3e89b3fb,1,7,7233,7240,10,2010-12-14 18:52:32,2010-12-14 18:51:08
3b5f19c5871af7f038fb1b5bb757c50f3e89b3fb...d946dce6920adf9b39a7d01546d6780911879b43,1,2,1,3,1,2010-12-14 19:24:42,2010-12-14 17:39:17
d946dce6920adf9b39a7d01546d6780911879b43...488eeaadec00f5fa45d9445a1521e993d57ec698,1,1,1,2,1,2010-12-14 19:24:42,2010-12-14 17:44:59
488eeaadec00f5fa45d9445a1521e993d57ec698...f74c2e179e6de7ed033339d7100b3b1378edc921,1,1,1,2,1,2010-12-14 20:34:40,2010-12-14 20:34:32
f74c2e179e6de7ed033339d7100b3b1378edc921...8e73062d8892089b948a25a42f828c9b861e623e,2,114,0,114,3,2010-12-14 21:06:59,2010-12-14 21:06:45
8e73062d8892089b948a25a42f828c9b861e623e...b55418440ae733de956c3b96aa34a68de5246186,1,6,0,6,1,2010-12-14 23:06:59,2010-12-14 23:06:59
b55418440ae733de956c3b96aa34a68de5246186...b608193a5852728a3664e14f941bef93866ffdfd,1,2,1,3,1,2010-12-15 01:23:17,2010-12-15 01:23:17
b608193a5852728a3664e14f941bef93866ffdfd...ba84222056a7c926b6a92c7e17d50184b18b610f,7,37,15,52,15,2010-12-15 01:27:24,2010-12-15 01:27:24
ba84222056a7c926b6a92c7e17d50184b18b610f...bcae358b9538bb45a54e1dca8f6d4b52d3fd4f06,1,1,1,2,1,2010-12-15 05:25:54,2010-12-15 05:25:54
bcae358b9538bb45a54e1dca8f6d4b52d3fd4f06...094efa18f900590837ae3058a1d5007824f6ab6e,1,0,3259,3259,1,2010-12-15 05:32:33,2010-12-15 05:32:33
094efa18f900590837ae3058a1d5007824f6ab6e...2da179f9a718ec904b4988ce91036f0ea5701494,1,1,1,2,1,2010-12-15 05:36:52,2010-12-15 05:36:52
2da179f9a718ec904b4988ce91036f0ea5701494...3ac6dfcd5cb768f793b845d871971133afd73962,2,178,126,304,48,2010-12-15 14:32:58,2010-12-14 19:09:50
3ac6dfcd5cb768f793b845d871971133afd73962...e5d0731c2d1e28b03c0a4bec194126f75bc14752,2,37,28,65,17,2010-12-15 14:32:58,2010-12-14 19:17:12
e5d0731c2d1e28b03c0a4bec194126f75bc14752...845360735a617684a4b3cafe8d8632cc64695493,2,94,71,165,13,2010-12-15 14:32:58,2010-12-14 19:37:24
845360735a617684a4b3cafe8d8632cc64695493...c022b54c08674e575c05589c525dea65dbbbb696,5,5,5,10,5,2010-12-15 14:50:35,2010-12-15 14:50:35
c022b54c08674e575c05589c525dea65dbbbb696...c7700058748d86e0643e2c2461d2673e7ca17bf9,2,30,25,55,23,2010-12-15 14:51:01,2010-12-15 14:51:01
c7700058748d86e0643e2c2461d2673e7ca17bf9...12477016f988d1d441e1cc0032cf45131b2594fa,1,2,2,4,2,2010-12-15 15:42:41,2010-12-15 02:19:06
12477016f988d1d441e1cc0032cf45131b2594fa...30d7c304fd333bc336792e585d73efd62da52606,1,2,1,3,1,2010-12-15 15:42:42,2010-12-15 07:07:29
30d7c304fd333bc336792e585d73efd62da52606...62fbef60e708eaaf02de89be7af18edea4e5677e,12,126,72,198,58,2010-12-15 15:42:43,2010-12-15 07:07:45
62fbef60e708eaaf02de89be7af18edea4e5677e...dad23bdae06bf171b7f2e5b2f1d4ed1f1ca07751,12,72,126,198,58,2010-12-15 15:42:45,2010-12-15 07:08:49
dad23bdae06bf171b7f2e5b2f1d4ed1f1ca07751...8a6a30bcb1564e91897206942bb9e5ae1baabe84,1,1,2,3,1,2010-12-15 15:42:46,2010-12-15 07:09:04
8a6a30bcb1564e91897206942bb9e5ae1baabe84...e0b30e313f2c5b77ee4473bfbcedc0b332051f7e,2,64,2,66,3,2010-12-15 15:42:47,2010-12-15 07:11:03
e0b30e313f2c5b77ee4473bfbcedc0b332051f7e...576feea5bb3661c5cfae88836a0ebf02ef77f902,1,2,1,3,1,2010-12-15 15:42:48,2010-12-15 07:12:55
576feea5bb3661c5cfae88836a0ebf02ef77f902...6689861a0d69e10446aebe2d04229311ed00390c,12,126,72,198,58,2010-12-15 15:42:50,2010-12-15 07:13:26
6689861a0d69e10446aebe2d04229311ed00390c...dd6beabbbfa06b7e61fde020d243ddc54bf7dcc5,2,2,1,3,2,2010-12-15 15:48:55,2010-12-15 15:48:55
dd6beabbbfa06b7e61fde020d243ddc54bf7dcc5...2393123c66ee498d9c2770be31bcc92d47d47a40,1,11,0,11,1,2010-12-15 15:52:19,2010-12-15 15:52:19
2393123c66ee498d9c2770be31bcc92d47d47a40...4d351c23f7eaaf5a03c103ad38edc053943a36d1,1,9,3,12,3,2010-12-15 17:07:12,2010-12-15 17:07:12
4d351c23f7eaaf5a03c103ad38edc053943a36d1...455f841fa731dd201a3115aab54dc4f7a370da74,1,1,0,1,1,2010-12-15 18:07:09,2010-12-15 18:07:09
455f841fa731dd201a3115aab54dc4f7a370da74...d039110cb7adf43af9c9c6fc0e19818d76f3800c,1,1,1,2,1,2010-12-15 18:23:11,2010-12-15 18:23:11
d039110cb7adf43af9c9c6fc0e19818d76f3800c...1d53f7ea9b237b459caf088f5a755555b39391c5,1,3,3,6,3,2010-12-15 19:43:04,2010-12-14 22:01:11
1d53f7ea9b237b459caf088f5a755555b39391c5...bc915c7cefc198e8d9841cdeed2f95cc04ce5f3f,1,4,2,6,2,2010-12-15 19:43:04,2010-12-14 22:12:02
bc915c7cefc198e8d9841cdeed2f95cc04ce5f3f...fd9777cfb4d640f54a71dcc360460869f161638e,1,1,1,2,1,2010-12-15 19:43:04,2010-12-15 17:27:41
fd9777cfb4d640f54a71dcc360460869f161638e...ab45b9af2538a5c8b018cb18b7c2b66bbec1c82c,2,12,18,30,6,2010-12-15 19:43:05,2010-12-15 19:42:09
ab45b9af2538a5c8b018cb18b7c2b66bbec1c82c...83a78478c2e84d8da29b0cd03ee96be766d749ef,2,1,11,12,3,2010-12-15 19:51:33,2010-12-15 19:51:33
83a78478c2e84d8da29b0cd03ee96be766d749ef...057443fa137c87d950b92070213a753b975abbac,2,12,1,13,4,2010-12-15 21:46:32,2010-12-15 21:46:32
057443fa137c87d950b92070213a753b975abbac...2325d9c61a59fcbcdd5d981700a7fd1a64f5d4ca,1,39,7,46,11,2010-12-15 22:19:51,2010-12-15 22:19:51
2325d9c61a59fcbcdd5d981700a7fd1a64f5d4ca...ea2bb1d419b62dd8f04b00d4c98583e27f12938d,1,1,2,3,1,2010-12-15 22:23:19,2010-12-15 22:23:19
ea2bb1d419b62dd8f04b00d4c98583e27f12938d...cd692f0af1c4a0afe1625e2c91c402e9d298d730,1,11,10,21,2,2010-12-16 00:21:12,2010-12-15 23:10:49
cd692f0af1c4a0afe1625e2c91c402e9d298d730...b5426b7948425910ff9e114a291d7abae9e58f43,1,12,6,18,2,2010-12-16 00:21:12,2010-12-15 23:42:28
b5426b7948425910ff9e114a291d7abae9e58f43...eff8dba307eb7bfd15045961adc9325124cb295b,1,9,3,12,2,2010-12-16 14:31:02,2010-12-16 14:31:02
9f03dfe7df918063feb2547aeac48eaa716009ae...4e76652538793cc5c4caa71b76a49dcba0f3166d,4,8,10,18,7,2010-12-23 20:04:39,2010-12-23 19:40:54
4e76652538793cc5c4caa71b76a49dcba0f3166d...8de039c000163df98ed710c81ac944d44cb29b8f,1,1,1,2,1,2010-12-23 20:15:40,2010-12-23 20:15:40
8de039c000163df98ed710c81ac944d44cb29b8f...9fbb4f81f42a50d88bb520af307cb237a48146dc,2,22,8,30,5,2010-12-23 20:49:22,2010-12-23 20:42:15
9fbb4f81f42a50d88bb520af307cb237a48146dc...a6bf3b2b61453a72842ff03bc9f416a185d3fb35,2,14,11,25,9,2010-12-23 20:49:22,2010-12-23 20:49:18
eff8dba307eb7bfd15045961adc9325124cb295b...0fa8c65cc0c5f8eaa4eae77b061bac910bf2ae73,2,59,1,60,5,2010-12-16 20:11:30,2010-12-16 20:11:30
eff8dba307eb7bfd15045961adc9325124cb295b...30c1709c2bceea522206761f2ba26ae99071965c,1,4,2,6,2,2010-12-16 19:31:59,2010-12-16 19:31:47
30c1709c2bceea522206761f2ba26ae99071965c...b0bafdf7d4617b936d5ffcbfd3bcbb5727ee1efb,1,1,1,2,1,2010-12-16 19:33:13,2010-12-16 19:33:13
b0bafdf7d4617b936d5ffcbfd3bcbb5727ee1efb...864a25da7401cc1a5e3b9832a9248b83e9a40ddb,1,4,3,7,2,2010-12-16 19:47:45,2010-12-16 19:47:31
a6bf3b2b61453a72842ff03bc9f416a185d3fb35...d5e6b184cd5828de1aeedb900cc6419d37f928da,1,2,1,3,2,2010-12-24 16:10:13,2010-12-24 16:10:13
d5e6b184cd5828de1aeedb900cc6419d37f928da...0f468fa5c1a6ad6c2263ac55cbd101b0f0fb5986,2,32,11,43,10,2010-12-24 17:13:26,2010-12-24 17:13:26
0f468fa5c1a6ad6c2263ac55cbd101b0f0fb5986...6d2d81e8de64fae96c9f67c7ba9ed105dc3a76f2,1,1,1,2,1,2010-12-24 17:14:53,2010-12-24 17:14:53
6d2d81e8de64fae96c9f67c7ba9ed105dc3a76f2...324086f927ba1866ccd376b323de51099f726e00,1,28,3,31,9,2010-12-24 17:20:33,2010-12-24 17:20:33
a6bf3b2b61453a72842ff03bc9f416a185d3fb35...378ba71fd2d98fcfd73deebd32376bdcee08df82,2,67,1,68,2,2010-12-24 01:39:22,2010-12-24 01:39:22
29676e06d90b62455bcd13e585e008cb15a9fcee...24dd7ff6661ef17a13fd99241a66754e734ab8aa,2,2,1,3,2,2010-12-16 21:22:14,2010-12-16 17:47:53
24dd7ff6661ef17a13fd99241a66754e734ab8aa...adb706e20eb3bfccb499e8a9234e8544470193d0,1,3,2,5,2,2010-12-16 21:22:14,2010-12-16 17:48:48
adb706e20eb3bfccb499e8a9234e8544470193d0...c2496691f11bab8bef8e9a1cbce0d356577d09cd,1,5,0,5,1,2010-12-16 21:22:14,2010-12-16 21:20:53
c2496691f11bab8bef8e9a1cbce0d356577d09cd...c0fa67131864a2f2c5cf59f7cb83eb8612ab40b8,17,269,147,416,87,2010-12-16 21:41:28,2010-12-16 21:38:24
c0fa67131864a2f2c5cf59f7cb83eb8612ab40b8...2d588fee5159f925737a538b7861b797e91a9755,1,1,2,3,1,2010-12-16 22:21:37,2010-12-16 22:21:37
2d588fee5159f925737a538b7861b797e91a9755...81bb882b78b3191ecc944302dfafea5afb414b76,1,1,1,2,1,2010-12-16 22:28:34,2010-12-16 22:28:34
7ce5dd99ba4a496fa0d8b6a3f971db3abfc9b794...192d96eee1a799dd1ec3fdcef0b040a95051c147,1,3,0,3,1,2010-12-24 17:21:19,2010-12-24 17:21:19
192d96eee1a799dd1ec3fdcef0b040a95051c147...c648a80fb800c35a80015d4d35aa428be639ff36,2,17,5,22,6,2010-12-24 17:56:25,2010-12-24 17:56:25
c648a80fb800c35a80015d4d35aa428be639ff36...9594f14ef4ed313e30b541fe72313581cac162cd,1,9,2,11,3,2010-12-24 18:03:20,2010-12-24 18:03:20
9594f14ef4ed313e30b541fe72313581cac162cd...ee36889eefb700aa119062b3cf5ba273762444f3,3,25,23,48,3,2010-12-24 18:07:26,2010-12-24 18:07:26
ee36889eefb700aa119062b3cf5ba273762444f3...19b8c2be8ac44b717e1c7adb8083bd5d744d5683,2,39,3,42,5,2010-12-24 18:33:24,2010-12-24 18:31:46
19b8c2be8ac44b717e1c7adb8083bd5d744d5683...1794b2fe343a7a3bff305cfc8799ec670f40c82f,3,19,15,34,11,2010-12-24 18:43:06,2010-12-24 18:43:06
1794b2fe343a7a3bff305cfc8799ec670f40c82f...60814a460faa902b75b3dc0b209e89c52512c8d6,2,8,22,30,5,2010-12-25 04:17:09,2010-12-25 04:17:09
60814a460faa902b75b3dc0b209e89c52512c8d6...3007bd925db455d2ea8d62f98137b39820506837,2,19,4,23,3,2010-12-25 04:55:59,2010-12-25 04:55:59
3007bd925db455d2ea8d62f98137b39820506837...de3564331d6bc9e8bc79b1b45880df44f73e7cc9,1,7,11,18,4,2010-12-25 07:04:09,2010-12-25 07:04:09
de3564331d6bc9e8bc79b1b45880df44f73e7cc9...5d7fd2df7bf55ff4cbe3bf7b79d764dbc4ddba2f,1,27,1,28,5,2010-12-25 07:04:19,2010-12-25 07:04:19
5d7fd2df7bf55ff4cbe3bf7b79d764dbc4ddba2f...8e13302dfd36fc4c8c1d4b470e9303a2f95898ff,1,1,1,2,1,2010-12-25 07:18:45,2010-12-25 07:18:45
8e13302dfd36fc4c8c1d4b470e9303a2f95898ff...cfda39963141157f9b2c44c322435575482ee212,1,0,2,2,2,2010-12-25 17:00:58,2010-12-25 17:00:58
cfda39963141157f9b2c44c322435575482ee212...1ea270db8eaae9dba8ac051341415f78fb9e8f66,1,1,1,2,1,2010-12-25 18:18:08,2010-12-25 18:18:08
1ea270db8eaae9dba8ac051341415f78fb9e8f66...70c8a02e6d0b17748a364cc9a1cff9cb1f129226,1,2,0,2,1,2010-12-25 18:36:02,2010-12-25 18:36:02
70c8a02e6d0b17748a364cc9a1cff9cb1f129226...f68273ffd74fcbb5238146008141336ea214eb4c,1,1,1,2,1,2010-12-25 21:14:35,2010-12-25 21:14:35
f68273ffd74fcbb5238146008141336ea214eb4c...199a261ba1c12fe7264205e51ce6d49abc326c99,1,11,5,16,4,2010-12-26 05:24:07,2010-12-26 05:23:52
199a261ba1c12fe7264205e51ce6d49abc326c99...3f725fdc083e30df3eed4c5ac43b8d83a99bb9f0,1,3,2,5,3,2010-12-26 15:13:20,2010-12-26 15:13:20
3f725fdc083e30df3eed4c5ac43b8d83a99bb9f0...4260a74dbdbbe7ece95a5ab4fb8460370eef915a,1,18,0,18,2,2010-12-26 15:37:37,2010-12-26 15:37:37
4260a74dbdbbe7ece95a5ab4fb8460370eef915a...f35b33da44147deeb664eb0f2b8bcc696be5bcce,3,24,6,30,12,2010-12-26 16:07:06,2010-12-26 16:07:06
f35b33da44147deeb664eb0f2b8bcc696be5bcce...da18488b48eb41538344e6c3cef995d2ef8b189e,2,16,11,27,5,2010-12-26 16:17:07,2010-12-26 16:17:07
da18488b48eb41538344e6c3cef995d2ef8b189e...be369b5419068d663b22e3e45e9523140cef0a48,1,10,2,12,5,2010-12-26 16:49:48,2010-12-26 16:49:48
be369b5419068d663b22e3e45e9523140cef0a48...2c5aae61e2034b7fdb25f19ee81f620fd8ff217e,3,6,1,7,5,2010-12-26 16:50:37,2010-12-26 16:50:37
2c5aae61e2034b7fdb25f19ee81f620fd8ff217e...8c3f13ddd3857e24427615cf2e9b6151e2a11932,1,2,4,6,1,2010-12-26 17:51:52,2010-12-26 17:51:52
8c3f13ddd3857e24427615cf2e9b6151e2a11932...7131d955e87980c26d39c84f7ceb6e7505931a89,1,7,0,7,3,2010-12-26 18:23:25,2010-12-26 18:23:25
7131d955e87980c26d39c84f7ceb6e7505931a89...bae0fdb4687a814022d72a3a5f1fdadc94759218,4,30,2,32,7,2010-12-26 19:01:19,2010-12-26 19:01:19
bae0fdb4687a814022d72a3a5f1fdadc94759218...d5f1c31db8bba25403e10b0a2986134757d15750,1,11,9,20,1,2010-12-26 19:09:15,2010-12-26 19:08:31
d5f1c31db8bba25403e10b0a2986134757d15750...43cca1ddb88cf5688495a0f8f10f9db22eb3baa1,2,38,38,76,8,2010-12-26 21:43:54,2010-12-26 21:43:54
43cca1ddb88cf5688495a0f8f10f9db22eb3baa1...66ee7c3c61246b31c33f4a64714a4159d81db26c,1,1,0,1,1,2010-12-26 21:45:48,2010-12-26 21:45:48
66ee7c3c61246b31c33f4a64714a4159d81db26c...7bcbeaf91dd51f1c7a905942b7df5fb95f627dca,1,20,7,27,2,2010-12-27 07:59:45,2010-12-27 07:59:45
7bcbeaf91dd51f1c7a905942b7df5fb95f627dca...1fa6403ef672506d88f2b2db91e35cf5835bef79,1,1,1,2,1,2010-12-27 13:54:36,2010-12-27 13:54:36
1fa6403ef672506d88f2b2db91e35cf5835bef79...9472613d04a6a6f17980265c5f62041b7ce06334,7,80,14,94,23,2010-12-27 16:29:16,2010-12-27 16:29:16
9472613d04a6a6f17980265c5f62041b7ce06334...c0bc8d6d66d0f5f174b2bae8def422967841910a,1,3,3,6,3,2010-12-27 16:32:37,2010-12-27 16:32:37
c0bc8d6d66d0f5f174b2bae8def422967841910a...57be437dd82e21844d0ed5248a4b6f8f9ac5b61e,1,5,2,7,3,2010-12-27 16:58:03,2010-12-27 16:58:03
57be437dd82e21844d0ed5248a4b6f8f9ac5b61e...18f3236ce66df372021f7cba17d3de43379f6928,1,15,0,15,1,2010-12-27 18:32:37,2010-12-27 18:32:37
18f3236ce66df372021f7cba17d3de43379f6928...77c9fc26819053b7d8ccd76b760a2ec84a5eb15e,3,17,4,21,8,2010-12-27 19:21:56,2010-12-27 19:20:49
77c9fc26819053b7d8ccd76b760a2ec84a5eb15e...84a30c24e952319ab261895a0c2e2ad94cb0acf2,2,16,1,17,6,2010-12-27 19:30:54,2010-12-27 19:30:41
84a30c24e952319ab261895a0c2e2ad94cb0acf2...7085a082e30dfe5c914053f6e26bb2c82c3ea338,2,3,2,5,2,2010-12-27 19:33:13,2010-12-27 19:32:23
7085a082e30dfe5c914053f6e26bb2c82c3ea338...da324130dc721ef74b13af8cbea17d56996db90e,2,43,1,44,21,2010-12-27 19:51:58,2010-12-27 19:50:41
da324130dc721ef74b13af8cbea17d56996db90e...de3be2307dc314a3a5f62d45a96ed8036ca3b62f,1,5,5,10,2,2010-12-27 20:00:11,2010-12-27 19:59:58
de3be2307dc314a3a5f62d45a96ed8036ca3b62f...d38d0a7ab6a6e0c90b5b646b0672c5009cbc5d39,1,5,0,5,3,2010-12-27 20:33:51,2010-12-27 20:17:50
d38d0a7ab6a6e0c90b5b646b0672c5009cbc5d39...99eb5e363e7bfd37ca765f89f86afd5568673e65,3,12,3,15,7,2010-12-27 20:33:52,2010-12-27 20:33:33
99eb5e363e7bfd37ca765f89f86afd5568673e65...2a98ef2361646bfeb948cbf479716bd5aa1d998e,1,1,0,1,1,2010-12-27 20:55:05,2010-12-27 20:55:05
2a98ef2361646bfeb948cbf479716bd5aa1d998e...13e0fa9d12259859d8c8121f23e576340ed94839,1,1,1,2,1,2010-12-27 20:55:35,2010-12-27 20:55:35
13e0fa9d12259859d8c8121f23e576340ed94839...9a8dda83d13938e981194a87a5e60bdf2d623f50,1,1,1,2,1,2010-12-27 21:00:46,2010-12-27 21:00:46
9a8dda83d13938e981194a87a5e60bdf2d623f50...fbf7b90a1eac4b93180ecc2cf02ae8daadc5d7b3,14,412,44,456,22,2010-12-27 21:07:33,2010-12-27 21:05:40
fbf7b90a1eac4b93180ecc2cf02ae8daadc5d7b3...439881c42908d7eec21ebc9df0785b124aa4db1d,2,4,1,5,2,2010-12-27 21:20:11,2010-12-27 21:19:51
439881c42908d7eec21ebc9df0785b124aa4db1d...d0134074063b50ac9d05057145bfe81d0e5959cb,8,206,135,341,10,2010-12-27 21:27:32,2010-12-27 21:27:32
d0134074063b50ac9d05057145bfe81d0e5959cb...54ebaf04cc49e585f5144e4ad7044f69b2afa72f,1,39,13,52,8,2010-12-27 21:33:42,2010-12-27 21:33:42
54ebaf04cc49e585f5144e4ad7044f69b2afa72f...224a70df915283c9ad2f64b31556875497fdfba8,3,153,137,290,7,2010-12-27 21:44:15,2010-12-27 21:44:15
224a70df915283c9ad2f64b31556875497fdfba8...ff2e487de3eea5830aaee849851b744120982322,4,32,39,71,14,2010-12-27 22:01:48,2010-12-27 21:56:43
ff2e487de3eea5830aaee849851b744120982322...d951fc4c9d9f04bd5e1d969d3007bbe82aacfb62,1,18,17,35,4,2010-12-27 22:05:01,2010-12-27 22:04:32
d951fc4c9d9f04bd5e1d969d3007bbe82aacfb62...544f3cc836242e6929a81821e4f74bce4c6144c7,1,0,1,1,1,2010-12-27 22:33:36,2010-12-27 22:11:16
544f3cc836242e6929a81821e4f74bce4c6144c7...49407d7316efed834d5599aa048aafcb3ce67c43,3,5,1,6,5,2010-12-27 22:33:37,2010-12-27 22:33:21
49407d7316efed834d5599aa048aafcb3ce67c43...52ece4101c2e1dc5b6120323bb982ec4dabb92ff,1,23,22,45,13,2010-12-27 22:56:53,2010-12-27 22:05:49
52ece4101c2e1dc5b6120323bb982ec4dabb92ff...d6d9acb91bcbc582cbf626ef4b4c8101a3416a1c,2,71,9,80,27,2010-12-27 22:56:53,2010-12-27 22:56:19
d6d9acb91bcbc582cbf626ef4b4c8101a3416a1c...b3fedf38266e00eb508f9ae85256f68e676728a4,1,1,1,2,1,2010-12-27 23:24:37,2010-12-27 23:24:37
b3fedf38266e00eb508f9ae85256f68e676728a4...e08ccea99f02bea43d5e84f10db10810ffa31ac7,1,1,1,2,1,2010-12-27 23:53:11,2010-12-27 23:28:09
e08ccea99f02bea43d5e84f10db10810ffa31ac7...a6fba448b2f85b4cb7f299c151973337d9925e40,2,13,23,36,6,2010-12-27 23:53:11,2010-12-27 23:53:06
a6fba448b2f85b4cb7f299c151973337d9925e40...c9dbb72e93504e89118c944d14c6c931f26568c5,1,2,0,2,1,2010-12-28 01:30:49,2010-12-28 01:30:49
c9dbb72e93504e89118c944d14c6c931f26568c5...96eb960e2896e126582785cb1886f77e41e67e57,1,1,1,2,1,2010-12-28 03:55:23,2010-12-28 03:55:23
96eb960e2896e126582785cb1886f77e41e67e57...28b9f0377d23e7b4253bd6241875bfc62d24c41f,2,13,1,14,3,2010-12-28 06:00:15,2010-12-28 06:00:15
28b9f0377d23e7b4253bd6241875bfc62d24c41f...bf28508aa4fb1f3c97813b54d7011fc1995eadd6,2,43,51,94,9,2010-12-28 06:30:06,2010-12-28 02:10:58
bf28508aa4fb1f3c97813b54d7011fc1995eadd6...dccc20d6c9c6e02cfbf7151ee37ece9bafa545a3,3,132,21,153,7,2010-12-28 06:30:06,2010-12-28 05:41:07
dccc20d6c9c6e02cfbf7151ee37ece9bafa545a3...0ee14969a0eaf4f63428c96117e947e822e5126a,1,24,27,51,2,2010-12-28 06:30:06,2010-12-28 06:15:20
0ee14969a0eaf4f63428c96117e947e822e5126a...3b7152d81bc6b30fa15bfd301d28924a33ac5dfe,1,3,2,5,1,2010-12-28 06:36:01,2010-12-28 06:36:01
3b7152d81bc6b30fa15bfd301d28924a33ac5dfe...c05c212eb3359ac357f8e621875f0753975d2a95,4,12,0,12,5,2010-12-28 15:51:28,2010-12-28 15:51:28
c05c212eb3359ac357f8e621875f0753975d2a95...9435935283980bf8d0d5d45b663ee574cda784fa,1,23,5,28,3,2010-12-28 16:06:20,2010-12-28 16:06:20
9435935283980bf8d0d5d45b663ee574cda784fa...1f6f0fa8ec218e34a6227ac1367f03fdfbd553d2,2,4,0,4,2,2010-12-28 16:06:33,2010-12-28 16:06:33
c05c212eb3359ac357f8e621875f0753975d2a95...e9b71963022e1c5881764636a4f2113f42a68c93,1,1,1,2,1,2010-12-28 15:57:13,2010-12-28 15:57:01
d3f77d95eb0b995a485198c8e87876decee215e5...a4045bc7ccb67ca6161503eefa7de27a51e523f2,1,0,1,1,1,2010-12-28 16:47:33,2010-12-28 16:47:33
a4045bc7ccb67ca6161503eefa7de27a51e523f2...83b6d04f0d3742095f18bab54359712d775160c9,1,1,1,2,1,2010-12-28 17:53:14,2010-12-28 17:53:14
83b6d04f0d3742095f18bab54359712d775160c9...f6f605355d97511cd60ba9cf34433fe791f0ec50,1,7,0,7,3,2010-12-28 18:38:47,2010-12-28 18:38:34
f6f605355d97511cd60ba9cf34433fe791f0ec50...0512c2ad13dc9c4c7bb5e1ed5d17f697bff9842b,1,2,2,4,2,2010-12-28 18:46:36,2010-12-28 18:46:36
0512c2ad13dc9c4c7bb5e1ed5d17f697bff9842b...5e5ed8bb03e9e624bef9ef946707bb61275eead9,2,12,12,24,7,2010-12-28 19:54:29,2010-12-28 19:54:15
5e5ed8bb03e9e624bef9ef946707bb61275eead9...ff3699851d7420b02c1fad9143602578cba1e41e,1,1,0,1,1,2010-12-28 21:11:26,2010-12-28 21:11:13
ff3699851d7420b02c1fad9143602578cba1e41e...497a8624915b596b04088fcda53da59a3ad320cc,1,1,1,2,1,2010-12-28 22:13:52,2010-12-28 16:57:28
497a8624915b596b04088fcda53da59a3ad320cc...1dd733af1a323a6e5c54373262cac8d3dc8db6ea,1,2,1,3,1,2010-12-28 22:13:52,2010-12-28 17:46:22
1dd733af1a323a6e5c54373262cac8d3dc8db6ea...4abdbb73db174869566938c9dc0c460afd38d2a6,1,1,1,2,2,2010-12-28 22:13:52,2010-12-28 22:13:10
4abdbb73db174869566938c9dc0c460afd38d2a6...55acd83dd0606342b77c0e1dc87210733ff235f1,1,2,0,2,1,2010-12-28 22:30:35,2010-12-28 19:04:42
55acd83dd0606342b77c0e1dc87210733ff235f1...bf79f5a009e1e18fbcc78ffea86a0de8e4c5a706,1,4,5,9,1,2010-12-28 22:30:35,2010-12-28 19:06:48
bf79f5a009e1e18fbcc78ffea86a0de8e4c5a706...ef7a5a2ef8ad36bd040502d968bffa398652d8e3,1,2,2,4,1,2010-12-28 22:30:35,2010-12-28 22:29:06
ef7a5a2ef8ad36bd040502d968bffa398652d8e3...7d4bc0093f97215d235272116fa937751470c842,1,7,0,7,2,2010-12-28 22:30:35,2010-12-28 22:29:26
7d4bc0093f97215d235272116fa937751470c842...8937f72ef7af36d95bb08714204726f27010e6c4,2,16,0,16,4,2010-12-28 23:01:57,2010-12-28 23:01:29
8937f72ef7af36d95bb08714204726f27010e6c4...6da107cc624017d610715e0b3d859fdc66242cb3,1,17,7,24,6,2010-12-28 23:49:53,2010-12-28 23:49:39
6da107cc624017d610715e0b3d859fdc66242cb3...7a06594e254ffb47d5e412add18ec495bb8ff71f,1,28,9,37,2,2010-12-29 00:13:50,2010-12-29 00:12:38
7a06594e254ffb47d5e412add18ec495bb8ff71f...a4519f65593bbe15dc1ba773b8d50edfe1a2df02,2,97,44,141,10,2010-12-29 00:22:58,2010-12-29 00:22:37
a4519f65593bbe15dc1ba773b8d50edfe1a2df02...0d010f81312a3dbb3ed60a7f353e51eb1223bc17,2,11,8,19,2,2010-12-29 00:25:33,2010-12-29 00:24:36
0d010f81312a3dbb3ed60a7f353e51eb1223bc17...8dbe2f97455df1b888ec4f0ccd866c64e5f52e5d,1,1,1,2,1,2010-12-29 00:36:51,2010-12-29 00:36:51
8dbe2f97455df1b888ec4f0ccd866c64e5f52e5d...66e9e0a93764592e8a44fad151667bbf8d33d424,2,8,2,10,2,2010-12-29 01:03:42,2010-12-29 01:03:42
66e9e0a93764592e8a44fad151667bbf8d33d424...2deea4c97daf5f8c03e1d6f6f33c6bb162cf5e83,1,8,0,8,1,2010-12-29 01:12:23,2010-12-29 01:12:23
2deea4c97daf5f8c03e1d6f6f33c6bb162cf5e83...33fa6ce2acbbb0ecf1525e63253f1552c74a0b56,1,44,0,44,1,2010-12-29 01:19:26,2010-12-29 01:19:26
33fa6ce2acbbb0ecf1525e63253f1552c74a0b56...02d0a9cf664aeea1e4cfe4dccbfa22b0463e1d6d,1,18,17,35,2,2010-12-29 01:20:40,2010-12-29 01:20:40
02d0a9cf664aeea1e4cfe4dccbfa22b0463e1d6d...3a2087ac5c736c89ac9c7a125d525bdd5417d5f2,10,59,15,74,20,2010-12-29 01:35:15,2010-12-29 01:34:59
3a2087ac5c736c89ac9c7a125d525bdd5417d5f2...e0cc22ad539533c9110a3ce52999ce1f444b48b7,1,3,1,4,2,2010-12-29 02:35:46,2010-12-29 02:35:46
e0cc22ad539533c9110a3ce52999ce1f444b48b7...8e8d09912a417576f2024d21e458f7773b735e58,1,0,1,1,1,2010-12-29 03:23:25,2010-12-29 03:23:25
8e8d09912a417576f2024d21e458f7773b735e58...661e2018e5ebc9229cc22ff86e83c5ff25dd9227,1,10,1,11,2,2010-12-29 03:23:44,2010-12-29 03:23:44
661e2018e5ebc9229cc22ff86e83c5ff25dd9227...789467bd625f3f994d2d92e20c202ddf15eb92c4,2,12,9,21,9,2010-12-29 05:51:25,2010-12-29 05:51:25
789467bd625f3f994d2d92e20c202ddf15eb92c4...a4267c0b9bb3007600c9992b54c72a895a53ab2d,1,3,2,5,2,2010-12-29 05:51:38,2010-12-29 05:51:38
a4267c0b9bb3007600c9992b54c72a895a53ab2d...82cf5dc7a96755b54108ae84473815702d5cc573,3,58,71,129,10,2010-12-29 05:52:03,2010-12-29 05:52:03
82cf5dc7a96755b54108ae84473815702d5cc573...57e58d0d69191246c15a01526b938a9e6a1fd5cc,1,439,0,439,1,2010-12-29 06:46:36,2010-12-29 06:46:12
57e58d0d69191246c15a01526b938a9e6a1fd5cc...43eb9af2f29773014d250acbc927ab9cd8c9f7ba,3,31,1,32,3,2010-12-29 07:04:35,2010-12-29 07:04:19
43eb9af2f29773014d250acbc927ab9cd8c9f7ba...d4502f02576ef976cd1135108752e41b9f97b06e,1,1,1,2,1,2010-12-29 07:07:16,2010-12-29 07:07:16
d4502f02576ef976cd1135108752e41b9f97b06e...1490910ffff8d0571538e5b597a84def96dae623,1,2,2,4,2,2010-12-29 07:20:24,2010-12-29 07:20:07
1490910ffff8d0571538e5b597a84def96dae623...70cf11916e9a1fd047ae5b684712bc7493ed1e0a,3,32,19,51,15,2010-12-29 14:59:05,2010-12-29 14:58:38
70cf11916e9a1fd047ae5b684712bc7493ed1e0a...e37360e81cb54fcdbe636ba394a497db287e55c1,1,0,1,1,1,2010-12-29 16:00:19,2010-12-29 16:00:19
70cf11916e9a1fd047ae5b684712bc7493ed1e0a...acb40fb68460edfa7560f5e914ca7834abffa0c4,3,88,1,89,6,2010-12-29 15:53:02,2010-12-29 15:53:02
3feb1682b93e57f87769c0cdc52303a80d0a1819...411f6eff6397abf7d413c6b8ce4590c6cece20ac,1,1,1,2,1,2010-12-29 16:02:12,2010-12-29 16:02:12
411f6eff6397abf7d413c6b8ce4590c6cece20ac...abf4b56913c9e7a5ef31da6f77ad364726c1cf23,1,5,0,5,1,2010-12-29 16:02:53,2010-12-29 16:02:22
abf4b56913c9e7a5ef31da6f77ad364726c1cf23...0472e3396ae2bec8430db8c5741deebf42eea96d,1,1,1,2,1,2010-12-29 16:32:18,2010-12-29 16:32:18
0472e3396ae2bec8430db8c5741deebf42eea96d...786b5defd8a196159cfe1295107df42819442a4d,4,7,3,10,5,2010-12-29 16:48:57,2010-12-29 16:48:34
786b5defd8a196159cfe1295107df42819442a4d...2e1be2738a2159ab492f1cd1b02da0431910ed9d,1,2,2,4,2,2010-12-29 16:59:31,2010-12-29 16:59:18
2e1be2738a2159ab492f1cd1b02da0431910ed9d...e6452738d8f20b2f19cdaa92bb4e11d7027566bb,1,1,1,2,1,2010-12-29 17:53:14,2010-12-29 17:53:02
e6452738d8f20b2f19cdaa92bb4e11d7027566bb...be01a4f1d1c83b0e9a4ea31660542565c2c58c5f,1,1,1,2,1,2010-12-29 18:28:37,2010-12-29 18:28:37
be01a4f1d1c83b0e9a4ea31660542565c2c58c5f...2b0054d77766d32197dac3b5d792ce9bfbb16bfa,1,14,12,26,6,2010-12-29 20:48:47,2010-12-29 20:48:47
2b0054d77766d32197dac3b5d792ce9bfbb16bfa...79538f41fb457afe0f11c7aa963455008d0ccbec,1,0,0,0,0,2010-12-29 20:50:56,2010-12-29 20:50:56
79538f41fb457afe0f11c7aa963455008d0ccbec...1ab9b47a0a6ef15a3d407837f23c9f246fc9ab52,1,1,1,2,1,2010-12-29 20:52:12,2010-12-29 20:52:12
1ab9b47a0a6ef15a3d407837f23c9f246fc9ab52...7fb0a7c86999f7c6b181179f0cbb3586efc6a185,1,3,3,6,2,2010-12-29 21:04:07,2010-12-29 21:04:07
7fb0a7c86999f7c6b181179f0cbb3586efc6a185...35e717cdd4cf84bc3b4dc9011be8d62d188f1137,1,22,3,25,3,2010-12-29 21:22:29,2010-12-29 21:22:13
35e717cdd4cf84bc3b4dc9011be8d62d188f1137...20e25e13156a626671393159e93c3e13307bfd66,3,2,30,32,7,2010-12-30 00:25:31,2010-12-30 00:25:31
20e25e13156a626671393159e93c3e13307bfd66...fd6681f26fd6b97418fe39a3912416ef3a39d3e3,1,6,0,6,6,2010-12-30 00:32:33,2010-12-30 00:32:33
fd6681f26fd6b97418fe39a3912416ef3a39d3e3...4501105b7e91afe055aea736ce768153fc364bce,4,18,26,44,16,2010-12-30 01:08:21,2010-12-30 01:08:21
4501105b7e91afe055aea736ce768153fc364bce...a1101c06c758c88a7fc8b160a9c27eb653c972d4,2,40,5,45,8,2010-12-30 01:33:59,2010-12-30 01:33:59
a1101c06c758c88a7fc8b160a9c27eb653c972d4...19709a7401a5a5181aada3477617235be8f8956b,4,65,8,73,10,2010-12-30 03:23:03,2010-12-30 03:22:50
19709a7401a5a5181aada3477617235be8f8956b...b818949c3a04b24f4a59c2e5a25f02036f47a3d4,1,2,1,3,1,2010-12-30 03:27:22,2010-12-30 03:27:22
b818949c3a04b24f4a59c2e5a25f02036f47a3d4...7a75224d408eba78bd9f63e7bece92c884a2b7b3,1,1,0,1,1,2010-12-30 13:16:32,2010-12-30 13:16:32
7a75224d408eba78bd9f63e7bece92c884a2b7b3...b789ce6b94d4738145ec786cb2689ac41d440027,1,1,0,1,1,2010-12-30 13:32:51,2010-12-30 13:32:51
b789ce6b94d4738145ec786cb2689ac41d440027...30464fe0e103aae06a0a7b021d3b7f77f9d951e1,2,4,4,8,4,2010-12-30 16:39:02,2010-12-30 16:39:02
30464fe0e103aae06a0a7b021d3b7f77f9d951e1...d62ca23e4a825e04d38704d3939901dfc398dbc3,1,1,1,2,1,2010-12-30 17:16:18,2010-12-30 17:16:18
d62ca23e4a825e04d38704d3939901dfc398dbc3...4bda3b3d4db6b23ffe5eb385e60c7a50bef19a43,1,4,2,6,3,2010-12-30 17:21:29,2010-12-30 17:21:17
4bda3b3d4db6b23ffe5eb385e60c7a50bef19a43...a397b3aa1651b0d8c65741ca337a8f87cc9101fb,2,0,5,5,2,2010-12-30 18:41:15,2010-12-30 17:19:14
a397b3aa1651b0d8c65741ca337a8f87cc9101fb...249952b8ae3eabc792ef6395c3477f9613c28a00,1,3,0,3,1,2010-12-30 18:41:15,2010-12-30 18:37:32
249952b8ae3eabc792ef6395c3477f9613c28a00...833004929cea08e8ee8132e9924b975fa0042f28,1,2,0,2,1,2010-12-30 18:41:15,2010-12-30 18:37:56
833004929cea08e8ee8132e9924b975fa0042f28...55dda1adf13175062bc4261f4738021bea9ab019,2,148,123,271,18,2010-12-30 18:41:15,2010-12-30 18:38:09
55dda1adf13175062bc4261f4738021bea9ab019...202ae7ec72be32cf8d90c6b31824ba6654ae7ccf,3,290,224,514,14,2010-12-30 18:41:15,2010-12-30 18:38:20
202ae7ec72be32cf8d90c6b31824ba6654ae7ccf...15157931323dea4a436f35e9d93236efcf66f3dc,1,1,0,1,1,2010-12-30 18:41:15,2010-12-30 18:39:25
15157931323dea4a436f35e9d93236efcf66f3dc...32f28606d7486af69f9eec630bfd822bb78aacec,2,46,45,91,21,2010-12-30 18:41:15,2010-12-30 18:41:06
32f28606d7486af69f9eec630bfd822bb78aacec...c4c5d66d016f36b0c56021fd142c8a027c6b132d,2,61,7,68,8,2010-12-30 19:12:26,2010-12-30 19:12:26
c4c5d66d016f36b0c56021fd142c8a027c6b132d...ca311f1e27b40e993c591e3508c89824f3d9cdb4,3,6,6,12,4,2010-12-30 19:42:58,2010-12-30 19:42:58
ca311f1e27b40e993c591e3508c89824f3d9cdb4...aa5d394b2de5306c7c02c50ec5bf4064a185e614,1,5,2,7,2,2010-12-30 19:43:34,2010-12-30 18:55:42
aa5d394b2de5306c7c02c50ec5bf4064a185e614...70781110b465c2a770f99c48a4257a2776e7bbfa,1,1,1,2,1,2010-12-30 19:43:36,2010-12-30 19:12:29
70781110b465c2a770f99c48a4257a2776e7bbfa...c325d0f44fa323e7942ffa62cd4d91a87f9b2af6,7,58,9,67,20,2010-12-30 20:34:30,2010-12-30 20:34:30
c325d0f44fa323e7942ffa62cd4d91a87f9b2af6...479fa7c3ccefe4a5eb3c0255c44814e463810622,1,1,1,2,1,2010-12-30 20:35:40,2010-12-30 20:35:40
479fa7c3ccefe4a5eb3c0255c44814e463810622...0830dde457d8d62cd4bd8aee6073d7b381986f3e,1,1,1,2,1,2010-12-30 20:38:54,2010-12-30 20:38:54
0830dde457d8d62cd4bd8aee6073d7b381986f3e...9b7676c8b9422763ad12f692b269ba6c4684f118,2,2,2,4,2,2010-12-30 20:47:30,2010-12-30 19:01:01
9b7676c8b9422763ad12f692b269ba6c4684f118...38624c7cc0248cfbe1c3a086859ddc3939c4d63d,2,24,16,40,8,2010-12-30 20:47:30,2010-12-30 20:46:57
38624c7cc0248cfbe1c3a086859ddc3939c4d63d...a93eb13f919a5ccaf72099ec0e98e4375acc592f,1,5,1,6,1,2010-12-31 00:58:22,2010-12-31 00:58:22
a93eb13f919a5ccaf72099ec0e98e4375acc592f...93b06214ed3791d1ae6c87d0f7837e266c935925,2,52,1,53,3,2010-12-31 02:46:49,2010-12-31 02:46:27
93b06214ed3791d1ae6c87d0f7837e266c935925...d378223f7be244dff790c8f2de4d2e991dc37796,2,10,16,26,5,2010-12-31 03:20:45,2010-12-31 03:20:30
d378223f7be244dff790c8f2de4d2e991dc37796...411274ae4210d20e98640035f86188bfd559fb12,4,3,3,6,5,2010-12-31 04:08:42,2010-12-31 04:08:42
411274ae4210d20e98640035f86188bfd559fb12...b0f1ce87ffcb8acc2e9b67b428ce8dc359648528,1,10,0,10,1,2010-12-31 04:17:23,2010-12-31 04:17:23
b0f1ce87ffcb8acc2e9b67b428ce8dc359648528...7c6e505289bf099f73b3b97d770c27331cc45645,1,2,0,2,1,2010-12-31 04:26:23,2010-12-31 04:26:23
7c6e505289bf099f73b3b97d770c27331cc45645...9d8e3967a904c426339eb84a27f071676a845e54,1,3,1,4,1,2010-12-31 04:38:51,2010-12-31 04:38:51
9d8e3967a904c426339eb84a27f071676a845e54...d60aa255e3e54ea385dffb6a0c8d4889144273f3,3,26,3,29,7,2010-12-31 04:59:18,2010-12-31 04:59:01
d60aa255e3e54ea385dffb6a0c8d4889144273f3...c664067e07d1f52f8c545f31868c10b2b3a7fa4c,2,45,39,84,14,2010-12-31 15:48:42,2010-12-31 15:48:42
c664067e07d1f52f8c545f31868c10b2b3a7fa4c...c2e0253554254055bea67d0d38f50cb1e96d0c63,1,9,13,22,7,2011-01-01 20:44:20,2011-01-01 20:44:20
c2e0253554254055bea67d0d38f50cb1e96d0c63...7c7a9689be64065b76a5afedabb5acddd3a52831,1,18,7,25,2,2011-01-01 20:52:36,2011-01-01 20:52:36
7c7a9689be64065b76a5afedabb5acddd3a52831...00a4a0951db5e04b336fb37f797f004b477c0869,1,40,23,63,3,2011-01-01 20:57:28,2011-01-01 20:57:28
00a4a0951db5e04b336fb37f797f004b477c0869...ff70f15cbca7cae5786d96e21b1d795cdb65d4db,1,12,0,12,1,2011-01-01 21:41:07,2011-01-01 21:41:07
ff70f15cbca7cae5786d96e21b1d795cdb65d4db...0092900ac1c1ddfd65076b17289862648d8993b8,1,4,0,4,1,2011-01-01 21:43:28,2011-01-01 21:43:28
0092900ac1c1ddfd65076b17289862648d8993b8...15465b598dc7e0b8d67e65d579628a31ea0feb39,1,52,33,85,10,2011-01-01 22:23:51,2011-01-01 22:23:51
15465b598dc7e0b8d67e65d579628a31ea0feb39...d7a81395c3acec226b198f3d25348437d059481b,1,19,19,38,4,2011-01-01 22:27:10,2011-01-01 22:27:10
d7a81395c3acec226b198f3d25348437d059481b...9677a992607fcf1225afc9f6953e4d10ca849f90,1,5,1,6,1,2011-01-01 22:28:39,2011-01-01 22:28:39
9677a992607fcf1225afc9f6953e4d10ca849f90...9b6885b71fff4b4cfb34ea6ad8ec0f1c970d6fde,9,268,268,536,22,2011-01-01 22:29:27,2011-01-01 22:29:27
9b6885b71fff4b4cfb34ea6ad8ec0f1c970d6fde...74c81182182f29747a6127ad18ba73ed6866cc45,1,76,70,146,2,2011-01-01 22:32:07,2011-01-01 22:32:07
74c81182182f29747a6127ad18ba73ed6866cc45...72c0520ec95c472f5ea69401e77a1ac716a7f53f,1,28,13,41,3,2011-01-01 23:19:40,2011-01-01 23:19:40
72c0520ec95c472f5ea69401e77a1ac716a7f53f...242fea5287e369f1b3a2f2172008cd8ecec557ef,1,42,27,69,7,2011-01-02 02:37:31,2011-01-02 02:37:31
242fea5287e369f1b3a2f2172008cd8ecec557ef...5a99f52a74d5135c8464871c376e72c6f61a86c8,1,2,0,2,1,2011-01-02 02:53:06,2011-01-02 02:53:06
5a99f52a74d5135c8464871c376e72c6f61a86c8...d4780c6bd411f107c4a627b54bce0dc4150cc601,2,79,77,156,6,2011-01-02 20:58:42,2011-01-02 20:58:42
d4780c6bd411f107c4a627b54bce0dc4150cc601...4f54f4c2fa443e77c0971167279a87350aeaa08a,1,11,1,12,1,2011-01-02 22:04:08,2011-01-02 22:04:08
4f54f4c2fa443e77c0971167279a87350aeaa08a...6c1cdf7d2ed66f8bde6a892ea0a77c903ecca9bd,1,1,1,2,1,2011-01-02 22:08:36,2011-01-02 22:08:36
6c1cdf7d2ed66f8bde6a892ea0a77c903ecca9bd...025cf2313e8d2a19b517b784cf26c34d407930e0,1,2,1,3,2,2011-01-03 01:28:09,2011-01-03 01:28:09
025cf2313e8d2a19b517b784cf26c34d407930e0...c970fde6c191215a13275d3e1735f892558b5bdb,2,44,28,72,5,2011-01-03 03:34:13,2011-01-03 03:33:50
c970fde6c191215a13275d3e1735f892558b5bdb...0e1e3118c6c86750ec3df69b4c4213696e0f6b90,1,19,15,34,3,2011-01-03 04:04:06,2011-01-03 04:04:06
0e1e3118c6c86750ec3df69b4c4213696e0f6b90...4fae261c87c69f034b98d294c892997c0e7fc476,3,46,0,46,7,2011-01-03 05:20:46,2011-01-03 05:20:46
4fae261c87c69f034b98d294c892997c0e7fc476...5bf4a6be167f1b0b6f059bed51ef4eadc12cfe40,1,7,19,26,3,2011-01-03 06:01:11,2011-01-03 06:01:11
5bf4a6be167f1b0b6f059bed51ef4eadc12cfe40...0b190bfed4ed96c1046ec240c235928d295431f2,1,40,40,80,5,2011-01-03 06:02:25,2011-01-03 06:02:25
0b190bfed4ed96c1046ec240c235928d295431f2...bfa73484df97fd0d93e8a734df8b9088a1b8df2e,1,1,1,2,1,2011-01-03 06:04:04,2011-01-03 06:04:04
bfa73484df97fd0d93e8a734df8b9088a1b8df2e...9e55fce95eb5cb1d57dd12ec76fc22bf6d9a7400,1,1,1,2,1,2011-01-03 07:53:58,2011-01-03 07:53:58
9e55fce95eb5cb1d57dd12ec76fc22bf6d9a7400...1397e6354c5e174cebb38aff20a9e44962b9aa58,1,2,4,6,3,2011-01-03 16:35:45,2011-01-03 16:35:45
1397e6354c5e174cebb38aff20a9e44962b9aa58...9b7949d402ee98185b068dd43425debbb4636d00,1,1,1,2,1,2011-01-03 16:53:05,2011-01-03 16:53:05
9b7949d402ee98185b068dd43425debbb4636d00...57c509a1c007e108610ed32113c091f8548e8b46,1,1,1,2,1,2011-01-03 16:59:13,2011-01-03 16:59:13
57c509a1c007e108610ed32113c091f8548e8b46...411389f0805b8906a5a7d662ac3e7a53b68ec592,4,38,15,53,8,2011-01-03 17:08:17,2011-01-03 17:08:17
411389f0805b8906a5a7d662ac3e7a53b68ec592...7e711d39a23c99d04a84ebd47e2b69b9cacffe89,1,3,0,3,1,2011-01-03 17:31:03,2011-01-03 17:31:03
7e711d39a23c99d04a84ebd47e2b69b9cacffe89...370061cd9b645129c30f96e14c46c8cfa61ff5ff,1,124,0,124,1,2011-01-03 17:31:39,2011-01-03 17:31:39
370061cd9b645129c30f96e14c46c8cfa61ff5ff...0721557a2abfcd227c37d4d0f913d449204c9987,2,74,61,135,12,2011-01-03 18:16:13,2011-01-03 17:00:41
0721557a2abfcd227c37d4d0f913d449204c9987...310507046010c0bf447db25859bc142c1a4ee492,3,76,64,140,8,2011-01-03 18:16:13,2011-01-03 17:07:04
310507046010c0bf447db25859bc142c1a4ee492...aca009ca806cdc716d934d64af2d1f41ed8b89f2,5,25,12,37,17,2011-01-03 18:16:13,2011-01-03 17:22:00
aca009ca806cdc716d934d64af2d1f41ed8b89f2...cf33b4b84bdb7dadcfe2cb597272af3ed5c843c8,2,5,5,10,5,2011-01-03 18:24:13,2011-01-03 18:23:59
cf33b4b84bdb7dadcfe2cb597272af3ed5c843c8...d7f625ad2d705059e38c61064f1ddd2a7305c2c2,3,8,32,40,13,2011-01-03 18:33:46,2011-01-03 18:33:46
d7f625ad2d705059e38c61064f1ddd2a7305c2c2...5379e7ce30bc66d06ede3d62c536108d654f0e34,2,0,16,16,4,2011-01-03 18:51:02,2011-01-03 18:51:02
5379e7ce30bc66d06ede3d62c536108d654f0e34...73be40b922fa22b8ac24afc137ce6b7072a32bbe,1,4,1,5,1,2011-01-03 18:53:47,2011-01-03 18:53:47
73be40b922fa22b8ac24afc137ce6b7072a32bbe...a19ebee8d977fda2e26e76a1d9defadd2480bdb0,1,15,6,21,4,2011-01-03 18:59:06,2011-01-03 18:59:06
a19ebee8d977fda2e26e76a1d9defadd2480bdb0...04b0d4366a504b54bb8159fbe0cfa5bfce1bd857,1,1,4,5,2,2011-01-03 19:01:13,2011-01-03 19:01:13
04b0d4366a504b54bb8159fbe0cfa5bfce1bd857...28a558b2135d00ccc91aebed2586c0cfadd0e250,2,5,2,7,3,2011-01-03 19:05:56,2011-01-03 19:05:56
28a558b2135d00ccc91aebed2586c0cfadd0e250...e869f00e1db484d173cdec30edd1b6adff0c2878,1,1,0,1,1,2011-01-03 19:13:07,2011-01-03 18:39:37
e869f00e1db484d173cdec30edd1b6adff0c2878...5266e0fd8a0139a89ff606e690f7d9f22892abc9,1,1,0,1,1,2011-01-03 19:13:07,2011-01-03 19:11:53
5266e0fd8a0139a89ff606e690f7d9f22892abc9...17621a52d3cb1bce3042011f538535b34bfde2f5,2,5,3,8,4,2011-01-03 19:13:07,2011-01-03 19:12:04
17621a52d3cb1bce3042011f538535b34bfde2f5...b99c10320e1fcb28e36167ed0022fcbf55e02cbf,5,78,32,110,24,2011-01-03 19:13:07,2011-01-03 19:12:32
b99c10320e1fcb28e36167ed0022fcbf55e02cbf...49b45410c0ce3dc22a262f011c5ff3fd42db4b00,1,10,10,20,2,2011-01-03 19:23:53,2011-01-03 19:20:27
49b45410c0ce3dc22a262f011c5ff3fd42db4b00...a638ff0d9030f7ca046c744f2e16141f3d7673e0,1,2,2,4,2,2011-01-03 19:42:01,2011-01-03 19:42:01
a638ff0d9030f7ca046c744f2e16141f3d7673e0...87cf5a3f83afdf679d96d825a751fc9f75cfccff,2,16,0,16,4,2011-01-03 20:00:09,2011-01-03 20:00:09
87cf5a3f83afdf679d96d825a751fc9f75cfccff...1b7ac8c5e60f6492da69ef79dec2fdccffb29ba4,1,1,0,1,1,2011-01-03 20:15:07,2011-01-03 20:15:07
1b7ac8c5e60f6492da69ef79dec2fdccffb29ba4...4c1ee8ca6e6919de39daddc60f38e54774007e1d,1,3,1,4,2,2011-01-03 20:41:01,2011-01-03 20:41:01
4c1ee8ca6e6919de39daddc60f38e54774007e1d...50650373fbf960c2d99440b1f08c67a79fd66439,1,4,3,7,3,2011-01-03 21:24:59,2011-01-03 21:02:00
50650373fbf960c2d99440b1f08c67a79fd66439...44c7aff0f80c8dbe5c66b0b7224d1a27fd2231f5,1,0,0,0,0,2011-01-03 21:27:15,2011-01-03 21:27:15
44c7aff0f80c8dbe5c66b0b7224d1a27fd2231f5...764400caa28e1063a97754e50f03c31be3726c95,2,57,45,102,16,2011-01-03 21:35:28,2011-01-03 21:35:28
764400caa28e1063a97754e50f03c31be3726c95...befcc2704c5347c0f707882bde2adbe9c9eca78f,1,22,0,22,3,2011-01-03 22:05:36,2011-01-03 22:04:58
befcc2704c5347c0f707882bde2adbe9c9eca78f...43157a8dded9fffb6f1355347e1bf2e69244b662,1,76,0,76,1,2011-01-03 22:05:36,2011-01-03 22:05:19
43157a8dded9fffb6f1355347e1bf2e69244b662...8c09870dd6d4c072a784a2009fcf527c5255cc7f,1,2,2,4,2,2011-01-03 23:26:41,2011-01-03 23:26:41
8c09870dd6d4c072a784a2009fcf527c5255cc7f...93286ffa825204f2a264f047a1371e924cdf71a6,1,5,3,8,2,2011-01-04 04:40:03,2011-01-04 04:40:03
93286ffa825204f2a264f047a1371e924cdf71a6...4315a900ae604e11f2d9d68d1e6f87b8aa01dddc,1,1,1,2,1,2011-01-04 04:53:54,2011-01-04 04:53:54
4315a900ae604e11f2d9d68d1e6f87b8aa01dddc...b828d21630d8715fff5a30c682a51ab79880093d,407,20706,20294,41000,11852,2011-01-04 05:40:41,2011-01-04 05:40:41
b828d21630d8715fff5a30c682a51ab79880093d...ff53fe31ab72e8cd61b70950d3b35a741d73d53f,1,6,0,6,1,2011-01-04 06:52:48,2011-01-04 06:52:48
ff53fe31ab72e8cd61b70950d3b35a741d73d53f...d5d2da55dead65ac9dc225b23698d90998bc7560,2,5,2,7,3,2011-01-04 06:52:54,2011-01-04 06:52:54
d5d2da55dead65ac9dc225b23698d90998bc7560...44543e6f764e9cbc5d5591b01c87b1d685b61390,1,3,2,5,1,2011-01-04 06:56:07,2011-01-04 06:56:07
44543e6f764e9cbc5d5591b01c87b1d685b61390...84a36e6f63e68692b403fc01b8d7946e47f2d82b,2,3,1,4,2,2011-01-04 17:32:11,2011-01-04 17:32:11
84a36e6f63e68692b403fc01b8d7946e47f2d82b...5583c643bf2394a1c6a74ee92c58ca13e46fd981,5,30,13,43,18,2011-01-04 17:58:03,2011-01-04 17:58:03
5583c643bf2394a1c6a74ee92c58ca13e46fd981...9578b8be2cc1a42081a7dd12f58ebae9e4bdb8d0,1,3,3,6,3,2011-01-04 18:08:57,2011-01-04 18:08:57
9578b8be2cc1a42081a7dd12f58ebae9e4bdb8d0...8b99193220a126f07dea62964b2f222984fa944c,1,9,2,11,3,2011-01-04 18:45:36,2011-01-04 18:45:02
8b99193220a126f07dea62964b2f222984fa944c...24655afe33c64f387d8b2664d88e980d47e92bfe,1,2,2,4,2,2011-01-04 19:06:29,2011-01-04 19:06:29
24655afe33c64f387d8b2664d88e980d47e92bfe...5a4217538fc8dc370862b25ed15a0333d4c8e058,1,5,2,7,1,2011-01-04 22:44:34,2011-01-04 18:38:19
5a4217538fc8dc370862b25ed15a0333d4c8e058...8b9a74f6a61ed01f57a59dbc30ed69f3d1b8456f,1,67,2,69,4,2011-01-04 22:44:35,2011-01-04 21:14:31
8b9a74f6a61ed01f57a59dbc30ed69f3d1b8456f...89007cd83ebaf88d24e04f1a3c0cb504df1476d4,1,48,12,60,7,2011-01-04 22:44:37,2011-01-04 22:40:39
89007cd83ebaf88d24e04f1a3c0cb504df1476d4...21c3f8a245f2f44f4ae1db3c07f7cc8ba5272e83,1,1,1,2,2,2011-01-04 22:44:38,2011-01-04 22:43:57
21c3f8a245f2f44f4ae1db3c07f7cc8ba5272e83...0ca0ce9b2a73b6f781916d5f69c6f07f0984a9d2,1,1,1,2,1,2011-01-04 22:45:28,2011-01-04 22:45:28
0ca0ce9b2a73b6f781916d5f69c6f07f0984a9d2...4a3ef2ec061c17ed23c7773b0e1c4b7fee738fd1,1,9,18,27,7,2011-01-05 17:18:19,2011-01-05 17:18:19
4a3ef2ec061c17ed23c7773b0e1c4b7fee738fd1...23c7da463fcd2364e8782f9e2d9d380413dcdba2,1,0,2,2,1,2011-01-05 17:18:50,2011-01-05 17:18:50
0ca0ce9b2a73b6f781916d5f69c6f07f0984a9d2...42ebc1c0374ddbab4497b1e05cfd8f5e1e558b67,1,13,1,14,3,2011-01-04 23:02:37,2011-01-04 22:40:02
42ebc1c0374ddbab4497b1e05cfd8f5e1e558b67...6e30f811e8aaa03cd886a149dfeb8b622bf64b93,1,114,0,114,1,2011-01-04 23:02:37,2011-01-04 22:40:19
6e30f811e8aaa03cd886a149dfeb8b622bf64b93...ffccf20842b834c4a368ffe558cd977993221313,1,9,3,12,5,2011-01-04 23:02:37,2011-01-04 22:41:25
ffccf20842b834c4a368ffe558cd977993221313...10dfdf6201516fe3400a39ccde501a204b2829d0,1,0,0,0,0,2011-01-04 23:02:37,2011-01-04 22:44:36
10dfdf6201516fe3400a39ccde501a204b2829d0...9c45e253f9d6c727ec458770c9b3f2a464305f50,1,9,3,12,1,2011-01-04 23:02:37,2011-01-04 23:01:28
9c45e253f9d6c727ec458770c9b3f2a464305f50...91c208c5777c716c7fa68606d163ad268d1e0b66,3,4,6,10,4,2011-01-04 23:02:37,2011-01-04 23:02:22
91c208c5777c716c7fa68606d163ad268d1e0b66...a8053a46396d2ca1ffb7562db1255cce9b7135fd,1,1,1,2,1,2011-01-04 23:03:40,2011-01-04 23:03:40
a8053a46396d2ca1ffb7562db1255cce9b7135fd...626b4eb79cb932377e0256e2b74ed013db2a716d,1,1,1,2,1,2011-01-05 00:39:26,2011-01-04 19:39:17
626b4eb79cb932377e0256e2b74ed013db2a716d...1558b7543baafd7bf6c90f390bba69e7f85a0c36,2,9,9,18,6,2011-01-05 00:39:26,2011-01-05 00:38:32
1558b7543baafd7bf6c90f390bba69e7f85a0c36...0dca1c2332f945737631eea120c08ab799fd1f9f,3,9,5,14,8,2011-01-05 01:01:22,2011-01-05 01:01:22
0dca1c2332f945737631eea120c08ab799fd1f9f...79e5cbbd57752d7273cdb3cc058bf50b5638d004,3,50,65,115,11,2011-01-05 02:02:13,2011-01-05 02:02:13
79e5cbbd57752d7273cdb3cc058bf50b5638d004...b0dc17c0c4831297fdcb62d69577f4ac606c1718,1,4,4,8,2,2011-01-05 03:05:56,2011-01-05 03:05:30
b0dc17c0c4831297fdcb62d69577f4ac606c1718...872236ef778e5ea0288b7aae8b54a4b579219ce3,1,22,1,23,1,2011-01-05 04:44:16,2011-01-05 04:02:58
872236ef778e5ea0288b7aae8b54a4b579219ce3...86af56ebd898d3ebcea90ea43a9be21d99aa294c,1,1,1,2,1,2011-01-05 04:44:17,2011-01-05 04:03:19
86af56ebd898d3ebcea90ea43a9be21d99aa294c...4b80354d2fdf18d187673631cee3755000784be8,2,38,1,39,3,2011-01-05 05:32:15,2011-01-05 05:31:35
4b80354d2fdf18d187673631cee3755000784be8...19f1a2c184c16c950de48489d3ada5f5675bd3c3,6,27,27,54,23,2011-01-05 05:32:30,2011-01-05 05:32:30
19f1a2c184c16c950de48489d3ada5f5675bd3c3...60600a14ab8b74016bc8361cc0a0e9c24733f9d8,1,3,0,3,1,2011-01-05 05:41:40,2011-01-05 05:41:21
60600a14ab8b74016bc8361cc0a0e9c24733f9d8...fa7f1a3ca99de67a0f094be3418af91ff8a270d2,3,590,6,596,6,2011-01-05 05:44:06,2011-01-05 05:43:04
fa7f1a3ca99de67a0f094be3418af91ff8a270d2...f5e2323933025844cd76e9f31025f8dc1747e55d,5,64,11,75,15,2011-01-05 07:17:22,2011-01-05 07:16:44
f52ce911460f1e33a3dbe10e14ad7a43671fabbc...5d1f802ebec042d57a715fd560f6666d3f20c369,2,2,2,4,2,2011-01-05 17:32:54,2011-01-05 17:32:54
5d1f802ebec042d57a715fd560f6666d3f20c369...49af28aa00525f4ff7cdef91c5a90c3a7dc4ed6f,1,1,1,2,1,2011-01-05 17:43:05,2011-01-05 17:39:12
49af28aa00525f4ff7cdef91c5a90c3a7dc4ed6f...42c57258cd6c69d5f6c5a794651d41b18f9d83d6,1,2,1,3,2,2011-01-05 17:43:05,2011-01-05 17:39:37
42c57258cd6c69d5f6c5a794651d41b18f9d83d6...a46248bdf65f2951c76b3f699da4c8fa2891da92,1,3,3,6,1,2011-01-05 17:43:05,2011-01-05 17:42:38
a46248bdf65f2951c76b3f699da4c8fa2891da92...e27b051cc2338cbe738057953c341fca5fe2955f,1,3,3,6,2,2011-01-05 17:59:33,2011-01-05 17:59:33
e27b051cc2338cbe738057953c341fca5fe2955f...c4e0bd65a41f14dad537f0ee70e3c455306c8344,1,7,10,17,6,2011-01-05 20:40:43,2011-01-05 20:40:43
c4e0bd65a41f14dad537f0ee70e3c455306c8344...11eb14f71b72bc28e58c88b9c98e45fb9fde03d7,1,73,43,116,7,2011-01-06 01:05:25,2011-01-06 01:05:25
11eb14f71b72bc28e58c88b9c98e45fb9fde03d7...b72cf3543836d108233c684c4e5e45da65ea101c,1,1,1,2,1,2011-01-06 01:15:31,2011-01-06 01:15:31
b72cf3543836d108233c684c4e5e45da65ea101c...da0bc2917778593d0368b89427d9d504a1230389,5,76,5,81,9,2011-01-06 06:06:04,2011-01-06 06:05:10
da0bc2917778593d0368b89427d9d504a1230389...cd969593bc310b513b81d47e2838f1448cf15f7c,1,33,2,35,4,2011-01-06 14:16:12,2011-01-06 14:16:00
cd969593bc310b513b81d47e2838f1448cf15f7c...27501ce21f68ec144d6bb04e2e95718d2a2c4974,1,1,1,2,1,2011-01-06 17:20:26,2011-01-06 17:20:26
27501ce21f68ec144d6bb04e2e95718d2a2c4974...a5aae2759333eb7fffd6f01edd000f28e01ec995,2,34,54,88,9,2011-01-06 18:06:34,2011-01-06 18:06:23
a5aae2759333eb7fffd6f01edd000f28e01ec995...4f47d79a61604a93cbfe40d0bcafa3051be70e80,4,81,2,83,10,2011-01-06 18:37:56,2011-01-06 18:37:56
4f47d79a61604a93cbfe40d0bcafa3051be70e80...69afc0d81d53b91bf8ed1e0158bd5dc25b17daa3,3,3,1,4,3,2011-01-06 18:40:21,2011-01-06 18:40:21
69afc0d81d53b91bf8ed1e0158bd5dc25b17daa3...401f73dc8f07ed398685ddda6db2d4b62159ffe6,2,3385,3385,6770,2,2011-01-06 19:55:21,2011-01-06 19:55:21
401f73dc8f07ed398685ddda6db2d4b62159ffe6...80fecd37e37aea6f55dae25b4a63174061fea598,1,3,3,6,3,2011-01-06 20:48:25,2011-01-06 20:47:48
80fecd37e37aea6f55dae25b4a63174061fea598...cf68b13124462939a088054c10433b04620bde58,1,4,1,5,2,2011-01-07 15:41:54,2011-01-07 15:41:54
cf68b13124462939a088054c10433b04620bde58...66e654de6a8400c9ce1210fc5140f75a159f727c,1,1,1,2,1,2011-01-07 16:18:55,2011-01-06 19:54:47
66e654de6a8400c9ce1210fc5140f75a159f727c...23adcf5c563a432b0d500a50dca6d6a77d07a73d,1,14,10,24,1,2011-01-07 16:18:56,2011-01-07 16:18:03
23adcf5c563a432b0d500a50dca6d6a77d07a73d...13b139f6c13a47116c33a665f7848473f45624ef,14,32,81,113,41,2011-01-08 18:22:45,2011-01-08 18:22:45
13b139f6c13a47116c33a665f7848473f45624ef...f07eb9c5b31baa002abf7f94418515564de4f731,1,5,1,6,3,2011-01-08 18:43:35,2011-01-08 18:43:35
f07eb9c5b31baa002abf7f94418515564de4f731...bcb127567ddd8690ec1897a34c3fb81f27866b6b,2,7,1,8,4,2011-01-08 19:43:04,2011-01-08 19:43:04
bcb127567ddd8690ec1897a34c3fb81f27866b6b...62425650ef6b54d51c8f380c67de00dffaae5e27,1,1,1,2,1,2011-01-08 20:01:04,2011-01-08 20:01:04
62425650ef6b54d51c8f380c67de00dffaae5e27...25f0610257f6a19e0b30f40044af8b8f4450f731,1,3,3,6,3,2011-01-08 22:37:28,2011-01-08 22:37:28
25f0610257f6a19e0b30f40044af8b8f4450f731...c806aa83f9a2e8bddb0dba0c6a7b3251ce749c3e,1,21,21,42,2,2011-01-08 22:48:25,2011-01-08 22:48:25
c806aa83f9a2e8bddb0dba0c6a7b3251ce749c3e...b3f7712ce45b0b4ae046b0bbdc15a9371608fddd,1,2,0,2,1,2011-01-09 06:45:33,2011-01-09 06:44:52
b3f7712ce45b0b4ae046b0bbdc15a9371608fddd...51ca8ee218a8ed249a4cbbd406eeaf1e9af41b36,9,26,15,41,16,2011-01-09 06:45:33,2011-01-09 06:45:11
51ca8ee218a8ed249a4cbbd406eeaf1e9af41b36...e1c86828cb3fbb29fbb995572fa96043e8624499,1,1,1,2,1,2011-01-09 15:57:56,2011-01-09 15:57:56
e1c86828cb3fbb29fbb995572fa96043e8624499...2dbe7e6937c43515a008d3f8bf77493b612f565f,8,68,66,134,33,2011-01-09 21:26:33,2011-01-09 21:26:17
2dbe7e6937c43515a008d3f8bf77493b612f565f...de1cc7a9c2d746880c3ed92970065df20538aea8,1,9,6,15,6,2011-01-10 02:51:16,2011-01-10 02:48:10
de1cc7a9c2d746880c3ed92970065df20538aea8...37fd9be7d44646786f2d5f3ce2859b141d327987,1,20,0,20,6,2011-01-10 02:51:16,2011-01-10 02:48:20
37fd9be7d44646786f2d5f3ce2859b141d327987...6485f8b9f3092bfb2d520adbd54a7809a047cc22,1,135,0,135,3,2011-01-10 02:51:16,2011-01-10 02:51:02
6485f8b9f3092bfb2d520adbd54a7809a047cc22...3907c971eed501207ed5c5c16b831697a3956978,3,21,0,21,5,2011-01-10 13:38:52,2011-01-10 13:38:52
3907c971eed501207ed5c5c16b831697a3956978...95883498e57326ad0fedf111f65922c03ca0f356,2,114,0,114,2,2011-01-10 17:12:34,2011-01-10 17:12:34
95883498e57326ad0fedf111f65922c03ca0f356...7003b4b5b6c3febaa136b1d489a21c32c3d71708,1,1,1,2,1,2011-01-10 17:56:26,2011-01-10 17:56:26
7003b4b5b6c3febaa136b1d489a21c32c3d71708...c0e021cbe7eeab18f28b02668e7889ee01c2d182,1,2,3,5,3,2011-01-10 18:57:37,2011-01-10 18:57:37
c0e021cbe7eeab18f28b02668e7889ee01c2d182...603387986c9d6fbc245462851823d45f6d2a335e,1,1,1,2,1,2011-01-10 18:58:14,2011-01-06 21:56:02
603387986c9d6fbc245462851823d45f6d2a335e...6d25aae842d5f350b52e1e0d79ced3d1f94852f7,3,3,3,6,3,2011-01-10 18:58:14,2011-01-06 22:09:24
6d25aae842d5f350b52e1e0d79ced3d1f94852f7...36254334704fb41ddeb8a2cae7a8b5ce792d4e87,2,5,17,22,7,2011-01-10 18:58:15,2011-01-06 22:48:57
36254334704fb41ddeb8a2cae7a8b5ce792d4e87...a593ed70dfd25d97d3fc1ab6fce244a9fc723b25,2,6,1,7,3,2011-01-10 18:58:15,2011-01-06 22:25:46
a593ed70dfd25d97d3fc1ab6fce244a9fc723b25...87bb1b58661966c0655637e9a120f5e06912e0c4,1,25,19,44,9,2011-01-10 18:58:15,2011-01-06 23:37:12
87bb1b58661966c0655637e9a120f5e06912e0c4...067f9de68e97905537dc2f31c1aebe028dc530bb,3,4,17,21,5,2011-01-10 18:58:15,2011-01-06 23:54:57
067f9de68e97905537dc2f31c1aebe028dc530bb...d1d3df7b1267651c97f57a7235bcd298ceb9fd1f,3,12,8,20,9,2011-01-10 18:58:15,2011-01-10 17:43:12
d1d3df7b1267651c97f57a7235bcd298ceb9fd1f...6a6ad16702e90f0020e2a2a3e847830d2e05e108,2,24,0,24,4,2011-01-10 19:56:28,2011-01-10 19:55:55
6a6ad16702e90f0020e2a2a3e847830d2e05e108...5079064a7c60878ba9865bc4c6c8f91f893ecbd4,2,10,16,26,6,2011-01-10 20:18:38,2011-01-10 20:18:18
5079064a7c60878ba9865bc4c6c8f91f893ecbd4...8b7b68a3ec0c2db53e693091ce710a1b4851bb01,2,16,15,31,7,2011-01-10 21:17:23,2011-01-10 21:05:43
8b7b68a3ec0c2db53e693091ce710a1b4851bb01...31c4e9ab871003b3501356fb8eb369750a6c83ca,2,15,16,31,7,2011-01-10 21:31:08,2011-01-10 21:30:35
31c4e9ab871003b3501356fb8eb369750a6c83ca...4dac3edc3037a0a3faf4d3d92e375d37fb96f9f1,3,37,0,37,3,2011-01-10 21:31:08,2011-01-10 21:24:27
4dac3edc3037a0a3faf4d3d92e375d37fb96f9f1...532ebd514a39ae63c58ad70cf13d5898c472b0cd,1,2,7,9,3,2011-01-10 22:01:10,2011-01-10 22:01:10
532ebd514a39ae63c58ad70cf13d5898c472b0cd...5cb82809ab9341b9cc5304fd31fe3590db813b09,1,9,8,17,3,2011-01-10 22:07:39,2011-01-10 22:07:39
5cb82809ab9341b9cc5304fd31fe3590db813b09...4b15083a1ba9cc9fbbc66407f9a403ad3a31c269,1,4,0,4,2,2011-01-10 22:16:31,2011-01-10 21:56:21
4b15083a1ba9cc9fbbc66407f9a403ad3a31c269...c73f63d7f9f8bd10be052e84c00ff14688e829f3,1,17,2,19,3,2011-01-10 23:39:12,2011-01-10 23:38:48
c73f63d7f9f8bd10be052e84c00ff14688e829f3...717af9c6bc234d61105e2253eb5b9006a14ba199,1,4,0,4,2,2011-01-10 23:50:47,2011-01-10 23:50:17
717af9c6bc234d61105e2253eb5b9006a14ba199...8c9cc752e7e55b458dbd4bfbf8de642a2b8ae818,2,63,53,116,8,2011-01-11 02:59:23,2011-01-11 02:59:23
8c9cc752e7e55b458dbd4bfbf8de642a2b8ae818...640852ef604cdfa604a2c5d605419c10ffe479cc,1,2,0,2,2,2011-01-11 06:15:54,2011-01-11 06:15:54
640852ef604cdfa604a2c5d605419c10ffe479cc...8f6aa41ebd9473679ffaa695a10984ba8d37ea85,2,2,2,4,2,2011-01-11 06:52:21,2011-01-11 06:07:04
8f6aa41ebd9473679ffaa695a10984ba8d37ea85...fdc39d18bba4a1d9485395d0f94bbef8b2c96479,1,0,3,3,1,2011-01-11 06:52:21,2011-01-11 06:22:35
fdc39d18bba4a1d9485395d0f94bbef8b2c96479...d81f037c21767284e1ebe7ec928c0b040d0ad082,2,10,2,12,6,2011-01-11 06:52:21,2011-01-11 06:51:33
d81f037c21767284e1ebe7ec928c0b040d0ad082...512cbb06db2ba8c11ba91d4eae7937fb1b1f65a8,1,3,0,3,1,2011-01-11 18:06:45,2011-01-11 18:06:45
512cbb06db2ba8c11ba91d4eae7937fb1b1f65a8...b7ca3057211459965c9ece7f7a2898f2994c10ee,1,0,6,6,2,2011-01-11 18:13:30,2011-01-11 18:12:57
b7ca3057211459965c9ece7f7a2898f2994c10ee...7c3be2b805181697dad0b04db42aa759934d340d,1,21,1,22,2,2011-01-11 21:04:39,2011-01-11 21:04:39
7c3be2b805181697dad0b04db42aa759934d340d...2560f2c291329b0783a08d9ba7af5b7cfbf0a446,1,2,2,4,1,2011-01-11 21:07:12,2011-01-11 21:06:13
2560f2c291329b0783a08d9ba7af5b7cfbf0a446...c8be8c7b275504d0160711006fdd41de663ff4cf,2,19,7,26,8,2011-01-12 00:10:06,2011-01-12 00:10:06
c8be8c7b275504d0160711006fdd41de663ff4cf...70599d7e8d478f51fe4d1312c39cd58df823fe5c,1,136,0,136,1,2011-01-12 02:43:22,2011-01-12 02:43:22
70599d7e8d478f51fe4d1312c39cd58df823fe5c...d456901022a2108682c88071fb9129660970a473,1,1,1,2,1,2011-01-12 03:38:18,2011-01-12 03:38:18
d456901022a2108682c88071fb9129660970a473...5b6a5a90ac496448abb3ebf831191ba13a42bd1e,1,10,0,10,1,2011-01-12 04:01:17,2011-01-12 04:01:17
5b6a5a90ac496448abb3ebf831191ba13a42bd1e...d9b92b0f984ec1e75705e90a6ee0fe56b0487ce2,1,1,0,1,1,2011-01-12 05:01:32,2011-01-12 05:01:32
d9b92b0f984ec1e75705e90a6ee0fe56b0487ce2...e3b1d105767dce60f31f6b16e2e9b2cec49df795,1,1,1,2,1,2011-01-12 13:42:36,2011-01-12 13:42:36
e3b1d105767dce60f31f6b16e2e9b2cec49df795...91647267b3da87f585ae5e83e2c7751a29865f5f,1,6,0,6,2,2011-01-12 13:45:53,2011-01-12 13:45:53
91647267b3da87f585ae5e83e2c7751a29865f5f...8a37c45ed7e8407517a7f0b6b78b2de8815a859e,1,7,3,10,1,2011-01-12 13:49:45,2011-01-12 13:49:45
8a37c45ed7e8407517a7f0b6b78b2de8815a859e...a4c8d5ccaf43bd5d6f72fae0a0855c56cb5af713,3,4,3,7,4,2011-01-12 15:05:49,2011-01-12 15:05:49
a4c8d5ccaf43bd5d6f72fae0a0855c56cb5af713...c08524bf3ad810d69188f26491cb119e0628df50,1,2,0,2,1,2011-01-12 15:08:49,2011-01-12 15:08:49
c08524bf3ad810d69188f26491cb119e0628df50...1f11a13120c33717ce459b326dd16cbfd62b94ce,2,6,0,6,3,2011-01-12 15:37:00,2011-01-12 15:37:00
1f11a13120c33717ce459b326dd16cbfd62b94ce...fcf81e35c62f68d26827263f769b9f40446685b7,1,1,0,1,1,2011-01-12 15:45:31,2011-01-12 15:45:31
fcf81e35c62f68d26827263f769b9f40446685b7...0063a97194f1a5d7c72fd64857febdff91abb344,3,19,2,21,6,2011-01-12 19:03:27,2011-01-12 19:03:27
0063a97194f1a5d7c72fd64857febdff91abb344...0d58f8d17b2dfb73ce7e906a52d96e37279e8c1f,1,4,0,4,1,2011-01-12 19:39:25,2011-01-12 19:32:51
0d58f8d17b2dfb73ce7e906a52d96e37279e8c1f...dd02c70f72fdd652d2c51db443457805840bf5c0,1,2,3,5,1,2011-01-12 20:01:17,2011-01-12 20:01:01
dd02c70f72fdd652d2c51db443457805840bf5c0...72fdc637c985ca2fc8f8135e046867efeaa87e30,2,11,4,15,2,2011-01-12 21:11:47,2011-01-12 21:11:47
72fdc637c985ca2fc8f8135e046867efeaa87e30...06d88a13678e76545db6b41fc591b153aa98abd4,2,2,1,3,2,2011-01-12 21:16:25,2011-01-11 19:03:20
06d88a13678e76545db6b41fc591b153aa98abd4...6564496c102beb3fc5de3c6a069138e290376a78,1,3,0,3,2,2011-01-12 21:16:25,2011-01-12 19:59:58
6564496c102beb3fc5de3c6a069138e290376a78...1bc1c3cc3ab111d7177c426b1757221c36171fc0,3,18,0,18,5,2011-01-12 21:16:25,2011-01-12 20:50:20
1bc1c3cc3ab111d7177c426b1757221c36171fc0...b4094b20bb0668800ee456f7b6198d0822343f1a,3,24,30,54,13,2011-01-12 21:16:25,2011-01-12 20:54:31
b4094b20bb0668800ee456f7b6198d0822343f1a...b9e92de6d792dd0de7efa962862c650ade28a9a2,1,1,1,2,1,2011-01-12 21:18:58,2011-01-12 21:18:46
b9e92de6d792dd0de7efa962862c650ade28a9a2...87716d415211e23833afac305af96acb9ea67900,1,12,12,24,2,2011-01-12 21:32:24,2011-01-12 21:32:24
87716d415211e23833afac305af96acb9ea67900...e0bdcb4f2b96e35e0fe4e5b830791b2c20259c4c,1,2,0,2,2,2011-01-12 21:57:56,2011-01-12 21:57:56
e0bdcb4f2b96e35e0fe4e5b830791b2c20259c4c...d22898cd960ee1af6c1bd0115328bd5fc3137117,1,1,1,2,1,2011-01-12 22:40:14,2011-01-12 22:40:14
d22898cd960ee1af6c1bd0115328bd5fc3137117...4ee1a5bfad2f6dcae282b94f37d5c9b9321ee011,1,5,2,7,2,2011-01-12 23:02:43,2011-01-12 23:02:30
4ee1a5bfad2f6dcae282b94f37d5c9b9321ee011...58ee69ab28fc1e817a729634144631aa538c6584,2,54,2,56,14,2011-01-12 23:54:13,2011-01-12 23:54:13
58ee69ab28fc1e817a729634144631aa538c6584...16fdaa9d65e4656b82ccdcf293e74b43317a8330,1,1,1,2,1,2011-01-12 23:58:14,2011-01-12 23:58:14
16fdaa9d65e4656b82ccdcf293e74b43317a8330...bc79320ca8807ce4d8990d1d793a34f3a2f05588,1,1,1,2,1,2011-01-13 01:22:46,2011-01-13 01:12:49
bc79320ca8807ce4d8990d1d793a34f3a2f05588...e3ae36e0764c1d66b77fb201165c06851ccc237a,2,0,4,4,3,2011-01-13 01:22:46,2011-01-13 01:20:25
e3ae36e0764c1d66b77fb201165c06851ccc237a...6bf551e90f84fd16a5bd7dccfd2546fb00634b30,1,27,14,41,7,2011-01-13 18:31:01,2011-01-13 18:30:13
6bf551e90f84fd16a5bd7dccfd2546fb00634b30...a4c04f51cbe90dbb26efeb7abf02098f7faf1740,2,8,20,28,7,2011-01-13 19:31:05,2011-01-13 19:31:05
a4c04f51cbe90dbb26efeb7abf02098f7faf1740...71f257f2c5275b62521422ad8a960b4c0b104a2a,1,1,1,2,1,2011-01-13 19:47:20,2011-01-13 19:47:06
71f257f2c5275b62521422ad8a960b4c0b104a2a...2a1bdfe3e2749e7e9fc5f4f272f8c6c292b933b6,1,1,1,2,1,2011-01-13 19:49:38,2011-01-13 19:48:39
2a1bdfe3e2749e7e9fc5f4f272f8c6c292b933b6...bec19b9fb98ac84c04cf3975e4bf53c9b35dcf64,1,5,4,9,4,2011-01-13 21:11:55,2011-01-13 21:11:39
bec19b9fb98ac84c04cf3975e4bf53c9b35dcf64...209a0e24d122fea0ea9329c9ad35fa4fe80d995c,1,9,10,19,4,2011-01-13 21:52:38,2011-01-13 21:52:38
209a0e24d122fea0ea9329c9ad35fa4fe80d995c...6f04f2e4e023107b841f8a1e0f358012de737c2c,1,3,0,3,1,2011-01-13 22:05:25,2011-01-13 21:20:44
6f04f2e4e023107b841f8a1e0f358012de737c2c...5526c3835343f84e0567d7b3f330f1454fb1e661,1,1,1,2,1,2011-01-13 22:05:25,2011-01-13 21:40:19
5526c3835343f84e0567d7b3f330f1454fb1e661...7e78a93c75b95cfff767238937f033e051e94a9b,3,19,1,20,7,2011-01-13 22:19:23,2011-01-13 22:19:14
7e78a93c75b95cfff767238937f033e051e94a9b...bfda2f21d56711ad5fd3c4d9a37d85fb8375c2ac,1,1,0,1,1,2011-01-13 22:24:09,2011-01-13 22:24:09
bfda2f21d56711ad5fd3c4d9a37d85fb8375c2ac...a0cb81514e20f843adc490f04f9c7738c1e210b8,1,1,0,1,1,2011-01-13 22:47:23,2011-01-13 22:47:23
a0cb81514e20f843adc490f04f9c7738c1e210b8...2397fef9c1f8ae157c81dc9f00842f3e737239f8,2,3,3,6,2,2011-01-13 22:48:44,2011-01-13 22:48:44
2397fef9c1f8ae157c81dc9f00842f3e737239f8...c07f1d537958881548aec0a3db7e83d505354b0a,1,4,5,9,4,2011-01-13 23:49:05,2011-01-13 23:49:05
c07f1d537958881548aec0a3db7e83d505354b0a...526387a2df7582d880256185fe9257c846dd6f11,1,3,0,3,1,2011-01-14 00:02:39,2011-01-14 00:02:39
526387a2df7582d880256185fe9257c846dd6f11...4666cecb3469e7a6320e9cc21dee006517bedffc,1,9,1,10,1,2011-01-14 00:44:11,2011-01-14 00:44:11
4666cecb3469e7a6320e9cc21dee006517bedffc...a11b25979d66bbccd98f9c2ebe341ba7606b9546,1,10,0,10,10,2011-01-14 01:06:14,2011-01-14 01:05:50
a11b25979d66bbccd98f9c2ebe341ba7606b9546...f740064ca9eb619888bb2566698e3025d415e49e,2,11,1,12,5,2011-01-14 02:23:12,2011-01-14 02:23:12
f740064ca9eb619888bb2566698e3025d415e49e...a1e801791c64e4183bdf1a66ef70145eee115b33,2,2,2,4,3,2011-01-14 02:51:28,2011-01-14 02:51:28
a1e801791c64e4183bdf1a66ef70145eee115b33...e0ed2956116c8615b88514e32858a27940faaf3f,4,26,28,54,7,2011-01-14 03:33:44,2011-01-14 03:33:44
e0ed2956116c8615b88514e32858a27940faaf3f...3e4bec745d40e97cbcf2bd8f44b4437132009270,1,8,6,14,6,2011-01-14 03:37:04,2011-01-14 03:36:41
3e4bec745d40e97cbcf2bd8f44b4437132009270...b3ce623097ba05b25820bdab91053cd1aa51217f,1,3,1,4,3,2011-01-14 05:47:39,2011-01-14 05:42:38
b3ce623097ba05b25820bdab91053cd1aa51217f...aed38eda42734d09327585aa82ab08cfdd40db52,1,1,1,2,1,2011-01-14 16:24:42,2011-01-14 16:24:42
aed38eda42734d09327585aa82ab08cfdd40db52...325b51e25b13c08a3ec3ae02d247e681f0ed03f5,1,1,7,8,5,2011-01-14 18:44:21,2011-01-14 18:39:54
325b51e25b13c08a3ec3ae02d247e681f0ed03f5...e419e8c850d2a40e1d36f42a734d9ab5735fb1d8,2,5,1,6,2,2011-01-14 18:44:21,2011-01-14 18:43:35
e419e8c850d2a40e1d36f42a734d9ab5735fb1d8...a7e51ea6742f63abbe939e4e493329bf390777c8,1,10,20,30,6,2011-01-14 20:15:28,2011-01-14 20:13:05
a7e51ea6742f63abbe939e4e493329bf390777c8...4ebc3250853cfc532220961152629674e43cbd5e,1,6,8,14,6,2011-01-14 20:44:15,2011-01-14 20:44:15
4ebc3250853cfc532220961152629674e43cbd5e...d030c86a4601ea6ac03ac88281d92e2eb342f065,1,1,9,10,1,2011-01-14 20:44:32,2011-01-14 20:44:32
d030c86a4601ea6ac03ac88281d92e2eb342f065...a380c189fccec3c7e21d207c16f13bbad3433d6b,1,2,2,4,2,2011-01-14 20:45:25,2011-01-14 20:45:25
a380c189fccec3c7e21d207c16f13bbad3433d6b...1050261fbe371cdd3e546b80d9f193b7afeb2032,1,1,1,2,1,2011-01-14 20:45:45,2011-01-14 20:45:45
1050261fbe371cdd3e546b80d9f193b7afeb2032...1e32f521621326f4b49684b963c3e54d39eb22c7,1,1,3,4,2,2011-01-14 21:41:53,2011-01-14 21:41:53
1e32f521621326f4b49684b963c3e54d39eb22c7...56f648f07ac02a08005db367b3403dd8e21fdd31,1,1,1,2,1,2011-01-14 21:44:38,2011-01-14 21:44:04
56f648f07ac02a08005db367b3403dd8e21fdd31...d56aef4fa6216ee6a56312ca63af845cfdb1a4eb,1,1,1,2,1,2011-01-14 22:33:20,2011-01-14 20:11:31
d56aef4fa6216ee6a56312ca63af845cfdb1a4eb...a39420b6558b2bbe3bc56d65df249c34fa2dedfa,1,0,11,11,9,2011-01-14 22:33:20,2011-01-14 20:13:51
a39420b6558b2bbe3bc56d65df249c34fa2dedfa...d8f480ab93ce4d079aa2586389b63a4556943095,1,4,0,4,1,2011-01-14 22:36:53,2011-01-14 22:36:53
d8f480ab93ce4d079aa2586389b63a4556943095...8ed6dc3da7df11f58000a2cb794299705fcc2197,1,2,2,4,2,2011-01-14 23:01:29,2011-01-14 23:01:29
8ed6dc3da7df11f58000a2cb794299705fcc2197...e8a0dc9096d3a2ead21c755a2a5c360eb4b33098,1,2,5,7,2,2011-01-14 23:06:33,2011-01-14 23:06:33
e8a0dc9096d3a2ead21c755a2a5c360eb4b33098...6c5e7e2789c1aec92f78fce5a24350ce6357bee0,1,1,0,1,1,2011-01-15 00:27:06,2011-01-14 23:29:22
6c5e7e2789c1aec92f78fce5a24350ce6357bee0...a8b02e12deddc6584bb6c5b3c39f6079932dbc35,3,36,5,41,9,2011-01-15 00:27:07,2011-01-14 23:48:11
a8b02e12deddc6584bb6c5b3c39f6079932dbc35...a61e609d2bc52025d9f7b479411a5241baaa0130,5,19,19,38,16,2011-01-15 00:27:07,2011-01-15 00:26:26
a61e609d2bc52025d9f7b479411a5241baaa0130...37a315ef47a95b46710dbdf9b9f1806ed03f3923,1,55,0,55,1,2011-01-15 01:00:28,2011-01-15 01:00:28
37a315ef47a95b46710dbdf9b9f1806ed03f3923...a3b6f1efdc16a6c01e6577a70f3760ba3cb7ec6b,2,4,4,8,4,2011-01-15 01:28:33,2011-01-15 01:28:33
a3b6f1efdc16a6c01e6577a70f3760ba3cb7ec6b...69813b4367f9893becb4bc57535549026ddddaab,1,4,1,5,1,2011-01-15 01:47:48,2011-01-15 01:47:48
69813b4367f9893becb4bc57535549026ddddaab...1f80cd450111fa9afd8f36181654dde58c227961,1,0,3,3,1,2011-01-15 02:02:18,2011-01-15 02:02:18
1f80cd450111fa9afd8f36181654dde58c227961...a860959b443d80d22398bac3c5545b76fd6de3bc,1,12,0,12,1,2011-01-15 03:35:44,2011-01-15 03:35:44
a860959b443d80d22398bac3c5545b76fd6de3bc...b7546b71c72589b64cf47159e9c6de0806ec64df,2,4,1,5,4,2011-01-15 16:01:17,2011-01-15 16:01:04
b7546b71c72589b64cf47159e9c6de0806ec64df...7b2023f3960cb9f640f36ce8e191871eb6d0aee0,1,1,1,2,1,2011-01-15 20:56:26,2011-01-15 20:56:26
7b2023f3960cb9f640f36ce8e191871eb6d0aee0...1d9d858d981ff312b925bd8b933e844962404fac,3,12,3,15,5,2011-01-16 01:38:57,2011-01-16 01:38:57
1d9d858d981ff312b925bd8b933e844962404fac...7e434caa8d16d87ddfbbe1495e928138a5cbe90d,2,8,6,14,6,2011-01-16 02:14:32,2011-01-16 02:14:32
7e434caa8d16d87ddfbbe1495e928138a5cbe90d...95dfd011e6199191cae20df72dd89922df2b7da6,1,7,3,10,2,2011-01-16 02:25:14,2011-01-16 02:25:14
95dfd011e6199191cae20df72dd89922df2b7da6...fd3adf7629ea858fc5dd3a05d2ba9ba76a96a202,1,2,0,2,1,2011-01-16 05:22:58,2011-01-16 05:22:58
fd3adf7629ea858fc5dd3a05d2ba9ba76a96a202...bbf5abc04abd59bf4f1b731cfddb0c4eca259852,1,4,12,16,7,2011-01-16 05:38:18,2011-01-16 05:38:18
bbf5abc04abd59bf4f1b731cfddb0c4eca259852...1e2021f5d190df58a8cdd7444297ab80a350414f,2,5,0,5,3,2011-01-16 05:44:18,2011-01-16 05:44:18
1e2021f5d190df58a8cdd7444297ab80a350414f...418423388cdfbbb6fd6070b418862f56e9b72179,1,1,1,2,1,2011-01-16 05:51:19,2011-01-16 05:51:19
418423388cdfbbb6fd6070b418862f56e9b72179...58038719764598a23cdb8d4cb8b5e75c75db986e,3,7,34,41,9,2011-01-16 06:03:05,2011-01-16 06:03:05
58038719764598a23cdb8d4cb8b5e75c75db986e...ba78158d2f93394032daa2890e29777b29bf3192,2,77,0,77,2,2011-01-16 06:21:21,2011-01-16 06:21:21
ba78158d2f93394032daa2890e29777b29bf3192...7a1c5d322ce447d810f7027a1851ff7f425aa142,1,1,1,2,1,2011-01-16 06:30:48,2011-01-16 06:30:48
7a1c5d322ce447d810f7027a1851ff7f425aa142...006f2cdab8488b65e7569f047c5f5be35119fee5,1,2,2,4,2,2011-01-16 06:55:36,2011-01-16 06:55:36
006f2cdab8488b65e7569f047c5f5be35119fee5...a3c5fd0642605396b54b52c64afe6a5dd23a59be,2,5,37,42,3,2011-01-16 07:21:07,2011-01-16 07:21:07
a3c5fd0642605396b54b52c64afe6a5dd23a59be...1f8cb82448f92d6ed3472198d6ca8c5f40499c38,1,1,1,2,1,2011-01-16 16:09:40,2011-01-16 16:09:40
a3c5fd0642605396b54b52c64afe6a5dd23a59be...79291bb3a54f77353f65d956b96a7e80fb45e097,1,3,1,4,1,2011-01-16 15:57:34,2011-01-16 15:57:17
659afac62b7413dcd5f29e3e45ea3bcd9dc81764...c0b32e669cceddadcd3890790991dda688be7c39,1,25,0,25,1,2011-01-16 19:31:28,2011-01-16 19:31:11
c0b32e669cceddadcd3890790991dda688be7c39...8bab4da2d78122e11576bcf5b958de77fb0a3d1d,1,3,2,5,1,2011-01-16 21:31:01,2011-01-16 21:31:01
8bab4da2d78122e11576bcf5b958de77fb0a3d1d...9095d06b41bd8a4fdfa57935f972d9400fb71089,2,34,26,60,2,2011-01-17 00:33:42,2011-01-17 00:33:42
9095d06b41bd8a4fdfa57935f972d9400fb71089...53eb4d4441354c5dfe4eeb071ab009da0eac081f,1,12,9,21,4,2011-01-17 02:25:15,2011-01-17 02:25:15
53eb4d4441354c5dfe4eeb071ab009da0eac081f...c5cfbbd2a22cd516e88ffb05a1378efa1fc4a42b,1,1,1,2,1,2011-01-17 06:35:15,2011-01-17 06:28:16
c5cfbbd2a22cd516e88ffb05a1378efa1fc4a42b...066deac52970232c73b40b37a9c35027e64f6d53,1,2,0,2,1,2011-01-17 19:30:36,2011-01-14 23:35:16
066deac52970232c73b40b37a9c35027e64f6d53...00d67d07a9cde9d5736909b5357bf829bd1c1663,1,15,0,15,2,2011-01-17 20:32:40,2011-01-17 20:31:22
00d67d07a9cde9d5736909b5357bf829bd1c1663...880a77542336fedbc0efa5cb69227425398fb26f,1,18,3,21,2,2011-01-17 20:32:40,2011-01-17 20:31:43
880a77542336fedbc0efa5cb69227425398fb26f...593819743eb0f2ca0f29b4a2a2891081e9502a15,1,24,7,31,3,2011-01-18 02:56:08,2011-01-18 02:56:08
593819743eb0f2ca0f29b4a2a2891081e9502a15...83f504f83bde9ad98cff74188e82876fca10d65e,2,10,4,14,6,2011-01-18 03:11:57,2011-01-18 03:11:57
83f504f83bde9ad98cff74188e82876fca10d65e...7324c1722acb4da5c3abc355c8206ecad11ae093,1,3,1,4,2,2011-01-18 04:00:19,2011-01-17 22:45:26
7324c1722acb4da5c3abc355c8206ecad11ae093...593d6a05b46caf77c92219f9b51cecec6fa5e9fc,1,3,3,6,2,2011-01-18 04:00:19,2011-01-18 02:31:48
593d6a05b46caf77c92219f9b51cecec6fa5e9fc...a2cf17b2d6c806b4312f72c9818eb10063a0b43f,1,1,1,2,1,2011-01-18 04:00:19,2011-01-18 03:50:51
a2cf17b2d6c806b4312f72c9818eb10063a0b43f...e37b40a7cd614ae5d5baad2ac1af09fb5cbcd67a,1,2,1,3,1,2011-01-18 04:21:52,2011-01-18 04:21:52
e37b40a7cd614ae5d5baad2ac1af09fb5cbcd67a...41daf0e83f61be17d432e6a92314709fde94bd33,1,3,3,6,2,2011-01-18 04:30:48,2011-01-18 04:30:48
41daf0e83f61be17d432e6a92314709fde94bd33...6be565d6080cea124856095d998d3bbdebf07297,1,2,1,3,1,2011-01-18 04:31:31,2011-01-18 04:31:31
6be565d6080cea124856095d998d3bbdebf07297...7cf243e8bde0b8278757922b703a31810a2d3a63,1,1,1,2,1,2011-01-18 04:31:46,2011-01-18 04:31:46
7cf243e8bde0b8278757922b703a31810a2d3a63...fd1addeab9a5e70e3aaf7ed5c66fd9451f512a1b,1,52,52,104,13,2011-01-18 04:34:35,2011-01-18 04:34:35
fd1addeab9a5e70e3aaf7ed5c66fd9451f512a1b...c400248eb917b99a1513f1ea44f9195ca5ad341c,1,5,4,9,2,2011-01-18 04:44:57,2011-01-18 04:44:57
c400248eb917b99a1513f1ea44f9195ca5ad341c...bffff7d07dd5d5dfa83017ad6ab3127a3a2d4b05,1,2,9,11,1,2011-01-18 13:37:27,2011-01-18 13:37:27
bffff7d07dd5d5dfa83017ad6ab3127a3a2d4b05...d798243f50226bcd1c076d831f94e3062eaeaecd,1,6,0,6,1,2011-01-18 18:11:48,2011-01-18 18:11:48
d798243f50226bcd1c076d831f94e3062eaeaecd...d5b18574eeee86330aa273746381c7798f2b7d09,1,1,0,1,1,2011-01-18 18:14:16,2011-01-18 18:13:52
d5b18574eeee86330aa273746381c7798f2b7d09...c31339550bd3eff0209455ee0da3cf62156f2aac,1,8,1,9,3,2011-01-18 18:14:16,2011-01-18 18:13:57
c31339550bd3eff0209455ee0da3cf62156f2aac...33d8cd8302b219f72b636cced4426a888bc6891d,3,22,3,25,4,2011-01-18 18:49:19,2011-01-18 18:49:19
33d8cd8302b219f72b636cced4426a888bc6891d...c424e28a2f7aec3f44aaaa6707d2c04ad76f2041,1,26,1,27,7,2011-01-18 18:55:48,2011-01-18 18:55:23
c424e28a2f7aec3f44aaaa6707d2c04ad76f2041...5d1abfeb3405527dce05d0cd31f586c4b667ecf2,1,1,1,2,1,2011-01-18 21:32:49,2011-01-18 21:32:49
5d1abfeb3405527dce05d0cd31f586c4b667ecf2...a072c12c30d8ffed06278bdc2ea43864eeda4e6b,1,14,9,23,5,2011-01-19 00:12:11,2011-01-19 00:11:39
a072c12c30d8ffed06278bdc2ea43864eeda4e6b...d4c9571a5aff074b641bac19399a5bd7fab76dc4,2,4,3,7,3,2011-01-19 00:43:55,2011-01-19 00:43:55
d4c9571a5aff074b641bac19399a5bd7fab76dc4...c92162b32db4ff5d7fed97fe7c5392f8f0127a3d,1,9,0,9,3,2011-01-19 00:54:33,2011-01-18 15:14:41
c92162b32db4ff5d7fed97fe7c5392f8f0127a3d...371e0b3b57f7892fb0adc6a421e4ba26875f5433,2,2,2,4,2,2011-01-19 00:55:11,2011-01-19 00:51:09
371e0b3b57f7892fb0adc6a421e4ba26875f5433...85f4700e918678c1ac35fd8c7581fa57258a8efb,1,5,4,9,4,2011-01-19 01:02:48,2011-01-19 01:02:48
85f4700e918678c1ac35fd8c7581fa57258a8efb...8631bb6aad20a140328dc5a22a46f646f57ce974,1,4,1,5,2,2011-01-19 04:42:27,2011-01-19 04:42:27
8631bb6aad20a140328dc5a22a46f646f57ce974...ea23304184509969c8b266404ae218b36142ac7e,1,4,0,4,1,2011-01-19 05:05:43,2011-01-19 05:05:43
ea23304184509969c8b266404ae218b36142ac7e...5a0d65c5b7d00fb2b9e1b51fd2e680a4a903d214,1,1,1,2,1,2011-01-19 05:06:34,2011-01-19 05:06:34
5a0d65c5b7d00fb2b9e1b51fd2e680a4a903d214...b605e4df48c20776a44df27be2e10f24340ffcd1,1,1,1,2,1,2011-01-19 05:34:51,2011-01-19 05:34:06
b605e4df48c20776a44df27be2e10f24340ffcd1...743bb6f02b2ddccff5394cb071f29c3a26355588,1,5,3,8,2,2011-01-19 06:57:27,2011-01-19 06:46:13
743bb6f02b2ddccff5394cb071f29c3a26355588...1830f9cb5e948abcf5e0fa300b941f46a7c57b27,3,52,7,59,7,2011-01-19 08:16:29,2011-01-19 08:14:07
1830f9cb5e948abcf5e0fa300b941f46a7c57b27...19c5748e425fc07b4b724c856c110e07c2098b7a,1,19,7,26,7,2011-01-19 15:45:38,2011-01-19 15:45:38
19c5748e425fc07b4b724c856c110e07c2098b7a...2ab562dc662582705a4114346115f6b913e403e7,1,1,1,2,1,2011-01-19 15:48:20,2011-01-19 15:48:20
2ab562dc662582705a4114346115f6b913e403e7...51aaab10d675b53a179a500aa1cfc77824136f62,1,4,1,5,1,2011-01-19 16:19:20,2011-01-19 16:19:20
51aaab10d675b53a179a500aa1cfc77824136f62...6db38bc79c7871e7833077ee6199fe22717605c6,1,5,5,10,5,2011-01-19 20:37:22,2011-01-19 20:37:22
6db38bc79c7871e7833077ee6199fe22717605c6...0c5c3dcfb197b015fb0797b8e692319d78fd82df,1,1,1,2,1,2011-01-19 20:53:43,2011-01-19 20:53:12
0c5c3dcfb197b015fb0797b8e692319d78fd82df...ead932738864bfa0a2cc1379b16139766724e961,1,32,32,64,4,2011-01-19 21:38:06,2011-01-19 21:38:06
ead932738864bfa0a2cc1379b16139766724e961...de17e47850aa05032edd570f0746342d7d2aa49f,1,5,5,10,5,2011-01-19 21:39:43,2011-01-19 21:39:43
de17e47850aa05032edd570f0746342d7d2aa49f...baa76f1890f4a9a6507100f9b81b44995adf03e3,2,6,6,12,6,2011-01-19 21:41:57,2011-01-19 21:41:57
baa76f1890f4a9a6507100f9b81b44995adf03e3...cf0bfbabef34db1e7fc513dd09c52832780a2a8e,1,19,10,29,1,2011-01-19 22:19:56,2011-01-19 22:17:38
cf0bfbabef34db1e7fc513dd09c52832780a2a8e...39e8457350089ffb7c40ae77142dd1f5eed295f9,1,2,0,2,1,2011-01-19 22:19:58,2011-01-19 22:17:44
39e8457350089ffb7c40ae77142dd1f5eed295f9...c00ed72c02f09ee24223119401e70979aa2d6691,1,13,1,14,1,2011-01-19 22:31:52,2011-01-19 22:31:52
c00ed72c02f09ee24223119401e70979aa2d6691...7c4988b4c49b3a2798c0d6229a6d70359d7447c4,4,7,7,14,4,2011-01-19 23:04:57,2011-01-19 23:03:16
7c4988b4c49b3a2798c0d6229a6d70359d7447c4...f4d4d60929cdddcd95befdb4d5eac9e27ddad5ba,1,11,7,18,2,2011-01-20 00:08:49,2011-01-20 00:08:49
f4d4d60929cdddcd95befdb4d5eac9e27ddad5ba...d92c8417346db67f99e7308ce10c3638c5b9a982,1,7,4,11,4,2011-01-20 00:29:58,2011-01-20 00:29:58
d92c8417346db67f99e7308ce10c3638c5b9a982...fce353f01c887f6f15b875df4ab0eddb911b8d0e,1,3,0,3,1,2011-01-20 00:31:44,2011-01-20 00:31:44
fce353f01c887f6f15b875df4ab0eddb911b8d0e...f8754e701e2d736835db619362b24f394ec7a955,2,9,3,12,4,2011-01-20 03:19:48,2011-01-20 03:19:48
f8754e701e2d736835db619362b24f394ec7a955...f964db5b9e282a733fc2629d4fa96a513ac828c8,1,3,3,6,2,2011-01-20 04:18:15,2011-01-20 04:17:13
f964db5b9e282a733fc2629d4fa96a513ac828c8...cb48ff63f27dd5c133206eac101fe87ad11d9eb2,1,1,1,2,1,2011-01-20 04:18:15,2011-01-20 04:17:36
cb48ff63f27dd5c133206eac101fe87ad11d9eb2...1e7985147a76fc3d2b1b0a3459345b3820b1475b,1,8,6,14,4,2011-01-20 04:18:15,2011-01-20 04:17:51
1e7985147a76fc3d2b1b0a3459345b3820b1475b...58b69777502ea61cbe479dca01775dccfc0ff8f0,2,4,0,4,2,2011-01-20 07:00:22,2011-01-20 07:00:22
58b69777502ea61cbe479dca01775dccfc0ff8f0...16061c38f57cadfaa62dfa49d44d52e6cff65b50,1,1,8,9,1,2011-01-20 07:00:32,2011-01-20 07:00:32
16061c38f57cadfaa62dfa49d44d52e6cff65b50...adc52c9fbcfbe5c3d54392d67dbba539cc32d0f8,1,1,1,2,1,2011-01-20 07:02:32,2011-01-20 07:02:32
adc52c9fbcfbe5c3d54392d67dbba539cc32d0f8...ebba6ab6692a8934e941c822b957de56e3c5a218,1,0,4,4,1,2011-01-20 08:07:05,2011-01-20 08:07:05
ebba6ab6692a8934e941c822b957de56e3c5a218...f8172fe7299902e540b0d72d5e49d2d22b5d0490,2,2,2,4,2,2011-01-20 16:01:57,2011-01-20 16:01:57
f8172fe7299902e540b0d72d5e49d2d22b5d0490...f80dba445f93dd274577a0c400f7b7c7cd258595,1,13,0,13,1,2011-01-20 19:03:59,2011-01-20 19:03:14
f80dba445f93dd274577a0c400f7b7c7cd258595...0a18aae345858061ab6e785288e9835198b0b26b,2,8,0,8,2,2011-01-20 22:00:37,2011-01-20 22:00:17
0a18aae345858061ab6e785288e9835198b0b26b...60f046c9ce5df51758078dcf57b40e9c9a75a76d,1,5,1,6,1,2011-01-20 22:00:37,2011-01-20 22:00:28
60f046c9ce5df51758078dcf57b40e9c9a75a76d...c07259ad3f7f015c412a5927a3d6d2f985429cc7,1,0,1,1,1,2011-01-20 22:05:26,2011-01-20 22:05:26
c07259ad3f7f015c412a5927a3d6d2f985429cc7...d782a78fc75721a4548e28ca3b2adba36470747e,1,1,0,1,1,2011-01-20 22:06:20,2011-01-20 22:06:20
d782a78fc75721a4548e28ca3b2adba36470747e...0369b127ba35196333f2c0be37aacb9e8490c9ef,1,1,1,2,1,2011-01-21 00:34:37,2011-01-21 00:34:37
0369b127ba35196333f2c0be37aacb9e8490c9ef...a756cf2375574732d77479fe3a4ed1c4138feb4e,1,1,1,2,1,2011-01-21 00:35:12,2011-01-21 00:34:44
a756cf2375574732d77479fe3a4ed1c4138feb4e...29f2a72a13ede81261a936040456f1427132fac1,1,5,1,6,1,2011-01-21 02:56:23,2011-01-21 02:56:23
29f2a72a13ede81261a936040456f1427132fac1...279d61cce49b981ff8d44d50b66a5fe0e79da7b1,3,19,9,28,10,2011-01-21 05:55:38,2011-01-21 05:55:38
279d61cce49b981ff8d44d50b66a5fe0e79da7b1...762716d53cf869ce176cfe31045c2058bdc1c6d9,2,1,4,5,2,2011-01-21 07:08:04,2011-01-21 07:08:04
762716d53cf869ce176cfe31045c2058bdc1c6d9...38047f976e9694fe2c5abf014ad87aef3b2882b7,1,4,0,4,1,2011-01-21 07:49:21,2011-01-21 07:49:21
38047f976e9694fe2c5abf014ad87aef3b2882b7...c31c7f322943034bd294993e832f51383799ee5f,4,44,0,44,5,2011-01-21 07:51:21,2011-01-21 07:51:21
c31c7f322943034bd294993e832f51383799ee5f...af54331c386668b05bc85a45fd8fba3cf97c6bed,8,10,10,20,9,2011-01-21 12:58:02,2011-01-21 12:58:02
af54331c386668b05bc85a45fd8fba3cf97c6bed...f63206fed40e42b567b60d9d421fdaa4d2578486,3,7,1,8,3,2011-01-21 14:01:24,2011-01-21 14:01:24
f63206fed40e42b567b60d9d421fdaa4d2578486...253b6aa4ca0d0555b4132fbb72d9e4cc8c7a57a0,1,5,4,9,4,2011-01-21 16:06:30,2011-01-21 16:06:30
253b6aa4ca0d0555b4132fbb72d9e4cc8c7a57a0...26b2082e88773930801dfff4992095e6a4840667,2,14,4,18,4,2011-01-21 18:14:34,2011-01-21 18:14:34
26b2082e88773930801dfff4992095e6a4840667...f0eb24f2245d438a47b677a3c33d3c02c73f7097,1,3,0,3,1,2011-01-21 18:57:35,2011-01-21 18:57:35
f0eb24f2245d438a47b677a3c33d3c02c73f7097...5d45bcfdd4d0e3720e40ea7e2147b0b6d5a0c616,1,6,2,8,2,2011-01-21 19:19:49,2011-01-21 17:44:00
5d45bcfdd4d0e3720e40ea7e2147b0b6d5a0c616...eb6e8a111c4bdaa73b5b069f9c03c82b824b4c1c,1,1,1,2,1,2011-01-21 19:19:49,2011-01-21 17:44:13
eb6e8a111c4bdaa73b5b069f9c03c82b824b4c1c...34de75445d87df5e29b2b1e77fee86613c88c6d1,2,33,0,33,4,2011-01-21 19:19:49,2011-01-21 17:58:20
34de75445d87df5e29b2b1e77fee86613c88c6d1...6fd94b8d3bb308ae9c866f8b9bb98aa62f7f95de,1,2,0,2,1,2011-01-21 19:19:49,2011-01-21 19:17:31
6fd94b8d3bb308ae9c866f8b9bb98aa62f7f95de...cf47b32ead15e42dcd0013fa0a1318fd1a60ca86,1,3,1,4,3,2011-01-21 19:19:49,2011-01-21 19:17:52
cf47b32ead15e42dcd0013fa0a1318fd1a60ca86...124193c25929b70baa9fdd00127d87159b9b64ca,1,1,0,1,1,2011-01-21 19:19:49,2011-01-21 19:18:21
124193c25929b70baa9fdd00127d87159b9b64ca...b331e1c7aed7d85dd14f86e1396f5c091aaa3f0f,6,62,25,87,31,2011-01-21 19:19:49,2011-01-21 19:19:20
b331e1c7aed7d85dd14f86e1396f5c091aaa3f0f...3419f550a0d58a04f505374c2027f7348cdbbb9c,1,5,0,5,1,2011-01-21 20:48:47,2011-01-21 20:48:47
3419f550a0d58a04f505374c2027f7348cdbbb9c...0def9a77bedd970e069dfa46de13d7f6ef2641c5,1,4,1,5,2,2011-01-21 20:48:56,2011-01-21 20:48:56
0def9a77bedd970e069dfa46de13d7f6ef2641c5...609f7211c24339341c8ebb977aa9378cc4ec05b3,1,11,2,13,2,2011-01-21 20:49:13,2011-01-21 20:49:13
609f7211c24339341c8ebb977aa9378cc4ec05b3...5943d51891dbcd23f81710d20865fae35370e4dc,1,38,2,40,3,2011-01-21 22:49:19,2011-01-21 00:26:55
5943d51891dbcd23f81710d20865fae35370e4dc...9aa0cec5b4a5b01c03707c447162932f6720596c,1,172,0,172,1,2011-01-21 22:49:19,2011-01-21 19:05:39
9aa0cec5b4a5b01c03707c447162932f6720596c...97b401462c49a0072d4643efb2f9c5b572c3a1ce,1,20,10,30,7,2011-01-21 22:49:19,2011-01-21 22:48:40
97b401462c49a0072d4643efb2f9c5b572c3a1ce...84e7e2ce17c1d5a48c1cf8f468a6ce4c0d558097,1,20,0,20,6,2011-01-22 00:10:51,2011-01-22 00:10:51
84e7e2ce17c1d5a48c1cf8f468a6ce4c0d558097...18880d7216832e1a3fbdfb287c860f5a41d655ef,1,1,1,2,1,2011-01-22 01:32:49,2011-01-22 01:32:49
18880d7216832e1a3fbdfb287c860f5a41d655ef...8e315500f5ceaaac6739a8fd85aff7a5732df4ca,1,9,3,12,5,2011-01-22 01:33:27,2011-01-22 01:33:27
8e315500f5ceaaac6739a8fd85aff7a5732df4ca...32198fddd90612388cad7ebb4c71493dd351fb4f,1,12,1,13,4,2011-01-22 05:27:28,2011-01-22 05:27:28
32198fddd90612388cad7ebb4c71493dd351fb4f...40b3524b75c498759d91ce0b4c3ae8046db37911,2,8,2,10,2,2011-01-22 05:38:52,2011-01-22 05:38:52
40b3524b75c498759d91ce0b4c3ae8046db37911...749f9ebda284a94d5e806e400cec08601887971b,1,1,1,2,1,2011-01-22 15:49:58,2011-01-22 15:49:58
749f9ebda284a94d5e806e400cec08601887971b...a35642a48c9bda63ab3741d320523084e7071d7f,1,1,0,1,1,2011-01-22 15:57:08,2011-01-22 15:57:08
a35642a48c9bda63ab3741d320523084e7071d7f...b99dbf9cfcc326203e5978cdb5ba7d527cf2ba68,1,11,4,15,4,2011-01-22 17:39:42,2011-01-22 17:39:42
b99dbf9cfcc326203e5978cdb5ba7d527cf2ba68...449f4e40c87ec742b179d06e45146f8937dda3d6,1,8,3,11,1,2011-01-22 17:54:17,2011-01-22 17:54:17
449f4e40c87ec742b179d06e45146f8937dda3d6...f70a285449c1b934b496f905a97657f8f388b2e0,2,14,4,18,3,2011-01-22 19:07:16,2011-01-22 19:07:16
f70a285449c1b934b496f905a97657f8f388b2e0...3156a1fb43bf50d5d0185961ebcc681d79df6abb,1,12,0,12,1,2011-01-22 22:11:17,2011-01-22 22:11:17
3156a1fb43bf50d5d0185961ebcc681d79df6abb...76418c81fdf80b9545ab8ecf0ed7a68c9aac0404,1,7,0,7,2,2011-01-23 00:57:15,2011-01-23 00:57:15
76418c81fdf80b9545ab8ecf0ed7a68c9aac0404...3465621cb93fdf8990f30861c8f6c802b7e2fca7,1,2,2,4,2,2011-01-23 01:53:12,2011-01-23 01:53:12
3465621cb93fdf8990f30861c8f6c802b7e2fca7...097a82fda953a52f782f2c081a9fd9baeefb5b22,1,1,0,1,1,2011-01-23 02:25:56,2011-01-23 02:25:56
097a82fda953a52f782f2c081a9fd9baeefb5b22...f522e3cf7867996d602a653a5281d130b9fd6d81,1,10,0,10,1,2011-01-23 02:49:00,2011-01-23 02:49:00
f522e3cf7867996d602a653a5281d130b9fd6d81...e55de40941f2055ebe22d431781181128160440a,1,2,0,2,1,2011-01-23 02:50:19,2011-01-23 02:50:19
e55de40941f2055ebe22d431781181128160440a...c5f147a35a209a54cced9399be5612333fe01cef,1,7,4,11,3,2011-01-23 02:54:27,2011-01-23 02:54:27
c5f147a35a209a54cced9399be5612333fe01cef...5fe08938f0fb07cf4de17ca4af3259182f99eb65,1,27,28,55,14,2011-01-23 03:46:19,2011-01-23 03:46:19
5fe08938f0fb07cf4de17ca4af3259182f99eb65...0380e6fb2c7f7776cb76368e355496e71df671e9,1,2,1,3,2,2011-01-23 03:52:06,2011-01-23 03:52:06
0380e6fb2c7f7776cb76368e355496e71df671e9...0fc527a17c6aca517fe8410c8e9738715cd0a266,1,1,1,2,1,2011-01-23 04:37:11,2011-01-23 04:37:11
0fc527a17c6aca517fe8410c8e9738715cd0a266...f7bc0765eb14c14790c4749bc0d0c6322dcba569,2,16,4,20,8,2011-01-23 04:38:44,2011-01-23 04:38:44
f7bc0765eb14c14790c4749bc0d0c6322dcba569...5edb4cc31008a3556d61121c3699d4dd212884d0,2,8,4,12,2,2011-01-23 07:53:31,2011-01-23 07:48:44
5edb4cc31008a3556d61121c3699d4dd212884d0...2c5795d6207ff16ea44e27bf55e8c3729e1060ed,3,84,6,90,6,2011-01-23 07:53:31,2011-01-23 07:50:22
2c5795d6207ff16ea44e27bf55e8c3729e1060ed...4f5b88015724bd866564b95592296c7ea28a46cb,2,26,8,34,8,2011-01-23 07:53:31,2011-01-23 07:50:45
4f5b88015724bd866564b95592296c7ea28a46cb...a85d0760cd8b023ff2dbf9e6e0330e497c91eddf,1,38,18,56,3,2011-01-23 07:53:31,2011-01-23 07:51:31
a85d0760cd8b023ff2dbf9e6e0330e497c91eddf...cef783d1cf181457057d87fba386635923a2d6c5,1,40,5,45,8,2011-01-23 07:53:31,2011-01-23 07:51:42
cef783d1cf181457057d87fba386635923a2d6c5...017c0ab553e1304691e6f7a72c4a6eb0633d1c2c,2,2,2,4,2,2011-01-23 15:08:23,2011-01-23 15:08:23
017c0ab553e1304691e6f7a72c4a6eb0633d1c2c...fea817552a5624875a1fe31909a8e178f5b506c8,1,0,0,0,0,2011-01-23 15:09:02,2011-01-23 15:09:02
fea817552a5624875a1fe31909a8e178f5b506c8...e2b9ab610d06030a7ecce42c10643f57fc07e4c7,1,5,2,7,1,2011-01-23 23:42:14,2011-01-23 23:42:14
e2b9ab610d06030a7ecce42c10643f57fc07e4c7...ece3377d996acba9d9961986381a1a5fbcc4636b,2,10,1,11,4,2011-01-24 05:19:53,2011-01-24 05:19:53
ece3377d996acba9d9961986381a1a5fbcc4636b...2951ea2d16ad6ba24121a401aca6634846694662,1,1,1,2,1,2011-01-24 05:21:33,2011-01-24 05:21:33
2951ea2d16ad6ba24121a401aca6634846694662...a8bf207d8493f752f7afb64d6d37df29c13b6ae0,1,23,23,46,10,2011-01-24 06:03:02,2011-01-24 06:03:02
a8bf207d8493f752f7afb64d6d37df29c13b6ae0...bcab1f1ab1ac66797924256c0bef7cba2826edb5,1,3,0,3,1,2011-01-24 06:43:25,2011-01-24 06:42:56
bcab1f1ab1ac66797924256c0bef7cba2826edb5...6dd4315ccbb2897b7e5f0943882f2bf57a87d37d,1,4,0,4,2,2011-01-24 06:43:25,2011-01-24 06:43:08
6dd4315ccbb2897b7e5f0943882f2bf57a87d37d...303db30c85716cf22272c990d09c3658d6012238,1,11,3,14,5,2011-01-24 06:48:57,2011-01-24 06:48:57
303db30c85716cf22272c990d09c3658d6012238...9c1381ece0055e5582b874205eb7493676b500bb,1,8,6,14,1,2011-01-24 15:03:23,2011-01-24 15:03:23
9c1381ece0055e5582b874205eb7493676b500bb...bc8bfe2625fee9b4b596c2d0bd83c3201ce558bc,1,9,3,12,2,2011-01-24 15:39:26,2011-01-24 15:39:26
bc8bfe2625fee9b4b596c2d0bd83c3201ce558bc...ef2657b9b67e5a4031fc2bf21b5410aab647b350,3,3,83,86,6,2011-01-24 16:39:12,2011-01-24 16:39:12
ef2657b9b67e5a4031fc2bf21b5410aab647b350...7dfc4aeac0cadd324f37ce6989434db3d2c76f55,1,11,2,13,2,2011-01-24 19:04:36,2011-01-24 18:59:00
7dfc4aeac0cadd324f37ce6989434db3d2c76f55...3bbf45d1899733b9370f85998bddab48c399065a,1,2,11,13,2,2011-01-24 20:44:14,2011-01-24 20:43:58
3bbf45d1899733b9370f85998bddab48c399065a...25d5328e04635171aa8722e1dcbb6fcfb5620f45,1,1,1,2,1,2011-01-24 21:47:51,2011-01-24 21:47:39
25d5328e04635171aa8722e1dcbb6fcfb5620f45...50182cce101041a52645c668e3aaa18f99d66962,1,1,1,2,1,2011-01-24 21:53:00,2011-01-24 21:53:00
50182cce101041a52645c668e3aaa18f99d66962...58bbafbc57df03bd4cf06a15fa61e57baca59a11,2,142,40,182,74,2011-01-24 23:07:54,2011-01-24 23:07:54
58bbafbc57df03bd4cf06a15fa61e57baca59a11...d45a6d5b1a6a9e8d0c8bc4b7bbe324f807e2357f,1,47,0,47,1,2011-01-24 23:38:44,2011-01-24 23:38:44
d45a6d5b1a6a9e8d0c8bc4b7bbe324f807e2357f...feb971d07c3e0bfc32c7961b9f91be18e71f71ef,1,4,1,5,2,2011-01-25 06:00:51,2011-01-25 06:00:51
feb971d07c3e0bfc32c7961b9f91be18e71f71ef...2846cea2e392344753e65523feb158ed0750c07b,1,5,4,9,3,2011-01-25 06:49:41,2011-01-25 06:22:41
2846cea2e392344753e65523feb158ed0750c07b...34e9ef62fbe4f3ba285efa2e37f5fc33e6462c23,2,23,6,29,3,2011-01-25 07:02:37,2011-01-25 06:54:16
34e9ef62fbe4f3ba285efa2e37f5fc33e6462c23...a7eb7f2c47f247f6a9632ecd491536c93aa7ef3a,6,42,14,56,22,2011-01-25 07:02:37,2011-01-25 07:00:30
a7eb7f2c47f247f6a9632ecd491536c93aa7ef3a...fd36dc975e8129121ec25db7a5576c4994a288af,1,2,1,3,1,2011-01-25 07:02:37,2011-01-25 07:01:07
fd36dc975e8129121ec25db7a5576c4994a288af...43d4d1306fdebfc83d8aa5827242751b9beda4f5,2,52,32,84,5,2011-01-25 07:02:38,2011-01-25 07:02:20
43d4d1306fdebfc83d8aa5827242751b9beda4f5...f95847b3cf800b9646f34b1dc9039ba6d36c20dc,1,2,2,4,1,2011-01-25 07:23:31,2011-01-25 07:23:31
f95847b3cf800b9646f34b1dc9039ba6d36c20dc...58b6f4283870249aac279509fb32bda54347f4d3,3,14,9,23,11,2011-01-25 15:19:53,2011-01-25 15:19:53
58b6f4283870249aac279509fb32bda54347f4d3...7c0c4d13e5c8e92d6450fc8ab540fbbe66303ea8,1,1,1,2,1,2011-01-25 15:33:53,2011-01-25 15:33:53
7c0c4d13e5c8e92d6450fc8ab540fbbe66303ea8...d1e0c5a47a5564e05bb0a3d118214e19f9e44751,3,23,5,28,7,2011-01-25 15:53:42,2011-01-25 15:53:42
d1e0c5a47a5564e05bb0a3d118214e19f9e44751...1059f85625c82045bd2c3370be4552db84d4c60c,1,4,0,4,1,2011-01-25 16:18:30,2011-01-25 16:18:30
1059f85625c82045bd2c3370be4552db84d4c60c...d6504a9936345c608b4f6ab43e2a641776f4183a,1,9,2,11,3,2011-01-25 16:53:03,2011-01-25 16:53:03
d6504a9936345c608b4f6ab43e2a641776f4183a...9a6b01a2c339aee02bdcb2e8de12c639ab7a4762,1,1,1,2,1,2011-01-25 16:58:21,2011-01-25 16:58:21
9a6b01a2c339aee02bdcb2e8de12c639ab7a4762...9a868b1198931ff3fb555bceef15192184feca7e,1,2,2,4,2,2011-01-25 17:05:15,2011-01-25 17:05:15
9a868b1198931ff3fb555bceef15192184feca7e...4e3145686e5372149ccd2cbd3a7f98d44df78836,1,2,2,4,1,2011-01-25 19:24:19,2011-01-25 19:24:19
4e3145686e5372149ccd2cbd3a7f98d44df78836...dde119cf7bf9d42a3a3ef68fb44f21040b04f3a4,1,3,3,6,2,2011-01-25 19:40:46,2011-01-25 19:37:01
dde119cf7bf9d42a3a3ef68fb44f21040b04f3a4...4d6fc6d5e5ff9fbf465062e711dcd60b3039700f,2,10,6,16,6,2011-01-25 19:52:45,2011-01-25 19:52:32
4d6fc6d5e5ff9fbf465062e711dcd60b3039700f...5d1a9035bbc98e605040fcfc3ba902474ca896fe,3,200,0,200,3,2011-01-25 20:04:22,2011-01-25 20:04:22
5d1a9035bbc98e605040fcfc3ba902474ca896fe...9956662b3a3a8fba47db838ff36a937e635f8071,1,1,4,5,1,2011-01-25 20:06:21,2011-01-25 20:05:35
9956662b3a3a8fba47db838ff36a937e635f8071...99fc51205f68a40bce67e20d719043c9e62f3aca,1,5,3,8,2,2011-01-25 20:24:18,2011-01-25 20:24:18
99fc51205f68a40bce67e20d719043c9e62f3aca...5dfdf5cc0e9038ee6b8b18f7eca7a118a5ec81d1,1,0,0,0,0,2011-01-25 21:07:56,2011-01-25 21:07:56
5dfdf5cc0e9038ee6b8b18f7eca7a118a5ec81d1...001b3a655a1eb403801430f6937248f0bcd92b28,3,1,81,82,3,2011-01-25 21:12:51,2011-01-25 21:12:39
001b3a655a1eb403801430f6937248f0bcd92b28...fd204c99b376f598893c2622a816ccdc227c469a,4,26,9,35,6,2011-01-25 21:19:21,2011-01-25 21:18:54
fd204c99b376f598893c2622a816ccdc227c469a...7765cc598206b57ddbfab74dd8b8b4b7f7f5d989,1,2,0,2,1,2011-01-25 21:35:01,2011-01-25 21:35:01
7765cc598206b57ddbfab74dd8b8b4b7f7f5d989...1aabdc3d74d83759d40f4b290fc89aa653c494d5,1,2,0,2,1,2011-01-25 22:40:30,2011-01-25 22:33:12
1aabdc3d74d83759d40f4b290fc89aa653c494d5...34f8e800ce518a3cedee2f2a61cafc7e919e0bb1,2,18,14,32,12,2011-01-25 23:20:07,2011-01-25 22:41:16
34f8e800ce518a3cedee2f2a61cafc7e919e0bb1...f2f6c281b04c2986c6d3d96adf8a5a523145e502,1,2,0,2,1,2011-01-25 23:22:33,2011-01-25 23:22:24
f2f6c281b04c2986c6d3d96adf8a5a523145e502...3923e7c47ed2419b082d306305777df6217fa7e5,1,1,0,1,1,2011-01-26 14:27:12,2011-01-26 14:27:12
3923e7c47ed2419b082d306305777df6217fa7e5...60034218a71b89069750e693d53fe35676f3c775,1,1,1,2,1,2011-01-26 14:28:33,2011-01-26 14:28:33
60034218a71b89069750e693d53fe35676f3c775...6001665cee7d1dfd04d97058691c9d72ac190150,5,26,22,48,9,2011-01-26 16:21:16,2011-01-26 16:21:16
6001665cee7d1dfd04d97058691c9d72ac190150...7e0285040eb8754f2b4e72d18bf072fbd3af82fc,1,7,10,17,4,2011-01-26 16:43:43,2011-01-26 16:43:43
7e0285040eb8754f2b4e72d18bf072fbd3af82fc...d4c4acf737d55fc5e7008c056eafbe40dcbdcd48,2,14,1,15,2,2011-01-26 16:43:58,2011-01-26 16:43:58
d4c4acf737d55fc5e7008c056eafbe40dcbdcd48...440c54506b12cf6581b9d860a41a37c8afebc5ab,1,6,2,8,1,2011-01-26 17:01:58,2011-01-26 17:01:58
440c54506b12cf6581b9d860a41a37c8afebc5ab...66d4211bbae8fa39c31a620692cd4564f7681669,1,18,0,18,1,2011-01-26 18:22:20,2011-01-26 18:21:23
66d4211bbae8fa39c31a620692cd4564f7681669...c104467d2d6943a14e09d60de122620e4da1e304,1,1,0,1,1,2011-01-26 18:34:43,2011-01-26 18:32:27
c104467d2d6943a14e09d60de122620e4da1e304...f7d1dbff85b54014ead2d5859228fd16b072b9db,1,6,2,8,3,2011-01-26 18:34:43,2011-01-26 18:34:31
f7d1dbff85b54014ead2d5859228fd16b072b9db...1978898d7a013657e5400133defdc996fb4c2c15,4,10,3,13,4,2011-01-26 18:38:55,2011-01-26 18:38:55
1978898d7a013657e5400133defdc996fb4c2c15...7ccac7109dccc0384b761f6b02b9788342c5eabb,1,9,3,12,5,2011-01-26 19:19:40,2011-01-26 19:19:40
7ccac7109dccc0384b761f6b02b9788342c5eabb...92e287cfe8d41d8ced928181521827475fcbbeb7,1,1,1,2,1,2011-01-26 21:58:27,2011-01-26 21:58:27
92e287cfe8d41d8ced928181521827475fcbbeb7...a6be478c8dfec850ea2873f23f8b5358fab102c9,2,2,2,4,2,2011-01-26 22:05:08,2011-01-26 22:05:08
a6be478c8dfec850ea2873f23f8b5358fab102c9...c3de5e8a1aabb7d732566907e4887f322b3a9ac8,5,7,7,14,6,2011-01-27 01:25:08,2011-01-27 01:25:08
c3de5e8a1aabb7d732566907e4887f322b3a9ac8...4eb5359825ca6d7133d09a7fbf0360f51b72d876,1,3,3,6,3,2011-01-27 05:48:22,2011-01-27 05:48:22
4eb5359825ca6d7133d09a7fbf0360f51b72d876...dcb98b613dcba31a8f80ad0cbad894a623d75ae4,1,0,1,1,1,2011-01-27 19:56:28,2011-01-27 19:56:28
4eb5359825ca6d7133d09a7fbf0360f51b72d876...669b2f2dd36b11e17ae4ab21c2fdfec958ac72b9,1,2,2,4,1,2011-01-27 19:56:23,2011-01-27 00:26:45
ad0bc93a2901c0ddf5e6ad302cf55077cfed924b...3a22a0652f8f50393cb4143a7b1bbec3b491cde6,1,2,1,3,1,2011-01-27 22:00:51,2011-01-27 22:00:51
3a22a0652f8f50393cb4143a7b1bbec3b491cde6...fba003d1820b1d710186a718a412224a4f56b715,1,47,0,47,1,2011-01-27 22:23:10,2011-01-27 22:10:09
fba003d1820b1d710186a718a412224a4f56b715...6b94c09f48d4632158eff0018c4c8b4f687c3b5c,2,14,7,21,6,2011-01-28 07:42:13,2011-01-28 07:41:59
6b94c09f48d4632158eff0018c4c8b4f687c3b5c...aef67c542f2f27d3770db617c9d3c5231d2e233e,1,39,10,49,6,2011-01-28 15:50:08,2011-01-28 15:50:08
aef67c542f2f27d3770db617c9d3c5231d2e233e...2cf0b20831c79799a231e1d66416cba7b95fe928,3,55,10,65,4,2011-01-28 17:28:57,2011-01-28 17:28:57
2cf0b20831c79799a231e1d66416cba7b95fe928...7fa627b35627e94c94aafe9b0275de665129acd2,1,12,1,13,3,2011-01-28 17:43:40,2011-01-28 17:43:40
7fa627b35627e94c94aafe9b0275de665129acd2...fa9403f789af0afec82df8accd4177520729a1c9,1,11,6,17,3,2011-01-29 02:23:27,2011-01-29 02:23:27
fa9403f789af0afec82df8accd4177520729a1c9...a58c7c690dec4cd2f5a0ab877d5b3608e578e5e0,1,1,1,2,1,2011-01-29 02:26:27,2011-01-29 02:26:27
a58c7c690dec4cd2f5a0ab877d5b3608e578e5e0...1b68b2f53b9493425d9e524bbd81ea4ac0ae3524,2,3,3,6,3,2011-01-29 06:25:24,2011-01-29 06:25:24
1b68b2f53b9493425d9e524bbd81ea4ac0ae3524...ea4585664e368175c4ab19daaaca4e7a960d736d,1,4,2,6,2,2011-01-29 07:43:01,2011-01-29 07:43:01
ea4585664e368175c4ab19daaaca4e7a960d736d...f4c3936ebc081e69244892f472ef2670eed3f1d0,1,1,0,1,1,2011-01-29 08:17:59,2011-01-29 08:17:59
f4c3936ebc081e69244892f472ef2670eed3f1d0...55637a2881455cde1483c7f4d9fdf0ee36ea4328,1,2,2,4,2,2011-01-30 16:44:30,2011-01-30 16:44:30
55637a2881455cde1483c7f4d9fdf0ee36ea4328...a5afcff3247eee5baba8be0c7afd7051fc1f73dd,1,6,4,10,4,2011-01-31 05:12:04,2011-01-31 05:12:04
a5afcff3247eee5baba8be0c7afd7051fc1f73dd...6a7e659b02ad151ae15f081d63cc38cc60f1c5fc,1,1,1,2,1,2011-01-31 06:42:59,2011-01-31 06:42:59
6a7e659b02ad151ae15f081d63cc38cc60f1c5fc...9a6f2dcf91c2025f7549c875e78e4a203b26adcf,1,1,1,2,1,2011-01-31 07:05:45,2011-01-31 07:05:45
9a6f2dcf91c2025f7549c875e78e4a203b26adcf...6871c53e17728bec7e90353e0eacb91ba0cb1761,1,2,0,2,2,2011-01-31 16:28:00,2011-01-31 16:28:00
6871c53e17728bec7e90353e0eacb91ba0cb1761...57954be3a717fdab9246d0f7cd0b1068e1e715c7,1,13,2,15,2,2011-01-31 16:28:14,2011-01-31 16:28:14
57954be3a717fdab9246d0f7cd0b1068e1e715c7...8867e60e886d90d6cdb915f1a71e50a89f925dc7,2,23,10,33,5,2011-01-31 16:34:47,2011-01-31 16:23:25
8867e60e886d90d6cdb915f1a71e50a89f925dc7...5d157ac521fddd663d25751c1bb52d2109c29154,1,2,2,4,2,2011-01-31 18:37:42,2011-01-31 17:01:49
5d157ac521fddd663d25751c1bb52d2109c29154...a241bf7b69d34004a2238ad3108b19cd09f62a6a,1,2,2,4,2,2011-01-31 18:37:42,2011-01-31 18:37:27
a241bf7b69d34004a2238ad3108b19cd09f62a6a...e6396979996d107420aa13dbf65232482edb9abc,2,51,0,51,2,2011-01-31 19:37:38,2011-01-31 19:37:23
e6396979996d107420aa13dbf65232482edb9abc...af1b41984aa81f912aef251fa6c51074c283ef6e,1,2,2,4,2,2011-01-31 19:45:03,2011-01-31 19:45:03
af1b41984aa81f912aef251fa6c51074c283ef6e...24481f28759e359321f1d5eee5be33430afd82a6,1,3,3,6,2,2011-01-31 19:47:48,2011-01-31 19:47:48
24481f28759e359321f1d5eee5be33430afd82a6...59e153c5259e2ac20cf5ed449c31b379c572e0ae,1,4,1,5,2,2011-01-31 20:03:11,2011-01-31 20:03:11
59e153c5259e2ac20cf5ed449c31b379c572e0ae...6797df01a30ee2491a4be36a4528153fa863b521,1,6,2,8,4,2011-01-31 20:45:14,2011-01-31 20:45:14
6797df01a30ee2491a4be36a4528153fa863b521...01dd41df3fb54ec63d9dd8d2d08480d28e53cd5d,1,2,1,3,2,2011-01-31 20:46:42,2011-01-31 20:45:36
01dd41df3fb54ec63d9dd8d2d08480d28e53cd5d...1b73f3ef83dee41997f546176192895c8e9de289,1,1,1,2,1,2011-01-31 20:46:42,2011-01-31 20:45:52
1b73f3ef83dee41997f546176192895c8e9de289...d6ed8446bc403c41977383cb00974a2159062257,1,3,2,5,2,2011-01-31 21:06:08,2011-01-31 21:05:32
d6ed8446bc403c41977383cb00974a2159062257...4ee5edf02a9505ec543d7a45d14de507b50c3eda,1,1,1,2,2,2011-01-31 23:58:55,2011-01-31 23:57:42
4ee5edf02a9505ec543d7a45d14de507b50c3eda...79994b4325be51d01fe5d787ba1fc7bc5dd6f2ec,1,6,6,12,4,2011-01-31 23:58:55,2011-01-31 23:58:02
79994b4325be51d01fe5d787ba1fc7bc5dd6f2ec...1cc11c971bce05c6c41e267c582b887231a2ffca,1,2,2,4,2,2011-01-31 23:58:55,2011-01-31 23:58:25
1cc11c971bce05c6c41e267c582b887231a2ffca...c61ac1e2fd63b2a4f309d0d6f46d05fb36fb4743,1,1,0,1,1,2011-01-31 23:58:55,2011-01-31 23:58:37
c61ac1e2fd63b2a4f309d0d6f46d05fb36fb4743...c4c41d831e6b65f6e11f274cd65b149bc53c45aa,1,21,0,21,1,2011-02-01 01:35:47,2011-02-01 01:35:47
c4c41d831e6b65f6e11f274cd65b149bc53c45aa...15e5552dbbd58b858ae0ac4c786ba7e7e91a69cd,1,0,2,2,2,2011-02-01 01:42:24,2011-02-01 01:42:24
15e5552dbbd58b858ae0ac4c786ba7e7e91a69cd...41182e1adf963c0f4e01589f5aa64d217c5cae6c,1,1,1,2,1,2011-02-01 01:58:29,2011-02-01 01:58:29
41182e1adf963c0f4e01589f5aa64d217c5cae6c...da3c2d6e6a171beb3ac1ac75ba8805a1e65cdccd,2,2,2,4,2,2011-02-01 02:39:38,2011-02-01 02:39:38
da3c2d6e6a171beb3ac1ac75ba8805a1e65cdccd...8330ff07664b1bbc1a966e5d224520872fbb245a,2,9,5,14,4,2011-02-01 05:02:49,2011-02-01 05:02:49
8330ff07664b1bbc1a966e5d224520872fbb245a...693f98877f026c5a6e47986a13998b2984130e85,2,7,1,8,2,2011-02-01 06:08:57,2011-02-01 06:01:51
693f98877f026c5a6e47986a13998b2984130e85...0482bced01e315f5bb6de37af027ebc1b549ee89,2,5,5,10,4,2011-02-01 06:08:57,2011-02-01 06:02:07
0482bced01e315f5bb6de37af027ebc1b549ee89...ee7f6dd929f7c97dca70ae44b2183e90fdaa4147,1,1,1,2,1,2011-02-01 06:11:32,2011-02-01 06:11:32
ee7f6dd929f7c97dca70ae44b2183e90fdaa4147...4e678efc48b86b9de737a20238d50259b21ab476,1,15,0,15,1,2011-02-01 16:37:46,2011-02-01 16:37:46
4e678efc48b86b9de737a20238d50259b21ab476...d85cdcf1b5fcee70918cdd4d98ec72430347f305,1,7,1,8,3,2011-02-01 16:38:33,2011-02-01 16:38:33
d85cdcf1b5fcee70918cdd4d98ec72430347f305...35deed4a4984b59bb7a128d27fc7c17d341506d3,1,3,2,5,3,2011-02-01 17:00:40,2011-02-01 17:00:25
35deed4a4984b59bb7a128d27fc7c17d341506d3...2320f6211ad7db0bc0f98923472482bd01778844,1,2,2,4,2,2011-02-01 17:17:41,2011-02-01 17:17:41
2320f6211ad7db0bc0f98923472482bd01778844...aa7977f986a25f8e046c61fa2199ebcdb6bb77ad,1,2,0,2,1,2011-02-01 18:02:38,2011-02-01 18:02:11
aa7977f986a25f8e046c61fa2199ebcdb6bb77ad...841a56ba4caf9cfff8c456cf183c78d7c2a61ab5,1,4,0,4,2,2011-02-01 20:08:50,2011-02-01 20:08:50
841a56ba4caf9cfff8c456cf183c78d7c2a61ab5...54175da5173d758c960531649e2e18b755a2ad9a,1,158,150,308,12,2011-02-01 23:03:00,2011-02-01 23:03:00
54175da5173d758c960531649e2e18b755a2ad9a...3537518adf5b0a523467875615abf86e1f1b0804,1,8,6,14,2,2011-02-01 23:18:36,2011-02-01 23:18:01
3537518adf5b0a523467875615abf86e1f1b0804...76585f8f2e6b21b9066b61926c44300bd576dcf8,2,13,12,25,2,2011-02-02 06:00:38,2011-02-02 05:59:47
76585f8f2e6b21b9066b61926c44300bd576dcf8...a8b01fa52171de773633a63a8f48ed6168c8178f,1,9,1,10,1,2011-02-02 06:00:38,2011-02-02 06:00:03
a8b01fa52171de773633a63a8f48ed6168c8178f...6ecbaca69b10f377e8a6f7cccc84c137a3f0214f,2,6,2,8,3,2011-02-02 07:51:54,2011-02-02 06:39:13
6ecbaca69b10f377e8a6f7cccc84c137a3f0214f...b27afb18b85c4bce84ce069a9487b32bc98d5e93,1,1,0,1,1,2011-02-02 07:51:55,2011-02-02 07:51:37
b27afb18b85c4bce84ce069a9487b32bc98d5e93...9297201b7f10690812917a60bc6f283e67972625,1,3,0,3,1,2011-02-02 14:43:09,2011-02-02 14:43:09
9297201b7f10690812917a60bc6f283e67972625...1227dfe359d312389a7aaa4302f4be61e05444dc,2,40,5,45,11,2011-02-02 15:47:02,2011-02-02 15:47:02
1227dfe359d312389a7aaa4302f4be61e05444dc...9affe01fae20c095272e009dc338a6a8a201e219,1,54,0,54,2,2011-02-02 16:50:33,2011-02-02 16:50:33
9affe01fae20c095272e009dc338a6a8a201e219...6c202830de3292c6f1cb68bec70efcb05b12b568,1,14,0,14,1,2011-02-02 17:21:18,2011-02-02 17:21:18
6c202830de3292c6f1cb68bec70efcb05b12b568...4c26ae7633db58c0c5b89cc3bf6cbe9183838b12,1,2,5,7,3,2011-02-02 22:15:23,2011-02-02 22:15:23
4c26ae7633db58c0c5b89cc3bf6cbe9183838b12...38364885c5fb0e171b45ce82c3e9569c81204098,1,7,1,8,1,2011-02-03 16:23:27,2011-02-03 16:23:27
38364885c5fb0e171b45ce82c3e9569c81204098...c1835259d0c1d59d3f4b978bbbb9b318f5e6a8fc,1,1,0,1,1,2011-02-03 17:12:15,2011-02-03 17:12:15
c1835259d0c1d59d3f4b978bbbb9b318f5e6a8fc...41e665c98da1a54d931ee575b2b6113b5e2b4c67,2,145,0,145,2,2011-02-03 22:23:38,2011-02-03 22:23:38
41e665c98da1a54d931ee575b2b6113b5e2b4c67...e3760e478e96d3dc9f5311ed14d1c6deeead140e,2,9,2,11,7,2011-02-04 17:15:20,2011-02-04 17:15:20
e3760e478e96d3dc9f5311ed14d1c6deeead140e...7ea3b35626952771a236a1fc18f82837db427877,1,5,2,7,1,2011-02-04 17:38:02,2011-02-04 17:38:02
7ea3b35626952771a236a1fc18f82837db427877...879e5e1b0ad098cdd10add9fa6490a5b5c0ae583,7,143,20,163,33,2011-02-04 20:02:06,2011-02-04 20:02:06
879e5e1b0ad098cdd10add9fa6490a5b5c0ae583...ba308c26e7cef99830577c059aee7b0311c6f646,1,2,2,4,2,2011-02-04 20:03:37,2011-02-04 20:03:37
ba308c26e7cef99830577c059aee7b0311c6f646...61e35fa7496d07857b81884561812d79fe31354f,1,1,1,2,1,2011-02-04 20:06:06,2011-02-04 20:06:06
61e35fa7496d07857b81884561812d79fe31354f...0bade7bf8cff66c38fad9d30fc5533e872372149,2,7,0,7,3,2011-02-04 20:41:58,2011-02-04 20:41:58
0bade7bf8cff66c38fad9d30fc5533e872372149...bc89eaa5110b921616a1d98fb5b08864f9601454,1,51,51,102,6,2011-02-04 20:43:05,2011-02-04 20:43:05
bc89eaa5110b921616a1d98fb5b08864f9601454...bda02722891fac55cb69e8ad15133c11b7e82401,1,3,0,3,1,2011-02-04 20:45:05,2011-02-04 20:45:05
bda02722891fac55cb69e8ad15133c11b7e82401...7cc935306e35f9f61579972126431f633ac9835f,1,7,4,11,1,2011-02-04 21:02:14,2011-02-04 21:02:14
7cc935306e35f9f61579972126431f633ac9835f...e26ffc2bd58979eeb4f59194f7c429219ebfdd3e,1,8,4,12,3,2011-02-04 21:13:56,2011-02-04 21:13:56
e26ffc2bd58979eeb4f59194f7c429219ebfdd3e...11e614465fdde7dc81929b62823b2d3da22f87e4,1,1,1,2,1,2011-02-04 21:16:22,2011-02-04 21:16:22
11e614465fdde7dc81929b62823b2d3da22f87e4...d807a9ca0584e25fa695afa1a75656499053689b,1,10,3,13,2,2011-02-07 17:15:28,2011-02-07 17:15:28
11e614465fdde7dc81929b62823b2d3da22f87e4...f94110baedf5c14342767d32bc85157ac434aa75,1,1,1,2,1,2011-02-05 01:13:34,2011-02-05 01:13:34
f94110baedf5c14342767d32bc85157ac434aa75...adb1308bb89786bbe93099f1ecf04bed6c03a331,6,113,38,151,12,2011-02-05 02:02:48,2011-02-05 02:02:48
adb1308bb89786bbe93099f1ecf04bed6c03a331...58efac445a7b1c3f822f7ab219e245e8e916c92e,1,6,3,9,2,2011-02-05 04:51:17,2011-02-05 04:51:17
58efac445a7b1c3f822f7ab219e245e8e916c92e...4bee09a92063b273b54e77fc2930766caf4d79fc,1,17,23,40,6,2011-02-05 19:02:28,2011-02-05 19:02:28
4bee09a92063b273b54e77fc2930766caf4d79fc...c823d631683873855a79f99f3c5bc11c09c7e188,2,24,15,39,11,2011-02-05 19:17:48,2011-02-05 19:17:48
c823d631683873855a79f99f3c5bc11c09c7e188...a3f7217dd3e0f8cb264fd25727c42be7486bce64,1,50,11,61,6,2011-02-05 20:12:55,2011-02-05 20:12:55
a3f7217dd3e0f8cb264fd25727c42be7486bce64...3f56bafa08d8ca1b6b667157d50bb19fe96d28b8,1,1,1,2,1,2011-02-05 21:26:31,2011-02-05 21:26:31
3f56bafa08d8ca1b6b667157d50bb19fe96d28b8...e199733c787ab52b420516585ebf3440a1f821f0,1,10,3,13,2,2011-02-05 21:28:49,2011-02-05 21:28:49
e199733c787ab52b420516585ebf3440a1f821f0...3a1db008a7da4e2ce4edb117570c9dfea11d6d70,1,6,5,11,4,2011-02-05 21:40:27,2011-02-05 21:40:27
3a1db008a7da4e2ce4edb117570c9dfea11d6d70...567480430e62759dcc79303c3add8fb91f05c76a,2,31,0,31,2,2011-02-05 22:52:36,2011-02-05 05:41:55
567480430e62759dcc79303c3add8fb91f05c76a...5287de64fbc3bd412c84a23da7280b3c20853f21,3,41,19,60,17,2011-02-05 22:52:36,2011-02-05 20:46:13
5287de64fbc3bd412c84a23da7280b3c20853f21...f3c16066c68e4372b8d7f9565e5bc7ee82ef14e5,1,1,1,2,1,2011-02-05 22:52:36,2011-02-05 21:40:36
f3c16066c68e4372b8d7f9565e5bc7ee82ef14e5...2949494e2c245461f9a91b3e705aec966f0109ed,1,12,1,13,3,2011-02-05 22:52:36,2011-02-05 22:51:17
2949494e2c245461f9a91b3e705aec966f0109ed...471fd7da06644d80c906e2ac69190216791ef450,8,20,11,31,13,2011-02-05 22:52:36,2011-02-05 22:51:36
471fd7da06644d80c906e2ac69190216791ef450...ed2b128e5de0ddd2bf5303fda7980bd1d0b2c683,6,38,13,51,17,2011-02-05 22:52:37,2011-02-05 22:52:07
ed2b128e5de0ddd2bf5303fda7980bd1d0b2c683...c3125e18776014b3ed5f0a7b2c1fcdac3c952e8f,1,1,1,2,1,2011-02-05 22:56:14,2011-02-05 22:56:14
c3125e18776014b3ed5f0a7b2c1fcdac3c952e8f...cd834438e55086442b264dfc6cc9425d8a34f0bd,1,7,7,14,2,2011-02-06 03:44:06,2011-02-06 03:44:06
cd834438e55086442b264dfc6cc9425d8a34f0bd...cfd9c0e758a61f1b66de99a54fa965c2665bd845,2,34,4,38,6,2011-02-06 04:18:23,2011-02-06 04:18:23
cfd9c0e758a61f1b66de99a54fa965c2665bd845...71ef504e9d8e58cd791e970813d71bc0df2642fa,1,14,8,22,1,2011-02-06 16:44:25,2011-02-06 16:35:31
71ef504e9d8e58cd791e970813d71bc0df2642fa...221dddb522ca05c2b875590ad3c9188d9cb42ab6,1,12,11,23,3,2011-02-06 16:44:26,2011-02-06 16:44:10
221dddb522ca05c2b875590ad3c9188d9cb42ab6...b0834a3e4314353e6b4a9890343119d6810e8272,2,66,42,108,9,2011-02-07 04:01:19,2011-02-07 04:00:45
ba60f49b460f63ce0ca153d91439069b2d349c01...2173d54bd0440831c1378fd82ebb252abb7b01ce,1,34,34,68,7,2011-02-07 17:22:32,2011-02-07 17:22:32
2173d54bd0440831c1378fd82ebb252abb7b01ce...b5e5f8e87554cd131c9afbb141620f33bf37255d,1,4,2,6,1,2011-02-07 17:31:50,2011-02-07 17:31:50
b5e5f8e87554cd131c9afbb141620f33bf37255d...28c8e6f004e1a1e0e92f606727ebc890c9579d1f,1,6,1,7,1,2011-02-07 17:47:09,2011-02-07 17:47:09
28c8e6f004e1a1e0e92f606727ebc890c9579d1f...4209f5029f8526ff85204011e346a3817450be37,1,5,2,7,3,2011-02-07 17:55:20,2011-02-07 17:55:07
4209f5029f8526ff85204011e346a3817450be37...3b2c66e4841636ca9f1b162f8836d1e24c276321,1,4,0,4,2,2011-02-07 18:12:13,2011-02-07 18:12:13
3b2c66e4841636ca9f1b162f8836d1e24c276321...5aac53012075e9be9342213f218c268ae9e8be5b,3,11,2,13,3,2011-02-07 18:48:32,2011-02-07 18:48:32
5aac53012075e9be9342213f218c268ae9e8be5b...9af4bc9ed9063070f8e3e650ead0de3dbf3edf37,1,1,2,3,1,2011-02-07 21:04:25,2011-02-07 21:04:01
9af4bc9ed9063070f8e3e650ead0de3dbf3edf37...e0000924d4e5b1f6fd6af8c35ae3f29123d7bbde,1,1,1,2,1,2011-02-07 21:04:25,2011-02-07 21:04:07
e0000924d4e5b1f6fd6af8c35ae3f29123d7bbde...1ef1e7f2b8d89d98f0daf667d459a45e20e5582a,1,1,1,2,1,2011-02-07 21:42:35,2011-02-07 21:42:35
1ef1e7f2b8d89d98f0daf667d459a45e20e5582a...256e52081dd1cf0873aaf9f37d57892fa12d6082,1,1,1,2,1,2011-02-08 04:40:16,2011-02-08 04:40:16
256e52081dd1cf0873aaf9f37d57892fa12d6082...1f4ba96c5a1adc591708c9db6afeb555c0d1e4c5,1,21,7,28,2,2011-02-08 04:40:27,2011-02-08 04:40:27
1f4ba96c5a1adc591708c9db6afeb555c0d1e4c5...abf0bff628f922af74f3d7470cddf7889cd14403,3,3,3,6,3,2011-02-08 19:49:52,2011-02-08 19:49:52
abf0bff628f922af74f3d7470cddf7889cd14403...c8f4f74781968319c3802bdc38233e672c1d7920,2,4,2,6,2,2011-02-08 19:50:10,2011-02-08 19:50:10
c8f4f74781968319c3802bdc38233e672c1d7920...6d04d3a7c8972102fd210634837a21da04d8a81b,1,5,0,5,1,2011-02-08 21:53:48,2011-02-08 21:53:37
6d04d3a7c8972102fd210634837a21da04d8a81b...79485cc77cac4c2cc3b438fcbb3a0d835815ea63,2,2,2,4,2,2011-02-08 23:00:41,2011-02-08 23:00:41
79485cc77cac4c2cc3b438fcbb3a0d835815ea63...446bc312751cfa27a89fa419b7fc93991c418939,1,2,2,4,2,2011-02-09 02:24:09,2011-02-09 02:24:09
446bc312751cfa27a89fa419b7fc93991c418939...9f02a6260ee09bdc72d50c96a19cbaf9477ffb8e,1,18,1,19,2,2011-02-09 05:04:52,2011-02-09 05:02:42
9f02a6260ee09bdc72d50c96a19cbaf9477ffb8e...814ab3f61338b121a24e478955b2acedf9d1be21,1,5,3,8,1,2011-02-09 05:04:53,2011-02-09 05:03:04
814ab3f61338b121a24e478955b2acedf9d1be21...2194e18a93cf3ebaca4e74647be8467d3f7bdd20,1,3,0,3,1,2011-02-09 05:54:01,2011-02-09 05:53:30
2194e18a93cf3ebaca4e74647be8467d3f7bdd20...3c3119593977ae7d8f72a47c630e62d6f6fba154,1,1,1,2,1,2011-02-09 05:56:21,2011-02-09 05:07:36
3c3119593977ae7d8f72a47c630e62d6f6fba154...44f73de7e02d1c8ac39cf0e4a977434279242b20,1,7,1,8,2,2011-02-09 05:56:21,2011-02-09 05:07:49
44f73de7e02d1c8ac39cf0e4a977434279242b20...56a3e524e38eb3ad6176dfbb8d713857c88e41a6,1,2,4,6,1,2011-02-09 05:56:21,2011-02-09 05:56:12
56a3e524e38eb3ad6176dfbb8d713857c88e41a6...ab45f42f14be3c6934edd4cbb1a857e9ee209adf,1,1,1,2,1,2011-02-09 07:21:16,2011-02-09 07:21:16
ab45f42f14be3c6934edd4cbb1a857e9ee209adf...950da41582217ef4a815fe45af1a8510cd0037f5,1,1,1,2,1,2011-02-09 18:07:58,2011-02-09 15:32:38
950da41582217ef4a815fe45af1a8510cd0037f5...d6bcf91f2f504298e8149c9b5523a79561ede075,1,3,0,3,3,2011-02-09 18:08:00,2011-02-09 16:34:20
d6bcf91f2f504298e8149c9b5523a79561ede075...9ab78514ea2cd3f22c4cfa1fce0f30ec6345665b,2,12,1,13,2,2011-02-09 18:35:34,2011-02-09 18:35:34
9ab78514ea2cd3f22c4cfa1fce0f30ec6345665b...2b1c61b92ab2e9b7d4da1c1c9f2e1e23ab8034a1,1,3,0,3,3,2011-02-09 18:43:19,2011-02-09 18:43:19
2b1c61b92ab2e9b7d4da1c1c9f2e1e23ab8034a1...6a6e4d571d0bcaaaf88f8202d3c3cff37683161e,1,0,3,3,3,2011-02-09 21:08:09,2011-02-09 21:08:09
6a6e4d571d0bcaaaf88f8202d3c3cff37683161e...f6f3cf1bf631a9632a543f8996dc0e2e5fa50c57,1,7,0,7,2,2011-02-09 21:15:47,2011-02-09 21:15:47
f6f3cf1bf631a9632a543f8996dc0e2e5fa50c57...57b5ede3616c3704c1aa9c365b9eff2277e7159c,1,1,1,2,1,2011-02-09 21:57:10,2011-02-09 21:56:43
57b5ede3616c3704c1aa9c365b9eff2277e7159c...e0c8d9a6fc6bc5a23873b45a1f8c9d52163e79d7,1,1,1,2,1,2011-02-10 04:03:03,2011-02-10 04:01:02
e0c8d9a6fc6bc5a23873b45a1f8c9d52163e79d7...37b11e4dde95b6f93032448d48d0190045aebe54,7,37,4,41,16,2011-02-10 04:03:03,2011-02-10 04:02:05
37b11e4dde95b6f93032448d48d0190045aebe54...3174e3fc0d41a965a6438b126c512e9245fb315d,1,1,1,2,1,2011-02-10 04:16:57,2011-02-10 04:16:57
3174e3fc0d41a965a6438b126c512e9245fb315d...922f614d0f1a2768d76eca78f4ec8fa6f6e7da4d,1,4,4,8,4,2011-02-10 05:56:53,2011-02-10 05:56:53
922f614d0f1a2768d76eca78f4ec8fa6f6e7da4d...bca3cdef99ec0ef0f5cec98be5beb158e960d53a,1,2,0,2,1,2011-02-10 05:57:46,2011-02-10 05:57:46
bca3cdef99ec0ef0f5cec98be5beb158e960d53a...9fbb64caf399b097eba973d263c1c480d7893e16,1,1,1,2,1,2011-02-10 06:47:09,2011-02-10 06:47:09
9fbb64caf399b097eba973d263c1c480d7893e16...621b4f0338164a33fe5a3452ffd4060a3a5ebd9b,1,1,0,1,1,2011-02-10 15:00:31,2011-02-10 15:00:31
621b4f0338164a33fe5a3452ffd4060a3a5ebd9b...6fccb3bca4619f23002ad6ab3a382fdc992a01f1,2,6,3,9,3,2011-02-10 16:47:13,2011-02-10 16:47:13
6fccb3bca4619f23002ad6ab3a382fdc992a01f1...1041ffd623cfa2d2ad6b5dc0fad16eda54924905,1,3,0,3,1,2011-02-10 20:33:30,2011-02-10 20:33:30
1041ffd623cfa2d2ad6b5dc0fad16eda54924905...9b5be3e8838040cbcdf8cc5f59d435624867e148,1,3,0,3,1,2011-02-10 20:48:23,2011-02-10 20:48:23
9b5be3e8838040cbcdf8cc5f59d435624867e148...3d8ca912a03cb6e6a0ebc431ac72c3b89e87b7be,2,5,2,7,3,2011-02-10 20:49:47,2011-02-10 20:46:34
3d8ca912a03cb6e6a0ebc431ac72c3b89e87b7be...288db3e311ba70d29ced43ef1b68a657c18f66e2,1,2,2,4,2,2011-02-11 15:58:52,2011-02-10 19:18:31
288db3e311ba70d29ced43ef1b68a657c18f66e2...397db56b40438056b2c309cd94586642ef4d9e87,1,3,1,4,1,2011-02-11 16:19:38,2011-02-11 16:19:38
397db56b40438056b2c309cd94586642ef4d9e87...3094a42860a24442973fc941c962fe3ab070b0a8,1,3,0,3,1,2011-02-11 23:39:50,2011-02-11 23:39:50
3094a42860a24442973fc941c962fe3ab070b0a8...4e77ed67712b699c588861377e47af81f1b9af9c,1,3,0,3,3,2011-02-12 00:27:08,2011-02-12 00:27:08
4e77ed67712b699c588861377e47af81f1b9af9c...0196f0159e6ef5aab44429ba28c832228d543932,1,1,2,3,2,2011-02-12 05:41:26,2011-02-12 05:41:26
0196f0159e6ef5aab44429ba28c832228d543932...f4f7ceccf88c7653fd8173cae666200b64a07e36,3,23,15,38,8,2011-02-12 19:48:20,2011-02-12 19:48:20
f4f7ceccf88c7653fd8173cae666200b64a07e36...64e39098c4eab5502bd993a37e75262f015f1a2c,5,113,34,147,32,2011-02-12 19:48:35,2011-02-12 19:48:35
64e39098c4eab5502bd993a37e75262f015f1a2c...8b0bbc584eeed9c34cac95134e6ef4ff2d62ce83,1,1,1,2,1,2011-02-12 19:54:07,2011-02-12 19:54:07
8b0bbc584eeed9c34cac95134e6ef4ff2d62ce83...b1a9d70ed7846c41e01403a8e67f79e79f5ef786,1,2,2,4,1,2011-02-12 19:54:14,2011-02-12 19:54:14
b1a9d70ed7846c41e01403a8e67f79e79f5ef786...ca198bc64f0b841118a0fc911ff714cc0bfb0a32,1,3,0,3,1,2011-02-12 22:39:44,2011-02-12 22:39:44
ca198bc64f0b841118a0fc911ff714cc0bfb0a32...f31d82cad9b20b8cde9bb9d5cccb3ba0803c14e0,2,9,1,10,3,2011-02-13 15:07:13,2011-02-13 15:07:13
f31d82cad9b20b8cde9bb9d5cccb3ba0803c14e0...e6a68871ece9a3d7eb3aa0afdc5a884d27869f2c,1,3,0,3,1,2011-02-13 15:08:37,2011-02-13 15:08:37
e6a68871ece9a3d7eb3aa0afdc5a884d27869f2c...cfd8af10a2d9316456cedf704dfad5bf3409a545,1,6,6,12,5,2011-02-13 15:09:10,2011-02-13 15:09:10
cfd8af10a2d9316456cedf704dfad5bf3409a545...0f95fb49c4a80278dbd7907c46d7e9004b4b0dd3,1,6,1,7,2,2011-02-13 15:10:00,2011-02-13 15:10:00
0f95fb49c4a80278dbd7907c46d7e9004b4b0dd3...66e90c6185f7c33871042581c4f9328cb14b75bb,1,3,0,3,1,2011-02-13 15:12:28,2011-02-13 15:12:28
66e90c6185f7c33871042581c4f9328cb14b75bb...71545122e77485b74d8371446b52c77b1ec5dab2,1,3,1,4,2,2011-02-13 18:33:43,2011-02-13 18:33:43
71545122e77485b74d8371446b52c77b1ec5dab2...7a4399841f24ba171156e63bffc5f1e1b4bcc9d2,4,6,3,9,4,2011-02-13 21:04:06,2011-02-13 21:04:06
7a4399841f24ba171156e63bffc5f1e1b4bcc9d2...ed360a84f92d3c234ca9a4c2256de95be5562abe,1,1,1,2,1,2011-02-13 23:08:12,2011-02-13 23:08:12
ed360a84f92d3c234ca9a4c2256de95be5562abe...7e5a60ba66225d261463cf1c7151acf5cb3331ba,1,17,3,20,4,2011-02-14 00:13:21,2011-02-14 00:12:54
7e5a60ba66225d261463cf1c7151acf5cb3331ba...24f9d634964346c2d04f0e15c6f53c682839be80,1,1,0,1,1,2011-02-14 04:28:53,2011-02-14 04:28:53
24f9d634964346c2d04f0e15c6f53c682839be80...763c49f692fe343cac1f841c7037b728b0ccfd05,1,6,4,10,5,2011-02-14 04:29:11,2011-02-14 04:29:11
763c49f692fe343cac1f841c7037b728b0ccfd05...1e5d77f29792f82026df86b3a96323b66aac00c0,4,9,3,12,4,2011-02-14 16:14:03,2011-02-14 16:14:03
1e5d77f29792f82026df86b3a96323b66aac00c0...6dee6f9498d0f5d2d5a5eac8e92fb9ff62124105,1,24,5,29,12,2011-02-14 17:39:53,2011-02-14 17:39:53
1e5d77f29792f82026df86b3a96323b66aac00c0...91c51c6507562fbbccea49120e0845d4ef1a15f8,1,1,1,2,1,2011-02-14 17:32:23,2011-02-14 17:32:23
91c51c6507562fbbccea49120e0845d4ef1a15f8...a969a0168cdb23c8cfa0fbcb26a92d0cabebf411,3,59,22,81,7,2011-02-14 19:13:19,2011-02-14 19:13:06
36f405d6a76d3940e0d589038edc5a2bd2a76c00...3f1c76f47a18e4d99d658189aef3dfb058f077a6,3,26,17,43,9,2011-02-14 19:16:18,2011-02-14 19:16:18
3f1c76f47a18e4d99d658189aef3dfb058f077a6...8b690e338760c1ae5945218c05f0970abb02dc90,1,4,0,4,2,2011-02-14 20:27:44,2011-02-14 20:27:44
8b690e338760c1ae5945218c05f0970abb02dc90...8ed7eabacb742383c4b8c2fc4de7c4795663676c,1,1,0,1,1,2011-02-14 21:21:04,2011-02-14 21:21:04
8ed7eabacb742383c4b8c2fc4de7c4795663676c...ac86cdec4778b37f2b58e78c3f759da75c737df0,1,20,15,35,12,2011-02-14 21:21:36,2011-02-14 21:18:52
ac86cdec4778b37f2b58e78c3f759da75c737df0...4c9f3922d364c3bcb37455fcbd7812f39d1d8204,1,1,1,2,1,2011-02-14 21:21:36,2011-02-14 21:20:56
4c9f3922d364c3bcb37455fcbd7812f39d1d8204...5909aa6962bebe24f7cd65b924053a5cf70b83d3,1,22,7,29,7,2011-02-14 21:21:36,2011-02-14 21:21:12
5909aa6962bebe24f7cd65b924053a5cf70b83d3...2c59a42acf6116ee58d17b5f086de8993620845c,2,2,2,4,2,2011-02-15 06:53:14,2011-02-15 06:53:14
2c59a42acf6116ee58d17b5f086de8993620845c...277ff8dbf010839f0345dd395e255dda1961e86e,1,9,2,11,1,2011-02-15 17:50:51,2011-02-15 17:50:51
277ff8dbf010839f0345dd395e255dda1961e86e...f7692fea1a67431061e1230acb15c7537c6e2900,1,3,1,4,1,2011-02-15 20:04:10,2011-02-12 21:39:52
f7692fea1a67431061e1230acb15c7537c6e2900...9bd9f144b33253773973f3253684d7c627492f0d,7,207,39,246,17,2011-02-15 20:04:12,2011-02-15 20:03:56
9bd9f144b33253773973f3253684d7c627492f0d...c6b434de1b74af3cbc10252f02719f14283fcf40,1,1,2,3,2,2011-02-15 20:22:41,2011-02-15 20:22:41
c6b434de1b74af3cbc10252f02719f14283fcf40...7783418dcde7a9cf9dcf0362c7284232f1a4f157,1,6,3,9,2,2011-02-15 20:31:44,2011-02-15 20:31:44
7783418dcde7a9cf9dcf0362c7284232f1a4f157...5ede773a23c061b2805ad69d9abf8e6ce08f9700,2,10,10,20,8,2011-02-16 01:26:15,2011-02-16 01:26:15
5ede773a23c061b2805ad69d9abf8e6ce08f9700...e1636f4e771d164822d10ded32cf581bddf9ccac,1,1,0,1,1,2011-02-16 01:27:19,2011-02-16 01:27:19
e1636f4e771d164822d10ded32cf581bddf9ccac...79b45181243a69b42beb936e067f9a06a8260c4b,1,18,0,18,1,2011-02-16 19:26:24,2011-02-16 19:26:24
79b45181243a69b42beb936e067f9a06a8260c4b...eae007bd5709f0e4e4d49fe345f0dad442320348,1,3,3,6,1,2011-02-16 19:40:25,2011-02-16 17:23:44
eae007bd5709f0e4e4d49fe345f0dad442320348...d5927efbbd45bd33a8ac6dbd0874f2dc900eb542,1,2,2,4,2,2011-02-16 19:40:25,2011-02-16 17:25:50
d5927efbbd45bd33a8ac6dbd0874f2dc900eb542...e690bfef3ca96c156db17e9be6580daa8118e9a9,2,4,2,6,4,2011-02-16 19:40:25,2011-02-16 19:40:18
e690bfef3ca96c156db17e9be6580daa8118e9a9...a4153eb6edcf3975afed2f33f7595fee2dd6a71b,3,65,2,67,5,2011-02-16 20:51:25,2011-02-16 20:51:25
a4153eb6edcf3975afed2f33f7595fee2dd6a71b...cf275ec820b9d40e872d32f569794f7eb13a680a,1,4,0,4,1,2011-02-16 22:23:16,2011-02-16 22:23:16
cf275ec820b9d40e872d32f569794f7eb13a680a...3a5cfc0a371d4983cceb4e50c06cbc07356d551a,1,1,1,2,1,2011-02-16 22:54:23,2011-02-16 22:53:15
3a5cfc0a371d4983cceb4e50c06cbc07356d551a...02eafcd82f8079727a14893c2d80d0ecf1b1f174,1,14,3,17,4,2011-02-16 23:50:09,2011-02-15 08:02:45
02eafcd82f8079727a14893c2d80d0ecf1b1f174...c77e4c8ee9f7696bfa5fc0da9b6c10284c2805a5,3,50,8,58,7,2011-02-17 06:10:50,2011-02-17 06:10:50
c77e4c8ee9f7696bfa5fc0da9b6c10284c2805a5...7792243481dbb8ee2cebb361fb3d4c7672b74f11,1,28,28,56,4,2011-02-17 06:11:22,2011-02-17 06:11:22
7792243481dbb8ee2cebb361fb3d4c7672b74f11...07dfc029c76df4e1324897544818cbdb8c765323,1,1,1,2,1,2011-02-17 15:14:09,2011-02-17 15:14:09
07dfc029c76df4e1324897544818cbdb8c765323...77f2a06c6d28fc96e8f5548a093c1afa3df19ea2,1,6,0,6,1,2011-02-17 16:03:50,2011-02-17 16:03:50
77f2a06c6d28fc96e8f5548a093c1afa3df19ea2...f7c8abd417edbad9331a90881b4e79374920db15,1,11,1,12,2,2011-02-17 16:04:51,2011-02-17 16:04:51
f7c8abd417edbad9331a90881b4e79374920db15...abbff52dbda3f7679bb86ce54c8899e953507da4,1,2,2,4,2,2011-02-17 21:35:49,2011-02-17 21:35:38
abbff52dbda3f7679bb86ce54c8899e953507da4...8d4850ae65b5ca314a540090bd94714cf327b71b,1,19,10,29,8,2011-02-18 00:59:33,2011-02-18 00:59:33
8d4850ae65b5ca314a540090bd94714cf327b71b...cd5a958c31b64de198f3289e5c3c734ba4f33ac5,2,7,2,9,2,2011-02-18 04:59:15,2011-02-18 04:59:15
cd5a958c31b64de198f3289e5c3c734ba4f33ac5...b2ad6e76575881b75299acb71620f269a4105e5b,1,9,1,10,1,2011-02-18 06:56:48,2011-02-18 06:56:48
b2ad6e76575881b75299acb71620f269a4105e5b...95694121cc34fc0f2d144ceb9f6f5e6b05ed0d8e,2,18,4,22,2,2011-02-18 15:16:47,2011-02-18 15:16:36
95694121cc34fc0f2d144ceb9f6f5e6b05ed0d8e...51b77743b10f45570aac539309fc4986dc2002de,1,7,2,9,3,2011-02-18 15:49:31,2011-02-18 15:49:31
51b77743b10f45570aac539309fc4986dc2002de...d7d4e35459f0fa9107f1ed0f1630551859b12956,1,1,1,2,1,2011-02-18 16:36:32,2011-02-18 16:36:32
d7d4e35459f0fa9107f1ed0f1630551859b12956...a9e3511eda147d42f79203ad6e181e789c632c49,1,1,1,2,1,2011-02-18 21:38:51,2011-02-18 21:38:51
a9e3511eda147d42f79203ad6e181e789c632c49...dcd5c777b7baa2c12636272372a8a1de669ad7c6,1,2,0,2,1,2011-02-18 21:45:34,2011-02-18 21:45:09
dcd5c777b7baa2c12636272372a8a1de669ad7c6...9e73768cebcf84ac89ca91d57bc731612ee286ff,1,43,43,86,4,2011-02-19 01:59:59,2011-02-19 01:59:59
9e73768cebcf84ac89ca91d57bc731612ee286ff...7e13092c2f41ce844c3671cd39cf96afd8e62a90,1,3,0,3,1,2011-02-19 02:04:21,2011-02-19 02:04:21
7e13092c2f41ce844c3671cd39cf96afd8e62a90...af363697167c103374d7534b1af4b92f6eb3270c,4,52,6,58,9,2011-02-21 15:48:28,2011-02-21 15:48:28
af363697167c103374d7534b1af4b92f6eb3270c...62b843a58874f2e77253dc8c4a1fe674b7258360,1,1,1,2,1,2011-02-21 16:14:01,2011-02-21 16:14:01
62b843a58874f2e77253dc8c4a1fe674b7258360...badd41ef11213d3e1b27bcad262ccc69d89bd155,1,62,62,124,5,2011-02-21 16:19:58,2011-02-21 16:19:58
badd41ef11213d3e1b27bcad262ccc69d89bd155...50ed53d2bcbe39cb38e2fc758765ee6ebecfa3cd,1,1,1,2,1,2011-02-22 19:23:07,2011-02-22 19:23:07
badd41ef11213d3e1b27bcad262ccc69d89bd155...b138f371920a426137d0f964be6761d6523dba8b,1,2,2,4,2,2011-02-22 00:09:54,2011-02-22 00:09:54
b138f371920a426137d0f964be6761d6523dba8b...109c7101f5e36b9c0c4e2d13e5692beda504f22a,1,5,2,7,3,2011-02-22 16:29:49,2011-02-22 16:01:18
109c7101f5e36b9c0c4e2d13e5692beda504f22a...c2e985fdd6545c65de582fafeff4f070b6b5dec3,1,1,1,2,1,2011-02-22 16:29:49,2011-02-22 16:01:27
c2e985fdd6545c65de582fafeff4f070b6b5dec3...2c6e26690a5d9ee616ec953d1b75df47b1e388e1,1,3,1,4,3,2011-02-22 16:29:49,2011-02-22 16:29:34
2c6e26690a5d9ee616ec953d1b75df47b1e388e1...65a7e81df0747b6bc9380b78e0182192bacdb4d0,4,9,3,12,4,2011-02-22 20:28:02,2011-02-22 20:28:02
65a7e81df0747b6bc9380b78e0182192bacdb4d0...f6074c802493c6bb832aa660f9efd36d062a62b7,1,10,4,14,5,2011-02-25 20:00:51,2011-02-25 18:50:24
f6074c802493c6bb832aa660f9efd36d062a62b7...d38d0f8f5714fa08f0609b461ceeabda2bf60860,1,9,8,17,2,2011-02-27 18:38:51,2011-02-27 18:35:12
d38d0f8f5714fa08f0609b461ceeabda2bf60860...f6734a47841cfc842158b59b696a33e1574da174,2,2,2,4,2,2011-03-01 01:59:08,2011-03-01 01:59:08
f6734a47841cfc842158b59b696a33e1574da174...ed6273ba49319928e3c241c4dec33c3195e612f4,1,1,1,2,1,2011-03-01 15:51:48,2011-03-01 15:50:39
ed6273ba49319928e3c241c4dec33c3195e612f4...bd4605194760d9cb3c8f0f284c7346712deb86e0,1,7,6,13,3,2011-03-01 15:51:56,2011-03-01 13:05:51
bd4605194760d9cb3c8f0f284c7346712deb86e0...b2963ff3b293dc5eaf9acaf6de5b4fc835beb6b2,1,1,1,2,1,2011-03-01 15:57:02,2011-02-27 16:15:20
b2963ff3b293dc5eaf9acaf6de5b4fc835beb6b2...09ed6d9098b991ee36ea3cb3ee5232f3e50b84ab,1,6,0,6,1,2011-03-01 15:57:08,2011-02-28 20:15:45
09ed6d9098b991ee36ea3cb3ee5232f3e50b84ab...d328f5b1a5bcc021ccf8c2c96acab0e2eca0aeb6,1,13,11,24,2,2011-03-01 15:57:14,2011-02-28 20:26:17
d328f5b1a5bcc021ccf8c2c96acab0e2eca0aeb6...22596b3c06db48660dd3eec96ca833ab584136ad,1,1,0,1,1,2011-03-01 15:57:20,2011-02-28 20:30:51
22596b3c06db48660dd3eec96ca833ab584136ad...caaff8dfbeb2270079f5609002aa8e31020e47ef,1,5,0,5,1,2011-03-01 15:57:27,2011-02-28 21:55:38
caaff8dfbeb2270079f5609002aa8e31020e47ef...83282b72fab32cabeb160ec03c56d63f297b905e,1,1,1,2,1,2011-03-01 18:21:22,2011-03-01 18:06:03
83282b72fab32cabeb160ec03c56d63f297b905e...13608bb28320625c31c49f2cae9489874c4f295b,2,35,11,46,5,2011-03-01 18:21:26,2011-03-01 18:20:54
13608bb28320625c31c49f2cae9489874c4f295b...a0b0d4eb70f96fe91a69ae290ce21cc8facfb699,1,2,2,4,2,2011-03-01 18:31:22,2011-02-28 07:00:12
a0b0d4eb70f96fe91a69ae290ce21cc8facfb699...ad4abbc55ba8a29d4227f74299b8f398cf835b6e,1,2,0,2,1,2011-03-01 18:32:39,2011-02-28 23:40:02
ad4abbc55ba8a29d4227f74299b8f398cf835b6e...af4f0597fd0f7738b8e4923abc804567826b0c2e,3,18,2,20,5,2011-03-01 20:56:24,2011-03-01 20:07:56
af4f0597fd0f7738b8e4923abc804567826b0c2e...b47f248e0ff6fad579fd3ca6fda5f718c34c0afa,4,9,3,12,4,2011-03-01 20:58:08,2011-03-01 20:58:08
b47f248e0ff6fad579fd3ca6fda5f718c34c0afa...162418c1ddf548b8dea32febe4a0a2978aec46dd,1,1,1,2,1,2011-03-02 04:48:10,2011-03-01 21:28:44
162418c1ddf548b8dea32febe4a0a2978aec46dd...28267f679234a4aad64c3a417380abf0a7527d42,4,5,6,11,7,2011-03-02 04:48:22,2011-03-01 23:02:38
28267f679234a4aad64c3a417380abf0a7527d42...e5839f0a76b8ecd2687144db2e6d6a4ebf5acc93,2,7,5,12,3,2011-03-02 04:48:38,2011-03-02 02:08:44
e5839f0a76b8ecd2687144db2e6d6a4ebf5acc93...dc65bd51ae83bc90711a9ef83ac9bb606dc43d22,1,1,1,2,1,2011-03-02 04:59:43,2011-03-02 04:58:58
dc65bd51ae83bc90711a9ef83ac9bb606dc43d22...85bff78d00bbfdaee7bed511ba5d9e0ebcb5e965,3,5,0,5,3,2011-03-02 06:28:51,2011-03-02 05:46:22
85bff78d00bbfdaee7bed511ba5d9e0ebcb5e965...72f754439a68d8a6882fbfdb9ee709ad3072480d,2,2,2,4,2,2011-03-02 06:28:57,2011-03-02 06:28:17
72f754439a68d8a6882fbfdb9ee709ad3072480d...00bee150132340e5bf95e0f1d7d90a098fb256d7,1,9,9,18,2,2011-03-02 15:30:58,2011-03-02 15:29:24
00bee150132340e5bf95e0f1d7d90a098fb256d7...081b046b720b5bd28d0598b077e9cd5bef5ad25b,1,2,5,7,2,2011-03-02 15:59:04,2011-03-02 15:58:12
081b046b720b5bd28d0598b077e9cd5bef5ad25b...bbf18b270c52fe575b224ad5f62336b410f9b623,1,6,8,14,4,2011-03-03 17:21:23,2011-03-03 17:20:49
bbf18b270c52fe575b224ad5f62336b410f9b623...f53b65645fe61b75120b1daba2d070d69071b553,1,3,0,3,1,2011-03-04 02:56:38,2011-03-03 07:39:12
f53b65645fe61b75120b1daba2d070d69071b553...b1eb83e61c6358cc9144757f4e9c364cd9c6d1bf,1,3,1,4,2,2011-03-04 02:56:42,2011-03-03 08:12:55
b1eb83e61c6358cc9144757f4e9c364cd9c6d1bf...87dd5720e48e875487d5fbd78cbe120d5a610973,1,1,1,2,1,2011-03-04 02:56:55,2011-03-04 00:29:25
87dd5720e48e875487d5fbd78cbe120d5a610973...e0e5a4061ddf3eb6a212ca8af024241ff1b0edd9,2,2,2,4,2,2011-03-04 21:16:19,2011-03-04 21:16:19
e0e5a4061ddf3eb6a212ca8af024241ff1b0edd9...e3b4054f660b26c4afe375098a96a008decd29c9,1,5,5,10,2,2011-03-04 21:16:47,2011-03-04 18:21:17
e3b4054f660b26c4afe375098a96a008decd29c9...9f47ba6ca4be508d768e37c0ab9f3a1c5e114856,1,2,2,4,1,2011-03-04 21:16:51,2011-03-04 21:15:05
9f47ba6ca4be508d768e37c0ab9f3a1c5e114856...fe13a93925403e44b4a0c3cb08e3e032773dbcb8,1,5,1,6,2,2011-03-04 22:23:20,2011-03-04 22:22:20
fe13a93925403e44b4a0c3cb08e3e032773dbcb8...66af39a8b3a5c197c291dd36b6b80ae6825267ba,1,1,1,2,1,2011-03-05 21:24:57,2011-03-04 17:36:45
66af39a8b3a5c197c291dd36b6b80ae6825267ba...fa09f824edaf225e34fe8ecd82979d8ae5782474,1,2,2,4,2,2011-03-06 02:10:19,2011-03-05 23:25:48
fa09f824edaf225e34fe8ecd82979d8ae5782474...d2749d18eea3d6a2577b1d6c9a4fed3f45254163,2,13,1,14,4,2011-03-06 02:10:26,2011-03-05 23:11:04
d2749d18eea3d6a2577b1d6c9a4fed3f45254163...e521301d18cddf2765a8a392d1ecaccf7e726e20,1,46,33,79,7,2011-03-07 01:18:32,2011-03-06 07:51:18
e521301d18cddf2765a8a392d1ecaccf7e726e20...c3c2a3d41d3a8270bcbb18a249c4681d12037f99,1,3,0,3,1,2011-03-07 01:18:45,2011-03-06 20:26:14
c3c2a3d41d3a8270bcbb18a249c4681d12037f99...9d1f1a1fe3b059d4037dedda98c0c78ce78d37bf,1,103,58,161,16,2011-03-07 01:18:53,2011-03-06 22:04:50
9d1f1a1fe3b059d4037dedda98c0c78ce78d37bf...4d75f1be77ce659ec7b4128fdafb8c8cdc9bf10d,2,9,1,10,3,2011-03-07 01:21:08,2011-03-03 15:15:10
4d75f1be77ce659ec7b4128fdafb8c8cdc9bf10d...7a20ea7d74ce6eb6eb8305d1bdff959eed3385ce,1,3,1,4,1,2011-03-07 13:16:06,2011-03-07 13:15:18
7a20ea7d74ce6eb6eb8305d1bdff959eed3385ce...eb3d063c956539506bc830b64abee0f04b1e03d4,1,2,0,2,2,2011-03-07 15:36:00,2011-03-07 15:35:33
eb3d063c956539506bc830b64abee0f04b1e03d4...e451c5699ded5a07fda30a45ad47c50927491760,1,0,2,2,2,2011-03-07 17:06:25,2011-03-07 17:06:25
e451c5699ded5a07fda30a45ad47c50927491760...3754755c30ad83c679e7a82bd2afbd3299c4ca26,1,9,16,25,3,2011-03-07 17:18:40,2011-02-25 00:07:19
3754755c30ad83c679e7a82bd2afbd3299c4ca26...a14508a41e4294931b0fde802973b94f2b13bf56,2,7,4,11,7,2011-03-07 17:18:43,2011-03-07 17:09:23
a14508a41e4294931b0fde802973b94f2b13bf56...5d5b9dc17eca31b69f055f93f6a9c490baf6efc5,1,3,5,8,3,2011-03-07 17:18:57,2011-03-07 17:09:41
5d5b9dc17eca31b69f055f93f6a9c490baf6efc5...085553d8dde1f90ca82d1ef54bb325d6fcaabca5,1,1,1,2,1,2011-03-07 17:56:39,2011-03-07 17:19:01
085553d8dde1f90ca82d1ef54bb325d6fcaabca5...ec9dbe2b515440a581bcca1b1d9777541f4543ee,2,16,0,16,2,2011-03-08 19:12:44,2011-03-08 18:45:58
ec9dbe2b515440a581bcca1b1d9777541f4543ee...43f5f6f9bcd642b3f6099e2032e276fe2caa2dec,1,3,2,5,2,2011-03-08 19:12:48,2011-03-08 19:12:18
43f5f6f9bcd642b3f6099e2032e276fe2caa2dec...b28116bafe07a59ef030162c4da90ef4e754f8fd,1,1,1,2,1,2011-03-08 21:22:12,2011-03-08 21:21:56
b28116bafe07a59ef030162c4da90ef4e754f8fd...2bc1b84422be1053b984d05d61869781284ae486,2,11,1,12,4,2011-03-09 07:46:41,2011-03-09 07:34:28
2bc1b84422be1053b984d05d61869781284ae486...3bc93cc5dcdd511739bc729b8b77927b2f4b9429,1,5,5,10,2,2011-03-09 15:23:51,2011-03-09 15:22:53
3bc93cc5dcdd511739bc729b8b77927b2f4b9429...0e97d8b44b8bd2e9f4983a11338793d2f82a7faf,1,6,2,8,3,2011-03-09 16:14:12,2011-03-08 20:03:34
0e97d8b44b8bd2e9f4983a11338793d2f82a7faf...b3a113564fd8a9984a6030bd0220c5ac43f52403,2,2,2,4,2,2011-03-09 18:30:16,2011-03-09 18:30:16
b3a113564fd8a9984a6030bd0220c5ac43f52403...b2927d98603a48f4437dd39116e78bf023b4ee8c,1,1,1,2,1,2011-03-09 20:27:13,2011-03-09 20:16:38
b2927d98603a48f4437dd39116e78bf023b4ee8c...460d32f86ba837a4f1dd41cfeb65eddee41df65f,2,2,1,3,3,2011-03-09 22:21:11,2011-03-09 22:20:02
460d32f86ba837a4f1dd41cfeb65eddee41df65f...257b016504a76b586ebb9bec94e377b502761e08,2,2,2,4,2,2011-03-10 03:29:44,2011-03-10 03:29:44
257b016504a76b586ebb9bec94e377b502761e08...d83d060854bdcc966461d6d08a97889f5c07d511,1,2,0,2,1,2011-03-11 21:54:51,2011-03-11 20:59:18
d83d060854bdcc966461d6d08a97889f5c07d511...2409249072798c936c6a1e5a9ca3d603d0114de7,1,2,2,4,2,2011-03-11 21:55:02,2011-03-11 16:52:41
2409249072798c936c6a1e5a9ca3d603d0114de7...e89833c5d2e2a563e3f6cfe1ecb30edef646a95f,1,8,3,11,4,2011-03-11 21:55:14,2011-03-11 21:38:50
e89833c5d2e2a563e3f6cfe1ecb30edef646a95f...742349b0184a97ec31f99b32551035f0b8ef0b83,1,0,1,1,1,2011-03-11 21:55:44,2011-03-11 21:51:14
742349b0184a97ec31f99b32551035f0b8ef0b83...2ad98fd1fa41b51f89e14c3c3b655f788564b09a,2,5,14,19,4,2011-03-13 06:33:16,2011-03-11 21:24:01
2ad98fd1fa41b51f89e14c3c3b655f788564b09a...cc5b8c1094dccb231c9645d63f1664b721cc9366,1,2,2,4,2,2011-03-16 15:27:52,2011-03-16 15:14:28
cc5b8c1094dccb231c9645d63f1664b721cc9366...9c28b1d608df0ed6ebe791f63682370082da41c0,4,9,3,12,4,2011-03-16 15:33:30,2011-03-16 15:33:30
9c28b1d608df0ed6ebe791f63682370082da41c0...9a1ba315af6ae621e0cbecd7dbe91399063925cd,2,2,2,4,2,2011-03-16 18:45:01,2011-03-16 18:45:01
9a1ba315af6ae621e0cbecd7dbe91399063925cd...3d083de24be208d426817cc8cc9f4f24be520609,2,14,6,20,2,2011-03-16 19:54:35,2011-03-16 15:52:55
3d083de24be208d426817cc8cc9f4f24be520609...fade9c4e5160c90da06e767158b85fb679da05dd,1,11,1,12,2,2011-03-16 19:54:40,2011-03-16 16:33:54
fade9c4e5160c90da06e767158b85fb679da05dd...f1488a594f190b77d1e4d5e13a18ef6feb43b789,1,1,1,2,1,2011-03-16 21:46:50,2011-03-16 05:39:30
f1488a594f190b77d1e4d5e13a18ef6feb43b789...0dcc19701f1f5d5b4a99be6d1f49dc189a3fb32b,1,2,6,8,1,2011-03-16 21:46:50,2011-03-14 21:54:11
0dcc19701f1f5d5b4a99be6d1f49dc189a3fb32b...e4df10c2e034e9cb25e0f8de13b5c5e9b00283a9,1,14,1,15,3,2011-03-16 21:46:50,2011-03-15 04:17:16
e4df10c2e034e9cb25e0f8de13b5c5e9b00283a9...3d7f9d035e807c7648d246788deb99727698c1a1,1,1,1,2,1,2011-03-18 02:20:21,2011-03-17 22:59:05
3d7f9d035e807c7648d246788deb99727698c1a1...ab41f59e8f8d5bd9f40513cd1121f4365d3484c4,1,22,0,22,1,2011-03-19 02:04:48,2011-03-03 05:27:50
ab41f59e8f8d5bd9f40513cd1121f4365d3484c4...15c6cce90ad277ecb10cc9f4f8a53f4061358259,2,14,11,25,9,2011-03-19 02:04:52,2011-03-17 18:51:26
15c6cce90ad277ecb10cc9f4f8a53f4061358259...6187cea64f8f193365a22463473eef7e9b37d3ee,1,1,0,1,1,2011-03-19 02:05:51,2011-03-18 07:13:08
6187cea64f8f193365a22463473eef7e9b37d3ee...010e692d652ada892e57b3ae976dc13a4f31f06e,2,20,3,23,4,2011-03-19 02:07:24,2011-03-17 16:16:46
010e692d652ada892e57b3ae976dc13a4f31f06e...7e593365957dac139531b0ede79d9f0df217f584,3,10,6,16,8,2011-03-19 19:48:39,2011-03-19 19:48:39
7e593365957dac139531b0ede79d9f0df217f584...0d5979c50b07075f608e8341f3629e786badc5ca,4,26,8,34,9,2011-03-23 05:12:54,2011-03-22 00:44:29
0d5979c50b07075f608e8341f3629e786badc5ca...6021266abb19d3f1ff56465d0a7185699429b3c5,1,1,1,2,1,2011-03-23 05:13:03,2011-03-22 16:18:36
6021266abb19d3f1ff56465d0a7185699429b3c5...2394d382e194a11cd9d1194dad5321d1f59e253a,2,18,1,19,3,2011-03-24 17:02:29,2011-03-22 00:57:13
2394d382e194a11cd9d1194dad5321d1f59e253a...20ca858390938f916f64572bc21495b39a2db7be,2,51,0,51,2,2011-03-24 17:03:35,2011-03-23 04:06:54
20ca858390938f916f64572bc21495b39a2db7be...cd7e619868e127d39f5b7dc7da36f25dc3dd5f2a,1,2,2,4,1,2011-03-24 21:42:29,2011-03-24 21:42:29
cd7e619868e127d39f5b7dc7da36f25dc3dd5f2a...8c0cb88da90db05510d1775c84a5bf32bb60450e,4,9,3,12,4,2011-03-24 21:42:36,2011-03-24 21:42:36
8c0cb88da90db05510d1775c84a5bf32bb60450e...badd1cd93fce5c7a161f3384516f794dc6b79e5f,1,23,3,26,3,2011-03-24 22:42:48,2011-03-24 19:21:36
badd1cd93fce5c7a161f3384516f794dc6b79e5f...674a1b857aa6a7cc591dd76b95e5e9b932e240e6,1,2,1,3,2,2011-03-24 22:42:48,2011-03-24 19:47:01
674a1b857aa6a7cc591dd76b95e5e9b932e240e6...654567761333848dfe7ab9852e60260d9127ab7a,2,2,2,4,2,2011-03-25 15:33:07,2011-03-25 15:33:07
654567761333848dfe7ab9852e60260d9127ab7a...c48024855033ed8eef07762b17d7639fbebbef46,1,4,3,7,1,2011-03-30 05:40:45,2011-03-29 23:49:58
c48024855033ed8eef07762b17d7639fbebbef46...a75fddc244be17b3db962d413d1566c03d74dd67,1,1,1,2,1,2011-03-30 05:40:59,2011-03-30 05:36:01
a75fddc244be17b3db962d413d1566c03d74dd67...843747d201d13a98ac97e28b5292267645ec515b,1,2,0,2,1,2011-03-30 05:57:42,2011-03-30 05:57:42
843747d201d13a98ac97e28b5292267645ec515b...25cabc25ae7baf64b8a70a634e6c2dc2fc5e63a5,1,3,1,4,2,2011-03-31 02:20:52,2011-03-28 21:38:06
25cabc25ae7baf64b8a70a634e6c2dc2fc5e63a5...64eeb57f33813dbfc54a4faa7cc7eacb0508d9c1,1,3,1,4,1,2011-03-31 02:26:34,2011-03-31 02:26:34
64eeb57f33813dbfc54a4faa7cc7eacb0508d9c1...62cbfb842cf627946ca99e68a8090df1a65de2c5,1,1,1,2,1,2011-03-31 07:06:55,2011-03-31 07:06:55
62cbfb842cf627946ca99e68a8090df1a65de2c5...444950f086c004324905f4ecac58b1a120384197,1,5,4,9,2,2011-03-31 07:08:59,2011-03-30 17:49:19
444950f086c004324905f4ecac58b1a120384197...5cc6b7bca4a62674b51c1446181d4e652fc94700,2,18,6,24,10,2011-03-31 07:09:07,2011-03-30 17:52:51
5cc6b7bca4a62674b51c1446181d4e652fc94700...7c5b035e1bad0a4f1d84adde04df49b57dae7828,1,30,2,32,2,2011-03-31 07:12:40,2011-03-02 15:31:40
7c5b035e1bad0a4f1d84adde04df49b57dae7828...134e8eb0e0913747ac648875514332fe9949d4cd,12,89,265,354,67,2011-03-31 07:12:43,2011-03-30 21:03:52
134e8eb0e0913747ac648875514332fe9949d4cd...5bd0556e0efae784783cacd1cc38371c269e37ce,1,2,2,4,2,2011-03-31 07:42:07,2011-03-31 07:42:07
5bd0556e0efae784783cacd1cc38371c269e37ce...c340b4882b752b9e9fdae4db2738ee502cd254e3,4,9,3,12,4,2011-03-31 22:39:07,2011-03-31 22:39:07
c340b4882b752b9e9fdae4db2738ee502cd254e3...27413a5ca3030242cf021f2d764f730c01845456,2,2,2,4,2,2011-04-01 05:14:09,2011-04-01 05:14:09
27413a5ca3030242cf021f2d764f730c01845456...a429cd4f535b2499cc4130b06ff7c26f41c00f04,4,9,3,12,4,2011-04-06 04:40:13,2011-04-06 04:40:13
a429cd4f535b2499cc4130b06ff7c26f41c00f04...abfa5faccbc52bf1ce1e96c8071fa1318c338480,2,2,2,4,2,2011-04-06 20:37:01,2011-04-06 20:37:01
abfa5faccbc52bf1ce1e96c8071fa1318c338480...d0882e2ef57703200d3fa4eeedf18b91ca297384,1,57,39,96,30,2011-04-11 18:23:23,2011-04-11 09:50:45
d0882e2ef57703200d3fa4eeedf18b91ca297384...0c54e46abedd712353f43671506ca7ae427b6857,1,2,2,4,2,2011-04-11 18:23:28,2011-04-11 18:22:12
0c54e46abedd712353f43671506ca7ae427b6857...3cf20acae639214fb8a4363d6d3a4ad0fdf5dd68,4,53,0,53,5,2011-04-12 00:26:49,2011-04-06 06:50:20
3cf20acae639214fb8a4363d6d3a4ad0fdf5dd68...6b28225ad1ac39bdc6a363cd7d0971c6085a3dce,1,4,2,6,3,2011-04-12 14:43:57,2011-04-11 09:19:21
6b28225ad1ac39bdc6a363cd7d0971c6085a3dce...0c6ed621b30252235d070ef6e724b391f5ecf7b7,2,7,4,11,3,2011-04-14 18:44:22,2011-03-31 20:55:41
0c6ed621b30252235d070ef6e724b391f5ecf7b7...b55bdd60571a8edcf03216476c3a3008cde8a731,1,1,1,2,1,2011-04-15 20:31:29,2011-04-15 20:30:08
b55bdd60571a8edcf03216476c3a3008cde8a731...9de0190fbcd977c5be374b84252fef8f50547cce,1,1,1,2,1,2011-04-19 05:01:38,2011-04-18 23:11:29
9de0190fbcd977c5be374b84252fef8f50547cce...dff2c6b66e29f2d7b91fe5994d07532adca38135,1,1,1,2,1,2011-04-19 21:47:10,2011-04-19 20:39:51
dff2c6b66e29f2d7b91fe5994d07532adca38135...2e3f27c3f9654205ecbea2ce28367c138b7282d0,1,34,0,34,2,2011-04-20 15:58:43,2011-04-20 15:58:43
2e3f27c3f9654205ecbea2ce28367c138b7282d0...d29d02b69473c568cecc12360102ede3a0bc41f5,4,12,2,14,5,2011-04-20 16:06:57,2011-03-30 20:52:55
d29d02b69473c568cecc12360102ede3a0bc41f5...61374ff5acc13f1d5edeb4ff4d8d495ce823e02d,2,3,0,3,2,2011-04-25 19:39:18,2011-03-17 16:30:24
61374ff5acc13f1d5edeb4ff4d8d495ce823e02d...bd136c1c16b21ffa5d1afad0172a415d718db9e2,2,13,0,13,3,2011-04-26 21:33:26,2011-04-26 21:32:47
bd136c1c16b21ffa5d1afad0172a415d718db9e2...19d7fd194d5793441b945ef07f1ae46b0de6ceaa,2,15,0,15,2,2011-04-28 05:55:05,2011-04-08 14:31:05
19d7fd194d5793441b945ef07f1ae46b0de6ceaa...4b5f2b33e8e7e858990bd4837f37c82290b7150d,2,34,1,35,2,2011-04-28 12:50:23,2011-03-30 07:23:37
4b5f2b33e8e7e858990bd4837f37c82290b7150d...b7e87f07a6455279aeb65a5c18197b9e2025d3a2,8,6,12,18,11,2011-05-02 15:34:45,2011-04-03 23:10:36
b7e87f07a6455279aeb65a5c18197b9e2025d3a2...00a41661dbfb4ee8456fbb17f211d9b50d1cd1fe,1,0,2,2,2,2011-05-02 16:24:01,2011-05-02 16:24:01
00a41661dbfb4ee8456fbb17f211d9b50d1cd1fe...5347089eaffb4f1a932924ad93cde341cdc4935a,1,21,24,45,7,2011-05-02 17:00:38,2011-04-28 17:15:34
5347089eaffb4f1a932924ad93cde341cdc4935a...d050d236e5cfc0af296e84d57675a4d70337ada6,1,36,8,44,7,2011-05-03 15:07:17,2011-05-03 15:07:17
d050d236e5cfc0af296e84d57675a4d70337ada6...8a9f531efe371b8e79a82b0014d81f23927ff6fa,3,42,6,48,6,2011-05-03 15:17:25,2011-04-04 23:19:48
8a9f531efe371b8e79a82b0014d81f23927ff6fa...ab257b80a20324c4090407cb3a2daf20b2ecc396,1,1,1,2,1,2011-05-03 15:18:40,2011-04-14 00:25:42
ab257b80a20324c4090407cb3a2daf20b2ecc396...9061285aaed453d6ae63f3ef96a9e4d09456cb98,1,2,0,2,1,2011-05-03 15:19:14,2011-04-04 16:47:32
9061285aaed453d6ae63f3ef96a9e4d09456cb98...76ad17111ab4bbb2517841accb54a63db82396f3,1,9,8,17,3,2011-05-03 15:21:29,2011-04-28 20:37:40
76ad17111ab4bbb2517841accb54a63db82396f3...e2ab282a05c28158a6d5b94b7d14db8fffd1b5d8,4,9,3,12,4,2011-05-04 03:09:56,2011-05-04 03:09:56
e2ab282a05c28158a6d5b94b7d14db8fffd1b5d8...660616f57dc1bf23bf1316b22db88b7d1cf98b80,2,2,2,4,2,2011-05-04 12:39:11,2011-05-04 12:39:11
660616f57dc1bf23bf1316b22db88b7d1cf98b80...676a1aee8e78dd5570c6761128f632789b4ce3ba,1,3,0,3,1,2011-05-05 12:37:37,2011-05-05 12:37:37
676a1aee8e78dd5570c6761128f632789b4ce3ba...511ecc1c19904bc591f75a05cba8f62634a8915b,1,15,4,19,2,2011-05-08 00:06:16,2011-03-15 18:31:18
511ecc1c19904bc591f75a05cba8f62634a8915b...98ef5cc5cb2db42f8e268cb05abfa9606bb6c51d,5,25,22,47,12,2011-05-10 19:36:07,2011-05-10 19:36:07
98ef5cc5cb2db42f8e268cb05abfa9606bb6c51d...dc54306029630178fa6602f6518a9e3c98505e3a,2,4,0,4,2,2011-05-10 19:45:00,2011-05-10 19:45:00
dc54306029630178fa6602f6518a9e3c98505e3a...5d5a2bb16f8b8413f3b5a4502f93364cf725814f,1,2,1,3,1,2011-05-11 06:45:59,2011-05-11 06:45:59
5d5a2bb16f8b8413f3b5a4502f93364cf725814f...2ca9d0e5f6d23760d1e7a9694bae3878370bffe0,1,2,2,4,2,2011-05-11 07:04:11,2011-05-11 07:04:11
2ca9d0e5f6d23760d1e7a9694bae3878370bffe0...87e30d6af67abe735230fa1b7876f51f3d34a8ac,4,50,41,91,29,2011-05-11 07:04:25,2011-05-11 07:04:25
87e30d6af67abe735230fa1b7876f51f3d34a8ac...7377e5c0ca375c0a3373eacbfcd7810a3f0490df,1,2,2,4,2,2011-05-11 17:15:08,2011-05-11 17:14:39
7377e5c0ca375c0a3373eacbfcd7810a3f0490df...04b47e5c9811348cf80f83dac094dffc896a5971,7,48,13,61,17,2011-05-11 17:30:26,2011-05-11 17:28:04
04b47e5c9811348cf80f83dac094dffc896a5971...da537eae3ec18611424dabb63a202d4940059be4,4,9,3,12,4,2011-05-11 19:37:09,2011-05-11 19:37:09
da537eae3ec18611424dabb63a202d4940059be4...157c6dd098fc70dde00c6907477f62c8e2ebed6f,2,2,2,4,2,2011-05-12 05:32:37,2011-05-12 05:32:37
157c6dd098fc70dde00c6907477f62c8e2ebed6f...f7e1c875ca86f0b695433d7b39a59d19bb148b7e,1,33,17,50,5,2011-05-12 19:25:51,2011-05-11 19:05:00
f7e1c875ca86f0b695433d7b39a59d19bb148b7e...d251ae6b3f68756baa8e7fc577c0db747979475d,2,7,14,21,6,2011-05-12 19:58:18,2011-05-12 19:58:18
d251ae6b3f68756baa8e7fc577c0db747979475d...1bff7ec3bcd4fe8961ce4bcd3bc83b2375f360c4,1,4,0,4,1,2011-05-12 22:31:59,2011-05-12 19:44:00
1bff7ec3bcd4fe8961ce4bcd3bc83b2375f360c4...802e514aac3d63110f9d854b9a21141f81f0a787,1,0,1,1,1,2011-05-12 22:31:59,2011-05-12 19:25:30
802e514aac3d63110f9d854b9a21141f81f0a787...2c201bf63b6e2377ce90298043e32f5902c34659,2,14,14,28,9,2011-05-12 22:31:59,2011-05-12 20:59:57
2c201bf63b6e2377ce90298043e32f5902c34659...78644abdfb4a7ca834e8bdeaed55cde51989de12,2,7,1,8,4,2011-05-12 22:31:59,2011-05-12 20:57:28
78644abdfb4a7ca834e8bdeaed55cde51989de12...decf327ef50584a0a55f3718c55713b130362552,1,1,1,2,1,2011-05-13 22:34:09,2011-05-13 22:33:36
decf327ef50584a0a55f3718c55713b130362552...a852279bc770ea0594bc799ef14ddca4572944a9,1,10,6,16,4,2011-05-18 15:09:45,2011-05-18 15:08:41
a852279bc770ea0594bc799ef14ddca4572944a9...a1ecdb63772de668e23feca39f9713b735e8fee4,1,19,4,23,6,2011-05-18 16:56:11,2011-05-18 16:55:38
a1ecdb63772de668e23feca39f9713b735e8fee4...960975d5815e9353d4c622e3533f17760426a629,2,17,5,22,3,2011-05-18 16:57:01,2011-05-10 18:21:38
960975d5815e9353d4c622e3533f17760426a629...c167f9282ee4398b15670d0903f8caae5f8f8a8e,1,1,1,2,1,2011-05-18 16:57:25,2011-05-10 19:45:14
c167f9282ee4398b15670d0903f8caae5f8f8a8e...888bc45759308d4e1ce9480dfc6f545921feae2e,1,7,9,16,1,2011-05-20 06:01:46,2011-05-19 19:41:01
888bc45759308d4e1ce9480dfc6f545921feae2e...ad4402b760ddb263c4961bcd50e203f2152b3b20,1,6,0,6,1,2011-05-20 06:02:01,2011-05-19 19:40:34
ad4402b760ddb263c4961bcd50e203f2152b3b20...4e1ef081145de4464d9f3f94d8db81c707f8653b,1,2,2,4,2,2011-05-20 06:03:07,2011-05-20 06:03:07
4e1ef081145de4464d9f3f94d8db81c707f8653b...b138b40e511818b369a72638e00395b422eca980,1,6,6,12,3,2011-05-20 06:04:56,2011-04-05 07:11:49
b138b40e511818b369a72638e00395b422eca980...373038f53049071fddb5404698c8bebf99e3b51f,4,9,3,12,4,2011-05-20 17:13:45,2011-05-20 17:13:45
373038f53049071fddb5404698c8bebf99e3b51f...24e91d5b2c419f66e74ef18428db66cd0ba3d4a7,2,2,2,4,2,2011-05-21 04:52:30,2011-05-21 04:52:30
24e91d5b2c419f66e74ef18428db66cd0ba3d4a7...f507c99be0cbe0c8ec1a962bc58d9763d1c9e9e3,1,4,0,4,4,2011-05-21 05:07:32,2011-05-21 05:07:32
f507c99be0cbe0c8ec1a962bc58d9763d1c9e9e3...47840f05d29a3e63a402740e5914f2c803f3bda1,1,1,0,1,1,2011-05-22 05:11:36,2011-05-22 05:11:03
47840f05d29a3e63a402740e5914f2c803f3bda1...a23295b084353800481caf00c92bea1ec024b664,1,5,3,8,3,2011-05-27 01:25:47,2011-05-27 01:25:47
a23295b084353800481caf00c92bea1ec024b664...7b2eaf5c4c35132c5eee86c902612201ee963b0f,1,2,2,4,2,2011-05-28 00:21:10,2011-05-27 23:42:44
7b2eaf5c4c35132c5eee86c902612201ee963b0f...3d531c70579a3ce8ef610e777f65903e66676141,1,2,2,4,2,2011-05-28 01:03:25,2011-05-27 22:34:51
3d531c70579a3ce8ef610e777f65903e66676141...06882f6151e281aa314ce8659099ed21817da970,1,8,0,8,3,2011-05-31 21:27:52,2011-05-31 16:51:29
06882f6151e281aa314ce8659099ed21817da970...c7aed2d982a7769f577d2f727d4ec188637e9183,1,4,2,6,2,2011-05-31 21:28:12,2011-05-31 19:31:41
c7aed2d982a7769f577d2f727d4ec188637e9183...2d7719228787c9c8100456bc70bf860ec2885732,4,9,3,12,4,2011-06-01 06:31:17,2011-06-01 06:31:17
2d7719228787c9c8100456bc70bf860ec2885732...7c220fa4b5c212667f87c1de3d07f1b1ec8d9051,2,2,2,4,2,2011-06-01 17:15:03,2011-06-01 17:15:03
7c220fa4b5c212667f87c1de3d07f1b1ec8d9051...2e817ce6ba0934d6eb0dcfc39fc7adc9f9ce0eea,2,15,13,28,5,2011-06-06 15:17:19,2011-06-06 15:16:57
2e817ce6ba0934d6eb0dcfc39fc7adc9f9ce0eea...1118723f6f71a1a47af14ab73f4edf9832059ff5,4,9,3,12,4,2011-06-06 22:27:46,2011-06-06 22:27:46
1118723f6f71a1a47af14ab73f4edf9832059ff5...7aea274ad42aa71dc978239c46b22dd8d6a98cdb,2,2,2,4,2,2011-06-07 04:14:57,2011-06-07 04:14:57
7aea274ad42aa71dc978239c46b22dd8d6a98cdb...817ee028fe6df84b7f342fefecb20f622b506287,1,1,1,2,1,2011-06-09 04:22:28,2011-04-20 16:05:10
817ee028fe6df84b7f342fefecb20f622b506287...959500ba9977891b6a6d4736615d1ae5bf22d2c2,1,18,16,34,1,2011-06-09 04:22:32,2011-06-09 04:21:09
959500ba9977891b6a6d4736615d1ae5bf22d2c2...9990775e39701870c5238388aecfabda992de8e3,1,5,1,6,1,2011-06-09 15:10:38,2011-06-09 15:07:30
9990775e39701870c5238388aecfabda992de8e3...bd1ad6d52607ff7bfd3a0b5375a38c090cb21225,1,11,2,13,1,2011-06-13 21:59:18,2011-06-13 21:59:18
bd1ad6d52607ff7bfd3a0b5375a38c090cb21225...99e2d4e5d9e2c38f4bfe87e0f82895076cdccd31,1,4,0,4,1,2011-06-14 22:43:34,2011-06-14 20:39:43
99e2d4e5d9e2c38f4bfe87e0f82895076cdccd31...a22ec7fc390e7c7d41c31755a77fb65d4f2b5fdc,2,2,2,4,2,2011-06-14 22:51:51,2011-06-14 22:51:51
a22ec7fc390e7c7d41c31755a77fb65d4f2b5fdc...433bbaa14aaba6860da15bd4de8edf600f56501b,2,2,2,4,2,2011-06-15 13:43:13,2011-06-15 13:43:13
433bbaa14aaba6860da15bd4de8edf600f56501b...9bd9ac0cd54ed85a24a61d1a86cd203dbf9376f0,2,2,2,4,2,2011-06-15 23:23:09,2011-06-15 23:23:09
9bd9ac0cd54ed85a24a61d1a86cd203dbf9376f0...1f9df58e76cd47a19475c7532b114e4ec55af9b5,2,6,1,7,3,2011-06-17 21:44:49,2011-06-17 21:44:49
1f9df58e76cd47a19475c7532b114e4ec55af9b5...3bda11579bb9ac6cef26e6205c204ff6697c2ab6,1,9,3,12,3,2011-06-23 21:43:35,2011-06-23 21:41:14
3bda11579bb9ac6cef26e6205c204ff6697c2ab6...bdd22abc84a2206c48976fcb5516dbf8f4d345d2,1,4,0,4,2,2011-06-29 15:01:24,2011-06-29 15:01:24
bdd22abc84a2206c48976fcb5516dbf8f4d345d2...34c172c38f266702cf2a667138c20fb28436fd76,1,24,2,26,4,2011-06-29 15:01:36,2011-06-29 15:01:36
34c172c38f266702cf2a667138c20fb28436fd76...771b5bca9a1200edbbd99a42f22c8bef4ee18eef,1,39,11,50,6,2011-06-29 18:29:08,2011-06-21 23:25:03
771b5bca9a1200edbbd99a42f22c8bef4ee18eef...e7b5684e9dd289c72a103b96e76b7609a9fb6a96,1,2,2,4,1,2011-06-30 15:53:02,2011-06-30 15:53:02
e7b5684e9dd289c72a103b96e76b7609a9fb6a96...930611d96e57061155f15ebb757ddd9acdaee710,3,44,12,56,6,2011-06-30 15:53:08,2011-06-30 15:53:08
930611d96e57061155f15ebb757ddd9acdaee710...c40ec7638318696be5eaa07f83a859af2b76ff66,1,5,1,6,3,2011-06-30 18:13:48,2011-06-30 18:13:48
c40ec7638318696be5eaa07f83a859af2b76ff66...b6141de70ed78a676c28adf2469ceb15d5b886a1,1,3,2,5,2,2011-07-01 03:26:57,2011-06-30 22:27:58
b6141de70ed78a676c28adf2469ceb15d5b886a1...6f755db29cbf8683bf226eb5ff27575996786607,1,66,53,119,3,2011-07-06 05:25:08,2011-07-06 05:25:08
6f755db29cbf8683bf226eb5ff27575996786607...9ff2f6ce50b3caddcee7c43fffd3136e8c354270,1,7,2,9,5,2011-07-07 06:14:34,2011-07-07 06:14:34
9ff2f6ce50b3caddcee7c43fffd3136e8c354270...27d16a2a05862be5f4d9f034048afbb8444b793e,1,3,1,4,4,2011-07-07 07:30:19,2011-07-07 07:29:52
27d16a2a05862be5f4d9f034048afbb8444b793e...74bb5b66f9765937a4af2cdfd5ce0159d602b93a,1,1,1,2,1,2011-07-07 12:17:53,2011-07-07 12:16:53
74bb5b66f9765937a4af2cdfd5ce0159d602b93a...25de5330e9a575d094711a2dc5287d04ba10ad47,1,1,1,2,1,2011-07-07 12:29:38,2011-07-07 12:27:31
25de5330e9a575d094711a2dc5287d04ba10ad47...c0f7f526310f49b37cf1b98700003cc73ba27d17,1,3,3,6,3,2011-07-07 12:29:53,2011-07-07 12:29:15
c0f7f526310f49b37cf1b98700003cc73ba27d17...03ae331d1eeab6a884517076490db51b22864f7a,1,20,0,20,2,2011-07-07 17:21:29,2011-06-17 23:48:08
03ae331d1eeab6a884517076490db51b22864f7a...7323ec1545e9b0b932bd74fbd16e6e6eab3c4661,1,1,0,1,1,2011-07-07 17:21:42,2011-06-20 17:03:34
7323ec1545e9b0b932bd74fbd16e6e6eab3c4661...f9fcfffad6f95cf6e37d99d07b1d7c74075b56f6,1,1,1,2,1,2011-07-07 17:28:21,2011-07-07 17:28:21
f9fcfffad6f95cf6e37d99d07b1d7c74075b56f6...12cc8fb4ae8df0836f73d30ea95354155b757571,1,8,1,9,2,2011-07-10 04:26:10,2011-07-10 04:25:43
12cc8fb4ae8df0836f73d30ea95354155b757571...b3224f5ae3cc3c6982b23e0cd64b1854fe97d03c,1,3,1,4,3,2011-07-11 14:28:48,2011-07-11 14:27:15
b3224f5ae3cc3c6982b23e0cd64b1854fe97d03c...3337ab497cd55e25fbdbe732e6c40c724add857d,3,44,1,45,5,2011-07-11 20:11:40,2011-07-11 20:11:40
3337ab497cd55e25fbdbe732e6c40c724add857d...1b048c3a01aaaca98dbc2625920a52f39245d987,3,16,16,32,14,2011-07-12 15:17:33,2011-07-12 14:58:42
1b048c3a01aaaca98dbc2625920a52f39245d987...e6299cf1d1dd63ebda4fd4cd2a7e52de21c8a90a,1,8,1,9,1,2011-07-14 15:35:12,2011-07-14 15:20:58
e6299cf1d1dd63ebda4fd4cd2a7e52de21c8a90a...9134b167029adbe8682190854b88755929b14914,1,37,0,37,1,2011-07-14 15:36:08,2011-07-14 15:29:16
9134b167029adbe8682190854b88755929b14914...a85dd523b71ef5f364b527e6679476e942b7bd4c,1,3,3,6,3,2011-07-14 15:41:35,2011-07-14 15:41:35
a85dd523b71ef5f364b527e6679476e942b7bd4c...83207189ea7c6b594c948cc27b8ae25356d79b77,1,1,8,9,1,2011-07-25 20:03:57,2011-07-25 20:03:57
83207189ea7c6b594c948cc27b8ae25356d79b77...4697c39481ac4056d19e64017d15d74b34d533a1,1,8,1,9,1,2011-07-26 17:40:03,2011-07-26 17:40:03
4697c39481ac4056d19e64017d15d74b34d533a1...81147c1ca4cc10d9a81a0a2afdf364ab1ca8867d,2,2,2,4,2,2011-07-28 05:21:39,2011-07-28 05:21:39
81147c1ca4cc10d9a81a0a2afdf364ab1ca8867d...e96a9e7d61c4d48dc4eaae8d77f51eb7df4d7a11,2,2,2,4,2,2011-07-28 14:18:36,2011-07-28 14:18:36
e96a9e7d61c4d48dc4eaae8d77f51eb7df4d7a11...48d0219905699adfab7019ac951527875869a63c,1,1,1,2,1,2011-07-29 19:07:51,2011-07-26 20:08:49
48d0219905699adfab7019ac951527875869a63c...4b882e7b94c3d92e139a02dc8d104c30deb33b67,1,1,1,2,1,2011-08-03 15:32:09,2011-08-03 15:32:09
4b882e7b94c3d92e139a02dc8d104c30deb33b67...fba78d46345423318b9eb08bcc51c733e6dc0c5e,1,1,2,3,1,2011-08-04 14:12:33,2011-08-04 14:12:33
fba78d46345423318b9eb08bcc51c733e6dc0c5e...2290dcc14e8acb3db3f4efbf2d6b095397137d23,4,16,1,17,5,2011-08-04 19:11:30,2011-08-03 22:00:02
2290dcc14e8acb3db3f4efbf2d6b095397137d23...bb85c0204c705186ca1bd67c6f39e1920ee5711d,1,5,2,7,2,2011-08-07 16:49:10,2011-08-07 16:49:10
bb85c0204c705186ca1bd67c6f39e1920ee5711d...fbf572867acdb9e0b274c3d182e0228d98190f96,4,9,3,12,4,2011-08-10 14:25:19,2011-08-10 14:25:19
fbf572867acdb9e0b274c3d182e0228d98190f96...2a3b5f73ddeed199af2149f92aaf72827f5f0233,2,2,2,4,2,2011-08-11 04:18:11,2011-08-11 04:18:11
2a3b5f73ddeed199af2149f92aaf72827f5f0233...3d590b6dd6fc1d7135bf41fb954158db59e5ae30,1,21,0,21,2,2011-08-12 14:28:18,2011-08-12 14:28:18
3d590b6dd6fc1d7135bf41fb954158db59e5ae30...5e12acf80501fc5b4c7e925c878c2f8ac398e62d,2,27,6,33,4,2011-08-12 20:07:56,2011-08-12 20:07:56
5e12acf80501fc5b4c7e925c878c2f8ac398e62d...4e9ab8b148ae7eea98608ed5afc5a698ac95a3f9,2,2,2,4,2,2011-08-12 23:42:40,2011-08-12 23:42:40
4e9ab8b148ae7eea98608ed5afc5a698ac95a3f9...e6d5176463c31e15d3f14ac4e7184c024f38dd6f,2,2,2,4,2,2011-08-14 16:09:38,2011-08-14 16:09:38
e6d5176463c31e15d3f14ac4e7184c024f38dd6f...d6d4ee256edd8989a74fd6716841780696154da5,1,1,1,2,1,2011-08-15 00:22:13,2011-08-15 00:22:13
d6d4ee256edd8989a74fd6716841780696154da5...b9619c4bde7460b6c3a3be9927854925bda60521,1,1,1,2,1,2011-08-16 18:05:10,2011-08-16 18:05:10
b9619c4bde7460b6c3a3be9927854925bda60521...d4435681b510407cf2ba83f338a3a925efaeb1ec,5,31,0,31,5,2011-08-17 15:22:04,2011-08-17 15:22:04
d4435681b510407cf2ba83f338a3a925efaeb1ec...c520e0be0b9b49a4926d2aceba16350969315946,1,3,1,4,1,2011-08-18 03:36:13,2011-08-18 03:36:13
c520e0be0b9b49a4926d2aceba16350969315946...c206d77e94bc3b65c76681df5a6b605f68a2de05,3,3,3,6,3,2011-08-19 20:19:39,2011-08-19 20:19:39
c206d77e94bc3b65c76681df5a6b605f68a2de05...55087b1c66d0a8c037af69e4f539c4b819608cbf,2,2,2,4,2,2011-08-20 06:05:12,2011-08-20 06:05:12
55087b1c66d0a8c037af69e4f539c4b819608cbf...bc8b2ef3cc55a18274920ededbba6e18e99626e4,3,7,0,7,4,2011-08-23 19:46:28,2011-08-23 19:46:28
bc8b2ef3cc55a18274920ededbba6e18e99626e4...f3bd113e0df642703fda8cc9fe7f6cdf6503e5e8,2,5,1,6,2,2011-08-30 06:14:23,2011-08-30 06:02:47
f3bd113e0df642703fda8cc9fe7f6cdf6503e5e8...09afe30a6081d802141e671f43ca330eccd3528c,1,42,15,57,11,2011-09-06 17:29:39,2011-09-06 17:29:39
09afe30a6081d802141e671f43ca330eccd3528c...618a111c9001b83722d4505319d3bf7fb3f1ad17,1,8,0,8,1,2011-09-15 15:37:24,2011-09-15 15:25:52
618a111c9001b83722d4505319d3bf7fb3f1ad17...652f407b4b194bd98c1f59fb93f3a1b014ff9bb6,1,1,1,2,1,2011-09-15 18:41:01,2011-08-15 23:11:15
652f407b4b194bd98c1f59fb93f3a1b014ff9bb6...b09007c96bafb185374ccd5ab68fba5e8362017f,1,1,1,2,1,2011-09-26 06:42:28,2011-09-26 04:26:10
b09007c96bafb185374ccd5ab68fba5e8362017f...ca86100b8a62ea86ab39f49ea235b6b9dd19bbad,1,1,1,2,1,2011-09-26 06:42:34,2011-09-26 04:36:01
ca86100b8a62ea86ab39f49ea235b6b9dd19bbad...2e48cfb4d798f2a5d3d3535a1d2cbe442d086325,5,91,22,113,14,2011-10-05 18:32:14,2011-10-05 18:32:14
2e48cfb4d798f2a5d3d3535a1d2cbe442d086325...7db36ba5a388d1f8f55cd4c5a7ce9c8fb7e82d7d,1,18,6,24,2,2011-10-05 18:34:21,2011-10-05 18:34:21
7db36ba5a388d1f8f55cd4c5a7ce9c8fb7e82d7d...30149a4335fd08bb62287dd1b0fbd2bf7b8bfe62,2,19,16,35,4,2011-10-05 18:43:10,2011-10-05 18:43:10
30149a4335fd08bb62287dd1b0fbd2bf7b8bfe62...935deafec0217180cb5ea86ec62804e55ba3d8aa,4,9,3,12,4,2011-10-06 18:42:44,2011-10-06 18:42:44
935deafec0217180cb5ea86ec62804e55ba3d8aa...161bc6b60a5437b88f676e3da6c0434da0f2d77b,2,2,2,4,2,2011-10-07 14:11:53,2011-10-07 14:11:53
161bc6b60a5437b88f676e3da6c0434da0f2d77b...836a7578cbb52993c59b03df8e19f91dd2dedd70,1,1,1,2,1,2011-10-13 22:10:01,2011-10-13 22:10:01
836a7578cbb52993c59b03df8e19f91dd2dedd70...58a3ee1f9e39877ffee65564697c43ac647b001d,1,1,1,2,1,2011-10-14 04:01:33,2011-10-14 04:01:33
58a3ee1f9e39877ffee65564697c43ac647b001d...85902e0e826ba543f9ea6021e0d370fcc6dd6854,1,5,2,7,3,2011-10-20 19:48:29,2011-10-20 19:48:29
85902e0e826ba543f9ea6021e0d370fcc6dd6854...8a9c636fbde1e2e3b6d2154616aa80786f845be4,1,1,0,1,1,2011-10-21 15:30:28,2011-10-21 15:30:28
8a9c636fbde1e2e3b6d2154616aa80786f845be4...81f12749a15e3d158b1b16bab6bc3faea538e166,4,4,4,8,4,2011-10-24 04:50:52,2011-10-24 04:50:52
81f12749a15e3d158b1b16bab6bc3faea538e166...1e894dad0db4d954e636350c5547f6e44c973725,2,2,2,4,2,2011-10-25 04:49:07,2011-10-25 04:49:07
1e894dad0db4d954e636350c5547f6e44c973725...1519ef321f72b59dc8b586f049e7238728727e91,1,10,2,12,4,2011-11-11 17:14:25,2011-11-04 17:32:17
1519ef321f72b59dc8b586f049e7238728727e91...94b35f403221390f5dac1750a5c4b6302eaadf2b,5,48,41,89,8,2011-11-14 18:10:52,2011-11-14 18:10:52
94b35f403221390f5dac1750a5c4b6302eaadf2b...0524f59fcf33abb7ac10bbe03657a1b5348f2443,1,7,8,15,2,2011-11-14 18:14:06,2011-11-14 18:14:06
0524f59fcf33abb7ac10bbe03657a1b5348f2443...a8deef409a7319faafa4d746881bcaac31ee061c,3,23,5,28,8,2011-12-08 16:13:57,2011-12-08 16:13:57
a8deef409a7319faafa4d746881bcaac31ee061c...57fa5f296e00af8833bf19c31e3209e8c65bb47b,1,64,0,64,1,2011-12-08 16:15:35,2011-12-08 16:15:35
57fa5f296e00af8833bf19c31e3209e8c65bb47b...e82f9ddc53a4fe24a40f190b45dc25b7ed88ed96,4,69,4,73,10,2011-12-16 23:39:11,2011-12-16 23:39:11
e82f9ddc53a4fe24a40f190b45dc25b7ed88ed96...ddabd8c4b3f941a51305677e599c355aea610a52,2,2,2,4,2,2011-12-28 06:24:51,2011-12-28 06:24:51
ddabd8c4b3f941a51305677e599c355aea610a52...4f3b34405e00b0aac04b240a0aad9b22d27d7dc3,1,5,0,5,2,2011-12-28 17:01:48,2011-12-28 17:01:48
4f3b34405e00b0aac04b240a0aad9b22d27d7dc3...d774a10495e1a59660c6b83b80ba76b872151c75,2,2,2,4,2,2011-12-29 07:03:17,2011-12-29 07:03:17
d774a10495e1a59660c6b83b80ba76b872151c75...ad30979f8afeb60121dfb17195b23825a1fb7cec,1,2,2,4,2,2012-01-31 15:38:40,2012-01-31 15:37:37
ad30979f8afeb60121dfb17195b23825a1fb7cec...c4c624cb973af1f6d225333aefa51fe06e04e22f,1,11,2,13,3,2012-01-31 15:47:49,2012-01-31 15:47:49
c4c624cb973af1f6d225333aefa51fe06e04e22f...d664454f3ec706ad1b0ea054213cc0e899ff7a2f,1,16,3,19,1,2012-01-31 16:19:42,2012-01-31 16:19:42
d664454f3ec706ad1b0ea054213cc0e899ff7a2f...76039e04b7d5706f0c61c374fee1beaf941a259b,1,1,2,3,1,2012-01-31 16:33:22,2012-01-31 16:32:59
76039e04b7d5706f0c61c374fee1beaf941a259b...403c8dadcd56f68dcbe06013ecbfac67b32a22ac,4,9,3,12,4,2012-02-01 05:02:07,2012-02-01 05:02:07
403c8dadcd56f68dcbe06013ecbfac67b32a22ac...04c7cb57792f1bb1af0c7159639f30e1b079a49b,2,2,2,4,2,2012-02-01 22:14:17,2012-02-01 22:14:17
04c7cb57792f1bb1af0c7159639f30e1b079a49b...dc9199a6f395d65fc18679c846a759d0bfe6a9a3,1,1,1,2,1,2012-02-16 19:20:32,2012-02-16 19:20:32
65a7e81df0747b6bc9380b78e0182192bacdb4d0...c63fa1bc476f2b8c36ff5b8592c3ac48bb74cfa3,2,2,2,4,2,2011-02-23 04:40:39,2011-02-23 04:40:39
c63fa1bc476f2b8c36ff5b8592c3ac48bb74cfa3...8b0ba123cc51462cb52a4c32f4ae315081e171f0,3,31,4,35,6,2011-02-24 01:51:04,2011-02-22 20:55:03
8b0ba123cc51462cb52a4c32f4ae315081e171f0...992951f536cca4ca0bb8309e8ea04a9efaaf6567,1,31,0,31,1,2011-02-24 01:51:06,2011-02-22 22:44:19
992951f536cca4ca0bb8309e8ea04a9efaaf6567...7e6c8199ce4b8875e6e2b7af762e67bed1521b7a,1,1,0,1,1,2011-02-24 01:51:07,2011-02-22 22:46:12
7e6c8199ce4b8875e6e2b7af762e67bed1521b7a...4311bd389212fa0af6c0075c88e3c4321e26e195,1,12,2,14,1,2011-02-24 01:51:08,2011-02-23 00:33:54
4311bd389212fa0af6c0075c88e3c4321e26e195...43da5cb64158738e760cfcdb4d1ef23badf610b3,2,4,0,4,2,2011-02-24 01:51:10,2011-02-23 04:21:00
43da5cb64158738e760cfcdb4d1ef23badf610b3...9996ea0734cad5353b4fda8bf31d97f3379c3eb9,2,30,21,51,3,2011-02-24 01:51:11,2011-02-23 22:51:55
9996ea0734cad5353b4fda8bf31d97f3379c3eb9...73a8cfd0a47444849f807cef1621fc0001d15637,3,3,3,6,4,2011-02-24 01:51:13,2011-02-24 00:02:08
73a8cfd0a47444849f807cef1621fc0001d15637...40f1e46d52bd18779a7ab756b94ee4f10423d060,1,1,1,2,1,2011-02-24 01:58:13,2011-02-24 01:58:13
40f1e46d52bd18779a7ab756b94ee4f10423d060...6113b4cd262bb6068141c5eefe60dafaea59beef,8,103,28,131,17,2011-02-24 18:34:42,2011-02-24 18:34:42
6113b4cd262bb6068141c5eefe60dafaea59beef...9c5dd4adb5635f11cbcf79d637a3d4e05ddd03c9,1,4,0,4,1,2011-02-24 18:43:50,2011-02-24 18:43:50
9c5dd4adb5635f11cbcf79d637a3d4e05ddd03c9...29e9e126c821baaf4484f7ae7fcf71a858f0411c,1,1,1,2,1,2011-02-24 18:53:19,2011-02-24 18:52:56
29e9e126c821baaf4484f7ae7fcf71a858f0411c...f97ad3e767ec6b87eff54a23cb338adc0ededb20,1,2,2,4,2,2011-02-24 19:37:40,2011-02-24 19:37:40
f97ad3e767ec6b87eff54a23cb338adc0ededb20...4c4093adbee30855a16458068fa42f771f7237d5,4,141,11,152,11,2011-02-24 19:39:18,2011-02-24 19:39:18
b0545205b950bae680ddda3f048195ecc0b9fb37...2b05a2fcceadb1938a6b8def89b5a7b6df06dee7,1,9,16,25,3,2011-02-25 00:07:44,2011-02-25 00:07:19
2b05a2fcceadb1938a6b8def89b5a7b6df06dee7...7bf96ac92b1789655e23a49a31c671a52aeada75,1,0,9,9,7,2011-02-25 02:52:19,2011-02-25 02:52:19
7bf96ac92b1789655e23a49a31c671a52aeada75...201d0f5f342a31971015b78f2cf2bd1ee91a6324,1,8,9,17,7,2011-02-25 03:01:09,2011-02-25 03:01:09
201d0f5f342a31971015b78f2cf2bd1ee91a6324...64de0d729b7b5890a567dd0400b61f54a8701ce0,1,7,1,8,1,2011-02-25 05:02:07,2011-02-25 05:01:52
64de0d729b7b5890a567dd0400b61f54a8701ce0...5c3e71ac028a894351fc287302cfa3f5470fde1e,1,10,4,14,5,2011-02-25 18:50:24,2011-02-25 18:50:24
5c3e71ac028a894351fc287302cfa3f5470fde1e...4e38e78503c9f14cd5f72af9142408343a7e357e,1,840,0,840,1,2011-02-25 19:26:18,2011-02-25 19:25:22
4e38e78503c9f14cd5f72af9142408343a7e357e...626b7e2182298ac0591890f5660078c148b0e2cf,3,0,1425,1425,3,2011-02-25 19:26:18,2011-02-25 19:25:58
626b7e2182298ac0591890f5660078c148b0e2cf...dfa6ac6aadb174fbab60f6881f17ff6292e8334c,1,34,10,44,5,2011-02-25 21:13:16,2011-02-25 21:13:16
dfa6ac6aadb174fbab60f6881f17ff6292e8334c...97d4c5c7effb0c5fdf3c87affbba4ad6d6d2d077,1,6,1,7,5,2011-02-25 21:46:13,2011-02-25 21:45:58
97d4c5c7effb0c5fdf3c87affbba4ad6d6d2d077...a15ed6c45764aabb210d3d6868d704230e1a19b1,1,1,1,2,1,2011-02-26 05:35:49,2011-02-26 05:33:18
a15ed6c45764aabb210d3d6868d704230e1a19b1...02b4507e84993574938ad18ffe7996a22edb9b64,1,1,3,4,2,2011-02-26 05:35:49,2011-02-26 05:33:57
02b4507e84993574938ad18ffe7996a22edb9b64...b8337b7af21d919a885bd17e054641d1ae178378,1,1,1,2,1,2011-02-26 06:00:36,2011-02-26 06:00:36
b8337b7af21d919a885bd17e054641d1ae178378...3be9ac6efa7d418d9b97f6b0c71db157c1f6a82c,1,18,22,40,5,2011-02-26 16:02:55,2011-02-26 16:02:39
3be9ac6efa7d418d9b97f6b0c71db157c1f6a82c...357e8f0a222cade778ddb9f94b3a38b76fc00647,1,9,2,11,3,2011-02-26 16:45:10,2011-02-26 16:45:10
357e8f0a222cade778ddb9f94b3a38b76fc00647...095948e11e5c3968175273f6d5851e490802ef61,1,1,1,2,1,2011-02-27 02:20:08,2011-02-27 02:20:08
095948e11e5c3968175273f6d5851e490802ef61...c2b809bd675da36fa6214388947a57ea0221e229,1,29,9,38,14,2011-02-27 06:05:47,2011-02-27 06:05:47
c2b809bd675da36fa6214388947a57ea0221e229...7b12d390017f2b57fbdcadee5f6023c6e7a5efa7,1,1,1,2,1,2011-02-27 14:25:05,2011-02-27 14:25:05
7b12d390017f2b57fbdcadee5f6023c6e7a5efa7...733134f7da8c67f35096833539a101493968e84f,1,1,1,2,1,2011-02-27 16:15:20,2011-02-27 16:15:20
733134f7da8c67f35096833539a101493968e84f...6cea525c05c97b60315f37d1e5fb4af063bff610,4,11,6,17,4,2011-02-27 16:23:04,2011-02-27 16:23:04
6cea525c05c97b60315f37d1e5fb4af063bff610...0f533dd181c9807a47b1c6fe01206d7941c015f7,1,9,8,17,2,2011-02-27 18:35:32,2011-02-27 18:35:12
0f533dd181c9807a47b1c6fe01206d7941c015f7...77a039aec7109e6574954ae5fe353ec9db38800b,1,2,2,4,2,2011-02-28 07:00:12,2011-02-28 07:00:12
77a039aec7109e6574954ae5fe353ec9db38800b...7bf3c53a70eaa905ab3f5bdf7d76c17dfebed33f,2,22,1,23,5,2011-02-28 17:57:58,2011-02-28 17:57:43
7bf3c53a70eaa905ab3f5bdf7d76c17dfebed33f...8c6bf1776cf4c6fe2a99857e781f70dfa748197d,1,19,0,19,2,2011-02-28 18:20:37,2011-02-28 17:35:50
8c6bf1776cf4c6fe2a99857e781f70dfa748197d...cf07d57e5fa4ee15e5ffa4aaebb27b26764f41c8,1,1,1,2,1,2011-02-28 18:22:42,2011-02-28 18:22:42
cf07d57e5fa4ee15e5ffa4aaebb27b26764f41c8...665d7e5d2409fbec0812dc98bf1b2e7e24acd393,1,4,1,5,1,2011-02-28 18:43:43,2011-02-28 18:43:43
665d7e5d2409fbec0812dc98bf1b2e7e24acd393...f46d86c254f2ade330de5af4d80d174b6c51f2bc,1,6,0,6,1,2011-02-28 20:16:02,2011-02-28 20:15:45
f46d86c254f2ade330de5af4d80d174b6c51f2bc...81d0154d41c1c8416cfbe0f423614edca4834e36,1,13,11,24,2,2011-02-28 20:26:17,2011-02-28 20:26:17
81d0154d41c1c8416cfbe0f423614edca4834e36...95e224e65f5ea80e3aa8f65f66cd4d4e1bafb3ef,1,1,0,1,1,2011-02-28 20:30:51,2011-02-28 20:30:51
95e224e65f5ea80e3aa8f65f66cd4d4e1bafb3ef...b10942e94d1f9602809159d7ded57b6f5c4ef1f7,1,1,1,2,1,2011-02-28 20:46:06,2011-02-28 20:45:57
b10942e94d1f9602809159d7ded57b6f5c4ef1f7...b0488fdf7c8b84801022042508266e42f8f35a79,1,1,1,2,1,2011-02-28 21:09:48,2011-02-28 21:09:48
b0488fdf7c8b84801022042508266e42f8f35a79...7408b6aae6ddb62ca14bc9a183d6c3680e97d708,1,5,0,5,1,2011-02-28 21:56:46,2011-02-28 21:55:38
7408b6aae6ddb62ca14bc9a183d6c3680e97d708...88f00c904434264d79bd3e6ec945ef0cea847c54,1,35,24,59,14,2011-02-28 22:41:15,2011-02-28 22:40:35
88f00c904434264d79bd3e6ec945ef0cea847c54...b2ebbd04d716ab631f6caa8e51eecd1cc8b5e281,1,5,1,6,1,2011-02-28 23:16:58,2011-02-28 23:16:47
b2ebbd04d716ab631f6caa8e51eecd1cc8b5e281...6f73b51f8e2a040182eb97376c3debb3625ad669,1,2,0,2,1,2011-02-28 23:40:02,2011-02-28 23:40:02
6f73b51f8e2a040182eb97376c3debb3625ad669...8451714774bc9f4a5909621519bf0e802155eebf,2,2,2,4,2,2011-03-01 01:58:32,2011-03-01 01:58:09
8451714774bc9f4a5909621519bf0e802155eebf...8fb3dd54920aef9ca3791c48bfd5d90746335685,2,40,4,44,6,2011-03-01 07:37:58,2011-03-01 07:37:58
8fb3dd54920aef9ca3791c48bfd5d90746335685...68838eb4e642eac326a895b0ea14cfcfc1f86ed6,1,7,6,13,3,2011-03-01 13:05:51,2011-03-01 13:05:51
68838eb4e642eac326a895b0ea14cfcfc1f86ed6...a6ad2a147273f636641ccb1f66a76942f2016597,1,1,1,2,1,2011-03-01 15:50:39,2011-03-01 15:50:39
a6ad2a147273f636641ccb1f66a76942f2016597...654167180e15d049692f7aafd331a7f21a649936,3,12,1,13,4,2011-03-01 18:10:32,2011-03-01 18:09:53
654167180e15d049692f7aafd331a7f21a649936...244655b2ad204f8462b8f3ecfdd6f0cbbaa1dc16,1,1,1,2,1,2011-03-01 18:21:04,2011-03-01 18:06:03
244655b2ad204f8462b8f3ecfdd6f0cbbaa1dc16...e295d14d1d6ca0ed1508ed5a844a167430abf721,2,35,11,46,5,2011-03-01 18:21:04,2011-03-01 18:20:54
e295d14d1d6ca0ed1508ed5a844a167430abf721...737a20b8fa1cbf0f77bb602e8abcebfc65714271,16,1229,177,1406,101,2011-03-01 19:15:26,2011-02-15 23:08:59
737a20b8fa1cbf0f77bb602e8abcebfc65714271...622b8aee41a5edf19337fee9b92526401886958a,1,8,4,12,2,2011-03-01 19:45:31,2011-03-01 19:34:38
622b8aee41a5edf19337fee9b92526401886958a...bac77a4989dcb9aa02140a2d818bec002dc220a0,1,1,1,2,1,2011-03-01 19:56:46,2011-03-01 19:56:46
bac77a4989dcb9aa02140a2d818bec002dc220a0...a5ae1cfeb931261918a007919a04c62fa1cc53b4,3,18,2,20,5,2011-03-01 20:08:28,2011-03-01 20:07:56
a5ae1cfeb931261918a007919a04c62fa1cc53b4...e932625ade1ace4d030423b4e89f96c354c3d6f4,1,1,1,2,1,2011-03-01 20:09:44,2011-03-01 20:09:32
e932625ade1ace4d030423b4e89f96c354c3d6f4...1150cd0cd3aed9a140e960fb833eea107d5689dc,1,1,1,2,1,2011-03-01 20:28:54,2011-03-01 20:28:54
1150cd0cd3aed9a140e960fb833eea107d5689dc...f06b5db2146b02bee0a95b85a10545f9310132a3,2,7,1,8,3,2011-03-01 20:46:42,2011-03-01 20:46:27
f06b5db2146b02bee0a95b85a10545f9310132a3...ea825cd6c763f80d96a2199d196416dd9c6fafd8,1,12,0,12,1,2011-03-01 20:48:02,2011-03-01 20:47:23
ea825cd6c763f80d96a2199d196416dd9c6fafd8...df9b6cef28ed553f90ea644b6b0178e8a2785735,1,17,3,20,5,2011-03-01 21:06:06,2011-03-01 21:04:57
df9b6cef28ed553f90ea644b6b0178e8a2785735...4738e2f399268df116deb3a08dfe9730956dc3d7,1,199,132,331,51,2011-03-01 21:25:06,2011-03-01 21:24:48
4738e2f399268df116deb3a08dfe9730956dc3d7...e82ae13ca0e289e2b24230cf6f8acf694e70bafe,3,27,19,46,18,2011-03-01 22:02:06,2011-03-01 21:56:58
e82ae13ca0e289e2b24230cf6f8acf694e70bafe...9b534592f3c6ab152962e4ee5e03dd2e1f12e661,1,1,1,2,1,2011-03-01 23:05:15,2011-03-01 21:28:44
9b534592f3c6ab152962e4ee5e03dd2e1f12e661...eede4ec2fcb2f7c0ca2ac66765ea09fb435f628b,4,5,6,11,7,2011-03-01 23:05:15,2011-03-01 23:02:38
eede4ec2fcb2f7c0ca2ac66765ea09fb435f628b...ea8038f1a102c0e2d6e803b5bb826ffedd93f919,1,10,2,12,3,2011-03-02 01:18:37,2011-03-01 06:55:30
ea8038f1a102c0e2d6e803b5bb826ffedd93f919...bc81e2ac0c26649d2fbfb27d04dd650ca10c027c,1,1,1,2,1,2011-03-02 01:35:49,2011-03-02 01:35:49
bc81e2ac0c26649d2fbfb27d04dd650ca10c027c...c72895f779fa9d6b0f4dc62644aeff1d8970f3c8,1,2,0,2,1,2011-03-02 01:53:02,2011-03-02 01:53:02
c72895f779fa9d6b0f4dc62644aeff1d8970f3c8...df7248a721a0c722e0eec2ae5e018299bd41b982,2,7,5,12,3,2011-03-02 02:08:44,2011-03-02 02:08:44
df7248a721a0c722e0eec2ae5e018299bd41b982...0fe9db187a513e6ac0419dae5f06e9625ba3a209,4,11,7,18,6,2011-03-02 02:20:34,2011-03-02 02:20:34
0fe9db187a513e6ac0419dae5f06e9625ba3a209...40adfd5ebdd39afd980e8288cd52050f7ad48f6d,1,1,1,2,1,2011-03-02 04:58:58,2011-03-02 04:58:58
40adfd5ebdd39afd980e8288cd52050f7ad48f6d...ae21771238dd717aae9100c74cd90ddaa9f1eb1b,3,5,0,5,3,2011-03-02 05:46:22,2011-03-02 05:46:22
ae21771238dd717aae9100c74cd90ddaa9f1eb1b...73f4ee628caf10a1856a78ff817f927ac75572fe,2,2,2,4,2,2011-03-02 06:28:17,2011-03-02 06:28:17
73f4ee628caf10a1856a78ff817f927ac75572fe...66a43216b624b0c9b811823d31a78af6dc09523e,1,1,1,2,1,2011-03-02 06:52:35,2011-03-02 06:52:35
66a43216b624b0c9b811823d31a78af6dc09523e...8fcdd4c30e08380d730b4301a7e78f93de0de7f5,1,1,1,2,1,2011-03-02 06:54:19,2011-03-02 06:54:19
8fcdd4c30e08380d730b4301a7e78f93de0de7f5...5d1db756901d48dd5a3907232c6f7904aa65f9b3,2,4,2,6,2,2011-03-02 14:10:13,2011-03-02 14:10:13
5d1db756901d48dd5a3907232c6f7904aa65f9b3...d9db802056fd01a05c83a09a94a72a50af442c22,1,1,1,2,1,2011-03-02 14:10:20,2011-03-02 14:10:20
d9db802056fd01a05c83a09a94a72a50af442c22...7b4863aee6e9d09e11fbece86531c8c537c1759d,1,9,9,18,2,2011-03-02 15:29:24,2011-03-02 15:29:24
7b4863aee6e9d09e11fbece86531c8c537c1759d...52140f72137b2426554eafd2fb8145c6b66b07d0,1,35,0,35,1,2011-03-02 15:29:41,2011-03-02 15:29:41
52140f72137b2426554eafd2fb8145c6b66b07d0...af4a9aca5018c187ed782775a4a4115001e33622,2,2,2,4,2,2011-03-02 15:36:32,2011-03-02 15:36:32
af4a9aca5018c187ed782775a4a4115001e33622...928b65caed3c3025a4b15ae521ae277184711b9d,1,76,0,76,1,2011-03-02 15:40:32,2011-03-02 15:40:15
928b65caed3c3025a4b15ae521ae277184711b9d...a674f44fddc4934efe8acdb35d3382b1aaf9fa88,1,2,5,7,2,2011-03-02 15:58:31,2011-03-02 15:58:12
a674f44fddc4934efe8acdb35d3382b1aaf9fa88...8a8ede6c71e6d841a4d18178e10476456adba3f6,1,3,4,7,3,2011-03-02 16:28:15,2011-03-02 16:28:15
8a8ede6c71e6d841a4d18178e10476456adba3f6...7c4408194e26db0d503529fcb00aa227d15bc225,1,4,1,5,1,2011-03-02 16:53:50,2011-03-02 16:51:35
7c4408194e26db0d503529fcb00aa227d15bc225...2cb70dbb79da87294ef48df35f33a74dc79c8f6c,1,30,2,32,2,2011-03-02 16:57:58,2011-03-02 15:31:40
2cb70dbb79da87294ef48df35f33a74dc79c8f6c...daa11293a27ff05eff36a7bdc07216a31cdabf9b,1,126,0,126,1,2011-03-02 16:57:58,2011-03-02 15:34:06
daa11293a27ff05eff36a7bdc07216a31cdabf9b...11f3e9ddf13c2366d9d0ff6ec9795dc5d742bf79,1,17,2,19,3,2011-03-02 16:57:58,2011-03-02 16:56:47
11f3e9ddf13c2366d9d0ff6ec9795dc5d742bf79...4cb7f39d299fb5d1f6748ae1e1c9c62e048e4131,1,10,1,11,1,2011-03-02 17:41:07,2011-03-02 17:40:41
4cb7f39d299fb5d1f6748ae1e1c9c62e048e4131...9639c1a58c711602eea2b49fda38c2c0a5f7ba2d,3,1,12,13,4,2011-03-02 17:45:19,2011-03-02 17:39:57
9639c1a58c711602eea2b49fda38c2c0a5f7ba2d...1d972fce782c675c4f2af2c7e2eacbec17b0ff49,1,0,5,5,1,2011-03-02 17:45:21,2011-03-02 17:45:03
1d972fce782c675c4f2af2c7e2eacbec17b0ff49...571db521fa6f26c0524d178de489691249fbb978,1,33,10,43,15,2011-03-02 19:10:50,2011-03-02 19:10:09
571db521fa6f26c0524d178de489691249fbb978...084d38400e4abcd3ff729a620f65a8074b85390f,1,1,1,2,1,2011-03-02 20:34:10,2011-03-02 20:34:01
084d38400e4abcd3ff729a620f65a8074b85390f...0550b00028c6a669cd3b8aeb1498744f7e4b4cdc,1,0,126,126,1,2011-03-02 20:38:43,2011-03-02 20:38:43
0550b00028c6a669cd3b8aeb1498744f7e4b4cdc...8bee4e23551482d31913638540177e0a75e2cb67,1,22,2,24,2,2011-03-02 20:58:29,2011-03-02 20:17:53
8bee4e23551482d31913638540177e0a75e2cb67...79c994ddd814e7ebed53c3b600e2b268cf36fbec,1,1,0,1,1,2011-03-02 23:59:50,2011-03-02 23:47:27
79c994ddd814e7ebed53c3b600e2b268cf36fbec...63e3912a53af71397f4373e7febb36824477cbee,1,14,7,21,4,2011-03-03 03:13:05,2011-03-03 03:13:05
63e3912a53af71397f4373e7febb36824477cbee...f3dac0378400a2ae9cda51d25cc2387342eee216,1,3,0,3,1,2011-03-03 07:39:35,2011-03-03 07:39:12
f3dac0378400a2ae9cda51d25cc2387342eee216...6510ec1389f7d17c627c719bbae23dcbe26af39f,1,3,1,4,2,2011-03-03 08:12:55,2011-03-03 08:12:55
6510ec1389f7d17c627c719bbae23dcbe26af39f...0229a329b590d77c87d539e0e2146228c940c9b7,2,9,1,10,3,2011-03-03 15:15:10,2011-03-03 15:15:10
0229a329b590d77c87d539e0e2146228c940c9b7...68cbfd1e4871190ec5519d70516925a27c74d4b4,1,6,8,14,4,2011-03-03 17:20:49,2011-03-03 17:20:49
68cbfd1e4871190ec5519d70516925a27c74d4b4...15dcbf686676608578ac84a3343749a21712f94e,1,8,0,8,2,2011-03-03 18:12:35,2011-03-03 18:12:35
15dcbf686676608578ac84a3343749a21712f94e...9ccbf56791691b6b1342b6bd0556dbd9ef38a469,4,15,5,20,7,2011-03-03 19:57:36,2011-03-03 19:57:36
9ccbf56791691b6b1342b6bd0556dbd9ef38a469...4c9164cc671b1fdda3eacd531df7e3fdc439219e,1,6,1,7,4,2011-03-03 21:38:19,2011-03-03 21:38:01
4c9164cc671b1fdda3eacd531df7e3fdc439219e...540488c4bcf160660baaddbb07dba6c31092caa7,1,1,1,2,1,2011-03-03 21:47:49,2011-03-03 21:47:49
540488c4bcf160660baaddbb07dba6c31092caa7...8ccd4619486081d54081f9533005e16796580329,2,11,1,12,2,2011-03-03 21:56:10,2011-03-03 21:56:10
8ccd4619486081d54081f9533005e16796580329...451ecc7c36720728c26996a5850828a0311b2bc3,4,0,215,215,6,2011-03-03 22:50:59,2011-03-03 22:50:59
451ecc7c36720728c26996a5850828a0311b2bc3...a208c8d9e5a7918e8bf33d5308f57afd982c39d2,1,1,1,2,1,2011-03-04 00:29:49,2011-03-04 00:29:25
a208c8d9e5a7918e8bf33d5308f57afd982c39d2...08da1dee4e70f8720d299ceddb3786d0f13e60fe,1,1,2,3,2,2011-03-04 15:58:26,2011-03-04 15:58:26
08da1dee4e70f8720d299ceddb3786d0f13e60fe...ac8db92b1a31da4082ef47f7a7a40bca175a2f5f,1,9,1,10,1,2011-03-04 16:30:18,2011-02-10 17:05:01
ac8db92b1a31da4082ef47f7a7a40bca175a2f5f...dc1113c76335bb75c6add143c4328e5861a198de,1,1,1,2,1,2011-03-04 17:38:35,2011-03-04 17:36:45
dc1113c76335bb75c6add143c4328e5861a198de...fa4ed4c5dc79e21fc82f56619a497d2faca8307e,1,5,5,10,2,2011-03-04 18:21:17,2011-03-04 18:21:17
fa4ed4c5dc79e21fc82f56619a497d2faca8307e...204fe41b71491408589dd8abff7eb04efa68456e,1,2,2,4,1,2011-03-04 21:15:05,2011-03-04 21:15:05
204fe41b71491408589dd8abff7eb04efa68456e...cf1b25029ecbab3bf8b8fab3a7fa2963834060fd,1,6,2,8,3,2011-03-04 21:56:33,2011-03-04 21:56:33
cf1b25029ecbab3bf8b8fab3a7fa2963834060fd...cfb9d9bda452d55b3736129094781d2e0bda61a1,1,2,2,4,1,2011-03-04 21:56:46,2011-03-04 21:56:46
cfb9d9bda452d55b3736129094781d2e0bda61a1...82dfb712d7f7a47961408e5cf6a9487b1df3f39d,3,81,0,81,7,2011-03-04 22:01:37,2011-03-04 22:00:39
82dfb712d7f7a47961408e5cf6a9487b1df3f39d...f4ea64b9e9fb95faebdd57303c56f2f777dfdb1a,1,5,1,6,2,2011-03-04 22:22:33,2011-03-04 22:22:20
f4ea64b9e9fb95faebdd57303c56f2f777dfdb1a...b20e61fe65990813375c73b520f5be5be26c17c6,2,13,1,14,4,2011-03-05 23:11:04,2011-03-05 23:11:04
b20e61fe65990813375c73b520f5be5be26c17c6...2c025aa23e87bea82009e7ebbc748bbaa637fa15,1,2,2,4,2,2011-03-05 23:25:48,2011-03-05 23:25:48
2c025aa23e87bea82009e7ebbc748bbaa637fa15...a7c5ebf735ac92db6f62c12a2e7dd4dc753fb2fe,1,46,33,79,7,2011-03-06 07:51:18,2011-03-06 07:51:18
a7c5ebf735ac92db6f62c12a2e7dd4dc753fb2fe...afcf141e33a7d48ac396ea53125d0d8d71a33af7,1,45,0,45,1,2011-03-06 07:51:59,2011-03-06 07:51:59
afcf141e33a7d48ac396ea53125d0d8d71a33af7...16697486fd24dba42441e980458930a086a4b3b1,1,2,0,2,1,2011-03-06 20:22:04,2011-03-06 20:22:04
16697486fd24dba42441e980458930a086a4b3b1...fb591ace93d7ade9d86d5e2ce9f284e6b9b4baab,1,3,0,3,1,2011-03-06 20:26:14,2011-03-06 20:26:14
fb591ace93d7ade9d86d5e2ce9f284e6b9b4baab...edd22b17e352a93a5cd165d8ca3f9832dc372d71,1,2,1,3,2,2011-03-06 21:13:54,2011-03-06 21:13:54
edd22b17e352a93a5cd165d8ca3f9832dc372d71...e2636ded97669b063f302e867a11afabd4e34d3c,1,1,1,2,1,2011-03-06 22:04:37,2011-03-06 22:04:37
e2636ded97669b063f302e867a11afabd4e34d3c...7e56a7b2411730c57508a65b8e8d576e15fb90d5,1,103,58,161,16,2011-03-06 22:04:50,2011-03-06 22:04:50
7e56a7b2411730c57508a65b8e8d576e15fb90d5...b2fc358af31cabe3247787653ebc14c52d9249d2,3,199,1,200,3,2011-03-06 23:03:53,2011-03-06 23:03:53
b2fc358af31cabe3247787653ebc14c52d9249d2...b85ef57e224a722079db71df1d720ecb1d93eb41,1,6,5,11,4,2011-03-07 00:03:52,2011-03-07 00:03:52
b85ef57e224a722079db71df1d720ecb1d93eb41...382d7e21d3842bee948466914d16d28289823592,1,1,1,2,1,2011-03-07 02:05:57,2011-03-07 02:05:57
382d7e21d3842bee948466914d16d28289823592...28683f84647f088ecbcc4d6fec23f46b3be19193,1,20,2,22,1,2011-03-07 02:43:54,2011-03-07 02:43:54
28683f84647f088ecbcc4d6fec23f46b3be19193...82de6a0f3e8432824a65b8625c72f4fe8bcf95d7,1,4,4,8,4,2011-03-07 05:19:07,2011-03-07 05:19:07
82de6a0f3e8432824a65b8625c72f4fe8bcf95d7...2b145a4dec8fdcf6ca6e2e708bad94d5a0aca7e6,1,3,1,4,1,2011-03-07 13:15:18,2011-03-07 13:15:18
2b145a4dec8fdcf6ca6e2e708bad94d5a0aca7e6...049436fd5b352f7beff5d6648189fa1dcfa79f33,1,2,0,2,2,2011-03-07 15:35:33,2011-03-07 15:35:33
049436fd5b352f7beff5d6648189fa1dcfa79f33...bec1db9fc0cb03fd6fb94efd57f0dd7a6a30cf0a,1,1,1,2,1,2011-03-07 15:51:49,2011-03-07 15:51:22
bec1db9fc0cb03fd6fb94efd57f0dd7a6a30cf0a...509f17bc07183efa28869a76cf34aa6cfa03e525,1,0,2,2,2,2011-03-07 17:10:21,2011-03-07 17:06:19
509f17bc07183efa28869a76cf34aa6cfa03e525...8e7cdd22afc5cea2de4f3e55a17d0e11620c9900,2,7,4,11,7,2011-03-07 17:10:21,2011-03-07 17:09:23
8e7cdd22afc5cea2de4f3e55a17d0e11620c9900...719058066cbf1eddf358dad03b54ee3dc92e3cd7,1,3,5,8,3,2011-03-07 17:10:21,2011-03-07 17:09:41
719058066cbf1eddf358dad03b54ee3dc92e3cd7...507a393453307db7926e01f419258c3d3fbd541a,1,1,0,1,1,2011-03-07 17:14:23,2011-03-07 17:14:23
507a393453307db7926e01f419258c3d3fbd541a...fd3f3569c02f7a097768f7b75463b93f7698a098,1,1,1,2,1,2011-03-07 17:19:01,2011-03-07 17:19:01
fd3f3569c02f7a097768f7b75463b93f7698a098...93572fc05b83f3635abd1dc2d55aa810a46b8a83,1,22,0,22,1,2011-03-07 18:29:52,2011-03-03 05:27:50
93572fc05b83f3635abd1dc2d55aa810a46b8a83...8091e7ca7011c2c41f677a374c7f31813421318f,3,5,3,8,5,2011-03-07 20:17:43,2011-03-07 20:17:43
4c4093adbee30855a16458068fa42f771f7237d5...f77189cc8baa5e7a3b9da9e7851faf7c6d5a2b2e,16,760,2,762,16,2011-03-02 20:52:24,2011-03-02 20:52:24
f77189cc8baa5e7a3b9da9e7851faf7c6d5a2b2e...d2acbf5bac32818f30322eb19f8d031a19a5ba53,14,552,86,638,65,2011-03-04 22:49:23,2011-03-04 22:49:23
d2acbf5bac32818f30322eb19f8d031a19a5ba53...7a6e54b8f3638c8feafe1e850b92f42b02a42867,2,83,0,83,2,2011-03-04 22:49:52,2011-03-04 22:49:52
7a6e54b8f3638c8feafe1e850b92f42b02a42867...14a4eda40906f0bb767a57add4412ba04a33926e,16,648,252,900,39,2011-03-06 20:11:03,2011-03-06 20:11:03
14a4eda40906f0bb767a57add4412ba04a33926e...c0a5f0ae899437e1a773cd57e5651352fddcc281,8,257,53,310,55,2011-03-06 22:52:07,2011-03-06 22:52:07
c0a5f0ae899437e1a773cd57e5651352fddcc281...8ba89e8327d2ffc88a3274a9a12436e02e632bae,14,482,92,574,75,2011-03-11 01:19:53,2011-03-11 01:19:53
8ba89e8327d2ffc88a3274a9a12436e02e632bae...1d658811da60e483e2fc02c64688737d3fb9468c,5,21,19,40,18,2011-03-11 20:07:44,2011-03-11 20:07:44
1d658811da60e483e2fc02c64688737d3fb9468c...f59660211d40fab49594c22c3efe048b68a3cc06,15,723,81,804,55,2011-03-15 01:32:22,2011-03-15 01:32:22
f59660211d40fab49594c22c3efe048b68a3cc06...c574255520d53ec3d26872b20907e4c378e29602,6,156,33,189,29,2011-03-15 23:00:16,2011-03-15 23:00:16
c574255520d53ec3d26872b20907e4c378e29602...0acbb4aa00c1e5d17d748c896d19842ddbd58bf9,28,577,560,1137,180,2011-03-16 21:28:42,2011-03-16 21:28:42
0acbb4aa00c1e5d17d748c896d19842ddbd58bf9...44df861b49511661569476b0a1d1134ca4a3ce63,8,148,4,152,11,2011-03-16 22:08:08,2011-03-16 22:08:08
44df861b49511661569476b0a1d1134ca4a3ce63...7a190f50befbbce74c1dd3959f4d95190ac2f75b,2,6,0,6,2,2011-03-16 22:27:22,2011-03-16 22:27:22
7a190f50befbbce74c1dd3959f4d95190ac2f75b...1a5992170c35f1a2fcccafa302e2c4026742b5e2,19,962,128,1090,89,2011-03-23 00:30:08,2011-03-23 00:30:08
1a5992170c35f1a2fcccafa302e2c4026742b5e2...b1ab6ec0fe0d3ca122782acfee70d12d905bc46d,4,225,0,225,4,2011-03-23 21:51:28,2011-03-23 21:51:28
b1ab6ec0fe0d3ca122782acfee70d12d905bc46d...4c0007c6a3999cf9827a4a99da4f83b3b0b52afe,5,19,10,29,10,2011-03-25 17:38:43,2011-03-25 17:38:43
4c0007c6a3999cf9827a4a99da4f83b3b0b52afe...5a8de370175e4fe674f9f579cf84f9b12ce1b903,11,606,198,804,44,2011-03-28 22:22:16,2011-03-28 22:22:16
5a8de370175e4fe674f9f579cf84f9b12ce1b903...e61dead31aa13aa0d1b304670a242f27bd1aa6be,15,293,76,369,58,2011-03-29 01:26:16,2011-03-29 01:26:16
e61dead31aa13aa0d1b304670a242f27bd1aa6be...b7a303abc95fbf7117464e8314177bff82a18ea1,53,1397,2104,3501,67,2011-03-30 18:56:07,2011-03-30 18:56:07
b7a303abc95fbf7117464e8314177bff82a18ea1...0c34db79d494b6d00a2eeb5cd283802923f2cb90,18,3831,4158,7989,35,2011-03-30 21:09:45,2011-03-30 21:09:45
4c4093adbee30855a16458068fa42f771f7237d5...85f86d2766099eb4ef59b4a42e38a8d0943dd54a,1,2,1,3,2,2011-02-24 21:41:57,2011-02-24 21:41:57
85f86d2766099eb4ef59b4a42e38a8d0943dd54a...df7c3b2353e120e975583550e6e2dfb8c1ac9d55,1,15,9,24,1,2011-02-24 21:42:09,2011-02-24 21:42:09
8091e7ca7011c2c41f677a374c7f31813421318f...102afdad3e1de2b4475def7032e357b52c82ce6d,2,5,4,9,5,2011-03-07 21:19:15,2011-03-07 21:19:15
8091e7ca7011c2c41f677a374c7f31813421318f...fd7c3574030467116c8ff44f84f5d21a629d62b5,1,3,0,3,1,2011-03-07 20:26:04,2011-03-07 18:01:11
fd7c3574030467116c8ff44f84f5d21a629d62b5...e6d2aa60e513d0cc85668444cc7348bb17cfa2f6,1,7,1,8,1,2011-03-07 20:28:36,2011-03-07 20:28:36
c077fca275a0e7bde73c97de64dc8653b60270e4...40b99b58d7131270d9baaff513d9599e605587f3,2,1,1,2,1,2011-03-30 21:46:56,2011-03-30 21:46:56
40b99b58d7131270d9baaff513d9599e605587f3...0b936e36b587f15bbdfdd363a5c9d1b89a98c1bb,2,602,602,1204,1,2011-03-30 21:51:23,2011-03-30 21:51:23
0b936e36b587f15bbdfdd363a5c9d1b89a98c1bb...fbef84def5102c64a5cb42a2c37604f234161a28,8,809,718,1527,16,2011-03-31 19:50:28,2011-03-31 19:50:28
fbef84def5102c64a5cb42a2c37604f234161a28...1107a958b18c5edc49df69c8529836121d448eec,18,2420,1957,4377,34,2011-04-01 20:23:43,2011-04-01 20:23:43
5d70510d94442c91b758d0d64a654e1485f7979f...c6d2d29d42d5f0eb6bcd8611a6774adb9b89b31b,2,22,9,31,7,2011-03-07 21:28:24,2011-03-07 21:28:10
c6d2d29d42d5f0eb6bcd8611a6774adb9b89b31b...755d42db06d636baa2bc0ea5a7a3f64c28860233,1,4,1,5,1,2011-03-07 23:15:15,2011-03-07 23:15:15
755d42db06d636baa2bc0ea5a7a3f64c28860233...f4f39d2ea14774a5e11a356882fb1b6c1a86bf55,1,5,2,7,1,2011-03-08 01:59:44,2011-03-08 01:59:44
f4f39d2ea14774a5e11a356882fb1b6c1a86bf55...be7a644b31ecbf47418c7c622e4ce348f38b557a,1,2,1,3,1,2011-03-08 16:58:42,2011-03-08 16:58:42
be7a644b31ecbf47418c7c622e4ce348f38b557a...4842f430f5207626be70828d2acffd8087e469ae,1,1,1,2,1,2011-03-08 16:59:52,2011-03-08 16:59:52
4842f430f5207626be70828d2acffd8087e469ae...bcd73ab979fb01062ffc68610bfcf33e49e5459c,2,16,0,16,2,2011-03-08 18:47:22,2011-03-08 18:45:58
bcd73ab979fb01062ffc68610bfcf33e49e5459c...8125dc44c2f2744859f8310a40a0fc02fceded3d,1,3,2,5,2,2011-03-08 19:12:18,2011-03-08 19:12:18
8125dc44c2f2744859f8310a40a0fc02fceded3d...a2d0f05cb51de5f5d46c55a2107e901b86b2b258,1,7,2,9,2,2011-03-08 20:04:01,2011-03-07 18:35:10
a2d0f05cb51de5f5d46c55a2107e901b86b2b258...4cb0ecb905bfe01e60af54d9e46baad4844db88e,1,6,2,8,3,2011-03-08 20:04:01,2011-03-08 20:03:34
4cb0ecb905bfe01e60af54d9e46baad4844db88e...bf441d11413c3539212a57efc04ff90957309d57,1,1,47,48,3,2011-03-08 20:57:38,2011-03-08 20:57:20
bf441d11413c3539212a57efc04ff90957309d57...141df2310769d478123297c695a369dec03c8e22,2,65,12,77,14,2011-03-08 21:16:54,2011-03-08 21:10:01
141df2310769d478123297c695a369dec03c8e22...ba73b0a8cc914439a3d0d3a665e64344ed49e49c,1,1,1,2,1,2011-03-08 21:16:55,2011-03-08 21:12:37
ba73b0a8cc914439a3d0d3a665e64344ed49e49c...e071e5969c024a7071500942a83b6fccd7d58369,1,4,1,5,1,2011-03-08 21:16:55,2011-03-08 21:16:39
e071e5969c024a7071500942a83b6fccd7d58369...5a5097f9012c623ba4a7bd962e902105f6f96046,1,1,1,2,1,2011-03-08 21:21:56,2011-03-08 21:21:56
5a5097f9012c623ba4a7bd962e902105f6f96046...46396661455d3d4feb3fcc6a29e80b93db91cdbd,1,9,5,14,5,2011-03-08 21:26:01,2011-03-08 21:26:01
46396661455d3d4feb3fcc6a29e80b93db91cdbd...077f3ea317bb1b173b765972243580f42a68b132,1,2,0,2,1,2011-03-08 21:29:24,2011-03-08 21:29:24
077f3ea317bb1b173b765972243580f42a68b132...4ff4792ea09919d8752edba8bd3cec022df0a8af,1,1,1,2,1,2011-03-08 21:40:23,2011-03-08 21:40:23
4ff4792ea09919d8752edba8bd3cec022df0a8af...dad1e0614743991df06fbc57ba7e7b53e26d496b,1,4,0,4,1,2011-03-08 22:06:37,2011-03-07 02:09:02
dad1e0614743991df06fbc57ba7e7b53e26d496b...5d6f0a4fd003f05fb9c82483dd7d0a6383027b5a,1,20,17,37,6,2011-03-09 00:52:38,2011-03-09 00:52:38
5d6f0a4fd003f05fb9c82483dd7d0a6383027b5a...c2cee0989007df4cc5b7b082fed0b9c25835196c,2,11,1,12,4,2011-03-09 07:34:28,2011-03-09 07:34:28
c2cee0989007df4cc5b7b082fed0b9c25835196c...1af7baa5c14eb55ba3db6a6105a2855132288324,1,5,4,9,3,2011-03-09 07:43:38,2011-03-09 07:43:38
1af7baa5c14eb55ba3db6a6105a2855132288324...57a7eda88622fa44760d7bab8a9c7bdc13d27908,1,5,5,10,2,2011-03-09 15:22:53,2011-03-09 15:22:53
57a7eda88622fa44760d7bab8a9c7bdc13d27908...5771d2e2a1074a21ffb030fbf07aacbf23089775,1,6,9,15,6,2011-03-09 16:20:20,2011-03-09 16:20:20
5771d2e2a1074a21ffb030fbf07aacbf23089775...ed2303de56cee2ed08379ef42b83c116fec6f73f,1,2,2,4,2,2011-03-09 17:51:29,2011-03-09 17:51:29
ed2303de56cee2ed08379ef42b83c116fec6f73f...e92bdfba29dd9085689eecb5d38e0fa0bc11957f,1,1,1,2,1,2011-03-09 20:16:38,2011-03-09 20:16:38
e92bdfba29dd9085689eecb5d38e0fa0bc11957f...4115af00a891abde6fb1e2e0d1982d2c81b71b96,2,2,1,3,3,2011-03-09 22:20:02,2011-03-09 22:20:02
4115af00a891abde6fb1e2e0d1982d2c81b71b96...4480e0f3af1e96f8a7f6379f011254c69ee863f9,1,1,1,2,1,2011-03-10 16:10:47,2011-03-10 16:10:47
4480e0f3af1e96f8a7f6379f011254c69ee863f9...66ae70ace9766efd1431c3c79aba152198f2712a,1,2,2,4,2,2011-03-10 16:50:27,2011-03-10 16:50:27
66ae70ace9766efd1431c3c79aba152198f2712a...f26b64b49a7304c7d613a7a9f21eaabb437ac2a0,1,15,6,21,3,2011-03-10 16:50:40,2011-03-10 16:50:40
f26b64b49a7304c7d613a7a9f21eaabb437ac2a0...87de543df76dbcd0aeb0f93a40f12ee5df27bd88,1,1,1,2,1,2011-03-10 16:58:47,2011-03-10 16:58:47
87de543df76dbcd0aeb0f93a40f12ee5df27bd88...67f6128404e06a78110dce5d764ac047cccce221,1,2,0,2,1,2011-03-10 17:01:16,2011-03-10 17:01:16
67f6128404e06a78110dce5d764ac047cccce221...3e5e7edc4db48c35e3f775c7fd165dd2d48bb667,1,6,2,8,2,2011-03-10 17:11:29,2011-03-10 17:11:29
3e5e7edc4db48c35e3f775c7fd165dd2d48bb667...40c3772b11fac541f8c0d9c4a60a6a12a382ee73,2,25,1,26,6,2011-03-10 18:59:27,2011-03-10 18:59:27
40c3772b11fac541f8c0d9c4a60a6a12a382ee73...dc43ccdd8ea5e9030bd62eb0fb911aca3db5ddf3,1,5,1,6,2,2011-03-10 19:28:49,2011-03-10 19:28:49
dc43ccdd8ea5e9030bd62eb0fb911aca3db5ddf3...7550934069cdde1b561895ce73cd6e4dade9aaf4,1,0,2,2,1,2011-03-10 19:30:47,2011-03-10 19:30:47
7550934069cdde1b561895ce73cd6e4dade9aaf4...1740b023a8d053587611f9dab6fb1517c31b1263,1,8,0,8,1,2011-03-10 19:49:02,2011-03-10 19:49:02
1740b023a8d053587611f9dab6fb1517c31b1263...e1a725f37f974945ae111fd1c61ed08bfcefc94b,2,8,11,19,6,2011-03-10 20:58:47,2011-03-10 20:58:47
cede69df962cd673dff3861812dc6f886eeeac4f...54c2207e73091d5d0b15c14afe9e5816e4e46716,1,2,1,3,1,2011-04-01 21:08:06,2011-04-01 21:08:06
54c2207e73091d5d0b15c14afe9e5816e4e46716...ec400df462f77b78d409654f477ed8654dd4d01c,8,618,27,645,51,2011-04-05 00:16:44,2011-04-05 00:16:44
ec400df462f77b78d409654f477ed8654dd4d01c...818c262a13b12c0e09bee4a1d12ab0a3559dbf93,4,212,37,249,21,2011-04-05 14:53:11,2011-04-05 14:53:11
818c262a13b12c0e09bee4a1d12ab0a3559dbf93...7bcb756003ec7bdfaccb0549a9d52fedf0f9a797,5,253,118,371,42,2011-04-05 18:35:45,2011-04-05 18:35:45
7bcb756003ec7bdfaccb0549a9d52fedf0f9a797...337b7036945f6b872b91631cdc77c3acc7a52162,3,39,61,100,15,2011-04-05 22:21:30,2011-04-05 22:21:30
337b7036945f6b872b91631cdc77c3acc7a52162...21b793258dac44ca358bad134ee47d7c84e6e6ef,4,87,12,99,7,2011-04-06 15:50:27,2011-04-06 15:50:27
21b793258dac44ca358bad134ee47d7c84e6e6ef...df7691059ab9e3a8c9c92040d11b2f8f83aae1be,17,965,315,1280,138,2011-04-11 16:31:35,2011-04-11 16:31:35
df7691059ab9e3a8c9c92040d11b2f8f83aae1be...ae49305627859c4b18cebb3b82742953cd2f3b65,9,26,26,52,24,2011-04-11 16:53:18,2011-04-11 16:53:18
ae49305627859c4b18cebb3b82742953cd2f3b65...f9059d36d395d6f5d79eea268b480beb198da112,4,84,80,164,47,2011-04-11 17:46:54,2011-04-11 17:46:54
f9059d36d395d6f5d79eea268b480beb198da112...0d19a1f417a6584c787895e26f1e25dbdc7f1e72,21,543,532,1075,379,2011-04-11 19:36:56,2011-04-11 19:36:56
0d19a1f417a6584c787895e26f1e25dbdc7f1e72...ed3610fe6b84e8321606c1b617d9a1af8b3098f8,3,10,10,20,9,2011-04-11 20:13:27,2011-04-11 20:13:27
ed3610fe6b84e8321606c1b617d9a1af8b3098f8...fde9edb726e1dd1e3e2cca7df2716ac768ddddf7,2,10,9,19,6,2011-04-11 20:29:51,2011-04-11 20:29:51
fde9edb726e1dd1e3e2cca7df2716ac768ddddf7...f635a0ace78494d81172d35e67a7d91163c60445,6,248,170,418,21,2011-04-11 22:45:45,2011-04-11 22:45:45
f635a0ace78494d81172d35e67a7d91163c60445...0fef80ec499a7a5f0ffdd4a514de26de0a68219b,4,98,23,121,20,2011-04-14 22:35:58,2011-04-14 22:35:58
0fef80ec499a7a5f0ffdd4a514de26de0a68219b...4f1e156bde0b9543b583fe6a7985eecc06aae01c,10,57,92,149,51,2011-04-18 19:55:57,2011-04-18 19:55:57
4f1e156bde0b9543b583fe6a7985eecc06aae01c...84bd9c6029ae622f359aede1435fcd7687829a1f,3,28,7,35,8,2011-04-18 21:46:59,2011-04-18 21:46:59
84bd9c6029ae622f359aede1435fcd7687829a1f...d1b615a4a3b3427865ffe458675a993c7a44b7f0,3,193,1,194,4,2011-04-18 22:15:28,2011-04-18 22:15:28
d1b615a4a3b3427865ffe458675a993c7a44b7f0...f7dae9868bb238dfffa584e2e888befb2a7df7f0,7,34,6,40,15,2011-04-22 00:14:51,2011-04-22 00:14:51
f7dae9868bb238dfffa584e2e888befb2a7df7f0...4eb9993239f12a85502a3c653b6722b75714d98b,4,10,4,14,6,2011-04-22 01:05:57,2011-04-22 01:05:57
4eb9993239f12a85502a3c653b6722b75714d98b...797d28a3c75b8ffcf1b96e74af8be64cf563c317,2,10,1,11,2,2011-04-22 01:55:31,2011-04-22 01:55:31
797d28a3c75b8ffcf1b96e74af8be64cf563c317...ac4ab62ba3c59d2b76aa8a8473dc8f04b47f90fe,9,231,27,258,21,2011-04-27 00:51:20,2011-04-27 00:51:20
ac4ab62ba3c59d2b76aa8a8473dc8f04b47f90fe...ad348765235b88788faa12958d3265f10011bb28,2,2,2,4,2,2011-04-28 18:26:43,2011-04-28 18:26:43
ad348765235b88788faa12958d3265f10011bb28...5b77f1015090196ae4f77a330e93e95ad13405bb,13,258,36,294,52,2011-05-02 18:25:30,2011-05-02 18:25:30
5b77f1015090196ae4f77a330e93e95ad13405bb...7c80b83055b26bf88acad1c3736aee86fadbdb45,9,239,48,287,43,2011-05-03 21:35:18,2011-05-03 21:35:18
e1a725f37f974945ae111fd1c61ed08bfcefc94b...35f40670789d355f10542ec1b1cc51ff3618f1b3,6,133,24,157,24,2011-03-11 16:36:06,2011-03-11 16:36:06
e1a725f37f974945ae111fd1c61ed08bfcefc94b...8fbe4ead7832e57f602b235091c9a4a8bea75eab,2,503,86,589,93,2011-03-11 08:32:51,2011-03-11 08:32:26
2bb3c81228e50fef1a1f145a5fd390661827b18a...e80808c82730d1cf1615ce107b430e58a44a1460,11,452,96,548,36,2011-05-05 01:49:40,2011-05-05 01:49:40
e80808c82730d1cf1615ce107b430e58a44a1460...b4f7ca8055e8f92ce28fe24e7c4b42cb5be5452c,3,57,21,78,8,2011-05-05 23:51:25,2011-05-05 23:51:25
691c13e94739785f236b11aee53f724a98531c7f...c0b23b4511aaa37f9c8cd4ad0b8bf39ee90827de,1,2,2,4,2,2011-03-11 17:05:11,2011-03-11 16:52:41
c0b23b4511aaa37f9c8cd4ad0b8bf39ee90827de...597a1ffcc11f36af491eadf679bae7bc338c6f10,2,7,13,20,8,2011-03-11 17:05:11,2011-03-11 16:55:46
597a1ffcc11f36af491eadf679bae7bc338c6f10...fc4d134ae7a3bc9ad1d433977d88fd84107e7335,1,1,0,1,1,2011-03-11 17:05:11,2011-03-11 17:05:05
fc4d134ae7a3bc9ad1d433977d88fd84107e7335...df2913a7a01ec911bc95be243df4ce718ba1dad4,1,1,1,2,1,2011-03-11 17:44:23,2011-03-11 17:44:23
df2913a7a01ec911bc95be243df4ce718ba1dad4...7e9c5f3dcaff349489f3cd342afa42c2830113e9,2,21,9,30,5,2011-03-11 18:52:15,2011-03-11 18:52:02
7e9c5f3dcaff349489f3cd342afa42c2830113e9...e6d61f1c9345d7dc14fac8b4376f05d394546d22,1,2,0,2,1,2011-03-11 21:03:30,2011-03-11 20:59:18
e6d61f1c9345d7dc14fac8b4376f05d394546d22...f8c7144e2952b5fad59a73f088ac0a43f8eb59cf,1,5,0,5,2,2011-03-11 21:10:23,2011-03-11 21:10:17
f8c7144e2952b5fad59a73f088ac0a43f8eb59cf...6bb9cfc64b8ffb9ecd73728580d248af1ed7ba54,2,5,14,19,4,2011-03-11 21:37:19,2011-03-11 21:24:01
6bb9cfc64b8ffb9ecd73728580d248af1ed7ba54...05166dadcd40e320e56ba2dd3cb3f5889c435a5f,1,8,3,11,4,2011-03-11 21:38:55,2011-03-11 21:38:50
05166dadcd40e320e56ba2dd3cb3f5889c435a5f...3d6f23651f9df9974f02595d8f402f28f1fc361d,1,0,1,1,1,2011-03-11 21:51:14,2011-03-11 21:51:14
3d6f23651f9df9974f02595d8f402f28f1fc361d...27c2d5f2a276b5bc90d4de703932d1c0885dabdf,1,58,0,58,1,2011-03-11 21:51:55,2011-03-11 21:51:55
27c2d5f2a276b5bc90d4de703932d1c0885dabdf...67f71fe7740273e74549d00f473ba2f4b89daa50,1,2,0,2,2,2011-03-11 21:57:32,2011-03-11 21:57:18
67f71fe7740273e74549d00f473ba2f4b89daa50...c189e6b79db2bff4e296f9dbffe9130149af3c38,1,1,1,2,1,2011-03-11 22:29:22,2011-03-11 22:29:22
c189e6b79db2bff4e296f9dbffe9130149af3c38...8789244d12ce8c7b3baef51b6c15b435171ae1ab,1,3,3,6,2,2011-03-11 22:39:09,2011-03-11 22:39:09
8789244d12ce8c7b3baef51b6c15b435171ae1ab...70bb57ce544ef676c892385c1d422fc92ab57139,1,1,1,2,1,2011-03-13 00:00:43,2011-03-13 00:00:43
70bb57ce544ef676c892385c1d422fc92ab57139...b54cad165e45e567461144032dfe9e367058ef10,1,5,5,10,5,2011-03-13 00:01:21,2011-03-13 00:01:21
b54cad165e45e567461144032dfe9e367058ef10...3223fbae4d52225164344b687dc89975298a3430,5,38,49,87,19,2011-03-13 00:40:06,2011-03-13 00:40:06
6170b49c5891915097f4ac02de128c1474775504...fda10ac41ad9bf2f6a88990aa8f6018ecaddb661,5,59,8,67,10,2011-05-06 22:07:50,2011-05-06 22:07:50
fda10ac41ad9bf2f6a88990aa8f6018ecaddb661...7e365f2704d21ddff79ac45c6a6e320dba05cc7f,23,1122,648,1770,410,2011-05-12 16:57:29,2011-05-12 16:57:29
7e365f2704d21ddff79ac45c6a6e320dba05cc7f...ba53b941e677a85c63f75cd2fa8bcfd39f01bc1d,3,65,10,75,16,2011-05-12 22:32:13,2011-05-12 22:32:13
ba53b941e677a85c63f75cd2fa8bcfd39f01bc1d...702c5b09a8950428fdde61573a899b6699ca3d6d,9,406,199,605,77,2011-05-19 02:24:34,2011-05-19 02:24:34
702c5b09a8950428fdde61573a899b6699ca3d6d...c4208ca296dd1696218dd1ccbe684bffb2223726,3,24,4,28,8,2011-05-26 00:16:35,2011-05-26 00:16:35
c4208ca296dd1696218dd1ccbe684bffb2223726...2307281a4df10c75edce290301c495a1f56787a7,9,94,90,184,36,2011-05-26 20:54:23,2011-05-26 20:54:23
2307281a4df10c75edce290301c495a1f56787a7...5877a88cc01080a9de46b46f20c12d7fc1577243,6,450,1,451,6,2011-05-28 01:04:17,2011-05-28 01:04:17
5877a88cc01080a9de46b46f20c12d7fc1577243...a963ccb7896c18775b3f1e02cfece69905376f17,1,362,1,363,2,2011-05-31 18:58:57,2011-05-31 18:58:57
a963ccb7896c18775b3f1e02cfece69905376f17...77c68822805c0ddca8eb0092e3e35ebb445eb931,1,311,0,311,8,2011-05-31 20:33:24,2011-05-31 20:33:24
77c68822805c0ddca8eb0092e3e35ebb445eb931...a1f3114c84b23eb502e1eb6701315c73d39003b5,3,108,30,138,9,2011-05-31 22:32:30,2011-05-31 22:32:30
a1f3114c84b23eb502e1eb6701315c73d39003b5...d980d6f352dd5a4e1af54a98a5a432a1ef0950a5,7,155,14,169,18,2011-06-02 01:11:39,2011-06-02 01:11:39
d980d6f352dd5a4e1af54a98a5a432a1ef0950a5...ffe1ea0b5e67ba187cde79087065928d4e761402,10,517,13,530,23,2011-06-03 00:02:14,2011-06-03 00:02:14
3223fbae4d52225164344b687dc89975298a3430...77fca13149ffce72515b1cc09bfe65bc9c333d8c,2,7,26,33,4,2011-03-14 13:43:22,2011-03-14 13:43:22
3223fbae4d52225164344b687dc89975298a3430...3058cac971cc4d3b675eeaf35d1a341f919f8d24,1,47,0,47,1,2011-03-13 18:54:16,2011-03-13 18:54:16
f5ac45487cce0cfbe837bdb21b2464efeeaaa482...15e883cc8b668f0c9948d7752e76a5bd99120ad2,1,40,0,40,1,2011-06-06 19:54:57,2011-06-06 19:54:57
15e883cc8b668f0c9948d7752e76a5bd99120ad2...edaa0577b56906c6732dcbff3db41ca0056089c5,1,61,0,61,1,2011-06-13 19:04:13,2011-06-13 19:04:13
edaa0577b56906c6732dcbff3db41ca0056089c5...e89f76adccde58dd425498cb96796d0e3f386a82,7,124,69,193,18,2011-06-14 22:38:47,2011-06-14 22:38:47
cbd9c7ef478bddb51653661b2127ebe1cdf0fb3d...4b3f73ee93defb897a2dcea1696776be377544c8,1,22,0,22,1,2011-03-14 16:36:53,2011-03-14 16:36:53
4b3f73ee93defb897a2dcea1696776be377544c8...f027a8dbc746412ea4b45a3a6563d4f591059b06,3,22,13,35,8,2011-03-14 16:50:44,2011-03-14 16:50:44
f027a8dbc746412ea4b45a3a6563d4f591059b06...2d44964a8329d87be67a323f5e523b30c42ed22e,1,2,2,4,2,2011-03-14 17:58:17,2011-03-14 17:58:17
2d44964a8329d87be67a323f5e523b30c42ed22e...0f992d070164f1660989b7ac28afea920dc74c08,1,1,1,2,1,2011-03-14 20:27:58,2011-03-14 20:26:58
0f992d070164f1660989b7ac28afea920dc74c08...2fb5c66361e9a2cfa95e28f29f40d2b19cc785e2,1,2,6,8,1,2011-03-14 21:55:43,2011-03-14 21:54:11
e89f76adccde58dd425498cb96796d0e3f386a82...be3c46697591d128e0dea9ac4913428d364ca73c,15,33,33,66,21,2011-06-20 23:25:00,2011-06-20 23:25:00
e89f76adccde58dd425498cb96796d0e3f386a82...04284b03e7b376e7a2fc6f6f04016afb2bd6c83c,2,83,8,91,5,2011-06-20 18:01:31,2011-06-20 18:01:31
04284b03e7b376e7a2fc6f6f04016afb2bd6c83c...65110ba42eb8d34f528c45bf65ad6616710f425b,2,55,0,55,3,2011-06-20 18:19:04,2011-06-20 18:18:50
65110ba42eb8d34f528c45bf65ad6616710f425b...72841b7fa262961c2692b7556d5bbb0e607b23db,1,56,0,56,1,2011-06-20 18:49:09,2011-06-20 18:49:09
72841b7fa262961c2692b7556d5bbb0e607b23db...7c5e72eda1ebd77c82292ec46b08ba2c92681241,1,10,3,13,1,2011-06-20 19:06:50,2011-06-20 19:06:50
7c5e72eda1ebd77c82292ec46b08ba2c92681241...ee8ee88caf732aeec3c60534d80f3013f7a4581e,2,61,0,61,3,2011-06-21 13:12:07,2011-06-21 13:12:07
2fb5c66361e9a2cfa95e28f29f40d2b19cc785e2...ac0c7d40fc007bd141d9d0295c804e77e8bf691d,5,53,22,75,22,2011-03-15 14:22:11,2011-03-15 14:22:11
2fb5c66361e9a2cfa95e28f29f40d2b19cc785e2...6ebf0c03153113927cf28dd5151bdd0cc9a2eead,1,14,1,15,3,2011-03-15 04:17:16,2011-03-15 04:17:16
6ebf0c03153113927cf28dd5151bdd0cc9a2eead...b0389990c749443da2532696257f71b8ad56d475,2,44,22,66,25,2011-03-15 07:08:37,2011-03-15 06:59:07
8c62ce92d619f6799ea826b728c72c5cbbfc39b3...607484cd85c9ecc94bb82ea82ab0ec68036c43aa,1,15,4,19,2,2011-03-15 18:31:18,2011-03-15 18:31:18
607484cd85c9ecc94bb82ea82ab0ec68036c43aa...eb4f769c97525d3b701c8d2c4842694185e8ba1e,1,1,1,2,1,2011-03-15 19:25:42,2011-03-15 19:24:44
eb4f769c97525d3b701c8d2c4842694185e8ba1e...f14bb068505dcb6131b39b327f446525c9eb5370,6,30,0,30,10,2011-03-15 20:27:12,2011-03-15 20:22:47
f14bb068505dcb6131b39b327f446525c9eb5370...729f9caf51e2c82aa9a1b2493829b827610748ab,6,127,31,158,20,2011-03-15 23:16:02,2011-03-15 23:11:53
729f9caf51e2c82aa9a1b2493829b827610748ab...193ab1ee75398945649fe1c149f3b135a995e704,1,1,1,2,1,2011-03-16 00:07:28,2011-03-16 00:06:57
193ab1ee75398945649fe1c149f3b135a995e704...3c0b1c8e6d679f83e6a7b6e19a3f8f3df1432235,1,1,1,2,1,2011-03-16 05:39:30,2011-03-16 05:39:30
3c0b1c8e6d679f83e6a7b6e19a3f8f3df1432235...4d10d2228501500ed661d0690dadb7e60d3072fb,1,2,2,4,2,2011-03-16 05:44:01,2011-03-16 05:44:01
4d10d2228501500ed661d0690dadb7e60d3072fb...39942c950a02ff68ad2d8fb86267d1c94d4434ca,1,2,2,4,2,2011-03-16 15:14:28,2011-03-16 15:14:28
39942c950a02ff68ad2d8fb86267d1c94d4434ca...40b9bee42bc3302515028c9053823569eb85467c,2,14,6,20,2,2011-03-16 15:52:55,2011-03-16 15:52:55
40b9bee42bc3302515028c9053823569eb85467c...802c11fbc082a93a6ebd2beb4aee3012916d75dc,1,11,1,12,2,2011-03-16 16:33:54,2011-03-16 16:33:54
802c11fbc082a93a6ebd2beb4aee3012916d75dc...a7727d9c5e75da140b452a70f14ffec03f118b9c,1,3,0,3,2,2011-03-16 19:21:36,2011-03-16 19:19:23
a7727d9c5e75da140b452a70f14ffec03f118b9c...db1f1749c67143f0b80f7e88f3c47ce273221b13,1,1,1,2,1,2011-03-16 19:21:36,2011-03-16 19:20:43
db1f1749c67143f0b80f7e88f3c47ce273221b13...8b947f035d6e04c4b2a817c9c6b18b3e8c8379bf,1,2,1,3,2,2011-03-16 21:02:51,2011-03-16 21:02:29
8b947f035d6e04c4b2a817c9c6b18b3e8c8379bf...2b58bd890423fded08dc2c92fba38b9c9559b917,7,22,14,36,16,2011-03-16 21:25:53,2011-03-11 18:51:45
2b58bd890423fded08dc2c92fba38b9c9559b917...7b2a336ed118aa25f17d1b5da9eb2dc242c65b06,1,13,1,14,4,2011-03-16 21:25:53,2011-03-11 22:06:41
7b2a336ed118aa25f17d1b5da9eb2dc242c65b06...65bc193d30d3d3be77d676451429624377403271,1,4,2,6,2,2011-03-18 06:45:42,2011-03-18 06:45:42
7b2a336ed118aa25f17d1b5da9eb2dc242c65b06...7b37afefca2522b364ea0acaf913bf061f65b5dc,1,2,0,2,1,2011-03-17 00:08:27,2011-03-15 18:39:39
7b37afefca2522b364ea0acaf913bf061f65b5dc...635c70d61651f587dfdcfd232196b9084783cb9b,1,121,0,121,1,2011-03-17 00:08:27,2011-03-15 18:40:26
635c70d61651f587dfdcfd232196b9084783cb9b...5138460a7d80cfa349d9b1f3d795ee4537dbfbb4,1,23,15,38,3,2011-03-17 00:08:29,2011-03-16 18:51:43
5138460a7d80cfa349d9b1f3d795ee4537dbfbb4...697c7b337cbd0e13429f76fe8ae011dd8ab290cd,1,1,0,1,1,2011-03-17 00:08:30,2011-03-16 18:52:32
697c7b337cbd0e13429f76fe8ae011dd8ab290cd...3d38c57b93d0690a79fdead41d7a2d17452aa182,1,29,9,38,10,2011-03-17 04:34:56,2011-03-17 04:34:56
3d38c57b93d0690a79fdead41d7a2d17452aa182...c6eb45970e091da6dcd2d0d71cc84538636c5495,1,1,1,2,1,2011-03-17 05:28:43,2011-03-17 03:51:11
c6eb45970e091da6dcd2d0d71cc84538636c5495...4e4bac9297e83e2ada2e1f59702f9caf10eba143,1,0,1,1,1,2011-03-17 05:28:43,2011-03-17 04:03:10
4e4bac9297e83e2ada2e1f59702f9caf10eba143...c983ac5fc9f5d16a117f2a4a2614984618677fe1,1,0,1,1,1,2011-03-17 05:40:22,2011-03-17 05:40:22
c983ac5fc9f5d16a117f2a4a2614984618677fe1...92bc7c6021798c8ee772b9d79024cc0c8ef105e1,2,14,8,22,10,2011-03-17 05:45:53,2011-03-17 05:45:53
92bc7c6021798c8ee772b9d79024cc0c8ef105e1...0b4f7be174288c9a9687174ddcd2f69ba64f1fb6,1,2,0,2,1,2011-03-17 06:17:21,2011-03-17 06:17:21
0b4f7be174288c9a9687174ddcd2f69ba64f1fb6...a728eb33a0a9bad40f2c7d39d1d5f51734fa94df,1,3,8,11,4,2011-03-17 06:17:31,2011-03-17 06:17:31
a728eb33a0a9bad40f2c7d39d1d5f51734fa94df...2b04fcbfd8424653f1065b134861df92382ce9e8,4,231,145,376,92,2011-03-17 14:44:59,2011-03-04 21:54:37
2b04fcbfd8424653f1065b134861df92382ce9e8...b2de82de5deadb659429ca47f7f83dff6c2ecc61,4,112,54,166,18,2011-03-17 15:49:24,2011-03-17 15:49:24
b2de82de5deadb659429ca47f7f83dff6c2ecc61...c1d1016a48867ee33c9bc65f0e6fb1e8de835989,4,23,66,89,5,2011-03-17 15:55:55,2011-03-17 15:55:55
c1d1016a48867ee33c9bc65f0e6fb1e8de835989...2e7514262a51baae23c5c57dabc8a24f7f934510,1,1,1,2,1,2011-03-17 15:56:38,2011-03-17 15:34:10
2e7514262a51baae23c5c57dabc8a24f7f934510...ea930f7170542ddd4ba5433c1fa7a5672838d6f0,2,5,7,12,4,2011-03-17 16:08:08,2011-03-17 16:08:08
ea930f7170542ddd4ba5433c1fa7a5672838d6f0...ead5ec842d2b43fa57ef98acbf5b1f18c2117367,2,20,3,23,4,2011-03-17 16:17:11,2011-03-17 16:16:46
ead5ec842d2b43fa57ef98acbf5b1f18c2117367...9f8f03d75c733d2c80bf5b1076eea6fc9f9d65a6,1,1,1,2,1,2011-03-17 16:22:39,2011-03-16 16:53:28
9f8f03d75c733d2c80bf5b1076eea6fc9f9d65a6...fc829317a160ed04a67011003ceda5e6671f6cc8,1,11,10,21,8,2011-03-17 16:22:40,2011-03-17 16:22:08
fc829317a160ed04a67011003ceda5e6671f6cc8...9f74a0132cf2d78bf15e004f2924c58143849adf,1,3,3,6,4,2011-03-17 16:22:42,2011-03-17 16:22:23
9f74a0132cf2d78bf15e004f2924c58143849adf...c0dc0be108b09a94ac6ce571869266e7f24c68c6,2,3,0,3,2,2011-03-17 16:32:30,2011-03-17 16:30:24
c0dc0be108b09a94ac6ce571869266e7f24c68c6...3a87fcc1bb84a3cde9d031506d7eaf4a0bd7d3f6,1,1,0,1,1,2011-03-17 16:35:10,2011-03-17 16:34:53
3a87fcc1bb84a3cde9d031506d7eaf4a0bd7d3f6...5417d9fdbb4187f5a8c4facae9d2ea22c4dae6b2,1,0,1,1,1,2011-03-17 16:47:48,2011-03-17 16:47:28
5417d9fdbb4187f5a8c4facae9d2ea22c4dae6b2...12a4af1c493d77ea54419dada3c46571d4cb7abb,1,25,4,29,1,2011-03-17 17:18:02,2011-03-17 17:16:57
12a4af1c493d77ea54419dada3c46571d4cb7abb...51ade53e0ede7a2237c98564d4c695d4f92c91db,1,0,2,2,2,2011-03-17 17:18:04,2011-03-17 17:17:12
51ade53e0ede7a2237c98564d4c695d4f92c91db...33257d4b57020e92aec415adf16c9d183491857a,1,1,1,2,1,2011-03-17 17:18:05,2011-03-17 17:17:39
33257d4b57020e92aec415adf16c9d183491857a...43fb70dfe38c8c006bff8d77c41b257bbe6722ae,1,4,2,6,1,2011-03-17 17:52:12,2011-03-17 17:51:52
43fb70dfe38c8c006bff8d77c41b257bbe6722ae...4341737a9a08c8beb2f13258418aabec73f3b5c6,1,0,0,0,0,2011-03-17 18:50:38,2011-03-17 17:10:54
4341737a9a08c8beb2f13258418aabec73f3b5c6...6db701512057c1c017bd0069a27abcf2da705de0,2,3,4,7,3,2011-03-17 18:50:38,2011-03-17 18:25:05
6db701512057c1c017bd0069a27abcf2da705de0...c7858afaff8b2eab6638199086cf2a45aff66774,1,2,2,4,2,2011-03-17 18:50:38,2011-03-17 18:37:06
c7858afaff8b2eab6638199086cf2a45aff66774...676db17f512e39db5c9997e90ed12956a9b62630,2,35,25,60,9,2011-03-17 18:50:38,2011-03-17 18:49:49
676db17f512e39db5c9997e90ed12956a9b62630...783dc5a72155e2c73236f01490e5fc1b35968f79,2,4,5,9,3,2011-03-17 18:50:38,2011-03-17 18:50:18
783dc5a72155e2c73236f01490e5fc1b35968f79...d3a9fe9ae236b7b3013533453c0b33fd94051bb6,2,14,11,25,9,2011-03-17 18:52:01,2011-03-17 18:51:26
d3a9fe9ae236b7b3013533453c0b33fd94051bb6...72f549af6331ebee34ae70d97a7f8e52298470d3,11,388,87,475,70,2011-03-17 18:57:23,2011-03-17 18:56:03
72f549af6331ebee34ae70d97a7f8e52298470d3...2c0e128f7f3ee60a614bfa7afb502a76968e838c,1,1,1,2,1,2011-03-17 19:26:26,2011-03-17 19:26:12
2c0e128f7f3ee60a614bfa7afb502a76968e838c...550850e719624dd1aae6a8a41c61970795ab8359,1,1,1,2,1,2011-03-17 19:30:39,2011-03-17 19:30:39
550850e719624dd1aae6a8a41c61970795ab8359...c31719663ee0ae75d42ac0db429f1ac762b46b41,2,15,0,15,5,2011-03-17 19:34:40,2011-03-17 19:34:19
c31719663ee0ae75d42ac0db429f1ac762b46b41...a694a7169055c83e03664d34d784049ffb93d42b,2,86,60,146,22,2011-03-17 20:47:37,2011-03-17 20:47:23
a694a7169055c83e03664d34d784049ffb93d42b...12cbfefae2cbc9cea292ff564d495806b74f9762,1,6,0,6,2,2011-03-17 21:06:47,2011-03-17 21:06:47
12cbfefae2cbc9cea292ff564d495806b74f9762...1ef7155a4e48629bf94c5f6083f35eae4b17b2da,2,4,0,4,2,2011-03-17 21:32:36,2011-03-17 21:31:16
1ef7155a4e48629bf94c5f6083f35eae4b17b2da...c46e46308ccff8fe95d2ebc2554cb447438f3623,1,1,1,2,1,2011-03-17 22:59:05,2011-03-17 22:59:05
c46e46308ccff8fe95d2ebc2554cb447438f3623...23d2fb66a1f4c5ffb29c67405541fdb31ed78e1f,1,6,6,12,2,2011-03-18 01:12:46,2011-03-17 19:53:34
23d2fb66a1f4c5ffb29c67405541fdb31ed78e1f...2775fa3e2b8a4a29abf9cc2480aa08033e491856,5,31,10,41,13,2011-03-18 01:12:46,2011-03-17 22:22:03
2775fa3e2b8a4a29abf9cc2480aa08033e491856...7429a7411a622a01d25dea3bd76d2af9e6fc77cc,1,6,3,9,4,2011-03-18 01:12:46,2011-03-17 22:39:43
7429a7411a622a01d25dea3bd76d2af9e6fc77cc...1f0b0fe089e31e159344a9472513c31d5c577318,3,47,24,71,13,2011-03-18 01:12:46,2011-03-18 01:08:36
2500b9b9f38adec3430ce729170a3c5f09295a0d...4ba34752e43c6823cdc483ddcbb9e805cbf79e27,1,12,4,16,4,2011-06-27 21:04:30,2011-06-27 21:04:30
4ba34752e43c6823cdc483ddcbb9e805cbf79e27...c95a7e6df430eefcf79846369a19facbb81ec89e,5,172,0,172,9,2011-06-28 13:42:03,2011-06-28 13:42:03
c95a7e6df430eefcf79846369a19facbb81ec89e...48e73dce72c5b5664397c132ed65f37ca91cbdd7,3,84,0,84,4,2011-06-28 13:57:51,2011-06-28 13:57:51
48e73dce72c5b5664397c132ed65f37ca91cbdd7...b9afca9db946f00aa7e1e0a213c223b7c5c1f38b,3,82,1,83,5,2011-06-28 14:39:17,2011-06-28 14:37:21
b9afca9db946f00aa7e1e0a213c223b7c5c1f38b...98c38bc73568f1d5143b6f9dae4be3c1a5bed03c,3,96,0,96,4,2011-06-28 15:23:22,2011-06-28 15:23:22
98c38bc73568f1d5143b6f9dae4be3c1a5bed03c...976528764d99d6ee768e3ec8f6da3f5952e1a196,4,74,0,74,5,2011-07-01 14:10:16,2011-07-01 14:10:16
976528764d99d6ee768e3ec8f6da3f5952e1a196...5ae3e74d9ce6790ba1bf9ec870d8b57b005814ea,2,73,0,73,3,2011-07-01 17:34:31,2011-07-01 17:34:31
5ae3e74d9ce6790ba1bf9ec870d8b57b005814ea...d829bfd6b4bc45bca90bec05cebb19a6dafb5c5f,2,65,0,65,3,2011-07-01 17:45:24,2011-07-01 17:45:24
d829bfd6b4bc45bca90bec05cebb19a6dafb5c5f...73c823c99629b427413ea8390a3f6301ba5bb0bf,2,50,0,50,3,2011-07-01 17:55:52,2011-07-01 17:55:52
73c823c99629b427413ea8390a3f6301ba5bb0bf...4ac230f28676febbca8419e545bc94c97da51e4c,2,150,0,150,9,2011-07-01 19:41:11,2011-07-01 19:41:11
4ac230f28676febbca8419e545bc94c97da51e4c...60192352c9419278c4a94e877756c5eee8fe570d,2,22,22,44,17,2011-07-01 20:04:16,2011-07-01 20:04:16
60192352c9419278c4a94e877756c5eee8fe570d...dc29515edff9a3e2fee02ad62e99c5535e4fd01e,1,33,31,64,14,2011-07-01 20:33:47,2011-07-01 20:33:47
dc29515edff9a3e2fee02ad62e99c5535e4fd01e...6da838fe3db04c2f38a8a36983c020a7015ac08b,3,89,0,89,4,2011-07-05 13:31:22,2011-07-05 13:31:22
6da838fe3db04c2f38a8a36983c020a7015ac08b...4709b451725d4871dcb2d4e62855075dcce717b0,2,115,0,115,3,2011-07-05 15:14:53,2011-07-05 15:14:53
4709b451725d4871dcb2d4e62855075dcce717b0...5cb13cd2a50b6713d004aac36856a248290d826c,3,71,6,77,9,2011-07-05 18:28:03,2011-07-05 18:28:03
5cb13cd2a50b6713d004aac36856a248290d826c...bd4e2e0698c633044d7b6b53e6e9244552039d35,1,16,0,16,2,2011-07-05 18:42:38,2011-07-05 18:42:38
bd4e2e0698c633044d7b6b53e6e9244552039d35...bfd1bf9393337c4defd7ec40ba2005b4ac182dad,1,10,10,20,10,2011-07-05 18:59:23,2011-07-05 18:59:23
bfd1bf9393337c4defd7ec40ba2005b4ac182dad...9bb992f9c3e0ea9515949dc781b88e63c57ba173,2,2,4,6,3,2011-07-06 13:25:02,2011-07-06 13:25:02
9bb992f9c3e0ea9515949dc781b88e63c57ba173...0d37c2e9b2b96bf9c4a0d8908c14b87f22143be5,3,107,0,107,4,2011-07-06 14:25:42,2011-07-06 14:25:42
0d37c2e9b2b96bf9c4a0d8908c14b87f22143be5...769d5fa25c261a33bc2094f9856249ea6dc18500,1,15,15,30,8,2011-07-06 16:18:16,2011-07-06 16:18:16
769d5fa25c261a33bc2094f9856249ea6dc18500...19390ca47c89a84c23705743728d9f88041c2d08,3,172,25,197,25,2011-07-06 18:08:29,2011-07-06 18:08:29
19390ca47c89a84c23705743728d9f88041c2d08...d75328d994737c339b83b26b8cae6199773f6094,3,18,18,36,15,2011-07-06 22:04:34,2011-07-06 22:04:34
d75328d994737c339b83b26b8cae6199773f6094...03b975d1ca726c78e0cee0c07e706708bd5ccb9d,2,4,3,7,2,2011-07-11 13:44:12,2011-07-11 13:44:12
03b975d1ca726c78e0cee0c07e706708bd5ccb9d...f9d995c09d6ffcd29ba5285af8b59ff78244c7e9,1,13,0,13,3,2011-07-11 16:39:07,2011-07-11 16:39:07
f9d995c09d6ffcd29ba5285af8b59ff78244c7e9...4a2591e3f9d0a7fc8c665f14b0e7c2a29de09fb6,1,5,1,6,3,2011-07-11 17:28:19,2011-07-11 17:28:19
4a2591e3f9d0a7fc8c665f14b0e7c2a29de09fb6...d3738b9b874f2eb75a689cbc3854895fddd21e1b,5,39,25,64,22,2011-07-13 15:05:49,2011-07-13 15:05:49
d3738b9b874f2eb75a689cbc3854895fddd21e1b...8b726a9f3efb8910c544d1b78d23608bfeb7d820,4,52,175,227,23,2011-07-13 18:50:20,2011-07-13 18:50:20
8b726a9f3efb8910c544d1b78d23608bfeb7d820...32775ea8b6f91e925dae2a7f33bd5aec7c20bce1,1,1,1,2,1,2011-07-13 21:05:18,2011-07-13 21:05:18
32775ea8b6f91e925dae2a7f33bd5aec7c20bce1...0f75994aee8470c1666011cfa29047e962860312,1,3,3,6,3,2011-07-14 16:19:37,2011-07-14 16:19:37
0f75994aee8470c1666011cfa29047e962860312...6d122af07f079f0b3e740d4822c570962af7741e,6,74,49,123,16,2011-07-19 16:43:19,2011-07-19 16:43:19
6d122af07f079f0b3e740d4822c570962af7741e...aa5a6d82677e32cc13dd30193e79149f487e8bbc,2,9,6,15,6,2011-07-19 19:40:18,2011-07-19 19:40:18
aa5a6d82677e32cc13dd30193e79149f487e8bbc...990b52be183104fb0964223bd2d7d609ed52ad62,1,1,1,2,1,2011-07-19 20:26:47,2011-07-19 20:26:47
4544eea0f6029f5731da1cd597ce5ac55935e136...d91ad388be5cac4bce76fd4677de6b980823bc61,1,0,2,2,1,2011-03-18 06:48:07,2011-03-18 06:22:37
d91ad388be5cac4bce76fd4677de6b980823bc61...3403b88453284c47cdee0882ef067468a7ec62c4,9,773,79,852,26,2011-03-18 06:48:07,2011-03-18 06:41:55
837e37e5c829d9e10cc450436cbf86616508f2a1...32fd12816a15c7820178c9f499f628db7af5ca78,3,13,13,26,8,2011-07-20 16:01:19,2011-07-20 16:01:19
3403b88453284c47cdee0882ef067468a7ec62c4...425eb5b5db6fe036829e7a48a0c0a6340a53f6bc,2,4,0,4,2,2011-03-18 06:58:44,2011-03-18 06:58:44
3403b88453284c47cdee0882ef067468a7ec62c4...9f4ba7f5436fdc61c75a951679f21f8b64b4d3c0,2,2,2,4,2,2011-03-18 06:54:24,2011-03-18 06:54:24
0d14f0d4b324f3304fcef573c872a5e3f9e1a5c1...ebb47a6f3037fd3a281ca62f4b6d8d9f40cea60a,8,209,111,320,100,2011-08-08 22:42:05,2011-08-08 22:42:05
772ce197454b5b753512a763f58d73545c9d86ca...a691ba4d41d8e82f4bd0b2c16d0f82bd3bea2b59,1,16,7,23,2,2011-03-18 07:11:12,2011-03-18 07:11:12
a691ba4d41d8e82f4bd0b2c16d0f82bd3bea2b59...e360d60e2d3ad0e69f2d829d39a4a71f0074943f,2,17,6,23,7,2011-03-18 07:27:33,2011-03-18 07:27:21
e360d60e2d3ad0e69f2d829d39a4a71f0074943f...d1dd3e51cd0be5216aa81a613420ca1dd09464d7,1,1,0,1,1,2011-03-18 07:29:41,2011-03-18 07:13:08
d1dd3e51cd0be5216aa81a613420ca1dd09464d7...f525eff5ddf9462ace2c22faee223df3ecdb53f0,1,1,8,9,1,2011-03-18 07:29:41,2011-03-18 07:19:20
f525eff5ddf9462ace2c22faee223df3ecdb53f0...9a5cc45fcc74d3adacf05d07e995f0131b2e4df8,1,0,1,1,1,2011-03-18 07:29:41,2011-03-18 07:20:38
9a5cc45fcc74d3adacf05d07e995f0131b2e4df8...ac8554e12be938cb984e9d9131b90dc4e5944177,1,9,9,18,8,2011-03-18 07:51:12,2011-03-18 07:48:44
ac8554e12be938cb984e9d9131b90dc4e5944177...56e97eb8930432fa7fee02ca9f84f8baf10c7f14,1,1,0,1,1,2011-03-18 08:23:56,2011-03-18 08:01:05
56e97eb8930432fa7fee02ca9f84f8baf10c7f14...4cea18515c926dc8e496e96793ff8c6d2e312d84,1,4,3,7,3,2011-03-18 08:23:56,2011-03-18 08:21:53
4cea18515c926dc8e496e96793ff8c6d2e312d84...451f248452286fc28700122c22941702f964e8fa,2,26,0,26,2,2011-03-18 08:58:55,2011-03-18 08:58:22
451f248452286fc28700122c22941702f964e8fa...c59ba3a0838fd0373d06888a3f93cec7a50d79f2,7,21,0,21,7,2011-03-18 15:05:32,2011-03-17 19:37:47
c59ba3a0838fd0373d06888a3f93cec7a50d79f2...13118248cf05c57911d93271ec1aa5229c572d97,2,19,3,22,5,2011-03-18 15:12:11,2011-03-18 15:03:45
13118248cf05c57911d93271ec1aa5229c572d97...93eec9b91edcdb1504da4676dd97c05dc41531be,1,4,1,5,1,2011-03-18 15:25:27,2011-03-18 15:25:27
93eec9b91edcdb1504da4676dd97c05dc41531be...038a1e7043b958afbc968fd54e3b51c8250b954b,1,12,5,17,2,2011-03-18 15:31:28,2011-03-18 15:31:28
038a1e7043b958afbc968fd54e3b51c8250b954b...6f262cb07b7619f9abb39e79dcae4fef844daf8a,1,1,1,2,1,2011-03-18 17:29:51,2011-03-18 17:29:51
6f262cb07b7619f9abb39e79dcae4fef844daf8a...7a494a75b6b25cdd4464a2d1fc9be562ff496e09,1,4,0,4,2,2011-03-18 18:00:16,2011-03-18 18:00:16
7a494a75b6b25cdd4464a2d1fc9be562ff496e09...cd6f5e6537a9fdbed82e149d4d65e47428c12217,1,3,1,4,1,2011-03-18 19:12:05,2011-03-18 19:12:05
cd6f5e6537a9fdbed82e149d4d65e47428c12217...ff767886eecd985ee9af28861ef6ce177b849040,3,2,3,5,3,2011-03-18 19:17:40,2011-03-18 19:17:40
ff767886eecd985ee9af28861ef6ce177b849040...9711f4d311c27da7ab94e4cd649f4dab2454d1c4,3,447,9,456,6,2011-03-18 19:19:43,2011-03-18 19:19:43
9711f4d311c27da7ab94e4cd649f4dab2454d1c4...261d65d6935d36bd2f243268bd7a1f623a972984,1,8,4,12,5,2011-03-18 19:32:10,2011-03-18 19:32:10
261d65d6935d36bd2f243268bd7a1f623a972984...7cbc2f2d8e986e8e1a1ee4651e444e81b9cb282f,1,4,8,12,5,2011-03-18 19:33:39,2011-03-18 19:33:39
7cbc2f2d8e986e8e1a1ee4651e444e81b9cb282f...9dd5c86e5ee0cdda06b83b8c6648a0f306ed7fc8,1,8,1,9,4,2011-03-18 19:35:18,2011-03-18 19:35:18
9dd5c86e5ee0cdda06b83b8c6648a0f306ed7fc8...25f158176761386f68624052de1952f5c8ab5599,1,3,3,6,4,2011-03-18 19:39:33,2011-03-18 19:39:33
25f158176761386f68624052de1952f5c8ab5599...8c8c3368df0df6e354a32bf5ec70e1fd65b9e110,1,5,0,5,1,2011-03-18 19:57:06,2011-03-18 19:56:16
8c8c3368df0df6e354a32bf5ec70e1fd65b9e110...bfcfc759eae8bd992730fcfb22331863dcaed697,1,3,3,6,4,2011-03-18 20:01:54,2011-03-18 19:54:19
bfcfc759eae8bd992730fcfb22331863dcaed697...4229b5421d2d7107683395f05eabf3c6488b5246,2,6,6,12,5,2011-03-18 20:01:54,2011-03-18 20:01:11
4229b5421d2d7107683395f05eabf3c6488b5246...dd2cb5dd8835b15169ef8cc787b0aacc893f8ae5,1,5,4,9,2,2011-03-18 20:15:01,2011-03-18 20:12:12
dd2cb5dd8835b15169ef8cc787b0aacc893f8ae5...ec6a0645991cd12fb4d1e74f563210177c35c19e,1,2,0,2,2,2011-03-18 21:24:29,2011-03-18 21:24:09
ec6a0645991cd12fb4d1e74f563210177c35c19e...7b77930c05c59128561e6861523579d80e89a03a,1,1,1,2,1,2011-03-19 13:13:03,2011-03-19 13:13:03
7b77930c05c59128561e6861523579d80e89a03a...eb68d91dcfcdceb53edce9cc2e100c5b34e4e5db,1,74,74,148,5,2011-03-19 19:07:28,2011-03-19 19:07:28
eb68d91dcfcdceb53edce9cc2e100c5b34e4e5db...bf7de7316593927f0e4a8c6f600af7d3c1224981,3,10,6,16,8,2011-03-19 19:49:22,2011-03-19 19:48:39
bf7de7316593927f0e4a8c6f600af7d3c1224981...a1db9a9576f75ae9e87e4da01b8014a5fda0da72,1,22,0,22,3,2011-03-19 20:38:50,2011-03-19 20:38:00
a1db9a9576f75ae9e87e4da01b8014a5fda0da72...993e967fb434c9b161b43fa5f2a4b060a685d3c3,1,1,1,2,1,2011-03-19 22:06:11,2011-03-19 22:06:11
993e967fb434c9b161b43fa5f2a4b060a685d3c3...55067cbf55d29ecb739ff9ab05627aa938a601d8,1,1,1,2,1,2011-03-19 22:07:49,2011-03-19 22:07:49
55067cbf55d29ecb739ff9ab05627aa938a601d8...01aab7c317661ccf8ce3719268c4c178a1c3b43c,1,0,3,3,1,2011-03-20 14:36:24,2011-03-20 14:36:24
01aab7c317661ccf8ce3719268c4c178a1c3b43c...638f96c76f072290b002575cefd807a2af068d6c,1,0,4,4,2,2011-03-20 14:58:36,2011-03-20 14:58:36
638f96c76f072290b002575cefd807a2af068d6c...d69e0d4db83733f58d8f4b315c2bb067a899880d,2,13,5,18,5,2011-03-20 15:43:24,2011-03-20 15:43:24
d69e0d4db83733f58d8f4b315c2bb067a899880d...71edffe0e8aa88998385d80f0dd4858fcf3e6a94,2,4,3,7,4,2011-03-20 17:37:25,2011-03-20 17:37:25
71edffe0e8aa88998385d80f0dd4858fcf3e6a94...be4e08267d3ab9e9edb6973e0283f25da9eb1402,1,8,4,12,2,2011-03-20 17:44:57,2011-03-20 17:44:57
be4e08267d3ab9e9edb6973e0283f25da9eb1402...cbae5d0b46d92144f11fbcde80b3bb5558a1a475,1,2,0,2,1,2011-03-22 04:34:22,2011-03-22 04:34:22
be4e08267d3ab9e9edb6973e0283f25da9eb1402...cd625649f2dbc2830fb10ecd5800ea0542b2c7c2,1,1,1,2,1,2011-03-21 05:58:15,2011-03-21 05:58:15
cd625649f2dbc2830fb10ecd5800ea0542b2c7c2...1d633a13e1c8b9be892a8d21833c16a0950b1dec,1,1,1,2,1,2011-03-21 16:00:38,2011-03-21 16:00:38
1d633a13e1c8b9be892a8d21833c16a0950b1dec...47e564f47c32779dbe9d82991e60e486d178d9fa,1,2,2,4,2,2011-03-21 16:05:45,2011-03-21 16:05:45
47e564f47c32779dbe9d82991e60e486d178d9fa...e9e92021e342d92915f9e5d21cb3757e85ad32e9,2,16,0,16,2,2011-03-21 16:09:00,2011-03-21 16:09:00
e9e92021e342d92915f9e5d21cb3757e85ad32e9...79d8885cadc7ce988909c601e82f52eefb01210e,2,13,4,17,4,2011-03-21 20:00:21,2011-03-21 19:59:05
b74c9b8fd811c0ebde47705c1f09074b60261d18...6eeb0267a1b80ba88657d1d44bb7ae998c41e96a,2,9,9,18,5,2011-08-10 20:33:15,2011-08-10 20:33:15
6eeb0267a1b80ba88657d1d44bb7ae998c41e96a...9dea4e528a78e1156451892dd9248ca268b741f8,2,38,38,76,24,2011-08-17 23:29:05,2011-08-17 23:29:05
75ecdb8d460646ca81e669a423f9e2f2caefa5b2...64359fbbf66aca3ce0c995e56200ef1ece1be6bb,1,5,0,5,1,2011-03-22 04:52:34,2011-03-22 04:52:34
75ecdb8d460646ca81e669a423f9e2f2caefa5b2...c27b5406692acf0826c9ca4f25f2c6c5768aba0f,4,26,8,34,9,2011-03-22 04:52:21,2011-03-22 00:44:29
c27b5406692acf0826c9ca4f25f2c6c5768aba0f...5c98fc8930e96ebc5852534c102d26565d45c0c2,2,18,1,19,3,2011-03-22 04:52:21,2011-03-22 00:57:13
5c98fc8930e96ebc5852534c102d26565d45c0c2...c887ab329fd0f3433d5b1ece970840fa23dbdff8,5,30,24,54,19,2011-03-22 04:52:21,2011-03-22 04:51:52
6d5188ea67f5487b74e755333f5467e1be1abb32...0856b1c8e07197ef0140355e3ef4c8f8ce966424,25,166,163,329,155,2011-08-23 22:56:46,2011-08-23 22:56:46
0856b1c8e07197ef0140355e3ef4c8f8ce966424...e3573954b4c342d1a110daa3f86474e256021a27,18,306,306,612,242,2011-08-23 23:54:41,2011-08-23 23:54:41
e3573954b4c342d1a110daa3f86474e256021a27...d92833913a698f5f023962dce5f32e97bac707bb,14,304,301,605,256,2011-08-24 00:31:03,2011-08-24 00:31:03
d92833913a698f5f023962dce5f32e97bac707bb...ff55f473f6d5f8eeb612d195a247897d7b15302b,20,95,97,192,89,2011-08-24 01:22:08,2011-08-24 01:22:08
98d26e040ee89a985970122832283fdc69aa32c1...dc14c92069ade9dd88dc2cf7a7e628a71f7266a8,1,1,1,2,1,2011-03-22 16:18:36,2011-03-22 16:18:36
dc14c92069ade9dd88dc2cf7a7e628a71f7266a8...fbef3e1b637641389e88ecff10d6632736f55619,2,117,31,148,24,2011-03-23 02:28:04,2011-03-23 02:27:16
fbef3e1b637641389e88ecff10d6632736f55619...14ef6d6bc3a3f5950b6d2bb70ac7af92df5c2298,2,51,0,51,2,2011-03-23 05:10:42,2011-03-23 04:06:54
14ef6d6bc3a3f5950b6d2bb70ac7af92df5c2298...b49e9338db5b3c20996113fcc0e9f1d4ed3b4bf4,2,18,2,20,6,2011-03-23 14:43:14,2011-03-23 14:43:14
b49e9338db5b3c20996113fcc0e9f1d4ed3b4bf4...d2bb5fa4f3145c57fb76cc39a7c742ca82347810,2,6,2,8,3,2011-03-23 14:43:53,2011-03-23 14:43:53
d2bb5fa4f3145c57fb76cc39a7c742ca82347810...c3667000b35c66b24ca8f430215d891b505846ca,2,137,110,247,2,2011-03-23 14:56:19,2011-03-23 14:56:19
c3667000b35c66b24ca8f430215d891b505846ca...ea1a8d7b1d9cb8e6f8dda2519ab14d59c40c84c0,1,4,4,8,3,2011-03-23 16:47:05,2011-03-23 02:38:30
ea1a8d7b1d9cb8e6f8dda2519ab14d59c40c84c0...db73ff7aff2c2e4c2868d408d846e8869e2d9a50,1,16,12,28,2,2011-03-23 16:47:05,2011-03-23 02:39:51
db73ff7aff2c2e4c2868d408d846e8869e2d9a50...fb4482b1bfdcbeb72695c53db92cb656d92042ef,1,2,1,3,2,2011-03-23 16:47:05,2011-03-23 16:46:36
fb4482b1bfdcbeb72695c53db92cb656d92042ef...a5ef5f81429389259871b9160279aa079c7c9aec,1,1,1,2,1,2011-03-23 18:19:10,2011-03-23 18:16:44
a5ef5f81429389259871b9160279aa079c7c9aec...6620177e03b9ddb578cd7d9578c8740d6a3d878b,1,1,1,2,1,2011-03-23 20:34:40,2011-03-23 20:34:40
8afbc5591681bbedb69be843ef5cb4f63ad81d2a...83ebf01497063865f3a981417d280bc46b061952,5,123,28,151,21,2011-09-16 15:00:45,2011-09-16 15:00:45
83ebf01497063865f3a981417d280bc46b061952...db25aa3da27c621f3ac1bf4b9b0ee093bc76e202,3,129,0,129,3,2011-09-16 15:23:48,2011-09-16 15:23:48
6620177e03b9ddb578cd7d9578c8740d6a3d878b...c663d7922b80108c6763894f0d93893fec4c68f1,2,7,3,10,5,2011-03-27 17:21:08,2011-03-27 17:21:08
6620177e03b9ddb578cd7d9578c8740d6a3d878b...37a16360bfedb18057f672a2fb02b3ece22da5c0,1,4,0,4,1,2011-03-23 21:17:27,2011-03-23 21:07:16
37a16360bfedb18057f672a2fb02b3ece22da5c0...2dcf0e93639ab5b172d6d6c7281642d5dff7049e,1,5,2,7,1,2011-03-23 21:17:27,2011-03-23 21:07:38
2dcf0e93639ab5b172d6d6c7281642d5dff7049e...c8f553af3a5a8191f9bec5318d05de76e90637d9,1,1,1,2,1,2011-03-23 21:17:27,2011-03-23 21:17:09
c8f553af3a5a8191f9bec5318d05de76e90637d9...5d5e995ecfa85877bec952da286b430d8354d128,1,23,3,26,3,2011-03-24 19:21:58,2011-03-24 19:21:36
5d5e995ecfa85877bec952da286b430d8354d128...79ea0806a97c40611311c8ecda493a07eed62187,1,4,1,5,2,2011-03-24 19:39:36,2011-03-24 19:38:17
79ea0806a97c40611311c8ecda493a07eed62187...73de55d3e1ff7d95236550ac9f71740dfd22e8a2,1,5,5,10,1,2011-03-24 19:39:36,2011-03-24 19:39:32
73de55d3e1ff7d95236550ac9f71740dfd22e8a2...be058d77324aa1191929fbe24e84e19b1cadc577,1,2,1,3,2,2011-03-24 19:47:21,2011-03-24 19:47:01
db25aa3da27c621f3ac1bf4b9b0ee093bc76e202...0d20c508a25435a783107c5463d0db59155251d9,10,654,59,713,80,2011-09-23 01:43:09,2011-09-23 01:43:09
db25aa3da27c621f3ac1bf4b9b0ee093bc76e202...0cdde95cc3d2abf00efb61d9e66f2c16c896cbc6,1,12,58,70,8,2011-09-20 15:18:34,2011-09-20 15:18:34
0cdde95cc3d2abf00efb61d9e66f2c16c896cbc6...983506dd46321896f21e135909c7d01973fcf822,5,406,0,406,6,2011-09-20 15:30:50,2011-09-20 15:30:50
983506dd46321896f21e135909c7d01973fcf822...58a5a1ad68dd5865bb81b7b6a9697756d9bad8bc,1,8,34,42,9,2011-09-26 16:36:27,2011-09-26 16:36:27
2278a8018f1140cedb05ca58f3ecb53b58dfb86e...8ebc664e3c23f0aeda109b32d068e445e77f0bff,4,313,49,362,28,2011-03-28 15:27:32,2011-03-26 00:38:07
8ebc664e3c23f0aeda109b32d068e445e77f0bff...f7970605970fe778d7d616a5aebf59fdf28fb32e,1,1,1,2,1,2011-03-28 17:33:47,2011-03-28 17:33:47
f7970605970fe778d7d616a5aebf59fdf28fb32e...d6c8b5e5ccda10e8c73a90ba334850c390b8f40c,1,28,11,39,3,2011-03-28 18:26:21,2011-03-28 18:26:21
d6c8b5e5ccda10e8c73a90ba334850c390b8f40c...f45587a30a9537398c01d2a666f7e3f72cd26948,6,190,66,256,46,2011-03-28 19:51:50,2011-03-28 19:47:52
f45587a30a9537398c01d2a666f7e3f72cd26948...a027e5fa543be78d8125816dc7ec41a71f39953d,1,10,1,11,3,2011-03-28 20:10:41,2011-03-28 20:10:21
a027e5fa543be78d8125816dc7ec41a71f39953d...b9e79c918ed66a961ad67a05a07beb7a707d7062,2,5,3,8,3,2011-03-28 20:10:43,2011-03-28 20:10:30
b9e79c918ed66a961ad67a05a07beb7a707d7062...581d2db86b5c4bfb1768e0b53172788b864dae7b,1,3,1,4,2,2011-03-28 21:38:06,2011-03-28 21:38:06
581d2db86b5c4bfb1768e0b53172788b864dae7b...101c833ac21d146e91a6ae613d07e232f30e8bfd,1,3,1,4,1,2011-03-28 21:45:07,2011-03-28 21:45:07
101c833ac21d146e91a6ae613d07e232f30e8bfd...b118ce7994722d8de44cc2d952b831b106e6d502,1,4,3,7,3,2011-03-28 21:51:57,2011-03-28 21:51:57
b118ce7994722d8de44cc2d952b831b106e6d502...96ba4e2a05167948a6b21bf36a746071dbcc86cf,1,5,5,10,1,2011-03-28 21:54:39,2011-03-28 21:54:39
96ba4e2a05167948a6b21bf36a746071dbcc86cf...31983926aa809c63e91e810ddbf11945985fbbc8,1,9,2,11,1,2011-03-28 22:23:54,2011-03-28 22:23:54
31983926aa809c63e91e810ddbf11945985fbbc8...68c8f70c33b9827906434ce02c70de22a4067ad4,1,1,1,2,1,2011-03-28 22:47:08,2011-03-28 22:47:08
68c8f70c33b9827906434ce02c70de22a4067ad4...ac6c7442c3fa08d9451fc6d375027efb610b8922,1,22,0,22,2,2011-03-29 03:35:38,2011-03-29 03:35:38
ac6c7442c3fa08d9451fc6d375027efb610b8922...b689325c427ddb0874f01a17b8513d13df9624d6,3,75,3,78,4,2011-03-29 11:49:54,2011-03-29 11:49:54
b689325c427ddb0874f01a17b8513d13df9624d6...41675f5f3951efba386d45034ef1f9324dfc2e20,2,7,8,15,3,2011-03-29 11:54:57,2011-03-29 11:54:57
41675f5f3951efba386d45034ef1f9324dfc2e20...dfbee8cf4545cbe4784aac6cb2224751d24008ee,2,11,4,15,3,2011-03-29 12:20:21,2011-03-29 12:20:21
dfbee8cf4545cbe4784aac6cb2224751d24008ee...1bb6de4c1ae53b1edcfb16642311bb428a85f5b3,2,2,1,3,2,2011-03-29 12:42:36,2011-03-29 12:42:36
1bb6de4c1ae53b1edcfb16642311bb428a85f5b3...06c1f33ed93cff15ef8a81f0d74a554f6c7cde24,1,1,1,2,1,2011-03-29 17:46:52,2011-03-29 17:46:52
06c1f33ed93cff15ef8a81f0d74a554f6c7cde24...e9dc703b9716204abf288c213cfdf3a5848832c5,1,31,6,37,9,2011-03-29 18:36:46,2011-03-29 18:28:07
e9dc703b9716204abf288c213cfdf3a5848832c5...19639446c1716e9b1e5db8c21c8266a1c27d2c94,1,26,2,28,5,2011-03-29 19:39:12,2011-03-29 19:38:03
19639446c1716e9b1e5db8c21c8266a1c27d2c94...ccd42395d9d18229fd4e399e870d251159a1efb7,1,9,2,11,3,2011-03-29 22:44:33,2011-03-29 22:44:33
ccd42395d9d18229fd4e399e870d251159a1efb7...fce112398b0ea27bae68f662a69df0e6953799f5,28,134,2928,3062,95,2011-03-29 23:56:53,2011-03-29 23:56:21
fce112398b0ea27bae68f662a69df0e6953799f5...d399d0844b17c84c353345bbe976021442f8272e,3,46,22,68,12,2011-03-30 00:43:41,2011-03-28 20:10:56
d399d0844b17c84c353345bbe976021442f8272e...0584a5ee577587b90b7cafb5c86cb13d6322cc3c,3,18,18,36,18,2011-03-30 00:52:44,2011-03-29 23:48:15
0584a5ee577587b90b7cafb5c86cb13d6322cc3c...30dd944c47d84482880387ce82bbebe65a79ed9f,3,81,21,102,37,2011-03-30 00:52:53,2011-03-30 00:20:04
30dd944c47d84482880387ce82bbebe65a79ed9f...fc88362bdb64ba960a9991bf117b42e05bb3d269,1,11,0,11,2,2011-03-30 01:00:01,2011-03-30 00:59:36
fc88362bdb64ba960a9991bf117b42e05bb3d269...a000767c150b67ba502eae397ee5d0c211a5b56e,1,2,2,4,2,2011-03-30 01:14:52,2011-03-29 06:17:33
a000767c150b67ba502eae397ee5d0c211a5b56e...18e260a9983a546345412fa1afbdf0d41d2ac6f5,7,73,40,113,37,2011-03-30 01:14:52,2011-03-29 07:13:27
18e260a9983a546345412fa1afbdf0d41d2ac6f5...d1e7d7fe4f1b688a0f363850fbc7a43fba51681d,3,39,18,57,4,2011-03-30 01:14:52,2011-03-29 07:44:01
d1e7d7fe4f1b688a0f363850fbc7a43fba51681d...e46b9d2957c5d6d10ecb59049206b5b820b0a9f2,1,1,1,2,1,2011-03-30 01:14:53,2011-03-29 08:41:40
e46b9d2957c5d6d10ecb59049206b5b820b0a9f2...8e06d82d47a68d2a2a571aca25cdad965078fbc1,1,29,0,29,1,2011-03-30 01:14:53,2011-03-30 00:15:14
8e06d82d47a68d2a2a571aca25cdad965078fbc1...0d66b07974306d5220e588e9bb3bff810df409ba,1,1,1,2,1,2011-03-30 01:14:53,2011-03-30 01:14:26
0d66b07974306d5220e588e9bb3bff810df409ba...f3218bb84e0866f78ed568a5a56f6f0216bd8316,1,1,1,2,1,2011-03-30 01:40:22,2011-03-30 01:40:22
f3218bb84e0866f78ed568a5a56f6f0216bd8316...ed16cb7ceaa77c9b8b75d3f5b7c7433d058e976d,1,4,3,7,1,2011-03-30 05:37:13,2011-03-29 23:49:58
ed16cb7ceaa77c9b8b75d3f5b7c7433d058e976d...a62266be57561d57f8bfe679f3b1c71500a86096,1,4,0,4,2,2011-03-30 05:37:13,2011-03-30 05:36:58
a62266be57561d57f8bfe679f3b1c71500a86096...5931bc0231c91ecdfc5dd313d8cce578eae426bb,1,0,2,2,2,2011-03-30 05:37:21,2011-03-30 05:01:18
5931bc0231c91ecdfc5dd313d8cce578eae426bb...fb9ed2964ab6165b250f5c3d8a9bdd25242dd349,1,1,1,2,1,2011-03-30 05:37:21,2011-03-30 05:36:01
fb9ed2964ab6165b250f5c3d8a9bdd25242dd349...8cd20b51fd4defa44343decb235a5053d66381d6,2,34,1,35,2,2011-03-30 07:23:37,2011-03-30 07:23:37
8cd20b51fd4defa44343decb235a5053d66381d6...8ba84aacf7c86575c1f467e6253c20773cf421ab,1,55,11,66,4,2011-03-30 15:13:05,2011-03-30 15:13:05
8ba84aacf7c86575c1f467e6253c20773cf421ab...adddf74ca1a379ae94471455a99d7ba67e574a88,1,3,3,6,3,2011-03-30 16:14:51,2011-03-30 16:14:51
adddf74ca1a379ae94471455a99d7ba67e574a88...c16a3b78c4ad8baded3c99f4d4556befd9eb2eb0,1,8,7,15,2,2011-03-30 16:15:48,2011-03-30 16:15:48
c16a3b78c4ad8baded3c99f4d4556befd9eb2eb0...4e05ef32a1b42c90ab77d58ea8e8beeda9928aaa,2,14,14,28,14,2011-03-30 16:16:06,2011-03-30 16:16:06
4e05ef32a1b42c90ab77d58ea8e8beeda9928aaa...daceb099cf445390ca18a1ff941af6ffd8c61ba4,1,5,4,9,2,2011-03-30 17:49:19,2011-03-30 17:49:19
daceb099cf445390ca18a1ff941af6ffd8c61ba4...1707fa2a7edf8ab3f13777c8afe9674c48681581,2,18,6,24,10,2011-03-30 17:52:51,2011-03-30 17:52:51
1707fa2a7edf8ab3f13777c8afe9674c48681581...35bdf7428b9c6848bbde8962ac017e27ce4e1be8,2,0,4,4,2,2011-03-30 19:08:23,2011-03-30 19:08:23
be058d77324aa1191929fbe24e84e19b1cadc577...5900879780ba11b3b3a7e4813b856344cf605779,1,24,0,24,1,2011-03-24 21:12:22,2011-03-24 21:12:22
5900879780ba11b3b3a7e4813b856344cf605779...9bb7936f962af8f04775886b4a1cbba60300ac17,1,19,0,19,1,2011-03-24 21:47:38,2011-03-24 21:47:38
9bb7936f962af8f04775886b4a1cbba60300ac17...8004154cda5556e326bf97e14f847032fe3ef3ec,1,17,0,17,1,2011-03-24 21:48:11,2011-03-24 21:48:11
be058d77324aa1191929fbe24e84e19b1cadc577...ad3824dcf847a16fcf2d5036c43c53839731a03f,1,4,28,32,3,2011-03-24 20:33:30,2011-03-24 20:33:20
ad3824dcf847a16fcf2d5036c43c53839731a03f...c947377014c77e58347533e52b392de9540189be,4,4,4,8,4,2011-03-25 13:59:50,2011-03-25 13:59:50
c5a65f9076734a2e60c0e5b023e26c5a5c0b77a1...a37c9dbd3a6c044df93e73b38b4aab2b0bcff758,2,26,27,53,3,2011-09-26 22:41:03,2011-09-26 22:41:03
a37c9dbd3a6c044df93e73b38b4aab2b0bcff758...554e9b6208288957918802089cd77eba1ff67ba9,5,30,149,179,26,2011-09-26 23:50:44,2011-09-26 23:50:44
554e9b6208288957918802089cd77eba1ff67ba9...a4272161628b319f06fba8c3f56619629da8beff,4,74,39,113,15,2011-09-27 21:52:21,2011-09-27 21:52:21
a4272161628b319f06fba8c3f56619629da8beff...19f1cda2051770bd12faccc8fa6800efde632313,7,177,84,261,49,2011-09-29 21:56:18,2011-09-29 21:56:18
19f1cda2051770bd12faccc8fa6800efde632313...c0dba389eb203cea6d1c9505ede56683bf4c729f,2,6,4,10,3,2011-09-29 22:23:06,2011-09-29 22:23:06
c0dba389eb203cea6d1c9505ede56683bf4c729f...ef515eb22b57f394869a2db7fda420e42e4affa1,2,102,25,127,24,2011-10-11 23:28:39,2011-10-11 23:28:39
ef515eb22b57f394869a2db7fda420e42e4affa1...dbdcf96cc9c772ea8cd089103cbb88e2e7d7e20e,3,48,3,51,7,2011-10-12 01:00:19,2011-10-12 01:00:19
35bdf7428b9c6848bbde8962ac017e27ce4e1be8...f3c3435f0301d88816b0b92fcd33cd887ea3ac5c,1,2,2,4,2,2011-03-31 01:15:40,2011-03-31 01:15:40
f3c3435f0301d88816b0b92fcd33cd887ea3ac5c...1d46a7e4baa781c32e770988f6cafa803f3ef190,14,336,211,547,51,2011-04-04 16:38:38,2011-04-04 16:38:38
35bdf7428b9c6848bbde8962ac017e27ce4e1be8...b980e631d97249dcf22d0a61fefcb02655224f6e,2,2,2,4,2,2011-03-30 20:07:22,2011-03-30 20:07:22
b980e631d97249dcf22d0a61fefcb02655224f6e...50613b671861803260440b06dabdc29eac82506f,2,32,0,32,2,2011-03-30 20:28:21,2011-03-30 20:28:21
50613b671861803260440b06dabdc29eac82506f...fe6664136cafbeb95fd86f7be6c5e781f2e72d1d,1,2,2,4,2,2011-03-30 20:29:09,2011-03-30 20:29:09
fe6664136cafbeb95fd86f7be6c5e781f2e72d1d...ae0f82093e559f57dafcd7d3d4af350dbe5c63d9,12,89,265,354,67,2011-03-30 21:04:22,2011-03-30 21:03:52
96c5fb945be70c0c28111d9e720fc1c8ef15d2fa...d8cc3de82711d6a4bacacd6e4be82be387e4fa07,1,0,0,0,0,2011-03-25 18:25:35,2011-03-25 18:25:35
d8cc3de82711d6a4bacacd6e4be82be387e4fa07...124bf4617650b5026c5dff5b45da9c86bcf48525,1,6,1,7,1,2011-03-25 18:26:03,2011-03-25 18:26:03
124bf4617650b5026c5dff5b45da9c86bcf48525...4993a1bf7923b7090f737a1c1727d17e5722e8f7,3,50,20,70,15,2011-03-25 18:31:10,2011-03-25 05:50:43
4993a1bf7923b7090f737a1c1727d17e5722e8f7...131ba64314adb5236af84f9f6a0690c588f83f32,1,0,3,3,2,2011-03-25 18:31:10,2011-03-25 05:56:31
131ba64314adb5236af84f9f6a0690c588f83f32...02162fa52bccc9314aed2a7f78caee78149d7d7f,1,35,0,35,1,2011-03-25 18:31:11,2011-03-25 06:01:36
02162fa52bccc9314aed2a7f78caee78149d7d7f...aac5e1bd9b6d6cd9ce6e93fef1a2db01873eec4b,1,18,0,18,1,2011-03-25 18:31:11,2011-03-25 06:23:10
aac5e1bd9b6d6cd9ce6e93fef1a2db01873eec4b...819f4001dff0678aa3550b3eec6ac699fddf6b66,1,28,0,28,1,2011-03-25 18:31:11,2011-03-25 06:42:56
819f4001dff0678aa3550b3eec6ac699fddf6b66...273dda0b61a10084798dc59d455ea735d19074bc,3,11,2,13,5,2011-03-25 18:31:11,2011-03-25 18:04:49
273dda0b61a10084798dc59d455ea735d19074bc...7e1da0db8e6fc3134c6431ac233972ad2f0a94cc,2,4,11,15,10,2011-03-25 18:48:59,2011-03-22 15:02:42
7e1da0db8e6fc3134c6431ac233972ad2f0a94cc...68d848fe4c036d2bc377e3b281ebae998d861b9c,3,115,66,181,15,2011-03-25 18:49:00,2011-03-22 18:28:59
68d848fe4c036d2bc377e3b281ebae998d861b9c...d7ded4842e6bfb454b501d0ef0e4d890566b5837,3,64,5,69,6,2011-03-25 18:49:02,2011-03-25 18:48:46
d7ded4842e6bfb454b501d0ef0e4d890566b5837...aeb26c953ea34d2f9b8e547031d56da631aa454a,2,68,7,75,7,2011-03-25 21:09:52,2011-03-25 21:06:22
aeb26c953ea34d2f9b8e547031d56da631aa454a...8e000febf2de98a3b5ffe95159bdf0e67ae89d5b,1,37,0,37,1,2011-03-26 22:04:34,2011-03-26 21:53:42
8e000febf2de98a3b5ffe95159bdf0e67ae89d5b...a600249b21716871eb557dfbeeae9ebbd99dab49,2,6,2,8,3,2011-03-27 06:33:10,2011-03-27 06:33:10
a40e2b03b4f7f4833b07e8575b16479093372a64...11381e2b764da9f60a0a7a8ca1c09a9ddaf78a1d,1,2,2,4,2,2011-10-18 00:11:49,2011-10-18 00:11:49
11381e2b764da9f60a0a7a8ca1c09a9ddaf78a1d...16557b99eb6d75fa1065a11b3417991606b0794a,17,497,26,523,38,2011-11-02 01:25:26,2011-11-02 01:25:26
16557b99eb6d75fa1065a11b3417991606b0794a...d1adc4fbb102ac46798ffa91a97170d3e0667e75,1,1,1,2,2,2011-11-02 01:47:37,2011-11-02 01:47:37
d1adc4fbb102ac46798ffa91a97170d3e0667e75...099b54faf355a53a9bacf1b71263c099fb861aba,1,1,0,1,1,2011-11-02 02:41:31,2011-11-02 02:41:31
099b54faf355a53a9bacf1b71263c099fb861aba...03a6a675b6bf88436c1b2185f28ea88071b6bdae,1,1,1,2,2,2011-11-02 20:40:56,2011-11-02 20:40:56
ae0f82093e559f57dafcd7d3d4af350dbe5c63d9...95c0b3b5cfe834f6f6251adb7c4bb92e09125565,1,22,1,23,1,2011-03-30 21:42:24,2011-03-30 21:38:18
95c0b3b5cfe834f6f6251adb7c4bb92e09125565...69cf8bee0b7ae3135560a1baa5d7f292995129c6,3,144,3,147,9,2011-03-30 23:20:18,2011-03-18 17:04:38
69cf8bee0b7ae3135560a1baa5d7f292995129c6...bff866a5a1b3d12c9728fb76b92cc7c2576cf836,1,0,2,2,1,2011-03-30 23:24:48,2011-03-30 23:24:17
bff866a5a1b3d12c9728fb76b92cc7c2576cf836...ad2827cd3bf72506a248adae6ecbde170db8e281,2,23,15,38,9,2011-03-31 00:51:25,2011-03-31 00:51:25
ad2827cd3bf72506a248adae6ecbde170db8e281...05afa3b8a07f2dd0c7bd4e216066a01494e5a0f2,1,3,2,5,2,2011-03-31 01:01:37,2011-03-31 01:01:37
05afa3b8a07f2dd0c7bd4e216066a01494e5a0f2...3372fb003a5d3f52bc6e1e720309166f7204411f,1,1,1,2,1,2011-03-31 01:02:00,2011-03-31 01:02:00
3372fb003a5d3f52bc6e1e720309166f7204411f...a2e0f2aab55c0ab966050430d5e36ed21c8c2383,1,1,1,2,1,2011-03-31 01:34:54,2011-03-31 01:34:54
a2e0f2aab55c0ab966050430d5e36ed21c8c2383...be791982c4c9309e29bf12a7bac82dfd5436b9a4,1,0,20,20,1,2011-03-31 07:02:52,2011-03-31 07:02:52
be791982c4c9309e29bf12a7bac82dfd5436b9a4...30d7a2645b4ef0c3b09e2582120774fcc687407e,1,33,0,33,1,2011-03-31 07:04:12,2011-03-31 07:04:12
30d7a2645b4ef0c3b09e2582120774fcc687407e...c2956f1d8bb27837349bf42556b0b4e948cb2a6d,1,1,1,2,1,2011-03-31 12:23:40,2011-03-31 12:23:40
c2956f1d8bb27837349bf42556b0b4e948cb2a6d...c3da625d6a839a885189abd079f8e81785ee975a,2,76,27,103,7,2011-03-31 12:48:05,2011-03-31 12:48:05
c3da625d6a839a885189abd079f8e81785ee975a...9a397af854861484ebba3cfd6bbe92f7bbe7fb62,2,12,0,12,3,2011-03-31 12:57:53,2011-03-31 12:57:53
9a397af854861484ebba3cfd6bbe92f7bbe7fb62...ded0dac9263f9205bbc2efe45537da49210e1c10,2,39,4,43,4,2011-03-31 13:29:41,2011-03-31 13:29:41
ded0dac9263f9205bbc2efe45537da49210e1c10...c6ea2dd0c57981dd2943cc8d2a8db81c383f4653,1,21,20,41,5,2011-03-31 13:41:47,2011-03-31 13:41:47
c6ea2dd0c57981dd2943cc8d2a8db81c383f4653...d54651e5f25d51c0b0483e8134f364f3aa7753b1,2,1,11,12,3,2011-03-31 14:28:36,2011-03-31 14:28:36
d54651e5f25d51c0b0483e8134f364f3aa7753b1...e00f629ae1792ac430faa1aefb2c1c1588232139,3,24,9,33,7,2011-03-31 15:07:11,2011-03-31 15:07:11
e00f629ae1792ac430faa1aefb2c1c1588232139...67ba94424e8282787c5833edcf8e5ab29934c2ac,2,10,2,12,4,2011-03-31 15:17:16,2011-03-31 15:17:16
67ba94424e8282787c5833edcf8e5ab29934c2ac...9eb9c7200d715da0e2327bcdf11501cda9e293aa,1,2,0,2,1,2011-03-31 15:45:39,2011-03-31 15:45:39
9eb9c7200d715da0e2327bcdf11501cda9e293aa...c71fac2af7563ad81bd07f65b318ac9f6f341da9,2,7,4,11,3,2011-03-31 20:55:41,2011-03-31 20:55:41
c71fac2af7563ad81bd07f65b318ac9f6f341da9...e59799f0790731f1615c8c369e20a66b651b58d0,1,22,2,24,2,2011-03-31 21:31:43,2011-03-31 21:30:57
e59799f0790731f1615c8c369e20a66b651b58d0...86ae5d6fd99138d02f3a7a15e388e77c683e8983,3,50,21,71,13,2011-03-31 21:58:17,2011-03-31 21:57:39
86ae5d6fd99138d02f3a7a15e388e77c683e8983...215f3b479eeb5c18eb813ec89b356ab6bfc7a5c4,4,12,2,14,5,2011-04-01 13:11:48,2011-03-30 20:52:55
215f3b479eeb5c18eb813ec89b356ab6bfc7a5c4...8750ddd3bdf6125271ee1289d2d2c79b97b987e7,1,56,0,56,1,2011-04-01 13:11:48,2011-03-30 20:53:37
8750ddd3bdf6125271ee1289d2d2c79b97b987e7...301376410c7b8c9a922435e6d5a97645f3ee95db,11,55,59,114,38,2011-04-01 13:45:10,2011-03-31 15:32:47
301376410c7b8c9a922435e6d5a97645f3ee95db...ad78ff6280e928b93fb2e6aacd69e617949eb9e4,1,1,0,1,1,2011-04-01 15:47:14,2011-04-01 15:47:14
ad78ff6280e928b93fb2e6aacd69e617949eb9e4...ab4bb9321450650f0cb06a8a91b048ee5d43a6d9,2,14,1,15,4,2011-04-01 15:55:23,2011-04-01 15:55:23
696314ab8922b0cce92b96e8bb63c4b8bd52ea4a...0082af774aa93c5d431bf9119bd36803bb952ae4,3,80,0,80,4,2011-11-17 23:27:27,2011-11-17 23:27:27
0082af774aa93c5d431bf9119bd36803bb952ae4...67839bc7e83203027cb7dca299191eb17c0db5c5,9,125,32,157,22,2011-11-29 20:44:51,2011-11-29 20:44:51
fab72a5400d184b9b449824a9d48904d4b226bd9...1d3134107f60faa46977e04731587a95714e79d2,2,5,5,10,4,2011-04-04 17:05:46,2011-04-04 17:05:46
1d3134107f60faa46977e04731587a95714e79d2...63aa80450c64ea44d07ad0d2afddf99d950edda3,1,1,1,2,1,2011-04-04 17:08:08,2011-04-04 17:08:08
63aa80450c64ea44d07ad0d2afddf99d950edda3...9d84427c622a26ea6a30bba6978ea20c114054ea,1,1,1,2,1,2011-04-04 17:18:45,2011-04-04 17:18:22
9d84427c622a26ea6a30bba6978ea20c114054ea...dafb88648f5148b940290b6c6ba0d0c11ce2ca07,3,5,5,10,4,2011-04-04 17:20:45,2011-04-04 17:20:45
dafb88648f5148b940290b6c6ba0d0c11ce2ca07...0ff487c7d1763c8639c1d02a00882a1571ebd1d5,3,7,4,11,5,2011-04-04 18:16:37,2011-04-04 18:16:37
0ff487c7d1763c8639c1d02a00882a1571ebd1d5...c2992ef1080d355717826c04fb5b8d6a694ddfe4,1,8,0,8,2,2011-04-04 18:50:33,2011-04-04 18:50:11
c2992ef1080d355717826c04fb5b8d6a694ddfe4...92784f6872db87173683387a5088ec5832438039,2,145,140,285,34,2011-04-04 19:11:01,2011-04-04 18:41:09
92784f6872db87173683387a5088ec5832438039...82896bee571519a1640f60fcf733cba178dd2700,1,2,6,8,1,2011-04-04 19:19:41,2011-04-04 19:07:39
82896bee571519a1640f60fcf733cba178dd2700...700b3394b1132c185031c6ce6dcab235c0aa62f2,1,2,2,4,1,2011-04-04 19:19:41,2011-04-04 19:09:55
700b3394b1132c185031c6ce6dcab235c0aa62f2...ee4780794884ff0e5914078ed1673c2e46a03d01,1,9,0,9,3,2011-04-04 19:19:41,2011-04-04 19:16:04
ee4780794884ff0e5914078ed1673c2e46a03d01...31970cf322438a6ecf50f0d9f3015fcc8c0a7dca,1,4,1,5,2,2011-04-04 20:12:56,2011-04-04 20:12:56
31970cf322438a6ecf50f0d9f3015fcc8c0a7dca...822efa3ffa7494743e727184c5964c39da303455,1,17,6,23,5,2011-04-04 20:21:25,2011-04-04 20:20:19
822efa3ffa7494743e727184c5964c39da303455...7b9d59116242a955bd2e20c58429c1f72ae3ccf2,6,136,45,181,30,2011-04-04 20:30:23,2011-04-04 20:30:09
7b9d59116242a955bd2e20c58429c1f72ae3ccf2...6e400fee9fdf356e9193c8719186e2c24700eb46,3,16,24,40,4,2011-04-04 20:41:58,2011-04-04 20:41:58
6e400fee9fdf356e9193c8719186e2c24700eb46...200b9ea5def492c74cc7e68b300c1d3e982efabd,1,0,2,2,1,2011-04-04 20:52:57,2011-04-04 20:52:57
200b9ea5def492c74cc7e68b300c1d3e982efabd...e7786d70b5384f306a9ce7d171cb8faa243781ae,1,0,1,1,1,2011-04-04 21:05:31,2011-04-04 21:05:31
e7786d70b5384f306a9ce7d171cb8faa243781ae...ee79aa11f63f2e20692fe80a510b08cacbac2a55,1,1,1,2,1,2011-04-04 21:14:11,2011-04-04 21:14:11
ee79aa11f63f2e20692fe80a510b08cacbac2a55...72ee3c3ef7ed3ccbdd37a3df1b280b2a8d46ad2a,1,1,1,2,1,2011-04-04 21:22:43,2011-04-04 21:22:43
72ee3c3ef7ed3ccbdd37a3df1b280b2a8d46ad2a...e73c3aac9d5a594b0e1bf23643b2b48e025bf51a,3,5,5,10,5,2011-04-04 21:32:49,2011-04-04 21:32:49
e73c3aac9d5a594b0e1bf23643b2b48e025bf51a...af792b80100a0320f241ae88d9cf7a9705bbe975,2,13,1,14,2,2011-04-04 22:17:21,2011-04-04 22:06:54
af792b80100a0320f241ae88d9cf7a9705bbe975...fa7fbbb1f66ec5e189f6deba58564b72c2e4cbef,3,22,10,32,7,2011-04-04 22:34:11,2011-04-04 22:31:23
fa7fbbb1f66ec5e189f6deba58564b72c2e4cbef...ec093cc5accdc0ef6f5272e84b2930044cbf4d01,3,42,6,48,6,2011-04-04 23:19:48,2011-04-04 23:19:48
ab4bb9321450650f0cb06a8a91b048ee5d43a6d9...ff63bf56849a9fea8ebfa46c45e21618ae1c2738,1,1,1,2,1,2011-04-02 01:34:09,2011-04-02 01:27:04
ff63bf56849a9fea8ebfa46c45e21618ae1c2738...cd19c1835fd18bf288b5a7651e195e2c72f2eaff,7,80,23,103,31,2011-04-02 01:34:10,2011-04-02 01:33:11
cd19c1835fd18bf288b5a7651e195e2c72f2eaff...fa7cd65e480d80ba1cd196bdcec8f4714e361e8e,8,6,12,18,11,2011-04-03 23:10:36,2011-04-03 23:10:36
fa7cd65e480d80ba1cd196bdcec8f4714e361e8e...cd972a701d67dcc3110bf69db44b97ddee7f6583,1,2,1,3,1,2011-04-04 00:50:45,2011-03-27 16:01:31
cd972a701d67dcc3110bf69db44b97ddee7f6583...a67334a28675ac44c15f99c7814d851152b0365a,1,34,1,35,4,2011-04-04 00:50:45,2011-03-31 23:23:41
a67334a28675ac44c15f99c7814d851152b0365a...244b1621119d8291c73411bcc8b3d9d92bdda2fa,11,70,40,110,27,2011-04-04 00:50:45,2011-04-01 21:35:11
244b1621119d8291c73411bcc8b3d9d92bdda2fa...bf9a5c23a32f17affd8cd17c3edc95159bfec03a,1,1,1,2,1,2011-04-04 01:00:31,2011-04-04 01:00:31
bf9a5c23a32f17affd8cd17c3edc95159bfec03a...2b23df9f52979c20c1548cc01f580f1c413d9c34,1,1,1,2,1,2011-04-04 01:21:26,2011-04-04 01:21:26
2b23df9f52979c20c1548cc01f580f1c413d9c34...6d52227ae7493d9d806e1dd2a0e71c4026638082,1,2,2,4,2,2011-04-04 02:32:00,2011-04-04 02:32:00
6d52227ae7493d9d806e1dd2a0e71c4026638082...c5b38d88eb92b0b32697578be45499062ea5aebb,2,2,2,4,2,2011-04-04 14:15:51,2011-04-04 14:15:51
c5b38d88eb92b0b32697578be45499062ea5aebb...1b9b77cfdc0fb7fce28355bbdca549dc57ad20c1,2,9,0,9,3,2011-04-04 15:53:20,2011-04-04 15:53:20
1b9b77cfdc0fb7fce28355bbdca549dc57ad20c1...b994faa86717f780fe8e88e67dbbe49ba455b01d,1,250,270,520,42,2011-04-04 15:55:29,2011-03-29 21:31:49
b994faa86717f780fe8e88e67dbbe49ba455b01d...33f74634e47c7f31e8df6b8d971ba43348e540b2,2,8,1,9,3,2011-04-04 16:05:43,2011-04-04 15:53:46
33f74634e47c7f31e8df6b8d971ba43348e540b2...69546ff082de7f44fbba41ae319b61c994424bea,3,5,14,19,5,2011-04-04 16:05:43,2011-04-04 16:03:56
69546ff082de7f44fbba41ae319b61c994424bea...270996933d24a60cfc3803908cc5b639f77b6923,9,13,13,26,13,2011-04-04 16:15:23,2011-04-04 16:15:23
270996933d24a60cfc3803908cc5b639f77b6923...1e3afd84eb17473a43d44928c8d84fadc0283ad2,2,47,27,74,11,2011-04-04 16:32:20,2011-04-04 16:31:26
5d443029c1d7c18b0d75f5a1b4a5de7bdf230fe6...dbceed4dffe77f69e57fa0beb678d08f4b969fb7,1,2,0,2,1,2011-12-07 22:41:35,2011-12-07 22:41:35
ec093cc5accdc0ef6f5272e84b2930044cbf4d01...e58648e3a58467ab39e9ebf6bbd7cbbfa9cbe62e,1,34,0,34,1,2011-04-05 13:03:54,2011-04-05 13:03:54
ec093cc5accdc0ef6f5272e84b2930044cbf4d01...f9237e3cb634a70fbb64631253cffd1f91c6aa87,14,133,36,169,36,2011-04-05 06:24:16,2011-04-05 06:24:16
f9237e3cb634a70fbb64631253cffd1f91c6aa87...75aec1061eed172f31caf57159344d434d41ab9b,2,18,146,164,10,2011-04-05 06:30:06,2011-04-05 06:30:06
75aec1061eed172f31caf57159344d434d41ab9b...c4b09ea4d20b1b70b562e0e63f478ed19a714ba5,3,13,8,21,3,2011-04-05 06:37:18,2011-04-05 06:37:18
c4b09ea4d20b1b70b562e0e63f478ed19a714ba5...df27479b68e03d52f6332042e39c1dd9ffab19e8,1,6,6,12,3,2011-04-05 07:11:49,2011-04-05 07:11:49
df27479b68e03d52f6332042e39c1dd9ffab19e8...90e5a91851c36235656a8882888c19a71be7d138,2,7,2,9,4,2011-04-05 12:26:35,2011-04-05 12:26:35
90e5a91851c36235656a8882888c19a71be7d138...767131fdb2c48034300591be9edc08193868aceb,1,1,2,3,2,2011-04-05 12:35:45,2011-04-05 12:35:45
1e3afd84eb17473a43d44928c8d84fadc0283ad2...a1689f68472f55a11b5dd02ab087c7c091762170,2,2,2,4,2,2011-04-04 16:47:59,2011-04-04 16:35:48
a1689f68472f55a11b5dd02ab087c7c091762170...64151ca41ac480805add7603320ca2a8adcba98c,1,2,0,2,1,2011-04-04 16:47:59,2011-04-04 16:47:32
8c753d691ff3fcb6c6d6523e1a15fee7a02db8d4...d6da3547969ea153acf9f3027e645d2656ea6d58,1,1,2,3,1,2011-12-08 06:30:42,2011-12-08 06:30:42
d6da3547969ea153acf9f3027e645d2656ea6d58...b2c28592bc3458550b721c6332ffdcc9c53f846d,1,11,7,18,5,2011-12-08 07:09:50,2011-12-08 07:09:50
b2c28592bc3458550b721c6332ffdcc9c53f846d...9d530fff19362277859932d9248e3f05da1ad163,1,2,2,4,2,2011-12-08 15:00:18,2011-12-08 15:00:18
9d530fff19362277859932d9248e3f05da1ad163...35c76c0a277f3657685e064adae401e0e16607c3,1,3,0,3,2,2011-12-08 15:28:33,2011-12-08 15:28:33
35c76c0a277f3657685e064adae401e0e16607c3...afa5b9cc3d4c9325e59269f4d1d34b32283ebeba,1,3,2,5,2,2011-12-08 17:25:53,2011-12-08 17:25:03
afa5b9cc3d4c9325e59269f4d1d34b32283ebeba...8b36f24f66fcf922e86fcdcb8951d852545b942a,1,1,1,2,1,2011-12-08 18:07:17,2011-12-08 18:06:30
8b36f24f66fcf922e86fcdcb8951d852545b942a...3f1ef19d232304d2a13b9f876204749ac07dde0e,4,279,1,280,19,2011-12-08 18:17:48,2011-12-08 18:17:11
3f1ef19d232304d2a13b9f876204749ac07dde0e...be906900f64261e9207f4b29784759609bd18ab8,1,0,1,1,1,2011-12-08 18:37:18,2011-12-08 18:36:57
be906900f64261e9207f4b29784759609bd18ab8...42d9df7b9f81a6ae7f102af339ebacd00e205d90,2,2,2,4,2,2011-12-08 18:51:42,2011-12-08 18:51:42
8c753d691ff3fcb6c6d6523e1a15fee7a02db8d4...8b5047b82457097b4253e054cc46fef4310a977d,1,2,1,3,1,2011-12-08 02:14:41,2011-12-08 00:48:49
20342f2b9d85fef0941b3461daae2198f1c06e40...c7bc8fd06cf668ce2648a1aa8d840d1b86cc54de,1,1,1,2,1,2011-04-05 13:22:14,2011-04-05 13:21:55
c7bc8fd06cf668ce2648a1aa8d840d1b86cc54de...7526ddae279ae64a1cb22914e7ec4300c76215d9,1,1,1,2,1,2011-04-05 14:38:52,2011-04-05 14:38:52
7526ddae279ae64a1cb22914e7ec4300c76215d9...c30ad9b2385622569468bf0e494bcc7a971a7b63,1,5,5,10,6,2011-04-05 15:04:27,2011-04-05 15:04:11
c30ad9b2385622569468bf0e494bcc7a971a7b63...7c1a9cec152baff49b12697d5e502fa680dc7fc1,1,33,0,33,2,2011-04-05 18:08:06,2011-04-05 16:22:53
7c1a9cec152baff49b12697d5e502fa680dc7fc1...0a1b0214b68b9cdeb409adb5343eafd5f37121fc,1,8,8,16,2,2011-04-05 18:08:06,2011-04-05 16:24:30
0a1b0214b68b9cdeb409adb5343eafd5f37121fc...98c7a81e67a5c445cba99195177ec86a1ac1f009,1,35,5,40,6,2011-04-05 18:08:06,2011-04-05 18:04:32
98c7a81e67a5c445cba99195177ec86a1ac1f009...0407e1d4d20c302aff34fe85c97418b311d130ac,1,34,0,34,2,2011-04-05 18:08:06,2011-04-05 18:07:32
0407e1d4d20c302aff34fe85c97418b311d130ac...baa419929fdf795a188b5b08a12e0458393bd997,2,30,14,44,12,2011-04-05 18:14:27,2011-04-05 18:14:10
baa419929fdf795a188b5b08a12e0458393bd997...9c65e3ed8bed2eedb171cdfee6569d05c62a869e,1,1,1,2,1,2011-04-05 18:19:43,2011-04-05 18:19:43
9c65e3ed8bed2eedb171cdfee6569d05c62a869e...eb899a2cb52c7099c52bcdb7d88a3741039685fd,1,1,1,2,1,2011-04-05 19:05:17,2011-04-05 19:04:16
eb899a2cb52c7099c52bcdb7d88a3741039685fd...98ce52215780e1d5675d0874bd61102ec8f2213e,3,8,2,10,3,2011-04-05 19:16:18,2011-04-05 19:16:18
98ce52215780e1d5675d0874bd61102ec8f2213e...b40989ef278602b556eaa9af7301ff4b44579d1a,1,1,1,2,1,2011-04-05 19:20:12,2011-04-05 19:20:12
b40989ef278602b556eaa9af7301ff4b44579d1a...d8f79a52f2461d15849b5f363fd2079870a8e7d2,3,17,6,23,6,2011-04-05 19:59:45,2011-04-05 19:59:28
d8f79a52f2461d15849b5f363fd2079870a8e7d2...74086c6f40a39a34b3ba034ed82b695cc4758f37,2,41,0,41,2,2011-04-05 20:14:15,2011-04-04 21:28:54
74086c6f40a39a34b3ba034ed82b695cc4758f37...78aeb2e1120766785cb85517735e6c1dd45c1851,2,37,1,38,5,2011-04-05 20:14:16,2011-04-04 21:32:03
78aeb2e1120766785cb85517735e6c1dd45c1851...a29f3931af3b208f515b0546e1facc4a679e689c,1,6,4,10,2,2011-04-05 20:14:16,2011-04-04 21:36:18
a29f3931af3b208f515b0546e1facc4a679e689c...daee9aca49e99a09bee882c1843fd8b0e419602e,1,2,2,4,2,2011-04-05 20:14:16,2011-04-04 21:50:52
daee9aca49e99a09bee882c1843fd8b0e419602e...f97863227992f5e25ebe0882875d54cc5cc5937a,4,11,4,15,5,2011-04-05 20:14:16,2011-04-04 22:16:28
f97863227992f5e25ebe0882875d54cc5cc5937a...a7360cc67fffc5951f1f5e898f90e2fc3575e396,2,72,1,73,7,2011-04-05 20:14:16,2011-04-05 00:51:38
a7360cc67fffc5951f1f5e898f90e2fc3575e396...3a5326d9b4a54f6df5d4307f4fc73bcc94212d43,3,20,3,23,4,2011-04-05 20:14:16,2011-04-05 01:14:58
3a5326d9b4a54f6df5d4307f4fc73bcc94212d43...1e7801efab0f26d0e73ae83c02028abb5eefc53d,1,15,0,15,1,2011-04-05 20:14:16,2011-04-05 01:54:18
1e7801efab0f26d0e73ae83c02028abb5eefc53d...4a773a43b3f2d4da2c6cdf2af533ce2055c2dc39,2,52,14,66,9,2011-04-05 20:14:16,2011-04-05 06:17:58
4a773a43b3f2d4da2c6cdf2af533ce2055c2dc39...d0854da68d379acbfaf12ae58014ffb273b97566,1,17,0,17,1,2011-04-05 20:14:17,2011-04-05 06:29:54
d0854da68d379acbfaf12ae58014ffb273b97566...64f3b082265bb0cd19d258ab25fd1c3296fd739f,1,8,0,8,1,2011-04-05 20:14:17,2011-04-05 17:45:25
64f3b082265bb0cd19d258ab25fd1c3296fd739f...bcf7d73d917d11279ae75828c63b39715a0bd3d2,1,15,0,15,1,2011-04-05 20:14:17,2011-04-05 18:27:07
bcf7d73d917d11279ae75828c63b39715a0bd3d2...4c981f252999738777e9c6bf1743aea22941861c,1,44,0,44,1,2011-04-05 20:14:17,2011-04-05 19:16:34
4c981f252999738777e9c6bf1743aea22941861c...6af8365495692b330f1ec8a93c5f172817f7a7c3,6,84,3,87,7,2011-04-05 22:07:20,2011-04-05 22:02:37
42d9df7b9f81a6ae7f102af339ebacd00e205d90...e5bd79b33f310f4ec2f35a71efd715ef92b9680c,2,18,7,25,8,2011-12-08 20:10:42,2011-12-08 20:10:42
6af8365495692b330f1ec8a93c5f172817f7a7c3...9f570ea7feedbce4b2e0935bb42668a0fb2c6d1f,1,14,6,20,8,2011-04-06 01:35:49,2011-04-06 01:35:49
6af8365495692b330f1ec8a93c5f172817f7a7c3...d2fbf3f5c313765092d6cf6feb5af8e17e090b66,1,13,3,16,2,2011-04-05 23:18:21,2011-04-05 22:09:28
d2fbf3f5c313765092d6cf6feb5af8e17e090b66...3fb147f515b83896b0de17490aa7da4e1b261690,2,26,7,33,7,2011-04-05 23:18:21,2011-04-05 23:14:32
3fb147f515b83896b0de17490aa7da4e1b261690...bf43709ad26c22c7dcc007f7b22c7237e08ca335,1,1,1,2,1,2011-04-05 23:50:56,2011-04-05 21:19:56
bf43709ad26c22c7dcc007f7b22c7237e08ca335...85ffb652ff4f1ee8d9804d8f72b5e5cc4a91c700,2,171,62,233,49,2011-04-05 23:50:57,2011-04-05 23:14:46
85ffb652ff4f1ee8d9804d8f72b5e5cc4a91c700...c245d7d3634ffce22986f8ef49a275a0a855733b,2,5,5,10,3,2011-04-05 23:50:57,2011-04-05 23:21:46
c245d7d3634ffce22986f8ef49a275a0a855733b...0fdd9cf2efa0a84926b28c25a364e0c97a9c3a43,1,1,1,2,1,2011-04-05 23:50:57,2011-04-05 23:22:19
0fdd9cf2efa0a84926b28c25a364e0c97a9c3a43...098e605f532360c8247bf220d360d1c226d8290f,2,298,275,573,29,2011-04-05 23:50:57,2011-04-05 23:50:37
098e605f532360c8247bf220d360d1c226d8290f...9e354f7caa3aae058a27b640c700f41d1db3fd42,1,1,1,2,1,2011-04-06 00:17:21,2011-04-06 00:17:21
9e354f7caa3aae058a27b640c700f41d1db3fd42...9d9275dc62b14334ed737bba7df9f305fd90315f,1,45,0,45,1,2011-04-06 01:25:49,2011-04-06 01:25:21
f214072dba79259c25b4391c2994882c284ba642...7e0586bd65a148146a7254d47e40893b1670613d,10,40,35,75,28,2011-12-08 21:01:52,2011-12-08 20:54:44
7e0586bd65a148146a7254d47e40893b1670613d...789f87e9ccfcba148aa4345f17befca6e49d847d,2,1,1,2,2,2011-12-08 21:24:32,2011-12-08 21:24:32
789f87e9ccfcba148aa4345f17befca6e49d847d...53e631d758d43c9f06a8b4f239ed40970a972fdc,2,2,2,4,2,2011-12-08 22:34:54,2011-12-08 22:34:54
53e631d758d43c9f06a8b4f239ed40970a972fdc...e221038722d54c7e5623bacbce6a8a9fa5d846b7,1,198,28,226,32,2011-12-09 13:10:48,2011-12-09 13:10:48
e221038722d54c7e5623bacbce6a8a9fa5d846b7...48ff079ebee28af28f5a82973012ee37bdb42624,2,5,5,10,5,2011-12-09 14:13:34,2011-12-09 14:12:47
48ff079ebee28af28f5a82973012ee37bdb42624...7450bc147428975b6412635ba7d9262e635316e5,2,165,37,202,27,2011-12-09 16:00:09,2011-12-07 22:15:16
7450bc147428975b6412635ba7d9262e635316e5...b064cb5acb35db617250703e5da2cfbb4a939f01,1,78,0,78,1,2011-12-09 16:00:09,2011-12-08 22:01:59
b064cb5acb35db617250703e5da2cfbb4a939f01...d2ba47fa412f8d1f9982eac8b6220a1cbec47ad0,1,1,2,3,1,2011-12-09 16:58:29,2011-12-09 16:58:29
d2ba47fa412f8d1f9982eac8b6220a1cbec47ad0...2c130588886b78c0193f15d016c1d5a28f724346,1,6,0,6,1,2011-12-09 18:57:26,2011-12-06 19:05:00
2c130588886b78c0193f15d016c1d5a28f724346...c50fed194e425750f41c8414c7254fe877600cf5,1,9,7,16,3,2011-12-09 19:04:18,2011-12-06 19:17:46
c50fed194e425750f41c8414c7254fe877600cf5...757f86029e0fc9461a5a3d12a4cc5723d6874923,1,13,8,21,6,2011-12-09 19:16:37,2011-12-08 17:16:09
757f86029e0fc9461a5a3d12a4cc5723d6874923...79f671e46eb204504df3f0e005c26bcf85efd5db,1,20,0,20,1,2011-12-09 19:16:37,2011-12-08 19:12:10
79f671e46eb204504df3f0e005c26bcf85efd5db...129b3dc5ca806b08981de78e58d65e648f546840,1,15,11,26,4,2011-12-09 19:16:37,2011-12-08 23:41:31
9d9275dc62b14334ed737bba7df9f305fd90315f...65096208afda527b3a2c6017d667041492c35669,3,114,114,228,103,2011-04-06 01:57:09,2011-04-06 01:57:09
65096208afda527b3a2c6017d667041492c35669...56daba0d4870a9e83739de88afacbe0b46cc975f,4,53,0,53,5,2011-04-06 06:50:20,2011-04-06 06:50:20
56daba0d4870a9e83739de88afacbe0b46cc975f...23dae53f75eaba0e3ad40fe37ca3e780c4a893c3,2,7,2,9,2,2011-04-06 14:33:26,2011-04-06 14:33:26
23dae53f75eaba0e3ad40fe37ca3e780c4a893c3...0d2ca3e2c188604f0bfa6533f719ffebca8b5df4,2,3,1,4,2,2011-04-06 14:56:03,2011-04-06 14:56:03
0d2ca3e2c188604f0bfa6533f719ffebca8b5df4...c4c8745b44f358dc263a3547aaf179a9ffdcd071,2,9,3,12,4,2011-04-06 15:16:39,2011-04-06 15:16:39
c4c8745b44f358dc263a3547aaf179a9ffdcd071...09795ae38a6b5814f6797c5d102f60382b4b944b,1,9,2,11,3,2011-04-06 15:26:14,2011-04-06 15:26:14
09795ae38a6b5814f6797c5d102f60382b4b944b...01a776ec9992b1f60aeb1d6af827e04da1d4eda9,1,1,1,2,1,2011-04-06 15:27:58,2011-04-06 15:27:58
01a776ec9992b1f60aeb1d6af827e04da1d4eda9...49f94ae22f9ba6c57a655cfe7441e8c14a2bafa0,3,11,4,15,4,2011-04-06 16:01:55,2011-04-06 15:58:31
49f94ae22f9ba6c57a655cfe7441e8c14a2bafa0...746af4a2747a6c09bd9298d3f99c8294cef37e68,3,30,109,139,11,2011-04-06 16:40:53,2011-04-06 16:40:53
746af4a2747a6c09bd9298d3f99c8294cef37e68...cd89ae05d7fe9bcbbf44e919a55e7b60c1e476bc,4,7,0,7,5,2011-04-06 16:41:48,2011-04-06 16:41:48
cd89ae05d7fe9bcbbf44e919a55e7b60c1e476bc...10d687fc18fc4314ab209a0b71f4c54ae7142e31,3,1,41,42,6,2011-04-06 16:48:19,2011-04-06 16:48:19
10d687fc18fc4314ab209a0b71f4c54ae7142e31...5c8f497d6c8970e47a45055d9298ebea54a49034,1,2,1,3,1,2011-04-06 17:20:28,2011-04-06 17:20:28
5c8f497d6c8970e47a45055d9298ebea54a49034...54dc72c6474738d3b1cc05ead0032350518ff29d,1,8,3,11,2,2011-04-06 17:52:02,2011-04-06 17:52:02
54dc72c6474738d3b1cc05ead0032350518ff29d...a3b7bb6b8339433b7926477307f0c3c185beb48f,4,37,13,50,7,2011-04-06 18:05:43,2011-04-06 18:05:19
a3b7bb6b8339433b7926477307f0c3c185beb48f...9193ff5d00829dccffc9572eb15a446bd4d2309e,2,29,1,30,3,2011-04-06 19:44:55,2011-04-06 19:44:07
9193ff5d00829dccffc9572eb15a446bd4d2309e...4d9e44c1ee31aff9a51d352bac9321bc3bf3bdaa,2,29,22,51,10,2011-04-06 20:40:41,2011-04-06 18:09:30
4d9e44c1ee31aff9a51d352bac9321bc3bf3bdaa...51f681328feb3dac52c27b9bb5c0d5b9a5cd671e,1,2,1,3,1,2011-04-06 20:40:43,2011-04-06 20:40:26
51f681328feb3dac52c27b9bb5c0d5b9a5cd671e...1f364244cb8cf63cab4705231a13fab1cdaff889,1,65,65,130,1,2011-04-06 20:46:52,2011-04-06 20:25:15
1f364244cb8cf63cab4705231a13fab1cdaff889...b7817b8986c958e426a5740810e0347f6a25aa2b,2,8,15,23,6,2011-04-06 20:46:53,2011-04-06 20:30:19
b7817b8986c958e426a5740810e0347f6a25aa2b...1ecf07317a45a1f546cfaa040ec051167457d853,1,19,9,28,6,2011-04-06 20:46:53,2011-04-06 20:46:45
1ecf07317a45a1f546cfaa040ec051167457d853...10c58a626db967c54fcd5a4d47fad47a74c9074e,2,4,0,4,2,2011-04-06 21:32:11,2011-04-06 21:32:11
10c58a626db967c54fcd5a4d47fad47a74c9074e...0e2ef15e9c5f54575754abac77e6e9d579b83785,2,4,7,11,6,2011-04-06 21:58:56,2011-04-06 21:58:47
129b3dc5ca806b08981de78e58d65e648f546840...21a4dccfaba8bdbfeec87bd576260d8ba8fb462a,4,648,593,1241,131,2011-12-12 21:23:17,2011-12-12 21:23:17
129b3dc5ca806b08981de78e58d65e648f546840...3a0388d26f06ce120f9ffb3b04f65887f31f1b71,2,59,7,66,2,2011-12-09 21:52:10,2011-12-09 21:51:07
3a0388d26f06ce120f9ffb3b04f65887f31f1b71...9af87f480aaea4a240fa47be3ae4163b7c936a25,1,1,1,2,1,2011-12-10 00:03:29,2011-12-10 00:03:29
9af87f480aaea4a240fa47be3ae4163b7c936a25...3f7c567c693c6d307ae55654881654655a0a5ec7,1,2,0,2,1,2011-12-10 17:18:30,2011-12-10 17:18:30
3f7c567c693c6d307ae55654881654655a0a5ec7...deefd0741bacdeeff77c9ae1b51af2f9e25c2095,1,263,111,374,15,2011-12-11 02:01:04,2011-12-11 02:01:04
6d7bae1006d09332d65c76d7da192ecd98be4027...ff71aead201ace7d99ba2d3c9e12b1ea7e8b55aa,1,1,0,1,1,2011-04-07 01:09:03,2011-04-07 01:09:03
0e2ef15e9c5f54575754abac77e6e9d579b83785...100af667b2b9342ba7385b5ac1e5fdb81edea0e8,1,6,26,32,6,2011-04-07 16:08:09,2011-04-07 16:08:09
0e2ef15e9c5f54575754abac77e6e9d579b83785...651d142fdf64b14f697cab5dd7c32b0e6222fa43,2,11,1,12,4,2011-04-06 22:10:52,2011-04-06 22:06:19
651d142fdf64b14f697cab5dd7c32b0e6222fa43...efaaadb7f73d7b63219725b52e2f752e943806d2,1,4,0,4,1,2011-04-06 22:10:52,2011-04-06 22:06:54
efaaadb7f73d7b63219725b52e2f752e943806d2...df64416280682223cd51fc2dfeb0358841188922,1,3,3,6,3,2011-04-06 22:10:52,2011-04-06 22:08:07
df64416280682223cd51fc2dfeb0358841188922...9e05a4eddbc81ff59a2e1f06ddc1939c00244b45,1,6,0,6,2,2011-04-06 22:10:52,2011-04-06 22:10:28
43a180b0a98f5f55d77151c301b4cc5d2ca46d3c...3dd48a56ab7b0dbdbe2ce8ee1d3b9ee84c303b2b,1,39,5,44,3,2011-12-12 22:18:53,2011-12-12 21:37:37
3dd48a56ab7b0dbdbe2ce8ee1d3b9ee84c303b2b...54c3c80b1f7f81e9f332a2213bd664ada3293a61,4,22,24,46,10,2011-12-13 00:39:38,2011-12-13 00:39:38
54c3c80b1f7f81e9f332a2213bd664ada3293a61...feedad9a2d03102ce052083cedb7709b5cd87d73,1,2,1,3,2,2011-12-13 00:43:47,2011-12-13 00:43:47
feedad9a2d03102ce052083cedb7709b5cd87d73...42d73f841cadcfc42ed028e2b40547d1b70688ba,11,68,51,119,30,2011-12-13 01:12:07,2011-12-13 00:33:49
42d73f841cadcfc42ed028e2b40547d1b70688ba...36a54d65fc2ebd2dd0767d63af2529ced2fdfbb1,2,170,90,260,35,2011-12-13 01:12:09,2011-12-13 01:11:02
36a54d65fc2ebd2dd0767d63af2529ced2fdfbb1...7343e485e3537520cec82e31a053a2a4e435b123,1,1,1,2,1,2011-12-13 02:11:16,2011-12-13 02:11:16
7343e485e3537520cec82e31a053a2a4e435b123...82a53933565ba4162f85ef301727054fa774fe37,1,1,1,2,1,2011-12-13 05:35:32,2011-12-13 05:35:32
82a53933565ba4162f85ef301727054fa774fe37...9e0a78c91474bc12e17c28dc6d91a972d89db142,2,21,19,40,5,2011-12-13 11:17:36,2011-12-13 11:17:36
9e0a78c91474bc12e17c28dc6d91a972d89db142...3fb4ab76d64474c43eedd67a492f249b86d42ae3,1,5,2,7,2,2011-12-13 14:33:28,2011-12-12 21:38:38
3fb4ab76d64474c43eedd67a492f249b86d42ae3...706ff9a2566bb1414b53fd36aee2e3130479212a,1,14,0,14,1,2011-12-13 14:33:28,2011-12-13 14:28:55
706ff9a2566bb1414b53fd36aee2e3130479212a...bc1c27f184cc1dda2d07f387a2534be0337640d0,1,7,2,9,4,2011-12-13 14:33:29,2011-12-13 14:29:39
bc1c27f184cc1dda2d07f387a2534be0337640d0...898240062668d4b429755ac2c18f62cf7f3c26c0,1,2,1,3,2,2011-12-13 14:33:29,2011-12-13 14:30:39
898240062668d4b429755ac2c18f62cf7f3c26c0...95a4c9fbd90efeac9c5e9ed9c3eac74f2611f3c2,1,7,1,8,1,2011-12-13 15:42:20,2011-12-13 15:42:20
95a4c9fbd90efeac9c5e9ed9c3eac74f2611f3c2...cea5e63523da873c10fc76b3acd672eb02e77316,1,2,7,9,4,2011-12-13 16:34:45,2011-12-13 16:32:45
cea5e63523da873c10fc76b3acd672eb02e77316...766e4493d3f58470cd4f1a510419393a926b7287,2,191,3,194,11,2011-12-13 19:37:47,2011-10-17 18:42:26
766e4493d3f58470cd4f1a510419393a926b7287...29adff139c3cef1c5908b07c61268ce5512d78d8,1,0,1,1,1,2011-12-13 19:45:07,2011-12-13 19:45:07
29adff139c3cef1c5908b07c61268ce5512d78d8...163b8c553b8c56f222037d00fc2766a14d846a5b,3,51,51,102,46,2011-12-13 19:58:58,2011-12-13 19:58:58
163b8c553b8c56f222037d00fc2766a14d846a5b...91d134d629015e91e27fa563bc5fb081e0a4c261,1,1,1,2,1,2011-12-13 20:39:19,2011-12-13 20:35:42
91d134d629015e91e27fa563bc5fb081e0a4c261...96d1d640fbbc2532fcf925dc55c7283bfd55e609,1,2,2,4,1,2011-12-13 20:39:19,2011-12-13 20:39:10
96d1d640fbbc2532fcf925dc55c7283bfd55e609...f1d96052a9ebcc94cbc61ff526fb686c69d6f8e2,1,2,1,3,1,2011-12-13 21:19:02,2011-12-13 18:52:46
f1d96052a9ebcc94cbc61ff526fb686c69d6f8e2...eb541c2c77aa2b1f0b724045d798c6af34de240e,1,1,5,6,2,2011-12-13 21:58:34,2011-12-13 21:58:34
eb541c2c77aa2b1f0b724045d798c6af34de240e...e1faeb6d9d1298548edb5d18f6f459bc6fe6b910,1,1,1,2,1,2011-12-13 22:00:03,2011-11-18 19:10:53
e1faeb6d9d1298548edb5d18f6f459bc6fe6b910...8995853205dbc58df0a37537cd5bdaa61472f393,12,149,95,244,41,2011-12-13 22:00:03,2011-11-09 22:28:41
8995853205dbc58df0a37537cd5bdaa61472f393...d9adbc6082e0a8d7fcf95c3767a06cf1f39f02a6,4,129,29,158,12,2011-12-13 22:03:40,2011-12-13 00:13:14
d9adbc6082e0a8d7fcf95c3767a06cf1f39f02a6...db409afb5ea4dce56c0cd341bf005a3f05b2f106,7,643,27,670,26,2011-12-14 15:14:00,2011-12-13 23:14:44
db409afb5ea4dce56c0cd341bf005a3f05b2f106...1973153321caf7483d0ff10913e196fa367d78f5,6,139,75,214,37,2011-12-14 15:48:31,2011-12-14 15:48:31
1973153321caf7483d0ff10913e196fa367d78f5...9c13e0bc611897c2b0a11e11df76605292f825e0,2,56,29,85,18,2011-12-14 15:52:22,2011-11-21 22:18:56
9c13e0bc611897c2b0a11e11df76605292f825e0...3ea528a4512a48bc0993547544451230d5a56481,2,18,2,20,4,2011-12-14 15:55:53,2011-12-14 15:55:53
3ea528a4512a48bc0993547544451230d5a56481...8351843a091cb7c2bce7f84470ee4f15b2c9e2ee,3,22,9,31,9,2011-12-14 16:18:37,2011-12-14 16:18:37
8351843a091cb7c2bce7f84470ee4f15b2c9e2ee...b8f86e566213a441fbf2b950a70f8daaf44c6e41,6,200,77,277,68,2011-12-14 17:56:49,2011-11-22 17:20:48
b8f86e566213a441fbf2b950a70f8daaf44c6e41...082a92b92097041174a5bd32a4dcd352b5ae3a00,3,19,56,75,12,2011-12-14 19:34:53,2011-12-14 19:18:08
082a92b92097041174a5bd32a4dcd352b5ae3a00...2100da5aa5d5779af02c8945c8f5e43b6489dc32,1,5,0,5,1,2011-12-14 20:14:03,2011-12-14 20:13:29
2100da5aa5d5779af02c8945c8f5e43b6489dc32...9f3b8a42c5063db0f5f7f114ba9370938dec83ff,7,58,60,118,24,2011-12-14 20:43:49,2011-12-14 20:08:17
9f3b8a42c5063db0f5f7f114ba9370938dec83ff...8844b2e732de8e88af75395fefb9cdb6efd3c66d,2,192,130,322,29,2011-12-14 20:43:52,2011-12-14 20:42:23
8844b2e732de8e88af75395fefb9cdb6efd3c66d...0cdb263ee8fcc7381db5ca8bfe0a4774fa94ac52,2,6,1,7,2,2011-12-14 20:44:31,2011-12-14 20:43:54
0cdb263ee8fcc7381db5ca8bfe0a4774fa94ac52...44ef35280f4d1112934e7f338007f95a0aeadae1,1,35,57,92,5,2011-12-14 21:18:18,2011-12-14 21:18:18
deefd0741bacdeeff77c9ae1b51af2f9e25c2095...0d6bdcd5ec070ef018c18aa167161a48199f9549,3,62,28,90,24,2011-12-11 16:01:18,2011-12-04 01:50:14
0d6bdcd5ec070ef018c18aa167161a48199f9549...c92ef6868c9123a6e0b87b7852f4eb2f2e4b6b4e,6,51,18,69,18,2011-12-11 16:01:20,2011-12-05 22:48:41
c92ef6868c9123a6e0b87b7852f4eb2f2e4b6b4e...5f7c8109db658fd786726b0868dbdf2a0c45ddd2,17,201,257,458,55,2011-12-11 16:01:23,2011-12-11 15:59:10
5f7c8109db658fd786726b0868dbdf2a0c45ddd2...5d26cc400847e478a6b0f216f2a2a29df68c2b7d,1,3,3,6,3,2011-12-11 15:20:32,2011-12-11 15:20:32
5d26cc400847e478a6b0f216f2a2a29df68c2b7d...d38957fa67f42b885172da14934d5adcfb3722fa,1,3,1,4,2,2011-12-11 17:03:01,2011-12-11 17:03:01
d38957fa67f42b885172da14934d5adcfb3722fa...0fdbec10d663e94e3a69ae169a35501f826822c1,1,123,86,209,79,2011-12-11 20:37:23,2011-12-11 20:37:23
0fdbec10d663e94e3a69ae169a35501f826822c1...59b8d78a690bfa72b9faa0cd76857ea2ed7f094b,1,115,5,120,34,2011-12-12 03:17:21,2011-12-12 03:17:21
59b8d78a690bfa72b9faa0cd76857ea2ed7f094b...707c85da920e79663d35aa2f9502288d5f294d06,4,178,29,207,31,2011-12-12 03:28:54,2011-10-26 00:42:53
707c85da920e79663d35aa2f9502288d5f294d06...af7cb35b0ba3df544e841619a9648f15023e275c,1,13,3,16,2,2011-12-12 03:28:54,2011-10-26 00:44:29
af7cb35b0ba3df544e841619a9648f15023e275c...53ba6ca66fafdfd1a09bece1626ef7977652c538,3,64,58,122,13,2011-12-12 03:28:55,2011-10-26 00:44:55
53ba6ca66fafdfd1a09bece1626ef7977652c538...46d49e316d37667c9a500d19b91353700ca37c95,7,206,145,351,9,2011-12-12 03:28:55,2011-10-26 00:46:39
46d49e316d37667c9a500d19b91353700ca37c95...2465c2a4849426a920058112cd69184d657a0ba7,1,3,3,6,3,2011-12-12 03:28:55,2011-10-26 00:47:53
2465c2a4849426a920058112cd69184d657a0ba7...74397cdcf0a56f157db4562ebd2c7819fff22df7,1,3,3,6,3,2011-12-12 03:28:55,2011-10-26 00:49:14
74397cdcf0a56f157db4562ebd2c7819fff22df7...53589d5b2980522645f10af33ce1a3bb6713daaf,1,1,1,2,1,2011-12-12 03:28:56,2011-10-26 00:50:43
53589d5b2980522645f10af33ce1a3bb6713daaf...0d947ded807a54c6cae10a7227346c69f71e07c0,1,8,2,10,2,2011-12-12 03:28:56,2011-11-09 04:44:47
0d947ded807a54c6cae10a7227346c69f71e07c0...61b387e7c1d45c5db889176488892c3e18df0b66,9,317,221,538,49,2011-12-12 03:28:56,2011-12-07 00:43:08
61b387e7c1d45c5db889176488892c3e18df0b66...89834d70bd55a1ddb6553504f03e87af4474b7e1,1,2,2,4,2,2011-12-12 03:28:56,2011-12-07 01:21:48
89834d70bd55a1ddb6553504f03e87af4474b7e1...df7f289b71bbd914187f85d18e9af2b3745d82a1,2,5,5,10,5,2011-12-12 03:28:56,2011-12-07 05:07:49
df7f289b71bbd914187f85d18e9af2b3745d82a1...f4adf5f3d38ee85f764edf64d392fc96aeb94f4f,1,1,5,6,1,2011-12-12 03:28:57,2011-12-07 05:23:37
f4adf5f3d38ee85f764edf64d392fc96aeb94f4f...cc688328b1e799273a7d7e1ccf508275edb3a423,4,83,44,127,27,2011-12-12 03:28:57,2011-12-07 06:26:41
cc688328b1e799273a7d7e1ccf508275edb3a423...00ca77d9c5efb4f48215e0406a6490571f6c4ba6,1,19,15,34,9,2011-12-12 03:28:57,2011-12-07 18:23:53
00ca77d9c5efb4f48215e0406a6490571f6c4ba6...ba581b3b5f15ac17395a149b33d592bbe4d43066,6,34,17,51,21,2011-12-12 03:28:58,2011-12-07 18:36:52
ba581b3b5f15ac17395a149b33d592bbe4d43066...4e6ae0489500f6c5b6cb33c3fcb8af7efdb69783,1,2,2,4,2,2011-12-12 03:28:58,2011-12-07 18:38:48
4e6ae0489500f6c5b6cb33c3fcb8af7efdb69783...4e08c88fbe69d09a9bbf07a91d94347b4d916d0d,1,14,1,15,3,2011-12-12 03:28:58,2011-12-12 01:53:01
4e08c88fbe69d09a9bbf07a91d94347b4d916d0d...6529f9aa1ba5e41c97c819fe374ea4fe4f09d441,3,11,14,25,8,2011-12-12 03:28:58,2011-12-12 01:54:31
6529f9aa1ba5e41c97c819fe374ea4fe4f09d441...bb58eded1207f43c4db2a6c88d72d908c7a1d305,5,618,124,742,90,2011-12-12 03:28:59,2011-12-12 01:56:23
bb58eded1207f43c4db2a6c88d72d908c7a1d305...806669bb43f14c32ec5876b06f398bf083f685a9,1,2,2,4,2,2011-12-12 03:28:59,2011-12-12 02:13:20
deefd0741bacdeeff77c9ae1b51af2f9e25c2095...f95597951233ce79faa3d717419166dc69b640ef,1,1,1,2,1,2011-12-11 13:56:35,2011-12-11 13:56:35
c5fe61a71945d062b9d0c656ba3cb69d2c90467d...eb647131e683c0d718c34432d82b9ea6f6ac5d94,1,18,9,27,9,2011-04-07 17:36:05,2011-04-07 17:36:05
44ef35280f4d1112934e7f338007f95a0aeadae1...38a558ae6ad3e1a498ced23203cd6c837f9bfbfe,4,19,0,19,6,2011-12-14 23:01:29,2011-12-14 23:01:29
44ef35280f4d1112934e7f338007f95a0aeadae1...8a824b890d5473fd80c6932d6aa5cc2f87e97626,1,1,1,2,1,2011-12-14 22:57:31,2011-12-14 22:57:31
eb647131e683c0d718c34432d82b9ea6f6ac5d94...fcffeb2ad659b0914d2000acae3ad0952c018695,1,2,2,4,2,2011-04-07 19:29:23,2011-04-07 19:29:23
eb647131e683c0d718c34432d82b9ea6f6ac5d94...cc938790f2b274043f92917e77dc8db624e95943,1,3,3,6,1,2011-04-07 18:25:25,2011-04-07 18:25:25
99d3364e1234174bee291e6b58f6c4f1e70c3dfc...d1f054c05022532ed9ed3aef071e02961a21f369,2,107,66,173,32,2011-12-15 01:16:16,2011-12-15 01:15:25
d1f054c05022532ed9ed3aef071e02961a21f369...3cf820a7435c77d7fd1ddc8eaeaef8c2734f1762,2,75,16,91,6,2011-12-15 01:18:38,2011-12-15 01:18:38
3cf820a7435c77d7fd1ddc8eaeaef8c2734f1762...ad9b8224b3145f1f1cd227a3e3774d79fdac7e02,1,1,1,2,1,2011-12-15 01:20:03,2011-12-13 22:55:03
ad9b8224b3145f1f1cd227a3e3774d79fdac7e02...6bbe838b4d89e381b0ef777a6906876752c2dd16,3,56,8,64,6,2011-12-15 01:20:03,2011-12-14 03:50:45
6bbe838b4d89e381b0ef777a6906876752c2dd16...dd62235d71bd2afcf2c9713a33f07892186ae458,2,23,4,27,8,2011-12-15 01:20:04,2011-12-14 20:54:27
dd62235d71bd2afcf2c9713a33f07892186ae458...716dc72fc03be867c1166640f24f335e71607157,2,29,1,30,3,2011-12-15 01:20:04,2011-12-14 23:43:02
716dc72fc03be867c1166640f24f335e71607157...ad23655b1d9a68c7f7b085c0edb60e3336b055e8,3,48,14,62,27,2011-12-15 01:20:04,2011-12-15 00:46:14
ad23655b1d9a68c7f7b085c0edb60e3336b055e8...e905d80d5d1eba2ef1775a71263c92870bd0ae0d,10,287,147,434,14,2011-12-15 01:20:04,2011-12-15 01:19:54
e905d80d5d1eba2ef1775a71263c92870bd0ae0d...76c0e91da521df958c842b5a2eae515677b3a3d1,1,0,4,4,1,2011-12-15 01:25:51,2011-12-15 01:25:51
76c0e91da521df958c842b5a2eae515677b3a3d1...1a944648d8d8a7ac12ff53973264501cf854916e,3,3,3,6,3,2011-12-15 01:28:21,2011-12-15 01:28:21
1a944648d8d8a7ac12ff53973264501cf854916e...e7ff9802a420ccfee8d6fa423fd5de56711e21aa,1,3,3,6,3,2011-12-15 01:39:15,2011-12-15 01:39:15
e7ff9802a420ccfee8d6fa423fd5de56711e21aa...58feea52f688187b9a1dfc83a8ee7864d80e2d64,1,2,1,3,2,2011-12-15 01:39:32,2011-12-15 01:39:32
58feea52f688187b9a1dfc83a8ee7864d80e2d64...c3a207a793ec613fe69397036f697e50663613b6,3,3,5,8,3,2011-12-15 03:02:25,2011-12-15 03:02:25
c3a207a793ec613fe69397036f697e50663613b6...06566cce9b93b7c41c26d5b30122a84251789994,1,1,1,2,1,2011-12-15 03:57:04,2011-12-15 03:57:04
06566cce9b93b7c41c26d5b30122a84251789994...9a02d3124abe69b13218b5beef5ae5ba6650def8,1,1,1,2,1,2011-12-15 04:38:39,2011-12-15 04:38:39
9a02d3124abe69b13218b5beef5ae5ba6650def8...22960475f3188b637aefacd30c077fed15ff7c7a,2,0,4,4,2,2011-12-15 07:09:25,2011-12-15 07:09:25
22960475f3188b637aefacd30c077fed15ff7c7a...ab95a1e384e716ec787d7f763c66868e877b7b17,4,28,0,28,10,2011-12-15 09:06:16,2011-12-15 09:06:16
ab95a1e384e716ec787d7f763c66868e877b7b17...1ae8bb7a2c438341aa8177e73926fb755d420fb5,1,1,1,2,1,2011-12-15 09:47:45,2011-12-15 09:47:45
1ae8bb7a2c438341aa8177e73926fb755d420fb5...7c79cef343f93d74681635f3ed8462e6dc0d9ba3,1,2,0,2,1,2011-12-15 13:47:08,2011-12-15 13:47:08
7c79cef343f93d74681635f3ed8462e6dc0d9ba3...4661dfe20a29eb8770ffb078243119bf983fd873,1,1,1,2,1,2011-12-15 15:55:45,2011-12-15 15:40:18
4661dfe20a29eb8770ffb078243119bf983fd873...1157f5230974645f598a9da99f9b74a6aeab2f88,2,3,4,7,2,2011-12-15 16:10:05,2011-12-15 16:10:05
1157f5230974645f598a9da99f9b74a6aeab2f88...1ce8da799ebf5f3e2b4f616db68d870b7c9345c4,1,41,0,41,1,2011-12-15 20:38:42,2011-12-15 20:38:16
1ce8da799ebf5f3e2b4f616db68d870b7c9345c4...955d3591ad35ec9ba2e26f624a622cc826c5360b,1,1,1,2,1,2011-12-15 21:18:00,2011-12-15 21:12:12
955d3591ad35ec9ba2e26f624a622cc826c5360b...ba4437f011dd11ae8fa168e1f030707a2378531e,1,4,8,12,4,2011-12-15 23:31:27,2011-12-15 17:59:59
ba4437f011dd11ae8fa168e1f030707a2378531e...b845b97bb85f72bcc5322307bb6ec8fa86758430,3,6,11,17,9,2011-12-15 23:32:34,2011-12-15 18:01:38
b845b97bb85f72bcc5322307bb6ec8fa86758430...285a9067c19dfe52d1bed34c3c12a06b14af3f78,2,226,172,398,2,2011-12-15 23:32:37,2011-12-15 18:02:36
285a9067c19dfe52d1bed34c3c12a06b14af3f78...1fcb2d258450963b8b2f0d0ac5b23e2ebfec6725,1,225,225,450,1,2011-12-15 23:32:39,2011-12-15 23:31:06
1fcb2d258450963b8b2f0d0ac5b23e2ebfec6725...b6e00abb7a0a29c9c0769eddc6c6ff0781b750d8,1,4,4,8,4,2011-12-15 23:34:09,2011-12-15 23:34:09
b6e00abb7a0a29c9c0769eddc6c6ff0781b750d8...91b80441d70a2ca9d3df8a6baed1701d7b8d1b9f,1,2,2,4,2,2011-12-15 22:50:28,2011-12-15 22:50:28
91b80441d70a2ca9d3df8a6baed1701d7b8d1b9f...b346f3cd216a5826eedc57560768830fad3f6225,1,5,0,5,2,2011-12-16 14:49:22,2011-12-16 14:48:38
b346f3cd216a5826eedc57560768830fad3f6225...bf7fb0566a59a6fbaddefff82bef9b5f12e77f85,1,1,1,2,1,2011-12-16 18:41:57,2011-12-16 18:41:57
bf7fb0566a59a6fbaddefff82bef9b5f12e77f85...07bcc35879ccd2d54b9d4bb6af9aa6e276c2d121,3,113,89,202,50,2011-12-16 20:23:06,2011-12-16 02:09:34
07bcc35879ccd2d54b9d4bb6af9aa6e276c2d121...03acf084423d8bf26ce388c8bcc7281d950dcbd3,2,8,5,13,4,2011-12-16 20:23:11,2011-12-16 20:20:12
639061789c6e448b46406d67d692f766563390b2...f2ad5b0254ca3d64241417c5f474090f6d4e2cd5,1,3,2,5,2,2011-12-12 05:38:45,2011-12-09 09:20:44
f2ad5b0254ca3d64241417c5f474090f6d4e2cd5...5115bf67517682ee177db5606a51e5c4b7dd698f,1,15,0,15,1,2011-12-12 05:38:45,2011-12-09 09:20:54
5115bf67517682ee177db5606a51e5c4b7dd698f...f37bb4d90557e028b2f2525add3a5784c63f42b1,1,0,1,1,1,2011-12-12 05:38:45,2011-12-11 05:40:39
f37bb4d90557e028b2f2525add3a5784c63f42b1...8d309499fdfbc69d6cb8769a4f8fad2918a8a76b,1,1,2,3,2,2011-12-12 05:38:45,2011-12-11 05:41:07
8d309499fdfbc69d6cb8769a4f8fad2918a8a76b...040724a3f35dfb3970702d0547a4a0c23858bc68,1,1,1,2,1,2011-12-12 06:15:27,2011-12-12 06:15:27
040724a3f35dfb3970702d0547a4a0c23858bc68...9796eb1bcad3913acc390c981e047a751995206d,1,3,1,4,1,2011-12-12 07:08:48,2011-12-12 06:45:33
9796eb1bcad3913acc390c981e047a751995206d...776114c3904dd72309ede8d7cc4c9760ea0fcc9a,1,2,1,3,2,2011-12-12 07:50:17,2011-12-12 07:50:17
776114c3904dd72309ede8d7cc4c9760ea0fcc9a...81c688139fc335d57b5b2f64e5deb68e0cffcae9,1,3,0,3,1,2011-12-12 12:57:53,2011-12-12 12:57:53
81c688139fc335d57b5b2f64e5deb68e0cffcae9...21fee761c6dc159ae8c3e4d26a29c17a7bcd0ef5,1,3,0,3,1,2011-12-12 15:23:19,2011-12-12 15:22:12
21fee761c6dc159ae8c3e4d26a29c17a7bcd0ef5...352b27c12fd16a289cea981f9352d723605e9403,1,4,1,5,1,2011-12-12 15:38:55,2011-12-12 15:38:55
cde9219f84d73da65e19c6db45fa7175050aaf86...b1298d7b4a9e00d199100a74c121817da8b27a2b,1,20,10,30,11,2011-04-07 20:11:23,2011-04-07 20:11:23
cde9219f84d73da65e19c6db45fa7175050aaf86...8511c5702b44aeb044a508b0ea39ba446f2cab42,2,270,176,446,56,2011-04-07 20:04:01,2011-04-07 19:12:08
8511c5702b44aeb044a508b0ea39ba446f2cab42...0b9d3a5c226d9171241dacfff573465134206230,1,1,7,8,3,2011-04-07 20:04:01,2011-04-07 20:02:40
5c47de64a04ef1a3d4210885c0b7d8a993f0a8a0...a80c82844c71324a4c1d1a2a15e25765a0f52310,2,2,2,4,2,2011-12-16 21:39:54,2011-12-16 21:39:54
a80c82844c71324a4c1d1a2a15e25765a0f52310...103a1e6019c0e0d034aed178a8fb062fc1383f52,1,32,0,32,2,2011-12-16 21:51:15,2011-12-16 21:51:15
103a1e6019c0e0d034aed178a8fb062fc1383f52...f4512aa38324ee0541d51bf003ac93fe6866e84e,4,15,21,36,12,2011-12-16 23:18:47,2011-12-16 23:18:47
f4512aa38324ee0541d51bf003ac93fe6866e84e...ff24938b5aa495e4bdee971085151534852e627c,5,54,18,72,13,2011-12-17 01:02:05,2011-12-16 21:19:26
ff24938b5aa495e4bdee971085151534852e627c...79a35c40068c27d9f5324773aac288977762a9ca,2,1,5,6,5,2011-12-17 01:02:05,2011-12-16 22:43:11
79a35c40068c27d9f5324773aac288977762a9ca...7e4a1549711a3d28cc471e106047e01fb9e9728a,2,39,65,104,13,2011-12-17 01:02:05,2011-12-17 01:00:43
7e4a1549711a3d28cc471e106047e01fb9e9728a...c8028c6e388ac15d637a12f1848bf7c8701924ba,1,1,1,2,1,2011-12-17 01:30:23,2011-12-17 01:30:23
c8028c6e388ac15d637a12f1848bf7c8701924ba...1d27cf53df4ac6e3fa1e3f8ac09da5d42ac9421a,4,141,78,219,10,2011-12-17 02:48:34,2011-12-17 02:48:34
1d27cf53df4ac6e3fa1e3f8ac09da5d42ac9421a...407303fd36e276189286630dddae4618fec937cd,1,1,0,1,1,2011-12-17 17:16:11,2011-12-17 04:22:39
407303fd36e276189286630dddae4618fec937cd...9b98973483e41c8d206d0e59114c52c9d6c3db99,2,33,34,67,27,2011-12-17 17:16:13,2011-12-17 17:15:54
9b98973483e41c8d206d0e59114c52c9d6c3db99...e143d34f669b626d62b301cb88b275e98469d009,1,6,1,7,2,2011-12-18 02:57:55,2011-12-17 07:14:20
e143d34f669b626d62b301cb88b275e98469d009...8f35e989e5602917c42de72d5150e63ec21eceb7,1,1,1,2,1,2011-12-18 02:57:55,2011-12-18 02:57:39
8f35e989e5602917c42de72d5150e63ec21eceb7...9ed156ced8b838b785d43a5bccbad6a8d0f7f9b7,1,2,3,5,2,2011-12-18 04:17:58,2011-12-17 21:47:23
9ed156ced8b838b785d43a5bccbad6a8d0f7f9b7...f9a25e7030a16bf99b73dae0171bbf7cb5365e6a,22,234,51,285,64,2011-12-18 04:18:00,2011-12-18 04:16:52
f9a25e7030a16bf99b73dae0171bbf7cb5365e6a...b18a14917ac70223c4e462d130a72c55aa613a8b,1,1,1,2,1,2011-12-18 03:40:07,2011-12-18 03:40:07
b18a14917ac70223c4e462d130a72c55aa613a8b...e21b141eecd9ea189dbbf0e7ab6da5b54ee0d800,0,0,0,0,0,2011-12-18 04:26:49,2011-12-16 20:48:40
e21b141eecd9ea189dbbf0e7ab6da5b54ee0d800...2a31e77375ab2785ace3b396ffedc2fc0053b938,2,34,1,35,2,2011-12-18 04:26:50,2011-12-17 22:15:37
2a31e77375ab2785ace3b396ffedc2fc0053b938...e87659410a8084c664c70fb8df72742f72a6adaa,1,2,0,2,2,2011-12-18 04:57:56,2011-12-18 04:57:56
e87659410a8084c664c70fb8df72742f72a6adaa...9342fa79dafa1e2dbe6f0f6c37eb77cbfb41fb8f,1,5,5,10,1,2011-12-18 04:59:41,2011-12-18 04:59:41
9342fa79dafa1e2dbe6f0f6c37eb77cbfb41fb8f...c21cd776850f91a43544b558ebc671353fb17076,1,1,1,2,1,2011-12-18 05:01:29,2011-12-18 05:01:29
c21cd776850f91a43544b558ebc671353fb17076...08ea18eaf6d41a7e9589e98b7915f31383dff2bf,1,29,0,29,1,2011-12-18 05:02:29,2011-12-18 05:02:29
08ea18eaf6d41a7e9589e98b7915f31383dff2bf...30478f1968f7f36bbd9d59bbaa2725c337645451,1,2,1,3,1,2011-12-18 05:11:34,2011-12-18 05:11:34
30478f1968f7f36bbd9d59bbaa2725c337645451...b633da88d6e2ce407988a2edba6d884a160f256c,1,1,0,1,1,2011-12-18 05:32:32,2011-12-18 05:32:32
b633da88d6e2ce407988a2edba6d884a160f256c...3c7e80456d38cb759133c2c3e955b531f4c625ea,1,4,2,6,2,2011-12-18 06:13:22,2011-12-18 06:13:22
3c7e80456d38cb759133c2c3e955b531f4c625ea...f323101a9fdcb021ae2f05882fcde7398ddd36a7,1,1,1,2,1,2011-12-18 06:14:20,2011-12-18 06:14:20
f323101a9fdcb021ae2f05882fcde7398ddd36a7...6389c67a0f499b23f60aaad80657b75856f3549c,1,21,0,21,1,2011-12-18 07:09:26,2011-12-18 07:09:26
6389c67a0f499b23f60aaad80657b75856f3549c...36f7949a181caa3369c9b03eb288463ba171f692,1,1,3,4,1,2011-12-18 17:22:00,2011-12-18 17:20:15
36f7949a181caa3369c9b03eb288463ba171f692...c14b67b558c3c32680b32b801bdc8b2dc5940f03,1,9,0,9,2,2011-12-18 17:22:02,2011-12-18 17:21:12
c14b67b558c3c32680b32b801bdc8b2dc5940f03...706b9e89a8a466111929330be449e250253a7dc8,1,452,72,524,39,2011-12-18 22:59:37,2011-12-18 22:59:37
706b9e89a8a466111929330be449e250253a7dc8...31435666fada495130ba8e1e0b0fad8bab01d16e,5,113,93,206,29,2011-12-19 15:38:55,2011-12-19 15:38:55
31435666fada495130ba8e1e0b0fad8bab01d16e...6ebb6b8e1b7f645f2e91b02387144434542315e4,1,1,1,2,1,2011-12-19 16:39:11,2011-12-19 16:39:11
6ebb6b8e1b7f645f2e91b02387144434542315e4...32f6e84c12607686ef228adfeddd5cdc1e17726e,1,6,0,6,1,2011-12-19 19:56:54,2011-12-19 19:56:54
32f6e84c12607686ef228adfeddd5cdc1e17726e...9e96a4a1a16c2ab4a4d8a64a2f2ac1a45bbd379c,56,461,382,843,165,2011-12-19 20:21:11,2011-12-19 20:20:05
9e96a4a1a16c2ab4a4d8a64a2f2ac1a45bbd379c...ef8428f52871bbe719fa04b1b32dca59b302f955,2,2,2,4,2,2011-12-19 19:44:20,2011-12-19 19:44:20
ef8428f52871bbe719fa04b1b32dca59b302f955...c3642f34d94089ed23941a0109f536a60c18007f,1,1,0,1,1,2011-12-19 20:33:23,2011-12-19 20:28:39
c3642f34d94089ed23941a0109f536a60c18007f...18fc76ec884e70373223ae78a8c5f12025c15d61,1,16,2,18,6,2011-12-19 21:06:55,2011-12-19 21:04:06
18fc76ec884e70373223ae78a8c5f12025c15d61...eb61237c403e5f34d2519d3ae4b470f8477c1fa4,3,14,15,29,3,2011-12-19 21:14:58,2011-12-19 21:14:42
eb61237c403e5f34d2519d3ae4b470f8477c1fa4...8d103a1f3b18dcfcf95b38c85f7030abe4d6d15d,1,3,1,4,2,2011-12-19 20:47:11,2011-12-19 20:47:11
352b27c12fd16a289cea981f9352d723605e9403...bb3a6f99dd08dbd3bb056e0735d339353a709b29,1,14,14,28,14,2011-12-16 21:31:47,2011-12-16 21:31:47
bb3a6f99dd08dbd3bb056e0735d339353a709b29...5ded85f377deb7f974e00a96d4af971aa8752031,2,3,1,4,2,2011-12-16 21:32:03,2011-12-16 21:32:03
352b27c12fd16a289cea981f9352d723605e9403...345331fb277ba65fa145124577dfdae3b3ed00ae,1,4,0,4,1,2011-12-12 15:42:32,2011-12-12 15:39:58
345331fb277ba65fa145124577dfdae3b3ed00ae...9d9b2cf71ae14f0813c1c587dfb8c21046d45234,2,63,1,64,2,2011-12-12 16:12:57,2011-12-08 21:48:08
9d9b2cf71ae14f0813c1c587dfb8c21046d45234...e1439a3740b3fdf67b7414b013d48f58fd1b4532,1,44,7,51,7,2011-12-12 17:07:08,2011-12-12 17:07:08
e1439a3740b3fdf67b7414b013d48f58fd1b4532...4ef6e176b44f26a43e9f29bb4459134ce0ede4d6,1,3,1,4,1,2011-12-12 19:08:51,2011-12-12 19:08:23
4ef6e176b44f26a43e9f29bb4459134ce0ede4d6...4362ed116899ed80145e118ab8526483496b8346,2,643,604,1247,134,2011-12-12 19:33:03,2011-12-12 19:33:03
4362ed116899ed80145e118ab8526483496b8346...48f8aa29059e71cc152609a0b209390ffdff09f1,2,29,0,29,3,2011-12-12 19:43:09,2011-12-12 19:43:09
48f8aa29059e71cc152609a0b209390ffdff09f1...d5ca8e65e0d3b52ecd83bff13f417037b5d89518,18,430,352,782,34,2011-12-12 19:46:45,2011-12-12 19:46:22
d5ca8e65e0d3b52ecd83bff13f417037b5d89518...5c7dd475d5871759891ce985718584dfacd28abd,2,5,5,10,4,2011-12-12 19:53:41,2011-12-12 19:53:41
5c7dd475d5871759891ce985718584dfacd28abd...39685d2888887340a26c195080a76f2745649d28,1,1,1,2,1,2011-12-12 19:11:33,2011-12-12 19:11:33
39685d2888887340a26c195080a76f2745649d28...6ebb2c50b3ce9a82fec7be921dd7996c7bd28545,1,99,60,159,44,2011-12-12 20:59:36,2011-12-12 20:59:36
6ee3bfed9acb7e8726a668889f5ea3e89e7522b1...dcca06c478d85cd64a094c41041c2984e14790aa,1,9,3,12,6,2011-04-07 20:34:10,2011-04-07 20:34:10
dcca06c478d85cd64a094c41041c2984e14790aa...1c896c3e22ec871f944084897af5623718e2e6f4,1,1,1,2,1,2011-04-07 20:37:58,2011-04-07 20:37:58
1c896c3e22ec871f944084897af5623718e2e6f4...b7162f455f67d331765ffe6c8a902a60dec86edf,1,3,0,3,1,2011-04-07 20:38:10,2011-04-07 20:38:10
b7162f455f67d331765ffe6c8a902a60dec86edf...6e7ac4a037f13da15bb964623a9e14a36c10fe25,2,5,0,5,3,2011-04-07 20:41:43,2011-04-07 20:41:43
8d103a1f3b18dcfcf95b38c85f7030abe4d6d15d...d99853d0156d4b6a615912fa838bb91783e84d56,3,7,4,11,3,2011-12-20 00:41:04,2011-12-20 00:41:04
8d103a1f3b18dcfcf95b38c85f7030abe4d6d15d...a60c9e3979c8ba9c0ab15e6a147bb56b18fdcf73,6,53,42,95,17,2011-12-19 21:45:45,2011-12-19 21:44:46
a60c9e3979c8ba9c0ab15e6a147bb56b18fdcf73...fb7a2498d3daa8b9eeac20c3923f43fd1ae18459,1,0,10,10,2,2011-12-19 22:13:55,2011-12-19 22:13:55
fb7a2498d3daa8b9eeac20c3923f43fd1ae18459...8f0c84dc201611f7c39038bceee6b6da2a85b601,1,2,2,4,2,2011-12-19 22:43:33,2011-12-19 06:35:31
8f0c84dc201611f7c39038bceee6b6da2a85b601...25e061ed48aad8b57e4364f2e98e28b14fc9cd28,1,2,2,4,2,2011-12-19 22:43:33,2011-12-19 19:47:59
25e061ed48aad8b57e4364f2e98e28b14fc9cd28...09de9bd82602ff94807cc8edd20e7eee6d712c90,1,16,0,16,1,2011-12-19 22:43:33,2011-12-19 22:43:25
09de9bd82602ff94807cc8edd20e7eee6d712c90...eb4132d63e0b5c9a982a1a9cc8fbab3cba9578bf,1,5,2,7,1,2011-12-20 00:08:32,2011-12-20 00:08:32
6e7ac4a037f13da15bb964623a9e14a36c10fe25...b7b5886d979c9211de791e75b025cb0c1a70d276,2,36,14,50,15,2011-04-08 18:44:26,2011-04-08 18:44:26
6e7ac4a037f13da15bb964623a9e14a36c10fe25...d81c86870cc4d4a47e122453319f7088db99240f,1,1,1,2,1,2011-04-07 21:11:55,2011-04-07 21:11:42
d81c86870cc4d4a47e122453319f7088db99240f...3cff88123ec7a00a8addcc0f61d0f9b73eabf261,3,48,14,62,10,2011-04-07 21:16:44,2011-04-07 21:04:32
3cff88123ec7a00a8addcc0f61d0f9b73eabf261...8eb72fe373dd9f6aa3e8d1c6c335e84d010660de,1,6,8,14,6,2011-04-07 21:16:44,2011-04-07 21:16:24
8eb72fe373dd9f6aa3e8d1c6c335e84d010660de...c126846c24a1d43179490226a3c63097d1eacd75,1,2,9,11,1,2011-04-07 21:22:13,2011-04-07 21:22:13
c126846c24a1d43179490226a3c63097d1eacd75...ff395882d2aa4c85d6023c58ade489b3e38fe617,2,156,123,279,17,2011-04-07 21:43:39,2011-04-07 21:43:28
ff395882d2aa4c85d6023c58ade489b3e38fe617...e5fc58773bd4dd68e1e26ccc6d0e3be65f72cc99,1,1,1,2,1,2011-04-07 21:56:35,2011-04-07 21:56:35
e5fc58773bd4dd68e1e26ccc6d0e3be65f72cc99...5b25538d15a980c985907ea09f115cb87431793f,5,154,153,307,111,2011-04-07 23:07:29,2011-04-07 23:07:29
5b25538d15a980c985907ea09f115cb87431793f...831eee02a5564354c600535ffa14803bcf27534d,2,15,0,15,2,2011-04-08 14:31:48,2011-04-08 14:31:05
831eee02a5564354c600535ffa14803bcf27534d...71d062e682583e19b8ab51ec4f2f8203ce19900d,1,12,0,12,1,2011-04-08 14:31:48,2011-04-08 14:31:44
aa64e74db7cbc633eab33042314025fad7cd09c7...b61a5535bc349717641190861237e7bc3741f734,1,1,1,2,1,2011-12-20 00:51:55,2011-12-20 00:51:55
b61a5535bc349717641190861237e7bc3741f734...2baf1bcf679df8e72b6d54beff19f9b40972ee4f,1,5,0,5,1,2011-12-20 14:17:55,2011-12-20 14:17:55
2baf1bcf679df8e72b6d54beff19f9b40972ee4f...5d241544ff2ad9a6d93c8fe2eb665972a9b69cb0,1,1,1,2,1,2011-12-20 15:17:42,2011-12-20 15:17:10
5d241544ff2ad9a6d93c8fe2eb665972a9b69cb0...b4c100b0083db46f7915dceaf6ce4dd86d8497c6,2,10,2,12,4,2011-12-20 15:55:42,2011-12-20 15:51:42
b4c100b0083db46f7915dceaf6ce4dd86d8497c6...2f2b6cba7615bb3876fe459076f85ae3a413e40b,1,4,1,5,1,2011-12-20 16:33:12,2011-12-20 16:32:52
2f2b6cba7615bb3876fe459076f85ae3a413e40b...3567d17a58845fb1e1c8f84da18aa0a5a9118d4b,1,6,2,8,3,2011-12-20 16:34:19,2011-12-02 16:46:00
3567d17a58845fb1e1c8f84da18aa0a5a9118d4b...97666dd833dccd69268194524a87ec47532be346,1,1,1,2,1,2011-12-20 16:41:06,2011-12-20 16:41:06
97666dd833dccd69268194524a87ec47532be346...4060d82d79a22b1330b2fc6552444a32db093a9d,2,23,11,34,4,2011-12-20 17:05:38,2011-12-20 17:05:38
4060d82d79a22b1330b2fc6552444a32db093a9d...153c217d8e0c8d6e04184dbb9a1e1910113633bc,1,5,0,5,1,2011-12-20 17:18:23,2011-12-20 17:15:52
153c217d8e0c8d6e04184dbb9a1e1910113633bc...f3943569e09993659a82969e72cdac011c10cc64,1,7,0,7,2,2011-12-20 17:18:23,2011-12-20 17:17:05
f3943569e09993659a82969e72cdac011c10cc64...c7a0a5d056c70bfa24e101d3e7482ebf526a205d,1,63,0,63,1,2011-12-20 17:18:23,2011-12-20 17:18:13
c7a0a5d056c70bfa24e101d3e7482ebf526a205d...912c9af513016740282701afb42aff08c4a000ed,3,17,3,20,3,2011-12-20 18:11:46,2011-12-20 18:11:37
912c9af513016740282701afb42aff08c4a000ed...ceaa11646de9eda45d16d51a1ac01dd97e135cb5,1,2,1,3,1,2011-12-20 18:32:59,2011-12-20 18:32:35
ceaa11646de9eda45d16d51a1ac01dd97e135cb5...88e4e699dc4db5efd20f393ac587fbe8d66673ac,1,17,0,17,1,2011-12-20 19:53:20,2011-12-20 19:53:20
88e4e699dc4db5efd20f393ac587fbe8d66673ac...cc37fe348d61291f2e9a1d8e12334184020c9f9b,4,105,4,109,10,2011-12-20 20:42:54,2011-12-20 19:49:00
cc37fe348d61291f2e9a1d8e12334184020c9f9b...f2968db61913ee4b9be5e6401836ced0f606ce35,2,16,8,24,6,2011-12-20 20:42:54,2011-12-20 20:42:45
f2968db61913ee4b9be5e6401836ced0f606ce35...9e05bc58e16e1618db0d9a5ab3e5e3655080789f,1,3,4,7,2,2011-12-20 21:21:30,2011-12-20 21:21:30
9e05bc58e16e1618db0d9a5ab3e5e3655080789f...7941b98733fcb480bbfaf15ae2097b3eaa6e081c,1,4,2,6,1,2011-12-20 21:32:59,2011-12-20 21:31:54
7941b98733fcb480bbfaf15ae2097b3eaa6e081c...8de99aae6b84dee5a09481e2b50da518456522bd,3,23,10,33,4,2011-12-20 21:42:53,2011-12-20 21:39:28
8de99aae6b84dee5a09481e2b50da518456522bd...5de2d423d8f2356e4c168b0c5dd2b555d9b8f1f2,1,1,1,2,1,2011-12-20 23:05:41,2011-12-20 23:05:41
5de2d423d8f2356e4c168b0c5dd2b555d9b8f1f2...06a3af77f906ecf2797d4eb76dda896da7e948a3,1,4,1,5,2,2011-12-21 05:05:37,2011-12-18 04:55:08
06a3af77f906ecf2797d4eb76dda896da7e948a3...67004f1f526d231b782aa2f04ce1e100d83b4073,1,1,1,2,1,2011-12-21 05:08:37,2011-12-21 05:08:37
d0b2bdad87b142f9ef4a1bc541c94a68cd49b484...8b035652c1292998ae2b60af0134f6a4db7e8456,1,4,2,6,3,2011-04-11 09:19:21,2011-04-11 09:19:21
8b035652c1292998ae2b60af0134f6a4db7e8456...c7805762227bafa4059750d11ee4718205d26cc1,1,57,39,96,30,2011-04-11 09:50:45,2011-04-11 09:50:45
c7805762227bafa4059750d11ee4718205d26cc1...3ef6632eb95b232973aade1076fcc0428a7db426,1,69,0,69,1,2011-04-11 14:40:31,2011-04-11 14:40:31
67004f1f526d231b782aa2f04ce1e100d83b4073...219e18eae9c218d09d04f04ce3f5c3ea4b10b2ab,1,10,2,12,3,2011-12-21 14:21:00,2011-12-21 14:18:27
219e18eae9c218d09d04f04ce3f5c3ea4b10b2ab...211112b40fda601f02499b456e54ff6c50a6293b,1,1,1,2,1,2011-12-21 15:10:39,2011-12-21 15:10:39
67004f1f526d231b782aa2f04ce1e100d83b4073...0bbd941f492c784b97f3f2b21ede4e348b9ac7fd,1,1,1,2,1,2011-12-21 13:01:15,2011-12-21 13:01:15
3ef6632eb95b232973aade1076fcc0428a7db426...7c986e64325acda9c4b9bbf82e7f451c112fc714,14,469,181,650,118,2011-04-11 22:21:48,2011-04-11 22:21:48
7c986e64325acda9c4b9bbf82e7f451c112fc714...bab2182780cd415fd8a25a225501578e534e74ac,7,249,22,271,36,2011-04-12 21:09:08,2011-04-12 21:09:08
bab2182780cd415fd8a25a225501578e534e74ac...9bb89d382f6c8bdde0269899df289c6cc0850473,1,1,5,6,4,2011-04-13 18:00:01,2011-04-13 18:00:01
9bb89d382f6c8bdde0269899df289c6cc0850473...7e2c810dc6bbf16ad8dbdd6f0310afaf51f833a1,3,11,7,18,4,2011-04-14 01:58:10,2011-04-14 01:58:10
7e2c810dc6bbf16ad8dbdd6f0310afaf51f833a1...4f2f00bba00b997949d9acb2e9de49e9f583b976,5,48,11,59,11,2011-04-19 17:36:21,2011-04-19 17:36:21
4f2f00bba00b997949d9acb2e9de49e9f583b976...6b6dd6e45d1a933ff646c1b6c3175881be0bc9d5,1,5,0,5,1,2011-04-20 13:23:39,2011-04-20 13:23:39
6b6dd6e45d1a933ff646c1b6c3175881be0bc9d5...a7040fc63455fc472a107932b5aa3d19578fa53b,1,1,1,2,1,2011-04-20 13:24:36,2011-04-20 13:24:36
a7040fc63455fc472a107932b5aa3d19578fa53b...ac86734a43cb7ee8e8710dea30b3e54070a12db7,1,3,1,4,1,2011-04-20 13:25:59,2011-04-20 13:25:59
ac86734a43cb7ee8e8710dea30b3e54070a12db7...138c60541a203569feefb5cc536143480391821d,1,12,6,18,4,2011-04-20 13:30:56,2011-04-20 13:30:56
138c60541a203569feefb5cc536143480391821d...ede44430d1000badf520ee3292a37bb306a66bd2,5,76,56,132,33,2011-04-20 16:07:08,2011-04-20 16:07:08
ede44430d1000badf520ee3292a37bb306a66bd2...a6cceefeb794c2fd38384c54e6b3299b628e7f08,17,675,327,1002,172,2011-04-20 19:45:32,2011-04-20 19:45:32
a6cceefeb794c2fd38384c54e6b3299b628e7f08...846a7a0bc516f80659fb10db4bb6b2f54ca1d791,14,77,35,112,32,2011-04-21 18:53:10,2011-04-21 18:53:10
846a7a0bc516f80659fb10db4bb6b2f54ca1d791...52ea89ab4753084e2d4231c9105a68ef95a78ae7,11,277,220,497,149,2011-04-22 22:16:43,2011-04-22 22:16:43
52ea89ab4753084e2d4231c9105a68ef95a78ae7...c335ebcd0f97788740995e7aeed4c39c7eb8607d,6,1713,1697,3410,14,2011-04-23 02:04:51,2011-04-23 02:04:51
c335ebcd0f97788740995e7aeed4c39c7eb8607d...c8de43c161b4e46df89e361e301904c21bc4e797,1,24,18,42,6,2011-04-25 02:16:41,2011-04-25 02:16:41
c8de43c161b4e46df89e361e301904c21bc4e797...16aa2fd807c0fd8f40ea5ceb48e819cff90cb951,2,13,4,17,4,2011-04-25 14:24:28,2011-04-25 14:24:28
16aa2fd807c0fd8f40ea5ceb48e819cff90cb951...2d176b320aed5c2f301723fa370bdb59096307a6,1,30,7,37,8,2011-04-27 13:52:11,2011-04-27 13:52:11
2d176b320aed5c2f301723fa370bdb59096307a6...6f8d8e4ff919d9d606f85d20f96740f0b664f27c,2,5,3,8,2,2011-05-02 18:03:19,2011-05-02 18:03:19
6f8d8e4ff919d9d606f85d20f96740f0b664f27c...67a5a1934c6c1c42c2e41fb8ed16cee54b82c21c,8,294,261,555,186,2011-05-02 22:16:03,2011-05-02 22:16:03
67a5a1934c6c1c42c2e41fb8ed16cee54b82c21c...4382278e828c312a60fc69f53a7fd6f54845bb89,2,8,6,14,4,2011-05-03 02:02:18,2011-05-03 02:02:18
3ef6632eb95b232973aade1076fcc0428a7db426...5ad8d4b8ff49e3e08c4020c2438dc624f75b41c6,1,1,1,2,1,2011-04-11 16:07:23,2011-04-11 16:07:23
5ad8d4b8ff49e3e08c4020c2438dc624f75b41c6...fbbd3785a8bd14465347169e07c3cdc0edc55649,1,2,2,4,2,2011-04-11 18:22:12,2011-04-11 18:22:12
fbbd3785a8bd14465347169e07c3cdc0edc55649...4e4a1c2b282d071568553f92e9c40f3db7c71ff0,5,615,84,699,73,2011-04-11 19:16:35,2011-04-07 17:43:14
4e4a1c2b282d071568553f92e9c40f3db7c71ff0...73126163cc233828fa724d12ff0d197dcf3b41e3,1,4,0,4,2,2011-04-11 22:26:21,2011-04-11 22:26:21
73126163cc233828fa724d12ff0d197dcf3b41e3...00c383f6c0551f5b1748a29d00a8a77b52d72a16,1,218,87,305,29,2011-04-11 23:00:15,2011-04-11 22:54:09
00c383f6c0551f5b1748a29d00a8a77b52d72a16...ae79f44dd289e67b5b68adf931312e96c2dd2e2d,2,2,5,7,2,2011-04-11 23:00:15,2011-04-11 22:59:00
e3dc32dc9a4f58364dd80f94271ce81d95e2f509...e65a90d143c8155a5a8dfb4f34c2152e638e39c5,1,98,103,201,61,2011-12-21 15:36:42,2011-12-21 15:36:42
e65a90d143c8155a5a8dfb4f34c2152e638e39c5...2fa3f79aeb5185053541be4e1412bcf97399c6dc,5,22,5,27,5,2011-12-21 17:24:18,2011-12-21 17:24:18
2fa3f79aeb5185053541be4e1412bcf97399c6dc...d98f37b72dcf0ee64bf621a1f82d753203e10ecc,1,2,0,2,2,2011-12-21 17:59:17,2011-12-21 17:59:17
d98f37b72dcf0ee64bf621a1f82d753203e10ecc...51054057b2ed432ef925cb48bcb28e5684d8b76d,1,4,1,5,2,2011-12-21 18:09:09,2011-12-21 18:05:04
51054057b2ed432ef925cb48bcb28e5684d8b76d...a93ef638b67424aa5f3c412d6e7b2f4a0a53b6fe,1,1,1,2,2,2011-12-21 18:17:44,2011-12-21 18:17:34
a93ef638b67424aa5f3c412d6e7b2f4a0a53b6fe...ea3ecfdc0908a014c1db5778e1b354fd4ac850e2,1,1,2,3,2,2011-12-21 18:22:23,2011-12-21 18:21:15
ea3ecfdc0908a014c1db5778e1b354fd4ac850e2...15d5ed29163283a784fab344f50404a0a46207af,1,22,4,26,3,2011-12-21 19:07:08,2011-12-21 18:54:44
15d5ed29163283a784fab344f50404a0a46207af...e07910f4c70d42be505fc0af97735a5aac55e67d,1,2,2,4,1,2011-12-21 19:30:04,2011-12-21 19:30:04
e07910f4c70d42be505fc0af97735a5aac55e67d...529890db59690e1027a1c0a4e4034525f372bae5,1,13,21,34,2,2011-12-21 19:45:43,2011-12-21 19:44:46
529890db59690e1027a1c0a4e4034525f372bae5...14758c586c184f3d59d8a5e90465ae02d8a68373,1,1,1,2,1,2011-12-21 19:49:34,2011-12-21 19:39:09
14758c586c184f3d59d8a5e90465ae02d8a68373...0ce372f89f5052cfcd389486ba1f9c8c23942d2a,1,3,3,6,3,2011-12-21 21:17:03,2011-12-21 21:17:03
0ce372f89f5052cfcd389486ba1f9c8c23942d2a...4fa93b277db5613bdd11019d04c1cd0da1c1d162,1,1,1,2,1,2011-12-21 21:31:05,2011-12-21 21:31:05
4fa93b277db5613bdd11019d04c1cd0da1c1d162...7525b291d104c7acd1823905e8cb269da49bd767,1,3,4,7,3,2011-12-21 21:49:20,2011-12-21 21:49:20
7525b291d104c7acd1823905e8cb269da49bd767...5150c31ac4c46677debbd5ff68d372eced680235,1,1,1,2,1,2011-12-21 22:10:33,2011-12-21 22:10:33
5150c31ac4c46677debbd5ff68d372eced680235...5827c82fa8992f585dfdf2f766c01bb40f5a218e,4,72,2,74,10,2011-12-21 22:42:58,2011-12-21 01:05:26
ae79f44dd289e67b5b68adf931312e96c2dd2e2d...1369f8f3c478170c52f066829476ad7bc61fddbc,2,28,4,32,8,2011-04-12 22:53:58,2011-04-12 22:53:58
ae79f44dd289e67b5b68adf931312e96c2dd2e2d...220d4139069d5eed73a457a0c1f22463c9e660d1,1,4,4,8,3,2011-04-11 23:27:19,2011-04-11 23:27:19
220d4139069d5eed73a457a0c1f22463c9e660d1...7dee30b39fc0b69914923f029811c77a22dae141,1,1,1,2,1,2011-04-11 23:32:30,2011-04-11 23:32:30
7dee30b39fc0b69914923f029811c77a22dae141...fc0500e539ef912002631d9deb23a3f153b81c44,1,3,1,4,1,2011-04-11 23:45:25,2011-04-11 23:45:25
fc0500e539ef912002631d9deb23a3f153b81c44...c440cb9ddaa9cde91f58f35f24d6ac4d2583a016,1,51,0,51,1,2011-04-12 01:32:01,2011-04-12 01:32:01
c440cb9ddaa9cde91f58f35f24d6ac4d2583a016...4ea7daa56983d67ebe6010ffb8599349942237a0,1,4,0,4,1,2011-04-12 15:25:47,2011-04-12 15:25:47
4ea7daa56983d67ebe6010ffb8599349942237a0...d3df83bf029a8ca06d9fe1d461a5fe57748ec7ba,1,1,2,3,1,2011-04-12 15:25:57,2011-04-12 15:25:57
d3df83bf029a8ca06d9fe1d461a5fe57748ec7ba...f86fd65d66b92d0d0f6b524641f9084ab8446f3d,4,16,5,21,5,2011-04-12 15:37:23,2011-04-12 15:37:23
f86fd65d66b92d0d0f6b524641f9084ab8446f3d...a354d60a16e401d5303270e960b511fd2f07448c,3,21,1,22,8,2011-04-12 16:09:31,2011-04-12 16:09:31
a354d60a16e401d5303270e960b511fd2f07448c...f8b902ebc6bbf351cc2c424f20955493656b5446,1,1,7,8,2,2011-04-12 16:10:54,2011-04-12 16:10:54
5827c82fa8992f585dfdf2f766c01bb40f5a218e...cb1515b9cb66fb80bd85aed4c55d6c93f139581a,1,4,1,5,1,2011-12-22 22:31:32,2011-12-22 22:31:32
5827c82fa8992f585dfdf2f766c01bb40f5a218e...83c101d111731322c0264ed96b28f49381a849bd,1,1,1,2,1,2011-12-22 16:07:55,2011-12-22 16:06:30
83c101d111731322c0264ed96b28f49381a849bd...e5c01f7360439e0976a5220fe84caa13ff662131,1,10,0,10,2,2011-12-22 16:50:28,2011-12-22 16:50:28
e5c01f7360439e0976a5220fe84caa13ff662131...dc9fb4cc88aa3c4fd5cd7475901857ff29c5f438,1,9,0,9,1,2011-12-22 17:24:20,2011-12-22 17:23:44
dc9fb4cc88aa3c4fd5cd7475901857ff29c5f438...993a4a55efffad18cd735db0adc6604be5d0e807,1,24,14,38,4,2011-12-22 18:33:37,2011-12-22 18:33:37
993a4a55efffad18cd735db0adc6604be5d0e807...5b6a46a603dadda153db1581dea3000f57963631,5,25,5,30,9,2011-12-22 20:08:40,2011-12-22 20:08:40
5b6a46a603dadda153db1581dea3000f57963631...4691085ea565db1b52be8ab63332da94347f2fea,1,54,35,89,12,2011-12-22 20:36:11,2011-12-22 20:34:44
4691085ea565db1b52be8ab63332da94347f2fea...6dbda206551284b242c768a122243e3dcf897cc1,1,63,19,82,10,2011-12-22 21:33:27,2011-12-22 21:33:27
6dbda206551284b242c768a122243e3dcf897cc1...504b8c51ca05c707dd60aa89d4f78358abb2a066,1,8,2,10,2,2011-12-22 22:16:48,2011-12-22 22:16:48
504b8c51ca05c707dd60aa89d4f78358abb2a066...dbcbb1463d9fa951d2d13bd3346dd9d2d95dc9e2,1,3,0,3,1,2011-12-22 22:31:29,2011-12-22 22:30:27
dbcbb1463d9fa951d2d13bd3346dd9d2d95dc9e2...3fa7478a6f890fe631d4381acbd802b42c545301,2,0,6,6,5,2011-12-22 23:05:23,2011-12-22 23:05:23
3fa7478a6f890fe631d4381acbd802b42c545301...00c8aa955ab27e4ccfdde481c779615a1d79c36d,3,39,3,42,6,2011-12-22 23:17:27,2011-12-22 23:17:09
ead352ffece502164f68f42e69ca951318f583ac...6fe499effc4fe74a0acdcd9939af8d2062d277f6,4,6,4,10,6,2011-05-03 20:17:38,2011-05-03 20:17:38
ead352ffece502164f68f42e69ca951318f583ac...929f3ec75cc8f4cbbac17e4c07b5256aed5d375d,3,0,4,4,3,2011-05-03 20:06:48,2011-05-03 20:06:48
4f5efa53d478157a62a5131e65ea5afafa2a7b1a...4c66fe26c74839682e72ee3ec704f85834a63380,10,344,23,367,32,2011-04-13 04:54:20,2011-04-13 04:53:55
4c66fe26c74839682e72ee3ec704f85834a63380...e1f8ea459eaeb70622679d35736a035f81b8edb2,1,5,3,8,1,2011-04-13 05:24:49,2011-04-13 05:24:49
e1f8ea459eaeb70622679d35736a035f81b8edb2...e50a02fa1e3cdb4856c89f1f0144b8f2ab6cd88e,1,2,2,4,2,2011-04-13 05:25:05,2011-04-13 05:25:05
e50a02fa1e3cdb4856c89f1f0144b8f2ab6cd88e...81d192dff01d80ac89ef4a021f729eb377d5bc33,2,42,2,44,3,2011-04-13 18:29:23,2011-04-13 18:29:23
81d192dff01d80ac89ef4a021f729eb377d5bc33...5a7c53cb5c01f7e16c0f6f64b71ecbcc310931fd,1,1,1,2,1,2011-04-13 18:29:29,2011-04-13 18:29:29
5a7c53cb5c01f7e16c0f6f64b71ecbcc310931fd...12c745e38735feabcd26df60bb900e792502c633,2,0,21,21,2,2011-04-13 18:30:12,2011-04-13 18:30:12
f8b902ebc6bbf351cc2c424f20955493656b5446...9c8515d27a22948d198a5e42366b847e5597da9b,1,1,1,2,1,2011-04-12 17:37:34,2011-04-12 17:37:34
f8b902ebc6bbf351cc2c424f20955493656b5446...780539fe551c38aa68701e073bbe10f0972d13cb,1,4,6,10,2,2011-04-12 17:13:43,2011-04-12 17:13:43
ecb64a7f04830befe38491b0f52f2f87eca2db03...1480c8756d280a06a19446ddbd29f157c6b62a11,3,40,42,82,4,2011-12-23 01:41:05,2011-12-23 01:41:05
1480c8756d280a06a19446ddbd29f157c6b62a11...85f34e66056a03b775314856693b10fb70f369ad,4,8,2,10,6,2011-12-23 02:32:14,2011-12-23 02:32:14
85f34e66056a03b775314856693b10fb70f369ad...c443ba7bd935e50c76dc680c06dfd463ab3833de,1,1,1,2,1,2011-12-23 03:05:43,2011-12-23 03:05:43
c443ba7bd935e50c76dc680c06dfd463ab3833de...53a4d22e812282d2bbc92fc345a3a1045613842c,3,161,188,349,30,2011-12-23 03:05:50,2011-12-23 03:05:50
53a4d22e812282d2bbc92fc345a3a1045613842c...1aae6e9142e7ac61843996d982c85c53479e8800,2,3,3,6,2,2011-12-23 05:57:01,2011-12-23 05:57:01
1aae6e9142e7ac61843996d982c85c53479e8800...4d93f3df75a388316fcf7b8959449b097d8186ec,2,61,5,66,3,2011-12-23 15:50:40,2011-12-23 15:43:11
4d93f3df75a388316fcf7b8959449b097d8186ec...c9f3dcb266ea1ab234beb1c387023834af87a2fc,1,5,0,5,3,2011-12-23 16:21:10,2011-12-23 16:18:17
c9f3dcb266ea1ab234beb1c387023834af87a2fc...4cb6d892d3332cdbc7a5009671dbde69f5998718,1,17,13,30,3,2011-12-23 17:00:03,2011-12-23 16:59:13
4cb6d892d3332cdbc7a5009671dbde69f5998718...2c8926fb73d94b40de22a37731405c64afe1bc09,2,19,3,22,3,2011-12-23 17:02:57,2011-12-23 17:02:28
2c8926fb73d94b40de22a37731405c64afe1bc09...2dfeb1a5c5902b910e6066cedc2618c2125ec60c,1,0,1,1,1,2011-12-23 18:23:32,2011-12-23 18:23:32
2dfeb1a5c5902b910e6066cedc2618c2125ec60c...f846834354abaf557a92fac3d474020c6db90264,2,39,41,80,19,2011-12-23 21:30:46,2011-12-23 16:45:14
f846834354abaf557a92fac3d474020c6db90264...eb293c09a456e24dc0b83ede05839fa22c8f9e27,1,5,2,7,3,2011-12-23 22:30:42,2011-12-23 22:28:36
eb293c09a456e24dc0b83ede05839fa22c8f9e27...68bc1931ee48863bf52c8317395107c6a7b7f617,1,8,2,10,4,2011-12-23 22:40:29,2011-12-23 22:39:20
68bc1931ee48863bf52c8317395107c6a7b7f617...11944664894c29e9d1c31fcdf256d652cd7d9ce3,2,9,8,17,4,2011-12-24 18:44:34,2011-12-24 18:44:34
11944664894c29e9d1c31fcdf256d652cd7d9ce3...dfa4cd7e2cf109b072440155fabc08a93c8045a0,1,2,2,4,1,2011-12-24 20:25:19,2011-12-24 20:25:19
dfa4cd7e2cf109b072440155fabc08a93c8045a0...ae1ecd9c786911f9f1f0242f0f7d702b3e5dfeba,888,102,114,216,60,2011-12-24 20:33:45,2011-12-24 20:33:26
ae1ecd9c786911f9f1f0242f0f7d702b3e5dfeba...c8af8a123611cf88ca59e689cf8f9aa961b02ab4,1,6,4,10,3,2011-12-25 01:25:24,2011-12-25 01:25:24
c8af8a123611cf88ca59e689cf8f9aa961b02ab4...17eafca8397607bb5364535b233e1e67ee855299,1,33,8,41,10,2011-12-25 03:49:25,2011-12-25 03:48:28
17eafca8397607bb5364535b233e1e67ee855299...da402cf22d45841c7c1f4cd9583c1d327899b057,1,4,4,8,2,2011-12-25 04:01:31,2011-12-25 04:01:31
31e9d7307c55d71a19cb9c7706cefbb2165020df...511e4be86b30705c47754cd3125f7064365e6e5a,1,11,4,15,2,2011-05-03 20:24:42,2011-05-03 20:24:42
511e4be86b30705c47754cd3125f7064365e6e5a...30cf98d5d70370563dd90f4fc1dd75dba506405e,2,4,2,6,2,2011-05-03 20:31:21,2011-05-03 20:31:21
12c745e38735feabcd26df60bb900e792502c633...260f7852722d5937900e40c362976ce2a71b105d,2,29,7,36,4,2011-04-14 21:35:56,2011-04-14 21:35:56
12c745e38735feabcd26df60bb900e792502c633...845eb8c9d8924f990ae36f81bf50a12dc38458e8,2,179,24,203,18,2011-04-13 22:15:18,2011-04-13 22:14:12
845eb8c9d8924f990ae36f81bf50a12dc38458e8...c5f2988fd091a68890d7f740728105fe855a8d37,1,26,16,42,12,2011-04-13 23:04:38,2011-04-13 22:59:22
c5f2988fd091a68890d7f740728105fe855a8d37...cb89d4b543dd6e600ad7f593828952ad9f55139f,1,1,1,2,1,2011-04-14 00:25:42,2011-04-14 00:25:42
cb89d4b543dd6e600ad7f593828952ad9f55139f...5e6f75b1c554f02c361500ee1afc2c680023cc75,3,7,4,11,6,2011-04-14 00:49:49,2011-04-14 00:49:49
5e6f75b1c554f02c361500ee1afc2c680023cc75...76b168785fa1f9b1fa92a1c7eea6f12ad299071d,2,3,2,5,3,2011-04-14 17:49:23,2011-04-14 17:49:23
76b168785fa1f9b1fa92a1c7eea6f12ad299071d...fbc4032a8ac5f71f2fd4877f55208c007aed393c,1,4,1,5,1,2011-04-14 17:59:12,2011-04-14 17:59:12
f605cadf54c5890740967c29c8bc9915bb0f9d07...ec2af8b55aaed263b875943bd73be2bc7ba3d780,2,248,0,248,4,2011-04-12 17:37:56,2010-10-29 00:31:54
ec2af8b55aaed263b875943bd73be2bc7ba3d780...c05b16d7711ff5d5b63b60e7d9ccb049eb08b379,1,72,71,143,21,2011-04-12 17:37:56,2011-04-11 20:55:39
c05b16d7711ff5d5b63b60e7d9ccb049eb08b379...678dd045058bdef50c217a6c6ca8a254401416cb,1,221,0,221,1,2011-04-12 17:37:56,2011-04-12 16:18:02
678dd045058bdef50c217a6c6ca8a254401416cb...46363cf5f2a46cec5add6ffcf784881d45e3322b,1,8,8,16,5,2011-04-12 17:37:56,2011-04-12 17:08:50
46363cf5f2a46cec5add6ffcf784881d45e3322b...4762b2074ebac4a95000e06b69d9649fac14b705,8,327,11,338,27,2011-04-12 17:57:26,2011-04-12 17:56:32
4762b2074ebac4a95000e06b69d9649fac14b705...41631ef969129a604a0185eb96dc35fa1de54294,1,3,3,6,2,2011-04-12 17:57:26,2011-04-12 17:57:13
41631ef969129a604a0185eb96dc35fa1de54294...1c9e34bcd8bed3e7c5cb6ea364c0686530061598,2,24,2,26,6,2011-04-12 18:20:04,2011-04-12 18:20:04
1c9e34bcd8bed3e7c5cb6ea364c0686530061598...79b8999754e29af242d411507003ac8f9f8bde4a,2,4,5,9,4,2011-04-12 20:11:10,2011-04-12 20:11:10
79b8999754e29af242d411507003ac8f9f8bde4a...fd33c673ab6c69a96470f14f795fde5a7bddd08c,1,204,190,394,6,2011-04-12 20:42:00,2011-04-12 20:41:43
fd33c673ab6c69a96470f14f795fde5a7bddd08c...9d8740619600d754389632a1e3fe8063bdea9784,1,16,5,21,6,2011-04-12 21:07:57,2011-04-12 21:07:57
9d8740619600d754389632a1e3fe8063bdea9784...c68392bfe824cc4c8bae24fd9622d8872a05f98a,1,6,4,10,1,2011-04-12 22:23:47,2011-04-12 16:25:55
c68392bfe824cc4c8bae24fd9622d8872a05f98a...30792b84a37510eda7f4b02b99b895be207e5293,2,8,3,11,4,2011-04-12 22:23:47,2011-04-12 17:00:38
30792b84a37510eda7f4b02b99b895be207e5293...63943c6541e94a28d9dbe31058c027872b06b37d,1,5,4,9,3,2011-04-12 22:23:47,2011-04-12 17:29:47
63943c6541e94a28d9dbe31058c027872b06b37d...6cab62d6cea02d6b48ef9d017225232d07bfaacc,1,1,1,2,1,2011-04-12 22:31:04,2011-04-12 22:31:04
6cab62d6cea02d6b48ef9d017225232d07bfaacc...bba87960d05de77e29e002048fe28131bc703365,1,20,4,24,1,2011-04-12 22:31:02,2011-04-12 22:30:16
da402cf22d45841c7c1f4cd9583c1d327899b057...f229dfb177eeeac49d936e69b3fe8a9fdf439ad1,1,7,4,11,2,2011-12-25 06:21:33,2011-12-25 06:18:55
f229dfb177eeeac49d936e69b3fe8a9fdf439ad1...ab391b3ce38ede564d528d3202cf67177c8dc8cf,1,4,4,8,2,2011-12-25 06:22:13,2011-12-25 06:22:13
da402cf22d45841c7c1f4cd9583c1d327899b057...09332c2c3bef0e4ea6377c0b51e70f334895fe7c,1,4,4,8,2,2011-12-25 05:12:11,2011-12-25 05:12:11
30cf98d5d70370563dd90f4fc1dd75dba506405e...8b0e7ecde68404c527f54ca14c4aed2fac2ae916,1,21,11,32,3,2011-05-03 20:59:14,2011-05-03 20:59:14
30cf98d5d70370563dd90f4fc1dd75dba506405e...251af4da040b5c377b5829b9824307d94e152f23,1,2,1,3,1,2011-05-03 20:35:04,2011-05-03 20:35:04
55cbefc22dfd2dc338990654deb71da48596c738...002c71ed7a3e97683815cf36db92f529c375a854,1,1,1,2,1,2011-04-14 22:52:50,2011-04-14 22:52:50
fbc4032a8ac5f71f2fd4877f55208c007aed393c...a463ddb5f7a946c102c79a7eb7d1ef92f03f4ca4,1,1,1,2,1,2011-04-14 18:00:17,2011-04-14 18:00:17
a463ddb5f7a946c102c79a7eb7d1ef92f03f4ca4...b66adf88283ac4c234eb41db4e1b5f9f6d6e6fb0,1,20,2,22,4,2011-04-14 18:30:52,2011-04-14 18:30:52
fbc4032a8ac5f71f2fd4877f55208c007aed393c...380c6217af2a847d90ba688f7eaf37633e04aa14,2,92,26,118,20,2011-04-14 17:56:41,2011-04-14 17:43:17
bc0982dc010109132570afaefc9c0be512893975...607d9fc0a50f593348445085fe3395b85d05ccce,1,4,4,8,2,2011-12-25 06:24:30,2011-12-25 06:24:30
607d9fc0a50f593348445085fe3395b85d05ccce...baf050dd1891da12f2f4290b6356ff2c99aa9cde,1,3,3,6,1,2011-12-25 15:41:34,2011-12-25 15:41:34
baf050dd1891da12f2f4290b6356ff2c99aa9cde...71b0d616fe41d6637dfeed0861ee9cc96dd9d854,10,929,353,1282,252,2011-12-25 16:38:18,2011-12-25 16:38:18
71b0d616fe41d6637dfeed0861ee9cc96dd9d854...6648144e576f0d0ba313dbbf26944d24258bfd4e,2,0,93,93,2,2011-12-25 17:00:26,2011-12-25 16:37:00
6648144e576f0d0ba313dbbf26944d24258bfd4e...57ebd125ae621d054258dcfa95971f67378d1ab8,1,0,103,103,1,2011-12-25 17:00:26,2011-12-25 16:54:42
57ebd125ae621d054258dcfa95971f67378d1ab8...f0d84aded98593c24a3c067f66f25865b4ca1dba,1,0,139,139,1,2011-12-25 17:00:26,2011-12-25 16:56:16
f0d84aded98593c24a3c067f66f25865b4ca1dba...54b37b38ca683fa6d0da87c06c7798802998a922,1,0,9,9,1,2011-12-25 17:00:27,2011-12-25 16:58:44
54b37b38ca683fa6d0da87c06c7798802998a922...1c2950f9dae69aa3421feefada584032bdab8fa4,1,0,3,3,1,2011-12-25 17:01:48,2011-12-25 17:01:48
1c2950f9dae69aa3421feefada584032bdab8fa4...9016d3fd77e079b210e322189952902d45bf7e8d,2,0,57,57,2,2011-12-25 17:02:26,2011-12-25 17:02:26
9016d3fd77e079b210e322189952902d45bf7e8d...c204ae515fbc23fd57d8e6749ea670312acd371a,1,0,2,2,1,2011-12-25 18:16:25,2011-12-25 18:16:25
c204ae515fbc23fd57d8e6749ea670312acd371a...78e883aca9305cfbc0011424702528b8cddf7ace,5,96,3,99,12,2011-12-25 18:54:48,2011-12-25 18:39:43
78e883aca9305cfbc0011424702528b8cddf7ace...c666313f63ff78362e7a6249a21ac834b8371f6a,7,51,24,75,24,2011-12-25 18:54:52,2011-12-25 18:49:24
c666313f63ff78362e7a6249a21ac834b8371f6a...e7924eac9be1b3ed4cdf27f1bbc4b8cedcebeda6,2,0,0,0,0,2011-12-25 18:17:00,2011-12-25 18:17:00
e7924eac9be1b3ed4cdf27f1bbc4b8cedcebeda6...3cfe8e909f0d3fc123b24d0ff18df823c90a4ab0,7,64,58,122,7,2011-12-25 21:43:58,2011-12-25 21:43:58
3cfe8e909f0d3fc123b24d0ff18df823c90a4ab0...9214fe7c39ebb67602d06d5353844583a16c2f08,1,27,0,27,1,2011-12-25 23:32:28,2011-12-25 20:28:49
9214fe7c39ebb67602d06d5353844583a16c2f08...d65a4b460a6dfd582f10ebe2c8e170f144c932eb,1,4,1,5,2,2011-12-25 23:32:28,2011-12-25 20:34:25
d65a4b460a6dfd582f10ebe2c8e170f144c932eb...d9f5556c7a7473b228422c40cd1f73968d8b174d,1,13,2,15,4,2011-12-25 23:32:29,2011-12-25 20:55:36
d9f5556c7a7473b228422c40cd1f73968d8b174d...524ac00d2fdc32b47cbdf1689bd7bfcb4051d05c,1,1,1,2,1,2011-12-25 23:32:29,2011-12-25 20:57:09
524ac00d2fdc32b47cbdf1689bd7bfcb4051d05c...517619183efdb6ce8d41e38d52aac608e37ec153,1,0,1,1,1,2011-12-25 23:32:30,2011-12-25 20:57:56
517619183efdb6ce8d41e38d52aac608e37ec153...4b0c3218b59acc609ab0c4ead5e97263a93b9a4c,3,20,9,29,11,2011-12-26 17:37:05,2011-12-26 17:36:46
4b0c3218b59acc609ab0c4ead5e97263a93b9a4c...1e20799a2d5c9718b8d8d0c25d9386db7b33a559,1,102,98,200,24,2011-12-26 19:59:50,2011-12-26 19:59:50
1e20799a2d5c9718b8d8d0c25d9386db7b33a559...110cd7dadbf438599887b106584374454985a5e8,1,2,2,4,2,2011-12-26 20:02:24,2011-12-26 20:02:24
14c8eb5752f6dbbad7b23e472d296477c3195a16...555eb81349e92905402208715e933340fdfdc8de,2,10,19,29,2,2011-05-03 21:05:15,2011-05-03 21:05:15
555eb81349e92905402208715e933340fdfdc8de...b13dff542f40d79d2cc3b1206c768b67b7c6a9ed,1,15,5,20,3,2011-05-03 21:22:11,2011-05-03 21:22:11
002c71ed7a3e97683815cf36db92f529c375a854...9a6697dc2daf9e00ebe2d5c72c01dc4d7ba36d0f,1,2,0,2,2,2011-04-14 23:52:18,2011-04-14 23:52:18
002c71ed7a3e97683815cf36db92f529c375a854...e16d89f20a048f35888864b541c814427d5bee85,1,9,9,18,2,2011-04-14 23:51:46,2011-04-14 23:51:46
7e257b5a299362d223acd08b3063dfdb1e6fb87b...fbc1a0d20f5c3be61f76a8196668e5e7787d5048,4,22,20,42,10,2011-04-14 19:49:45,2011-04-14 19:49:45
fbc1a0d20f5c3be61f76a8196668e5e7787d5048...d65b438a5f78864a4a124374e732930160305753,2,2,2,4,2,2011-04-14 20:46:03,2011-04-14 20:46:03
d65b438a5f78864a4a124374e732930160305753...39c5cbdbf72ad8baaebb90180bcc698013ac1f36,2,5,1,6,3,2011-04-14 20:47:06,2011-04-14 20:47:06
110cd7dadbf438599887b106584374454985a5e8...3043227843c7a11c284c9cecb91696d8aa64e887,1,2,2,4,2,2011-12-26 21:02:33,2011-12-26 21:02:33
110cd7dadbf438599887b106584374454985a5e8...30bb6e4b45ed556f42c48b55066728a4d80fc1b9,1,3,1,4,1,2011-12-26 20:18:16,2011-12-26 20:18:16
30bb6e4b45ed556f42c48b55066728a4d80fc1b9...ccd99616bfa251759f7bbf6c3a870963c10cf25c,1,2,2,4,1,2011-12-26 21:46:44,2011-12-26 21:46:44
b13dff542f40d79d2cc3b1206c768b67b7c6a9ed...e8c945c8e1f3f2f3b3d1c812ca386ed6329c2786,1,3,3,6,2,2011-05-03 21:52:36,2011-05-03 21:52:36
a46e54d9b1b8a9e82988d0ee4ca68129b95727ee...4a4103a9b8f069f155f91cc3e65073a59e5f65cc,2,14,15,29,3,2011-04-15 01:21:59,2011-04-15 01:21:59
4a4103a9b8f069f155f91cc3e65073a59e5f65cc...66eddbed7ae154ea306d8f91d84b4a20eb4e7961,1,12,0,12,1,2011-04-15 01:22:24,2011-04-15 01:22:24
66eddbed7ae154ea306d8f91d84b4a20eb4e7961...3126e58f01431cecac6cba704acde51e858bbaa8,2,5,2,7,3,2011-04-15 01:22:33,2011-04-15 01:22:33
a46e54d9b1b8a9e82988d0ee4ca68129b95727ee...7efbe7b79959dd80c1d6ede22819fb2cfffd9f9d,2,20,19,39,3,2011-04-15 00:00:18,2011-04-12 17:46:06
7efbe7b79959dd80c1d6ede22819fb2cfffd9f9d...6d4891d676f1a4c16a35180a9225baee24e67b0e,1,3,1,4,1,2011-04-15 00:00:18,2011-04-12 22:48:32
6d4891d676f1a4c16a35180a9225baee24e67b0e...e46920d6b39a327b05f52d27061548b55316ca9f,5,52,4,56,8,2011-04-15 00:00:18,2011-04-13 02:06:34
39c5cbdbf72ad8baaebb90180bcc698013ac1f36...fbc032038dc6bb113da9261716e53448a9972f07,5,30,15,45,9,2011-04-14 21:20:29,2011-04-14 21:20:29
39c5cbdbf72ad8baaebb90180bcc698013ac1f36...450cc4282aa62d2b12be0eaf1add07b01e1918f8,1,10,0,10,2,2011-04-14 20:59:33,2011-04-14 18:36:48
450cc4282aa62d2b12be0eaf1add07b01e1918f8...ea8e6863e2a07adee2986e536b15f600a76e80ee,1,36,0,36,5,2011-04-14 20:59:33,2011-04-14 19:25:17
ea8e6863e2a07adee2986e536b15f600a76e80ee...fa79ec7ba8af80e13a56d478d0ff49a72a1b4302,2,15,44,59,31,2011-04-14 20:59:33,2011-04-14 19:50:12
fa79ec7ba8af80e13a56d478d0ff49a72a1b4302...07502672a2f8883081b20ec811fb86664d8ad3bb,2,10,0,10,2,2011-04-14 20:59:33,2011-04-14 20:58:05
084bc36d4f5e724645a0b0c58324e27b67032b42...0d0cfb7cf5b1259e7ccddef52c6c7e9ebb669ee9,2,2,2,4,2,2011-12-27 00:48:46,2011-12-26 19:06:36
0d0cfb7cf5b1259e7ccddef52c6c7e9ebb669ee9...31e21ec95ef26c27f2de4b232193e222cf8720e4,1,5,3,8,2,2011-12-27 00:48:46,2011-12-26 23:21:26
31e21ec95ef26c27f2de4b232193e222cf8720e4...9c8dd2f5248c223a909f98b9c573bb112034c04d,4,119,23,142,12,2011-12-27 00:48:47,2011-12-27 00:48:37
9c8dd2f5248c223a909f98b9c573bb112034c04d...ffa51deade63e8093fcc6b575c27f56c69d497b0,2,4,0,4,2,2011-12-27 09:55:13,2011-12-27 09:55:13
ffa51deade63e8093fcc6b575c27f56c69d497b0...b7eb383d513facccd48a7fc75f58a48bd96fa392,2,2,0,2,2,2011-12-27 14:31:13,2011-12-27 14:31:13
b7eb383d513facccd48a7fc75f58a48bd96fa392...03c505592c69d54e3d45ab23b379cc0eb07f219e,1,2,1,3,1,2011-12-27 14:41:30,2011-12-27 14:41:30
03c505592c69d54e3d45ab23b379cc0eb07f219e...ca7386b0be2727740cff4017a28fd9bfb1bb4606,1,1,1,2,1,2011-12-27 15:21:44,2011-12-27 15:21:44
ca7386b0be2727740cff4017a28fd9bfb1bb4606...d70eb56fc6a667c984c204aab3ce262b9e580c46,1,4,0,4,1,2011-12-27 15:51:10,2011-12-27 15:51:10
e8c945c8e1f3f2f3b3d1c812ca386ed6329c2786...3bb52716f1907587a22afd2c3649e1150ce82083,1,1,6,7,2,2011-05-04 16:17:51,2011-05-04 16:17:51
3bb52716f1907587a22afd2c3649e1150ce82083...3848e82964770439e433f42561c96d337236d40b,2,32,2,34,6,2011-05-04 16:23:20,2011-05-04 16:23:20
e8c945c8e1f3f2f3b3d1c812ca386ed6329c2786...cb64435c2817c8aa3c6cfb342385507f0f104534,1,43,43,86,2,2011-05-04 15:28:12,2011-05-04 15:28:12
cb64435c2817c8aa3c6cfb342385507f0f104534...b01a0a987aefacc7a081734f776e030ec446b8eb,1,24,0,24,1,2011-05-04 15:30:59,2011-05-04 15:30:59
90372ab038501b527f40d67c581694a78e73a837...bf09b1cc49bb2bff684dff1bf97043063d764016,1,37,0,37,1,2011-04-15 06:44:10,2011-04-15 06:44:10
bf09b1cc49bb2bff684dff1bf97043063d764016...1e60b2904c7b8af3a2c0adc655e04bb60c2c4364,1,1,1,2,1,2011-04-15 07:38:14,2011-04-15 07:38:14
1e60b2904c7b8af3a2c0adc655e04bb60c2c4364...da438f85bca6e4b9e2e12d678c754441aee47eab,2,139,20,159,29,2011-04-15 15:06:44,2011-04-15 15:06:08
d70eb56fc6a667c984c204aab3ce262b9e580c46...96f8a5fc7b0f6d6ae4fc562a7ace29f0817bcea0,2,54,0,54,3,2011-12-27 20:01:48,2011-12-27 20:01:48
d70eb56fc6a667c984c204aab3ce262b9e580c46...ffec084f16fc7b1d1a4feb6862766c20fe228532,2,17,1,18,4,2011-12-27 18:41:13,2011-12-27 18:41:13
f4ba05e9920789e374d9c5a1c3781b99109c4307...9520b96433e85241989e91ce659583c92160721e,1,30,10,40,15,2011-05-04 16:37:35,2011-05-04 16:37:35
9520b96433e85241989e91ce659583c92160721e...4639c271b8fc844e44395f479fad1f95defcc6f1,2,95,95,190,2,2011-05-04 16:38:05,2011-05-04 16:38:05
4639c271b8fc844e44395f479fad1f95defcc6f1...2b7145944b2c73ce7e76866d40ddc2611df3cb0c,1,1,1,2,1,2011-05-04 17:13:38,2011-05-04 17:13:38
da438f85bca6e4b9e2e12d678c754441aee47eab...67fdfce7913f4e9222bb13374acf5eafcf07afc8,1,1,1,2,1,2011-04-15 18:36:54,2011-04-15 18:36:54
67fdfce7913f4e9222bb13374acf5eafcf07afc8...a92aef4e153f675d77ef0cc01816803cb9145df2,1,13,38,51,5,2011-04-15 18:38:04,2011-04-15 18:38:04
da438f85bca6e4b9e2e12d678c754441aee47eab...33f4bb08bc988956d4a73c66f0fc5277a71cb5b5,1,7,5,12,2,2011-04-15 17:39:47,2011-04-15 17:29:22
33f4bb08bc988956d4a73c66f0fc5277a71cb5b5...138040ccc03885b30e55e7b560e3de446c033701,8,10,10,20,10,2011-04-15 17:39:47,2011-04-15 17:39:23
451b52bae935bb8b41941b191e2c2346e452b237...3338b59b25da0e637cb5c5e07e91e3e9c5ea7eb9,1,1,1,2,1,2011-12-27 19:28:25,2011-12-27 19:28:25
3338b59b25da0e637cb5c5e07e91e3e9c5ea7eb9...583d33df5d70236371fc697cd118e199b7710b5c,1,15,2,17,3,2011-12-27 19:44:27,2011-12-27 19:44:27
583d33df5d70236371fc697cd118e199b7710b5c...5808f6c0fdb417e46713bfda1a0a8bba6a9cd7f9,1,1,1,2,1,2011-12-27 19:48:26,2011-12-27 19:48:26
2b7145944b2c73ce7e76866d40ddc2611df3cb0c...5e99599e6912fcc916cd9f7c9d89690b6285029a,1,41,35,76,5,2011-05-04 18:22:39,2011-05-04 18:22:39
5e99599e6912fcc916cd9f7c9d89690b6285029a...68037ada33dd462491b0054795cf1ac54ba46995,2,25,20,45,9,2011-05-04 19:10:51,2011-05-04 19:10:51
2b7145944b2c73ce7e76866d40ddc2611df3cb0c...9b67c7914fdeae98d445561e1eabcd92bf58e30f,1,0,1,1,1,2011-05-04 17:27:23,2011-05-04 17:04:18
9b67c7914fdeae98d445561e1eabcd92bf58e30f...2e5c5def21925132344f931a2ddec02d88eb44a4,2,0,2,2,2,2011-05-04 17:27:23,2011-05-04 17:04:35
2e5c5def21925132344f931a2ddec02d88eb44a4...0ab853590ebd0cae35222cf856fd4d94b7ee8486,1,1,0,1,1,2011-05-04 17:27:23,2011-05-04 17:25:07
0ab853590ebd0cae35222cf856fd4d94b7ee8486...bd29441d12e5645674a8355191833b068d1aca5f,5,1083,100,1183,32,2011-05-04 17:28:57,2011-05-04 17:26:13
bd29441d12e5645674a8355191833b068d1aca5f...71f29e073a949848e73c2565835a926408f3013f,1,1,1,2,1,2011-05-04 17:44:21,2011-05-04 17:44:21
71f29e073a949848e73c2565835a926408f3013f...0eb1da57a2d6a7d2038726109c9e46a361fb5a53,1,1,0,1,1,2011-05-04 18:09:27,2011-05-04 18:09:27
0eb1da57a2d6a7d2038726109c9e46a361fb5a53...56080a9fa4d93bde5e41aa17381a8aed9cc3ab35,3,18,11,29,13,2011-05-04 18:09:48,2011-05-04 18:03:25
56080a9fa4d93bde5e41aa17381a8aed9cc3ab35...7829b0029c1b685b51aeb905c02b18c53f2ce23e,2,57,9,66,9,2011-05-04 18:13:54,2011-05-04 18:13:39
4ee9302fd7ad125b555cac9fdb9199b21c9b76f5...0e00d068f4a99b4e68aa8d6f9b23a2a4678c0ddb,1,1,1,2,1,2011-04-15 18:55:27,2011-04-15 18:55:27
5808f6c0fdb417e46713bfda1a0a8bba6a9cd7f9...6988da36137c72bc3f3a07e7c0c30f2b9bf24bab,3,16,7,23,7,2011-12-27 20:42:01,2011-12-27 19:55:26
6988da36137c72bc3f3a07e7c0c30f2b9bf24bab...390abf36eb36705f5f9f7a5542f63376053e131a,1,27,0,27,1,2011-12-27 20:42:01,2011-12-27 19:55:36
5808f6c0fdb417e46713bfda1a0a8bba6a9cd7f9...d175b6fe88abdbf6134ce732d0523740778d8820,3,21,1,22,3,2011-12-27 20:06:21,2011-12-27 20:06:21
126ea68e6cb1b411e21627741a80dc4510633a37...80332e34fcc8a272b39e1e6edc863e0c1f88396a,4,10,0,10,5,2011-05-04 19:24:10,2011-05-04 19:24:10
0e00d068f4a99b4e68aa8d6f9b23a2a4678c0ddb...cc2afee21dd9dbe7469a64672db86aab1263638e,1,47,1,48,4,2011-04-18 16:37:00,2011-04-18 16:37:00
cc2afee21dd9dbe7469a64672db86aab1263638e...94f581c1a1d274224e137b32fc46e69eab823c57,1,1,1,2,1,2011-04-18 16:37:34,2011-04-18 16:37:34
0e00d068f4a99b4e68aa8d6f9b23a2a4678c0ddb...002288b50bbcb9808cac8319db133847cac52ecc,1,1,1,2,1,2011-04-15 20:30:23,2011-04-15 20:30:08
002288b50bbcb9808cac8319db133847cac52ecc...ad187ed5c4f330e1d7a1ce38c3c36690f57bec37,1,6,5,11,3,2011-04-15 20:30:23,2011-04-15 20:30:16
ad187ed5c4f330e1d7a1ce38c3c36690f57bec37...3d1f0d67835a0ce4a3213dd0514fe58df3010d56,1,5,2,7,4,2011-04-15 20:51:21,2011-04-15 20:51:21
3d1f0d67835a0ce4a3213dd0514fe58df3010d56...feb266b1a9e28cbaa3275fde46679a32af4f6600,1,1,1,2,1,2011-04-15 21:32:45,2011-04-15 21:32:45
feb266b1a9e28cbaa3275fde46679a32af4f6600...17892972aa45c2abdd15c353c37ae4ebdb5daf1e,1,1,1,2,1,2011-04-15 21:42:22,2011-04-15 21:42:22
01ab069471e75949b19718726f073e0b766f3184...5ea3bf83f931bad7a0e3aae20fa6176e1724f3e1,1,3,1,4,1,2011-12-27 21:16:14,2011-12-27 16:38:46
5ea3bf83f931bad7a0e3aae20fa6176e1724f3e1...b3c728d97b98a9b0dc5aec4e987a666922cc0788,1,15,2,17,3,2011-12-27 21:16:14,2011-12-27 21:15:21
b3c728d97b98a9b0dc5aec4e987a666922cc0788...7b745865c00a9d5de60fb3aab190755755845685,2,2,2,4,2,2011-12-27 22:15:07,2011-12-27 22:15:07
80332e34fcc8a272b39e1e6edc863e0c1f88396a...3de56d187f81d11f737414f158b866236b04ffd1,1,6,2,8,1,2011-05-04 19:47:17,2011-05-04 19:47:17
3de56d187f81d11f737414f158b866236b04ffd1...20ac162f3c84c2fc2b715dfe43d03fbdeeaeeb61,1,44,0,44,1,2011-05-04 19:47:21,2011-05-04 19:47:21
80332e34fcc8a272b39e1e6edc863e0c1f88396a...3b63bf927a773611e6b2948dbe668b0502e9aa80,2,2,1,3,2,2011-05-04 19:41:43,2011-05-04 00:32:57
3b63bf927a773611e6b2948dbe668b0502e9aa80...78a6c2e2f209743021c272f669b19b8d1b3688a5,1,3,0,3,3,2011-05-04 19:41:43,2011-05-04 17:16:26
78a6c2e2f209743021c272f669b19b8d1b3688a5...59bfa55e659fcf2d05b50290d22ce0e39ccebc9c,1,4,0,4,2,2011-05-04 19:41:43,2011-05-04 17:46:38
59bfa55e659fcf2d05b50290d22ce0e39ccebc9c...1577c6e8a2a213d5e5e57dbd195f16c77e98ebf7,1,5,3,8,4,2011-05-04 19:41:43,2011-05-04 18:17:50
1577c6e8a2a213d5e5e57dbd195f16c77e98ebf7...82f9f32993abdbda3c3e0a9db2f5dce340a7fb94,1,8,0,8,1,2011-05-04 19:41:43,2011-05-04 18:25:02
82f9f32993abdbda3c3e0a9db2f5dce340a7fb94...9be9a1e51c2d491de523e573a0d55daa135e9bdc,1,3,3,6,1,2011-05-04 19:41:43,2011-05-04 19:02:35
e749ff2ff61748480c35abe7a4f80eb6f28f187a...f3fee9740dec7b316e92d8da718da4b80ba32f2b,1,0,1,1,1,2011-04-18 16:46:58,2011-04-18 16:46:58
f3fee9740dec7b316e92d8da718da4b80ba32f2b...41891d55591399d10bb011249243ca7a282cd58f,1,2,2,4,1,2011-04-18 16:57:29,2011-04-18 16:57:29
41891d55591399d10bb011249243ca7a282cd58f...32e07991c0b0ad639dae3d418d955555219c3543,1,1,1,2,1,2011-04-18 16:58:56,2011-04-18 16:58:56
32e07991c0b0ad639dae3d418d955555219c3543...27f6f7827aa4c791ebdef26f4c8929bf663f93e5,2,5,1,6,2,2011-04-18 18:53:26,2011-04-18 18:53:26
17892972aa45c2abdd15c353c37ae4ebdb5daf1e...4e3a3e90ce59f5020ba7a3bc8fdbe912322484bb,1,1,1,2,1,2011-04-16 19:29:10,2011-04-16 19:29:10
17892972aa45c2abdd15c353c37ae4ebdb5daf1e...e0d7cc9432caba15e5c61f097ba099674b93ea59,1,6,5,11,6,2011-04-15 23:32:43,2011-04-15 23:32:43
e0d7cc9432caba15e5c61f097ba099674b93ea59...2892c6daf9d6c5a9686805380cc8b1457db19faf,1,8,0,8,1,2011-04-15 23:50:50,2011-04-15 23:50:39
2892c6daf9d6c5a9686805380cc8b1457db19faf...d3574a11cb6930aaaa1915ad5965426d492f3b7a,1,6,3,9,2,2011-04-15 23:55:50,2011-04-15 23:55:50
d3574a11cb6930aaaa1915ad5965426d492f3b7a...b81192b775c11e985876bbc34c2e635c6c311499,1,1,1,2,2,2011-04-16 06:37:42,2011-04-16 06:37:42
b81192b775c11e985876bbc34c2e635c6c311499...0ecbdc0702ea297edb7ef42001eb2e2743a01ce6,1,1,1,2,1,2011-04-16 06:41:09,2011-04-16 06:41:00
0ecbdc0702ea297edb7ef42001eb2e2743a01ce6...d2bd72c3e4821c389beb4719e5dc7f8580b20ad1,2,58,0,58,9,2011-04-16 06:41:09,2011-04-16 06:41:03
d2bd72c3e4821c389beb4719e5dc7f8580b20ad1...9c98a92af0e93f8e0b1af412225b7c120b5d2887,1,39,1,40,2,2011-04-16 08:22:10,2011-04-16 08:15:00
7b745865c00a9d5de60fb3aab190755755845685...b9cd4aed67d1919be458f55b9f956d91c720b5eb,1,2,2,4,1,2011-12-27 22:45:09,2011-12-27 22:45:09
7b745865c00a9d5de60fb3aab190755755845685...1310f7e8a3a88e2c1118783830b0da40cff7406d,1,3,3,6,2,2011-12-27 22:28:56,2011-12-27 21:54:42
828fe439192c9424545a281ffcfe7cd9747b42d8...4fa17ac8b59412cfa765db03c01b684443027fd7,1,5,1,6,1,2011-05-04 19:52:40,2011-05-04 19:52:40
828fe439192c9424545a281ffcfe7cd9747b42d8...591ee51785660fdb68b246557338363a25b02898,1,1,1,2,1,2011-05-04 19:49:33,2011-05-04 19:49:33
27f6f7827aa4c791ebdef26f4c8929bf663f93e5...4f8f0c6a9f4b5ee2e9aa22f373fc903d9b75a81e,1,2,0,2,1,2011-04-19 14:31:21,2011-04-19 14:31:21
27f6f7827aa4c791ebdef26f4c8929bf663f93e5...52fdfd097f5dca5a83de85b9a7f47e3d206d068e,1,47,162,209,34,2011-04-18 20:31:15,2011-04-18 20:31:15
52fdfd097f5dca5a83de85b9a7f47e3d206d068e...47e15ceb886f2565e8431638510e21e5fd302442,1,96,35,131,23,2011-04-18 20:42:59,2011-04-18 20:41:35
24626e831f6aed3bdb159c0e8ad3b4655509657e...a49c6b5b6b40984ee3744f82742d358bc1cb9d76,1,2,0,2,1,2011-04-18 22:42:29,2011-04-18 22:42:29
a49c6b5b6b40984ee3744f82742d358bc1cb9d76...4cccc1232c4ee3063a0b5d315d827ddee1054d6b,1,5,2,7,2,2011-04-18 22:43:09,2011-04-18 22:43:09
4cccc1232c4ee3063a0b5d315d827ddee1054d6b...736733e95784d1344592e76e6d7921d59008827d,1,2,1,3,1,2011-04-18 22:43:51,2011-04-18 22:43:51
736733e95784d1344592e76e6d7921d59008827d...4f969e112abf5a30b0e2bfde170b0c868d79bde5,9,81,22,103,29,2011-04-18 22:44:38,2011-04-18 22:44:38
24626e831f6aed3bdb159c0e8ad3b4655509657e...982fb4e66f54b29d30dbd4d0ba30cc652c300c1d,1,8,4,12,5,2011-04-18 14:19:31,2011-04-18 14:19:31
9ec2be4a76b75a75f5534cfb0bad17ac8630d9fb...a29fd83afd05d4ac84e897e66166cbd03d8bb0a0,2,4,7,11,4,2011-12-27 23:06:51,2011-12-27 23:06:51
a29fd83afd05d4ac84e897e66166cbd03d8bb0a0...045eb0addbd45e1f1cdf0247365b6b708ab6bbe3,1,10,0,10,1,2011-12-27 23:07:01,2011-12-27 23:07:01
045eb0addbd45e1f1cdf0247365b6b708ab6bbe3...5abe3d31044e062423a8bf584128af32ba22c072,2,2,1,3,2,2011-12-28 00:01:42,2011-12-28 00:01:42
5abe3d31044e062423a8bf584128af32ba22c072...e033a9dac650b728cd6e36d7336fbac6b01e2312,3,54,4,58,6,2011-12-28 00:02:14,2011-12-28 00:02:14
e033a9dac650b728cd6e36d7336fbac6b01e2312...873b6e9616c46652817cefc48ba294b6ebef3262,1,0,1,1,1,2011-12-28 04:03:13,2011-12-28 04:03:13
873b6e9616c46652817cefc48ba294b6ebef3262...954e94260cdef8884c3c4fe9b81c522eec31fbd5,2,4,0,4,2,2011-12-28 04:04:44,2011-12-28 04:04:44
954e94260cdef8884c3c4fe9b81c522eec31fbd5...fa6f59eb4810632ae4900df28fe2f6bae138d266,1,90,0,90,1,2011-12-28 04:11:22,2011-12-28 04:11:22
fa6f59eb4810632ae4900df28fe2f6bae138d266...853a89a5fcd96f9d6c129fa99e3af97cf5af3c99,1,30,2,32,2,2011-12-28 04:12:02,2011-12-28 04:12:02
853a89a5fcd96f9d6c129fa99e3af97cf5af3c99...88b45199cae474ac2af76bb438971229523e9bf0,7,22,14,36,9,2011-12-28 04:12:26,2011-12-28 04:12:26
88b45199cae474ac2af76bb438971229523e9bf0...41534924f8e63f050077e8eb8c81eb1bdc904652,2,10,10,20,4,2011-12-28 03:32:21,2011-12-28 03:32:21
41534924f8e63f050077e8eb8c81eb1bdc904652...57239813e2c9fe786b34ff2c13931dc1ab272287,3,9,34,43,10,2011-12-28 04:09:52,2011-12-28 04:09:52
57239813e2c9fe786b34ff2c13931dc1ab272287...91fc1590e24d7a846376286f800fef4ffd84eec7,1,9,9,18,1,2011-12-28 14:21:29,2011-12-28 14:21:29
91fc1590e24d7a846376286f800fef4ffd84eec7...05ff88039a8a5f2a7879a9544f5696f12bbc0dc3,1,1,1,2,1,2011-12-28 14:41:41,2011-12-28 14:41:41
05ff88039a8a5f2a7879a9544f5696f12bbc0dc3...6795672aaa2bb9864e8aa868a4ab67b9a70adf0b,3,19,10,29,6,2011-12-28 14:44:47,2011-12-28 14:44:47
6795672aaa2bb9864e8aa868a4ab67b9a70adf0b...f8cae7cad1468ca7c1a4a9ad3f3d6dfddfa21aa5,1,3,0,3,1,2011-12-28 15:23:04,2011-12-28 15:23:04
f8cae7cad1468ca7c1a4a9ad3f3d6dfddfa21aa5...a50d66fc045b1206eecd4655b02b7925fd39e9f9,10,1863,23,1886,678,2011-12-28 15:40:03,2011-12-28 15:40:03
a50d66fc045b1206eecd4655b02b7925fd39e9f9...d84cb69608f62c53009adc543c51fe004fb560a7,1,1,0,1,1,2011-12-28 15:48:55,2011-12-28 15:48:55
d84cb69608f62c53009adc543c51fe004fb560a7...63a71bdf346609b8200be735b7b03146eb1c8f5c,1,2,0,2,1,2011-12-28 15:14:10,2011-12-28 15:14:10
e483a546654e8f1dd8672ef2746caf5973fb2fef...479a085bbc62270142fd6091b3d6ce7985d312a7,1,1,1,2,1,2011-05-04 19:58:37,2011-05-04 19:58:37
e483a546654e8f1dd8672ef2746caf5973fb2fef...3741503bec716a54f8fe3386096628d1accbbf7b,1,1,4,5,1,2011-05-04 19:55:17,2011-05-04 19:54:55
3741503bec716a54f8fe3386096628d1accbbf7b...4b1b122cd03cf9584c66e1a278d6626ce1a844c9,1,10,8,18,10,2011-05-04 19:57:00,2011-03-29 09:49:18
6c9fe3bbfdd7f66f96cba82c029904671b54bf05...d7d2ce01f56510a792d53982ced313318a1f5ce4,1,10,7,17,5,2011-04-19 17:10:44,2011-04-19 17:10:44
d7d2ce01f56510a792d53982ced313318a1f5ce4...e2ff53f6931ed0af937492a2e45bd2e6db27afa6,1,8,0,8,1,2011-04-19 18:16:44,2011-04-19 18:16:44
e2ff53f6931ed0af937492a2e45bd2e6db27afa6...a2739c03995a15866991ae2d5d5db4288aa6578d,1,14,14,28,1,2011-04-19 18:21:59,2011-04-19 18:21:59
a2739c03995a15866991ae2d5d5db4288aa6578d...61b5b745084a12ab07ae30f889d89c36a1757d60,1,1,2,3,2,2011-04-19 18:24:13,2011-04-19 18:22:36
61b5b745084a12ab07ae30f889d89c36a1757d60...af93c8bb91d4a7a2ce25d8b81bc08a01f52cdc46,1,27,0,27,1,2011-04-19 18:27:14,2011-04-19 18:26:16
af93c8bb91d4a7a2ce25d8b81bc08a01f52cdc46...acbc6b1fc443a0c262ab76a23e28bee627e8ec2e,1,17,0,17,1,2011-04-19 18:27:14,2011-04-19 18:26:26
acbc6b1fc443a0c262ab76a23e28bee627e8ec2e...9d9e85d7e2b092853a284101340e68e0b254a6e1,1,5,2,7,1,2011-04-19 20:40:22,2011-04-19 19:50:19
9d9e85d7e2b092853a284101340e68e0b254a6e1...3835614864ee5f28b8de96af0dc6f6c629515d88,2,14,4,18,6,2011-04-19 20:40:22,2011-04-19 19:50:33
3835614864ee5f28b8de96af0dc6f6c629515d88...157ab952e51c0c08e9c6534541ee276a4d9b4292,1,1,1,2,1,2011-04-19 20:40:23,2011-04-19 20:39:51
157ab952e51c0c08e9c6534541ee276a4d9b4292...f8cb1e292c1e7e80ba5627468705cbf0130c82af,2,20,1,21,2,2011-04-19 21:46:33,2011-04-19 21:46:33
f8cb1e292c1e7e80ba5627468705cbf0130c82af...7d1b34670099329c8dac435219d5c6050b0b72b3,2,7,5,12,4,2011-04-19 22:16:08,2011-04-19 22:15:51
7d1b34670099329c8dac435219d5c6050b0b72b3...78f525a937c6c34a6e32d8b9f9f07ed8784e463b,1,1,3,4,2,2011-04-20 12:01:35,2011-04-20 12:01:35
78f525a937c6c34a6e32d8b9f9f07ed8784e463b...df30db031cd1531705f23fa6ed75a88e2116568f,1,4,2,6,1,2011-04-20 13:06:43,2011-04-20 13:06:34
df30db031cd1531705f23fa6ed75a88e2116568f...5967f52eef079cce50e5de2a75a817452434bdf9,1,1,1,2,1,2011-04-20 16:05:10,2011-04-20 16:05:10
5967f52eef079cce50e5de2a75a817452434bdf9...c1fda2b61d311af694678de2603d07d73040afa8,1,6,1,7,2,2011-04-20 16:28:34,2011-04-20 16:22:52
c1fda2b61d311af694678de2603d07d73040afa8...b39582c84eb6257d970ec33515572d488b3c0b48,1,2,2,4,2,2011-04-20 17:18:10,2011-04-20 17:18:10
b39582c84eb6257d970ec33515572d488b3c0b48...9047007b4ca3f5db0546768a6660b3a568403f6c,1,27,1,28,2,2011-04-20 18:40:07,2011-04-20 18:01:28
9047007b4ca3f5db0546768a6660b3a568403f6c...1c69e7b64e732d86468a825260c641bfad954efb,1,17,4,21,5,2011-04-20 18:40:07,2011-04-20 18:37:50
1c69e7b64e732d86468a825260c641bfad954efb...81c200c85483848e01e87b69b1b051e3fe949fd5,1,6,3,9,2,2011-04-20 20:13:21,2011-04-20 20:13:21
81c200c85483848e01e87b69b1b051e3fe949fd5...57f9a4ad592cd6f4b8046e7215582c5074f446b0,1,34,6,40,7,2011-04-21 06:10:46,2011-04-21 06:10:46
57f9a4ad592cd6f4b8046e7215582c5074f446b0...c889977329906d86aaf3464fc77b1000c3b89fc1,3,6,5,11,6,2011-04-21 15:19:55,2011-04-21 15:19:41
c889977329906d86aaf3464fc77b1000c3b89fc1...76d3ea758e0faa4e161c7e4bf677aa94d88cc880,1,2,1,3,2,2011-04-21 18:00:19,2011-04-21 18:00:12
76d3ea758e0faa4e161c7e4bf677aa94d88cc880...b291d96b0a536a5832bb89fb08d209128d5d5c97,2,15,12,27,4,2011-04-21 18:57:44,2011-04-20 19:00:19
b291d96b0a536a5832bb89fb08d209128d5d5c97...516600ebbd7831b5056a989cab5c59e919b42304,2,10,0,10,4,2011-04-21 18:57:44,2011-04-20 19:00:45
516600ebbd7831b5056a989cab5c59e919b42304...40b607d051ec57e226dbdf9ee9745991154a183e,2,23,16,39,4,2011-04-21 18:57:44,2011-04-20 19:01:06
40b607d051ec57e226dbdf9ee9745991154a183e...5f6e63338f436b55dede57c6dc7b5f8b1e5e6cac,1,4,6,10,1,2011-04-21 18:57:44,2011-04-20 19:16:11
5f6e63338f436b55dede57c6dc7b5f8b1e5e6cac...ae53a3a0ce855ed5319eb591ed1eae7ac189ac7c,1,10,2,12,4,2011-04-21 18:57:44,2011-04-21 15:14:14
ae53a3a0ce855ed5319eb591ed1eae7ac189ac7c...11bb6c6cae66e63d10a9c6af295dc876e6f2103d,1,1,0,1,1,2011-04-21 18:57:44,2011-04-21 15:16:27
11bb6c6cae66e63d10a9c6af295dc876e6f2103d...f939069509315a0a30bc28ad97fa08d84332e394,6,90,11,101,17,2011-04-21 18:57:44,2011-04-21 18:56:38
f939069509315a0a30bc28ad97fa08d84332e394...4106745747711f48bae0e80ad691c7bf52ae1620,2,80,5,85,13,2011-04-21 18:57:44,2011-04-21 18:57:05
4106745747711f48bae0e80ad691c7bf52ae1620...ac1f4dfe9a939b085ca0d872517a93c944af4d49,1,1,1,2,1,2011-04-23 01:43:02,2011-04-23 01:43:02
ac1f4dfe9a939b085ca0d872517a93c944af4d49...e47072ed136cdba167d3d41a4e5003817be63818,1,11,9,20,6,2011-04-23 01:57:02,2011-04-23 01:57:02
e47072ed136cdba167d3d41a4e5003817be63818...1a4bc082866ccdde9926ca2070c92e9f5c886e76,3,14,6,20,3,2011-04-23 17:50:53,2011-04-23 17:50:53
1a4bc082866ccdde9926ca2070c92e9f5c886e76...1e6220e3af05724f563e58f4b835ca3e37160dd2,8,926,868,1794,134,2011-04-24 18:56:52,2011-04-24 18:56:26
1e6220e3af05724f563e58f4b835ca3e37160dd2...b6913e34171b2e7b32d8cc7f0ff8b696dc062ef7,2,47,25,72,11,2011-04-24 19:34:21,2011-04-24 19:34:21
b6913e34171b2e7b32d8cc7f0ff8b696dc062ef7...d2219e9bfc6563b7effb3e87014781c1c0dd2e04,1,44,43,87,39,2011-04-24 20:06:59,2011-04-24 20:06:59
d2219e9bfc6563b7effb3e87014781c1c0dd2e04...6a9fad1b2c19e0216fcae6e27a884a086038785c,1,78,78,156,47,2011-04-24 20:17:47,2011-04-24 20:17:47
6a9fad1b2c19e0216fcae6e27a884a086038785c...fe868a35f3631b0b603ab2f7c8c09421084eab6e,1,3,0,3,2,2011-04-25 00:44:44,2011-04-25 00:44:44
fe868a35f3631b0b603ab2f7c8c09421084eab6e...03d6d9247502e394660c62268c68847becbe5e5c,1,7,1,8,4,2011-04-25 04:23:21,2011-04-25 04:23:21
03d6d9247502e394660c62268c68847becbe5e5c...372fb80637099d28e459519eb384a485c1ab9f76,1,3,3,6,2,2011-04-25 04:29:30,2011-04-25 04:29:30
372fb80637099d28e459519eb384a485c1ab9f76...9a3d756d9f436552f80f2159b3bb4c0dc4bb10b7,1,1,1,2,1,2011-04-25 04:31:37,2011-04-25 04:31:37
9a3d756d9f436552f80f2159b3bb4c0dc4bb10b7...d6997cbf795353e2edb2f62500a1853bfd9dc0eb,2,110,2,112,7,2011-04-25 13:49:01,2011-04-25 13:49:01
d6997cbf795353e2edb2f62500a1853bfd9dc0eb...32afd00ca76f7358a9e52fb15b0c5a00bfc17cb0,1,1,1,2,1,2011-04-25 14:26:50,2011-04-25 14:26:50
32afd00ca76f7358a9e52fb15b0c5a00bfc17cb0...c75b2cbae1b0d6315324cd94a11d4ea460676047,2,148,5,153,9,2011-04-25 18:02:52,2011-04-25 17:58:43
c75b2cbae1b0d6315324cd94a11d4ea460676047...1733f391c97e8aba5db5c5803bf98691c939f961,1,1,1,2,1,2011-04-25 19:22:04,2011-04-25 19:21:50
1733f391c97e8aba5db5c5803bf98691c939f961...2df2fe89910ae0c0c78f85e1533c49dfb765a2d0,10,284,128,412,24,2011-04-25 20:29:50,2011-04-25 18:13:52
2df2fe89910ae0c0c78f85e1533c49dfb765a2d0...a22732613243b36d91170d2ba6d5b492f36f3722,8,795,486,1281,230,2011-04-25 20:29:50,2011-04-25 18:20:58
a22732613243b36d91170d2ba6d5b492f36f3722...f799371da9b38f65b68abec09d4b9738fe6d1c66,7,23,11,34,14,2011-04-25 20:29:50,2011-04-25 18:22:22
f799371da9b38f65b68abec09d4b9738fe6d1c66...870fedc9e1dea57532d109782b2a31378b32f16c,4,179,0,179,4,2011-04-25 20:29:50,2011-04-25 18:24:06
870fedc9e1dea57532d109782b2a31378b32f16c...8e92ba9ac0dfba5865810a1a26f5934d69e70fe3,1,58,0,58,1,2011-04-25 20:29:51,2011-04-25 18:24:39
8e92ba9ac0dfba5865810a1a26f5934d69e70fe3...71735ebc866ea664f16543e6ad8dca66c5cb8fe2,1,17,0,17,1,2011-04-25 20:29:51,2011-04-25 18:24:56
71735ebc866ea664f16543e6ad8dca66c5cb8fe2...06b905b0fd11021444ba964d70ee012b81684bd2,1,31,0,31,1,2011-04-25 20:29:51,2011-04-25 18:25:22
06b905b0fd11021444ba964d70ee012b81684bd2...3af50f5b941a07b0f290c7f8ee2726c85e2d0699,7,113,102,215,35,2011-04-25 20:29:51,2011-04-25 20:29:38
3af50f5b941a07b0f290c7f8ee2726c85e2d0699...13ee281c4cc9b806092a2b13ee4772a0cc47d989,2,2,2,4,2,2011-04-25 21:21:10,2011-04-25 21:21:10
f8d7c352f747fda8dd0c34569207b626317e1e18...b1b247e2714bee5b124ed93f6cc96f1b17b9d63a,1,1,0,1,1,2011-04-18 22:56:02,2011-04-18 22:56:02
63a71bdf346609b8200be735b7b03146eb1c8f5c...5c5ff0711d281e2f467f2d6991aba63f40daa60e,1,3,0,3,2,2011-12-28 18:52:54,2011-12-28 18:52:54
5c5ff0711d281e2f467f2d6991aba63f40daa60e...51efa78aeeabf96efd49e4732577b3ad4996a96c,3,88,18,106,15,2011-12-28 18:53:28,2011-12-28 18:53:28
63a71bdf346609b8200be735b7b03146eb1c8f5c...59ece3a545b7eaab48b73c9ee3c527953e4bc899,1,1,0,1,1,2011-12-28 16:09:38,2011-12-28 15:57:42
59ece3a545b7eaab48b73c9ee3c527953e4bc899...d07b6d1e33ba0c3556dd8576fc46247a4bccc33a,1,2,0,2,2,2011-12-28 16:09:40,2011-12-28 16:08:57
d07b6d1e33ba0c3556dd8576fc46247a4bccc33a...2ee10b7df46f9f3b95aebcd2757a181b91796394,1,1,0,1,1,2011-12-28 18:06:29,2011-12-28 18:06:29
2ee10b7df46f9f3b95aebcd2757a181b91796394...aab58686d0e14dc36fc44f46e3a49f67471c3800,1,4,4,8,1,2011-12-28 18:08:27,2011-12-28 18:08:27
79ceacbb42b30b5581cd8fc52c9b8f710f68e67f...9b35cc654027b28a9bc86e5d9a8deacff7e8c34c,1,15,0,15,1,2011-05-04 20:01:44,2011-05-04 20:01:23
9b35cc654027b28a9bc86e5d9a8deacff7e8c34c...3f28d8294fd2827d4a4f7f14c16c0fda34625827,1,4,2,6,2,2011-05-04 20:36:28,2011-05-04 20:36:28
3f28d8294fd2827d4a4f7f14c16c0fda34625827...ad01e102a8b766c8a2fe0cfc09f3fccd5e3b53c5,3,294,93,387,42,2011-05-04 21:22:00,2011-05-03 15:21:49
ad01e102a8b766c8a2fe0cfc09f3fccd5e3b53c5...9dbe9864dbfa26db8b20426a47eb56e149bf6f8f,6,50,22,72,22,2011-05-04 22:46:16,2011-05-04 22:46:16
13ee281c4cc9b806092a2b13ee4772a0cc47d989...6598de203916e07d07807a7e40da98b8ee937894,1,1,1,2,1,2011-04-25 23:34:25,2011-04-25 23:33:23
6598de203916e07d07807a7e40da98b8ee937894...aa0495a4b62428d0c0d6d2633c65a2e2128d55af,1,2,1,3,1,2011-04-25 23:57:45,2011-04-25 23:56:06
aa0495a4b62428d0c0d6d2633c65a2e2128d55af...5a9fe69f840f814a81ecb462f2542370eb143d54,7,23,2,25,10,2011-04-26 02:01:10,2011-04-26 02:01:10
5a9fe69f840f814a81ecb462f2542370eb143d54...19ac38c82309268e2af59b1f58d13cf56dfe4161,1,8,1,9,1,2011-04-26 02:13:22,2011-04-26 02:13:22
19ac38c82309268e2af59b1f58d13cf56dfe4161...42942893e1661595d81022b82e3d5a05a27fee67,1,0,4,4,2,2011-04-26 03:53:23,2011-04-26 03:06:54
42942893e1661595d81022b82e3d5a05a27fee67...c46900cf81ec39d5ae8f52e5a7daa322118647f9,1,9,2,11,4,2011-04-26 04:54:50,2011-04-26 04:54:50
c46900cf81ec39d5ae8f52e5a7daa322118647f9...ef0cae716fe0a1433ec7531ffa1a4f746d8336c4,4,7,0,7,7,2011-04-26 07:15:14,2011-04-26 07:15:14
ef0cae716fe0a1433ec7531ffa1a4f746d8336c4...65abee1492381fb4358c9a0c59e414b2e8f6511f,1,1,1,2,1,2011-04-26 14:38:31,2011-04-26 14:38:31
65abee1492381fb4358c9a0c59e414b2e8f6511f...b661f15b4d10920eecaa4fc659f2f2a4b8d14b1a,1,1,1,2,1,2011-04-26 14:52:54,2011-04-26 14:52:54
b661f15b4d10920eecaa4fc659f2f2a4b8d14b1a...ee92cf98824cbaa6f5692a2fdcc89932c396cd40,1,5,1,6,1,2011-04-26 18:28:30,2011-04-26 18:19:57
ee92cf98824cbaa6f5692a2fdcc89932c396cd40...552c03201a5aff6dffa2d6755f897e368176e4d7,1,1,0,1,1,2011-04-26 18:54:43,2011-04-26 18:53:53
552c03201a5aff6dffa2d6755f897e368176e4d7...627048913de2aff9ef9ddd717adb6b953058391e,1,3,3,6,2,2011-04-26 20:33:31,2011-04-26 20:32:15
627048913de2aff9ef9ddd717adb6b953058391e...18cad05feaa1d008fdef93b52d8e5fc22a393fbf,2,13,0,13,3,2011-04-26 21:32:47,2011-04-26 21:32:47
18cad05feaa1d008fdef93b52d8e5fc22a393fbf...4916ede8e55f41d9c1424ef0d6ba4460bdefffb1,1,23,0,23,1,2011-04-26 22:01:26,2011-04-26 22:01:15
4916ede8e55f41d9c1424ef0d6ba4460bdefffb1...0e6200e16dad433a8e22529668706dc4fc146313,1,1,0,1,1,2011-04-26 22:41:37,2011-04-26 22:41:26
0e6200e16dad433a8e22529668706dc4fc146313...2a4fc317fc1a274d0de84673eeda3b8f3b5a74b8,1,4,4,8,4,2011-04-27 04:00:32,2011-04-27 04:00:32
2a4fc317fc1a274d0de84673eeda3b8f3b5a74b8...336a1db69131635d33f3b7cf8a7a31353d10407c,2,5,4,9,5,2011-04-27 04:09:07,2011-04-27 04:09:07
336a1db69131635d33f3b7cf8a7a31353d10407c...61c601a678cc9408c7d629e055331c3eed98f879,1,1,1,2,1,2011-04-27 05:30:00,2011-04-27 05:30:00
13ee281c4cc9b806092a2b13ee4772a0cc47d989...ffb3f37978dec9125438f88935ca41b77664463c,1,5,4,9,3,2011-04-25 22:43:12,2011-04-25 22:43:12
ffb3f37978dec9125438f88935ca41b77664463c...87ab46c3a49ea857dba6dad8c60f51e974139cdf,1,3,3,6,2,2011-04-25 23:17:45,2011-04-25 23:17:45
b1b247e2714bee5b124ed93f6cc96f1b17b9d63a...43e19abd0921d1b47cb462fc43b285005b3a5b97,4,19,18,37,11,2011-04-18 23:16:08,2011-04-18 23:16:08
b1b247e2714bee5b124ed93f6cc96f1b17b9d63a...0e34fc9b58899fa8aa15c19249865937cbe224b8,1,1,1,2,1,2011-04-18 22:49:50,2011-04-18 22:49:50
11418039ade291cabe2211514b552cd0151d3eb5...757de40cffc57644aad958ec6635b59487e5ee88,1,7,1,8,3,2011-12-28 18:20:41,2011-12-28 18:20:41
9dbe9864dbfa26db8b20426a47eb56e149bf6f8f...1bce317d2c3e6f8b70d178015cf7ed30ddb7d330,2,127,12,139,11,2011-05-05 18:09:07,2011-05-05 18:09:07
9dbe9864dbfa26db8b20426a47eb56e149bf6f8f...00e3f424a1dfc667ab38eee2cc1883bd4b2aed7e,1,0,0,0,0,2011-05-05 02:40:32,2011-05-05 02:40:32
00e3f424a1dfc667ab38eee2cc1883bd4b2aed7e...13eb4fc7adc17f1ecd8d08e424d76d8071e19614,1,3,0,3,1,2011-05-05 12:38:14,2011-05-05 12:37:37
13eb4fc7adc17f1ecd8d08e424d76d8071e19614...d50efdcbd8ca880f2c5837decfed1e763db992a1,1,15,9,24,2,2011-05-05 14:15:34,2011-05-05 14:15:34
d50efdcbd8ca880f2c5837decfed1e763db992a1...5800c920f14f29d4b6219d8e8ac53d0abffce774,2,12,9,21,6,2011-05-05 15:37:47,2011-05-05 15:37:33
5800c920f14f29d4b6219d8e8ac53d0abffce774...f8688da55ba025537d6cd6340226b792f196ae13,2,384,401,785,28,2011-05-05 15:28:42,2011-05-04 22:02:58
f8688da55ba025537d6cd6340226b792f196ae13...75e33c52511c8d1daa4ad6179239c2ac194dca33,3,518,44,562,31,2011-05-05 15:28:42,2011-05-05 15:05:37
75e33c52511c8d1daa4ad6179239c2ac194dca33...e4c3ecd92c8903141146c0b685f6ede311e7b1c6,4,18,6,24,8,2011-05-05 15:28:42,2011-05-05 15:17:40
e4c3ecd92c8903141146c0b685f6ede311e7b1c6...2e7a28c0d7b73b5ea65c78769feb3e7a4916abc1,2,17,6,23,7,2011-05-05 16:42:32,2011-05-05 16:42:14
2e7a28c0d7b73b5ea65c78769feb3e7a4916abc1...d71d5f1b9fb55a28356ed5d18b968c6481c0cef1,1,2,2,4,2,2011-05-05 17:43:59,2011-05-05 17:43:59
61c601a678cc9408c7d629e055331c3eed98f879...2221ad4eea656016858a51cc8ced07597683d15a,2,60,0,60,6,2011-04-30 15:53:52,2011-04-30 15:53:52
61c601a678cc9408c7d629e055331c3eed98f879...a4467c4849e2032f682598e06ba5437e843d1125,1,4,1,5,1,2011-04-27 16:29:45,2011-04-27 16:29:45
a4467c4849e2032f682598e06ba5437e843d1125...2b922d909798a4b3eb48bca5dd4771bc428cfee5,2,15,15,30,10,2011-04-27 21:54:49,2011-04-27 21:37:01
2b922d909798a4b3eb48bca5dd4771bc428cfee5...18abbfe85c6fa1a0eea95b44d5cfc1eb0d486cf6,1,1,1,2,1,2011-04-28 03:49:25,2011-04-28 03:49:25
18abbfe85c6fa1a0eea95b44d5cfc1eb0d486cf6...2e31fc98690ab90611f0c0c6b55e4f8e76c2a0ab,1,1,1,2,1,2011-04-28 13:53:39,2011-04-28 13:53:39
2e31fc98690ab90611f0c0c6b55e4f8e76c2a0ab...8659088c682099c0ffc98c9d17371d8841f9f0d5,1,3,0,3,1,2011-04-28 14:15:37,2011-04-28 14:15:37
8659088c682099c0ffc98c9d17371d8841f9f0d5...ac9c6a7f9aa86be1fcd619c85e6a7c296185e0a6,1,1,1,2,1,2011-04-28 14:28:08,2011-04-28 14:28:08
ac9c6a7f9aa86be1fcd619c85e6a7c296185e0a6...6543ca6e0f5c060f80e5945b190406c24a3a7677,1,1,0,1,1,2011-04-28 15:08:36,2011-04-28 15:08:28
6543ca6e0f5c060f80e5945b190406c24a3a7677...6cdeee14b96378e9082dc18914ac2478c5901174,1,1,1,2,1,2011-04-28 16:02:52,2011-04-28 16:02:52
6cdeee14b96378e9082dc18914ac2478c5901174...dd1877599f6e8cd383ab102816f38388e4516069,1,21,24,45,7,2011-04-28 17:15:34,2011-04-28 17:15:34
dd1877599f6e8cd383ab102816f38388e4516069...77f533612ca7eaa54b9c0718e18462bae541c0f9,1,29,0,29,1,2011-04-28 17:15:57,2011-04-28 17:15:57
77f533612ca7eaa54b9c0718e18462bae541c0f9...02048643945239f7e17795b0707481cd11f947c4,2,7,0,7,2,2011-04-28 17:36:22,2011-04-28 17:36:22
02048643945239f7e17795b0707481cd11f947c4...79c9a7906481d0f20568054aef63892203a6a87b,1,5,1,6,1,2011-04-28 17:40:30,2011-04-28 17:40:30
79c9a7906481d0f20568054aef63892203a6a87b...a27401fa5639758df6a2711b5135e21e3a2511cb,1,4,2,6,1,2011-04-28 19:12:54,2011-04-28 19:08:25
a27401fa5639758df6a2711b5135e21e3a2511cb...0195c538dd270b905241d9eef3c36dc65fcad069,1,8,8,16,6,2011-04-28 19:47:10,2011-04-28 19:47:10
0195c538dd270b905241d9eef3c36dc65fcad069...2b76720b72c92f14b6dc60e6727a84db785dbfcd,1,9,8,17,3,2011-04-28 20:37:58,2011-04-28 20:37:40
2b76720b72c92f14b6dc60e6727a84db785dbfcd...5273d66937cbcb25bb1790d1ae8042a514404fcd,1,29,19,48,1,2011-04-28 22:10:42,2011-04-28 22:10:42
5273d66937cbcb25bb1790d1ae8042a514404fcd...6e59ddcc7a0d4682786a91b391e156a41eade48c,1,27,27,54,1,2011-04-28 22:18:02,2011-04-28 22:18:02
6e59ddcc7a0d4682786a91b391e156a41eade48c...ef042e49915d2699049fc94caf386c58d1548842,1,5,0,5,2,2011-04-28 22:57:25,2011-04-28 22:57:25
ec0533d973e40911b41e65577f3df797469294fc...6d6d6e4309e6921b09f6c650f03951f277c758b8,1,1,5,6,1,2011-04-19 13:21:29,2011-04-19 13:21:29
ec0533d973e40911b41e65577f3df797469294fc...e8ab9155c4325355e9a24a7f400bbca053c19ecd,1,1,1,2,1,2011-04-18 23:24:49,2011-04-18 23:11:29
e8ab9155c4325355e9a24a7f400bbca053c19ecd...e8031de33421e267c8b106e102d42c4f3a45ce89,1,3,0,3,3,2011-04-18 23:24:49,2011-04-18 23:24:04
757de40cffc57644aad958ec6635b59487e5ee88...796a36c50f12c7d6de0c220a9404c84518aa5588,1,1,3,4,2,2011-12-28 19:25:20,2011-12-28 19:25:01
796a36c50f12c7d6de0c220a9404c84518aa5588...ff70c7c017840ec54897085e7d0bc5d4f8f5acb7,2,119,0,119,3,2011-12-28 21:29:31,2011-12-27 22:14:32
ff70c7c017840ec54897085e7d0bc5d4f8f5acb7...41c64c1b88f37827a8b9aa455bd76cd0de6ffbce,1,2,1,3,1,2011-12-28 22:21:49,2011-12-28 22:21:49
41c64c1b88f37827a8b9aa455bd76cd0de6ffbce...f341b2f26382f74ee5e9666f2df3507dbd7d6a29,1,5,1,6,2,2011-12-28 22:49:15,2011-12-28 22:47:47
f341b2f26382f74ee5e9666f2df3507dbd7d6a29...7b64c26e17b6994f1a19d38d00766ef64b256185,1,1,1,2,1,2011-12-28 23:39:41,2011-12-28 23:38:11
7b64c26e17b6994f1a19d38d00766ef64b256185...a71bda30078c262667ccdb8bb97fe3add24a2afb,4,27,14,41,15,2011-12-29 01:42:54,2011-12-29 01:41:40
a71bda30078c262667ccdb8bb97fe3add24a2afb...25840a6fa69a4ef2d5b5e3b376aea5e52827ee7d,2,0,4,4,1,2011-12-29 01:52:46,2011-12-29 01:52:36
25840a6fa69a4ef2d5b5e3b376aea5e52827ee7d...d97a9442b4a0ceb98ea26a981bf49d05974c77b8,1,1,1,2,1,2011-12-29 08:08:45,2011-12-29 08:08:45
d97a9442b4a0ceb98ea26a981bf49d05974c77b8...9673d19492dc9260d6a8eedf489e57cce182fe0b,1,1339,1299,2638,321,2011-12-29 14:36:27,2011-12-29 14:36:27
9673d19492dc9260d6a8eedf489e57cce182fe0b...83f81b05911d361371b8306644eff8b1a188d589,3,19,2,21,6,2011-12-29 14:44:56,2011-12-29 14:40:02
757de40cffc57644aad958ec6635b59487e5ee88...5d8849e276d82258e54d8c8d32586d83326cd73c,1,5,2,7,3,2011-12-28 19:07:24,2011-12-28 19:07:24
d74aa3e41c5fb63be3b491974454c9863ef2091f...0a5e650cb21ab8873455b79e7b0db769aee20a6f,1,1,1,2,1,2011-05-09 14:51:00,2011-05-09 14:51:00
d74aa3e41c5fb63be3b491974454c9863ef2091f...f8b214bdc3ea7755b1ab1b81af3b3a92d9d9c62a,1,8,8,16,7,2011-05-05 19:43:42,2011-05-05 19:43:42
f8b214bdc3ea7755b1ab1b81af3b3a92d9d9c62a...d41794452a203b8586167bf6ac14ed721d754d5d,2,9,10,19,6,2011-05-05 22:01:37,2011-05-05 21:49:11
d41794452a203b8586167bf6ac14ed721d754d5d...dbe76163c54aec9210a0518928e749394bf8ada3,2,10,20,30,6,2011-05-05 22:01:37,2011-05-05 21:57:47
dbe76163c54aec9210a0518928e749394bf8ada3...f3eaa8b80493911944c9ff557359e5f4bb03c89a,2,5,19,24,7,2011-05-05 22:01:37,2011-05-05 22:01:29
f3eaa8b80493911944c9ff557359e5f4bb03c89a...32627bd70519e37f916624adf4d783571c2226a9,1,5,1,6,1,2011-05-05 23:07:40,2011-05-05 23:07:40
d04022b31f5d8c8b79386c4fc58946a7324e8643...5f3694fb9a560e466d32c5e6011662b276b6d5ce,3,3,3,6,3,2011-04-30 16:13:17,2011-04-30 16:13:17
5f3694fb9a560e466d32c5e6011662b276b6d5ce...227e25c55ef47c54fb899579e2325a41782d8b7a,2,37,0,37,8,2011-04-30 17:30:57,2011-04-30 17:30:57
227e25c55ef47c54fb899579e2325a41782d8b7a...1773ba2f5e6c7358e200450f93900b787179132b,2,57,9,66,14,2011-04-30 18:59:10,2011-04-30 18:59:10
1773ba2f5e6c7358e200450f93900b787179132b...633150e7a15bccc957d1635ff5ec9762f1b251f2,3,6,0,6,3,2011-04-30 18:59:20,2011-04-30 18:59:20
633150e7a15bccc957d1635ff5ec9762f1b251f2...55c95ec3f08cdb7382ffdb5861edafc9577f1d71,1,4,4,8,4,2011-04-30 19:12:34,2011-04-30 19:12:34
55c95ec3f08cdb7382ffdb5861edafc9577f1d71...287981ace2ec0fc5bb9930afe9061b47fc54d474,1,4,1,5,4,2011-04-30 22:55:22,2011-04-30 22:55:22
287981ace2ec0fc5bb9930afe9061b47fc54d474...434d8b47e569578d932e3caedd3bb16e8c0836a3,4,9,3,12,4,2011-05-01 06:40:52,2011-05-01 06:40:52
434d8b47e569578d932e3caedd3bb16e8c0836a3...b1fdaec5363234ed0a8148f579fefc2facf3724a,2,2,2,4,2,2011-05-01 13:30:05,2011-05-01 13:30:05
b1fdaec5363234ed0a8148f579fefc2facf3724a...c203325c67046c970030859a557fbe67d04732b1,1,23,0,23,1,2011-05-01 13:30:17,2011-05-01 13:30:17
c203325c67046c970030859a557fbe67d04732b1...72b2c46fabdb0470e27f8a1ff102e46d9d07f362,2,69,36,105,10,2011-05-01 21:50:23,2011-05-01 21:50:23
72b2c46fabdb0470e27f8a1ff102e46d9d07f362...b06a2c7ef337ceb0336b0195556f151c77d98f5b,1,18,4,22,2,2011-05-02 02:50:06,2011-05-02 02:49:50
b06a2c7ef337ceb0336b0195556f151c77d98f5b...d174ab91eab41c521ee9df51a5b45c06ae93c065,1,5,1,6,4,2011-05-02 04:04:35,2011-05-02 04:04:35
ef042e49915d2699049fc94caf386c58d1548842...5ae781d54cd57ce7af23623be5acd7e4988a8f16,1,2,2,4,1,2011-04-29 03:10:46,2011-04-29 03:10:46
5ae781d54cd57ce7af23623be5acd7e4988a8f16...64e8cca9c9d8048dfe6580635e2e83739caf0a0d,1,2,1,3,1,2011-04-29 14:17:00,2011-04-29 14:16:17
64e8cca9c9d8048dfe6580635e2e83739caf0a0d...1183afb5c661d6fa34f69e75fb7c5d522bc1a8b9,1,24,21,45,3,2011-04-29 14:54:12,2011-04-29 14:53:58
0797232ce9144257dae4f7ddc5e97b07ff0dd9b8...f46e1873013ba477896148f385dc3656d444df1d,3,6,4,10,4,2011-04-30 03:22:21,2011-04-30 03:22:21
83f81b05911d361371b8306644eff8b1a188d589...ae1ea7fcab5079531df5f2b452068b588c538c77,2,26,28,54,7,2011-12-29 18:00:28,2011-12-29 18:00:28
ae1ea7fcab5079531df5f2b452068b588c538c77...eca9d75d11c79f0c9233ec77b261661c078d1a0e,1,20,0,20,1,2011-12-29 19:00:07,2011-12-29 19:00:07
eca9d75d11c79f0c9233ec77b261661c078d1a0e...ddb8c8a02765b9508ad73ef6a87ba46e87e4d245,1,2,0,2,1,2011-12-29 20:07:54,2011-12-29 20:07:00
ddb8c8a02765b9508ad73ef6a87ba46e87e4d245...64b596993b18e5a22becf729549ec0386ce278a3,4,44,14,58,14,2011-12-29 20:41:11,2011-12-29 20:41:11
64b596993b18e5a22becf729549ec0386ce278a3...594e67254a657966e1913923b34030f29f07fe2f,1,3,2,5,1,2011-12-29 20:42:03,2011-12-29 20:42:03
594e67254a657966e1913923b34030f29f07fe2f...009cc229ea0af766e632db87d5d6b45f7a60a275,2,114,0,114,4,2011-12-29 21:37:24,2011-12-29 21:37:24
f8f27e19edcf164ed0b498df4b0fd088e466b395...ac059a15ac561499ed6232a49ac4ef0a31d3568d,1,2,1,3,2,2011-05-09 14:52:12,2011-05-09 14:52:12
ac059a15ac561499ed6232a49ac4ef0a31d3568d...18a3313ffa9663a9b6903454e8e5891af68583d6,1,1,1,2,1,2011-05-09 15:05:30,2011-05-09 15:05:30
18a3313ffa9663a9b6903454e8e5891af68583d6...730d2d30a5ab7b96d12f93bb86b96f29c4781b2b,2,7,4,11,4,2011-05-09 15:16:45,2011-05-09 15:10:18
730d2d30a5ab7b96d12f93bb86b96f29c4781b2b...174d466dace8c62668bc671740832e14c64a044a,14,128,95,223,43,2011-05-09 15:25:12,2011-05-05 17:19:05
174d466dace8c62668bc671740832e14c64a044a...97859cb7fcade8f13cd5f83765543e04f61bb2dc,1,36,0,36,1,2011-05-09 15:25:12,2011-05-05 19:39:03
97859cb7fcade8f13cd5f83765543e04f61bb2dc...14a452e85e593ed9dc8fe3b3972463aa802af62a,2,19,16,35,6,2011-05-09 15:34:03,2011-05-09 15:33:40
14a452e85e593ed9dc8fe3b3972463aa802af62a...d9e693d9e96ebe8c27da30a56aafdc6ad61f8717,2,2,2,4,2,2011-05-09 15:43:16,2011-05-09 15:43:16
d9e693d9e96ebe8c27da30a56aafdc6ad61f8717...6236e63d319ec99b71d27a5736ac5284f450d4da,1,2,2,4,1,2011-05-09 15:46:22,2011-05-09 14:40:59
6236e63d319ec99b71d27a5736ac5284f450d4da...e7bca564d545d8168bede6bf1a82d0070a97a697,1,22,0,22,1,2011-05-09 15:46:22,2011-05-09 15:12:38
e7bca564d545d8168bede6bf1a82d0070a97a697...6141dacd9fe8e7c650efe5018ed0aa5e3b8be6f2,2,0,32,32,2,2011-05-09 15:46:22,2011-05-09 15:14:39
6141dacd9fe8e7c650efe5018ed0aa5e3b8be6f2...9def02f2e81d4649ef660c0def8c5d8f2aaf7f87,14,95,128,223,43,2011-05-09 15:39:10,2011-05-09 15:37:23
9def02f2e81d4649ef660c0def8c5d8f2aaf7f87...8f3d65df19c9c7dc81649375f5f802fd60cc5e7a,1,0,36,36,1,2011-05-09 15:39:10,2011-05-09 15:37:41
32627bd70519e37f916624adf4d783571c2226a9...2692ba8b46cc1be67c20862221ac4442673a16b2,1,2,0,2,1,2011-05-06 01:05:37,2011-05-06 01:05:37
2692ba8b46cc1be67c20862221ac4442673a16b2...032f6fcc6429e43445abc25a1cb00ae50d381f2d,1,6,6,12,6,2011-05-06 02:52:10,2011-05-06 00:07:23
032f6fcc6429e43445abc25a1cb00ae50d381f2d...791717764d2069e04640454c34b6472bc96701bd,3,46,65,111,6,2011-05-06 02:52:10,2011-05-06 02:19:47
791717764d2069e04640454c34b6472bc96701bd...80d6f91f1936d945dcc39a62d575f3f852eba33c,3,31,26,57,20,2011-05-06 02:52:10,2011-05-06 02:50:12
80d6f91f1936d945dcc39a62d575f3f852eba33c...ecdef30666605e1891eee276a8afff2eb1be270e,3,26,12,38,7,2011-05-06 14:43:45,2011-05-06 14:43:39
ecdef30666605e1891eee276a8afff2eb1be270e...4f2d95933c1f80b9d4de1ad2693ebd6147123602,1,10,1,11,1,2011-05-06 14:50:44,2011-05-06 14:50:44
4f2d95933c1f80b9d4de1ad2693ebd6147123602...c9b29b3418221f239c077f7fb4c5177c5f53830b,1,1,1,2,1,2011-05-06 15:55:43,2011-05-06 15:54:56
c9b29b3418221f239c077f7fb4c5177c5f53830b...360a8eadfedad666c912ec81698388a48f50605a,2,143,8,151,7,2011-05-06 17:26:37,2011-05-06 17:26:27
360a8eadfedad666c912ec81698388a48f50605a...d24985a99afc0e87609e262469edd5710e8281e5,1,1,1,2,1,2011-05-06 17:36:24,2011-05-06 16:29:32
d24985a99afc0e87609e262469edd5710e8281e5...be124009c226d122979fb11623dc3f98aaa1c3be,1,20,16,36,3,2011-05-06 17:36:24,2011-05-06 17:35:50
be124009c226d122979fb11623dc3f98aaa1c3be...aa13edaae8449d76d16d3931428c6bd922cbb81f,3,69,10,79,16,2011-05-06 17:31:26,2011-05-06 14:22:08
aa13edaae8449d76d16d3931428c6bd922cbb81f...c119c015fee475d8bc1a57a34bd2a7c4fd057d9e,1,1,1,2,1,2011-05-06 19:21:22,2011-05-06 18:02:08
c119c015fee475d8bc1a57a34bd2a7c4fd057d9e...d0dd2926942e83f12a692747a5d863ea87c37714,1,1,1,2,1,2011-05-06 19:21:22,2011-05-06 18:04:01
d0dd2926942e83f12a692747a5d863ea87c37714...0c5c2b49d2d95042b9f9fdd0be44846e267e99f8,1,24,7,31,3,2011-05-06 20:04:43,2011-05-06 20:04:25
0c5c2b49d2d95042b9f9fdd0be44846e267e99f8...a9faaa2b083e7eaf5928199474d7ad08878f2ed8,1,10,3,13,3,2011-05-06 21:07:32,2011-05-06 21:07:32
a9faaa2b083e7eaf5928199474d7ad08878f2ed8...2ac6dbcf63547fd90609e3812e4c99e835ed0082,2,8,10,18,9,2011-05-06 21:30:24,2011-05-06 21:30:24
9689ddf9e8ab4480cd37d94bdc821b664f5effed...26c85ceb237ac9a7f02a7df3412572605d4e631c,1,6,1,7,1,2011-05-02 16:25:09,2011-04-20 21:59:17
26c85ceb237ac9a7f02a7df3412572605d4e631c...ef373aa1de3a442a1bd36c3f598a18343a0e6660,2,2,2,4,2,2011-05-02 17:28:11,2011-05-02 17:28:11
ef373aa1de3a442a1bd36c3f598a18343a0e6660...d1474f426fa7cc53b584eb00fe8d6e23a1254f25,2,987,947,1934,3,2011-05-02 17:30:49,2011-04-25 22:00:45
d1474f426fa7cc53b584eb00fe8d6e23a1254f25...77155b29231642e91c65116b1b3e9bae23110cff,4,0,7,7,5,2011-05-02 17:30:50,2011-04-25 22:12:34
77155b29231642e91c65116b1b3e9bae23110cff...a9f50f19307bbcb978f4cd428dfd3ba1a7d38712,2,2,2,4,2,2011-05-02 17:30:50,2011-04-25 22:18:05
a9f50f19307bbcb978f4cd428dfd3ba1a7d38712...c8a934caf7a12ff5fe6c8969c76808beda728a05,1,3,1,4,2,2011-05-02 17:30:50,2011-04-25 22:28:50
c8a934caf7a12ff5fe6c8969c76808beda728a05...ddd7dd323dabdc4cd55fd753bb71c3340e2f4872,6,29,29,58,26,2011-05-02 17:33:52,2011-04-25 22:47:01
ddd7dd323dabdc4cd55fd753bb71c3340e2f4872...216f9ca3a0bcf0fbbf8fd1372771d8b926911e0b,1,4,0,4,1,2011-05-02 17:33:52,2011-04-25 22:51:11
216f9ca3a0bcf0fbbf8fd1372771d8b926911e0b...4786360d414f6b4421a71456222866c9a4f033fa,4,31,10,41,9,2011-05-02 17:33:52,2011-04-26 01:16:08
4786360d414f6b4421a71456222866c9a4f033fa...2c0521528152b6fc2b23cb77f9bc714f3398c6ac,2,3,3,6,3,2011-05-02 17:33:52,2011-04-26 22:26:16
2c0521528152b6fc2b23cb77f9bc714f3398c6ac...e780ffc12fc56885566a93f5fa97f8281885f334,4,76,4,80,12,2011-05-02 17:33:53,2011-05-02 17:30:38
e780ffc12fc56885566a93f5fa97f8281885f334...9bb14b30a08b695a78705536a4502079038770a3,3,151,107,258,12,2011-05-02 18:26:36,2011-05-02 17:58:06
9bb14b30a08b695a78705536a4502079038770a3...008e375fe424ff2c860ee5869410867372a7dd8a,1,2,2,4,2,2011-05-02 18:26:36,2011-05-02 17:58:44
008e375fe424ff2c860ee5869410867372a7dd8a...b5016480328394516a8e3e29d992fa9f264b0587,5,106,7,113,14,2011-05-02 18:26:36,2011-05-02 18:26:02
b5016480328394516a8e3e29d992fa9f264b0587...e98a9e6c2d1a4754305c7ba9f09a83fafdacc985,1,12,12,24,12,2011-05-02 18:33:24,2011-05-02 18:33:24
e98a9e6c2d1a4754305c7ba9f09a83fafdacc985...aaad7824cddd8db18263346c1258ad86ce76abec,1,55,52,107,52,2011-05-02 18:39:16,2011-05-02 18:39:16
aaad7824cddd8db18263346c1258ad86ce76abec...6c49cef53c727bd8efde33fd78431f2945a28036,1,13,3,16,2,2011-05-02 18:48:54,2011-05-02 18:48:54
6c49cef53c727bd8efde33fd78431f2945a28036...815b9952074536f7bc255bfb594df74dcba95897,6,66,4,70,12,2011-05-02 19:01:52,2011-05-02 19:01:52
815b9952074536f7bc255bfb594df74dcba95897...be8e2f261d50a410749f2934431d451eecdb47b3,1,4,3,7,3,2011-05-02 19:44:37,2011-05-02 19:40:55
be8e2f261d50a410749f2934431d451eecdb47b3...210d9599c32c0819ae7a7715e146c2c27f603623,1,5,0,5,1,2011-05-02 20:37:56,2011-05-02 20:37:56
210d9599c32c0819ae7a7715e146c2c27f603623...1008b8240eb361a7f98bd649dd05d8ba66d43052,3,6,34,40,9,2011-05-02 22:26:08,2011-05-02 22:26:08
1008b8240eb361a7f98bd649dd05d8ba66d43052...7a3a04458403713ee9cda6d4d978ebd5a25c5208,1,4,9,13,2,2011-05-02 22:34:12,2011-05-02 22:34:12
7a3a04458403713ee9cda6d4d978ebd5a25c5208...52c03d3954fe7bc988a04b05e28882a266f5be0d,1,3,1,4,2,2011-05-02 23:08:40,2011-04-25 20:33:33
52c03d3954fe7bc988a04b05e28882a266f5be0d...1725803c209ddf6ca52190447ddb1bdbc7371719,12,156,118,274,65,2011-05-02 23:08:41,2011-04-27 18:57:10
1725803c209ddf6ca52190447ddb1bdbc7371719...04d364a44d34b22c2c44df9240025bc01730ae1d,4,13,3,16,6,2011-05-02 23:08:41,2011-04-27 23:05:40
04d364a44d34b22c2c44df9240025bc01730ae1d...1f6df26f345fdeb1c936d9a61fed38fd9cb4065d,1,2,2,4,2,2011-05-02 23:08:41,2011-04-28 17:19:39
1f6df26f345fdeb1c936d9a61fed38fd9cb4065d...ce74c015fcf5503b55dc4b50064a923f517eb941,5,7,1,8,5,2011-05-03 00:53:11,2011-05-03 00:53:11
ce74c015fcf5503b55dc4b50064a923f517eb941...84f7cc0339f6726a6e9dd1fd11289b56aa90120c,1,52,51,103,50,2011-05-03 02:05:10,2011-05-03 02:04:38
84f7cc0339f6726a6e9dd1fd11289b56aa90120c...d85a192d18988e8fb116af8f955be8a963fd3646,1,12,12,24,12,2011-05-03 03:24:54,2011-05-03 03:24:54
d85a192d18988e8fb116af8f955be8a963fd3646...a72aea2378c4ba24e029ce14936158b05791396c,2,4,0,4,2,2011-05-03 04:31:47,2011-05-03 04:31:47
a72aea2378c4ba24e029ce14936158b05791396c...33897ac5d18956afcb605547f7ce337ed7c65603,2,23,9,32,4,2011-05-03 04:56:47,2011-05-03 04:49:39
33897ac5d18956afcb605547f7ce337ed7c65603...18dc400e68183bb2332d9e5440b939972340a031,4,43,4,47,8,2011-05-03 14:53:24,2011-05-03 14:53:24
1183afb5c661d6fa34f69e75fb7c5d522bc1a8b9...c574959c57f3f66dcdd41a244f08b687ca03480b,3,39,2,41,6,2011-04-29 21:37:45,2011-04-29 21:37:45
1183afb5c661d6fa34f69e75fb7c5d522bc1a8b9...6d659f8a97b7c98199b69d3c0a286f552f6df5bf,1,25,7,32,7,2011-04-29 18:48:42,2011-04-29 18:48:42
6d659f8a97b7c98199b69d3c0a286f552f6df5bf...fee2092cc0aacfe7f32421fbb06274c43514ee56,7,22,12,34,15,2011-04-29 18:50:41,2011-04-29 18:50:41
fee2092cc0aacfe7f32421fbb06274c43514ee56...21050ef6aeb61770ab31316ab11b5caf08758951,1,12,15,27,11,2011-04-29 19:37:39,2011-04-29 19:37:39
009cc229ea0af766e632db87d5d6b45f7a60a275...2eafe478d667bb2e68410c6709806efe60b0b713,2,9,5,14,7,2011-12-30 00:26:28,2011-12-30 00:24:36
5d822cc2c215e2b54b002b5f86be3ef4a1822876...0825375aa178e4a8d278f3315155604bb1927e85,1,0,2,2,1,2011-05-09 18:35:50,2011-05-09 18:35:19
0825375aa178e4a8d278f3315155604bb1927e85...2758a8bac039b57cc26e8ff7fc8a24f7ae257893,1,1,1,2,1,2011-05-09 19:02:39,2011-05-09 19:01:39
2758a8bac039b57cc26e8ff7fc8a24f7ae257893...6734bc5c88a6a162cd528de81b3a80a8014e2c8e,1,0,2,2,2,2011-05-09 19:45:45,2011-05-09 19:43:14
6734bc5c88a6a162cd528de81b3a80a8014e2c8e...764b6d595ab9d594160f21ff867cab6f86d4eeac,1,3,0,3,2,2011-05-09 19:45:45,2011-05-09 19:43:25
764b6d595ab9d594160f21ff867cab6f86d4eeac...f3a9c31c5cb46dba82b468b369f23caa58239de7,3,160,1,161,5,2011-05-09 19:46:12,2011-05-09 19:45:13
f3a9c31c5cb46dba82b468b369f23caa58239de7...217b88af17ebb0470fbf53dce1797f251837923b,3,47,11,58,12,2011-05-09 20:00:04,2011-05-09 17:56:11
217b88af17ebb0470fbf53dce1797f251837923b...a03fc0744bcb481609a757440917ed74cb84d449,1,59,0,59,4,2011-05-09 20:00:04,2011-05-09 18:31:54
a03fc0744bcb481609a757440917ed74cb84d449...de5b7c284bbee4ae3217af675cde3096a3e183bb,1,3,2,5,2,2011-05-09 20:00:05,2011-05-09 18:47:13
de5b7c284bbee4ae3217af675cde3096a3e183bb...b005cc8aeb534f06abe8e28228f365ff5a418893,1,0,3,3,2,2011-05-09 20:56:00,2011-05-09 20:54:21
b005cc8aeb534f06abe8e28228f365ff5a418893...f34353fd579e918360d2a3d0b32fef0bee307ea2,1,1,0,1,1,2011-05-09 20:56:00,2011-05-09 20:55:37
f34353fd579e918360d2a3d0b32fef0bee307ea2...a6ea8999579e4902c1a89e925a8fc9536d261c06,2,2,1,3,2,2011-05-09 22:28:25,2011-05-09 22:27:43
a6ea8999579e4902c1a89e925a8fc9536d261c06...c38e8ec4659c54f813867afe8f7f72f1e93cbb05,2,2,0,2,2,2011-05-10 00:27:27,2011-05-10 00:27:27
c38e8ec4659c54f813867afe8f7f72f1e93cbb05...699ebbbe37f1d2c9d7c9f7912494160b2440ff72,3,12,12,24,6,2011-05-10 01:23:58,2011-05-10 01:23:58
699ebbbe37f1d2c9d7c9f7912494160b2440ff72...1c00db6e1a83eda518558f5f1186c74338972e51,1,1,0,1,1,2011-05-10 01:21:02,2011-05-10 01:21:02
1c00db6e1a83eda518558f5f1186c74338972e51...ce0dd5aec9e1214a8e7fad7f0547bdc6cfee5085,1,1,0,1,1,2011-05-10 01:29:06,2011-05-10 01:29:06
2ac6dbcf63547fd90609e3812e4c99e835ed0082...b596d0feea4c42a273d0046d83793d944aba0de9,1,3,0,3,1,2011-05-06 21:57:40,2011-05-06 21:57:40
2ac6dbcf63547fd90609e3812e4c99e835ed0082...9c79d5735da100a25aed37c3a1339b69e8883c07,1,18,11,29,2,2011-05-06 21:42:00,2011-05-06 21:40:28
18dc400e68183bb2332d9e5440b939972340a031...e9ae388f308071c90f883c36c08277bc6ca990a6,1,18,7,25,8,2011-05-03 15:29:30,2011-05-03 15:29:30
e9ae388f308071c90f883c36c08277bc6ca990a6...5eaaddba616acf65c55bb4c0ca0b7f9c48f27999,1,1,1,2,1,2011-05-03 16:01:31,2011-05-03 16:01:31
f7f040a96ac8f4448af97edc8288ab69d66474e3...6fd1677e8718b077ca304fe22a16ba1ccbfd1485,1,0,2,2,1,2011-12-30 15:55:32,2011-12-30 15:55:32
6fd1677e8718b077ca304fe22a16ba1ccbfd1485...3c4ea9314fb363d2c29573ec80f1573431527124,1,29,13,42,12,2011-12-30 15:55:42,2011-12-30 15:55:42
3c4ea9314fb363d2c29573ec80f1573431527124...eb39a025d70dcc0f5ae7fed6ccf9087b1aa01676,1,5,0,5,1,2011-12-30 17:11:08,2011-12-30 17:11:08
ce0dd5aec9e1214a8e7fad7f0547bdc6cfee5085...871d923401fd5c296564d81c10f20bb500858883,8,128,51,179,28,2011-05-10 16:40:01,2011-05-10 16:40:01
ce0dd5aec9e1214a8e7fad7f0547bdc6cfee5085...f70b49ddefb8cefc180ecba379fa4e838f149935,1,1,1,2,1,2011-05-10 03:59:14,2011-05-10 03:59:14
f70b49ddefb8cefc180ecba379fa4e838f149935...6075760ada035566f530c42875053e296dc4fb73,3,80,154,234,46,2011-05-10 14:34:18,2011-05-09 19:30:17
6075760ada035566f530c42875053e296dc4fb73...35be251fd98bbcd3eef97499e6bbe7169f1b652e,1,0,70,70,1,2011-05-10 14:34:18,2011-05-10 14:19:13
58f9b93b07739e92e32dae34d3eaa738d368b54a...2e4f101dab55893ef93b75c9074687f9eb38e8d9,1,2,0,2,1,2011-05-07 00:51:06,2011-05-07 00:51:06
58f9b93b07739e92e32dae34d3eaa738d368b54a...fafe6cb761354bd131cb631035706179dd820a48,2,13,6,19,7,2011-05-06 23:01:03,2011-05-06 17:53:32
fafe6cb761354bd131cb631035706179dd820a48...7cf37b75c3ea8dccac2734dbe032ca7f221dedeb,1,1,1,2,1,2011-05-06 23:01:03,2011-05-06 17:55:06
7cf37b75c3ea8dccac2734dbe032ca7f221dedeb...6ccfff789a967641d20cfe8f1470178b00a91154,2,12,17,29,5,2011-05-06 23:01:03,2011-05-06 17:57:24
6ccfff789a967641d20cfe8f1470178b00a91154...d9e87d10997541fa3d17ea3f3de8d53814640e7f,2,31,38,69,30,2011-05-06 23:01:03,2011-05-06 19:30:37
d9e87d10997541fa3d17ea3f3de8d53814640e7f...596d71e61dbad10c11857da40a84d00fe099f939,2,8,9,17,4,2011-05-06 23:01:03,2011-05-06 20:05:27
596d71e61dbad10c11857da40a84d00fe099f939...28e399333bb65e8d7038633e7d37c10281ccf8e6,1,2,10,12,1,2011-05-06 23:01:03,2011-05-06 20:16:07
28e399333bb65e8d7038633e7d37c10281ccf8e6...71f5dd3d5e4102aa0079356f730f2de14fd40386,1,0,8,8,2,2011-05-06 23:01:03,2011-05-06 20:18:35
71f5dd3d5e4102aa0079356f730f2de14fd40386...708f76bc60f1e9014d0fd610d9273fab754a7a5f,2,23,25,48,7,2011-05-06 23:01:03,2011-05-06 20:22:34
708f76bc60f1e9014d0fd610d9273fab754a7a5f...50a0115bd2449b7c554e2a128e8de89c26fa5a75,3,13,32,45,14,2011-05-06 23:01:03,2011-05-06 20:44:07
50a0115bd2449b7c554e2a128e8de89c26fa5a75...7e1a3ab554e08c3d3e872e0febd7989f0293032f,1,2,2,4,2,2011-05-06 23:01:04,2011-05-06 20:47:38
7e1a3ab554e08c3d3e872e0febd7989f0293032f...e15ca906624e18224a7c3b1eacff38a5641c1727,2,0,64,64,2,2011-05-06 23:01:04,2011-05-06 20:56:41
e15ca906624e18224a7c3b1eacff38a5641c1727...0ca805953972134c6710f7df1ee8629aa2788e2b,1,1,1,2,1,2011-05-06 23:01:04,2011-05-06 21:00:15
0ca805953972134c6710f7df1ee8629aa2788e2b...24cd932f3ef29ad38c0c45b9076652e8f707df13,2,17,16,33,10,2011-05-06 23:01:04,2011-05-06 21:12:21
24cd932f3ef29ad38c0c45b9076652e8f707df13...bb0873d14c340f48a96a48d19d626c8b9fb70b91,2,20,23,43,8,2011-05-06 23:01:04,2011-05-06 21:30:46
bb0873d14c340f48a96a48d19d626c8b9fb70b91...8e216ef190e6bd8221a8635e32b602696a0aeac8,2,4,16,20,11,2011-05-06 23:01:04,2011-05-06 21:52:15
8e216ef190e6bd8221a8635e32b602696a0aeac8...04ac31d0756a4620b7a10b6845f18e8cdfdd969d,1,1,1,2,2,2011-05-06 23:14:42,2011-05-06 23:14:42
04ac31d0756a4620b7a10b6845f18e8cdfdd969d...c25588e0300143642a0d2213a05f48840af30199,1,1,1,2,1,2011-05-06 23:37:59,2011-05-06 23:37:23
c25588e0300143642a0d2213a05f48840af30199...06f6eec33daf40d6513f099774331ea77c74ca62,1,21,0,21,4,2011-05-06 23:40:18,2011-05-06 23:27:54
eb39a025d70dcc0f5ae7fed6ccf9087b1aa01676...6b618de816fed87cdb179cf9c246fd28d01f8d7b,12,38,48,86,33,2011-12-31 02:23:08,2011-12-31 02:23:08
eb39a025d70dcc0f5ae7fed6ccf9087b1aa01676...2e0f749b8418ae7a82aa814715eb6510a0411e93,2,2,2,4,2,2011-12-30 17:48:14,2011-12-30 17:45:14
2e0f749b8418ae7a82aa814715eb6510a0411e93...d1d3ba01d73a762694ef0540535ede4d61fcc9c8,8,0,0,0,0,2011-12-30 17:48:14,2011-12-30 17:47:46
d1d3ba01d73a762694ef0540535ede4d61fcc9c8...940f2015f40baa25ed2e401af33b8bd584dcd011,8,16,15,31,15,2011-12-30 18:06:43,2011-12-30 18:06:43
940f2015f40baa25ed2e401af33b8bd584dcd011...cdb28667df845b9359e6f5127d0aec69d212afb2,3,27,1,28,3,2011-12-30 19:06:44,2011-12-30 19:06:12
cdb28667df845b9359e6f5127d0aec69d212afb2...2b06e2683cc348ec6b3bd6973510096bd8d88b0e,1,20,67,87,12,2011-12-30 20:18:10,2011-12-27 21:00:26
2b06e2683cc348ec6b3bd6973510096bd8d88b0e...d9d0b431f225c4e3369a6e320b2ee45ff6d8c9be,1,1,1,2,1,2011-12-30 20:18:10,2011-12-30 20:17:41
d9d0b431f225c4e3369a6e320b2ee45ff6d8c9be...944e73aaa98f7cf47a628f64bf69c03ebb9d1545,1,67,20,87,12,2011-12-30 20:19:40,2011-12-30 20:19:40
944e73aaa98f7cf47a628f64bf69c03ebb9d1545...982f933d491c977e5d9f708e6ed9945cea2940f4,1,5,0,5,1,2011-12-30 20:30:34,2011-12-30 20:30:34
982f933d491c977e5d9f708e6ed9945cea2940f4...8819493622f57442be79e1cd4bf4c224dfb53631,2,11,22,33,7,2011-12-30 21:02:38,2011-12-30 20:29:10
8819493622f57442be79e1cd4bf4c224dfb53631...7f94073f98554d026857321232c68ba728089a52,1,2,2,4,1,2011-12-30 21:31:11,2011-12-30 21:31:11
7f94073f98554d026857321232c68ba728089a52...8d9c9ac80c10786bf0d3e4c57a80608c9f89f595,11,91,17,108,20,2011-12-30 21:32:04,2011-12-16 00:46:39
8d9c9ac80c10786bf0d3e4c57a80608c9f89f595...090e37b08b55d785429ad62925b8ad1386c7bfeb,6,8,7,15,7,2011-12-30 22:52:01,2011-12-30 22:52:01
090e37b08b55d785429ad62925b8ad1386c7bfeb...f1f19c50eecfc34ba3c75f20f3ee04e49e16e721,8,12,12,24,12,2011-12-30 22:58:41,2011-12-30 22:58:41
f1f19c50eecfc34ba3c75f20f3ee04e49e16e721...279b9e5185c5daaefc75343aaca06e4efd8a4951,4,23,7,30,4,2011-12-30 23:40:38,2011-12-30 23:40:38
9b52904dc65ea51ed057f00bc9917f9cbf573550...40e9a56d226b89d7a4977e05ea9d117c439962cf,2,6,1,7,2,2011-05-10 16:58:56,2011-05-10 16:58:56
40e9a56d226b89d7a4977e05ea9d117c439962cf...e4e267013ca733c912df6e5e288a8576b6fe31b9,1,0,1,1,1,2011-05-10 17:04:24,2011-05-10 17:04:24
e4e267013ca733c912df6e5e288a8576b6fe31b9...bbe02062d57c9c2acfd9a7e6bc5c4f333ba1b6b7,1,2,0,2,1,2011-05-10 18:50:32,2011-05-10 15:38:30
bbe02062d57c9c2acfd9a7e6bc5c4f333ba1b6b7...a9c3e5ffecbc24e844118145f5cc7957a9cdf70e,2,17,5,22,3,2011-05-10 18:50:32,2011-05-10 18:21:38
a9c3e5ffecbc24e844118145f5cc7957a9cdf70e...69a40de4dc877765f403bb56844e03eace490016,2,69,31,100,16,2011-05-10 18:50:32,2011-05-10 18:23:07
69a40de4dc877765f403bb56844e03eace490016...c83b140fbee2816e2693723be27419b38c19f317,8,69,38,107,26,2011-05-10 18:50:32,2011-05-10 18:41:01
c83b140fbee2816e2693723be27419b38c19f317...b1c7af5e557abe4001192de8e1b1482689d2f9a3,2,9,4,13,5,2011-05-10 18:50:32,2011-05-10 18:46:46
b1c7af5e557abe4001192de8e1b1482689d2f9a3...8bb232d7b31dfcc893c36bc841bdc70f0def3b19,1,5,0,5,1,2011-05-10 18:50:32,2011-05-10 18:50:20
641e11524c9082535583ced8801c50e645cefcea...a5b1570b4f554232eff6c09c1cc80bea355f752f,6,18,14,32,16,2011-05-07 02:08:09,2011-05-07 02:08:09
a5b1570b4f554232eff6c09c1cc80bea355f752f...d2c770380f99c67440763ee23a56c5dad6fe9e78,1,0,21,21,4,2011-05-07 04:46:01,2011-05-07 04:45:49
d2c770380f99c67440763ee23a56c5dad6fe9e78...f6c332c91d0354d48d27d147556116564682198f,1,7,4,11,6,2011-05-07 16:34:20,2011-05-07 16:34:20
f6c332c91d0354d48d27d147556116564682198f...ee86c57d3e73048192c8ef70d9801af6617940c1,3,8,2,10,4,2011-05-07 16:34:35,2011-05-07 16:34:35
ee86c57d3e73048192c8ef70d9801af6617940c1...96ee65be74f8f78ac37f2fb27091870c1f4c495a,1,1,3,4,1,2011-05-07 16:49:27,2011-05-07 16:49:27
96ee65be74f8f78ac37f2fb27091870c1f4c495a...09bf5bbf6b12b006b2ffbdb42f9bcf7e5838a656,1,142,142,284,35,2011-05-07 17:03:56,2011-05-07 17:03:56
09bf5bbf6b12b006b2ffbdb42f9bcf7e5838a656...60388786785233dd5a7897710ef40d919ec4832c,1,7,4,11,5,2011-05-07 18:46:37,2011-05-07 18:44:36
60388786785233dd5a7897710ef40d919ec4832c...71dc50d0062938e8b1b2180e36fcd51d5a5429cb,10,197,94,291,55,2011-05-07 21:00:57,2011-05-07 21:00:57
71dc50d0062938e8b1b2180e36fcd51d5a5429cb...46bc601cc6cbf95b7a832d21d8ace35754a159b4,1,2,1,3,1,2011-05-08 00:11:17,2011-05-08 00:11:17
46bc601cc6cbf95b7a832d21d8ace35754a159b4...bdf6318aa38d8820089da2cc8595866d5f865c2b,1,1,1,2,1,2011-05-08 00:11:35,2011-05-08 00:11:35
bdf6318aa38d8820089da2cc8595866d5f865c2b...9e4087883d0acb3bbbdf8c8b2b175e8b8da511c1,7,109,21,130,14,2011-05-08 04:53:07,2011-05-08 04:53:07
9e4087883d0acb3bbbdf8c8b2b175e8b8da511c1...280943f67fda00a9bee281cb7ab42ea2f97d4c32,1,8,0,8,2,2011-05-08 04:57:31,2011-05-08 04:57:31
280943f67fda00a9bee281cb7ab42ea2f97d4c32...0e1730a53b3d9f04ab5b6c8941f6621b2317bf65,1,1,1,2,1,2011-05-08 05:27:00,2011-05-08 05:27:00
0e1730a53b3d9f04ab5b6c8941f6621b2317bf65...2c49df47526aca35a866b7968bfa939a901eaa02,1,9,4,13,3,2011-05-08 16:47:52,2011-05-08 16:47:52
fa786827b04668e78f6322dbe9ad93285eb33d0d...a5f270a993b94cada84b14444502fbe40f8ab807,1,6,4,10,1,2011-12-31 02:25:14,2011-12-31 02:25:14
a5f270a993b94cada84b14444502fbe40f8ab807...5dcf40b76d94ffcb3a33a1c4a2f6c625ed730869,1,1,5,6,2,2011-12-31 01:51:52,2011-12-31 01:51:52
5dcf40b76d94ffcb3a33a1c4a2f6c625ed730869...8ab6ded98f04ceb2d5c9fe4549b8c28bb53e28eb,2,0,5,5,2,2011-12-31 03:55:45,2011-12-31 03:55:45
8ab6ded98f04ceb2d5c9fe4549b8c28bb53e28eb...066f2db047d56bfc4aab325127a3a6a68cc98434,1,27,27,54,22,2011-12-31 19:24:29,2011-12-31 19:24:29
066f2db047d56bfc4aab325127a3a6a68cc98434...ea6b5f489e511f97f27a9454c5e1e52b36367cc4,2,162,147,309,13,2011-12-31 19:26:31,2011-12-31 19:26:31
8bb232d7b31dfcc893c36bc841bdc70f0def3b19...063c8c926bd228caab11d30e0cb7e3d91dd4b3e1,1,1,1,2,1,2011-05-10 19:52:20,2011-05-10 19:52:20
8bb232d7b31dfcc893c36bc841bdc70f0def3b19...3a0518572fb934cc894c155f91bdc5d77590befa,1,1,1,2,1,2011-05-10 19:45:14,2011-05-10 19:45:14
2c49df47526aca35a866b7968bfa939a901eaa02...a24cd53e98ca098f7673c2b3fb80fe6ede7b2a49,2,5,1,6,2,2011-05-08 22:14:54,2011-05-08 22:14:54
2c49df47526aca35a866b7968bfa939a901eaa02...dac8ee20de47ad0ea8cec53011a0904ee787c67b,1,16,0,16,1,2011-05-08 20:05:58,2011-05-08 20:05:58
dac8ee20de47ad0ea8cec53011a0904ee787c67b...ccbfb35a9d6fe61ebcd1a377da51bf34ab81b48b,1,0,7,7,1,2011-05-08 20:10:57,2011-05-08 20:10:57
ccbfb35a9d6fe61ebcd1a377da51bf34ab81b48b...cef7da1bdf6689fb49fddd2858be1f936257ff6d,1,1,1,2,1,2011-05-08 21:11:20,2011-05-08 21:11:20
cef7da1bdf6689fb49fddd2858be1f936257ff6d...91c9abc30631a27600ed4370579aed40f2fb4e58,1,5,1,6,2,2011-05-08 21:28:46,2011-05-08 21:28:46
91c9abc30631a27600ed4370579aed40f2fb4e58...699abf32b752413fd1aba0953b7fa55f17da255a,1,1,1,2,1,2011-05-08 21:28:56,2011-05-08 21:28:56
699abf32b752413fd1aba0953b7fa55f17da255a...f4d944d610a153260c44d939e065690593119485,1,1,7,8,1,2011-05-08 21:29:09,2011-05-08 21:29:09
ea6b5f489e511f97f27a9454c5e1e52b36367cc4...22cb70f9ab0f5b3461af092a24b78c8958918f04,12,251,178,429,24,2012-01-03 15:45:40,2012-01-03 15:45:40
ea6b5f489e511f97f27a9454c5e1e52b36367cc4...444e87a3ef74d960f9f5e01087ec5790238cd6d2,1,1,1,2,1,2011-12-31 18:47:18,2011-12-31 18:47:18
444e87a3ef74d960f9f5e01087ec5790238cd6d2...ac72765bba79499f938aa1eb1a1fca1eabf1572b,2,15,0,15,3,2012-01-02 20:21:25,2012-01-02 20:21:25
ac72765bba79499f938aa1eb1a1fca1eabf1572b...5d78616641af1259b47869c80c44c3cca4eacfe1,1,8,1,9,4,2012-01-02 20:43:18,2012-01-02 20:43:18
5d78616641af1259b47869c80c44c3cca4eacfe1...8e08a3d0b02c13c28189b72137cd5bd1bf87b39d,1,4,0,4,1,2012-01-02 20:49:43,2012-01-02 20:49:43
b920ba413431b565598bd22c8b1f7e92aba32ab7...3407e2109f358ad0d91c5dc2ae140bd7f4eb49ee,3,38,27,65,18,2011-05-10 20:48:45,2011-05-10 20:48:30
3407e2109f358ad0d91c5dc2ae140bd7f4eb49ee...37e173b69865ce019806c83dc23650b8bf5e2484,1,17,20,37,15,2011-05-10 21:32:20,2011-05-10 21:32:20
37e173b69865ce019806c83dc23650b8bf5e2484...ff711f0d48ac22e403682925e53d11a980b92fea,2,6,3,9,4,2011-05-10 21:35:55,2011-05-10 21:35:55
6ceadb2d15a55bf530439aec89bf2eafaba1d423...5ac8be7e3a2d4b96280c87e1d476ef69f76ad3e0,1,2,0,2,1,2011-05-08 22:19:48,2011-05-08 22:19:48
5ac8be7e3a2d4b96280c87e1d476ef69f76ad3e0...4d72b66db321d11841bc885613d2948a8c56db6b,2,19,4,23,6,2011-05-09 02:13:15,2011-05-09 02:13:15
4d72b66db321d11841bc885613d2948a8c56db6b...3776dc77f169749d37af67e0f07682ad872b209c,2,20,7,27,7,2011-05-09 02:41:13,2011-05-09 02:41:13
3776dc77f169749d37af67e0f07682ad872b209c...9782af4848dbc07a917fd38ea59ae921b02e798b,2,7,0,7,2,2011-05-09 02:52:13,2011-05-09 02:52:13
9782af4848dbc07a917fd38ea59ae921b02e798b...c8a3adbe01dca8cab6d2a1ffbd23bbf6db33a96a,1,1,1,2,1,2011-05-09 04:20:24,2011-05-09 04:20:24
c8a3adbe01dca8cab6d2a1ffbd23bbf6db33a96a...76cbcfb53238825fc4e74e67a24ee25e78a3d57b,4,23,31,54,14,2011-05-09 13:40:48,2011-05-09 13:40:48
76cbcfb53238825fc4e74e67a24ee25e78a3d57b...041e17f96197c4e4303380d3ce1db677d0e1f6be,1,38,24,62,11,2011-05-09 14:42:51,2011-05-09 14:42:51
041e17f96197c4e4303380d3ce1db677d0e1f6be...c8918a0430b81732fef215c10135f5436a9a24b3,2,2,2,4,2,2011-05-09 14:49:19,2011-05-09 14:49:19
810c3c4905d1779b5d3f85ede2ad62ca75205233...4f6b54fce8bb2fae13b9bff824fde2cede998afb,2,2,2,4,3,2012-01-03 16:14:02,2012-01-03 16:14:02
4f6b54fce8bb2fae13b9bff824fde2cede998afb...b90da6fdc0ee0543d07f0add5d042ed3bf8c2efd,4,6,1,7,4,2012-01-04 22:30:14,2012-01-04 22:30:14
b90da6fdc0ee0543d07f0add5d042ed3bf8c2efd...c42305e11c4f89484f2d3e8ed553750f40c1febe,1,5,26,31,14,2012-01-13 01:32:02,2012-01-13 01:32:02
c42305e11c4f89484f2d3e8ed553750f40c1febe...53136779b5fbc647367618ab7ffe2dc4c439648c,1,1,1,2,1,2012-01-15 03:38:26,2012-01-15 03:38:26
53136779b5fbc647367618ab7ffe2dc4c439648c...2da1bd1d9501c1f2a0f1c165a9635d838f868193,1,6,1,7,3,2012-01-15 03:40:13,2012-01-15 03:40:13
2da1bd1d9501c1f2a0f1c165a9635d838f868193...42e98d4a20bf744179eebcb6043bf3eb43b5b4b2,8,13,254,267,23,2012-01-15 03:40:48,2012-01-15 03:40:48
8e08a3d0b02c13c28189b72137cd5bd1bf87b39d...80a02d11a144b59ab5a70a5924235e9be2d7c13a,2,10,0,10,4,2012-01-03 15:51:50,2012-01-03 15:51:50
80a02d11a144b59ab5a70a5924235e9be2d7c13a...f60cfe820cfa0802fc22be976fdc58c50c2df2ac,1,2,1,3,1,2012-01-03 16:06:31,2012-01-03 16:06:04
f60cfe820cfa0802fc22be976fdc58c50c2df2ac...9b35245407c9c13556874864a8a22258d5e08495,1,2,1,3,1,2012-01-03 16:18:16,2012-01-03 16:16:59
9b35245407c9c13556874864a8a22258d5e08495...181d52addd973c51962dc5afce9f65c92a1b6d2c,1,2,1,3,1,2012-01-03 16:18:32,2012-01-03 16:18:13
181d52addd973c51962dc5afce9f65c92a1b6d2c...0c1173a642832d19d8ebe2d2b8b7fbac9531e394,4,7,31,38,10,2012-01-03 18:39:33,2012-01-03 18:39:33
0c1173a642832d19d8ebe2d2b8b7fbac9531e394...c4ec255720610e14dd99124bbead664a6ac4d992,1,4,0,4,1,2012-01-03 18:53:04,2012-01-03 18:53:04
c4ec255720610e14dd99124bbead664a6ac4d992...ec0707e450dbeb586b42319f4ede75518b16039a,1,1,1,2,1,2012-01-03 19:03:19,2012-01-03 19:03:05
ec0707e450dbeb586b42319f4ede75518b16039a...e7fe1c16621ae483629c5663cb42da1e02d32934,2,156,95,251,19,2012-01-03 19:33:32,2012-01-03 19:33:32
e7fe1c16621ae483629c5663cb42da1e02d32934...ab13b26751df5d7439751730dea74dd7e134a7ef,1,18,3,21,3,2012-01-03 19:51:34,2012-01-03 19:51:34
ab13b26751df5d7439751730dea74dd7e134a7ef...d902a7d38328cd934f82152a63367dfa6bb495a0,1,2,1,3,2,2012-01-03 19:52:35,2012-01-03 19:52:11
d902a7d38328cd934f82152a63367dfa6bb495a0...aed4463a413dc51fbcc8405fbbadba66337831f1,5,2112,5,2117,7,2012-01-03 20:37:21,2012-01-03 20:37:21
aed4463a413dc51fbcc8405fbbadba66337831f1...2768eab625f59e24828a3769c6c861a3e935d36b,3,0,2107,2107,3,2012-01-03 20:41:11,2012-01-03 20:41:11
2768eab625f59e24828a3769c6c861a3e935d36b...14b42dd7450aaadd9635a55f6aec8968f1dec8cc,1,1,1,2,2,2012-01-03 21:22:04,2012-01-03 21:22:04
ff711f0d48ac22e403682925e53d11a980b92fea...d3494ef4d0653cf92f786b539e9ed59de239273b,1,2,0,2,2,2011-05-11 14:32:03,2011-05-11 14:32:03
ff711f0d48ac22e403682925e53d11a980b92fea...8d13203c40150d93b5747adf4430a8b6edd21ac9,10,120,36,156,51,2011-05-10 22:30:01,2011-05-05 23:30:55
8d13203c40150d93b5747adf4430a8b6edd21ac9...13e71279c964fc3f84e682901f37152935557f70,3,139,65,204,32,2011-05-10 22:30:02,2011-05-10 22:23:45
13e71279c964fc3f84e682901f37152935557f70...a6684a66aa6cf39f282341c4b735833a90d5d8e3,1,11,6,17,4,2011-05-10 23:10:28,2011-05-10 23:10:28
a6684a66aa6cf39f282341c4b735833a90d5d8e3...ae459f9ef5dac5228abb5f12fcb08be469694ed5,2,54,10,64,12,2011-05-10 23:15:58,2011-05-10 23:13:55
ae459f9ef5dac5228abb5f12fcb08be469694ed5...115a795e9993eca92a85a213180810baf55d780b,6,170,8,178,12,2011-05-10 23:15:58,2011-05-10 23:14:41
115a795e9993eca92a85a213180810baf55d780b...e0f23a5a1683210ba0ccbb78c9711ad23506b86d,1,1,1,2,1,2011-05-11 01:34:30,2011-05-11 01:34:30
c8918a0430b81732fef215c10135f5436a9a24b3...82cc11a2412f4af3b08b8362585d85a7d1203c64,1,1,1,2,1,2011-05-09 17:13:14,2011-05-09 17:13:14
67c5eabba3f70dae080a8e3db74b13646d8f6538...2e0fae51153a78e1979c8ed86b3a0fb68bd12c46,2,26,20,46,9,2012-01-18 22:26:09,2012-01-18 22:26:09
2e0fae51153a78e1979c8ed86b3a0fb68bd12c46...0362b1a6e81fcd2829036ce282a8e663bb7b0108,6,76,35,111,14,2012-01-22 21:34:30,2012-01-22 21:34:30
0362b1a6e81fcd2829036ce282a8e663bb7b0108...21e09e7e4e9750a23db1329cdb77633fce4b6f20,10,129,127,256,128,2012-01-24 16:37:05,2012-01-24 16:37:05
21e09e7e4e9750a23db1329cdb77633fce4b6f20...ae69650013ced36c7736df1233040082df9c4c84,1,31,28,59,21,2012-01-24 16:38:22,2012-01-24 16:38:22
ae69650013ced36c7736df1233040082df9c4c84...2286a73ed6d845b542b8cab3b418dda55f767a77,10,12,25,37,15,2012-01-24 16:46:29,2012-01-24 16:46:29
2286a73ed6d845b542b8cab3b418dda55f767a77...79073c40d24324f0edafbb6d7aa010f216be55b2,1,116,0,116,1,2012-01-24 23:01:57,2012-01-24 23:01:57
79073c40d24324f0edafbb6d7aa010f216be55b2...6266fabd27b40cf0527980dcf8cea34b3552571e,1,9,4,13,6,2012-01-24 23:03:03,2012-01-24 23:03:03
6266fabd27b40cf0527980dcf8cea34b3552571e...6088b43b64057ca4b37dfd7133189aa6e6711b35,2,16,1,17,4,2012-01-24 23:03:20,2012-01-24 23:03:20
6088b43b64057ca4b37dfd7133189aa6e6711b35...16beb8f9f7a9488f2a21b4e99f1a3b2105bb8221,17,154,151,305,151,2012-01-24 23:13:21,2012-01-24 23:13:21
14b42dd7450aaadd9635a55f6aec8968f1dec8cc...4dc80a579e2d8c9feeb7e38483c9c091efffd035,1,39,9,48,7,2012-01-03 22:56:26,2012-01-03 22:56:26
14b42dd7450aaadd9635a55f6aec8968f1dec8cc...c0a545aadc65b98f0116d3a5e4c2c630da6bea5c,3,1,10,11,6,2012-01-03 21:54:07,2012-01-03 21:54:07
e5fa3cba4a6abc77d98867b4bfa212ba60c28cbf...22bcccded34fde0b360c048e112ddd0114462876,1,2,2,4,2,2011-05-11 15:34:26,2011-05-11 15:34:26
22bcccded34fde0b360c048e112ddd0114462876...fb3fac3dffacddda2858443644e3bcb04f8dcada,6,10,17,27,11,2011-05-11 15:45:47,2011-05-11 15:45:47
e0f23a5a1683210ba0ccbb78c9711ad23506b86d...ebbc72f17c40e2ad17cd55dc3a167d2f839adb94,4,70,5,75,10,2011-05-11 14:28:28,2011-05-11 14:28:28
e0f23a5a1683210ba0ccbb78c9711ad23506b86d...088f11a6d620bdfa744cb58840925d7007e7b326,3,38,32,70,34,2011-05-11 02:15:18,2011-05-11 02:14:32
088f11a6d620bdfa744cb58840925d7007e7b326...d47de50498be988f3a8b139214a63e80d4d9fac3,2,9,3,12,4,2011-05-11 03:05:30,2011-05-11 03:05:30
d47de50498be988f3a8b139214a63e80d4d9fac3...d892174f432df42af74129c467366300f89e1c24,1,2,1,3,1,2011-05-11 06:46:26,2011-05-11 06:45:59
d892174f432df42af74129c467366300f89e1c24...abe72624760ae0eac64558150bc60935c892af07,1,2,2,4,2,2011-05-11 07:04:52,2011-05-11 07:04:11
abe72624760ae0eac64558150bc60935c892af07...7616b49d6d994debc19d839f3402515dbb5f7cea,1,1,1,2,1,2011-05-11 13:18:16,2011-05-11 13:18:16
7616b49d6d994debc19d839f3402515dbb5f7cea...cf2d5f41a0ff81e80230ac179a7b1d8c71b43e87,2,10,6,16,7,2011-05-11 14:09:14,2011-05-11 14:09:14
00210b785038129010fc54ba363d90d6a87f438f...d17c2e2f79ddfa79c5bcd01da597ae87b797d473,3,4,4,8,4,2012-01-24 23:23:10,2012-01-24 23:23:10
d17c2e2f79ddfa79c5bcd01da597ae87b797d473...1b493047762e9bc9450b298cdea22c4a3f4bd7b5,2,66,19,85,17,2012-01-24 23:49:57,2012-01-24 23:49:57
6eaece042c4a970d7b35922825e047433aad9dc8...d74b106e53aca72cd28331df7bb964f759855b7f,1,0,1,1,1,2012-01-03 23:01:45,2012-01-03 23:01:45
d74b106e53aca72cd28331df7bb964f759855b7f...9c9c3dd1f3c08ee562932d401498f9407a2acd57,1,12,8,20,3,2012-01-04 08:34:15,2012-01-04 08:34:15
9c9c3dd1f3c08ee562932d401498f9407a2acd57...8d2a8a6bd8a8bc6ac3102f907bf4cc5b2365eabd,1,5,0,5,1,2012-01-04 12:22:20,2012-01-04 12:22:20
8d2a8a6bd8a8bc6ac3102f907bf4cc5b2365eabd...e27891645a2871a65d632862bc13e44fd7e83e31,2,16,16,32,16,2012-01-04 13:43:41,2012-01-04 13:43:41
e27891645a2871a65d632862bc13e44fd7e83e31...b002202f5c9e8f321c3a3547a576714233312906,1,2,2,4,1,2012-01-04 15:46:39,2012-01-04 15:44:48
b002202f5c9e8f321c3a3547a576714233312906...53eb5520501e7c700c7188c8ee0c26a835a084bf,1,1,1,2,1,2012-01-04 15:46:40,2012-01-04 15:46:14
53eb5520501e7c700c7188c8ee0c26a835a084bf...671bad56b3e9c3dd9cd4b5f3e98d78032db769a1,1,1,1,2,2,2012-01-04 17:37:21,2012-01-04 17:37:21
671bad56b3e9c3dd9cd4b5f3e98d78032db769a1...6ba9a541de04c720d191cd54f8c505385520ca54,1,2,2,4,2,2012-01-04 18:28:57,2012-01-04 14:18:54
6ba9a541de04c720d191cd54f8c505385520ca54...5577afa6b7da62677dcacc983988144b41f7f308,1,29,20,49,19,2012-01-04 18:28:57,2012-01-04 18:28:05
5577afa6b7da62677dcacc983988144b41f7f308...37b331b75677016c9a8591c92befc369581a3b17,1,4,4,8,2,2012-01-04 19:22:18,2012-01-04 19:22:18
fb3fac3dffacddda2858443644e3bcb04f8dcada...bb1ccfa6f363b4b6ba754679ae112a71745ec291,6,20,20,40,20,2011-05-11 17:55:41,2011-05-11 17:55:41
fb3fac3dffacddda2858443644e3bcb04f8dcada...d6384470eb2f34244af63fa6d7ae11fbe59c5378,7,49,13,62,18,2011-05-11 17:30:12,2011-05-11 17:30:12
d6384470eb2f34244af63fa6d7ae11fbe59c5378...f78d25f6e241b4210f516e88fe5e99cef9fb57a0,9,61,22,83,27,2011-05-11 17:41:46,2011-05-09 15:37:23
f78d25f6e241b4210f516e88fe5e99cef9fb57a0...e11576cc8680adb4123deb759bd9b41ff1408691,1,8,2,10,2,2011-05-11 17:41:46,2011-05-11 16:52:04
e11576cc8680adb4123deb759bd9b41ff1408691...844f88f7cd5c34f95943d3a423409f30122c3330,2,76,64,140,11,2011-05-11 17:41:46,2011-05-11 17:39:11
198285abf9cdf7359c65ed99cf24fd4ce4682368...2e60d999928c7eb332c3344d6bdc1857b74bd5ee,3,62,65,127,4,2012-01-27 18:17:38,2012-01-27 18:17:38
2e60d999928c7eb332c3344d6bdc1857b74bd5ee...296c40ab908a6871d62d36a30759cb21fa06e730,1,17,0,17,2,2012-01-27 18:38:39,2012-01-27 18:38:39
296c40ab908a6871d62d36a30759cb21fa06e730...94115c51aef3390aa513413ddcdd2c92940a80fa,4,4,4,8,4,2012-01-27 18:40:27,2012-01-27 18:40:27
94115c51aef3390aa513413ddcdd2c92940a80fa...126d090a797498b7157919f1057224e1d0035398,4,21,14,35,7,2012-01-27 19:14:37,2012-01-27 19:14:37
126d090a797498b7157919f1057224e1d0035398...26eccbf5890128bffbc6f758ab89083e5cb58d96,6,11,11,22,10,2012-01-27 19:42:24,2012-01-27 19:42:24
37b331b75677016c9a8591c92befc369581a3b17...186721566a69192a91d75f424757b5edb2a6c257,4,31,14,45,10,2012-01-05 20:20:25,2012-01-05 20:20:25
37b331b75677016c9a8591c92befc369581a3b17...01587e687dc6003349712fe4f98f19f1e21bb4b5,1,1,1,2,1,2012-01-04 21:32:36,2012-01-04 21:32:36
01587e687dc6003349712fe4f98f19f1e21bb4b5...c93e6d520102f25e102c66649cd40c2207db4df4,1,1,1,2,1,2012-01-04 21:33:11,2012-01-04 21:33:11
c93e6d520102f25e102c66649cd40c2207db4df4...2306a5231c3632cd1198d14230058f0c1c2defe5,1,13,15,28,5,2012-01-04 22:34:55,2012-01-04 22:34:55
2306a5231c3632cd1198d14230058f0c1c2defe5...813420ded1be8ec4168e242522507f889614db31,1,71,5,76,8,2012-01-05 00:18:48,2012-01-05 00:18:48
813420ded1be8ec4168e242522507f889614db31...f720eb38b1372564d9fc01bde3b348d26feed04e,1,15,14,29,12,2012-01-05 00:28:35,2012-01-05 00:28:35
f720eb38b1372564d9fc01bde3b348d26feed04e...1bda0e1a394d5aa24cc60d9ae4a599716509ee00,1,1,0,1,1,2012-01-05 02:12:14,2012-01-05 02:12:14
1bda0e1a394d5aa24cc60d9ae4a599716509ee00...90a86ec1363e692f393d0421754196d621bbef44,1,37,6,43,25,2012-01-05 05:36:57,2012-01-05 05:36:57
90a86ec1363e692f393d0421754196d621bbef44...6704b84a71379b36e7b626564f22f04a57fe38bd,1,3,6,9,7,2012-01-05 05:44:54,2012-01-05 05:44:54
6704b84a71379b36e7b626564f22f04a57fe38bd...02853421e338a934f1a09582ac4d1f7e4906818b,6,40,10,50,17,2012-01-05 11:02:54,2012-01-05 11:02:54
02853421e338a934f1a09582ac4d1f7e4906818b...7e3bb61f7dfeca047fb23b7570941b2f26a3d988,1,9,0,9,1,2012-01-05 16:13:41,2012-01-05 16:08:52
7e3bb61f7dfeca047fb23b7570941b2f26a3d988...2767d9794505cd3fbdbec28a2610b3157ed9fd40,3,151,62,213,15,2012-01-05 16:13:42,2012-01-05 16:13:33
2767d9794505cd3fbdbec28a2610b3157ed9fd40...4af30fa0ac39f2654f9711a93ee7958e994f0b4e,1,1,1,2,1,2012-01-05 18:15:17,2012-01-05 18:15:17
4af30fa0ac39f2654f9711a93ee7958e994f0b4e...7341d9441ff64a1081a969429799c5ab0e5c15eb,1,28,18,46,24,2012-01-05 18:58:44,2012-01-02 16:35:11
7341d9441ff64a1081a969429799c5ab0e5c15eb...f10bce1e5ee2d168d9401eb4542ef1eb8d5879a8,1,1,1,2,1,2012-01-05 18:58:44,2012-01-05 18:55:50
f10bce1e5ee2d168d9401eb4542ef1eb8d5879a8...fcb1b909fbabe9dfd2eeefb64b28ae3658c61a92,4,19,7,26,8,2012-01-05 18:58:44,2012-01-05 18:57:00
fcb1b909fbabe9dfd2eeefb64b28ae3658c61a92...5ebd6956a7a3aea1d7b5a51a7bd1c91795989cbe,1,3,26,29,2,2012-01-05 18:58:44,2012-01-05 18:58:13
5ebd6956a7a3aea1d7b5a51a7bd1c91795989cbe...45ab7c3a4d9cbe199539464e966ad4193963f6fc,1,25,29,54,4,2012-01-05 18:58:44,2012-01-05 18:58:32
45ab7c3a4d9cbe199539464e966ad4193963f6fc...96da0440c8bed70bf1ec9a5a992552ff1a0fc655,1,1,1,2,1,2012-01-05 20:00:16,2012-01-05 19:59:38
1e83899c0637911d8ed5531fd483eef97f3ef8eb...1c665c45470ea93c7b98d4c66b2dbb9b270f459a,2,5,2,7,2,2011-05-13 21:29:16,2011-05-13 21:29:16
1e83899c0637911d8ed5531fd483eef97f3ef8eb...bc1d98cd0535ba48ef424aa4d53f9a2e234fa9b0,1,33,17,50,5,2011-05-11 19:19:06,2011-05-11 19:05:00
bc1d98cd0535ba48ef424aa4d53f9a2e234fa9b0...2766242090134b41ee7833c0b017702a1d89849d,1,1,1,2,1,2011-05-12 12:07:40,2011-05-12 12:07:40
2766242090134b41ee7833c0b017702a1d89849d...3f505215032aee43bcb10e18e9b82ce835eae0ce,1,1,1,2,1,2011-05-12 12:15:40,2011-05-12 12:15:40
3f505215032aee43bcb10e18e9b82ce835eae0ce...7415aab9b6be97d330c9abd16acc15dbc81c0c49,1,5,5,10,1,2011-05-12 12:23:12,2011-05-12 12:23:12
7415aab9b6be97d330c9abd16acc15dbc81c0c49...d24f128075494ccb9c13ac85e3b33bdec33173cb,2,3,3,6,3,2011-05-12 14:30:05,2011-05-11 16:00:40
d24f128075494ccb9c13ac85e3b33bdec33173cb...fcbcbdac954522f7af2cd804bf06ef1701ad9b42,2,30,14,44,9,2011-05-12 14:30:05,2011-05-11 18:30:56
fcbcbdac954522f7af2cd804bf06ef1701ad9b42...9850500a4e3090ff4d54588296e2e4fda11f0910,2,12,4,16,5,2011-05-12 14:30:05,2011-05-11 21:34:08
9850500a4e3090ff4d54588296e2e4fda11f0910...783dbc305921095179e3dccf3a6cd7b8996fe7c0,1,4,0,4,2,2011-05-12 16:03:53,2011-05-12 16:03:53
783dbc305921095179e3dccf3a6cd7b8996fe7c0...a6fe375df5c298a8f315a3473192c6607317b4cc,1,13,1,14,2,2011-05-12 17:18:16,2011-05-12 17:18:16
a6fe375df5c298a8f315a3473192c6607317b4cc...acb028bdcd34d2908d7f354dd98932213abb6ad1,2,5,3,8,3,2011-05-12 18:16:05,2011-05-11 04:12:03
acb028bdcd34d2908d7f354dd98932213abb6ad1...54ca9c202c9ce9c7f614bf8fc291cb498e363fa8,2,5,0,5,3,2011-05-12 18:16:05,2011-05-11 19:13:56
54ca9c202c9ce9c7f614bf8fc291cb498e363fa8...860369c353452e0b135d7944a84674862136d59a,1,9,5,14,4,2011-05-12 18:16:05,2011-05-11 22:02:02
860369c353452e0b135d7944a84674862136d59a...dad6b228f76b620ccffbb6994226348e263a5281,1,4,4,8,2,2011-05-12 18:16:06,2011-05-11 22:17:36
dad6b228f76b620ccffbb6994226348e263a5281...fddb4b44db84495c839bb5c0358191f705926308,1,10,1,11,2,2011-05-12 18:16:06,2011-05-11 22:52:39
fddb4b44db84495c839bb5c0358191f705926308...b7509f5433974f36837a07bc8f8f8b3e5893071b,1,7,6,13,3,2011-05-12 18:16:06,2011-05-12 18:15:19
b7509f5433974f36837a07bc8f8f8b3e5893071b...a6f79f97e282af263e8ba6e45b41027df35f85f9,1,3,2,5,2,2011-05-12 18:49:20,2011-05-12 18:28:55
a6f79f97e282af263e8ba6e45b41027df35f85f9...e0e8900a125dc0e7e45c40f1035c999aa9bc3f69,1,2,5,7,1,2011-05-12 18:49:20,2011-05-12 18:44:48
e0e8900a125dc0e7e45c40f1035c999aa9bc3f69...9c4a6bebd25b6e916b89fffb70b3be41645d302b,1,5,1,6,1,2011-05-12 19:21:37,2011-05-12 19:14:19
9c4a6bebd25b6e916b89fffb70b3be41645d302b...0017f70d1135e38fad9301cdf2879bdff9f85a96,1,0,1,1,1,2011-05-12 19:25:30,2011-05-12 19:25:30
0017f70d1135e38fad9301cdf2879bdff9f85a96...3c14eb6ee74441fd5a29a1b7b41db0d7f3482607,1,1,1,2,1,2011-05-12 19:26:39,2011-05-12 19:26:39
3c14eb6ee74441fd5a29a1b7b41db0d7f3482607...5d22fbae0205255d23818ce9be9a523a8d76c281,1,4,0,4,1,2011-05-12 19:44:33,2011-05-12 19:44:00
5d22fbae0205255d23818ce9be9a523a8d76c281...225227e8e217efc9757d89fd8d54f395926946d4,2,7,1,8,4,2011-05-12 20:57:28,2011-05-12 20:57:28
225227e8e217efc9757d89fd8d54f395926946d4...b0aa8ca91e274e186ac89923842e35a44593b7f1,1,10,8,18,9,2011-05-12 21:23:59,2011-05-12 21:23:38
b0aa8ca91e274e186ac89923842e35a44593b7f1...b379b6255770333adb6f35a9beda8cf91b0fde1b,1,1,1,2,1,2011-05-12 21:26:22,2011-05-12 21:22:43
b379b6255770333adb6f35a9beda8cf91b0fde1b...e99be1dfc9885c68d82bb86730a027181f54da62,1,1497,0,1497,1,2011-05-12 21:26:22,2011-05-12 21:23:11
e99be1dfc9885c68d82bb86730a027181f54da62...9077e45482367076c7cb7693d39d10fae7109e5c,1,11,0,11,1,2011-05-12 21:27:51,2011-05-12 21:03:53
9077e45482367076c7cb7693d39d10fae7109e5c...5d5d572a64d84a636ff6746ec7f10a7bd9143ef3,2,869,871,1740,158,2011-05-12 22:01:53,2011-05-12 21:39:00
5d5d572a64d84a636ff6746ec7f10a7bd9143ef3...811ab45d1eb1b4cf89d83528f593da3c77c89ea7,1,4,1,5,1,2011-05-12 22:28:24,2011-05-12 22:27:28
811ab45d1eb1b4cf89d83528f593da3c77c89ea7...07a3aeee84fbdc3574e5701ef06ae1e9dd59e252,2,2,2,4,2,2011-05-13 01:45:48,2011-05-13 01:45:48
26eccbf5890128bffbc6f758ab89083e5cb58d96...7942118d328ea0e49d6abb8a77c0a34f1338b5aa,1,3,4,7,3,2012-02-07 16:06:27,2012-02-07 16:06:27
26eccbf5890128bffbc6f758ab89083e5cb58d96...43469894258659b01f2f879546798ed6af8700a6,3,108,23,131,29,2012-02-04 14:11:09,2012-02-04 14:11:09
43469894258659b01f2f879546798ed6af8700a6...8118a88acc00905387f9e923a070b9425169df39,3,11,7,18,4,2012-02-04 14:27:12,2012-02-04 14:27:12
8118a88acc00905387f9e923a070b9425169df39...68495acfff38f7e3b74ac00f978b0deb9f24b91b,1,26,33,59,13,2012-02-04 15:53:25,2012-02-04 15:53:25
68495acfff38f7e3b74ac00f978b0deb9f24b91b...46bc8e8b7d399084497d4f1a7d2daab4a1d09d5c,3,32,20,52,15,2012-02-04 15:57:15,2012-02-04 15:57:15
46bc8e8b7d399084497d4f1a7d2daab4a1d09d5c...7d6b12da06fcb2745da1305b67d39a94b7dcaa20,1,32,38,70,20,2012-02-04 15:57:55,2012-02-04 15:57:55
7d6b12da06fcb2745da1305b67d39a94b7dcaa20...b7eb2f4ec960c7136e87250c5ba1a24bfcbce4be,4,62,6,68,12,2012-02-04 18:04:38,2012-02-04 18:04:38
b7eb2f4ec960c7136e87250c5ba1a24bfcbce4be...1b1d0bc2c1713cfe54f18a1466b57405e8eb3f56,2,51,111,162,19,2012-02-04 22:56:05,2012-02-04 22:56:05
7e1f5e2ae91c76095673d57a55ce997560082eb7...2620f51900f9bde596e8f79787d1fb73a8fd057b,1,8,2,10,1,2012-01-05 21:41:25,2012-01-05 21:41:25
2620f51900f9bde596e8f79787d1fb73a8fd057b...717c7a2d79272f03f73f3214fbb61b59e22836ee,1,31,4,35,5,2012-01-05 22:48:45,2012-01-05 22:48:45
717c7a2d79272f03f73f3214fbb61b59e22836ee...432a8396eef6888c740c5a6ad8be3eed3fba34b5,40,166,112,278,124,2012-01-05 22:58:21,2012-01-05 22:07:47
432a8396eef6888c740c5a6ad8be3eed3fba34b5...15a2cc40f5bbbea31722908eb88a4f9c671a5174,2,9,1,10,2,2012-01-05 22:58:21,2012-01-05 22:26:37
15a2cc40f5bbbea31722908eb88a4f9c671a5174...89b06c2a1c3fe2b97f4ee5cd91a69e75d90a4934,2,74,55,129,8,2012-01-05 22:58:21,2012-01-05 22:50:38
89b06c2a1c3fe2b97f4ee5cd91a69e75d90a4934...cf1214ab7f2d63daccd16763d71eb9cca66c3e7a,14,15,2,17,15,2012-01-05 22:58:21,2012-01-05 22:50:50
cf1214ab7f2d63daccd16763d71eb9cca66c3e7a...2b104cdedb06f2b6f764310ee6554f90a70bd0d6,2,2,0,2,2,2012-01-06 02:46:45,2012-01-06 02:46:45
2b104cdedb06f2b6f764310ee6554f90a70bd0d6...47e5e379a4cf364e3f5821a02840560066ac4a9d,1,6,6,12,6,2012-01-06 11:34:30,2012-01-06 11:34:30
47e5e379a4cf364e3f5821a02840560066ac4a9d...863991955fabb726ad8b31834439d510b0a6ae5b,3,7,8,15,5,2012-01-06 16:15:55,2012-01-06 04:03:55
863991955fabb726ad8b31834439d510b0a6ae5b...7f2c8005e8ad11833ab882b415e4727ea527e7c6,2,0,168,168,2,2012-01-06 16:15:55,2012-01-06 15:57:13
7f2c8005e8ad11833ab882b415e4727ea527e7c6...4f6a5bf5909994eb75ce1d6f28587b3b2a448310,3,21,8,29,6,2012-01-06 16:15:55,2012-01-06 16:15:38
4f6a5bf5909994eb75ce1d6f28587b3b2a448310...875440f15baec0425fda11d28bf8d08bf22cc81b,1,5,3,8,3,2012-01-06 16:18:55,2012-01-06 16:18:08
875440f15baec0425fda11d28bf8d08bf22cc81b...0c176d019c07672e4d102d232a0fc692e3c0038a,1,0,1,1,1,2012-01-06 16:33:23,2012-01-06 16:32:42
0c176d019c07672e4d102d232a0fc692e3c0038a...3c2305bdacbf6b9b908d131a08b35f7be188929d,1,1,1,2,1,2012-01-06 17:09:15,2012-01-06 17:02:17
3c2305bdacbf6b9b908d131a08b35f7be188929d...27ec6f49a18c2ac8b6c796cc2e0cf6bea0375e08,1,22,0,22,1,2012-01-06 17:11:45,2012-01-06 17:11:32
27ec6f49a18c2ac8b6c796cc2e0cf6bea0375e08...413a07d12c4a318c7be92af9625b595a95f92942,1,1,1,2,1,2012-01-06 20:07:48,2012-01-06 13:30:36
413a07d12c4a318c7be92af9625b595a95f92942...ed6e62e4ed270da04b64d06c560b38560b78ecfc,1,1,1,2,1,2012-01-06 20:07:48,2012-01-06 20:07:26
ed6e62e4ed270da04b64d06c560b38560b78ecfc...d15019534826b5b1698a475afac0509714570a29,2,13,2,15,4,2012-01-06 20:25:57,2012-01-06 20:25:19
d15019534826b5b1698a475afac0509714570a29...0e6ca07040fd2793f5921063f380df37b1e3168f,1,7,1,8,2,2012-01-06 22:29:28,2012-01-06 21:44:30
0e6ca07040fd2793f5921063f380df37b1e3168f...dce1de62f11a47462c9b1fa56338d45633d32208,4,13,9,22,9,2012-01-06 22:29:28,2012-01-06 22:22:15
dce1de62f11a47462c9b1fa56338d45633d32208...e39d2a7372460e3cdbf7e8e4601531bc73ccb712,1,17,7,24,5,2012-01-06 22:29:28,2012-01-06 22:24:43
e39d2a7372460e3cdbf7e8e4601531bc73ccb712...a50081ca34f30e9d493b2bb5c8f1fc52a0c71fb7,1,5,7,12,2,2012-01-06 22:29:28,2012-01-06 22:29:05
a50081ca34f30e9d493b2bb5c8f1fc52a0c71fb7...59c3247ac1da22024edfcb784e9224bf03ac0e5c,1,2,1,3,1,2012-01-06 23:54:48,2012-01-04 00:09:40
59c3247ac1da22024edfcb784e9224bf03ac0e5c...27e8af5b4f2eb88b552c46f846829f6a6c9f3545,12,439,162,601,77,2012-01-06 23:54:50,2012-01-06 23:54:21
27e8af5b4f2eb88b552c46f846829f6a6c9f3545...ed36419be780a8ce53f3636fc9708eae61a47707,1,6,0,6,2,2012-01-07 13:39:48,2012-01-07 13:39:48
ed36419be780a8ce53f3636fc9708eae61a47707...f62c1c1c59140d63ea08539465404d7e2d655a20,1,1,0,1,1,2012-01-07 13:40:01,2012-01-07 13:40:01
f62c1c1c59140d63ea08539465404d7e2d655a20...f4810a21d7b9605f5ae8b8b389670d8c37608331,1,10,12,22,3,2012-01-07 13:56:11,2012-01-07 13:56:11
f4810a21d7b9605f5ae8b8b389670d8c37608331...b327df37084ef9b7c58c6d22796c0c5644fc9489,2,0,987,987,2,2012-01-07 14:19:55,2012-01-07 14:19:55
b327df37084ef9b7c58c6d22796c0c5644fc9489...48d82e2444d560ba390acddf09210dc125cc17b4,1,1,1,2,1,2012-01-07 15:00:21,2012-01-07 15:00:21
48d82e2444d560ba390acddf09210dc125cc17b4...4294f8eb2c6c1c6747de5b93667b5dc8ec654209,2,7,0,7,4,2012-01-07 15:34:03,2012-01-07 15:34:03
4294f8eb2c6c1c6747de5b93667b5dc8ec654209...8427b4eb0180862bd4530fdd46b76ef933ae4087,45,4353,4537,8890,955,2012-01-10 22:52:59,2012-01-10 22:28:56
8427b4eb0180862bd4530fdd46b76ef933ae4087...465481d7c1bfc3caa43c16152df69b3c8aaee332,1,105,0,105,1,2012-01-11 23:00:38,2012-01-11 23:00:38
465481d7c1bfc3caa43c16152df69b3c8aaee332...bdf12ac67795ef52ff952f40da69df09bcbd7ccf,1,5,13,18,8,2012-01-12 00:28:43,2012-01-08 03:24:48
bdf12ac67795ef52ff952f40da69df09bcbd7ccf...903f414025429bfb3881fdc729162b8c1e868729,1,1,2,3,2,2012-01-12 00:28:43,2012-01-12 00:28:16
903f414025429bfb3881fdc729162b8c1e868729...179b61480fa4d8dd42e1fe9eacb7739b6543f331,1,7,3,10,4,2012-01-12 21:20:48,2012-01-12 21:20:48
179b61480fa4d8dd42e1fe9eacb7739b6543f331...ed9b1f3f4c73c5873bcee6c22e1c3c6722a082f2,2,3,3,6,4,2012-01-12 23:05:52,2012-01-12 23:05:13
ed9b1f3f4c73c5873bcee6c22e1c3c6722a082f2...528bd33d60a52c4e9364b560796c5d10ade18f58,1,9,17,26,10,2012-01-13 14:44:51,2012-01-13 14:41:56
528bd33d60a52c4e9364b560796c5d10ade18f58...5df39dded95a978982ba9e2dab8c005cb1f88e7a,2,64,54,118,9,2012-01-13 19:24:21,2012-01-13 19:23:37
5df39dded95a978982ba9e2dab8c005cb1f88e7a...12494a1316d15cc1ead95650652c4f6c87e5c638,1,13,1,14,2,2012-01-14 01:20:52,2012-01-14 01:20:52
12494a1316d15cc1ead95650652c4f6c87e5c638...fa0705dc9c10c7a702ecb52764b14f03cfac8dcb,1,1,1,2,1,2012-01-14 19:25:26,2012-01-14 19:25:26
fa0705dc9c10c7a702ecb52764b14f03cfac8dcb...e00dfd31eeb89c500018050efbbd6a7c65c8200c,1,1,1,2,1,2012-01-14 19:59:46,2012-01-14 19:59:46
e00dfd31eeb89c500018050efbbd6a7c65c8200c...2941743aa0ec1cc1f35ee73fbe69b32ee8ffbdc6,1,3,5,8,1,2012-01-14 20:49:55,2012-01-14 20:49:55
2941743aa0ec1cc1f35ee73fbe69b32ee8ffbdc6...e45f8d997c1593d1e9e8bf32f22b46ebc980a1e2,11,15,17,32,15,2012-01-14 23:33:50,2012-01-14 23:33:50
cccf0cace9afc002ba517fa45c1a82267d11b227...7f01b84b1b8554ceb3ade82c471b08dcf76177eb,1,41,0,41,3,2011-05-13 22:38:40,2011-05-13 22:38:40
cccf0cace9afc002ba517fa45c1a82267d11b227...0f391def9476c65bf6e901e5e6838ce7cf39e3b1,2,53,8,61,17,2011-05-13 22:00:11,2011-05-13 21:59:10
0f391def9476c65bf6e901e5e6838ce7cf39e3b1...17381fcf938ba903eac1b2e1ced94393451b54d9,1,1,1,2,1,2011-05-13 22:33:48,2011-05-13 22:33:36
07a3aeee84fbdc3574e5701ef06ae1e9dd59e252...28057edd5571966aa458149692f7b72846751d8b,1,25,32,57,12,2011-05-13 03:49:13,2011-05-13 03:49:13
07a3aeee84fbdc3574e5701ef06ae1e9dd59e252...3a8448bac68da2843e11fbd3c5319c01d676aa28,2,8,5,13,7,2011-05-13 02:38:10,2011-05-13 02:37:34
79b694a785a84b2394fa4699cc47e34ff888f6e2...27c85880962d92b187d5f71561b4e3bf7f0c62fd,4,92,66,158,39,2012-02-07 17:42:50,2012-02-07 17:42:50
27c85880962d92b187d5f71561b4e3bf7f0c62fd...cbf799d650d44bfa93c3917b9168d1c312f35c16,1,2,4,6,3,2012-02-07 17:48:34,2012-02-07 17:48:34
cbf799d650d44bfa93c3917b9168d1c312f35c16...79a6d37c13ca2126bc7040d47b7ded36e40b1003,1,2,1,3,2,2012-02-07 18:22:32,2012-02-07 18:22:32
79a6d37c13ca2126bc7040d47b7ded36e40b1003...8fe187da766ac272dea4ecabc23d75baf3400667,9,42,216,258,25,2012-02-08 20:04:31,2012-02-08 20:04:31
8fe187da766ac272dea4ecabc23d75baf3400667...8320fb0e97aa1350ee5671f0b49cab19047e818e,5,17,8,25,13,2012-02-08 20:36:19,2012-02-08 20:36:19
8320fb0e97aa1350ee5671f0b49cab19047e818e...dcd80f633d7ee1a6c4dfc92c3223e4e76dae241a,1,71,51,122,38,2012-02-08 20:47:02,2012-02-08 20:47:02
dcd80f633d7ee1a6c4dfc92c3223e4e76dae241a...054a2569bcbc308aad956b0f08dc36b31567eef4,2,11,12,23,5,2012-02-08 21:55:37,2012-02-08 21:55:37
054a2569bcbc308aad956b0f08dc36b31567eef4...e77a61e9e602b21a412f57f88c55979bbeb61e60,1,38,16,54,9,2012-02-08 22:15:23,2012-02-08 22:15:23
e77a61e9e602b21a412f57f88c55979bbeb61e60...3569d7537ad81a7d4372cc19399b6ae8687330c4,2,19,6,25,7,2012-02-09 00:19:14,2012-02-09 00:19:14
3569d7537ad81a7d4372cc19399b6ae8687330c4...e9a1d77b58a03cb7b8fa75d51f6f2a2c7bae2eb2,1,6,2,8,3,2012-02-09 05:00:25,2012-02-09 05:00:25
e9a1d77b58a03cb7b8fa75d51f6f2a2c7bae2eb2...7e006571bacd7d2c5a3794daadaeeb8d54074a76,3,26,8,34,9,2012-02-09 05:04:40,2012-02-09 05:04:40
7e006571bacd7d2c5a3794daadaeeb8d54074a76...40a27cd25f708809d91f4b8f5c8aa0db31f22c06,3,121,37,158,17,2012-02-09 23:58:14,2012-02-09 23:58:14
40a27cd25f708809d91f4b8f5c8aa0db31f22c06...a0fd6c7275f27695a3cf1be760da2192cbb0fe4f,4,36,48,84,22,2012-02-10 20:01:54,2012-02-10 20:01:54
a0fd6c7275f27695a3cf1be760da2192cbb0fe4f...c308b0eb0b021692362d8a969ec16f3a5d3765a5,2,37,12,49,10,2012-02-10 21:29:23,2012-02-10 21:29:23
c308b0eb0b021692362d8a969ec16f3a5d3765a5...b6d186738f6d11b5b7133e6c5e58bf188ee16398,2,107,11,118,7,2012-02-10 22:06:47,2012-02-10 22:06:47
1cc919df113ab4004195580e4177f26ec2363c77...9270aedd4da6486384083ebdb0443c8dd37ea457,1,2,2,4,2,2012-02-05 00:37:59,2012-02-05 00:37:59
9270aedd4da6486384083ebdb0443c8dd37ea457...d2f3cfe2c8bfce5a7af35e5f9d42667b7c3e5e4d,1,10,7,17,5,2012-02-05 03:03:42,2012-02-05 03:03:42
d2f3cfe2c8bfce5a7af35e5f9d42667b7c3e5e4d...7f5f62f32aed785a77d59b861780be63587a14b9,3,32,11,43,8,2012-02-05 03:20:09,2012-02-05 03:20:09
7f5f62f32aed785a77d59b861780be63587a14b9...aa0b7dd28d2f785f78604f52c036c9c86a2928e2,1,26,0,26,2,2012-02-06 21:52:48,2012-02-06 21:52:48
aa0b7dd28d2f785f78604f52c036c9c86a2928e2...aa025a90577be6548f78c045c26d3991a8953c99,5,69,54,123,31,2012-02-06 21:53:08,2012-02-06 21:53:08
e45f8d997c1593d1e9e8bf32f22b46ebc980a1e2...937e0d8e1afbc75ef475ec99196f1866f1c56679,1,1,2,3,2,2012-01-16 20:00:06,2012-01-16 19:37:42
e45f8d997c1593d1e9e8bf32f22b46ebc980a1e2...9dc1b751c288d5bb6430f7e0925158ee89e64a38,1,1,1,2,1,2012-01-15 22:14:59,2012-01-15 16:14:43
92a23fa6b8d41db5c877d8f951596d3836402b15...d43037f1982f94a406f2fdcfaaf034fd6ca865b0,2,25,22,47,18,2011-05-13 23:25:29,2011-05-13 22:43:50
d43037f1982f94a406f2fdcfaaf034fd6ca865b0...51011c187b5c5b5fe50d7b6f09b7c12dae2c3de7,2,30,7,37,6,2011-05-13 23:25:29,2011-05-13 23:24:44
51011c187b5c5b5fe50d7b6f09b7c12dae2c3de7...17e2688d76428cacad37f89252882bbf046f0bda,1,22,22,44,3,2011-05-13 23:32:22,2011-05-13 23:32:22
17e2688d76428cacad37f89252882bbf046f0bda...86b739cdcc79369baaf5dfc5fc242cfb3539652f,6,22,40,62,16,2011-05-14 15:43:25,2011-05-14 15:43:14
141e8c80f4147059bded0a65dcc83fc9c7daa479...52b09fbdd9e49999943a37548b57718154ef21dd,7,18,12,30,9,2011-05-14 18:05:59,2011-05-14 18:05:59
141e8c80f4147059bded0a65dcc83fc9c7daa479...8f2db1d98cda01992c628ff54253b6f3c5ce3307,3,4,3,7,4,2011-05-13 14:55:35,2011-05-13 14:55:21
8f2db1d98cda01992c628ff54253b6f3c5ce3307...4e1187f46b22e5b6c16d1179dc0bcbbcd3efda4a,2,1,5,6,2,2011-05-13 18:46:52,2011-05-13 18:46:52
4e1187f46b22e5b6c16d1179dc0bcbbcd3efda4a...08b057a79dd8021fb675576423b5081238a309b8,3,48,7,55,9,2011-05-13 19:27:25,2011-05-13 19:27:25
08b057a79dd8021fb675576423b5081238a309b8...c57cf8d1aec761cf85712d15da7e3b5659022b06,2,15,1,16,6,2011-05-13 21:02:07,2011-05-13 21:02:07
e22981326a6830a39b154fa28e2e54161583a2e1...dcb73b4e47bae412d869b0c666138877ef7fa2d2,4,23,19,42,18,2012-02-11 04:25:51,2012-02-11 04:25:51
dcb73b4e47bae412d869b0c666138877ef7fa2d2...8cd2740ddffd6ce7f5916bfb3a1f269e1513eda4,1,3,1,4,1,2012-02-13 01:42:27,2012-02-13 01:42:27
8cd2740ddffd6ce7f5916bfb3a1f269e1513eda4...06b48234043f2c006534a9fba134185d213967a9,4,37,2,39,5,2012-02-13 01:45:19,2012-02-13 01:45:19
06b48234043f2c006534a9fba134185d213967a9...0f633180a55e01b947c71f6089b9b37616b30b02,8,60,18,78,19,2012-02-13 15:09:00,2012-02-13 15:09:00
0f633180a55e01b947c71f6089b9b37616b30b02...0d27f0162445dd166fe34f4e1e107cfec9150275,7,24,25,49,23,2012-02-13 15:36:35,2012-02-13 15:36:35
0d27f0162445dd166fe34f4e1e107cfec9150275...fdef9fbf7050bb37a67210af0d5e524b30a9be46,6,14,7,21,9,2012-02-13 19:37:35,2012-02-13 19:37:35
fdef9fbf7050bb37a67210af0d5e524b30a9be46...455e15cab040d9a3e5775c0d69817c506b0ed39c,2,10,4,14,10,2012-02-14 02:28:57,2012-02-14 02:28:57
455e15cab040d9a3e5775c0d69817c506b0ed39c...07ea4f8280b9a04eecfd5887b6ea7fd0743fb1e2,1,3,3,6,3,2012-02-14 02:29:22,2012-02-14 02:29:22
07ea4f8280b9a04eecfd5887b6ea7fd0743fb1e2...620dcd2493af2ab0ee2dffc40636f62b52fe5281,4,29,100,129,20,2012-02-14 02:30:36,2012-02-14 02:30:36
620dcd2493af2ab0ee2dffc40636f62b52fe5281...338ef8c94b9677242a52e8855eecbfc449c9da76,1,4,2,6,1,2012-02-14 02:40:21,2012-02-14 02:40:21
338ef8c94b9677242a52e8855eecbfc449c9da76...45de664cb92d41165c5fffa36da956f6c6c93472,2,5,4,9,4,2012-02-14 02:47:30,2012-02-14 02:47:30
45de664cb92d41165c5fffa36da956f6c6c93472...78c4640fbab382ad06ca44ac128475f94abd959b,2,8,1,9,5,2012-02-14 02:47:48,2012-02-14 02:47:48
78c4640fbab382ad06ca44ac128475f94abd959b...cb30326463711edf438d1bdfc6d063e18d81fe86,1,4,4,8,4,2012-02-14 02:49:53,2012-02-14 02:49:53
cb30326463711edf438d1bdfc6d063e18d81fe86...1086922c94158f160ebaf232dc1c337777bbf0a7,1,1,1,2,1,2012-02-14 02:52:27,2012-02-14 02:52:27
1086922c94158f160ebaf232dc1c337777bbf0a7...43812da4d30efbe9482fa054e47f1139a0703699,1,7,19,26,9,2012-02-14 15:41:03,2012-02-14 15:41:03
43812da4d30efbe9482fa054e47f1139a0703699...944b86d685c09466ba55c1f9883f8bb22f367f79,2,2,1,3,2,2012-02-14 15:42:10,2012-02-14 15:42:10
944b86d685c09466ba55c1f9883f8bb22f367f79...70639b2d08bb6d0a7cd657d844d72637736e16bd,2,6,1,7,2,2012-02-14 16:17:58,2012-02-14 16:17:58
70639b2d08bb6d0a7cd657d844d72637736e16bd...379aeac8da1eaede8836cf9703e0d7fce78432f8,1,2,1,3,1,2012-02-14 16:18:30,2012-02-14 16:18:30
379aeac8da1eaede8836cf9703e0d7fce78432f8...def6c7b8f340e3ce53c9765e0c01325e243b1b56,1,0,1,1,1,2012-02-14 16:18:50,2012-02-14 16:18:50
def6c7b8f340e3ce53c9765e0c01325e243b1b56...223cf9a69668da7eb7e9c2fd301685ef1bb8e1f3,1,1,1,2,1,2012-02-14 16:19:11,2012-02-14 16:19:11
223cf9a69668da7eb7e9c2fd301685ef1bb8e1f3...989cf7dfb113eed5730e7136e1da001e336758aa,1,0,1,1,1,2012-02-14 19:11:02,2012-02-14 19:11:02
989cf7dfb113eed5730e7136e1da001e336758aa...f83b918b363552188e76a525780014f55673dd91,2,38,47,85,16,2012-02-14 19:11:47,2012-02-14 19:11:47
f83b918b363552188e76a525780014f55673dd91...311bd05fe4a0594659b8340e360479e5c633f994,1,6,3,9,5,2012-02-14 20:43:47,2012-02-14 20:43:47
311bd05fe4a0594659b8340e360479e5c633f994...34e831d160832d6439f26488b80c75ce79e5ce89,6,7,7,14,7,2012-02-14 20:45:17,2012-02-14 20:45:17
34e831d160832d6439f26488b80c75ce79e5ce89...43b611eb2c7eebdf853ae03c2a760286534fc510,2,20,13,33,13,2012-02-14 20:54:42,2012-02-14 20:54:42
43b611eb2c7eebdf853ae03c2a760286534fc510...d6f806aad7fc6825da87a7518653590e07d007d5,1,24,6,30,5,2012-02-14 23:18:38,2012-02-14 23:18:38
d6f806aad7fc6825da87a7518653590e07d007d5...800c13a673e1215161ff0f3a1b21b9098923eb2c,1,1,1,2,1,2012-02-15 02:50:23,2012-02-15 02:50:23
800c13a673e1215161ff0f3a1b21b9098923eb2c...64b9343254723856a33ad8e8e1f99b65af632764,1,6,0,6,1,2012-02-15 02:50:54,2012-02-15 02:50:54
64b9343254723856a33ad8e8e1f99b65af632764...addf0263d3ceeae21afc16ae6692ebd3e2e6dd0f,3,77,55,132,24,2012-02-15 17:31:56,2012-02-15 17:31:56
addf0263d3ceeae21afc16ae6692ebd3e2e6dd0f...0d1f6fefcafca8651181c4a0a05c8926b84b392a,2,28,13,41,13,2012-02-16 13:08:46,2012-02-16 13:08:46
0d1f6fefcafca8651181c4a0a05c8926b84b392a...2e2b0d8223417bb275e0f09822e72dfbf2caba4d,1,8,0,8,1,2012-02-16 17:35:32,2012-02-16 17:35:32
1842bddd2ccf74f6cc520dcb0519315d34d6b6d5...c5068593a701beff36ac8f972bf9cedebf2f6c34,2,16,6,22,4,2012-02-07 01:54:26,2012-02-07 01:54:26
c5068593a701beff36ac8f972bf9cedebf2f6c34...824d6e2eb13e78455b86ebd7c8541ea9a292f82c,1,0,1,1,1,2012-02-07 16:03:05,2012-02-07 16:03:05
1392e88c13e8ba01c2db589188110573bbb968bf...f08b9980df7667642af651a02a3bffd748b82072,4,35,5,40,7,2012-01-16 20:35:50,2012-01-14 05:24:40
f08b9980df7667642af651a02a3bffd748b82072...870fd44d145621ed5d6c05bd0311c2b277a9ee37,4,14,3,17,6,2012-01-16 20:35:51,2012-01-16 20:34:31
870fd44d145621ed5d6c05bd0311c2b277a9ee37...4992d8a270d44301c74fb2facbf1468406a77fa4,1,1,1,2,1,2012-01-16 20:35:51,2012-01-16 20:35:39
4992d8a270d44301c74fb2facbf1468406a77fa4...e75d664e24eb30aa48033a8a8afa4b387d02a331,1,1,1,2,1,2012-01-16 20:42:07,2012-01-16 20:42:07
53eb936ebb11d8ebf0353a414857940956452ccb...f3cfb889da2bb934ae12c87757569df87b392d61,7,51,29,80,16,2011-05-15 00:16:24,2011-05-15 00:16:24
f3cfb889da2bb934ae12c87757569df87b392d61...e7b06caec208f184e9a30f8d852c2e3c54c6f7b6,3,100,33,133,8,2011-05-15 02:30:18,2011-05-15 02:30:18
e7b06caec208f184e9a30f8d852c2e3c54c6f7b6...d5d8854effb3daf778157fab4b44b10198d3fba8,1,7,0,7,1,2011-05-15 15:10:38,2011-05-15 15:10:38
d5d8854effb3daf778157fab4b44b10198d3fba8...6d08c2b0e7954cfe6ab92bdea5281011ccc8f4c5,1,6,6,12,5,2011-05-15 15:10:51,2011-05-15 15:10:51
6d08c2b0e7954cfe6ab92bdea5281011ccc8f4c5...cdc246342b234b87d005930d72ee20ddd9e9b7aa,1,2,2,4,2,2011-05-16 00:15:10,2011-05-16 00:15:10
cdc246342b234b87d005930d72ee20ddd9e9b7aa...b7ba2ba3bcd4587ae4a17deb0d779604c58ecbfc,1,7,6,13,4,2011-05-16 00:15:27,2011-05-16 00:15:27
b7ba2ba3bcd4587ae4a17deb0d779604c58ecbfc...9d4b9791606ca81cad68507c91e24d5355caa8b7,2,113,104,217,12,2011-05-16 03:05:08,2011-05-16 03:05:08
9d4b9791606ca81cad68507c91e24d5355caa8b7...4238329e7a39cb24e75684c4a9f013f18266ff06,1,6,0,6,2,2011-05-16 15:54:20,2011-05-16 15:54:20
4238329e7a39cb24e75684c4a9f013f18266ff06...c31457d8fe18a50979fc5975ce086c218af8a57e,1,1,1,2,1,2011-05-16 18:35:08,2011-05-16 18:34:56
c31457d8fe18a50979fc5975ce086c218af8a57e...23ff45729d8de19be9e6fd614756e3d7ddbf6528,1,4,1,5,2,2011-05-16 18:39:21,2011-05-16 18:39:03
23ff45729d8de19be9e6fd614756e3d7ddbf6528...2ae8c2577c699314c7e51ce1d6c55e34ddd43d97,1,1,4,5,2,2011-05-16 18:43:33,2011-05-16 18:43:33
2ae8c2577c699314c7e51ce1d6c55e34ddd43d97...e14f0af046fbf32e43a379a4b72564670a5e39a1,1,2,11,13,1,2011-05-16 18:52:40,2011-05-16 18:52:40
e14f0af046fbf32e43a379a4b72564670a5e39a1...e8177474550d1270740f8bcc30f2c461d8d22d44,1,6,0,6,1,2011-05-16 20:53:28,2011-05-16 20:50:29
e8177474550d1270740f8bcc30f2c461d8d22d44...edf755ed9644cf946b26bf71428e772595aff8a6,2,109,13,122,18,2011-05-16 20:53:28,2011-05-16 20:53:05
edf755ed9644cf946b26bf71428e772595aff8a6...43034d04935e04fa678bd17b67b1630b4209500d,3,10,1,11,5,2011-05-16 22:05:03,2011-05-16 22:05:03
43034d04935e04fa678bd17b67b1630b4209500d...e84155dbd8bc627618459a9fbe168e920cbb6cc4,1,2,2,4,2,2011-05-17 02:50:36,2011-05-17 02:50:36
e84155dbd8bc627618459a9fbe168e920cbb6cc4...41111d56d194fda30d0e36df7eeba2b40a46abba,2,6,0,6,2,2011-05-17 02:54:46,2011-05-17 02:54:46
41111d56d194fda30d0e36df7eeba2b40a46abba...c8d7d5a21bf38691f554c939a56dc37b8d892de0,1,1,1,2,1,2011-05-17 02:55:54,2011-05-17 02:55:54
c8d7d5a21bf38691f554c939a56dc37b8d892de0...821f38fb8a6c30b926971dbceb4bbaa1cc9cdccc,2,15,3,18,2,2011-05-17 05:29:54,2011-05-17 05:29:54
821f38fb8a6c30b926971dbceb4bbaa1cc9cdccc...ce83d98bcfa035bfbf4ebd170f6b09cda8634ef2,2,10,8,18,3,2011-05-17 14:50:12,2011-05-17 14:50:12
ce83d98bcfa035bfbf4ebd170f6b09cda8634ef2...e52eee894cacd0bb4e289a0870efc2d07341ef9c,1,1,1,2,1,2011-05-17 16:43:30,2011-05-17 16:43:30
e52eee894cacd0bb4e289a0870efc2d07341ef9c...7e36a565869a057196d36da6f30c6a30d92c38d9,2,85,0,85,3,2011-05-17 18:23:18,2011-05-17 15:58:43
7e36a565869a057196d36da6f30c6a30d92c38d9...fc2f62330f9966400bad5a02de9e8807aa3898e5,4,8,23,31,7,2011-05-17 18:23:18,2011-05-17 15:58:56
fc2f62330f9966400bad5a02de9e8807aa3898e5...ec722585a9e6817a99b7929cc66b2815fa7d8349,4,48,15,63,20,2011-05-17 18:23:18,2011-05-17 18:22:40
ec722585a9e6817a99b7929cc66b2815fa7d8349...fa07a30464d9cab56da24c7c86d6f1f32a6b451d,2,55,4,59,9,2011-05-17 18:23:18,2011-05-17 18:22:53
fa07a30464d9cab56da24c7c86d6f1f32a6b451d...6c2ca47e8d82217be5c22b206ea44c8145d3cc64,1,3,3,6,2,2011-05-17 19:04:34,2011-05-17 19:02:38
6c2ca47e8d82217be5c22b206ea44c8145d3cc64...08730e6a5f7edefac59451d1586d8ec0a4101b87,1,9,2,11,2,2011-05-17 19:04:34,2011-05-17 19:03:22
08730e6a5f7edefac59451d1586d8ec0a4101b87...0988843ddf68899aac985b873245c7744ea4d14b,1,10,1,11,1,2011-05-17 19:04:34,2011-05-17 19:04:16
0988843ddf68899aac985b873245c7744ea4d14b...2ea2ae914a52bb8bc865f1923f55955f75462b27,1,1,1,2,1,2011-05-17 19:20:08,2011-05-16 18:54:56
2ea2ae914a52bb8bc865f1923f55955f75462b27...ae7cf9b73638ddf482b62a7151f23691c1ebae72,2,1,9,10,2,2011-05-17 19:20:08,2011-05-16 18:58:44
ae7cf9b73638ddf482b62a7151f23691c1ebae72...fc57e3f54d41106286f87120a3f6fd492d48fbfc,1,7,0,7,1,2011-05-17 19:20:08,2011-05-16 19:16:55
fc57e3f54d41106286f87120a3f6fd492d48fbfc...ab01eb9d1cbf2b6ebd285ed2294247f4e50962f8,1,1,1,2,1,2011-05-17 19:20:08,2011-05-16 22:07:20
ab01eb9d1cbf2b6ebd285ed2294247f4e50962f8...c61c9fa588821acc0abcee1e4fdc236ad2eaf0e7,7,993,81,1074,84,2011-05-17 19:20:08,2011-05-17 18:36:07
c61c9fa588821acc0abcee1e4fdc236ad2eaf0e7...dc922edc3172d36b3d2005d75c79519ceb7d2764,1,6,5,11,4,2011-05-17 19:20:09,2011-05-17 18:37:05
dc922edc3172d36b3d2005d75c79519ceb7d2764...b7b8c16d61e1fc48a7e5b4c95e21dbcb45ffbd99,1,12,10,22,1,2011-05-17 20:55:10,2011-05-17 20:55:10
b7b8c16d61e1fc48a7e5b4c95e21dbcb45ffbd99...b66a139b1799a469957c5754d7aa6d6f945ff883,1,3,3,6,3,2011-05-18 05:42:05,2011-05-18 05:40:42
b66a139b1799a469957c5754d7aa6d6f945ff883...719e23b5f72872a894b71f7f24b40f0db3284b20,4,53,12,65,16,2011-05-18 05:54:21,2011-05-18 02:08:24
719e23b5f72872a894b71f7f24b40f0db3284b20...859bb3ad164953e2a5c889939bf8c89dc5d6a6ef,7,190,28,218,16,2011-05-18 05:54:22,2011-05-18 05:53:48
859bb3ad164953e2a5c889939bf8c89dc5d6a6ef...aa0865f65528a88f545b1dee8517e1e326ad8390,1,4,3,7,3,2011-05-18 05:54:22,2011-05-18 05:54:05
aa0865f65528a88f545b1dee8517e1e326ad8390...b0f4f5b42777ccd9fc453ddd2484ac0d82edeea6,2,16,0,16,2,2011-05-18 14:47:43,2011-05-18 14:45:52
b0f4f5b42777ccd9fc453ddd2484ac0d82edeea6...c4f528bbe1f046416000e59ee5d3caa981a4fd86,1,1,1,2,1,2011-05-18 15:09:03,2011-05-17 18:38:09
c4f528bbe1f046416000e59ee5d3caa981a4fd86...0ae14a5055f10eaf2466d78df1ccb0cff022f4b7,1,10,6,16,4,2011-05-18 15:09:03,2011-05-18 15:08:41
0ae14a5055f10eaf2466d78df1ccb0cff022f4b7...0f3cd12149d634deb07bdff2ff59fa4ada869dec,1,19,4,23,6,2011-05-18 16:55:38,2011-05-18 16:55:38
0f3cd12149d634deb07bdff2ff59fa4ada869dec...d2c94bc2c104069141c00ae209ae27f6078507db,1,2,1,3,1,2011-05-18 20:42:57,2011-05-18 20:42:57
d2c94bc2c104069141c00ae209ae27f6078507db...d010e85f47fecdd7b3a1164260c0bf0bda982ea1,1,1,1,2,1,2011-05-18 21:36:55,2011-05-18 21:11:58
d010e85f47fecdd7b3a1164260c0bf0bda982ea1...e60621258d6f7e221778bfc0c878c6766da02cd5,1,1,0,1,1,2011-05-18 21:36:55,2011-05-18 21:12:10
e60621258d6f7e221778bfc0c878c6766da02cd5...8d4cee1fce76de96a728a5c1a61171864966ada5,1,54,0,54,1,2011-05-18 21:36:55,2011-05-18 21:14:43
8d4cee1fce76de96a728a5c1a61171864966ada5...4f9ae84652071c41df08ed130959d39a4aadef18,4,28,4,32,11,2011-05-18 21:36:55,2011-05-18 21:36:19
4f9ae84652071c41df08ed130959d39a4aadef18...93eaf061fad1773ba86fae6eb1e69488e64cbb48,2,17,17,34,8,2011-05-18 22:08:21,2011-05-18 22:08:21
93eaf061fad1773ba86fae6eb1e69488e64cbb48...0146bef876abb60d7891af81f675c44b4cc39713,1,3,1,4,2,2011-05-19 00:05:56,2011-05-18 06:44:16
0146bef876abb60d7891af81f675c44b4cc39713...19c5c80d2ba97bf4d5ec8e7ed66dc6f8d7059d2c,1,1,1,2,1,2011-05-19 15:11:36,2011-05-19 15:11:36
19c5c80d2ba97bf4d5ec8e7ed66dc6f8d7059d2c...73209450a27ff03d24c9aabb5a31bb7510139edd,1,1,0,1,1,2011-05-19 15:22:01,2011-05-19 15:21:37
73209450a27ff03d24c9aabb5a31bb7510139edd...6e01775d25d07a6722640a49cd96a353cca24f46,1,2,7,9,3,2011-05-19 15:22:01,2011-05-19 15:21:42
6e01775d25d07a6722640a49cd96a353cca24f46...57bb3d62dc75acc21cd992b9dbbbcfe94b549d18,1,15,12,27,8,2011-05-19 16:17:06,2011-05-19 16:17:06
57bb3d62dc75acc21cd992b9dbbbcfe94b549d18...8d009017c96b68241a405da7a5ff2b4593278386,2,35,15,50,16,2011-05-19 18:23:06,2011-05-19 18:19:40
8d009017c96b68241a405da7a5ff2b4593278386...0b689c83e8a8555d2167ef0337982008ff698c14,3,9,22,31,5,2011-05-19 18:23:06,2011-05-19 18:22:20
0b689c83e8a8555d2167ef0337982008ff698c14...a9924101a7c22e4919d28d1eaa518d49d64e9de1,2,21,3,24,6,2011-05-19 18:49:38,2011-05-19 18:49:38
a9924101a7c22e4919d28d1eaa518d49d64e9de1...1f4c905cffd0767958d38d8f79d2f7114713a9cc,1,6,0,6,1,2011-05-19 19:40:34,2011-05-19 19:40:34
1f4c905cffd0767958d38d8f79d2f7114713a9cc...cd0dbafc479e911ac52e1c76f6923118a6f9a8c0,1,7,9,16,1,2011-05-19 19:41:01,2011-05-19 19:41:01
cd0dbafc479e911ac52e1c76f6923118a6f9a8c0...2c1fa43373dd1ce1ffec572cdc0eaa63abaf1490,1,7,1,8,3,2011-05-19 21:29:56,2011-05-19 21:29:31
2c1fa43373dd1ce1ffec572cdc0eaa63abaf1490...ea1a8f4c295460916adb4c4024ded37750a1267b,2,22,5,27,5,2011-05-19 21:43:24,2011-05-19 21:43:24
ea1a8f4c295460916adb4c4024ded37750a1267b...096e570a64bef4c6aeda43a400ca16eb7151ec5f,2,23,8,31,4,2011-05-19 21:48:33,2011-05-19 21:48:33
096e570a64bef4c6aeda43a400ca16eb7151ec5f...2f9948df10c56db11df47cf65077761ee0853c80,1,1,0,1,1,2011-05-19 23:08:24,2011-05-19 23:08:08
2f9948df10c56db11df47cf65077761ee0853c80...c665d0a40644d91cad46b6067b9880bcb03bad5f,1,1,0,1,1,2011-05-22 05:11:03,2011-05-22 05:11:03
c665d0a40644d91cad46b6067b9880bcb03bad5f...ff53662a8f44862ca9430a7a6e7e83904e9d7b1d,1,4,0,4,1,2011-05-23 01:23:54,2011-05-23 01:23:06
ff53662a8f44862ca9430a7a6e7e83904e9d7b1d...0e28f89602e84f6ea6009cf5d5d91da675c1d199,1,1,4,5,2,2011-05-23 14:30:15,2011-05-23 14:30:15
0e28f89602e84f6ea6009cf5d5d91da675c1d199...b690e237fd7055ad1da8950882c62b4fab82baee,11,133,84,217,38,2011-05-23 22:46:27,2011-05-23 22:46:27
b690e237fd7055ad1da8950882c62b4fab82baee...0c02f3287831b479e5f6c23877104edeeddf79e0,2,11,5,16,5,2011-05-24 00:03:03,2011-05-21 14:07:22
0c02f3287831b479e5f6c23877104edeeddf79e0...990e708ead7363a4938e33688a9353dda03e78ce,2,7,16,23,16,2011-05-24 00:03:05,2011-05-21 18:06:20
990e708ead7363a4938e33688a9353dda03e78ce...923660edbb3158be412b651f5f97c7be7ec4310a,2,32,0,32,2,2011-05-24 00:03:06,2011-05-23 14:23:51
923660edbb3158be412b651f5f97c7be7ec4310a...b6f07e2b6db67ce4ef5812af4b912e3851f388f0,1,22,28,50,8,2011-05-24 00:03:08,2011-05-23 14:25:42
b6f07e2b6db67ce4ef5812af4b912e3851f388f0...3f9878191e9f44ec7cd48a1e439c2931d3ee1bc1,1,9,9,18,7,2011-05-24 00:03:09,2011-05-23 14:27:58
3f9878191e9f44ec7cd48a1e439c2931d3ee1bc1...b99eaa3387cb7678d216a43338b8f897baa11638,4,106,24,130,20,2011-05-24 00:03:11,2011-05-23 14:28:52
b99eaa3387cb7678d216a43338b8f897baa11638...9da83a5530a45a9c1046255bf1787f6e4c2bac49,1,19,1,20,2,2011-05-24 00:03:13,2011-05-23 14:31:04
9da83a5530a45a9c1046255bf1787f6e4c2bac49...0eebdbfe9daf4688c64e2f257a70102abae83e0d,2,42,44,86,29,2011-05-24 00:03:14,2011-05-23 14:32:18
0eebdbfe9daf4688c64e2f257a70102abae83e0d...16f7b4fe65193cdc9db3d18b36cb0f74025cf8d7,1,0,15,15,1,2011-05-24 00:03:16,2011-05-23 14:32:59
16f7b4fe65193cdc9db3d18b36cb0f74025cf8d7...bd5b6071376a21f3ae688751f3ec998275a621be,4,32,29,61,21,2011-05-24 00:03:18,2011-05-23 14:35:58
bd5b6071376a21f3ae688751f3ec998275a621be...8a0660ac31444b4e7c48442c0f44a01fbc9e4e07,16,28,28,56,28,2011-05-24 00:03:19,2011-05-23 14:49:50
8a0660ac31444b4e7c48442c0f44a01fbc9e4e07...7af38ae643835f0a8ba410da31ef4044e4bea8ee,1,5,0,5,5,2011-05-24 00:03:21,2011-05-23 14:50:45
7af38ae643835f0a8ba410da31ef4044e4bea8ee...4bd221e82493353f04681252711882de732983e8,1,1,0,1,1,2011-05-24 00:03:22,2011-05-23 15:07:45
4bd221e82493353f04681252711882de732983e8...c0384332f2d96a5ae1dff3eff83fe1c4bdbd91dd,10,73,70,143,28,2011-05-24 00:03:24,2011-05-24 00:01:42
c0384332f2d96a5ae1dff3eff83fe1c4bdbd91dd...ca5e75b6ff6f1a23410622ccc94fe25f634e4b1d,1,1,1,2,1,2011-05-24 00:09:09,2011-05-24 00:09:09
ca5e75b6ff6f1a23410622ccc94fe25f634e4b1d...816223af23e2df584dface7a2628191286a190d3,1,1,0,1,1,2011-05-24 00:14:12,2011-05-24 00:14:12
816223af23e2df584dface7a2628191286a190d3...2b28400dc26c1daada24b3765ef0c2ccdf0892d5,1,1,1,2,1,2011-05-24 00:17:42,2011-05-24 00:17:42
2b28400dc26c1daada24b3765ef0c2ccdf0892d5...a3cd7ed576f21d43edfb654bbb19d48da91dd1df,1,51,30,81,8,2011-05-24 06:13:10,2011-05-24 06:13:10
a3cd7ed576f21d43edfb654bbb19d48da91dd1df...afd23f33f934d0fa64aab7e121b98d70a5769285,10,32,30,62,25,2011-05-24 14:05:31,2011-05-24 14:05:31
afd23f33f934d0fa64aab7e121b98d70a5769285...bb3c531d01e8e20dd41aee102863b753401fbe9a,1,18,23,41,4,2011-05-24 14:12:25,2011-05-24 14:12:25
bb3c531d01e8e20dd41aee102863b753401fbe9a...19c9c5af7954a2cf178a93107fe5ac6f5eabef86,1,6,7,13,5,2011-05-24 14:21:04,2011-05-24 14:21:04
442d45052b54fa8a69d93ae21858d393b5aa5e23...5fbfa2839c15d648f3fb9fb5bd3092efe8a8a902,3,4,4,8,6,2012-02-16 17:51:50,2012-02-16 17:51:50
5fbfa2839c15d648f3fb9fb5bd3092efe8a8a902...16cdb248c9caa50b525178cce43ccc15651ae29f,1,0,2,2,1,2012-02-16 17:52:33,2012-02-16 17:52:33
16cdb248c9caa50b525178cce43ccc15651ae29f...83175e203a5739ef31e5d56e5b89d87f1b48f47b,5,502,369,871,90,2012-02-16 17:52:49,2012-02-16 17:52:49
83175e203a5739ef31e5d56e5b89d87f1b48f47b...31553521047a99cbe5431c0af5784ebd6df9e8c0,1,10,2,12,5,2012-02-16 22:50:59,2012-02-16 22:50:59
31553521047a99cbe5431c0af5784ebd6df9e8c0...0311f80b36772efc036eed6af5a70ed7b85f8a06,5,116,79,195,52,2012-02-16 22:52:11,2012-02-16 22:52:11
0311f80b36772efc036eed6af5a70ed7b85f8a06...73935fa257343cc89557fa9a82d9e114b34538c2,1,188,62,250,31,2012-02-17 17:42:44,2012-02-17 17:42:44
c270ddb2bf3c81c065cc3c9df6d9ce9479837064...222af62133b202cf97ff555a93695c6693c9e3e2,3,141,34,175,15,2012-01-17 00:09:33,2012-01-17 00:05:22
222af62133b202cf97ff555a93695c6693c9e3e2...e2adb6c54c58c6d63b97650e922fd951c43a2898,1,14,0,14,3,2012-01-17 02:58:39,2012-01-17 02:56:55
e2adb6c54c58c6d63b97650e922fd951c43a2898...524af38b3f62cf5b4e9a3feca2d422a0f4d4b3d6,1,1,1,2,1,2012-01-17 06:09:36,2012-01-17 06:09:28
524af38b3f62cf5b4e9a3feca2d422a0f4d4b3d6...2f94dce03fe1543bbf2af3d3af3668d58bb8ba7e,3,23,6,29,7,2012-01-17 17:04:55,2012-01-17 17:04:55
2f94dce03fe1543bbf2af3d3af3668d58bb8ba7e...6d375132cb8940f1b6b0254d0a729050587afd21,2,123,0,123,2,2012-01-17 17:45:52,2012-01-17 17:45:52
6d375132cb8940f1b6b0254d0a729050587afd21...a1280e5bccfaa97cad45c5fdfa6d27259c4103d0,1,3,2,5,1,2012-01-17 19:34:08,2012-01-17 17:44:48
a1280e5bccfaa97cad45c5fdfa6d27259c4103d0...61d3919fcd4ef6769339cb75f93384634ce477cc,2,21,17,38,9,2012-01-17 20:17:13,2012-01-17 20:16:50
61d3919fcd4ef6769339cb75f93384634ce477cc...6435da77feecc9e47a32b43fa836b7db8fccf030,1,1,1,2,2,2012-01-17 21:41:23,2012-01-17 21:41:23
6435da77feecc9e47a32b43fa836b7db8fccf030...6ebc58236500ca5500714a6ddfcb7c64bcd5e22a,2,11,2,13,4,2012-01-17 22:22:50,2012-01-17 22:22:50
6ebc58236500ca5500714a6ddfcb7c64bcd5e22a...8a002c30c6d6749f87c618b61d3f58d54696bb7a,1,6,5,11,5,2012-01-17 22:32:44,2012-01-17 22:31:32
8a002c30c6d6749f87c618b61d3f58d54696bb7a...30668e1c79cf6e8dac45a61b64694c045e1a59f5,19,1333,810,2143,76,2012-01-17 22:58:51,2012-01-04 19:30:29
30668e1c79cf6e8dac45a61b64694c045e1a59f5...f6fc6431bf0a49cef4d0bb019fa61f7e137852bc,1,1,0,1,1,2012-01-18 01:01:15,2012-01-18 01:01:15
f6fc6431bf0a49cef4d0bb019fa61f7e137852bc...057b78d8fca64c86c41515da7842d9dc10d7b714,1,12,0,12,1,2012-01-18 02:17:19,2012-01-18 02:17:19
057b78d8fca64c86c41515da7842d9dc10d7b714...6cf66ed2a01b470d3da0e765bc4dc2208746f61d,1,2,2,4,2,2012-01-18 03:23:17,2012-01-18 03:23:17
6cf66ed2a01b470d3da0e765bc4dc2208746f61d...84289e0b887facfb51ace4830aca5b87863bdf2d,2,13,5,18,7,2012-01-18 07:48:19,2012-01-18 07:48:19
84289e0b887facfb51ace4830aca5b87863bdf2d...118d9e40191ad3f979253d3ca40b9eb525e998c3,1,1,1,2,1,2012-01-18 15:36:16,2012-01-18 15:36:01
118d9e40191ad3f979253d3ca40b9eb525e998c3...c42319e75653e8da91ae7223b4cf637a09945c0c,1,1,1,2,1,2012-01-18 17:59:41,2012-01-18 17:59:41
c42319e75653e8da91ae7223b4cf637a09945c0c...2561f20421743c4a540b362988bbef6a977589c4,1,21,22,43,16,2012-01-18 19:01:55,2012-01-18 19:01:39
2561f20421743c4a540b362988bbef6a977589c4...82d75530b8eb2854c2b5b12c5c5f8df696713232,2,8,7,15,4,2012-01-18 19:50:31,2012-01-18 19:50:09
82d75530b8eb2854c2b5b12c5c5f8df696713232...55eff0ad5db7fc4d2b6d09852e2fb7a78f2462fc,1,5,3,8,3,2012-01-18 20:03:44,2012-01-18 20:01:41
55eff0ad5db7fc4d2b6d09852e2fb7a78f2462fc...6f3be45ecda2601b4e53ccca6fa95df7d07835bf,1,10,4,14,1,2012-01-18 20:26:11,2012-01-18 20:25:58
6f3be45ecda2601b4e53ccca6fa95df7d07835bf...7015b211d931cd6d456094e1abe3b68cc28c6e46,1,7,2,9,1,2012-01-18 21:37:45,2012-01-18 21:25:58
7015b211d931cd6d456094e1abe3b68cc28c6e46...826d964c31f7a96c43f0467b85ff6b23f66fad68,1,23,19,42,9,2012-01-18 21:37:45,2012-01-18 21:35:50
826d964c31f7a96c43f0467b85ff6b23f66fad68...dcb8445b554bb63264254a6e0df11766392f1ee2,2,9,1,10,2,2012-01-18 22:17:12,2012-01-18 22:10:11
dcb8445b554bb63264254a6e0df11766392f1ee2...c613d4aec3dd0f83fcc2a127b534260cf2be6431,1,9,8,17,6,2012-01-18 22:31:39,2012-01-18 22:31:31
c613d4aec3dd0f83fcc2a127b534260cf2be6431...dc84eafc356f6b176f10d87512d671df83cf8b74,2,36,8,44,20,2012-01-18 23:42:53,2012-01-18 23:16:43
dc84eafc356f6b176f10d87512d671df83cf8b74...baa097c07b244a69a8d409059eca4ce42810266e,3,22,12,34,6,2012-01-18 23:42:53,2012-01-18 23:41:07
baa097c07b244a69a8d409059eca4ce42810266e...2bd1aeb2996b7cba38218b3daddf04b12245b98d,2,13,8,21,4,2012-01-19 01:31:04,2012-01-08 22:36:12
2bd1aeb2996b7cba38218b3daddf04b12245b98d...dbb5bb1b5235ad6ded62882419853e5ad6d38c13,2,43,33,76,4,2012-01-19 01:31:05,2012-01-08 22:51:14
dbb5bb1b5235ad6ded62882419853e5ad6d38c13...b15003971f1957060a6ebf7a34fcb75fd89e6ba8,1,1,0,1,1,2012-01-19 01:31:05,2012-01-08 22:54:37
b15003971f1957060a6ebf7a34fcb75fd89e6ba8...7a8179149684663c066a90757f32d91a174725a8,11,262,114,376,77,2012-01-19 01:31:06,2012-01-13 02:29:48
7a8179149684663c066a90757f32d91a174725a8...446accecc4c9f13fb83d952f8989273ca95d30b1,1,17,0,17,2,2012-01-19 01:31:07,2012-01-13 05:39:37
446accecc4c9f13fb83d952f8989273ca95d30b1...a32de81bc868ad0df81c43f41332a842dd8158ae,1,3,3,6,3,2012-01-19 01:31:07,2012-01-13 05:43:15
a32de81bc868ad0df81c43f41332a842dd8158ae...5c0a8f45fb0cbc9acedced2b9c840b4ff9dda00f,1,3,3,6,3,2012-01-19 01:31:07,2012-01-13 05:47:17
5c0a8f45fb0cbc9acedced2b9c840b4ff9dda00f...9be857187370186e0a64b96f9dd84e2797aced2d,2,8,13,21,5,2012-01-19 01:31:08,2012-01-13 06:14:29
9be857187370186e0a64b96f9dd84e2797aced2d...6f6f131a3e86b8e84f269dab40bc152106d83eed,3,119,33,152,16,2012-01-19 01:31:08,2012-01-16 22:53:41
6f6f131a3e86b8e84f269dab40bc152106d83eed...8be91111b056b78945c25bcb73974f4e52a6573d,1,0,1,1,1,2012-01-19 01:31:08,2012-01-17 05:56:05
8be91111b056b78945c25bcb73974f4e52a6573d...d8c1ea9cb4f72f666e7a09054032ac6ab3d52cf6,1,8,4,12,5,2012-01-19 01:31:08,2012-01-17 05:57:04
d8c1ea9cb4f72f666e7a09054032ac6ab3d52cf6...a7b3d8fa55eba9a79b0642c0dc02c99798feb36c,18,70,58,128,25,2012-01-19 01:31:09,2012-01-17 05:58:06
a7b3d8fa55eba9a79b0642c0dc02c99798feb36c...e68bf57ddef3e68b0a639fae3157db89ad8b36f7,2,32,2,34,3,2012-01-19 01:31:09,2012-01-17 06:47:21
e68bf57ddef3e68b0a639fae3157db89ad8b36f7...57446543a07f67cdf8bc4d82eb17bddf5acb9539,1,14,5,19,3,2012-01-19 01:31:09,2012-01-17 06:50:05
57446543a07f67cdf8bc4d82eb17bddf5acb9539...67ed40c58e7c128d54655abe663aafba8275bd0a,2,6,5,11,3,2012-01-19 01:31:09,2012-01-17 06:59:31
67ed40c58e7c128d54655abe663aafba8275bd0a...8cf9df35649b1af35253ff0d7c2a9722bde986aa,5,18,21,39,16,2012-01-19 01:31:09,2012-01-17 18:39:18
8cf9df35649b1af35253ff0d7c2a9722bde986aa...d3f599943713773a4dec5ecda097facb0cd1fe88,2,29,3,32,3,2012-01-19 01:31:10,2012-01-17 19:58:21
d3f599943713773a4dec5ecda097facb0cd1fe88...3f564bdae6adc11d0cefac87c76764e9eb4ace1e,1,2,0,2,1,2012-01-19 01:31:11,2012-01-17 20:18:26
3f564bdae6adc11d0cefac87c76764e9eb4ace1e...c4a61d602c2775b9261a9d192f70ab7667ec251e,2,23,1,24,3,2012-01-19 01:31:11,2012-01-17 20:29:32
c4a61d602c2775b9261a9d192f70ab7667ec251e...71e18afb29d1d1371d5253a651d04eb5a3c7c496,1,1,1,2,1,2012-01-19 01:31:11,2012-01-17 21:22:30
71e18afb29d1d1371d5253a651d04eb5a3c7c496...7944ff9f3f2459473ce2c5fada33428c6f1d6434,1,1,1,2,1,2012-01-19 01:31:11,2012-01-18 02:27:14
7944ff9f3f2459473ce2c5fada33428c6f1d6434...c01b710c3eff8c38304dfc4b4f6e71b1f57b3482,1,2,5,7,1,2012-01-19 01:31:12,2012-01-18 02:27:46
c01b710c3eff8c38304dfc4b4f6e71b1f57b3482...64e27f2f05d077714b6d458efd60995f9da953fd,2,13,0,13,2,2012-01-19 01:31:12,2012-01-18 06:59:39
64e27f2f05d077714b6d458efd60995f9da953fd...9fa9d0102460f5e830392ce5413d36dc2ef27fac,2,6,3,9,3,2012-01-19 01:31:12,2012-01-18 07:07:49
9fa9d0102460f5e830392ce5413d36dc2ef27fac...94ff17db3325cb99dd8407a75526d17a95166e27,2,2,2,4,3,2012-01-19 01:31:12,2012-01-18 18:29:17
94ff17db3325cb99dd8407a75526d17a95166e27...dfb1461732cd8890c3cc8bdd326d737ca175d615,3,11,2,13,3,2012-01-19 14:09:30,2012-01-19 14:09:30
dfb1461732cd8890c3cc8bdd326d737ca175d615...935c8496741f75c664c262234063d540873adcad,1,9,3,12,2,2012-01-19 14:38:02,2012-01-19 14:37:51
935c8496741f75c664c262234063d540873adcad...961f0534b89d03836724f54c8a93a6b6cd414932,2,97,21,118,18,2012-01-19 16:04:49,2012-01-19 16:04:49
961f0534b89d03836724f54c8a93a6b6cd414932...5bd8a76aa7d01ac3b69c0ea11a8136683c22b3f7,1,1,1,2,2,2012-01-19 16:36:35,2012-01-19 16:36:35
5bd8a76aa7d01ac3b69c0ea11a8136683c22b3f7...fabc85f9815a211eeff2d90ce5afb40634c0d3a9,2,3,3,6,2,2012-01-19 17:30:59,2012-01-18 21:10:01
fabc85f9815a211eeff2d90ce5afb40634c0d3a9...85feca08df1276909311123694cdaf22baf1d592,2,8,2,10,4,2012-01-19 17:31:01,2012-01-18 21:22:41
85feca08df1276909311123694cdaf22baf1d592...51a735c40f0ba748d5328ef0551f5c2b743f9fdf,1,7,4,11,6,2012-01-19 18:26:48,2012-01-19 18:26:30
51a735c40f0ba748d5328ef0551f5c2b743f9fdf...680887991be6872885386753d62fd191ec03c191,2,16,4,20,2,2012-01-19 20:00:34,2012-01-19 20:00:12
680887991be6872885386753d62fd191ec03c191...13d924ad946704d509a7c921a56802cb60d94379,2,2,1,3,2,2012-01-19 21:32:59,2012-01-19 21:32:22
13d924ad946704d509a7c921a56802cb60d94379...959ca16b3114bff1b0424a2cb435af8c186fc25d,1,4,4,8,2,2012-01-20 00:50:57,2012-01-19 23:07:26
959ca16b3114bff1b0424a2cb435af8c186fc25d...785651d2be7cf285eb87cfb519bd7de66583ea4c,2,18,22,40,14,2012-01-20 08:32:00,2012-01-20 08:32:00
785651d2be7cf285eb87cfb519bd7de66583ea4c...1afb642f15af8e24bd84d47037478d13ddffa27a,1,1,1,2,1,2012-01-20 17:24:27,2012-01-20 17:24:27
1afb642f15af8e24bd84d47037478d13ddffa27a...93c545704be4e817f42d919bd33d476849f6d843,2,27,0,27,2,2012-01-20 18:16:36,2012-01-20 18:16:36
93c545704be4e817f42d919bd33d476849f6d843...30163a270db97c479a843a8c3e8ac1b644ad759f,3,6,12,18,6,2012-01-20 21:35:56,2012-01-20 21:33:42
30163a270db97c479a843a8c3e8ac1b644ad759f...71dc4e17a122f9fcd1c9d0594ec0657ac593296d,1,0,25,25,1,2012-01-20 22:48:33,2012-01-20 22:48:33
71dc4e17a122f9fcd1c9d0594ec0657ac593296d...fe7421e8f00f00cc723bbe0144319f6fac274562,2,17,5,22,6,2012-01-21 06:33:40,2012-01-21 03:34:13
fe7421e8f00f00cc723bbe0144319f6fac274562...2479794acdd9101efaee829b12bd2c8097dd62b4,4,17,85,102,7,2012-01-21 06:33:40,2012-01-21 06:31:08
2479794acdd9101efaee829b12bd2c8097dd62b4...e885029b8fa04e846619dc9b157b803e6c3e46a5,2,15,15,30,2,2012-01-21 07:03:12,2012-01-21 07:03:12
e885029b8fa04e846619dc9b157b803e6c3e46a5...ff0157a562557ce5a42145506c3a4c3af4a7303a,1,4,2,6,1,2012-01-22 00:50:45,2012-01-22 00:50:45
ff0157a562557ce5a42145506c3a4c3af4a7303a...cde936c7cd7ad0db67f19224e9e971095d9f2ed6,7,10,6,16,8,2012-01-22 01:00:39,2012-01-22 01:00:39
cde936c7cd7ad0db67f19224e9e971095d9f2ed6...08eac1faf3c019c4678f8025f7ad433eb917073f,1,35,24,59,2,2012-01-22 05:06:06,2012-01-22 05:06:06
08eac1faf3c019c4678f8025f7ad433eb917073f...ff87e84c3e8f881b163cd709f5d9c6046d23772a,1,13,2,15,3,2012-01-23 17:38:39,2012-01-23 17:38:39
ff87e84c3e8f881b163cd709f5d9c6046d23772a...29948a70afd735d7e52f56b9804e3cb66828aae2,1,3,0,3,1,2012-01-23 18:14:00,2012-01-23 18:14:00
29948a70afd735d7e52f56b9804e3cb66828aae2...bf385b2d1e4a97f259a2667b85b07eb068d87ef1,6,21,19,40,22,2012-01-23 19:02:59,2012-01-13 21:55:26
bf385b2d1e4a97f259a2667b85b07eb068d87ef1...8ab00af5257a16ace7807842d3a4843e5a0dd64a,10,136,13,149,18,2012-01-23 19:03:02,2012-01-23 18:58:22
8ab00af5257a16ace7807842d3a4843e5a0dd64a...477496bf414fafaa83c8512fcd47b1c0ede80b5e,1,8,0,8,1,2012-01-23 21:59:27,2012-01-23 21:58:35
477496bf414fafaa83c8512fcd47b1c0ede80b5e...75ce6fea6803afb1cb535589952012fa1b72041a,3,32,6,38,7,2012-01-23 22:05:47,2012-01-23 22:05:47
75ce6fea6803afb1cb535589952012fa1b72041a...be40a5eac197a86af64992153dcffe2072f65c89,2,4,1,5,2,2012-01-23 22:06:09,2012-01-23 22:06:09
be40a5eac197a86af64992153dcffe2072f65c89...f104ef1ddb381d41981709bede5092876cafaa19,1,5,1,6,2,2012-01-23 22:32:02,2012-01-23 22:30:53
f104ef1ddb381d41981709bede5092876cafaa19...0506366925126fd593c237f9545c743e7a6cbc4f,1,6,0,6,2,2012-01-23 22:32:02,2012-01-23 22:31:04
0506366925126fd593c237f9545c743e7a6cbc4f...52cd3d34a8db1ff28a07b0d27ff879a47a4f9c60,1,10,0,10,2,2012-01-23 22:32:02,2012-01-23 22:31:28
52cd3d34a8db1ff28a07b0d27ff879a47a4f9c60...06cf3493ab99e4482f5bf0f3b780f237b96dc16d,1,23,24,47,2,2012-01-23 22:35:45,2012-01-23 05:59:46
06cf3493ab99e4482f5bf0f3b780f237b96dc16d...345863cc87bfc941b28fd1a4b7a978e390d3c8f2,4,149,33,182,26,2012-01-23 22:35:45,2012-01-23 22:35:37
345863cc87bfc941b28fd1a4b7a978e390d3c8f2...c664a29f9afdb25576e3c9207b636dd1b01f0b37,1,2,2,4,2,2012-01-23 22:54:20,2012-01-23 22:54:20
c664a29f9afdb25576e3c9207b636dd1b01f0b37...95b2ec7612ef2ec1bb755993f771cedc3f11b9f1,1,1,1,2,1,2012-01-23 22:54:26,2012-01-23 22:54:26
95b2ec7612ef2ec1bb755993f771cedc3f11b9f1...0ae3555e77ffb5983f090176742af382bc757e81,1,38,3,41,15,2012-01-24 00:02:40,2012-01-24 00:01:38
0ae3555e77ffb5983f090176742af382bc757e81...5791be17f21c8daa647418e6843ce81ea2db79c8,1,65,0,65,3,2012-01-24 01:20:23,2012-01-24 01:19:38
5791be17f21c8daa647418e6843ce81ea2db79c8...3ff38cd001756757970f73d9fff2937adc12aa5a,1,1,2,3,1,2012-01-24 01:20:23,2012-01-24 01:20:03
3ff38cd001756757970f73d9fff2937adc12aa5a...b09709c7cce24ec72bfeb59cb0acd589eba98019,1,11,2,13,1,2012-01-24 03:55:25,2012-01-24 03:55:25
b09709c7cce24ec72bfeb59cb0acd589eba98019...6c269ae42ae89ea2f2080a8b21105196f86e3a77,1,10,5,15,2,2012-01-24 04:27:06,2012-01-24 04:27:06
6c269ae42ae89ea2f2080a8b21105196f86e3a77...6a4d7740f6ab1d81937d833c7d9d1f66f8992602,1,2,2,4,1,2012-01-24 05:00:17,2012-01-24 05:00:17
6a4d7740f6ab1d81937d833c7d9d1f66f8992602...d9b74dc7cf8c7cd9279281aa5ea8707e8e48e24a,1,3,1,4,2,2012-01-24 05:14:53,2012-01-24 05:14:53
d9b74dc7cf8c7cd9279281aa5ea8707e8e48e24a...544b108db93158a39d50efc691f2521f411fe517,1,1,2,3,2,2012-01-24 06:00:02,2012-01-24 06:00:02
544b108db93158a39d50efc691f2521f411fe517...4c1d7fe9c46daae55a3d4edfbac55cc8541a0aef,1,2,11,13,1,2012-01-24 16:30:27,2012-01-24 16:30:27
4c1d7fe9c46daae55a3d4edfbac55cc8541a0aef...4a39fd4c166549ac7297e5e705ff2c974363e207,2,9,4,13,2,2012-01-24 17:51:11,2012-01-24 17:51:11
4a39fd4c166549ac7297e5e705ff2c974363e207...65749ebccbc46844ce16848c2ea34fcf1881e960,4,11,4,15,5,2012-01-24 18:06:19,2012-01-24 18:04:38
65749ebccbc46844ce16848c2ea34fcf1881e960...f91b04bd34fbbcbdfb3ca0ed06d530068c9205d6,1,2,2,4,2,2012-01-24 18:06:19,2012-01-24 18:04:53
f91b04bd34fbbcbdfb3ca0ed06d530068c9205d6...88d7386f9ad97623d5de642c3e3021fd51764771,3,67,39,106,25,2012-01-24 18:06:19,2012-01-24 18:06:05
88d7386f9ad97623d5de642c3e3021fd51764771...fc6791a8589a505f54d84a27e07a4f9045c3c72e,3,55,21,76,6,2012-01-24 19:16:16,2012-01-24 18:48:05
fc6791a8589a505f54d84a27e07a4f9045c3c72e...24160afc96ee0b3c9ffc70323b134762131e3d5c,1,1,1,2,1,2012-01-24 22:42:17,2012-01-24 22:42:17
19c9c5af7954a2cf178a93107fe5ac6f5eabef86...7728a0a6e468150cedabec9b971df702db7e0cb1,1,7,7,14,7,2011-05-25 20:13:47,2011-05-25 20:13:47
19c9c5af7954a2cf178a93107fe5ac6f5eabef86...53677f3b05142dc8a9c8771ed5c0eb2470fa65f1,1,1,1,2,1,2011-05-24 15:46:53,2011-05-24 15:46:53
53677f3b05142dc8a9c8771ed5c0eb2470fa65f1...6bfc2d5d5ff748bf89f239ce0914052940e4998b,1,1,1,2,1,2011-05-24 18:30:06,2011-05-24 06:53:10
5011008cacce2e2804a40c7e4d2851619bc222c2...e8b24ae77d0d9558a50a60e38fdea0f067d4fae8,1,0,1,1,1,2012-02-17 18:37:35,2012-02-17 18:37:35
e8b24ae77d0d9558a50a60e38fdea0f067d4fae8...9528f3d6a08ce69052dd9b52d51887e4a1d55ce0,1,13,7,20,5,2012-02-17 20:22:26,2012-02-17 20:22:26
9528f3d6a08ce69052dd9b52d51887e4a1d55ce0...6a888e7e11c7b2d61ea3141d8417c6a91401ef92,1,3,3,6,2,2012-02-17 20:22:31,2012-02-17 20:22:31
6a888e7e11c7b2d61ea3141d8417c6a91401ef92...6d66f15aaba7a754b306593055c6a51dc8822b07,1,4,3,7,3,2012-02-17 20:42:15,2012-02-17 20:42:15
6d66f15aaba7a754b306593055c6a51dc8822b07...2aa952e5a8a53f7561c9c626999c3a0c606d64bd,1,5,2,7,1,2012-02-17 20:42:36,2012-02-17 20:42:36
2aa952e5a8a53f7561c9c626999c3a0c606d64bd...5d5e76cc4852062938cf73b1270545c92c97fc09,1,1,0,1,1,2012-02-17 21:50:26,2012-02-17 21:50:26
5d5e76cc4852062938cf73b1270545c92c97fc09...b3e47741a9d843fbf0ee6c3f41e7d956b4b9b34b,3,93,26,119,28,2012-02-20 01:24:15,2012-02-20 01:24:15
b3e47741a9d843fbf0ee6c3f41e7d956b4b9b34b...463d3c696ea73e768d297f8a78c3fd5223c7ef8a,2,3,3,6,3,2012-02-21 04:10:20,2012-02-21 04:10:20
24160afc96ee0b3c9ffc70323b134762131e3d5c...f3bdb0e16faac7d2831cc0b18d5af3639492ba91,2,2,0,2,2,2012-01-24 23:13:45,2012-01-24 23:13:45
f3bdb0e16faac7d2831cc0b18d5af3639492ba91...1b329639d499f31cfd9ed1fda1328dbf7cbf09fb,1,2,2,4,1,2012-01-24 23:31:53,2012-01-24 23:31:53
1b329639d499f31cfd9ed1fda1328dbf7cbf09fb...7fc7559750e36985407b5471de2d7136ded81354,3,17,10,27,6,2012-01-24 23:32:06,2012-01-24 23:32:06
7fc7559750e36985407b5471de2d7136ded81354...94f40d5f356c82b35ad17ddb7215eb562ecb6163,1,21,1,22,3,2012-01-25 00:19:28,2012-01-25 00:19:28
94f40d5f356c82b35ad17ddb7215eb562ecb6163...9f9f9a417dd3381424a8187a9e53890784adb0b0,1,26,7,33,17,2012-01-25 06:21:43,2012-01-25 06:21:43
9f9f9a417dd3381424a8187a9e53890784adb0b0...5d7fa5c8f25bc8e78c4cabf29a382c6950b720b5,1,11,0,11,1,2012-01-25 06:22:03,2012-01-25 06:22:03
5d7fa5c8f25bc8e78c4cabf29a382c6950b720b5...72231559d2727473f3fccada4bf8dd94f42a1ea9,12,33,14,47,23,2012-01-25 06:22:18,2012-01-25 06:22:18
72231559d2727473f3fccada4bf8dd94f42a1ea9...2e96baad22ef3dcb2ff487a92bf56281c60937bc,2,15,9,24,9,2012-01-25 07:07:00,2012-01-25 07:07:00
2e96baad22ef3dcb2ff487a92bf56281c60937bc...232cc17a547042ed5ce77ece74fe374d3f8ef87d,1,1,1,2,1,2012-01-25 13:53:18,2012-01-25 13:53:18
232cc17a547042ed5ce77ece74fe374d3f8ef87d...730dfc290694c70ea8b51207d3a4636ecb0348cd,2,15,2,17,3,2012-01-25 14:34:38,2012-01-25 14:34:38
730dfc290694c70ea8b51207d3a4636ecb0348cd...31f7a4d34cda51d4a8e1aa22a1a775eb16ab1bed,1,1,1,2,1,2012-01-25 14:47:50,2012-01-25 14:47:50
31f7a4d34cda51d4a8e1aa22a1a775eb16ab1bed...f40b1596bbaaaca8588e97d0ef38395934bf2e72,1,1,1,2,1,2012-01-25 14:54:26,2012-01-25 14:54:26
f40b1596bbaaaca8588e97d0ef38395934bf2e72...2b4448551c31dcf07fd56185c49a543c9a2b6ce0,1,0,2,2,1,2012-01-25 15:01:15,2012-01-25 15:01:15
2b4448551c31dcf07fd56185c49a543c9a2b6ce0...935fb05a79be3f5a5a2f330984c55ccd0f48c23a,2,3,1,4,3,2012-01-25 15:11:23,2012-01-25 15:11:23
935fb05a79be3f5a5a2f330984c55ccd0f48c23a...de06e671b99dfe1f65d15ac01fb9f7ccc96ea8bd,1,1,1,2,1,2012-01-25 16:44:27,2012-01-25 16:44:27
de06e671b99dfe1f65d15ac01fb9f7ccc96ea8bd...799dd957b11e660dc8694f2fd96d14fcd670fc59,1,1,1,2,1,2012-01-25 16:44:39,2012-01-25 16:44:39
799dd957b11e660dc8694f2fd96d14fcd670fc59...585ebf9f68f28ced10db178634837006ff9e0f39,1,29,18,47,11,2012-01-25 17:26:11,2012-01-25 17:26:11
585ebf9f68f28ced10db178634837006ff9e0f39...df532033b1b295c05c1086494ae87a3cb3de6d7d,1,4,4,8,4,2012-01-25 18:49:52,2012-01-25 18:49:52
df532033b1b295c05c1086494ae87a3cb3de6d7d...2bf29b4602f600010aed8d2d0f0372396e3432b8,1,2,2,4,1,2012-01-25 19:25:36,2012-01-25 00:24:24
2bf29b4602f600010aed8d2d0f0372396e3432b8...b50e02c59760f53b170a10e35a9352d7a66666e3,1,7,0,7,2,2012-01-25 19:25:36,2012-01-25 19:25:08
b50e02c59760f53b170a10e35a9352d7a66666e3...0c0f64f82d0bf920c47e345cdf1376ac91c74a58,1,3,0,3,1,2012-01-25 19:28:09,2012-01-25 19:26:46
0c0f64f82d0bf920c47e345cdf1376ac91c74a58...03429ab9b5f323f2ab9a3ea092cd81984523d4a3,1,2,0,2,1,2012-01-25 19:31:45,2012-01-25 17:59:55
03429ab9b5f323f2ab9a3ea092cd81984523d4a3...ab640c98350e81e3e36e48a97bf5c1d83f9af339,1,1,2,3,1,2012-01-25 19:31:45,2012-01-25 19:31:30
ab640c98350e81e3e36e48a97bf5c1d83f9af339...679c8eb7d97527f33b8bfc56d15402804abad1f8,1,493,488,981,84,2012-01-25 19:31:45,2012-01-25 19:31:37
679c8eb7d97527f33b8bfc56d15402804abad1f8...0465af113532684c4c0e9d72bb7d21454495bdba,1,2,2,4,2,2012-01-25 20:45:38,2012-01-25 20:45:38
0465af113532684c4c0e9d72bb7d21454495bdba...77c5a659cd2d1aeee8fcadf073a7a549943f9e50,1,2,1,3,1,2012-01-25 21:37:20,2012-01-25 21:37:20
77c5a659cd2d1aeee8fcadf073a7a549943f9e50...2a52182136085df4f6a6d9b46356c02ae84152bb,1,1,1,2,1,2012-01-25 22:11:52,2012-01-25 22:11:52
2a52182136085df4f6a6d9b46356c02ae84152bb...d9020e332a4e849093211e565ef5fb4edd294541,1,4,0,4,2,2012-01-25 23:31:48,2012-01-25 23:31:26
d9020e332a4e849093211e565ef5fb4edd294541...ba9733d36eec499d499881ebe338acceced4812e,1,2,2,4,1,2012-01-25 23:39:58,2012-01-25 23:39:58
ba9733d36eec499d499881ebe338acceced4812e...8e1f7f0964d5a75591615a5220ce80e539f5ee0e,1,4,1,5,1,2012-01-25 23:56:02,2012-01-25 23:56:02
8e1f7f0964d5a75591615a5220ce80e539f5ee0e...27f207582aec390aadebcc4ec0dabf77df78c003,1,4,4,8,2,2012-01-26 03:11:30,2012-01-26 03:10:34
27f207582aec390aadebcc4ec0dabf77df78c003...773a8eb74303533a29709bec5baa95c6a930ede7,1,2,2,4,2,2012-01-26 04:28:15,2012-01-26 04:28:15
773a8eb74303533a29709bec5baa95c6a930ede7...758ddac462836624b9fbac3f55a8ab2ea15089d7,1,8,2,10,2,2012-01-26 04:35:00,2012-01-26 04:35:00
758ddac462836624b9fbac3f55a8ab2ea15089d7...f79baf5a19ab3a06ea83a2dba482ae9a5e002b16,2,38,22,60,20,2012-01-26 09:04:18,2012-01-26 09:03:23
f79baf5a19ab3a06ea83a2dba482ae9a5e002b16...a9d08260ab23271ed849f2b1819d0ec202a297d0,1,1,1,2,1,2012-01-26 14:26:42,2012-01-26 14:23:04
a9d08260ab23271ed849f2b1819d0ec202a297d0...292c647305b6c41cb8c96be1ff5d213c97579809,2,3,3,6,2,2012-01-26 16:48:19,2012-01-26 15:13:02
292c647305b6c41cb8c96be1ff5d213c97579809...75b5ee69e55f94751d1cf6f31f4616c38a5abdfd,1,3,5,8,2,2012-01-26 16:53:13,2012-01-26 16:53:13
75b5ee69e55f94751d1cf6f31f4616c38a5abdfd...5273e69c6e20a4b4f73dba1f2608ec256f01d3ec,1,2,2,4,2,2012-01-26 20:14:09,2012-01-26 20:14:09
5273e69c6e20a4b4f73dba1f2608ec256f01d3ec...342c3c9e34a3f3926ceb308508d4d35996520441,1,4,1,5,1,2012-01-26 22:12:40,2012-01-26 22:12:31
342c3c9e34a3f3926ceb308508d4d35996520441...0810f68c74c6caeae7a811f9cd77440152fc3445,3,5,5,10,5,2012-01-26 23:06:13,2012-01-26 23:06:13
0810f68c74c6caeae7a811f9cd77440152fc3445...62f26893978ffe1dae12e7711a26a9646724c500,2,21,16,37,16,2012-01-26 23:25:50,2012-01-26 21:29:44
62f26893978ffe1dae12e7711a26a9646724c500...0f66d4037d400711a5dace3e3c0d96eabdd922e8,1,2,4,6,2,2012-01-26 23:25:50,2012-01-26 22:24:46
0f66d4037d400711a5dace3e3c0d96eabdd922e8...aab0ead2f9ad39f5e965ed20145b78561a8d8261,1,1,0,1,1,2012-01-27 13:05:57,2012-01-27 13:05:57
aab0ead2f9ad39f5e965ed20145b78561a8d8261...26b00169773291cab96bb36b01946f4f4fb16e9c,2,2,2,4,2,2012-01-27 13:15:21,2012-01-27 13:15:21
c82e2bbbc419c475c45ffdbe57bc5ec9b2eab4de...7979da8435ded0f52de27fbf678780d14804be2d,1,0,3,3,1,2011-05-25 20:58:35,2011-05-25 20:58:35
7979da8435ded0f52de27fbf678780d14804be2d...2809fd7c8631cf2b2e1615b179e7b58c38d78fa9,2,32,1,33,3,2011-05-26 05:35:48,2011-05-26 05:35:48
6bfc2d5d5ff748bf89f239ce0914052940e4998b...b0f0f07ef3c2ca56f5a7f5310a1e1295582e51e1,1,2,2,4,2,2011-06-17 02:38:05,2011-06-17 02:38:05
6bfc2d5d5ff748bf89f239ce0914052940e4998b...52d7736f73c78e70697c8b239eea4ecc24b9541b,2,42,2,44,4,2011-05-25 19:55:20,2011-05-25 19:55:20
52d7736f73c78e70697c8b239eea4ecc24b9541b...559f103ea0c2b479b07e2ba1a6c3b10997c7afa6,1,1,0,1,1,2011-05-25 20:00:48,2011-05-25 20:00:31
09c2b8d0202353e717eac942f71d3de6075a2ca2...a3da4d175dcedafdcbdc090bcae109c7126970af,1,3,2,5,3,2012-02-24 01:03:29,2012-02-24 01:03:29
a3da4d175dcedafdcbdc090bcae109c7126970af...44ce4fbfda47a36aeeacd40584910d15bbeeeefd,1,9,9,18,7,2012-02-24 03:06:18,2012-02-24 03:06:18
44ce4fbfda47a36aeeacd40584910d15bbeeeefd...a6878a451a047e9ed09038e9578299a0db4ba7fd,3,43,35,78,25,2012-02-26 20:14:55,2012-02-26 20:14:55
a6878a451a047e9ed09038e9578299a0db4ba7fd...7491daab6160ab135e5fb7dc65c1b47ae06afb4d,2,16,7,23,9,2012-02-27 14:53:23,2012-02-27 14:53:23
26b00169773291cab96bb36b01946f4f4fb16e9c...e0bacd9eb2f4adf77de61c21c5bce64c75a13509,1,5,0,5,1,2012-01-27 19:46:59,2012-01-27 19:46:36
e0bacd9eb2f4adf77de61c21c5bce64c75a13509...d841b9ea6a9161be9b8f0adad0905b091ce201d0,6,9,9,18,9,2012-01-27 21:54:10,2012-01-27 21:54:10
d841b9ea6a9161be9b8f0adad0905b091ce201d0...6a40af08608a412b30d8c75f29ad67e7ff1926c0,1,1,1,2,1,2012-01-30 05:58:42,2012-01-30 05:58:42
6a40af08608a412b30d8c75f29ad67e7ff1926c0...b9a602fa7c5e7b3f14825a4b7ccf0381fd6fb864,1,1,1,2,1,2012-01-30 16:53:26,2012-01-30 16:53:26
b9a602fa7c5e7b3f14825a4b7ccf0381fd6fb864...ef9684b7e0e6065b4b539205d2a23453f6f4f7b4,1,6,1,7,1,2012-01-30 17:50:30,2012-01-30 17:50:23
ef9684b7e0e6065b4b539205d2a23453f6f4f7b4...38399f723c6fb7a6de6f7ac1d57bd6f4490d7fb3,1,1,6,7,1,2012-01-30 20:43:19,2012-01-30 20:43:19
38399f723c6fb7a6de6f7ac1d57bd6f4490d7fb3...5cca648b607d438041aff206e1df44936110d28b,1,8,1,9,1,2012-01-30 20:43:45,2012-01-30 20:43:45
5cca648b607d438041aff206e1df44936110d28b...b86748469f151d147c2c40f68d5b02f7c49acc56,1,1,1,2,1,2012-01-30 20:59:39,2012-01-30 20:59:39
b86748469f151d147c2c40f68d5b02f7c49acc56...79c18c7270e12bc679403f31316064b96b495c64,1,5,1,6,2,2012-01-30 21:12:24,2012-01-30 21:12:24
79c18c7270e12bc679403f31316064b96b495c64...6a5269e37025ab957320a51717787187b1040bde,3,32,26,58,8,2012-01-31 07:58:59,2012-01-31 07:57:55
b93897317b3417d2908f555c2035bef43de03966...f1dd9b23f33a28ba04c34c7d2ed6ce5659ed5afc,1,3,3,6,3,2011-05-26 06:24:23,2011-05-26 06:24:23
559f103ea0c2b479b07e2ba1a6c3b10997c7afa6...5cc563b581ae6a438bd3b29dcb75facd6c3484d6,5,21,10,31,12,2011-05-26 00:41:40,2011-05-26 00:41:40
b701bc6eab8daf307c961873c5a7a9b1f021a119...c41ac1e1857eaeb3c31654471cbe17e842db6514,1,3,3,6,2,2012-02-27 23:13:28,2012-02-27 23:13:28
c41ac1e1857eaeb3c31654471cbe17e842db6514...1a64ebd9ea80d6c86b464459e34577d824c1f8b8,1,0,1,1,1,2012-02-27 23:14:50,2012-02-27 23:14:50
1a64ebd9ea80d6c86b464459e34577d824c1f8b8...c8b7edaf73a9f610614d458dee742cedca0f5fa1,1,6,1,7,1,2012-02-27 23:15:32,2012-02-27 23:15:32
6a5269e37025ab957320a51717787187b1040bde...7cb8cf6c3459bfda29eeae840aee708ceea22ed5,1,4,3,7,2,2012-01-31 15:32:54,2012-01-31 15:32:34
7cb8cf6c3459bfda29eeae840aee708ceea22ed5...e45cb6180280494f97eb5a0a2be32de56bc1644a,3,8,5,13,5,2012-02-01 03:26:34,2012-02-01 03:26:17
e45cb6180280494f97eb5a0a2be32de56bc1644a...3d908b6b00ccc403e19dd7dc3ba4e4ae41bd2516,1,1,1,2,1,2012-02-02 07:16:19,2012-02-02 07:16:19
3d908b6b00ccc403e19dd7dc3ba4e4ae41bd2516...3de6d8e2431109cd562b425d312c7f727024b9d1,1,1,1,2,1,2012-02-02 18:15:56,2012-02-02 18:15:56
3de6d8e2431109cd562b425d312c7f727024b9d1...263e3cc95f2282a860c7abe407031bb8ce59b405,1,13,0,13,1,2012-02-02 18:16:38,2012-02-02 18:16:38
263e3cc95f2282a860c7abe407031bb8ce59b405...64f361b5522c03fec43e24d12f23b075f2a31b3b,1,15,0,15,1,2012-02-02 18:16:53,2012-02-02 18:16:53
64f361b5522c03fec43e24d12f23b075f2a31b3b...4c0962e586bff51433afe658c26a94ee30c4f78c,1,2,1,3,1,2012-02-02 18:40:34,2012-02-02 18:39:16
4c0962e586bff51433afe658c26a94ee30c4f78c...c9ea81028d9f4aab389b402aab91eb49805710ca,1,24,24,48,6,2012-02-02 18:54:10,2012-02-02 16:33:12
c9ea81028d9f4aab389b402aab91eb49805710ca...a85185d5d04891618862f81b1b40991f76e2fdbc,1,11,0,11,1,2012-02-02 18:54:10,2012-02-02 18:52:34
a85185d5d04891618862f81b1b40991f76e2fdbc...4939423b952bebc002f252e973e740bdc259cf41,1,4,1,5,1,2012-02-02 20:56:01,2012-02-02 20:56:01
4939423b952bebc002f252e973e740bdc259cf41...9848a9cb4ea01f2ceecdb5cebc7ffa8a9bea59b6,1,1,4,5,1,2012-02-02 21:44:26,2012-02-02 21:44:26
9848a9cb4ea01f2ceecdb5cebc7ffa8a9bea59b6...d2cb8eaf8602276e889509fff7e8fcd90a65b299,1,7,0,7,2,2012-02-03 14:28:19,2012-02-03 14:28:19
d2cb8eaf8602276e889509fff7e8fcd90a65b299...20761c191e5b609cbfc00a0bee8488d077f643ba,1,7,2,9,3,2012-02-03 14:28:35,2012-02-03 14:28:35
20761c191e5b609cbfc00a0bee8488d077f643ba...d674c681170337e3dfc34ae796b06fdde5ac05dd,4,9,3,12,4,2012-02-03 14:32:28,2012-02-03 14:32:28
d674c681170337e3dfc34ae796b06fdde5ac05dd...ff46720d98d923116ee71ae1e154500c62065506,2,2,2,4,2,2012-02-03 22:52:26,2012-02-03 22:52:26
ff46720d98d923116ee71ae1e154500c62065506...b86ff6665b7f37bb40119888c8560e5c3f9b6633,1,1,2,3,2,2012-02-03 22:52:36,2012-02-03 22:52:36
6a5269e37025ab957320a51717787187b1040bde...01d17fa1c582c915e5df324a3144618a8e0719f1,1,6,3,9,5,2012-01-31 15:07:42,2012-01-31 15:07:42
b2938d9d0dd1f07a165e2b3f7d9350da7921033f...c775f5f250f9daa9bad803f738a5f6f351f4ca15,2,27,20,47,6,2011-05-26 22:27:47,2011-05-26 22:26:38
b2938d9d0dd1f07a165e2b3f7d9350da7921033f...2c8088f1802ada9780765d05cbc41c2c744cbb0b,14,37,37,74,37,2011-05-26 09:59:13,2011-05-26 09:59:13
2c8088f1802ada9780765d05cbc41c2c744cbb0b...911f80cd1dc9cdcb0343fe7cab2187e3b88430b6,1,1,1,2,1,2011-05-26 10:03:34,2011-05-26 10:03:34
843fe5a0429edaffc270d900e9aae66ae284b881...05dd56e28af544e98a800540baf5ef27cd4e43cb,3,1,1,2,1,2011-06-17 14:54:27,2011-06-17 14:54:27
05dd56e28af544e98a800540baf5ef27cd4e43cb...aea062efc6d8d0b4ffa3554cafc3414b17c7cb9d,2,0,2,2,2,2011-06-17 15:28:36,2011-06-17 15:28:36
aea062efc6d8d0b4ffa3554cafc3414b17c7cb9d...51a2949fa507c897d72f883765af46871c127f38,2,2,0,2,2,2011-06-17 15:29:12,2011-06-17 15:29:12
51a2949fa507c897d72f883765af46871c127f38...b469716f242f2af16b5a7503f2c9fbbbb05bddb0,1,7,0,7,1,2011-06-17 16:06:18,2011-06-17 16:06:18
b469716f242f2af16b5a7503f2c9fbbbb05bddb0...6c99d204c1bad3f8585d6b751040ef2ea107ec77,5,16,1,17,6,2011-06-17 18:57:16,2011-06-17 18:57:16
5cc563b581ae6a438bd3b29dcb75facd6c3484d6...1e252e05ea16a97e9ae44064a766dc2e9acd2168,1,3,3,6,2,2011-05-26 06:13:39,2011-05-26 06:13:39
c8b7edaf73a9f610614d458dee742cedca0f5fa1...49faa78ea1210f3b0e237687c17f6d270215187d,2,16,3,19,7,2012-02-28 14:47:21,2012-02-28 14:47:21
c8b7edaf73a9f610614d458dee742cedca0f5fa1...74f6973e4151bedadcf8bbfa0b950855ac30c9ec,3,18,22,40,20,2012-02-28 03:30:43,2012-02-28 03:30:43
74f6973e4151bedadcf8bbfa0b950855ac30c9ec...6add165f2a83107310e97619e84fdc51d0996cad,1,1,1,2,1,2012-02-28 04:13:24,2012-02-28 04:13:24
6add165f2a83107310e97619e84fdc51d0996cad...b13d1d0576608bdb28a60a35ab0455a8de180827,1,1,2,3,2,2012-02-28 13:33:15,2012-02-28 13:33:15
b13d1d0576608bdb28a60a35ab0455a8de180827...de2d80dedc54fed50544f6d6505300f8db977ff3,1,3,1,4,1,2012-02-28 14:24:10,2012-02-28 14:24:10
b86ff6665b7f37bb40119888c8560e5c3f9b6633...4743224055e1bff95c4e613825f17f9f2f2a26bd,1,4,4,8,1,2012-02-06 05:20:21,2012-02-06 05:20:21
4743224055e1bff95c4e613825f17f9f2f2a26bd...b0bfda95ff1fd213562bddded908ebd63b9be51c,1,1,1,2,1,2012-02-06 05:20:39,2012-02-06 05:20:39
b0bfda95ff1fd213562bddded908ebd63b9be51c...07da19cd4dd4372765dcce8ad483d7cab8e3d8fa,1,1,2,3,2,2012-02-06 05:45:21,2012-02-06 05:36:03
07da19cd4dd4372765dcce8ad483d7cab8e3d8fa...2b3445897998b1315fd42b432f8c9a6b3b1b6b63,1,5,1,6,2,2012-02-06 05:45:21,2012-02-06 05:42:25
2b3445897998b1315fd42b432f8c9a6b3b1b6b63...f4bfa7195da14643865821aaa3b54cb44881eaff,1,2,1,3,2,2012-02-06 05:45:21,2012-02-06 05:45:03
f4bfa7195da14643865821aaa3b54cb44881eaff...b722567affe6ae082af56e56349d2c67bff26ade,1,35,0,35,3,2012-02-06 17:51:02,2012-01-31 00:32:35
b722567affe6ae082af56e56349d2c67bff26ade...253956de2b74972da373aca11a78f50e1601b086,2,22,1,23,5,2012-02-06 17:51:02,2012-02-02 22:47:07
253956de2b74972da373aca11a78f50e1601b086...f8aa270ed947d969bcc76d9a0e15991a529761ca,1,59,57,116,11,2012-02-06 17:51:02,2012-02-01 19:17:21
f8aa270ed947d969bcc76d9a0e15991a529761ca...7307413888d153d062d5ddc0a26e058bdcc453a5,3,75,58,133,15,2012-02-06 19:24:49,2012-02-06 17:42:58
7307413888d153d062d5ddc0a26e058bdcc453a5...78520fda45035bbdb1af6bc84ead2cde99f6c6eb,1,3,3,6,1,2012-02-06 20:48:39,2012-02-06 20:48:39
78520fda45035bbdb1af6bc84ead2cde99f6c6eb...3078b6e9b25eab8883d546081bffe614c4d1c4c3,1,1,1,2,1,2012-02-06 20:56:59,2012-02-06 20:56:59
3078b6e9b25eab8883d546081bffe614c4d1c4c3...712c4f888b39ac71f66b452685638acfb3b55665,1,13,5,18,7,2012-02-06 21:59:17,2012-02-06 21:59:17
712c4f888b39ac71f66b452685638acfb3b55665...baf02d5e260ba46a3fe8792190f37627aba47f39,2,33,2,35,5,2012-02-06 22:10:39,2012-02-06 22:03:10
baf02d5e260ba46a3fe8792190f37627aba47f39...a950ba5fc7e48a92120ac94dff16c0d2de657285,2,39,0,39,2,2012-02-06 22:51:40,2012-02-06 22:51:40
a950ba5fc7e48a92120ac94dff16c0d2de657285...b1d820cfc34c1b43ab0e109445e6e9bc35606f98,1,1,1,2,1,2012-02-06 23:55:48,2012-02-06 23:55:30
7ee0d0d8d1348a7f40e2fde95367bd81c7ac096c...704e3a06258f32837879d952e732a206745e3d87,1,2,2,4,1,2012-03-04 01:20:51,2012-03-04 01:20:51
704e3a06258f32837879d952e732a206745e3d87...ad7deaa8818c95f2c590232a8a73e71441413e21,1,18,21,39,3,2012-03-04 18:46:15,2012-03-04 18:46:15
ad7deaa8818c95f2c590232a8a73e71441413e21...231ffceb86cb2f5b2c355f3e43e6eb524c244bec,2,25,2,27,6,2012-03-04 21:19:44,2012-03-02 18:55:53
231ffceb86cb2f5b2c355f3e43e6eb524c244bec...077765f03bc034836eedb630a39226cf38bd024f,2,14,1,15,4,2012-03-05 04:07:32,2012-03-05 04:07:32
c775f5f250f9daa9bad803f738a5f6f351f4ca15...284af81234941890b9ba06072886d1f248df4aaf,6,93,20,113,25,2011-05-27 04:49:47,2011-05-27 04:49:47
c775f5f250f9daa9bad803f738a5f6f351f4ca15...453a586af67dab0d1886184c7cca01b0a3d01926,1,5,3,8,3,2011-05-27 01:23:23,2011-05-27 01:23:23
453a586af67dab0d1886184c7cca01b0a3d01926...8fd5eeb9e94d5267bd5d0c6128d2f801326a3dec,2,3,1,4,2,2011-05-27 02:22:40,2011-05-27 02:22:40
8fd5eeb9e94d5267bd5d0c6128d2f801326a3dec...e964a32acbe07cba8e6a8959f1907ea5069c41b4,1,1,1,2,1,2011-05-27 02:28:13,2011-05-27 02:28:13
2bfa1817b5316ab7e6bd81e803e6cdebe88a6f98...24e8d8f08cdef384ca48f19c6d4b1f568d7cee71,1,1,1,2,1,2011-05-27 09:41:11,2011-05-27 09:41:11
24e8d8f08cdef384ca48f19c6d4b1f568d7cee71...953a3e7a4114a300d9dea0118868f286a3f1e8d0,1,1,1,2,1,2011-05-27 09:44:07,2011-05-27 09:44:07
6c99d204c1bad3f8585d6b751040ef2ea107ec77...c619fcb83ea7500da0388ae083d507eb6c839b6d,1,22,2,24,5,2011-06-18 16:33:43,2011-06-18 16:33:43
6c99d204c1bad3f8585d6b751040ef2ea107ec77...3eb1de47f1d19d96ae9facba2afd7e499f90cb7e,1,1,0,1,1,2011-06-17 21:28:40,2011-06-17 21:28:40
6960b2ce37b301f3e4684c27a6b95b7f413dd919...95b58dea790f1cc7e7d5bb0e93c5ff5986bfbeec,2,5,29,34,15,2012-02-28 22:27:29,2012-02-28 22:27:29
95b58dea790f1cc7e7d5bb0e93c5ff5986bfbeec...ebeba7866b46a438877f25dc16d878f8d708c3eb,7,66,65,131,25,2012-02-28 22:28:49,2012-02-28 22:28:49
ebeba7866b46a438877f25dc16d878f8d708c3eb...4f33a5d8bb5925b81cf22c7b510f1d786889c495,1,5,3,8,4,2012-02-28 23:30:16,2012-02-28 23:30:16
4f33a5d8bb5925b81cf22c7b510f1d786889c495...42a00d27e33ac5b40b4f1e5aa456432f98b8a654,2,13,8,21,8,2012-02-29 14:34:36,2012-02-29 14:34:36
42a00d27e33ac5b40b4f1e5aa456432f98b8a654...f9c66d821ae74a6e3bac851c3b8e66836f4cc9a6,8,33,4,37,16,2012-02-29 17:26:22,2012-02-29 17:26:22
f9c66d821ae74a6e3bac851c3b8e66836f4cc9a6...2ca325c8818c2cb8c86889cf59264bdff7f3dd59,1,5,5,10,4,2012-02-29 18:07:02,2012-02-29 18:07:02
2ca325c8818c2cb8c86889cf59264bdff7f3dd59...968e5e46af4f1f8a7e102b640554cb0f9698cb18,2,70,47,117,15,2012-02-29 21:18:57,2012-02-29 21:18:57
968e5e46af4f1f8a7e102b640554cb0f9698cb18...887c244b4e8a5d8d9c98a84442583f95b78a7159,5,32,10,42,11,2012-02-29 21:40:17,2012-02-29 21:40:17
b1d820cfc34c1b43ab0e109445e6e9bc35606f98...0a2f176644fd5fe07a90a89bd4df519545fa12d5,2,22,4,26,6,2012-02-07 03:40:11,2012-01-25 03:57:44
0a2f176644fd5fe07a90a89bd4df519545fa12d5...5c51318158191a1fcac6ece8489b222060a3c1ee,1,7,2,9,5,2012-02-07 04:20:02,2012-01-25 04:01:03
5c51318158191a1fcac6ece8489b222060a3c1ee...f5f171a0b41db08c122844aacaf81fb9be5f0240,1,10,0,10,2,2012-02-07 06:12:26,2012-01-25 21:31:41
f5f171a0b41db08c122844aacaf81fb9be5f0240...366b3dbd3b27890ae23814400b89053e5d5b120a,2,14,10,24,3,2012-02-07 06:12:26,2012-01-25 22:14:50
366b3dbd3b27890ae23814400b89053e5d5b120a...a4f471953d6c1ce8f615dbfdb2999afb29a0654c,1,10,0,10,2,2012-02-07 06:12:26,2012-01-25 22:16:49
a4f471953d6c1ce8f615dbfdb2999afb29a0654c...4ad6e3c6b0e08a877cccf476ffa0c7fa694c2452,1,2,4,6,2,2012-02-07 06:12:26,2012-01-25 22:40:46
4ad6e3c6b0e08a877cccf476ffa0c7fa694c2452...5750a5b7a1b7bb5ae495534f9228d5773c28db4b,2,91,0,91,2,2012-02-07 06:12:26,2012-01-26 04:55:25
5750a5b7a1b7bb5ae495534f9228d5773c28db4b...97c194fc3d3ab1773d4a6edc8c0fa540a154a62f,2,5,4,9,5,2012-02-07 06:12:26,2012-01-27 19:49:47
97c194fc3d3ab1773d4a6edc8c0fa540a154a62f...65e2ffc8d28e46148593512fbb976e970fbf2a52,1,4,0,4,2,2012-02-07 06:12:26,2012-02-06 05:44:04
65e2ffc8d28e46148593512fbb976e970fbf2a52...2f3d38360432bed89eccb8e0bbd535fd9bbf76d2,1,2,2,4,2,2012-02-07 06:12:27,2012-01-26 19:57:07
2f3d38360432bed89eccb8e0bbd535fd9bbf76d2...f86562d58757c6cc9f3378456e77f8fc9d3916c5,5,311,25,336,18,2012-02-07 06:12:27,2012-01-27 07:56:49
f86562d58757c6cc9f3378456e77f8fc9d3916c5...dd6da27e3290febad8214aa4f833dc7f7ed24b3c,1,1,1,2,1,2012-02-07 06:12:27,2012-01-27 07:58:33
dd6da27e3290febad8214aa4f833dc7f7ed24b3c...225bb5d3dbe26acd73eb8258b9b6ccf9de5184a6,1,7,1,8,2,2012-02-07 06:12:27,2012-01-27 08:01:08
225bb5d3dbe26acd73eb8258b9b6ccf9de5184a6...96c74898b9602e34609e78c2ea46115522e56784,1,6,2,8,1,2012-02-07 06:12:27,2012-01-27 08:02:44
96c74898b9602e34609e78c2ea46115522e56784...db19b8864f4e8c6591ea017e2d6d8b4026a449ab,1,14,13,27,9,2012-02-07 06:12:27,2012-01-30 18:12:12
db19b8864f4e8c6591ea017e2d6d8b4026a449ab...9d86d5290fa8a13ac803c783311fea03702e6970,1,22,0,22,1,2012-02-07 06:12:27,2012-01-31 06:20:40
9d86d5290fa8a13ac803c783311fea03702e6970...1578b86d2e6ece9c60b69d8a2db84d9da07d459f,1,2,0,2,2,2012-02-07 06:12:27,2012-01-31 06:27:26
1578b86d2e6ece9c60b69d8a2db84d9da07d459f...e5d3da81edd6d094678afa6a93a761389c2b2702,4,67,8,75,9,2012-02-07 06:12:28,2012-01-31 04:07:38
e5d3da81edd6d094678afa6a93a761389c2b2702...a3147b4cf2a8abf94d5eb420252beee6355fd01e,1,3,2,5,1,2012-02-07 06:12:28,2012-02-06 05:12:00
a3147b4cf2a8abf94d5eb420252beee6355fd01e...da48652a4375bc226c8c741263da06040f814e19,1,2,2,4,2,2012-02-07 06:12:28,2012-02-06 05:15:14
da48652a4375bc226c8c741263da06040f814e19...b55c9c3383a4316e21bff5da043647c73cdae6bb,2,0,47,47,2,2012-02-07 06:12:28,2012-02-06 05:25:37
b55c9c3383a4316e21bff5da043647c73cdae6bb...36957279f3d0b4b877684e12f228ef8b52326a8e,1,1,1,2,1,2012-02-07 06:12:28,2012-02-06 05:26:20
36957279f3d0b4b877684e12f228ef8b52326a8e...0fdb897f8eb47056fc213e66203563b80310dd4b,1,1,2,3,2,2012-02-07 06:12:28,2012-02-06 05:58:38
0fdb897f8eb47056fc213e66203563b80310dd4b...1a0af437eae2962d3de9298593291b9e28c62777,2,2,2,4,2,2012-02-07 06:17:06,2012-02-07 06:17:06
1a0af437eae2962d3de9298593291b9e28c62777...81c85b3df1b1db791965e5e33488a3343df742f5,1,1,0,1,1,2012-02-07 06:32:16,2012-02-07 06:32:16
81c85b3df1b1db791965e5e33488a3343df742f5...7b9fe4a2ef6460eaa19859ef825b00fdd583fcce,1,5,13,18,7,2012-02-07 12:39:21,2012-02-07 12:38:17
7b9fe4a2ef6460eaa19859ef825b00fdd583fcce...aff9725924d34487b4892df5cdcb6e6cc6d314b5,1,1,1,2,1,2012-02-07 17:38:19,2012-02-07 17:09:22
aff9725924d34487b4892df5cdcb6e6cc6d314b5...bad7a2b9599c4606112b1695a16c3a111e188ea3,1,2,1,3,2,2012-02-07 17:38:19,2012-02-07 17:12:52
bad7a2b9599c4606112b1695a16c3a111e188ea3...a4173c1e6ab92b3f0bf6e4e87ce67cb9faedfa86,1,2,1,3,2,2012-02-07 17:38:19,2012-02-07 17:15:03
a4173c1e6ab92b3f0bf6e4e87ce67cb9faedfa86...f0e4452fdf583c321770d721c726d5d78e832ea5,2,0,39,39,2,2012-02-07 19:39:58,2012-02-07 19:39:58
f0e4452fdf583c321770d721c726d5d78e832ea5...7ce95709fe1c4a8ba9b27236ea1e9fcd15d31b2b,2,19,12,31,7,2012-02-08 05:28:53,2012-02-07 21:33:08
7ce95709fe1c4a8ba9b27236ea1e9fcd15d31b2b...8294769d840677b813f443e58f1b73ced6dfcdb1,1,14,3,17,2,2012-02-08 16:10:29,2012-02-08 16:10:18
8294769d840677b813f443e58f1b73ced6dfcdb1...0b0a55509ed8fe26144e62f1476247478c6a2a53,1,4,1,5,1,2012-02-08 16:24:26,2012-02-08 14:44:27
0b0a55509ed8fe26144e62f1476247478c6a2a53...46d33235a2285f83d904b9290f2cee02d9bb333b,1,22,6,28,9,2012-02-08 16:39:32,2012-02-07 15:31:26
46d33235a2285f83d904b9290f2cee02d9bb333b...6f4af26b12224fe67ff99a87c082766169010662,1,3,3,6,1,2012-02-08 16:44:17,2012-02-08 16:44:17
6f4af26b12224fe67ff99a87c082766169010662...457b57fb2c48ceba3ba15817071a54dde072c412,1,34,8,42,4,2012-02-08 16:48:07,2012-02-08 16:48:07
457b57fb2c48ceba3ba15817071a54dde072c412...fe9a9d0080c4e036c181f0f74cc3852aaad02d4c,1,1,0,1,1,2012-02-08 19:02:33,2012-02-08 19:02:19
fe9a9d0080c4e036c181f0f74cc3852aaad02d4c...831bbe7dbf18ecab0a3b805393fc7ff0a634668b,3,4,3,7,3,2012-02-08 22:14:44,2012-02-08 22:14:44
831bbe7dbf18ecab0a3b805393fc7ff0a634668b...010488f6351acd460dcdcaad1919151e6bb50fa2,5,62,20,82,7,2012-02-09 02:13:45,2012-02-02 19:52:50
010488f6351acd460dcdcaad1919151e6bb50fa2...7fd5cf76c47a84844c51d33c9bc9d5dfc0303660,1,1,1,2,1,2012-02-09 14:45:09,2012-02-09 14:45:09
7fd5cf76c47a84844c51d33c9bc9d5dfc0303660...19bf4dbd9d632aaf3c91792e11ef6782f22f09c9,2,42,0,42,2,2012-02-09 15:27:37,2012-02-08 21:04:08
19bf4dbd9d632aaf3c91792e11ef6782f22f09c9...c1a2188dfb122c34baece5275b6fa1d446a86319,1,5,5,10,1,2012-02-09 16:18:08,2012-02-09 16:11:12
c1a2188dfb122c34baece5275b6fa1d446a86319...0aaf41a410c1b257309dc20be058d1c8a8e33d57,7,44,30,74,29,2012-02-09 16:34:04,2012-02-09 16:33:28
0aaf41a410c1b257309dc20be058d1c8a8e33d57...0ada9757bd3b79c19e1d643e53c91be6f5fe2cc0,2,9,9,18,6,2012-02-09 19:58:55,2012-02-09 19:58:55
0ada9757bd3b79c19e1d643e53c91be6f5fe2cc0...656caeacc59470be383ce442ac8905b5cd1230c0,1,12,3,15,3,2012-02-09 20:47:38,2012-02-09 20:44:07
656caeacc59470be383ce442ac8905b5cd1230c0...40e869df755b6c8107f2cda92cf34a12e24948de,2,4,1,5,2,2012-02-09 22:42:43,2012-02-09 22:36:00
40e869df755b6c8107f2cda92cf34a12e24948de...5b7abd2b0e3daaae22d5c4ad356979a0abdfde0e,1,1,1,2,1,2012-02-09 22:57:49,2012-02-07 18:13:30
5b7abd2b0e3daaae22d5c4ad356979a0abdfde0e...af663932ba6aeb3e17ed298e971b68ade9286e19,2,2,2,4,2,2012-02-09 22:57:49,2012-02-07 22:33:45
af663932ba6aeb3e17ed298e971b68ade9286e19...5c1fab4a1fe4a97cd54bd31ff0f536a7821aa1ed,2,15,13,28,7,2012-02-09 22:57:49,2012-02-08 00:31:06
5c1fab4a1fe4a97cd54bd31ff0f536a7821aa1ed...936fea78727ca9026ce35d6afb8896509ee6e273,5,28,6,34,10,2012-02-09 22:57:49,2012-02-09 21:09:06
936fea78727ca9026ce35d6afb8896509ee6e273...1eb864980b70545359eb8db355adc772f0e1c026,2,4,4,8,3,2012-02-09 22:57:49,2012-02-09 21:28:33
1eb864980b70545359eb8db355adc772f0e1c026...74c1ffb05d5d5fc274897deaa57aae3846db0ee7,5,6,6,12,6,2012-02-09 22:57:49,2012-02-09 22:00:47
74c1ffb05d5d5fc274897deaa57aae3846db0ee7...3bc8e32a19f62911224d622ef2dfaacee64e548e,1,1,4,5,2,2012-02-09 22:57:49,2012-02-09 22:13:49
3bc8e32a19f62911224d622ef2dfaacee64e548e...0e11df0b41db7802dc3565a7a666f6af1a9e4b93,1,4,2,6,3,2012-02-09 22:57:49,2012-02-09 22:35:06
0e11df0b41db7802dc3565a7a666f6af1a9e4b93...550c8441917b58b5f09367ee28765c5bf6c0ec0a,1,22,0,22,2,2012-02-10 01:57:36,2012-02-10 01:57:36
550c8441917b58b5f09367ee28765c5bf6c0ec0a...44d83c9ce8c3ac289b07c14550a4b0143397e6c4,1,2,1,3,2,2012-02-10 13:48:31,2012-02-10 13:45:57
44d83c9ce8c3ac289b07c14550a4b0143397e6c4...abc3e0cb35c4ab0e837936e04f378c1d963c849b,9,90,39,129,39,2012-02-10 15:16:58,2012-02-09 22:16:45
abc3e0cb35c4ab0e837936e04f378c1d963c849b...f4fe880d51db66ff6e7a5513350c9495ad9dac69,1,0,2,2,1,2012-02-10 18:10:25,2012-02-10 18:10:17
f4fe880d51db66ff6e7a5513350c9495ad9dac69...516bace9e92c78ab0765dbaf6c0b4daac88f916e,1,4,0,4,1,2012-02-10 21:14:56,2012-02-10 21:10:00
516bace9e92c78ab0765dbaf6c0b4daac88f916e...a617e02102f99af67d14841bff89034283d5c41f,3,11,22,33,11,2012-02-10 22:04:13,2012-01-31 20:48:35
b4fd27012d06c3cba4242dd0b73f57f6f211f63a...dbbb069e06c1f8c424f202d3ff95b0ff8afb15f9,1,7,7,14,7,2011-05-27 05:06:43,2011-05-27 05:06:25
dbbb069e06c1f8c424f202d3ff95b0ff8afb15f9...c2a6654951e7476c74d42eddd73f05205d9524fa,1,1,1,2,1,2011-05-27 05:12:00,2011-05-27 05:12:00
0d4db0b5b077f782e8b43727d65a8dbd79cf7791...d5decb0b6926527105da2b9f05104cf015e9f51d,1,8,8,16,3,2011-06-16 02:54:37,2011-06-14 04:03:11
d5decb0b6926527105da2b9f05104cf015e9f51d...41a2c33bb15a53fdd6b72695c16d5474228cd4a2,1,7,5,12,1,2011-06-16 03:00:39,2011-06-16 03:00:39
41a2c33bb15a53fdd6b72695c16d5474228cd4a2...e47444fe42150ef32918ce497091eda9ea4382c7,1,1,1,2,1,2011-06-16 03:26:29,2011-06-16 03:26:29
e47444fe42150ef32918ce497091eda9ea4382c7...0b32ad4e6d5629525001add932fe78ba517cb503,10,296,110,406,57,2011-06-16 04:03:04,2011-06-15 04:30:06
0b32ad4e6d5629525001add932fe78ba517cb503...d4b71c4756a72698a17ea97c5f408565ffd79c72,7,186,186,372,109,2011-06-16 04:03:06,2011-06-15 05:29:55
d4b71c4756a72698a17ea97c5f408565ffd79c72...d7908f6e0daab547c5ecde9417db8a153ac640eb,2,15,22,37,11,2011-06-16 04:03:06,2011-06-15 23:09:12
d7908f6e0daab547c5ecde9417db8a153ac640eb...fc3f8343201cabcc1a5c99b7f6a12f5c25647b9b,3,12,6,18,8,2011-06-16 04:03:06,2011-06-15 23:22:32
fc3f8343201cabcc1a5c99b7f6a12f5c25647b9b...0956da450ca059cbee3a98c12e28aa67c6abaed7,1,10,1,11,1,2011-06-16 04:03:06,2011-06-15 23:38:38
0956da450ca059cbee3a98c12e28aa67c6abaed7...6646b9024f755ea666b5e9a5660e6c55d3705a3a,1,33,0,33,5,2011-06-16 04:03:06,2011-06-16 00:24:29
6646b9024f755ea666b5e9a5660e6c55d3705a3a...666397744ecbcfd1237ffe1dd454e1502ab3f60b,1,46,2,48,3,2011-06-16 04:03:06,2011-06-16 00:32:00
666397744ecbcfd1237ffe1dd454e1502ab3f60b...0df4254ad55f971f153d6584013721c8ea1f8bbe,3,18,0,18,3,2011-06-16 04:03:06,2011-06-16 04:02:49
0df4254ad55f971f153d6584013721c8ea1f8bbe...dbc1ee21f16a6bb1fefac39204daf03946008ddc,1,2,1,3,1,2011-06-16 05:56:02,2011-06-16 05:56:02
57855de953f7ed92ca1795d790a07b59f1f65bc3...a3f0217f3751712ea9c69cfcd4e063f0737556a1,1,18,2,20,5,2011-06-18 18:27:21,2011-06-18 18:27:21
a3f0217f3751712ea9c69cfcd4e063f0737556a1...d7c10675a2291af0bfcca387d2d2e47c8e092aed,1,1,2,3,1,2011-06-18 18:28:39,2011-06-18 18:28:39
d7c10675a2291af0bfcca387d2d2e47c8e092aed...aa6307640e83eae9ed9a74ef2edb49ec0e33ddea,2,4,0,4,2,2011-06-18 19:39:42,2011-06-18 19:39:42
aa6307640e83eae9ed9a74ef2edb49ec0e33ddea...e95cab54294452b8e71cf6cc4fff4befec701bd9,1,10,3,13,3,2011-06-18 19:40:28,2011-06-18 19:40:28
2d888db10f468a9fcd1378c08703608bcf690ac1...50597bc35392e6d7c510617ea37885fcd7cb68a1,1,0,7,7,1,2012-03-01 17:40:26,2012-03-01 17:40:26
50597bc35392e6d7c510617ea37885fcd7cb68a1...7d43295f50f95ff36a4a23b0a53c4486fecd33e9,1,11,6,17,5,2012-03-01 18:04:16,2012-03-01 18:04:16
7d43295f50f95ff36a4a23b0a53c4486fecd33e9...fae090715e954247ab66adae44f521912a94ab5e,1,1,1,2,1,2012-03-01 22:30:46,2012-03-01 22:30:46
fae090715e954247ab66adae44f521912a94ab5e...c648fea15b1dfa3c005ec5aba09a522b86270638,2,46,23,69,17,2012-03-01 22:31:32,2012-03-01 22:31:32
c648fea15b1dfa3c005ec5aba09a522b86270638...df373d4ec0b8225f7c62f33040c12092bb9f0d1a,8,48,19,67,26,2012-03-01 22:32:23,2012-03-01 22:32:23
a617e02102f99af67d14841bff89034283d5c41f...b1d52e52466fc283ebcfcab1c586cc8eb4bf5373,2,4,0,4,2,2012-02-11 03:08:13,2012-02-11 03:08:13
b1d52e52466fc283ebcfcab1c586cc8eb4bf5373...408bdeb3ca7e820e2ac1c32454e21e65cbdf9179,3,10,1,11,4,2012-02-12 19:49:38,2012-02-12 19:49:38
408bdeb3ca7e820e2ac1c32454e21e65cbdf9179...921c3d74f30927ff49261cf79266fbbc9f37901a,1,39,0,39,1,2012-02-12 23:48:32,2012-02-12 23:48:32
921c3d74f30927ff49261cf79266fbbc9f37901a...dffb612e61e7331bcb2b3343faa0bf2fcecd227d,1,45,0,45,1,2012-02-12 23:52:02,2012-02-12 23:52:02
dffb612e61e7331bcb2b3343faa0bf2fcecd227d...8c13962e6878a9dd8de81ca7cebb729e9cc3ac43,1,37,0,37,1,2012-02-12 23:54:42,2012-02-12 23:54:42
8c13962e6878a9dd8de81ca7cebb729e9cc3ac43...9328dc4472192cccb4bfd8919d09c6b5f19cad95,1,40,0,40,1,2012-02-12 23:56:43,2012-02-12 23:56:43
9328dc4472192cccb4bfd8919d09c6b5f19cad95...48c1fe51df8736f12be2954e61d9516f25cb2b46,1,39,0,39,1,2012-02-12 23:58:35,2012-02-12 23:58:35
48c1fe51df8736f12be2954e61d9516f25cb2b46...ff08bdf03056665a1cc8366afe7de73cb1c237f8,1,41,0,41,1,2012-02-12 23:59:53,2012-02-12 23:59:53
ff08bdf03056665a1cc8366afe7de73cb1c237f8...61c3988d373a3e2d497feb577a4f9a6da334d938,1,39,0,39,1,2012-02-13 00:01:33,2012-02-13 00:01:33
61c3988d373a3e2d497feb577a4f9a6da334d938...3783f485e4e0447f5edf912b23aa402d35729883,3,1,10,11,4,2012-02-13 00:21:08,2012-02-13 00:21:08
3783f485e4e0447f5edf912b23aa402d35729883...72da0fd4c503b11069f4f76ffd0cd74e26bec2de,2,0,73,73,2,2012-02-13 00:46:49,2012-02-09 21:52:26
72da0fd4c503b11069f4f76ffd0cd74e26bec2de...7def59b99e68b9b3e7d8e3293d7ac35fa37209b1,1,10,4,14,2,2012-02-13 00:46:50,2012-02-09 23:46:14
7def59b99e68b9b3e7d8e3293d7ac35fa37209b1...ba1ac9effdd92b5e5ac4ed8b0163fcca886d096c,1,21,0,21,2,2012-02-13 00:46:50,2012-02-10 05:01:20
ba1ac9effdd92b5e5ac4ed8b0163fcca886d096c...0efb82fe712803b8224402ff2179f4b47cd9a1b6,6,58,56,114,45,2012-02-13 00:46:50,2012-02-11 06:08:19
0efb82fe712803b8224402ff2179f4b47cd9a1b6...928c5b01469aa08570fb71669e6488d1287adac1,1,1,1,2,1,2012-02-13 00:46:50,2012-02-11 06:56:46
928c5b01469aa08570fb71669e6488d1287adac1...e7504b9679ebf7101ff55b0cc2cf9c4967673381,13,441,152,593,63,2012-02-13 00:46:50,2012-02-11 19:37:39
e7504b9679ebf7101ff55b0cc2cf9c4967673381...eff60f45d5a065ea95b3e25e481ada409be510aa,1,1,1,2,1,2012-02-13 00:46:50,2012-02-12 23:12:28
eff60f45d5a065ea95b3e25e481ada409be510aa...df70f029d76c23936be2e249eeb70bf6f61c5679,1,1,1,2,1,2012-02-13 00:46:50,2012-02-12 23:13:30
df70f029d76c23936be2e249eeb70bf6f61c5679...56d69364400d4305413dc4bb63de9180116ef51a,1,1,1,2,1,2012-02-13 00:46:50,2012-02-13 00:36:15
56d69364400d4305413dc4bb63de9180116ef51a...43da6ce816036f436c27e8ec2bd58ca6d90f7ceb,1,5,5,10,5,2012-02-13 01:43:08,2012-02-13 01:43:08
43da6ce816036f436c27e8ec2bd58ca6d90f7ceb...5e7fa6106076ba1bc9f3b7da7505c25ed4edd65e,1,0,4,4,2,2012-02-13 01:43:21,2012-02-13 01:43:21
5e7fa6106076ba1bc9f3b7da7505c25ed4edd65e...cb8802de90caae91ee64fc2e94bb3f2a83d5959a,1,0,2,2,1,2012-02-13 04:04:31,2012-02-13 04:04:31
cb8802de90caae91ee64fc2e94bb3f2a83d5959a...7423b1654afef8aaadd54ba9fb03c0868f5b15ec,1,3,0,3,3,2012-02-13 04:09:48,2012-02-13 04:09:48
7423b1654afef8aaadd54ba9fb03c0868f5b15ec...d8433150b2b30d49d4a32ba4e47b3ec10d60851d,1,1,3,4,1,2012-02-13 04:47:46,2012-02-13 04:47:46
d8433150b2b30d49d4a32ba4e47b3ec10d60851d...3fcb1684251705eb159b5647b66ece2a455e60fa,2,4,0,4,3,2012-02-13 06:22:18,2012-02-01 22:20:28
3fcb1684251705eb159b5647b66ece2a455e60fa...578ca272eb2a8708c05cb5b4fb27dcdf5000302e,1,0,7,7,1,2012-02-13 14:25:09,2012-02-08 21:58:45
578ca272eb2a8708c05cb5b4fb27dcdf5000302e...2d8237e652e2875fb829e9604f79fccb1643f241,3,50,44,94,7,2012-02-13 14:25:09,2012-02-10 18:37:23
2d8237e652e2875fb829e9604f79fccb1643f241...23cbe7d09c0370d61367c1da65ab4a944370edd1,2,24,8,32,10,2012-02-13 15:28:13,2012-02-10 18:47:10
23cbe7d09c0370d61367c1da65ab4a944370edd1...715ba7106637aa04091d54e6edb2655b1bbdf991,1,1,5,6,2,2012-02-13 15:28:13,2012-02-09 21:30:32
715ba7106637aa04091d54e6edb2655b1bbdf991...4402792701d5df7b9669c2894e10d2c7dc035c58,2,45,35,80,9,2012-02-13 15:28:13,2012-02-09 21:19:15
4402792701d5df7b9669c2894e10d2c7dc035c58...7226ed15e92150301663220455b613705d64dc6d,1,4,1,5,1,2012-02-13 18:59:12,2012-02-13 18:57:36
7226ed15e92150301663220455b613705d64dc6d...444658ee70b45f7678fd60553e300c5f0563d017,1,6,0,6,1,2012-02-13 19:15:49,2012-02-13 19:15:17
444658ee70b45f7678fd60553e300c5f0563d017...2a1aa5317e538d4f13e9b60abe7e531a24b04228,1,9,2,11,4,2012-02-13 23:47:05,2012-02-10 21:04:43
2a1aa5317e538d4f13e9b60abe7e531a24b04228...e3f2efe9f848108b49468ba4c5e831a322f0c723,1,1,1,2,1,2012-02-13 23:47:05,2012-02-13 19:06:51
e3f2efe9f848108b49468ba4c5e831a322f0c723...5f3e16f58d35e2ea21bff282d17224061527af98,2,3,4,7,4,2012-02-13 23:47:05,2012-02-13 19:18:46
5f3e16f58d35e2ea21bff282d17224061527af98...86f8966f2c79dc2e3c7182c589ad596631030e86,3,54,43,97,23,2012-02-14 00:26:08,2012-02-13 20:38:04
86f8966f2c79dc2e3c7182c589ad596631030e86...33508c2c375404243cebeace4b3856af04b86448,1,1,0,1,1,2012-02-14 04:01:26,2012-02-14 04:01:26
33508c2c375404243cebeace4b3856af04b86448...a0e38678ffd22d9a2f428e27b603b6380838276d,1,1,1,2,1,2012-02-14 04:10:06,2012-02-14 04:05:35
a0e38678ffd22d9a2f428e27b603b6380838276d...778223d5687f8da2c36888eeb32b314dda965efd,1,0,6,6,1,2012-02-14 13:14:26,2012-02-14 13:14:26
778223d5687f8da2c36888eeb32b314dda965efd...c0e0f9d07a1758075f5ac3196ab10c5d1aeece76,6,37,21,58,18,2012-02-14 15:36:44,2012-02-14 15:36:44
c0e0f9d07a1758075f5ac3196ab10c5d1aeece76...6f15c1ac09f8d96d5683281783171bc5c8bea2f7,5,377,2,379,6,2012-02-14 17:39:46,2012-02-14 17:39:46
6f15c1ac09f8d96d5683281783171bc5c8bea2f7...291be8e769616761080d51c7edf694851e373216,1,4,4,8,4,2012-02-14 17:48:40,2012-02-14 17:48:40
291be8e769616761080d51c7edf694851e373216...35cdfe783700a5ce95805d18b30402374ec4cdf4,1,63,0,63,1,2012-02-14 17:55:03,2012-02-14 17:55:03
35cdfe783700a5ce95805d18b30402374ec4cdf4...5984ac837f0fab4eeac4c72e933c2685939e65de,1,1,1,2,1,2012-02-14 20:07:14,2012-02-14 20:06:46
5984ac837f0fab4eeac4c72e933c2685939e65de...23554914ff132e1bf49133226988aed2faec08ce,1,3,0,3,2,2012-02-14 21:00:33,2012-02-14 20:58:53
23554914ff132e1bf49133226988aed2faec08ce...dd86ee3c988be8c998309f9d2a409d4ff2cecdb0,1,2,2,4,2,2012-02-14 21:29:58,2012-02-14 20:58:56
dd86ee3c988be8c998309f9d2a409d4ff2cecdb0...e2e55afb1bc9f32d87d32a0426593b20ce0ea833,2,4,4,8,3,2012-02-14 22:27:38,2012-02-14 22:24:45
e2e55afb1bc9f32d87d32a0426593b20ce0ea833...1eaada83e82be3a8c4ef5977f5843f0d7aa3dfc1,1,1,0,1,1,2012-02-14 23:27:51,2012-02-14 23:27:51
1eaada83e82be3a8c4ef5977f5843f0d7aa3dfc1...57ea070eb7c129935d9d96e7655dfd4467eef857,23,577,53,630,120,2012-02-15 02:02:58,2012-01-31 01:12:51
57ea070eb7c129935d9d96e7655dfd4467eef857...59e9b72297906e68686c1ffeb2244736ecac945b,3,15,2,17,3,2012-02-15 02:03:01,2012-02-08 00:49:42
59e9b72297906e68686c1ffeb2244736ecac945b...c4bf7b30c13a5175752f9296dd8a2bbfad6a8242,7,367,19,386,17,2012-02-15 02:03:03,2012-02-14 21:49:53
c4bf7b30c13a5175752f9296dd8a2bbfad6a8242...be91e89eae5f8461d51708ffde59fa35a06230bb,21,238,128,366,146,2012-02-15 02:03:06,2012-02-15 02:02:35
be91e89eae5f8461d51708ffde59fa35a06230bb...f31eda3b9fdadec7db50b88cfc620a1bb7fa6d61,1,1,1,2,1,2012-02-15 05:27:29,2012-02-15 05:27:29
f31eda3b9fdadec7db50b88cfc620a1bb7fa6d61...c44cd1464034021eed587189071f9281b157a770,1,54,0,54,1,2012-02-15 06:54:36,2012-02-15 06:54:10
c44cd1464034021eed587189071f9281b157a770...1645b28958a0217704b525f646c2578a2d267957,4,49,7,56,17,2012-02-15 10:54:07,2012-02-15 10:54:07
1645b28958a0217704b525f646c2578a2d267957...e32c214a427601b4afcfda008561ebed75c48fea,1,4,2,6,2,2012-02-15 14:50:44,2012-02-15 14:49:53
a8b86f17b717c968e298023ba00432f4dee462e6...255e03216d3e75814b9f744fd27dccf93ff81611,3,48,0,48,3,2012-03-05 18:24:47,2012-02-29 21:42:14
255e03216d3e75814b9f744fd27dccf93ff81611...3dc9191947727193a423d19b47c56ec4dd31feec,3,0,48,48,3,2012-03-05 20:59:07,2012-03-05 20:59:07
c2a6654951e7476c74d42eddd73f05205d9524fa...191b585ef94a5f191b77640ca9ab7ea7dda83407,3,39,25,64,12,2011-05-27 16:37:27,2011-05-27 16:37:27
191b585ef94a5f191b77640ca9ab7ea7dda83407...1fd3656455e9ac7d6b77379f19d2ef7fb5ceaae8,1,2,2,4,2,2011-05-27 22:35:45,2011-05-27 22:34:51
1fd3656455e9ac7d6b77379f19d2ef7fb5ceaae8...be7074a9dd95282231b2b2d34e7b61cd52978c05,1,2,2,4,2,2011-05-27 23:42:44,2011-05-27 23:42:44
be7074a9dd95282231b2b2d34e7b61cd52978c05...a4a488044b050cf89cbf48b8157d96f6be46a103,1,5,1,6,3,2011-05-28 00:57:18,2011-05-28 00:55:41
a4a488044b050cf89cbf48b8157d96f6be46a103...02d431c23864ee6902a24d556c1e1434a3c177a5,1,2,2,4,1,2011-05-28 00:57:18,2011-05-28 00:56:03
dbc1ee21f16a6bb1fefac39204daf03946008ddc...808a7921864bc5dee8b14648105c3acfd91d9673,1,1,0,1,1,2011-06-16 15:39:07,2011-06-16 15:33:10
e95cab54294452b8e71cf6cc4fff4befec701bd9...8e1b5c26abe57b7484d6c36be3168d680a0d6f88,10,286,161,447,80,2011-06-20 14:17:42,2011-06-20 14:17:42
e95cab54294452b8e71cf6cc4fff4befec701bd9...f671a29c1edc28029b6eb69f49e2bf95cf389b82,1,8,1,9,1,2011-06-18 19:54:34,2011-06-18 19:54:03
bd40833c7e097f79d5ce90828d3fe1a065ca123e...c6bcdd2b571c2ea8009292b21d719236a1420430,2,2,2,4,2,2012-03-01 22:49:21,2012-03-01 22:49:21
c6bcdd2b571c2ea8009292b21d719236a1420430...965e79119062900233e1e8a9f665912b157eb48d,1,1,1,2,1,2012-03-04 00:37:37,2012-03-04 00:37:37
965e79119062900233e1e8a9f665912b157eb48d...39fe5e1fe77c5d7fcbc68818ee7aba94af4e244c,1,1,2,3,2,2012-03-04 00:38:35,2012-03-04 00:38:35
39fe5e1fe77c5d7fcbc68818ee7aba94af4e244c...997cd252a2234294a4a793126e6fc5d22b30fba0,2,13,5,18,5,2012-03-04 00:39:31,2012-03-04 00:39:31
997cd252a2234294a4a793126e6fc5d22b30fba0...593fd1ce4852464315645d252b11040bc6b413c9,3,23,19,42,15,2012-03-04 00:40:00,2012-03-04 00:40:00
593fd1ce4852464315645d252b11040bc6b413c9...4a802804a6ef8b8afd39b11a1fedf81c93de34b1,4,75,43,118,20,2012-03-05 20:06:46,2012-03-05 20:06:46
4a802804a6ef8b8afd39b11a1fedf81c93de34b1...82298b9dd4b2af9fdbc465996af38749bd0dd5cc,7,96,21,117,32,2012-03-06 18:23:59,2012-03-06 18:23:59
82298b9dd4b2af9fdbc465996af38749bd0dd5cc...9fe9098f16444ad613809895ef3582b393942e01,2,22,8,30,3,2012-03-06 18:37:53,2012-03-06 18:37:53
7b6908dcc014198e5524484fca2066e0e984ac35...71178baeb88780ca6092239e14653ff28c62629a,1,6,0,6,1,2012-02-15 17:46:44,2012-02-15 17:46:44
71178baeb88780ca6092239e14653ff28c62629a...c4619cf3833376ddd794ac11c9e8c4814e9bcd26,1,53,0,53,1,2012-02-15 18:44:09,2012-02-15 18:42:56
c4619cf3833376ddd794ac11c9e8c4814e9bcd26...615045f2970a48f3bf9e2c83768b23239daad659,3,10,1,11,4,2012-02-15 19:14:22,2012-02-15 19:14:22
615045f2970a48f3bf9e2c83768b23239daad659...462ea8a8b90c29b849026003319df31c86bed86e,1,0,3,3,2,2012-02-15 19:18:43,2012-02-15 19:18:43
462ea8a8b90c29b849026003319df31c86bed86e...8bdf0655d686b47e0a45c00c125074f2851484f0,1,10,2,12,3,2012-02-15 21:32:34,2012-02-15 21:31:26
8bdf0655d686b47e0a45c00c125074f2851484f0...f2f0dc6183cf33765a675b5192328c255490bce3,1,44,0,44,1,2012-02-15 21:32:34,2012-02-15 21:32:24
f2f0dc6183cf33765a675b5192328c255490bce3...0e5d68e2ec9e14ad9142e924fd857bab10a0a233,3,6,0,6,6,2012-02-15 22:30:40,2012-02-15 22:29:59
0e5d68e2ec9e14ad9142e924fd857bab10a0a233...0e95e3627ec7a81f4bcd6975ac292668ac98b10b,3,10,9,19,3,2012-02-15 22:44:39,2012-02-15 22:44:39
0e95e3627ec7a81f4bcd6975ac292668ac98b10b...3cbf394e2e2a07a02c30541284461e376383d242,1,4,3,7,4,2012-02-15 22:58:58,2012-02-15 22:55:46
3cbf394e2e2a07a02c30541284461e376383d242...c5b2accea82c20d16f0e9fe8fd96b0db80b726da,1,12,3,15,3,2012-02-15 22:58:59,2012-02-15 22:56:43
c5b2accea82c20d16f0e9fe8fd96b0db80b726da...0185a20220397723d8456b40fcb0e224743c6c29,1,0,2,2,2,2012-02-15 22:59:00,2012-02-15 22:58:27
0185a20220397723d8456b40fcb0e224743c6c29...5d73be91e054d498eadeb842558111c74e0c61a6,1,7,2,9,4,2012-02-15 23:14:23,2012-02-15 23:12:15
5d73be91e054d498eadeb842558111c74e0c61a6...c94d2c910a2cd185c804abffe4bdbdfa28cc598e,1,3,4,7,4,2012-02-15 23:14:23,2012-02-15 23:14:05
c94d2c910a2cd185c804abffe4bdbdfa28cc598e...7ada09610e73211856e4ca906eb06d54d2354641,8,57,18,75,26,2012-02-16 03:14:06,2012-02-16 00:33:17
7ada09610e73211856e4ca906eb06d54d2354641...0b57ab6a14e9e67dd4050c423fadc15e79709fbc,5,199,0,199,5,2012-02-16 03:14:08,2012-02-16 00:42:48
0b57ab6a14e9e67dd4050c423fadc15e79709fbc...81eb12828d423fe3bdee3952d67823c57c1f51ea,6,21,1,22,7,2012-02-16 03:14:11,2012-02-16 03:13:16
81eb12828d423fe3bdee3952d67823c57c1f51ea...00679f7b828368c4a99dd621cc7a58ec4156d0d1,1,57,1,58,3,2012-02-16 03:58:52,2012-02-16 03:57:56
00679f7b828368c4a99dd621cc7a58ec4156d0d1...e6b1edab73bb0a52792eab1f82618e719d3e9846,1,6,0,6,1,2012-02-16 05:58:38,2012-02-16 05:58:38
e6b1edab73bb0a52792eab1f82618e719d3e9846...8ffd58917638fe20d3fd85fdf49d397ba57da0c1,1,8,7,15,5,2012-02-16 15:24:06,2012-02-15 22:24:01
8ffd58917638fe20d3fd85fdf49d397ba57da0c1...3c525b7f1be33de26fc1a014fbb3c7577755574d,4,18,0,18,9,2012-02-16 15:32:00,2012-02-16 15:32:00
3c525b7f1be33de26fc1a014fbb3c7577755574d...128083f7f3958ebd9763242fabfef94938126172,1,1,0,1,1,2012-02-16 16:25:18,2012-02-16 16:25:18
3dc9191947727193a423d19b47c56ec4dd31feec...4cacd9d04797f8e56c14a7c457500d5f9afe1eff,1,1,1,2,1,2012-03-05 21:58:38,2012-03-05 21:58:38
02d431c23864ee6902a24d556c1e1434a3c177a5...c545dfed4f05fb8d3aa5fb0a78dfa2274d61d23c,2,12,9,21,8,2011-05-28 17:11:43,2011-05-28 17:11:43
c545dfed4f05fb8d3aa5fb0a78dfa2274d61d23c...90e61c3f8518ecc4f438a0f90b6e21a2cb3c9386,3,31,15,46,12,2011-05-28 20:20:18,2011-05-28 20:20:18
90e61c3f8518ecc4f438a0f90b6e21a2cb3c9386...4632539c064547dd3f8dc7300116ccaaa52a495f,1,2,6,8,2,2011-05-29 01:56:42,2011-05-29 01:56:42
4632539c064547dd3f8dc7300116ccaaa52a495f...626238c41a2ecc0798dad02ca2d3aa1c4284f384,2,115,61,176,16,2011-05-29 02:27:31,2011-05-29 02:27:31
02d431c23864ee6902a24d556c1e1434a3c177a5...034e7bdf809a0ae8259c4cf777aa7abad670bd91,2,4,0,4,2,2011-05-28 15:51:55,2011-05-28 15:51:55
9ec9c921a175e3a5fcffba636068850f878fc83c...fb7fdf852707eff6046686a71d7a36f324edd3e4,1,6,2,8,2,2011-06-16 17:06:59,2011-06-16 17:06:59
e144a03a4832bcff6b2f72a826a89febd6368727...5a2f84dcfe4564bc777155f35827fb556d770542,2,28,1,29,2,2011-06-20 14:45:49,2011-06-20 14:45:49
5a2f84dcfe4564bc777155f35827fb556d770542...870c4e5da560bb513a34a88dc694677f6a09cd1f,1,1,1,2,1,2011-06-20 15:01:43,2011-06-20 15:01:43
870c4e5da560bb513a34a88dc694677f6a09cd1f...6ec18b293a2d41bf9749201110d35434d51157ce,2,5,3,8,4,2011-06-20 16:02:15,2011-06-20 16:02:15
128083f7f3958ebd9763242fabfef94938126172...2cd084da70f989062ae26d5778021fcf3f170b22,1,29,20,49,12,2012-02-16 17:54:13,2012-02-16 17:00:28
2cd084da70f989062ae26d5778021fcf3f170b22...8c03d189b0317331b43e0f7d55e01dcf26f3cc56,1,1,0,1,1,2012-02-16 18:55:26,2012-02-16 18:54:44
8c03d189b0317331b43e0f7d55e01dcf26f3cc56...e5992464af21028b836413eb562cc4869da091ca,5,120,64,184,9,2012-02-16 19:45:31,2012-02-16 19:44:29
e5992464af21028b836413eb562cc4869da091ca...aa853edd99a59dd317751dbc4fc79365690a150e,1,1,12,13,1,2012-02-16 19:45:31,2012-02-16 19:45:17
aa853edd99a59dd317751dbc4fc79365690a150e...218fea2e18f4f22104ad531e6cabcd34c3304245,6,169,9,178,12,2012-02-16 20:09:30,2012-01-06 21:14:34
218fea2e18f4f22104ad531e6cabcd34c3304245...42f64f8cce74c9d1369205758262a194a11458a0,1,3,2,5,2,2012-02-16 22:14:48,2012-02-16 17:27:43
42f64f8cce74c9d1369205758262a194a11458a0...22969777821bc49ec7a33ed7f781ae42625857cc,2,5,0,5,3,2012-02-16 22:14:49,2012-02-16 17:28:14
22969777821bc49ec7a33ed7f781ae42625857cc...01cdeea8304222bc95c647ef4bf329faadbb7fe1,1,4,1,5,3,2012-02-16 22:14:50,2012-02-16 20:40:06
01cdeea8304222bc95c647ef4bf329faadbb7fe1...a74a5b216f329bdb0e0ec506a53e4c1cc57b9695,5,0,559,559,5,2012-02-16 22:56:46,2012-02-16 22:56:13
2845ca3af9aeb14d014907f94a1600e9b325a82d...39721deb5d43fe65560a6f0618bfb20b154c264b,1,1,1,2,1,2012-03-05 22:07:32,2012-03-05 21:40:36
39721deb5d43fe65560a6f0618bfb20b154c264b...fa2e2ef95c5c934eef63fff4b98d5eb060c56539,1,2,2,4,2,2012-03-05 23:43:51,2012-03-05 19:27:50
fa2e2ef95c5c934eef63fff4b98d5eb060c56539...1f0e2a07b20e0e8c2fd44600ff493a25816d6d57,2,30,18,48,23,2012-03-06 01:06:32,2012-03-01 04:58:06
1f0e2a07b20e0e8c2fd44600ff493a25816d6d57...c4960cf595cceb20a58529b8fe18df516cc62e54,2,36,10,46,14,2012-03-06 01:06:32,2012-03-01 14:18:20
c4960cf595cceb20a58529b8fe18df516cc62e54...b4f82d1e5b1c58a7326494b577c380ef9a03d658,1,21,0,21,2,2012-03-06 01:06:32,2012-03-01 05:54:45
b4f82d1e5b1c58a7326494b577c380ef9a03d658...28fe491ac1eb110426fbb1396108b77a3893579a,2,3,4,7,2,2012-03-06 01:06:32,2012-03-01 06:19:56
28fe491ac1eb110426fbb1396108b77a3893579a...73ffa8b89b77c48e94af0ef2d31e60e9171ded26,3,19,12,31,12,2012-03-06 01:06:33,2012-03-01 07:21:51
73ffa8b89b77c48e94af0ef2d31e60e9171ded26...be3473afebbac25047383db98c68660b729d6deb,1,4,4,8,2,2012-03-06 01:06:33,2012-03-01 07:22:15
be3473afebbac25047383db98c68660b729d6deb...fd713371498dec2b2cb319c3a50c7a0c49a062ec,13,114,120,234,104,2012-03-06 15:50:18,2012-03-06 15:50:18
fd713371498dec2b2cb319c3a50c7a0c49a062ec...c3443fc81194882c4b2673d0b8672b5358ba48e6,3,6,6,12,4,2012-03-06 16:30:41,2012-03-06 16:26:23
c3443fc81194882c4b2673d0b8672b5358ba48e6...13356cb807fc7a5142dbf6ac16c3e9b3853a5a7d,3,6,6,12,3,2012-03-06 18:11:33,2012-03-06 18:11:33
13356cb807fc7a5142dbf6ac16c3e9b3853a5a7d...e4f3f956888da028bb13a469f99941537f35f272,3,61,13,74,9,2012-03-06 18:50:41,2012-03-05 15:31:34
e4f3f956888da028bb13a469f99941537f35f272...8898bfc68a9322358751771dd041ed2f2cbbf15c,52,0,33290,33290,52,2012-03-06 19:13:18,2012-03-06 19:13:18
8898bfc68a9322358751771dd041ed2f2cbbf15c...b5342d02de3f194d4ef5b094feb425f6d7cfbccf,1,1,1,2,1,2012-03-06 19:49:30,2012-03-06 19:49:30
b5342d02de3f194d4ef5b094feb425f6d7cfbccf...f4d4dab45372fdcb41bafd112ed6de69d9cc96fd,11,781,501,1282,176,2012-03-06 21:08:00,2012-03-06 21:06:50
f4d4dab45372fdcb41bafd112ed6de69d9cc96fd...42addfe2e5a49d730b5cb806b7bc9dcc4becc12b,2,42,15,57,12,2012-03-06 22:16:13,2012-03-06 22:15:33
42addfe2e5a49d730b5cb806b7bc9dcc4becc12b...28b3a0a48a9d6a6d76a723ee19b404512d18998d,1,1,3,4,2,2012-03-06 22:29:52,2012-03-06 22:29:22
28b3a0a48a9d6a6d76a723ee19b404512d18998d...0e5a0113febadbb8a5e7f9a7b7e43e479c0b0640,1,9,1,10,5,2012-03-06 22:33:27,2012-03-06 22:33:01
0e5a0113febadbb8a5e7f9a7b7e43e479c0b0640...087c1bd72f3b9923770fd5a51325a7ae51f334ca,1,1,1,2,1,2012-03-06 22:47:52,2012-03-06 22:47:52
087c1bd72f3b9923770fd5a51325a7ae51f334ca...ef6e9ebd071cc23c64ac0f0b26195d498ca239a2,7,49,10,59,17,2012-03-06 23:02:53,2012-03-06 21:55:13
ef6e9ebd071cc23c64ac0f0b26195d498ca239a2...9025e8c72f20d6c7e7dbf2efadd2f0f7204934a7,2,8,0,8,5,2012-03-06 23:07:08,2012-03-06 23:06:19
9025e8c72f20d6c7e7dbf2efadd2f0f7204934a7...276e5f09ec00fdc7b8131664f4587fe6e9094e74,1,11,3,14,5,2012-03-06 23:23:04,2012-03-06 23:22:42
e37c13516782d7cedb613120e17b2b2cfb09a069...3d478f18aab7bdd5c161b2ddf09f6198a0e867b1,1,4,2,6,2,2011-05-29 02:30:22,2011-05-29 02:30:22
3d478f18aab7bdd5c161b2ddf09f6198a0e867b1...37204c7ca07bfb289cdba96f810cd4997f92006c,9,22,24,46,17,2011-05-29 04:31:17,2011-05-29 04:31:17
68c031388debc5dc7c1740f540be5e23793e1157...9f15e8cd301f65aa4b522b6df206352b07d7dfe6,2,13,5,18,7,2011-06-16 20:48:23,2011-06-16 20:48:23
9f15e8cd301f65aa4b522b6df206352b07d7dfe6...31f5fa3475bfdef256bb483b92afb599c6280835,1,12,0,12,2,2011-06-16 21:21:56,2011-06-16 21:12:34
31f5fa3475bfdef256bb483b92afb599c6280835...4d8ee4cc7c4d32ace1b1cab403dd429d9467a677,8,386,114,500,52,2011-06-16 21:34:39,2011-06-09 19:41:21
4d8ee4cc7c4d32ace1b1cab403dd429d9467a677...3316127d58babf98830a8f59fbb16c222df88107,2,529,29,558,44,2011-06-16 21:34:40,2011-06-13 17:34:43
3316127d58babf98830a8f59fbb16c222df88107...884e100ec01d21f493c327a72b92a5b1a5dfb440,11,34,30,64,26,2011-06-16 21:34:40,2011-06-16 20:14:17
884e100ec01d21f493c327a72b92a5b1a5dfb440...db3517a0ada1031ba7f914cbae1a3506472e2e6a,1,1,1,2,1,2011-06-16 21:34:40,2011-06-16 21:09:34
db3517a0ada1031ba7f914cbae1a3506472e2e6a...625f82720502abca68380fec37c558d115eaf39b,1,8,5,13,3,2011-06-17 01:11:32,2011-06-17 01:11:25
6ec18b293a2d41bf9749201110d35434d51157ce...1576673c069eea2b425c086176e3f020167240c3,1,0,12,12,4,2011-06-20 16:09:15,2011-06-20 16:09:15
6ec18b293a2d41bf9749201110d35434d51157ce...4ff37d67a414de341918f029f64e2c7ca4f260cd,1,2,22,24,5,2011-06-20 16:07:21,2011-06-20 16:07:21
4ff37d67a414de341918f029f64e2c7ca4f260cd...046fac538347e4838f7270efdd57a673edf350a7,1,20,0,20,2,2011-06-20 16:07:39,2011-06-17 23:48:08
88506eb74a40395e0d6f978a716469ad28989be3...d474d2b1d285aa8cf36c04eeadbda0687bc1c3fd,1,9,9,18,9,2012-03-12 17:14:48,2012-03-12 17:14:48
d474d2b1d285aa8cf36c04eeadbda0687bc1c3fd...c9297cd368688a4a844fe24a42bedca8fb20c5b7,9,75,27,102,25,2012-03-12 19:51:33,2012-03-12 19:51:33
c9297cd368688a4a844fe24a42bedca8fb20c5b7...0ae0b7445b8638d4a4e39abe064b0708bb8191c9,4,4,5,9,6,2012-03-13 12:03:47,2012-03-13 12:03:47
0ae0b7445b8638d4a4e39abe064b0708bb8191c9...99486e7850c7332b8c3f68deae3bb58f92da297d,2,5,3,8,3,2012-03-13 12:37:24,2012-03-13 12:37:24
99486e7850c7332b8c3f68deae3bb58f92da297d...76c64d0922a53eee6cb7457fe35725641489fe0b,2,2,0,2,2,2012-03-13 15:03:51,2012-03-13 15:03:51
a74a5b216f329bdb0e0ec506a53e4c1cc57b9695...3829adb0ec12dc00b6dc232af6523aa4d7b47464,3,7,2,9,5,2012-02-17 17:31:04,2012-02-17 17:31:04
a74a5b216f329bdb0e0ec506a53e4c1cc57b9695...7cf238c22c663ee87bcc2a5ff2416cd5cb41f5a4,1,1,0,1,1,2012-02-17 01:53:21,2012-02-17 01:53:21
7cf238c22c663ee87bcc2a5ff2416cd5cb41f5a4...31991afed8aa8302d649b6079ab9c6dd0d52650c,3,54,4,58,6,2012-02-17 02:49:02,2012-02-17 02:49:02
31991afed8aa8302d649b6079ab9c6dd0d52650c...fc7cac22396ea51d38591ccda973714f815304f3,6,173,165,338,14,2012-02-17 02:51:26,2012-02-17 02:51:26
fc7cac22396ea51d38591ccda973714f815304f3...84034bdf98b42ec2eb85e957c358b663612dd1f6,2,7,1,8,2,2012-02-17 05:06:50,2012-02-17 05:06:50
84034bdf98b42ec2eb85e957c358b663612dd1f6...79f999cf0326bb636377623180eb433e31556ead,2,37,41,78,15,2012-02-17 12:23:47,2012-02-17 12:23:47
276e5f09ec00fdc7b8131664f4587fe6e9094e74...654671234c900d71cbd7c9d7c60eaf80c9a6f475,1,4,0,4,1,2012-03-07 00:24:35,2012-03-05 23:02:46
37204c7ca07bfb289cdba96f810cd4997f92006c...04d51756fcf52ba1b0a3866a47e7000ef2ed1d5c,1,6,0,6,1,2011-05-30 05:16:09,2011-05-30 05:16:09
37204c7ca07bfb289cdba96f810cd4997f92006c...9050555da63f5f9196c8e5ca41c0233b09a38370,1,4,0,4,1,2011-05-30 03:46:10,2011-05-30 03:46:10
37204c7ca07bfb289cdba96f810cd4997f92006c...5ae386a221286f162f5abd86e1a02b27ea4c123e,1,3,3,6,3,2011-05-29 06:15:16,2011-05-29 06:15:07
5ae386a221286f162f5abd86e1a02b27ea4c123e...8b8427c898518e550a5730097cd5888f26553c39,2,11,2,13,4,2011-05-29 08:05:49,2011-05-29 08:05:49
8b8427c898518e550a5730097cd5888f26553c39...2e9c306fb53ff8efb245a51fc034c5bbdbc18fd0,1,1,1,2,1,2011-05-29 08:13:23,2011-05-29 08:13:23
2e9c306fb53ff8efb245a51fc034c5bbdbc18fd0...e0fdd549ccd275d266a8a2180b9ff5c4eddd05c8,1,1,1,2,1,2011-05-29 08:19:16,2011-05-29 08:19:16
e0fdd549ccd275d266a8a2180b9ff5c4eddd05c8...280969d9c878400cb8fa6a31f03ff7e20123e55b,1,2,2,4,2,2011-05-29 17:44:27,2011-05-29 17:44:27
280969d9c878400cb8fa6a31f03ff7e20123e55b...510347df13244344ba4d4ea476cd4bbc4bac0239,3,24,2,26,4,2011-05-30 02:19:59,2011-05-30 02:19:59
9c4ea72b22e0d68ae34fa1fe2971018b031e0a7d...fed4db4c72a3e7615e81ec98219cc395556b3d70,1,1,0,1,1,2011-06-20 17:04:13,2011-06-20 17:03:34
fed4db4c72a3e7615e81ec98219cc395556b3d70...5160c0eba1aafc80074dc5b4196d3c8ddab3dc44,1,19,0,19,1,2011-06-20 18:29:03,2011-06-20 18:29:03
1b41bc0079372a06d0fcc79ca83f652b5798a497...0dcdc6ef6084f8e5696ba9d3f35c98b4bbf01eca,2,5,5,10,6,2012-03-13 16:33:13,2012-03-13 16:33:13
79f999cf0326bb636377623180eb433e31556ead...0e859c4f7dcf6809e744d33d808c78663bc6cdda,1,1,1,2,1,2012-02-17 18:56:18,2012-02-17 18:56:18
0e859c4f7dcf6809e744d33d808c78663bc6cdda...46bc489a886d6d330a518ba8aaef05249b4798e3,4,36,5,41,7,2012-02-17 19:26:08,2012-02-08 18:27:14
46bc489a886d6d330a518ba8aaef05249b4798e3...ec2fee22c57bfa9eec48c906ebdacf156afc7100,2,27,2,29,4,2012-02-17 19:26:08,2012-02-10 21:37:41
ec2fee22c57bfa9eec48c906ebdacf156afc7100...d0542e44d90aa410bc82456f5ee1d06a73396b2c,2,23,1,24,3,2012-02-17 19:26:08,2012-02-10 21:56:53
d0542e44d90aa410bc82456f5ee1d06a73396b2c...359803779413dd3f17ef1f9f5910a03b1163f283,2,9,2,11,4,2012-02-17 19:26:08,2012-02-10 22:00:03
359803779413dd3f17ef1f9f5910a03b1163f283...1a016d3b3a5f7a6253a4a51d6a7075aa498bf5f6,1,5,2,7,2,2012-02-17 19:26:08,2012-02-10 22:11:24
1a016d3b3a5f7a6253a4a51d6a7075aa498bf5f6...8b833b9a759b0b3c1f058908c38066e1d8f961fb,1,9,2,11,1,2012-02-17 19:26:08,2012-02-13 19:01:39
8b833b9a759b0b3c1f058908c38066e1d8f961fb...a2dbee14665225f1fafe1fa97d487bd024d9091b,2,2,5,7,2,2012-02-17 19:26:09,2012-02-17 17:13:47
a2dbee14665225f1fafe1fa97d487bd024d9091b...9d53f3375a37145e62a0a5855d169164b0866325,1,2,1,3,1,2012-02-17 19:26:09,2012-02-17 17:14:47
9d53f3375a37145e62a0a5855d169164b0866325...d27ca868154849476c29d2ef2cd99e2ab38f2b76,1,8,5,13,3,2012-02-17 19:26:09,2012-02-17 17:15:32
d27ca868154849476c29d2ef2cd99e2ab38f2b76...c70f2d58ab352997776556d25bb258eea09e1a4d,1,5,11,16,3,2012-02-17 19:26:09,2012-02-17 17:16:21
b85f0d986bcc4943ee15f46f6f953ef3212d6510...05604645b421fa934b2db313b0d96a0bcc4fb5ad,3,82,30,112,13,2012-03-07 01:21:31,2012-03-07 01:20:44
05604645b421fa934b2db313b0d96a0bcc4fb5ad...2da0494661fcf68e272435424cbea0b4ce1ef49c,7,207,188,395,28,2012-03-07 04:54:38,2012-03-05 23:05:58
2da0494661fcf68e272435424cbea0b4ce1ef49c...be503cf25ba41565b701b42b51beb2b6238b9626,1,15,1,16,2,2012-03-07 04:54:44,2012-03-06 19:50:58
be503cf25ba41565b701b42b51beb2b6238b9626...dfee494de5b07c05668d1a2bcbade34731110a1a,2,18,16,34,13,2012-03-07 04:58:32,2012-03-07 04:58:32
dfee494de5b07c05668d1a2bcbade34731110a1a...b17579687420f13afcb173f29556d89475d3f31b,15,271,83,354,66,2012-03-07 04:59:44,2012-03-07 04:59:44
b17579687420f13afcb173f29556d89475d3f31b...9f86544e7c1e63886de8475c987b6c5d519080ac,2,34,1,35,3,2012-03-07 04:59:53,2012-03-06 23:40:03
9f86544e7c1e63886de8475c987b6c5d519080ac...215901f120d47dd268032985a73626131a068874,2,115,105,220,5,2012-03-07 04:59:58,2012-03-07 04:51:24
215901f120d47dd268032985a73626131a068874...4cd88bf3117d4a29c95bfc3c62f0580b71201408,3,0,12,12,6,2012-03-07 05:00:53,2012-03-07 05:00:29
4cd88bf3117d4a29c95bfc3c62f0580b71201408...284e018bc40a826acad2dc5f2cc7a6bcfe6be086,8,23,3,26,10,2012-03-07 12:20:11,2012-03-07 12:20:11
284e018bc40a826acad2dc5f2cc7a6bcfe6be086...9de2ec892e5ba0d217f09e6c76468600d9145e24,1,2,2,4,2,2012-03-07 13:40:06,2012-03-07 13:40:06
9de2ec892e5ba0d217f09e6c76468600d9145e24...3383759da7a13b35dcf57ae6ff52b5357760f8e2,1,4,4,8,4,2012-03-07 15:31:56,2012-03-07 15:31:56
3383759da7a13b35dcf57ae6ff52b5357760f8e2...e67ef0fb03063d57442d9200f3468debbc797706,2510,485948,0,485948,2510,2012-03-07 15:37:06,2012-03-02 14:38:44
e67ef0fb03063d57442d9200f3468debbc797706...a8c3284a0350fe873fd25f7d47d8abf418ae4a9d,7,108,75,183,16,2012-03-07 15:37:06,2012-03-02 16:13:09
a8c3284a0350fe873fd25f7d47d8abf418ae4a9d...1daae4e935fedec555d52475dfaf8a72fca61d5b,2,10,9,19,2,2012-03-07 15:46:54,2012-03-07 15:46:54
1daae4e935fedec555d52475dfaf8a72fca61d5b...eceb7584894362f09ba8ad5cbbc7a7a28fca35fb,1,2,0,2,1,2012-03-07 16:48:30,2012-03-07 16:47:49
eceb7584894362f09ba8ad5cbbc7a7a28fca35fb...f729d0c69bbaae99c38d56e8711c3ca9acb5c8c9,2,25,19,44,2,2012-03-07 17:29:19,2012-03-07 17:28:41
f729d0c69bbaae99c38d56e8711c3ca9acb5c8c9...322c3cc620d631640d7dc9ab2f99559ad6d25ba8,1,5,5,10,3,2012-03-07 20:05:48,2012-03-07 17:14:38
322c3cc620d631640d7dc9ab2f99559ad6d25ba8...0578ab5c5f732f28a0622b73df9751defc1e60d7,1,20,14,34,9,2012-03-07 20:44:04,2012-03-07 20:43:50
0578ab5c5f732f28a0622b73df9751defc1e60d7...358c71ad01d223668180af99666e75a327e20fac,1,1,0,1,1,2012-03-07 21:11:21,2012-03-07 21:11:21
358c71ad01d223668180af99666e75a327e20fac...021d13e449a3a2584ef097c6a4ed0a4165ef6ed3,1,9,0,9,1,2012-03-07 21:13:17,2012-03-07 21:13:07
021d13e449a3a2584ef097c6a4ed0a4165ef6ed3...60a2b250323b727f8b7253b88c05c9a0bfb57e37,14,1738,183,1921,80,2012-03-07 21:21:17,2012-03-07 21:21:17
60a2b250323b727f8b7253b88c05c9a0bfb57e37...63b37ba10b73e8bd8af85e57aa69196010ef8096,1,1,8,9,1,2012-03-07 22:18:49,2012-03-07 22:18:49
63b37ba10b73e8bd8af85e57aa69196010ef8096...7f6a8e037806b34a20448a9f7dd08e48c92bbc81,2,5,7,12,7,2012-03-07 23:53:41,2012-03-07 22:34:16
7f6a8e037806b34a20448a9f7dd08e48c92bbc81...5132fee1a9e4e5bcfe17a414e732c371d51072ea,1,1,0,1,1,2012-03-08 00:00:18,2012-03-08 00:00:08
5132fee1a9e4e5bcfe17a414e732c371d51072ea...ef111a5b999fdb6871775a57fedf4fab07a10df4,2,17,0,17,2,2012-03-08 08:31:39,2012-03-08 08:31:39
ef111a5b999fdb6871775a57fedf4fab07a10df4...f84147cf3fa29aea65529ac5cce3c56678530a48,1,10,6,16,5,2012-03-08 10:57:17,2012-03-08 10:57:17
f84147cf3fa29aea65529ac5cce3c56678530a48...1bf5aac8d6a6a649421f3482abe70f3c12730aa3,2,0,18,18,2,2012-03-08 12:53:48,2012-03-08 12:53:48
1bf5aac8d6a6a649421f3482abe70f3c12730aa3...0aa594375d88e59a6b8fe92e22142dd5e73d277b,3,118,18,136,13,2012-03-08 16:21:50,2012-03-08 02:23:52
0aa594375d88e59a6b8fe92e22142dd5e73d277b...d9579b080d1098166172fc94432a415afc85c60a,1,1,1,2,1,2012-03-08 22:44:54,2012-03-08 22:42:45
d9579b080d1098166172fc94432a415afc85c60a...2d91311153e841bc66be1c600966da5663e2cc57,1,13,15,28,5,2012-03-09 00:16:19,2012-03-08 21:16:10
2d91311153e841bc66be1c600966da5663e2cc57...5cf72997e3bb116d90f7d9969c6f6b4028a5f8f0,1,30,33,63,1,2012-03-09 00:48:51,2012-03-06 18:57:51
5cf72997e3bb116d90f7d9969c6f6b4028a5f8f0...d06ef3bd8e857fbe20d671a366f1696d8c3b2a27,1,5,2,7,2,2012-03-09 00:48:51,2012-03-06 21:44:40
d06ef3bd8e857fbe20d671a366f1696d8c3b2a27...1afdf32715eeaac5c287b25db7ea016ceaa44380,2,33,21,54,10,2012-03-09 00:48:51,2012-03-06 21:54:31
1afdf32715eeaac5c287b25db7ea016ceaa44380...0e06167978fe5e22f9b130f0e6483287369743a4,1,3,2,5,2,2012-03-09 15:19:38,2012-03-09 15:18:29
0e06167978fe5e22f9b130f0e6483287369743a4...4367c5493c2d1d193b805cf2cf801c69168fbfcc,1,1,1,2,1,2012-03-09 17:26:58,2012-03-09 17:26:58
4367c5493c2d1d193b805cf2cf801c69168fbfcc...b1586264fdbcbaa9ccef9291fefe93c5bf853dd9,1,2,1,3,2,2012-03-09 18:55:26,2012-03-09 18:53:59
b1586264fdbcbaa9ccef9291fefe93c5bf853dd9...e7a2aa504e99c2a75fb28bc8e0c733cc23fdbfd5,1,2,5,7,2,2012-03-10 18:54:02,2012-03-10 18:54:02
e7a2aa504e99c2a75fb28bc8e0c733cc23fdbfd5...bbc33ee614add49399439842135f52e5a8487031,1,13,4,17,1,2012-03-11 11:28:19,2012-03-11 11:28:19
bbc33ee614add49399439842135f52e5a8487031...dbd354f2c3327c3d2a46a1e59c58541324785d1e,3,130,26,156,20,2012-03-11 15:40:51,2012-03-11 15:40:51
dbd354f2c3327c3d2a46a1e59c58541324785d1e...ec9be5b766a8aaa7c250e36fec7a830c560904a8,1,61,55,116,3,2012-03-11 18:19:46,2012-03-09 00:41:10
ec9be5b766a8aaa7c250e36fec7a830c560904a8...8cf281eb779c7ebccd6c3b5b3783bef7e31c6893,6,50,64,114,46,2012-03-11 18:19:46,2012-03-09 03:59:11
8cf281eb779c7ebccd6c3b5b3783bef7e31c6893...519348e60d3cec8870516de56d1f5061d968edda,1,2,2,4,2,2012-03-11 18:19:46,2012-03-09 05:01:21
519348e60d3cec8870516de56d1f5061d968edda...7544d91e2af743683fcf62e49e8ecc4f03e28565,1,3,3,6,3,2012-03-11 18:19:47,2012-03-09 05:07:24
7544d91e2af743683fcf62e49e8ecc4f03e28565...17800789f39ab8534917db439773a69039d41088,1,1,1,2,1,2012-03-11 18:19:47,2012-03-09 05:08:02
17800789f39ab8534917db439773a69039d41088...a5407f5f80e9eb2b0252ec299c1303acfe38de1b,1,7,6,13,2,2012-03-11 18:19:47,2012-03-09 05:17:25
a5407f5f80e9eb2b0252ec299c1303acfe38de1b...716ba1ac5c3df49a90a262b01df66cd2e5410711,2,123,5,128,6,2012-03-11 18:19:47,2012-03-09 07:22:02
716ba1ac5c3df49a90a262b01df66cd2e5410711...82edf11fc876bddbb61ab1bb1065dcf3ff460f23,1,84,0,84,1,2012-03-11 18:19:47,2012-03-09 17:35:01
82edf11fc876bddbb61ab1bb1065dcf3ff460f23...f826e31d734238be63af3c435f44fd9b38d2e168,1,2,2,4,2,2012-03-11 18:19:48,2012-03-09 17:36:00
f826e31d734238be63af3c435f44fd9b38d2e168...c1aeea0cf536d797d1532a528bc212ed598c8c1b,1,996,977,1973,75,2012-03-11 18:19:48,2012-03-09 20:36:54
c1aeea0cf536d797d1532a528bc212ed598c8c1b...97ef31c5eaab0e6a2a5e0f8e6566c41970f1f357,2,41,0,41,3,2012-03-11 18:19:48,2012-03-09 23:20:40
97ef31c5eaab0e6a2a5e0f8e6566c41970f1f357...fc2ee5a6da77483af7091982c0a2cdf79adf0073,1,2,2,4,2,2012-03-11 18:19:48,2012-03-09 23:39:00
fc2ee5a6da77483af7091982c0a2cdf79adf0073...b614d6b16307cf4bc5fd3a455fecccc1f0f2a647,1,1,1,2,2,2012-03-11 18:39:11,2012-03-11 18:39:11
b614d6b16307cf4bc5fd3a455fecccc1f0f2a647...77a80dfb62f166bc5ef32c32896d14cc0b18e73a,1,1,1,2,1,2012-03-11 18:39:22,2012-03-11 18:39:22
77a80dfb62f166bc5ef32c32896d14cc0b18e73a...5cc2e3eb58473925798e0f0b2311cf4c85416625,1,2,0,2,1,2012-03-11 18:39:33,2012-03-11 18:39:33
5cc2e3eb58473925798e0f0b2311cf4c85416625...e120eb2d31d793ac9466921a18992796155b5e38,1,5,2,7,1,2012-03-11 19:30:27,2012-03-11 19:30:27
e120eb2d31d793ac9466921a18992796155b5e38...3a59385162569f7d2dbf0aec0bfb03c52ace706c,1,11,4,15,1,2012-03-12 02:02:42,2012-03-12 02:02:42
3a59385162569f7d2dbf0aec0bfb03c52ace706c...cd54317107d9acf63dc5de6c466990ca9d234462,1,5,12,17,1,2012-03-12 10:04:30,2012-03-12 10:04:30
cd54317107d9acf63dc5de6c466990ca9d234462...e714bcaf6899bde1466c414c4494ceb18216c3a3,1,4,4,8,5,2012-03-12 15:05:19,2012-03-12 15:04:09
2fdd55792094f01922b44c5ec11789ddddc0a876...21def6cf9438f77e54163c9109325d3f880fc6e6,3,16,14,30,4,2011-05-30 17:25:29,2011-05-30 17:05:22
21def6cf9438f77e54163c9109325d3f880fc6e6...1eb57466fc10c3538e1b1585fc709451909af359,4,83,25,108,19,2011-05-30 17:25:29,2011-05-30 17:15:56
1eb57466fc10c3538e1b1585fc709451909af359...e371c76ccac4f166b7f267114526a6c8b073f5de,2,20,3,23,6,2011-05-30 18:22:28,2011-05-30 18:22:28
e371c76ccac4f166b7f267114526a6c8b073f5de...8aeaf8d850d65c934cc5269e4c78a0eb138e9183,3,53,15,68,10,2011-05-30 23:29:48,2011-05-30 23:29:48
8aeaf8d850d65c934cc5269e4c78a0eb138e9183...61222372e838e1fe850c41b44236654cb0aeab7a,1,294,288,582,67,2011-05-31 04:35:45,2011-05-31 04:35:19
61222372e838e1fe850c41b44236654cb0aeab7a...d941aa402076332d32e4597533dfd88a028b1857,2,117,4,121,7,2011-05-31 04:35:45,2011-05-31 04:35:32
d941aa402076332d32e4597533dfd88a028b1857...f198a8072e39373674923950cfb103bb5f87f542,1,2,1,3,1,2011-05-31 05:30:03,2011-05-31 05:30:03
f198a8072e39373674923950cfb103bb5f87f542...337721586f3997a0d385f87dd1fd793da3ecbdeb,1,1,1,2,1,2011-05-31 05:48:04,2011-05-31 05:48:04
337721586f3997a0d385f87dd1fd793da3ecbdeb...d5f7ca3acc62b4cf5f7d4788d04425b2ddc9f2c0,1,7,24,31,11,2011-05-31 14:33:33,2011-05-31 14:33:33
d5f7ca3acc62b4cf5f7d4788d04425b2ddc9f2c0...299abff183a70b663854074aa23c89a2a19479d7,1,2,0,2,1,2011-05-31 15:29:28,2011-05-31 15:29:28
299abff183a70b663854074aa23c89a2a19479d7...9460505549b912053ae132e442347153f87caa71,1,8,3,11,3,2011-05-31 15:42:44,2011-05-31 15:42:44
ca99318f709c88e57159143aaf401a30bfab1847...f3df6e627ad333c2178bc6912ddbc0a5071ca699,1,8,8,16,7,2011-05-30 04:30:10,2011-05-30 04:30:10
5160c0eba1aafc80074dc5b4196d3c8ddab3dc44...cfc98d710f2351b1370ec72ab85aab167bd94633,1,1,1,2,1,2011-06-20 21:29:47,2011-06-20 21:29:47
cfc98d710f2351b1370ec72ab85aab167bd94633...05d1949790fce1954e2d65844e54872e952f04de,1,8,0,8,1,2011-06-20 21:43:18,2011-06-20 21:43:18
5160c0eba1aafc80074dc5b4196d3c8ddab3dc44...cf2980774d75809a391f0f41674f786debef1322,6,17,16,33,8,2011-06-20 20:16:37,2011-06-20 20:16:37
cf2980774d75809a391f0f41674f786debef1322...62ee12935a7fb42236fcc65b279550ea4e703aca,2,44,42,86,2,2011-06-20 20:17:32,2011-06-20 20:17:32
62ee12935a7fb42236fcc65b279550ea4e703aca...4d2cb04931e1fa0cca99b1de51695358d7cb493c,7,39,26,65,8,2011-06-20 20:23:54,2011-06-20 20:23:54
4d2cb04931e1fa0cca99b1de51695358d7cb493c...32de61255e44bf0661c44b28037a45112d406502,15,259,228,487,24,2011-06-20 21:34:16,2011-06-20 21:34:16
0dcdc6ef6084f8e5696ba9d3f35c98b4bbf01eca...0c3d363ba913263a5b99fa8b96f85b31b7e15e4c,1,4,0,4,1,2012-03-14 14:56:09,2012-03-14 14:56:09
0dcdc6ef6084f8e5696ba9d3f35c98b4bbf01eca...29600e69990bfed106777039ff3fb786affd36c1,1,4,4,8,4,2012-03-13 16:13:16,2012-03-13 16:13:16
29600e69990bfed106777039ff3fb786affd36c1...e6541f6d78fad5f94920ee8ace36c783fc09a00b,2,7,7,14,7,2012-03-13 16:38:21,2012-03-13 16:38:21
e6541f6d78fad5f94920ee8ace36c783fc09a00b...4b05a8732ee21dc05e30da75d6d16a21a774dfae,1,1,1,2,1,2012-03-13 17:20:33,2012-03-13 17:20:33
4b05a8732ee21dc05e30da75d6d16a21a774dfae...00f39a03ac068386464e96a5f44da7adb6d8062a,1,2,2,4,1,2012-03-14 14:18:46,2012-03-14 14:18:46
b76fd75476efbbcc9acc8bcedac00ec4d28ab088...c9787e73033e167789d8fec94cc8617227b84d33,1,11,8,19,9,2012-02-18 01:06:31,2012-02-18 01:06:31
e714bcaf6899bde1466c414c4494ceb18216c3a3...4e202ec5bfeff036ff42274e1594dcb82a74e942,1,1,8,9,1,2012-03-12 15:51:57,2012-03-12 15:51:57
9460505549b912053ae132e442347153f87caa71...63023cac639ef16bfb480fa1a51cf04924973273,5,10,10,20,9,2011-05-31 18:21:05,2011-05-31 18:21:05
9460505549b912053ae132e442347153f87caa71...bcb45ca21568bdfa3a2f3ad02bea4917235677b4,1,8,0,8,3,2011-05-31 16:51:29,2011-05-31 16:51:29
430257374f730477b9f1fa0e0ffc0dc946b49559...09a3af0229c1487c0e077c901c3a2a36bf92bada,6,26,11,37,17,2011-06-20 21:54:02,2011-06-20 21:54:02
09a3af0229c1487c0e077c901c3a2a36bf92bada...03736f9567b3fccccf92d4973ecfc40d680fb944,3,24,0,24,3,2011-06-20 23:29:12,2011-06-20 23:29:12
03736f9567b3fccccf92d4973ecfc40d680fb944...e33be1a519b8a6345eb4cefacafa8952b0a3d632,1,21,1,22,3,2011-06-21 00:17:44,2011-06-21 00:17:44
e33be1a519b8a6345eb4cefacafa8952b0a3d632...7e6536744ba162382fbeb3e1832b95ecdb02b2d1,1,1,1,2,1,2011-06-21 00:30:51,2011-06-21 00:30:51
7e6536744ba162382fbeb3e1832b95ecdb02b2d1...3dd1ea030d1624bddd9db9b84628682a61c0a063,2,10,7,17,6,2011-06-21 00:35:25,2011-06-21 00:35:25
3dd1ea030d1624bddd9db9b84628682a61c0a063...42c87168a9b5d29f57013112eb9df3b76525a1b7,1,13,0,13,1,2011-06-21 01:02:31,2011-06-21 01:02:31
42c87168a9b5d29f57013112eb9df3b76525a1b7...61be4fc8357c3784a22d0bba9e1107a77a2c9216,6,6,8,14,9,2011-06-21 05:56:49,2011-06-21 05:56:49
61be4fc8357c3784a22d0bba9e1107a77a2c9216...aed79701cae11d64c459a645761e66faf321c794,1,1,1,2,1,2011-06-21 13:23:00,2011-06-21 13:23:00
aed79701cae11d64c459a645761e66faf321c794...67d182174622e4c87b1c32f61751360cc319868d,3,26,0,26,5,2011-06-21 14:39:27,2011-06-21 14:39:27
67d182174622e4c87b1c32f61751360cc319868d...add206436e566d6659d5e1f00dbc6e63c6dcd436,6,47,4,51,11,2011-06-21 16:48:31,2011-06-21 16:48:31
add206436e566d6659d5e1f00dbc6e63c6dcd436...473a982fab35b080f8d6fdc11f6bda5dd21e3397,1,12,2,14,3,2011-06-21 17:22:59,2011-06-21 17:22:59
473a982fab35b080f8d6fdc11f6bda5dd21e3397...4de924a3d9f49181015e2e819afe0bedb3224cb7,4,229,45,274,18,2011-06-21 17:51:14,2011-06-21 17:12:04
4de924a3d9f49181015e2e819afe0bedb3224cb7...fcbfd0f54ebdc3a276de23703093294f42efb4c0,1,1,1,2,1,2011-06-21 17:51:15,2011-06-21 17:20:18
fcbfd0f54ebdc3a276de23703093294f42efb4c0...2a0ef3dd38fb2bf9453e0d987ea34a7abe987bfc,1,1,1,2,1,2011-06-21 17:51:15,2011-06-21 17:20:31
2a0ef3dd38fb2bf9453e0d987ea34a7abe987bfc...1d59eb6603fbd630ffc944563e48dd1ab5e8d091,1,10,1,11,10,2011-06-21 17:51:15,2011-06-21 17:50:49
f06e7dc332a694ed3b344c360338b2a18814db2b...49405ce14fc98462a09f94b3c0b79ebe817aa6d3,3,38,19,57,14,2012-02-18 01:10:04,2012-02-18 01:09:13
49405ce14fc98462a09f94b3c0b79ebe817aa6d3...2ebabdfbf48eda1c2278820c004605be83c281e5,6,165,173,338,14,2012-02-18 06:55:34,2012-02-18 06:55:34
2ebabdfbf48eda1c2278820c004605be83c281e5...75f2d553b105ebf7fb2dca3921b6c91f271ade77,1,23,7,30,7,2012-02-18 18:27:24,2012-02-18 03:50:29
75f2d553b105ebf7fb2dca3921b6c91f271ade77...fb3712c23886c5c1caba2c4661292b079ac929e4,1,16,16,32,9,2012-02-18 18:27:25,2012-02-18 04:11:02
fb3712c23886c5c1caba2c4661292b079ac929e4...75a5b79f5bbbe1abb71d096d0abaccea8e668fcd,1,121,117,238,17,2012-02-18 18:27:25,2012-02-18 04:15:44
75a5b79f5bbbe1abb71d096d0abaccea8e668fcd...0e4c737ce1550781048a23e60a50cf929540e506,1,3,3,6,2,2012-02-19 06:56:03,2012-02-19 06:56:03
0e4c737ce1550781048a23e60a50cf929540e506...e5f47c8131661893039a032ee25806f2a5307776,1,30,0,30,1,2012-02-20 00:10:38,2012-02-20 00:10:38
e5f47c8131661893039a032ee25806f2a5307776...421a6fbd20c96f28db154ac10354523aedd610c5,1,1,1,2,1,2012-02-21 05:38:47,2012-02-21 05:38:47
421a6fbd20c96f28db154ac10354523aedd610c5...5954c7f9a42372538147c0d305f14e9550ab1eff,1,2,0,2,2,2012-02-21 14:00:58,2012-02-21 14:00:58
5954c7f9a42372538147c0d305f14e9550ab1eff...8fdc53029c7e49a0c390a34df58bee7878763ea4,1,4,4,8,4,2012-02-21 14:23:51,2012-02-21 14:23:04
8fdc53029c7e49a0c390a34df58bee7878763ea4...be99a7f6b315cf3e0c3e136977fb222494bfa5bd,2,14,3,17,3,2012-02-21 14:24:17,2012-02-06 15:40:15
be99a7f6b315cf3e0c3e136977fb222494bfa5bd...03aabac5670065335093509f199900fd7f1541cd,1,17,16,33,8,2012-02-21 15:05:27,2012-02-21 15:04:37
03aabac5670065335093509f199900fd7f1541cd...e93976d265d365ac530238aecfecf6d783985624,1,15,2,17,2,2012-02-21 15:05:28,2012-02-21 15:05:00
e93976d265d365ac530238aecfecf6d783985624...f240a2a9eb376ec9789a562760864c652cc52593,1,1,1,2,1,2012-02-21 15:23:27,2012-02-10 18:08:13
f240a2a9eb376ec9789a562760864c652cc52593...26bb7661ebf0b58f5944ccfdfdf17127ab01819b,1,83,0,83,1,2012-02-21 17:25:46,2012-02-17 21:33:56
26bb7661ebf0b58f5944ccfdfdf17127ab01819b...1bd602c744a13f7edf191889b9d14315ccd98a29,1,6,0,6,1,2012-02-21 17:50:07,2012-02-21 17:49:06
1bd602c744a13f7edf191889b9d14315ccd98a29...ab7b4dbb51ac7252ecf4a3525ead615ecc243bdb,1,4,3,7,2,2012-02-21 17:50:07,2012-02-21 17:07:12
ab7b4dbb51ac7252ecf4a3525ead615ecc243bdb...cf0b0b38f4a2d41e14765ac9d1de9844a34128da,2,4,0,4,4,2012-02-21 18:30:25,2012-02-21 18:29:51
4e202ec5bfeff036ff42274e1594dcb82a74e942...efd5a0582a41cf2d8b4d4306da203e96d827fe07,1,3,2,5,4,2012-03-12 16:50:16,2012-03-12 16:48:57
efd5a0582a41cf2d8b4d4306da203e96d827fe07...66ad20abd4d99d811cddd354d4958123ef3e4233,1,25,19,44,4,2012-03-12 20:16:20,2012-03-02 03:20:33
66ad20abd4d99d811cddd354d4958123ef3e4233...6ad63a8ab7a215c607ffd8f545cbf1be8854952b,1,28,0,28,1,2012-03-12 20:21:57,2012-03-12 20:21:57
6ad63a8ab7a215c607ffd8f545cbf1be8854952b...ff7cd010c5da3a3e49ebf14f2fbb44e8425100dc,1,1,0,1,1,2012-03-12 20:22:03,2012-03-02 03:24:39
ff7cd010c5da3a3e49ebf14f2fbb44e8425100dc...728fdafdbf0b82956c34676db9299d655b119fd8,2,5,0,5,2,2012-03-12 20:23:42,2012-03-02 05:06:38
728fdafdbf0b82956c34676db9299d655b119fd8...564de424b79f0dcb7aad5278bd51787733a50333,2,8,14,22,5,2012-03-12 20:24:05,2012-03-04 05:33:48
564de424b79f0dcb7aad5278bd51787733a50333...47d77da609792d6e2fb24855333c4841b8602555,5,24,75,99,33,2012-03-12 20:25:20,2012-03-04 16:45:31
47d77da609792d6e2fb24855333c4841b8602555...77b24b3c0cb26810a4987086fa687a1ea79a87b0,2,21,19,40,11,2012-03-12 20:26:44,2012-03-04 16:55:53
77b24b3c0cb26810a4987086fa687a1ea79a87b0...aa18c5b3dcd7189d168ff7cc28b42f9ebdcf2de2,1,1,1,2,1,2012-03-12 20:28:05,2012-03-10 22:59:18
aa18c5b3dcd7189d168ff7cc28b42f9ebdcf2de2...5bf510bf9b5f1f5fdb2084b71761b43ef44f2df9,1,7,6,13,2,2012-03-12 20:28:23,2012-03-11 04:58:21
5bf510bf9b5f1f5fdb2084b71761b43ef44f2df9...6d3aab6e4d373eac880edb0c3a767c53e28f5836,2,46,33,79,16,2012-03-12 20:31:21,2012-03-12 20:31:21
6d3aab6e4d373eac880edb0c3a767c53e28f5836...5deaa6ca96547e09702780f84e72d00ee28cd4dc,3,24,7,31,11,2012-03-12 20:39:31,2012-03-12 03:52:54
5deaa6ca96547e09702780f84e72d00ee28cd4dc...22ac73535db5b423dce8202c45a6286271552689,1,3,3,6,3,2012-03-12 20:41:09,2012-03-12 05:20:22
22ac73535db5b423dce8202c45a6286271552689...a6487107c9b18d8d7849cb8b60e62b61a2eb772a,4,53,16,69,9,2012-03-12 20:41:17,2012-03-12 05:41:17
a6487107c9b18d8d7849cb8b60e62b61a2eb772a...4e1c66f452697a1c19af5eca23a0e8dfb37b6895,5,27,45,72,35,2012-03-12 20:42:30,2012-03-12 06:11:34
4e1c66f452697a1c19af5eca23a0e8dfb37b6895...f3744095b94d264ad83a11d0eb0faea2862f01eb,2,31,0,31,2,2012-03-13 13:53:10,2012-03-13 13:53:10
f3744095b94d264ad83a11d0eb0faea2862f01eb...206a2db6bae8228cf1d94ea5230a2f5d31657011,1,4,0,4,1,2012-03-13 15:25:30,2012-03-12 18:25:09
0a4e964ecf07ffa3dc6121e7f2b1a33d41db43f6...4437b203e712a2cf47fcfeb2fc0c747eee36b3bc,2,3,3,6,3,2011-05-31 20:25:57,2011-05-31 20:25:57
0a4e964ecf07ffa3dc6121e7f2b1a33d41db43f6...13364b16f47fb83b3cc5b9946fd1c9e2b57ae7eb,2,70,23,93,9,2011-05-31 19:17:55,2011-05-31 19:15:25
13364b16f47fb83b3cc5b9946fd1c9e2b57ae7eb...acc05925636f6709e95b927daaae593ff05b5a80,1,6,5,11,6,2011-05-31 19:28:56,2011-05-31 17:34:36
acc05925636f6709e95b927daaae593ff05b5a80...c117c4c2ea62201078f6a46b8bbed173f78746da,3,20,0,20,4,2011-05-31 19:28:56,2011-05-31 19:28:13
c117c4c2ea62201078f6a46b8bbed173f78746da...1cc6bb38db00247ece0a2353d90af8f7f1a53c75,1,4,2,6,2,2011-05-31 19:32:28,2011-05-31 19:31:41
1d59eb6603fbd630ffc944563e48dd1ab5e8d091...7acd67609322bb2771228e84c7bc381d170f89b1,1,45,11,56,9,2011-06-21 21:23:01,2011-06-21 21:23:01
7acd67609322bb2771228e84c7bc381d170f89b1...b5737916a7d0bec00e56a7256056a13746a8c9b0,1,39,11,50,6,2011-06-21 23:25:03,2011-06-21 23:25:03
b5737916a7d0bec00e56a7256056a13746a8c9b0...d55d9744ad38f698a16fd785e1c7d99fdfff02bb,3,47,2,49,8,2011-06-21 23:39:53,2011-06-21 20:32:31
d55d9744ad38f698a16fd785e1c7d99fdfff02bb...d56df6846343f39260afc5779a9ec957439213f6,1,64,0,64,2,2011-06-21 23:39:53,2011-06-21 21:39:42
d56df6846343f39260afc5779a9ec957439213f6...e40135e5cef54dd71c5969c2df3966d740d6a1ea,5,139,23,162,12,2011-06-22 01:42:47,2011-06-22 01:41:34
e40135e5cef54dd71c5969c2df3966d740d6a1ea...99c28cb998c7a8475dcfdf9b51b281efad024b05,2,3,3,6,3,2011-06-22 02:09:04,2011-06-22 02:09:04
1d59eb6603fbd630ffc944563e48dd1ab5e8d091...aefc2167f4e0ce488e39be27e7c3e01c66216492,1,1,1,2,1,2011-06-21 20:21:09,2011-06-21 20:21:09
83a9a19571c174bc934727b36d83ce5e2954d0dc...89230c31ee6d0ab0b1b303add8f4c406cca6fc90,1,1,1,2,1,2012-03-14 16:04:33,2012-03-14 16:04:33
89230c31ee6d0ab0b1b303add8f4c406cca6fc90...0ccf660c70dbc14e309fb6194d55e6d45724a892,1,6,0,6,1,2012-03-14 16:22:42,2012-03-14 16:22:42
0ccf660c70dbc14e309fb6194d55e6d45724a892...bdfc1eb360c8a9285cb0fc54a4a6f6b7efc45f0a,1,2,2,4,2,2012-03-14 17:21:50,2012-03-14 17:21:50
bdfc1eb360c8a9285cb0fc54a4a6f6b7efc45f0a...fd96f42d716f34cf30c24258dd379c2af552dc4f,1,2,0,2,1,2012-03-14 17:49:51,2012-03-14 17:49:51
fd96f42d716f34cf30c24258dd379c2af552dc4f...421745c87f8642ccce77bc4f241ca5f98a0b737a,2,22,4,26,2,2012-03-14 18:19:34,2012-03-14 18:19:06
421745c87f8642ccce77bc4f241ca5f98a0b737a...6d9beb1b39b24a98014ddb586cddfa893ccf2a44,1,10,48,58,12,2012-03-14 18:43:54,2012-03-14 18:43:54
6d9beb1b39b24a98014ddb586cddfa893ccf2a44...ced3eb63cf349aa42bcffaa8a8d06ee445e0ca60,4,1,47,48,9,2012-03-14 18:50:54,2012-03-14 18:50:54
ced3eb63cf349aa42bcffaa8a8d06ee445e0ca60...57c0176eff861ed468c86a694ea25cdc4f1d6a42,1,3,4,7,6,2012-03-15 15:05:39,2012-03-15 15:05:39
57c0176eff861ed468c86a694ea25cdc4f1d6a42...bd69f3d98fae89d2804e39e105eb6d1eb2c572d8,3,77,150,227,42,2012-03-15 15:30:01,2012-03-15 15:30:01
bd69f3d98fae89d2804e39e105eb6d1eb2c572d8...60ef5202cbdd273ca6c9b00938d8ee3d2309b295,1,1,1,2,1,2012-03-15 16:17:44,2012-03-15 15:32:19
60ef5202cbdd273ca6c9b00938d8ee3d2309b295...2feeb81d0b1795b97ca670b88d8f980ac8278634,1,15,14,29,10,2012-03-15 16:40:11,2012-03-15 16:40:11
2feeb81d0b1795b97ca670b88d8f980ac8278634...29931c1a15f4ae32ca3cdcf26ade606a46f38d7b,2,2,2,4,2,2012-03-15 16:56:39,2012-03-15 16:56:39
206a2db6bae8228cf1d94ea5230a2f5d31657011...825c8b7fa8cb3e907f651692b4e8410e524d7720,1,5,2,7,2,2012-03-13 19:34:05,2012-03-13 19:33:16
825c8b7fa8cb3e907f651692b4e8410e524d7720...f427d5cd4f1fe89ac5688c5e914a32d722f7a450,1,10,0,10,1,2012-03-14 03:53:09,2012-03-14 03:53:09
f427d5cd4f1fe89ac5688c5e914a32d722f7a450...88ea9f1fac06685d59a61a7f1d445b396f02441e,4,81,69,150,45,2012-03-14 03:54:07,2012-03-14 00:33:56
88ea9f1fac06685d59a61a7f1d445b396f02441e...0467512a8eaec22b54f2281624c229cacd5e36f5,1,24,0,24,1,2012-03-14 03:54:08,2012-03-14 00:46:40
0467512a8eaec22b54f2281624c229cacd5e36f5...b8d0917f1ea8092dadae529751701d9772a4ce81,1,14,0,14,1,2012-03-14 03:54:09,2012-03-14 01:26:59
ddc6ab7857be2704a3357ff9549610f7d5f7ee4f...51701b56b400cd8b00bee823c421cc04951f4581,1,25,0,25,2,2011-05-31 21:32:38,2011-05-31 21:32:38
51701b56b400cd8b00bee823c421cc04951f4581...8a2bdb812ce335cdefb6d1688b68ff8e7968502f,2,11,1,12,2,2011-05-31 21:49:19,2011-05-31 20:30:15
8a2bdb812ce335cdefb6d1688b68ff8e7968502f...c4dff971d6ba6bf69b40637168286aaeaaa227f1,2,33,38,71,12,2011-05-31 21:49:19,2011-05-31 21:31:24
c4dff971d6ba6bf69b40637168286aaeaaa227f1...6b336f862dda3a959d3104a648b34f92f25b8956,1,23,16,39,5,2011-05-31 21:49:59,2011-05-31 21:49:59
6b336f862dda3a959d3104a648b34f92f25b8956...00fe69f3fa4d80f072dbb346e91b2d9d5cce648f,1,4,4,8,4,2011-05-31 22:09:59,2011-05-31 22:09:59
00fe69f3fa4d80f072dbb346e91b2d9d5cce648f...ad63ae8a4b7c88ca28b665e1eb8ef6e1d77ae0b5,1,7,0,7,1,2011-06-01 00:53:00,2011-06-01 00:53:00
ad63ae8a4b7c88ca28b665e1eb8ef6e1d77ae0b5...927bd87c9033131fe28bbc3839df4ffcb0e01625,1,20,6,26,6,2011-06-01 07:06:17,2011-06-01 07:06:17
927bd87c9033131fe28bbc3839df4ffcb0e01625...d61ea38d7dd114f01128d8a50877962bee82f23c,1,3,2,5,2,2011-06-01 07:08:06,2011-06-01 07:08:06
d61ea38d7dd114f01128d8a50877962bee82f23c...600f2eef36c299b32810ce1a79c8bb4bb120c2ab,8,36,15,51,15,2011-06-01 13:35:42,2011-06-01 13:35:42
600f2eef36c299b32810ce1a79c8bb4bb120c2ab...cc95c7a995913451e57709b709050178f501ebbc,2,7,2,9,3,2011-06-01 13:41:12,2011-06-01 13:41:12
cc95c7a995913451e57709b709050178f501ebbc...6fb6d68be8276e43bfe3d08d3253a5140d8bde52,1,0,1,1,1,2011-06-01 15:01:31,2011-06-01 15:01:31
6fb6d68be8276e43bfe3d08d3253a5140d8bde52...a3b4ae9f1cc0d23b9f8975c7e36b7a65c9097c34,1,1,1,2,2,2011-06-01 15:06:23,2011-06-01 15:05:52
a3b4ae9f1cc0d23b9f8975c7e36b7a65c9097c34...b0251981731e091030d9a02e83614f4d68e1ee74,1,1,1,2,1,2011-06-01 15:40:37,2011-06-01 15:22:00
b0251981731e091030d9a02e83614f4d68e1ee74...224069295263b672736845ba40d7f79f82ee42e6,1,7,7,14,4,2011-06-01 16:23:10,2011-06-01 16:23:10
6391c9832602e4b9935a41dfbcf8b5c4808c8632...ab47d8d34b3f368b2242769e7f70d827b3790617,2,6,6,12,6,2011-06-22 05:35:35,2011-06-22 05:31:02
ab47d8d34b3f368b2242769e7f70d827b3790617...34c0970db02475a241b54e4aa62fe4c529c16060,1,12,10,22,4,2011-06-22 05:58:34,2011-06-22 05:22:44
29931c1a15f4ae32ca3cdcf26ade606a46f38d7b...fda3f259ef8c59918c14a106b9adfc94f8565f17,2,6,6,12,6,2012-03-16 17:50:30,2012-03-16 17:50:30
29931c1a15f4ae32ca3cdcf26ade606a46f38d7b...44b0ab91d74cfae6ddd04272d5ad0ff592c4f4f6,3,16,8,24,9,2012-03-15 18:27:38,2012-03-15 18:27:38
44b0ab91d74cfae6ddd04272d5ad0ff592c4f4f6...6c0d076da7af0b9e3ee7f1906e199ba62597c628,2,9,2,11,3,2012-03-15 18:42:30,2012-03-15 18:42:30
6c0d076da7af0b9e3ee7f1906e199ba62597c628...685cc9d58fe30d7fe4f08522b144ce28bc042cd5,1,4,4,8,4,2012-03-15 19:35:38,2012-03-15 19:35:33
685cc9d58fe30d7fe4f08522b144ce28bc042cd5...2634a4f3634fce7279f52ac3a17691072706e6c3,3,0,57,57,8,2012-03-15 20:56:47,2012-03-15 20:54:57
28b47022a5382b8647a8ea27881c863c9bad17ab...0a833687a98638018e0814beefe4f21de5d32c11,1,22,5,27,4,2012-02-21 19:34:06,2012-02-21 19:34:06
0a833687a98638018e0814beefe4f21de5d32c11...c6539aaea1fab92a7653a86cdc196193feb994bb,2,54,2,56,6,2012-02-21 20:28:54,2012-02-21 20:28:54
c6539aaea1fab92a7653a86cdc196193feb994bb...d96db7666600d4284237f357bb9b309832381fbd,1,1,1,2,1,2012-02-21 21:52:34,2012-02-21 21:52:34
d96db7666600d4284237f357bb9b309832381fbd...f1b4873140e2b2b00ff5e0b2ac50f990ef04515b,1,3,4,7,3,2012-02-21 22:16:01,2012-02-21 22:15:30
f1b4873140e2b2b00ff5e0b2ac50f990ef04515b...b2e03136d0d585df47d6c25f91c20f6bc98ec83d,2,4,4,8,2,2012-02-21 22:46:39,2012-02-21 18:14:22
b2e03136d0d585df47d6c25f91c20f6bc98ec83d...7b79d3b19323253bd977dba3dffbe4721cfd3beb,1,1,1,2,1,2012-02-21 22:48:59,2012-02-21 19:37:57
7b79d3b19323253bd977dba3dffbe4721cfd3beb...d729604faf373b4692db5bdb254c5ac53df90f4c,1,1,1,2,1,2012-02-21 23:39:08,2012-02-21 23:37:54
d729604faf373b4692db5bdb254c5ac53df90f4c...ddb88d3fcf4cda0d1bb0ddf9c35263fbe2e74868,5,595,133,728,60,2012-02-22 01:50:46,2012-02-22 01:49:48
ddb88d3fcf4cda0d1bb0ddf9c35263fbe2e74868...3250cdef82ac620cef1b1883782a9fa5cff788d1,1,1,1,2,1,2012-02-22 02:09:46,2012-02-22 02:09:46
3250cdef82ac620cef1b1883782a9fa5cff788d1...5db31ca293474a6b7ea50b91da9ca89e5b37f357,1,2,2,4,1,2012-02-22 15:14:46,2012-02-22 15:14:24
5db31ca293474a6b7ea50b91da9ca89e5b37f357...4398322121cb5a79eba7ccc67764a50181dfd27c,2,4,19,23,6,2012-02-22 16:48:01,2012-02-22 16:19:48
4398322121cb5a79eba7ccc67764a50181dfd27c...2eec128d9efac6fa383fbc466ed65c2259a4dd74,1,8,0,8,1,2012-02-22 19:52:30,2012-02-22 19:52:30
2eec128d9efac6fa383fbc466ed65c2259a4dd74...1e51e26a0de6a406a60244197cd0c2d078347a1b,1,1,1,2,1,2012-02-22 19:53:11,2012-02-22 19:53:11
1e51e26a0de6a406a60244197cd0c2d078347a1b...32944fa85a1d95cae028ddf7bdcdb62e3840b5ea,1,1,1,2,1,2012-02-22 20:40:29,2012-02-22 20:11:04
32944fa85a1d95cae028ddf7bdcdb62e3840b5ea...2daa081117651684eed47622c88ffd81b6321c68,1,1,1,2,1,2012-02-22 20:40:29,2012-02-22 20:11:25
2daa081117651684eed47622c88ffd81b6321c68...4a4e3a092fcf81cdcc6171720a345eb6b5546114,2,12,3,15,6,2012-02-22 20:40:29,2012-02-22 20:14:51
4a4e3a092fcf81cdcc6171720a345eb6b5546114...d91c4ee5fc8c7175264264b1b37a9784c19c8f5e,2,44,22,66,12,2012-02-22 20:40:29,2012-02-22 20:39:22
d91c4ee5fc8c7175264264b1b37a9784c19c8f5e...a61b5f365eb5e013ef17c7f567013965089ab10f,2,41,6,47,6,2012-02-22 20:40:29,2012-02-22 20:40:09
a61b5f365eb5e013ef17c7f567013965089ab10f...661b26c5f68c6987b70c8059d03f14397f7965a0,1,2,2,4,1,2012-02-22 20:58:37,2012-02-22 20:58:37
661b26c5f68c6987b70c8059d03f14397f7965a0...a5bd61d7753856918fbf2be1e1f1e14732831363,1,2,2,4,1,2012-02-22 21:26:30,2012-02-22 21:26:30
224069295263b672736845ba40d7f79f82ee42e6...e104e01f8410cef79e29e766d66133458df85220,3,52,8,60,9,2011-06-01 18:57:40,2011-06-01 18:57:40
224069295263b672736845ba40d7f79f82ee42e6...bec32bf3cdb7f3c771145fa9ad642b167171f23c,8,35,16,51,20,2011-06-01 16:27:09,2011-06-01 16:26:41
34c0970db02475a241b54e4aa62fe4c529c16060...6c4b677fcd07fe930b2ee0beaa9e8f7df3d9c5b4,4,62,10,72,12,2011-06-22 14:16:45,2011-06-22 14:16:45
34c0970db02475a241b54e4aa62fe4c529c16060...6973006921989f48910494a641e97ad5bdbd9453,6,65,20,85,15,2011-06-22 14:06:22,2011-06-22 14:06:22
a043a0964e57fbf1f8f7af21ae2c0ae977ead5e9...1489d40923399d8cd6384942c3e89bf5f4c3cb7b,1,0,2,2,1,2012-03-16 17:58:35,2012-03-16 17:58:35
1489d40923399d8cd6384942c3e89bf5f4c3cb7b...1881e047713e5c365c1429f963bcd63202fdb82c,2,45,18,63,24,2012-03-16 20:25:24,2012-03-16 20:25:24
1881e047713e5c365c1429f963bcd63202fdb82c...b45d00db61e1a20e58821acd502536948c8bfdcc,1,2,2,4,2,2012-03-16 22:05:29,2012-03-16 22:05:29
b45d00db61e1a20e58821acd502536948c8bfdcc...c4851043c682c9e2a9230166045ce85b518b85eb,1,5,1,6,2,2012-03-16 23:22:34,2012-03-16 23:22:34
c4851043c682c9e2a9230166045ce85b518b85eb...938ac1619dc88dc5f9e6df47dcb981fbf0f33663,4,8,1,9,4,2012-03-16 23:26:50,2012-03-16 23:26:50
938ac1619dc88dc5f9e6df47dcb981fbf0f33663...b8cec6e3c0df43c63e096dabd93d5697c6143b82,4,1,13,14,5,2012-03-17 02:05:39,2012-03-17 02:05:39
b8cec6e3c0df43c63e096dabd93d5697c6143b82...c952ba7c9c761d6f2198fc4e2ee29de04f91ba7e,1,3,0,3,1,2012-03-17 02:30:04,2012-03-17 02:30:04
c952ba7c9c761d6f2198fc4e2ee29de04f91ba7e...5c822e52d7bdb416f783d586f92ebd3c25343bcd,1,7,4,11,7,2012-03-17 06:31:28,2012-03-17 06:31:28
5c822e52d7bdb416f783d586f92ebd3c25343bcd...c949cad1fa6e4cb26693748b1751f4fd2e6113b8,3,6,1,7,4,2012-03-17 07:10:14,2012-03-17 07:10:14
c949cad1fa6e4cb26693748b1751f4fd2e6113b8...fc0769a8ac8dccd29c93444a9117f366e52a4e39,1,39,88,127,48,2012-03-18 15:06:43,2012-03-18 15:06:43
fc0769a8ac8dccd29c93444a9117f366e52a4e39...93def947328a833173a2b7072cf0cf81c4c0a97c,2,0,154,154,2,2012-03-18 16:46:02,2012-03-18 16:46:02
93def947328a833173a2b7072cf0cf81c4c0a97c...54314ed18b087024fc9802a4287692dd054b0555,1,1,1,2,1,2012-03-18 18:23:39,2012-03-18 18:23:39
54314ed18b087024fc9802a4287692dd054b0555...5836affdf8bb007254d77bb6a8beb3d21a2af68b,2,48,25,73,3,2012-03-18 18:24:01,2012-03-18 18:24:01
5836affdf8bb007254d77bb6a8beb3d21a2af68b...f5d4624920d1e6447ce4b2be83114f62e94392f9,1,36,0,36,1,2012-03-18 18:25:23,2012-03-18 18:25:23
f5d4624920d1e6447ce4b2be83114f62e94392f9...002a3520729b00d9f5a928bc7ae2991e1770d791,3,13,12,25,12,2012-03-18 18:50:14,2012-03-18 18:50:14
002a3520729b00d9f5a928bc7ae2991e1770d791...f2c3587ef3a31d54183be6e62c23f1e89c748065,3,29,9,38,12,2012-03-18 19:12:42,2012-03-18 19:12:42
f2c3587ef3a31d54183be6e62c23f1e89c748065...3caf10e15c9ffb9582cd1eaa386fae5c33ba12fa,4,50,68,118,33,2012-03-18 19:43:05,2012-03-18 19:43:05
3caf10e15c9ffb9582cd1eaa386fae5c33ba12fa...01972d5133fb6717b9ee8ef85956c97da281a181,1,1,0,1,1,2012-03-18 21:03:27,2012-03-18 21:02:43
01972d5133fb6717b9ee8ef85956c97da281a181...de20dd200870367e3f9000c9a6b74fed5e8fa402,1,6,5,11,2,2012-03-18 21:33:07,2012-03-18 21:33:07
a5bd61d7753856918fbf2be1e1f1e14732831363...b2cce77619151cf1fb2d5da56a2f4f8fb5511481,6,36,1,37,3,2012-02-22 23:35:00,2012-02-22 23:34:00
b2cce77619151cf1fb2d5da56a2f4f8fb5511481...9c14d20cf59b24846339a3145091894d85b217a1,4,51,8,59,13,2012-02-23 17:08:21,2012-02-23 16:49:00
9c14d20cf59b24846339a3145091894d85b217a1...51fbd62859b801431cad4625804dfadbe26e6496,1,1,1,2,1,2012-02-23 17:14:09,2012-02-23 17:14:09
51fbd62859b801431cad4625804dfadbe26e6496...51e9b45d893ab822f3885c42d7347572b977c1f6,2,10,4,14,3,2012-02-23 22:32:02,2012-02-23 22:28:59
51e9b45d893ab822f3885c42d7347572b977c1f6...b8bb84091d1e5b5b586553bf79ec15e5d1fc61f4,2,12,10,22,7,2012-02-23 23:12:57,2012-02-23 22:35:30
b8bb84091d1e5b5b586553bf79ec15e5d1fc61f4...7804ea784e5fec0e73fa95dc69f7df0e0c3413a5,1,9,10,19,6,2012-02-24 00:01:22,2012-02-23 23:59:55
7804ea784e5fec0e73fa95dc69f7df0e0c3413a5...fe8cd5a9829aafa51e177b2bebf835c6b23f0021,1,3,0,3,1,2012-02-24 04:39:37,2012-02-24 04:34:35
fe8cd5a9829aafa51e177b2bebf835c6b23f0021...d603bf761880e88872f56ff5f3001cf832b4f1f3,1,1,1,2,1,2012-02-24 04:56:11,2012-02-24 04:55:02
d603bf761880e88872f56ff5f3001cf832b4f1f3...bbace48501659fb35dd9c3764dbefc4601c4a90d,1,4,4,8,3,2012-02-24 13:00:56,2012-02-24 13:00:56
bbace48501659fb35dd9c3764dbefc4601c4a90d...0b88db9f59f580e16bd8325f4b6d69b9db6199fb,1,1,1,2,1,2012-02-24 15:24:32,2012-02-24 15:24:32
0b88db9f59f580e16bd8325f4b6d69b9db6199fb...d9e2eae9cbc84262d799d8736d49e4e32d432170,2,2,2,4,2,2012-02-24 17:57:57,2012-02-24 17:57:57
d9e2eae9cbc84262d799d8736d49e4e32d432170...6c93e73dadb508af7dda2fb5834bb4e6cbf3f174,1,1,1,2,1,2012-02-24 18:15:19,2012-02-24 18:15:19
6c93e73dadb508af7dda2fb5834bb4e6cbf3f174...79a8b1ec555c0a25c1d970f2e73a790f980acac9,1,2,2,4,1,2012-02-24 18:40:45,2012-02-24 18:40:45
79a8b1ec555c0a25c1d970f2e73a790f980acac9...f8eee92420b445224ab4efb52a0ae0ad39ff6ecc,1,13,2,15,2,2012-02-24 20:23:57,2012-02-24 20:20:29
f8eee92420b445224ab4efb52a0ae0ad39ff6ecc...0d67a4740d9bb05c99f9fb2fc1be73b39e2881f8,1,6,2,8,2,2012-02-24 21:06:14,2012-02-24 21:06:14
0d67a4740d9bb05c99f9fb2fc1be73b39e2881f8...ca3315fe176d4c7d718948481805af5c7362fa46,1,5,0,5,2,2012-02-24 21:17:36,2012-02-24 21:17:04
ca3315fe176d4c7d718948481805af5c7362fa46...78c281f3c4b05790292138a759236eddba4188da,1,0,1,1,1,2012-02-24 21:34:11,2012-02-24 21:32:59
78c281f3c4b05790292138a759236eddba4188da...88db626c74fac3ee0321f4e28e1f54d15c355fec,1,4,1,5,2,2012-02-25 00:20:04,2012-02-24 20:39:24
88db626c74fac3ee0321f4e28e1f54d15c355fec...3b4531c93d8c283dd9eceeb72ba2ed7dca17fffa,17,471,56,527,33,2012-02-25 06:49:05,2011-12-20 05:01:34
3b4531c93d8c283dd9eceeb72ba2ed7dca17fffa...20709ccd8e9c6f8ed6daa0c7d1d5b2afc4e3f509,5,25,55,80,19,2012-02-25 06:49:05,2011-12-27 01:31:31
20709ccd8e9c6f8ed6daa0c7d1d5b2afc4e3f509...9e1d7232897fc70f41baef2bf4b91263d6feb381,2,2,2,4,2,2012-02-25 06:49:05,2011-12-27 20:51:47
9e1d7232897fc70f41baef2bf4b91263d6feb381...1edece18f3ec57765bc47ebd15a5ac260b9e692d,1,15,4,19,2,2012-02-25 06:49:05,2011-12-30 02:02:09
1edece18f3ec57765bc47ebd15a5ac260b9e692d...9b4882f5529d28d77a10844333a53ebb148ceabe,1,1,1,2,1,2012-02-25 06:49:05,2011-12-30 02:03:00
9b4882f5529d28d77a10844333a53ebb148ceabe...421c216b76e48a579c6de73e840ce9636f7736f6,1,2,2,4,2,2012-02-25 06:49:06,2011-12-30 02:05:46
421c216b76e48a579c6de73e840ce9636f7736f6...069fe443807034b56338df137f5aa10e4c9e6455,3,25,21,46,13,2012-02-25 06:49:06,2011-12-30 06:23:10
069fe443807034b56338df137f5aa10e4c9e6455...d323a5c7b297b21018233ecebc1f05747ef96ed3,1,9,9,18,10,2012-02-25 06:49:06,2011-12-30 18:53:54
d323a5c7b297b21018233ecebc1f05747ef96ed3...cedf6ad01398267c028fc7f0919f811344606cb3,11,396,186,582,56,2012-02-25 06:49:06,2012-01-04 22:36:00
cedf6ad01398267c028fc7f0919f811344606cb3...cbc14d84aa92bf065f4998bb00af27c1dc946df8,1,1,1,2,1,2012-02-25 06:49:06,2012-01-04 22:48:01
cbc14d84aa92bf065f4998bb00af27c1dc946df8...eac5c56ed64fe98e4c77719a8f57d42cd5cb2632,10,272,50,322,49,2012-02-25 06:49:06,2012-01-23 23:11:13
eac5c56ed64fe98e4c77719a8f57d42cd5cb2632...a2a5d2807223fd41dc0651dc6bb3fa8aa7a3c6d4,1,1,1,2,1,2012-02-25 06:49:06,2012-01-24 00:40:15
a2a5d2807223fd41dc0651dc6bb3fa8aa7a3c6d4...18702b2e5293c4f8002b5f721c56bd5a315c146f,1,1,10,11,1,2012-02-25 06:49:06,2012-01-27 19:53:01
18702b2e5293c4f8002b5f721c56bd5a315c146f...f272ba34266c1295f8ff726b84ac6cbf259e50c9,1,4,2,6,2,2012-02-25 06:49:07,2012-01-27 20:42:36
f272ba34266c1295f8ff726b84ac6cbf259e50c9...03f8584da52bd271a7e9e62911be064d8465e2a5,3,73,79,152,22,2012-02-25 06:49:07,2012-02-03 02:16:30
03f8584da52bd271a7e9e62911be064d8465e2a5...cbe73fc1cf3aaa0f47706ac1f6721fbb5312b091,2,5,9,14,2,2012-02-25 06:49:07,2012-02-03 19:30:46
cbe73fc1cf3aaa0f47706ac1f6721fbb5312b091...a55a6a888eadf51489d5b4cefd58628d1e800323,2,4,11,15,5,2012-02-25 06:49:07,2012-02-03 19:48:26
a55a6a888eadf51489d5b4cefd58628d1e800323...6d25e34bffac719d9fac314f56aca77f6417f5cb,4,26,58,84,13,2012-02-25 06:49:07,2012-02-06 01:51:55
6d25e34bffac719d9fac314f56aca77f6417f5cb...55cb84305be208e5166baa4788a544973c02c7d4,1,0,1,1,1,2012-02-25 06:49:07,2012-02-06 04:36:19
55cb84305be208e5166baa4788a544973c02c7d4...84d715a5fd8c594591e12b7a93d65bd0fbf30c2c,6,145,3,148,30,2012-02-25 06:49:07,2012-02-06 04:49:18
84d715a5fd8c594591e12b7a93d65bd0fbf30c2c...45d8db20feeded0a7227c7306a91922b143c716a,1,114,114,228,1,2012-02-25 06:49:07,2012-02-06 04:53:22
45d8db20feeded0a7227c7306a91922b143c716a...2ccef07da8b4e4da64cbda6de3b52725e16d36d4,3,87,56,143,24,2012-02-25 06:49:07,2012-02-06 08:15:07
2ccef07da8b4e4da64cbda6de3b52725e16d36d4...cb40560b1a085f9cd0e632b3e6879d6611df10dc,4,41,54,95,32,2012-02-25 06:49:08,2012-02-06 08:57:25
cb40560b1a085f9cd0e632b3e6879d6611df10dc...afc4e7fe813a753bf24414ff1385226d8ebbbd86,24,1535,243,1778,117,2012-02-25 06:49:08,2012-02-14 17:30:08
afc4e7fe813a753bf24414ff1385226d8ebbbd86...cd13f06c5729921bdaf614743177b3169a737021,5,43,42,85,19,2012-02-25 06:49:08,2012-02-14 19:24:14
cd13f06c5729921bdaf614743177b3169a737021...f64ca4f1577e0502d2678a5e6d0ead50077614ea,1,96,42,138,18,2012-02-25 06:49:08,2012-02-14 21:18:05
f64ca4f1577e0502d2678a5e6d0ead50077614ea...e19d873f5cf97ab92360691a12dbb5d9a73a2e08,1,2,2,4,2,2012-02-25 06:49:08,2012-02-14 21:24:23
e19d873f5cf97ab92360691a12dbb5d9a73a2e08...460ebf18d7d71e5a2b8c921d3b46768fb2bfdc45,2,2,1,3,2,2012-02-25 06:49:08,2012-02-14 23:53:19
460ebf18d7d71e5a2b8c921d3b46768fb2bfdc45...98d1c227fdd7d088e9b954e1d6498a9613038e45,2,9,9,18,9,2012-02-25 06:49:08,2012-02-17 02:09:35
98d1c227fdd7d088e9b954e1d6498a9613038e45...6738c4804772f37f45bfa1b6c70dac2a19ab50bc,2,5,1,6,2,2012-02-25 06:49:09,2012-02-17 02:17:45
6738c4804772f37f45bfa1b6c70dac2a19ab50bc...48652d6d786712f822e4d521a79d8cb9c59e03c8,2,0,11,11,4,2012-02-25 06:49:09,2012-02-17 02:23:12
48652d6d786712f822e4d521a79d8cb9c59e03c8...84941f6a11962f898e6092abd99686a73dd03b54,3,110,281,391,15,2012-02-25 06:49:09,2012-02-17 02:35:13
84941f6a11962f898e6092abd99686a73dd03b54...ca11f9c005c419d4dc2f17a2ac17b60ed284d1fb,1,130,97,227,13,2012-02-25 06:49:09,2012-02-17 03:43:10
ca11f9c005c419d4dc2f17a2ac17b60ed284d1fb...d69d871d6929e7fe3544c1e2b42aa616f27a810a,1,25,22,47,18,2012-02-25 06:49:09,2012-02-17 03:55:02
d69d871d6929e7fe3544c1e2b42aa616f27a810a...edf626971096259fd39ee65ca193950b64085a71,4,6,6,12,6,2012-02-25 06:49:09,2012-02-17 04:47:56
edf626971096259fd39ee65ca193950b64085a71...6b3dce26dc75433ef11c24a720ce9117ddcff7f7,6,25,23,48,18,2012-02-25 06:49:09,2012-02-17 06:16:19
6b3dce26dc75433ef11c24a720ce9117ddcff7f7...39781e3feedbf64a8cff3f4794b5d6126d3ebb33,1,65,38,103,29,2012-02-25 06:49:09,2012-02-17 06:49:59
39781e3feedbf64a8cff3f4794b5d6126d3ebb33...c72b68716c1fb587cca44b25b1f66a9635665a31,1,61,49,110,16,2012-02-25 06:49:10,2012-02-17 07:11:43
c72b68716c1fb587cca44b25b1f66a9635665a31...97c843d457bc81b0880360e1980b484ceadf877f,1,27,18,45,18,2012-02-25 06:49:10,2012-02-17 18:35:18
97c843d457bc81b0880360e1980b484ceadf877f...4617a8c544ec30803cf89bc3eee5ee4b6142ec10,1,21,21,42,9,2012-02-25 06:49:10,2012-02-17 18:42:52
4617a8c544ec30803cf89bc3eee5ee4b6142ec10...51aa84dd7098fc621ec6b4703722c3aa04fb219c,1,44,10,54,3,2012-02-25 06:49:10,2012-02-18 06:12:54
51aa84dd7098fc621ec6b4703722c3aa04fb219c...7cd174a71c58f150038987d2f492de92cc952fc7,2,17,21,38,13,2012-02-25 06:49:10,2012-02-18 07:02:20
7cd174a71c58f150038987d2f492de92cc952fc7...17d6036719d3b95f2dfa06f71dd6c658926e3265,1,10,0,10,2,2012-02-25 06:49:10,2012-02-18 07:19:02
17d6036719d3b95f2dfa06f71dd6c658926e3265...7d19cc453dcd093caa4285097922d420b51a3c35,1,3,5,8,2,2012-02-25 06:49:10,2012-02-18 07:25:38
7d19cc453dcd093caa4285097922d420b51a3c35...02d8e5de8c3e8dfa1677df978b68e91f129c4439,1,1,1,2,1,2012-02-25 06:49:11,2012-02-18 07:33:19
02d8e5de8c3e8dfa1677df978b68e91f129c4439...d633f330ec01b1fcff1ee539df16344583583f55,3,47,8,55,7,2012-02-25 06:49:11,2012-02-18 20:38:54
d633f330ec01b1fcff1ee539df16344583583f55...b050af9205e7dc529e63d8e972babcb03723cb5c,1,4,0,4,1,2012-02-25 06:49:11,2012-02-18 21:54:00
b050af9205e7dc529e63d8e972babcb03723cb5c...ce68f3b6fb070672019d8856639c75bce71003f8,1,6,3,9,6,2012-02-25 06:49:11,2012-02-18 21:56:51
ce68f3b6fb070672019d8856639c75bce71003f8...b1d789243303c8e1a1968594d22ba5fa36301e1b,1,1,3,4,2,2012-02-25 06:49:11,2012-02-19 02:26:46
b1d789243303c8e1a1968594d22ba5fa36301e1b...cd2f289390128164383f4d7165613354dfa1a00a,2,32,1,33,6,2012-02-25 06:49:11,2012-02-19 02:58:22
cd2f289390128164383f4d7165613354dfa1a00a...5c0db4208cf8b0c4ce051190a4f93a17335ea21e,1,8,0,8,1,2012-02-25 06:49:11,2012-02-19 03:30:04
5c0db4208cf8b0c4ce051190a4f93a17335ea21e...78e17371f0e2c0f7d647bbbdf711465491568d97,2,34,8,42,7,2012-02-25 06:49:12,2012-02-19 04:03:02
78e17371f0e2c0f7d647bbbdf711465491568d97...b9eab2d7d881506dcb960ea34643eb6d7980c38a,3,16,3,19,5,2012-02-25 06:49:12,2012-02-19 04:55:22
b9eab2d7d881506dcb960ea34643eb6d7980c38a...9a186891dda7319aaf15fa4f5d1599ac229e745d,5,58,24,82,24,2012-02-25 06:49:12,2012-02-19 06:22:18
9a186891dda7319aaf15fa4f5d1599ac229e745d...6dc906b1fab17df7e91def34db026ac7cf520b78,2,18,12,30,9,2012-02-25 06:49:12,2012-02-19 06:43:43
6dc906b1fab17df7e91def34db026ac7cf520b78...2f216fc5fa7e6cc83e89bcb306ec7e7100da7197,1,16,2,18,3,2012-02-25 06:49:12,2012-02-19 07:33:11
2f216fc5fa7e6cc83e89bcb306ec7e7100da7197...13e775ba33601c50d0cbc6cd0f409f831b5883e0,1,143,131,274,6,2012-02-25 06:49:12,2012-02-19 19:53:45
13e775ba33601c50d0cbc6cd0f409f831b5883e0...4cc7a33095905aabbef315d057422bad60a1225c,4,276,247,523,19,2012-02-25 06:49:12,2012-02-19 20:10:01
4cc7a33095905aabbef315d057422bad60a1225c...988435bb98776a0242c9851ea27ec44e03b6ad0b,1,20,0,20,1,2012-02-25 06:49:12,2012-02-19 20:13:49
988435bb98776a0242c9851ea27ec44e03b6ad0b...43aa6577ae38c7183e50f0cadc96191d27d324db,1,13,1,14,4,2012-02-25 06:49:13,2012-02-20 00:15:59
43aa6577ae38c7183e50f0cadc96191d27d324db...ed3f8b03f91b94d1517e8ee724f3723383aa3851,5,50,21,71,13,2012-02-25 06:49:13,2012-02-20 02:39:02
ed3f8b03f91b94d1517e8ee724f3723383aa3851...c10c3e941b475ee13e922139c276d099b607d475,2,148,120,268,17,2012-02-25 06:49:13,2012-02-20 02:46:30
c10c3e941b475ee13e922139c276d099b607d475...edf19e30689e06a46b53fd5a9daeef9f3d60507f,2,32,35,67,21,2012-02-25 06:49:13,2012-02-20 03:16:34
edf19e30689e06a46b53fd5a9daeef9f3d60507f...33ede3392b3c46e0c97bb0227869fda553c4dd20,5,27,3,30,8,2012-02-25 06:49:13,2012-02-20 03:40:20
33ede3392b3c46e0c97bb0227869fda553c4dd20...3f4ac45585e7e5b78cafbd146b87bc49d0f96238,1,6,7,13,2,2012-02-25 06:49:13,2012-02-20 05:22:14
3f4ac45585e7e5b78cafbd146b87bc49d0f96238...7e8cf0cfa224fc5a6ffef26f8a92d23389e95178,1,1,1,2,1,2012-02-25 06:49:13,2012-02-20 06:36:36
7e8cf0cfa224fc5a6ffef26f8a92d23389e95178...2817787a28cf4fbe1c62a075e61f8b35d1654386,14,614,151,765,175,2012-02-25 06:49:13,2012-02-20 19:16:45
2817787a28cf4fbe1c62a075e61f8b35d1654386...eacd326fb0d9359151979b5c4bdb354f9b694a0c,1,32,33,65,7,2012-02-25 06:49:14,2012-02-20 19:37:35
eacd326fb0d9359151979b5c4bdb354f9b694a0c...020df3d5be8c1850bc8e4e1e7280c0c3d5c77deb,2,100,15,115,13,2012-02-25 06:49:14,2012-02-20 20:21:01
020df3d5be8c1850bc8e4e1e7280c0c3d5c77deb...2789a5b977e296f37890509326477a00b43d1abc,2,15,4,19,6,2012-02-25 06:49:14,2012-02-20 20:38:59
2789a5b977e296f37890509326477a00b43d1abc...7d9d6ac098d8deee0e99fc3d60828f9e73635eb9,1,19,0,19,1,2012-02-25 06:49:14,2012-02-20 20:40:50
7d9d6ac098d8deee0e99fc3d60828f9e73635eb9...a08868df50fc2d53c05cd434dda2e9a82ec7dc5e,2,6,3,9,5,2012-02-25 06:49:14,2012-02-20 20:49:39
a08868df50fc2d53c05cd434dda2e9a82ec7dc5e...febc2c84e0a93cab55d93f2ebfcc5ff8bbf90688,2,10,7,17,6,2012-02-25 06:49:14,2012-02-20 21:00:54
febc2c84e0a93cab55d93f2ebfcc5ff8bbf90688...5e74e60e0d3124dc42854cd159dd99f5c1308ce1,3,32,31,63,8,2012-02-25 06:49:14,2012-02-20 22:16:02
5e74e60e0d3124dc42854cd159dd99f5c1308ce1...315532e593564bdd797993cff7d4bfb0354bf06c,3,6,3,9,4,2012-02-25 06:49:15,2012-02-20 22:17:31
315532e593564bdd797993cff7d4bfb0354bf06c...331fe579b13ccb2205e3e54d40f4dc6c66e782bf,1,5,0,5,1,2012-02-25 06:49:15,2012-02-20 22:23:27
331fe579b13ccb2205e3e54d40f4dc6c66e782bf...5021e318a604f7b6b4ad07a3ed24680abfc21f07,1,25,0,25,1,2012-02-25 06:49:15,2012-02-20 22:42:47
5021e318a604f7b6b4ad07a3ed24680abfc21f07...9069aa464c3b44a9e8a2f3f97994268bec255bda,2,22,3,25,3,2012-02-25 06:49:15,2012-02-21 02:43:14
9069aa464c3b44a9e8a2f3f97994268bec255bda...c8ff3791143b2bc34c6d61e5b15e5e7a69f5da27,3,56,13,69,4,2012-02-25 06:49:15,2012-02-21 04:37:35
c8ff3791143b2bc34c6d61e5b15e5e7a69f5da27...ec0bc442b4bea1eb2eb241240d357138ac590176,3,89,82,171,4,2012-02-25 06:49:15,2012-02-21 05:35:58
ec0bc442b4bea1eb2eb241240d357138ac590176...04bbe2736135252cde754a8fe20845f3d177ffdf,1,3,3,6,2,2012-02-25 06:49:15,2012-02-21 05:39:40
04bbe2736135252cde754a8fe20845f3d177ffdf...5cc1349d911a481f834133faf44827679f3785a9,1,383,383,766,11,2012-02-25 06:49:15,2012-02-21 06:42:12
5cc1349d911a481f834133faf44827679f3785a9...70cd32e4324411f84c0330b587331207bef23ba1,2,33,3,36,7,2012-02-25 06:49:16,2012-02-21 07:30:29
70cd32e4324411f84c0330b587331207bef23ba1...a7f7be16cdd8e95ba0f36a19824f75662b5ce184,1,3,1,4,3,2012-02-25 06:49:16,2012-02-21 18:39:58
a7f7be16cdd8e95ba0f36a19824f75662b5ce184...6dba3baa3d16788cbacf45efb6b59fc2d893d5e9,2,62,62,124,5,2012-02-25 06:49:16,2012-02-21 19:15:41
6dba3baa3d16788cbacf45efb6b59fc2d893d5e9...ab1eca07c37c7bd6d4a17390d82d0b4cf78555bb,1,1,1,2,2,2012-02-25 06:49:16,2012-02-22 00:38:30
ab1eca07c37c7bd6d4a17390d82d0b4cf78555bb...ae93ce04ea63f1c998eee6870ac0348529cdd7ad,3,5,1,6,4,2012-02-25 06:49:16,2012-02-22 00:40:44
ae93ce04ea63f1c998eee6870ac0348529cdd7ad...b77af7efc90f6e8d70ae4304f3ca16f57c7a8c80,2,75,226,301,4,2012-02-25 06:49:16,2012-02-22 03:46:20
b77af7efc90f6e8d70ae4304f3ca16f57c7a8c80...e41c48320d7cc6e143d0c67c335df8e3a36506fc,2,5,20,25,8,2012-02-25 06:49:16,2012-02-22 05:15:51
e41c48320d7cc6e143d0c67c335df8e3a36506fc...04da5f76cc45020348db6c5906c87391d79bab47,4,222,25,247,31,2012-02-25 06:49:17,2012-02-22 06:39:53
04da5f76cc45020348db6c5906c87391d79bab47...34413328aa56af3280db84eb5a3d20409eddcdda,1,1,0,1,1,2012-02-25 06:49:17,2012-02-24 18:08:40
34413328aa56af3280db84eb5a3d20409eddcdda...87102538abc9c6cb65fca650585bfb9e4afe4910,8,514,117,631,62,2012-02-25 06:49:17,2012-02-24 23:16:08
87102538abc9c6cb65fca650585bfb9e4afe4910...5db4583fb162b51c695046990a618544da9bed6d,4,37,28,65,20,2012-02-25 06:49:17,2012-02-24 23:29:28
5db4583fb162b51c695046990a618544da9bed6d...776fbbf5e96e115d0deabc63a4f3f877b4ecc79d,1,79,3,82,5,2012-02-25 06:49:17,2012-02-25 00:27:06
776fbbf5e96e115d0deabc63a4f3f877b4ecc79d...311fd23c3b1c73245f743f8e67c4454f2ed5e788,2,173,85,258,15,2012-02-25 06:49:17,2012-02-25 01:55:05
311fd23c3b1c73245f743f8e67c4454f2ed5e788...4cf100a724914105328290c73cd433a3bb429c2a,2,28,16,44,17,2012-02-25 06:49:17,2012-02-25 03:10:24
4cf100a724914105328290c73cd433a3bb429c2a...c245f81e5d8170b14e798e00ba9e681f4dab4556,2,1,4,5,2,2012-02-25 06:49:17,2012-02-25 04:11:19
c245f81e5d8170b14e798e00ba9e681f4dab4556...884b7aa39d2db6efde863a42017c0954a7d830d1,4,36,8,44,7,2012-02-25 06:49:18,2012-02-25 04:23:24
884b7aa39d2db6efde863a42017c0954a7d830d1...fc94fe325a5b7d7e8a72d4717de0b63cdee19145,2,19,1,20,4,2012-02-25 06:49:18,2012-02-25 04:36:38
fc94fe325a5b7d7e8a72d4717de0b63cdee19145...292b455151d4e6852ed3a717f12407a8060930ef,1,80,0,80,2,2012-02-25 06:49:18,2012-02-25 05:11:24
292b455151d4e6852ed3a717f12407a8060930ef...74fec78207fd9aa465ef39a8e3a36369e7dc324a,2,7,3,10,4,2012-02-25 06:49:18,2012-02-25 05:22:47
74fec78207fd9aa465ef39a8e3a36369e7dc324a...96d7f43618723fdcb737552ad2337d5c28cf4650,1,13,0,13,1,2012-02-25 06:49:18,2012-02-25 05:29:28
96d7f43618723fdcb737552ad2337d5c28cf4650...b08eb0591a7ed0965f2ee0d5531809940e68f54f,6,13,14,27,12,2012-02-25 06:49:18,2012-02-25 06:46:52
b08eb0591a7ed0965f2ee0d5531809940e68f54f...8b794427092321ee128ba821d5ad9a211fec9c3c,3,62,52,114,7,2012-02-25 07:57:31,2012-02-25 07:57:31
8b794427092321ee128ba821d5ad9a211fec9c3c...b912edb2556a69ce6541452a60d4df5246b61a36,1,1,1,2,1,2012-02-25 19:04:49,2012-02-25 19:04:49
b912edb2556a69ce6541452a60d4df5246b61a36...db50c26d786e2a0d066dd53f266308b9cffb5d63,1,2,2,4,2,2012-02-25 19:31:50,2012-02-25 19:31:50
db50c26d786e2a0d066dd53f266308b9cffb5d63...9a725f3458a2f074c8630fa654d091fc0691f122,3,7,651,658,20,2012-02-25 19:32:00,2012-02-25 19:32:00
9a725f3458a2f074c8630fa654d091fc0691f122...73e7376b34f32162d0551274a32a75fcc4e25adf,6,18,14,32,15,2012-02-25 21:39:29,2012-02-25 21:39:29
73e7376b34f32162d0551274a32a75fcc4e25adf...01b24652415966469f55660a43f22b7b520c5569,1,6,6,12,3,2012-02-25 22:27:54,2012-02-25 22:27:54
01b24652415966469f55660a43f22b7b520c5569...0e1b3011e780be542801d2c49dcf280ab0bc1d50,1,2,0,2,1,2012-02-25 22:28:54,2012-02-25 22:28:54
0e1b3011e780be542801d2c49dcf280ab0bc1d50...ca0adfbabe96eb29563b51823e337e9006e6d65e,1,0,24,24,2,2012-02-25 22:50:14,2012-02-25 22:50:14
ca0adfbabe96eb29563b51823e337e9006e6d65e...9f57e14bf94552ffef412db2d2537b50ccb90768,1,2,2,4,1,2012-02-25 22:51:06,2012-02-25 22:51:06
9f57e14bf94552ffef412db2d2537b50ccb90768...d3371e4129addbf2c0c7a5b06a48fd58a319a8fe,1,2,2,4,2,2012-02-25 22:51:28,2012-02-25 22:51:28
d3371e4129addbf2c0c7a5b06a48fd58a319a8fe...78dc495e1b34b7bfd18454be2c74c1a600bfafa2,2,3,3,6,3,2012-02-25 22:56:13,2012-02-25 22:56:13
78dc495e1b34b7bfd18454be2c74c1a600bfafa2...4dd695bb9b0f2179477a114c26d314d4f4c015c1,3,11,0,11,6,2012-02-25 23:26:23,2012-02-25 23:26:23
4dd695bb9b0f2179477a114c26d314d4f4c015c1...2a345fc2e07d5c91059b6c9921e24c86a82d213e,1,3,2,5,1,2012-02-26 01:08:04,2012-02-26 01:08:04
2a345fc2e07d5c91059b6c9921e24c86a82d213e...dc1d6ff920b3dd3fbab20da41409786cb5705bb2,7,99,54,153,27,2012-02-26 01:40:35,2012-02-26 01:35:46
dc1d6ff920b3dd3fbab20da41409786cb5705bb2...d1ca542817b79d4fb0e51b88f02d419a1a6462d7,2,2,2,4,2,2012-02-26 02:23:21,2012-02-26 02:23:21
d1ca542817b79d4fb0e51b88f02d419a1a6462d7...1c34e3a801a9574f1ce76ae1bee71c67a6f69d4b,1,25,17,42,16,2012-02-26 20:47:20,2012-02-26 20:47:20
1c34e3a801a9574f1ce76ae1bee71c67a6f69d4b...10da27ca707b6b7b2766f4b4210ceb273da5dfdc,2,90,48,138,21,2012-02-27 09:27:09,2012-02-27 09:27:09
10da27ca707b6b7b2766f4b4210ceb273da5dfdc...10ffadafddaf05a7d451d0802c3c1dafdf8a51f0,1,1,2,3,1,2012-02-27 09:33:22,2012-02-27 09:33:22
10ffadafddaf05a7d451d0802c3c1dafdf8a51f0...95abc2c43f3b093eee9c0da2a1db997aa87f1737,1,1,9,10,3,2012-02-27 16:23:05,2012-02-27 16:23:05
95abc2c43f3b093eee9c0da2a1db997aa87f1737...f31ebbd79b7976b6b11124a42ed8b7f461b36b27,1,3,4,7,3,2012-02-27 16:23:34,2012-02-27 16:23:34
c1dffd1a436b33d5ee8a5aefb6f1eb60e29933e0...4fe6b5a0e2148459159549d18ac87299a982578d,1,5,4,9,3,2011-06-01 19:26:00,2011-06-01 19:26:00
4fe6b5a0e2148459159549d18ac87299a982578d...89887b21459e879c7e97bb6a7c5eaf0be8d69b6f,1,0,1,1,1,2011-06-01 19:47:52,2011-06-01 19:47:52
89887b21459e879c7e97bb6a7c5eaf0be8d69b6f...b2236461fa760ee455108fbf14ccf3099ff75187,6,65,3,68,12,2011-06-01 19:51:10,2011-06-01 19:51:10
b2236461fa760ee455108fbf14ccf3099ff75187...7db56fc74c2a774e58f72bd5ea79d078f2ed8a59,1,1,1,2,1,2011-06-01 20:18:11,2011-06-01 20:18:11
7db56fc74c2a774e58f72bd5ea79d078f2ed8a59...c954585085760b9b3113a323d0b19c6f32d4a203,1,1,1,2,1,2011-06-01 20:27:47,2011-06-01 20:27:47
c954585085760b9b3113a323d0b19c6f32d4a203...c3d9873759eec207dfab3868b2e5f780d3a09743,1,4,1,5,2,2011-06-01 22:17:51,2011-06-01 22:17:51
c3d9873759eec207dfab3868b2e5f780d3a09743...94fd6890ecb254ac7208c63765615d6acbf92aaa,3,14,25,39,5,2011-06-02 06:07:21,2011-06-02 06:07:21
94fd6890ecb254ac7208c63765615d6acbf92aaa...943ecd4b16ccd9a801a12bb2237e524ba344f8ef,2,16,15,31,2,2011-06-02 07:19:19,2011-06-02 07:19:19
943ecd4b16ccd9a801a12bb2237e524ba344f8ef...282418b2d98b9248cd0c3ef6ced54e3c077d8743,1,27,28,55,15,2011-06-02 14:23:31,2011-05-23 18:05:17
282418b2d98b9248cd0c3ef6ced54e3c077d8743...d70079c7df7142cfc79b45e8f2297f514b3360ae,1,6,6,12,4,2011-06-02 14:23:32,2011-05-23 18:08:30
d70079c7df7142cfc79b45e8f2297f514b3360ae...70fbe10acfeb620022dd949a9ee9e90a3f683d32,15,117,48,165,41,2011-06-02 14:23:32,2011-06-02 04:47:14
70fbe10acfeb620022dd949a9ee9e90a3f683d32...f2beea161e769f7bc70a5994c16337e605f4e748,2,5,4,9,4,2011-06-02 14:23:33,2011-06-02 04:48:54
f2beea161e769f7bc70a5994c16337e605f4e748...635d2a680d46a09969a9616584a272c2cf395201,4,203,99,302,18,2011-06-02 14:23:33,2011-06-02 04:54:26
635d2a680d46a09969a9616584a272c2cf395201...c2f4f2c8da17af6f4699fe2e34d4405cf600bbea,2,4,4,8,4,2011-06-02 14:55:39,2011-06-02 14:55:39
c2f4f2c8da17af6f4699fe2e34d4405cf600bbea...69ea6ab82248388168c0f747bcb60e1c502f8b75,1,59,0,59,1,2011-06-02 15:00:53,2011-06-02 15:00:53
69ea6ab82248388168c0f747bcb60e1c502f8b75...69713ca560d81c127d915b6e7290ca24d99c6ef7,3,22,22,44,17,2011-06-02 15:46:29,2011-06-02 15:46:29
69713ca560d81c127d915b6e7290ca24d99c6ef7...6f6457dd6cd16e6d7d36d512ac64212f2964352f,1,21,0,21,1,2011-06-02 15:58:01,2011-06-02 15:58:01
6f6457dd6cd16e6d7d36d512ac64212f2964352f...94a622f76fd31f14edd181e4e436392f6c51a9d7,1,7,4,11,1,2011-06-02 16:02:37,2011-06-02 16:02:37
94a622f76fd31f14edd181e4e436392f6c51a9d7...41be5821f3a46bd817b0426dbe18cd9f85d5ad9b,7,51,52,103,46,2011-06-02 17:34:26,2011-06-02 17:34:26
41be5821f3a46bd817b0426dbe18cd9f85d5ad9b...37d36b7cf1f3a0b8b2a7639b91976673377fd47c,2,19,0,19,2,2011-06-02 18:54:56,2011-06-02 18:54:56
37d36b7cf1f3a0b8b2a7639b91976673377fd47c...6575b2ebbfdf54b83498baa852466303c683dd55,3,32,6,38,6,2011-06-02 20:39:53,2011-06-02 20:39:53
6575b2ebbfdf54b83498baa852466303c683dd55...6daddc776c4c9d61421f9012fe91a5ec4a7e0888,2,6,10,16,5,2011-06-02 20:50:59,2011-06-02 20:50:59
6daddc776c4c9d61421f9012fe91a5ec4a7e0888...f528a0e49dd39285c1c8db18ec7510e3c539fb20,1,3,2,5,2,2011-06-02 20:53:44,2011-06-02 20:53:44
f528a0e49dd39285c1c8db18ec7510e3c539fb20...6510475ff12a4d76b76ded89bdb3ee5c2fc037e5,8,40,34,74,23,2011-06-03 03:49:49,2011-06-03 03:49:49
6510475ff12a4d76b76ded89bdb3ee5c2fc037e5...48ca7d095d7b5ad5068971bed6536d70b14afdf1,1,0,1,1,1,2011-06-03 03:43:57,2011-06-03 03:43:57
dfddbec61ebd33622f477f24ac876c499c729a23...d48c3165d3e59eabac8bc4ece25ff6a93e3dcbf0,6,20,65,85,15,2011-06-22 14:21:13,2011-06-22 14:21:13
d48c3165d3e59eabac8bc4ece25ff6a93e3dcbf0...7ded5352a3d82233f71d34c06b9b8437cd683be6,4,62,10,72,12,2011-06-22 14:23:09,2011-06-22 14:23:09
7ded5352a3d82233f71d34c06b9b8437cd683be6...1b7c6af8a440b84def026c05688f49b9341e4edd,1,1,0,1,1,2011-06-22 14:47:38,2011-06-22 14:47:38
de20dd200870367e3f9000c9a6b74fed5e8fa402...49e35f53c6099b4abf21d0ad88bf2a1d9c41dd80,2,21,0,21,4,2012-03-19 11:54:59,2012-03-19 11:54:59
49e35f53c6099b4abf21d0ad88bf2a1d9c41dd80...b3bc0e8f8a10a1968046aa056f3b65c9917cb1a5,7,194,145,339,7,2012-03-19 14:25:45,2012-03-19 14:24:07
b3bc0e8f8a10a1968046aa056f3b65c9917cb1a5...6fc718c18a1d8bf5b54b358af190314dd2a42c83,2,17,11,28,3,2012-03-19 14:51:00,2012-03-19 14:51:00
de20dd200870367e3f9000c9a6b74fed5e8fa402...8a2ce2ac347eb7052cc5a3c9a0abc26094f74b79,2,60,42,102,36,2012-03-19 08:51:31,2012-03-19 08:51:31
8a2ce2ac347eb7052cc5a3c9a0abc26094f74b79...9eebc098a386ed9547aed6c8d9a7f26f6fc5ec1b,2,6,6,12,6,2012-03-19 09:11:15,2012-03-19 09:11:15
9eebc098a386ed9547aed6c8d9a7f26f6fc5ec1b...26d6974912cbbf15e7e6a81f876eda2a735b760e,2,25,4,29,6,2012-03-19 09:21:51,2012-03-19 09:21:51
26d6974912cbbf15e7e6a81f876eda2a735b760e...6390b00ea951c7151fa59a367c659c89516d3ad5,2,14,15,29,9,2012-03-19 16:53:59,2012-03-19 16:53:59
f31ebbd79b7976b6b11124a42ed8b7f461b36b27...d1de28e30396b4f7489f2b9513e979448729d29c,2,12,8,20,7,2012-02-27 18:34:18,2012-02-27 18:34:18
d1de28e30396b4f7489f2b9513e979448729d29c...76427cd8a7f21210e0b41b0382ce05e05f092245,8,371,193,564,107,2012-02-27 20:17:16,2012-02-27 20:17:16
76427cd8a7f21210e0b41b0382ce05e05f092245...451dccb3ec7801b0929a870f30adaf2f78286922,1,3105,3104,6209,1,2012-02-27 20:46:13,2012-02-27 20:46:13
f31ebbd79b7976b6b11124a42ed8b7f461b36b27...b52933ef78c4bb227d0bd48a4200999c166e143b,1,8,2,10,1,2012-02-27 16:48:03,2012-02-26 05:14:15
b52933ef78c4bb227d0bd48a4200999c166e143b...8b6f59eadea6f024a69a0fd96058520eb24c86a9,1,2,1,3,1,2012-02-27 16:48:03,2012-02-27 16:46:36
48ca7d095d7b5ad5068971bed6536d70b14afdf1...ff1d8b955a6b30dfd5aec56cade32f188e1e70f6,1,25,5,30,9,2011-06-03 15:34:56,2011-06-03 15:34:56
48ca7d095d7b5ad5068971bed6536d70b14afdf1...ba9daf00db064ef9a284f5b72bb3e43a0ca141bb,1,2,1,3,2,2011-06-03 14:55:22,2011-06-02 21:10:23
ba9daf00db064ef9a284f5b72bb3e43a0ca141bb...02f6e939043eaaf3815cd23a55a7b02047d3973f,1,5,5,10,5,2011-06-03 14:55:22,2011-06-03 14:54:25
1b7c6af8a440b84def026c05688f49b9341e4edd...131e1d21826d50e1d30e24e6943e08ba72f702dd,30,56,50,106,37,2011-06-22 19:51:08,2011-06-22 19:51:08
1b7c6af8a440b84def026c05688f49b9341e4edd...d9cec7a4805364b5266a6fed914958998fc0d9b7,2,11,0,11,2,2011-06-22 16:52:45,2011-06-22 16:52:45
d9cec7a4805364b5266a6fed914958998fc0d9b7...8c8f5220ef8fa38b96e5fe96498c25fc09e6db0d,1,11,6,17,7,2011-06-22 16:56:22,2011-06-22 16:56:22
8c8f5220ef8fa38b96e5fe96498c25fc09e6db0d...403b7aa8a28094fb4f541a86d8f89c0c794ef329,3,22,4,26,5,2011-06-22 17:16:14,2011-06-22 17:15:08
403b7aa8a28094fb4f541a86d8f89c0c794ef329...5798ea831b53e4c303c57cb14e72406a789fc86a,3,18,2,20,6,2011-06-22 17:49:25,2011-06-22 17:49:25
5798ea831b53e4c303c57cb14e72406a789fc86a...67945f8b00d6e3cad4eaace5ee8f3cd9a6a71dde,10,284,144,428,34,2011-06-22 18:20:53,2011-06-22 17:21:02
67945f8b00d6e3cad4eaace5ee8f3cd9a6a71dde...09d1825d7f599724739ee712c8b91bfb566ea607,2,61,49,110,3,2011-06-22 18:20:53,2011-06-22 17:24:43
09d1825d7f599724739ee712c8b91bfb566ea607...8335369399c222f81d830a5630f9d518a3c05088,1,1,1,2,1,2011-06-22 18:20:53,2011-06-22 18:11:59
8335369399c222f81d830a5630f9d518a3c05088...9e5a8a53d334082015e66274aa87f39a3b52c59a,10,196,25,221,15,2011-06-22 18:22:09,2011-06-22 18:22:09
9e5a8a53d334082015e66274aa87f39a3b52c59a...dd8dcf4fe6be76928fdf6eb1b059a3df707f215d,7,15,11,26,11,2011-06-22 19:15:53,2011-06-22 19:15:53
81e6afa4d59b2e92093a68e4a8753847979e2954...a9ee1a7b4fe53f714a97920518fc4a81a5ab1e1e,2,6,0,6,2,2012-03-19 17:03:04,2012-03-19 17:03:04
451dccb3ec7801b0929a870f30adaf2f78286922...c76b0ef5d1c9d46b0494b230686d7a3e7fa29362,1,2,1,3,1,2012-02-28 18:37:41,2012-02-28 17:32:01
451dccb3ec7801b0929a870f30adaf2f78286922...04de9098bb96c61c083d7a55215e604522ab132d,2,25,3,28,4,2012-02-28 17:10:49,2012-02-28 17:10:49
451dccb3ec7801b0929a870f30adaf2f78286922...bf3230c4cacbdfbea94bb6fa02d6ceb6d55dc611,1,5,5,10,2,2012-02-28 14:49:10,2012-02-28 14:49:10
afe6d251764399062d66bcad43f45fc552a77d85...0425cfd1f44bb719902930d8413351485c25ab0b,1,8,2,10,1,2012-02-28 23:04:15,2012-02-28 23:04:15
303961a9495b2acd7e7d61dd3f276256ae80e089...5133061a17bd5b09c5e2650063dae8378740af72,3,7,2,9,4,2011-06-03 18:01:41,2011-06-03 18:01:41
d417a66224fd11a29831602e0acbd1525a3cf19a...b86d3624d3c28bb87df6222bea58c7d2c81e2760,1,1,1,2,1,2011-06-22 22:14:15,2011-06-22 22:14:15
b86d3624d3c28bb87df6222bea58c7d2c81e2760...e64da4973691a6724e1209b779298ebbf9144ac6,1,1,0,1,1,2011-06-22 22:15:21,2011-06-22 22:15:21
e64da4973691a6724e1209b779298ebbf9144ac6...066039d36826bd05b88f140925f3aa768464ead3,5,11,7,18,11,2011-06-23 03:16:36,2011-06-23 03:16:36
066039d36826bd05b88f140925f3aa768464ead3...c4a92236f342852a2f633c8ae0fc8011ca85b543,3,42,8,50,11,2011-06-23 17:32:05,2011-06-23 17:32:05
c4a92236f342852a2f633c8ae0fc8011ca85b543...ea1de002b3a33ea9d41e10b0266f2ca9af522fbc,1,3,0,3,1,2011-06-23 19:23:11,2011-06-23 14:56:37
ea1de002b3a33ea9d41e10b0266f2ca9af522fbc...6cd435b005974c0c3e0ea743d9196e9dc75c3618,11,98,18,116,22,2011-06-23 19:46:10,2011-06-23 19:46:10
6cd435b005974c0c3e0ea743d9196e9dc75c3618...10858a7a5f80ecdc853ec07aea3985281974f09c,1,15,10,25,8,2011-06-23 19:57:10,2011-06-23 19:57:10
10858a7a5f80ecdc853ec07aea3985281974f09c...5449421885df50fdc691ce7d9f91841c3def9853,2,10,4,14,7,2011-06-23 21:38:40,2011-06-23 21:38:13
5449421885df50fdc691ce7d9f91841c3def9853...95a7bcb172c295b9e49c88a6b898f66f75a332c0,1,9,3,12,3,2011-06-23 21:41:59,2011-06-23 21:41:14
95a7bcb172c295b9e49c88a6b898f66f75a332c0...14eae41ed6fe75aa248f9a9142a5d71698ea215c,2,3,3,6,3,2011-06-23 21:46:25,2011-06-23 21:46:10
14eae41ed6fe75aa248f9a9142a5d71698ea215c...8a3a9eb50150dc35fcff41f8fd1e7a2763795c1c,1,1,1,2,1,2011-06-23 21:51:19,2011-06-23 21:51:19
8a3a9eb50150dc35fcff41f8fd1e7a2763795c1c...a1a0d503d9a3c419746a958b9c8b73265ff57fd6,1,1,1,2,1,2011-06-23 21:53:17,2011-06-23 21:52:40
a1a0d503d9a3c419746a958b9c8b73265ff57fd6...b341cedb20e0e5abdec77dfd9200b03bc9dda781,1,0,4,4,1,2011-06-23 22:32:21,2011-06-23 22:31:46
b341cedb20e0e5abdec77dfd9200b03bc9dda781...436ba6805d709b1ed0cc61dae56d38fe699c1f3d,1,27,0,27,1,2011-06-24 04:41:23,2011-06-24 04:41:23
436ba6805d709b1ed0cc61dae56d38fe699c1f3d...21217ca8b7182a6ee5d7ada5518d2f6df32fa1cd,1,1,1,2,1,2011-06-24 05:23:38,2011-06-24 05:22:15
a9ee1a7b4fe53f714a97920518fc4a81a5ab1e1e...2ec272b22b8d0bb4067deebf3a6cd946696b00a5,2,99,90,189,23,2012-03-19 19:26:21,2012-03-19 19:26:21
a9ee1a7b4fe53f714a97920518fc4a81a5ab1e1e...8395e741a51529efa6a61289e8f8357cf1604504,7,32,14,46,21,2012-03-19 18:46:23,2012-03-19 18:46:23
8395e741a51529efa6a61289e8f8357cf1604504...0e0adf8855859a206ff41188cc5b128cc37d5f40,2,59,20,79,14,2012-03-19 19:10:35,2012-03-19 15:12:25
4ddcf45dff502013298f5ce1495a26739d2af4ed...b47d3b6475f8fa78825d34ef6b95e4a0d8ff31b7,1,22,38,60,9,2012-02-28 18:44:35,2012-02-28 18:09:00
b47d3b6475f8fa78825d34ef6b95e4a0d8ff31b7...82997ce4e90d0a7c5dc60e42a5ce8c109b103329,1,4,4,8,3,2012-02-28 18:54:28,2012-02-28 18:54:28
82997ce4e90d0a7c5dc60e42a5ce8c109b103329...44be5ff6450744a74af21464b06ebe6f29b02e40,306,245975,0,245975,300,2012-02-28 19:06:35,2012-02-27 17:42:41
44be5ff6450744a74af21464b06ebe6f29b02e40...058a36a347549adcbfb47baa2522ea99e8e8c806,2,38,1,39,2,2012-02-28 19:06:35,2012-02-27 18:01:27
058a36a347549adcbfb47baa2522ea99e8e8c806...60f74834dd181b8ee1f2b6cc02ef90881d89e84f,1,26,9,35,11,2012-02-28 19:06:35,2012-02-27 18:01:50
60f74834dd181b8ee1f2b6cc02ef90881d89e84f...72442ab8e90cdac0f604a1a93e963d70b65de2f0,1,1,1,2,1,2012-02-28 19:06:35,2012-02-27 18:17:29
72442ab8e90cdac0f604a1a93e963d70b65de2f0...e7cb710a43760ccb1c71f9be2f682ca48ef19a44,1,198,0,198,1,2012-02-28 19:06:36,2012-02-27 18:21:46
e7cb710a43760ccb1c71f9be2f682ca48ef19a44...17828a9c5f9788ec231d57e4456abd68729da826,1,3,3,6,3,2012-02-28 19:06:36,2012-02-27 19:19:43
17828a9c5f9788ec231d57e4456abd68729da826...583520fa3b48b6eafc2b6f2ee20aa8883d192fc6,1,1,1,2,1,2012-02-28 19:06:36,2012-02-27 20:06:59
583520fa3b48b6eafc2b6f2ee20aa8883d192fc6...f075f670e374882a95b23a332482e86f5e9d38bb,1,3,2,5,1,2012-02-28 19:06:36,2012-02-28 18:53:00
f075f670e374882a95b23a332482e86f5e9d38bb...28da771d64532ec104bc392aa4f06e2c2d7e1c61,1,9,5,14,1,2012-02-28 19:16:13,2012-02-28 19:16:13
28da771d64532ec104bc392aa4f06e2c2d7e1c61...73f34a28286f3594bc71811b1e6e1fe0db84114d,1,1,1,2,1,2012-02-28 19:33:55,2012-02-28 19:32:46
73f34a28286f3594bc71811b1e6e1fe0db84114d...e49185dbbe00efa0d196064e114ce18be6daebf5,1,1,1,2,1,2012-02-28 19:58:13,2012-02-28 19:57:47
e49185dbbe00efa0d196064e114ce18be6daebf5...fffbfc7564216a2355e3d06ac85a54e6a33b9c5c,1,3,1,4,1,2012-02-28 20:25:30,2012-02-28 20:23:23
fffbfc7564216a2355e3d06ac85a54e6a33b9c5c...59885c8e6978316d59fb6224d41548808bdc7e40,1,11,8,19,4,2012-02-28 21:10:59,2012-02-27 23:59:33
59885c8e6978316d59fb6224d41548808bdc7e40...9cf0cc2233478ff41b8d32949fa58108071b0af2,1,1,0,1,1,2012-02-28 21:10:59,2012-02-28 21:10:38
a14ad248bbc7918f884f583c7ad437c6b0ffd496...31545716c5709ac74e2801e5a65e35a153126066,1,2,1,3,1,2012-02-28 23:49:26,2012-02-28 23:48:00
31545716c5709ac74e2801e5a65e35a153126066...265c196adacccb4d1d0c0b0a9b1a8a3260198c8b,2,7,1,8,3,2012-02-29 00:52:40,2012-02-29 00:51:57
265c196adacccb4d1d0c0b0a9b1a8a3260198c8b...8d87f158dc51809c993bb13da1d57c0907cc2659,1,9,3,12,2,2012-02-29 14:46:52,2012-02-29 14:46:13
8d87f158dc51809c993bb13da1d57c0907cc2659...17e1dd2529d9622544717e635e71fd261977899f,9,548,10,558,24,2012-02-29 16:28:01,2012-02-29 16:28:01
17e1dd2529d9622544717e635e71fd261977899f...de79634f489a084e8a1cb2a3d0fabaf7b58dfabe,1,8,0,8,1,2012-02-29 16:47:57,2012-02-29 16:47:57
de79634f489a084e8a1cb2a3d0fabaf7b58dfabe...3b8e9488040e6883ed931816d8ed16cc3aa5fa4e,1,6,4,10,1,2012-02-29 17:10:21,2012-02-29 17:03:44
3b8e9488040e6883ed931816d8ed16cc3aa5fa4e...09edd8531bdcbb5581706c989ad192575e7efde4,1,6,3,9,3,2012-02-29 18:10:54,2012-02-29 18:10:54
5133061a17bd5b09c5e2650063dae8378740af72...cb474fb216796462ec04d2afb5a133cd3044053a,1,2,2,4,1,2011-06-03 18:42:07,2011-06-03 18:42:07
5133061a17bd5b09c5e2650063dae8378740af72...1ee161dfbe597ea5627df867b2b6ca32a34bbf2e,4,29,10,39,13,2011-06-03 18:38:40,2011-06-03 18:38:40
21217ca8b7182a6ee5d7ada5518d2f6df32fa1cd...d3d1f3242710fcc4f9707d9febae3e9e2d176b83,1,22,0,22,4,2011-06-24 21:15:22,2011-06-17 20:29:58
21217ca8b7182a6ee5d7ada5518d2f6df32fa1cd...24fdf9b1a1a63c7ac89c5e6441010db0bda30f50,1,19,0,19,4,2011-06-24 15:21:35,2011-06-17 20:29:58
7bb06f1e3dc4aec2c06a1bad6fbc26d9818de6d8...888018d560afe6bacebe0cd8a777bf7c61c5ff45,1,8,8,16,8,2012-03-19 19:42:43,2012-03-19 19:42:43
7bb06f1e3dc4aec2c06a1bad6fbc26d9818de6d8...93f7a08f39ee0f942eefc70ce5b1865a9d423881,1,0,3,3,1,2012-03-19 19:36:10,2012-03-19 19:35:55
9cf0cc2233478ff41b8d32949fa58108071b0af2...b0da47b1bd4bf3b9186be57c4c1df4be5d828716,1,1,1,2,1,2012-02-28 22:43:19,2012-02-28 22:43:19
9cf0cc2233478ff41b8d32949fa58108071b0af2...1fab66e9b7178732650047806536a3aaf1bb98e0,1,8,2,10,1,2012-02-28 22:39:59,2012-02-26 05:14:15
1fab66e9b7178732650047806536a3aaf1bb98e0...6a7242300df804b99986b5db10b094b227fc7a61,1,2,1,3,1,2012-02-28 22:39:59,2012-02-27 16:46:36
09edd8531bdcbb5581706c989ad192575e7efde4...9fcca4f886ce7176178a3168ebd9c67422ad951e,184,0,117663,117663,178,2012-02-29 22:04:07,2012-02-29 22:02:13
9fcca4f886ce7176178a3168ebd9c67422ad951e...215735b2a6c9bfc6b22102b83e4efc24e2be02a7,3,14,17,31,13,2012-03-01 00:36:35,2012-03-01 00:36:35
215735b2a6c9bfc6b22102b83e4efc24e2be02a7...b413701c48ec74a4f2b9ad197911290f2571770b,1,8,1,9,4,2012-03-01 01:24:03,2012-03-01 01:12:53
b413701c48ec74a4f2b9ad197911290f2571770b...507904583ca81a7e9a8bb369923d80f5beb7c29b,2,7,28,35,7,2012-03-01 01:24:03,2012-03-01 01:15:31
507904583ca81a7e9a8bb369923d80f5beb7c29b...dd4909f631355bf614893cb26de07d46b726af98,2,48,0,48,2,2012-03-01 01:42:12,2012-02-29 18:21:06
dd4909f631355bf614893cb26de07d46b726af98...b974a8e8229440c1cb1cf06061f1cc4df0b3c9c4,4,30,2,32,6,2012-03-01 01:42:24,2012-03-01 00:35:56
b974a8e8229440c1cb1cf06061f1cc4df0b3c9c4...28122356ec72347f3414bd204d9bf83d15696e60,1,27,0,27,1,2012-03-01 01:42:25,2012-03-01 00:44:43
28122356ec72347f3414bd204d9bf83d15696e60...e0b685a829cc2351ad682c86c61f5becdb359c63,2,51,12,63,5,2012-03-01 01:42:25,2012-02-27 03:17:35
e0b685a829cc2351ad682c86c61f5becdb359c63...8dba1d858cc4480b72a9e7f3ffe3a2202fdcb9e3,7,22,30,52,27,2012-03-01 01:42:25,2012-03-01 00:54:06
8dba1d858cc4480b72a9e7f3ffe3a2202fdcb9e3...1ca44e09a176fdf6dbdf0d966eaec89feac6e86d,12,201,36,237,110,2012-03-01 01:42:25,2012-03-01 01:03:34
1ca44e09a176fdf6dbdf0d966eaec89feac6e86d...cdf7e46a11fda538cb74b8abf7a2bb1a751c2626,2,35,1,36,3,2012-03-01 01:42:25,2012-03-01 01:07:33
cdf7e46a11fda538cb74b8abf7a2bb1a751c2626...d5bcc464a0479a2a07ab5299dc2b34c760857ea5,2,6,2,8,2,2012-03-01 04:33:50,2012-02-23 19:45:52
d5bcc464a0479a2a07ab5299dc2b34c760857ea5...00498dc20f070394d9d42e1d40e6dadd0ff54e0a,2,7,6,13,3,2012-03-01 04:33:52,2012-02-24 18:42:34
00498dc20f070394d9d42e1d40e6dadd0ff54e0a...4bc0143d3f44d51a76a03e90b66cfec466e8e9ee,1,2,4,6,2,2012-03-01 04:33:55,2012-02-25 01:11:50
4bc0143d3f44d51a76a03e90b66cfec466e8e9ee...a4e0a681dd8b62c3f0784466e03f6530e63fa0d8,15,127,51,178,49,2012-03-01 14:41:55,2012-02-28 21:03:08
a4e0a681dd8b62c3f0784466e03f6530e63fa0d8...eed4990236f4e9b5a997f7b4e115df0c25edee97,1,1,1,2,1,2012-03-01 14:49:10,2012-03-01 14:49:10
eed4990236f4e9b5a997f7b4e115df0c25edee97...6288c5f13973717a2ec0168f4b28242c0c981bd3,7,99,43,142,22,2012-03-01 15:30:42,2012-02-27 19:46:45
6288c5f13973717a2ec0168f4b28242c0c981bd3...06d2438c122d1a20750f2bf3197df735367e22c4,1,1,1,2,1,2012-03-01 15:43:24,2012-02-29 17:49:27
06d2438c122d1a20750f2bf3197df735367e22c4...caf6045dd9ec2d4e093a2c2790910eb9ca7900a6,3,23,0,23,5,2012-03-01 15:51:58,2012-02-29 22:27:49
caf6045dd9ec2d4e093a2c2790910eb9ca7900a6...40365f6cb494ae39fcf094053f23afe820b26d1f,1,1,0,1,1,2012-03-01 20:15:40,2012-03-01 20:15:40
40365f6cb494ae39fcf094053f23afe820b26d1f...2e4f02012cff3e775a8e8ff432b034cbec885817,1,4,5,9,1,2012-03-01 21:49:28,2012-03-01 21:09:22
fe5d9fb37c1d74244d3d5777e0a1a99d96421e7f...477807b85133b0ddf3c7b81b35423485417648bd,1,1,0,1,1,2011-06-03 18:49:41,2011-06-03 18:49:41
1ee161dfbe597ea5627df867b2b6ca32a34bbf2e...7c022c4f5fba4f5e8409b2397dbd3e10eb893c55,1,1,1,2,1,2011-06-03 18:36:23,2011-06-03 18:36:23
c8a737a22e8a94b9b942fc4b0ddcf76063bc97c2...f5d76c6a9e7d60b7530db4cfd607dd37f0a2723d,3,1,27,28,6,2011-06-24 21:56:42,2011-06-24 21:50:59
f5d76c6a9e7d60b7530db4cfd607dd37f0a2723d...d53566233a7028449600f66283e3860cadb6422f,2,74,37,111,13,2011-06-24 21:56:42,2011-06-24 21:56:07
d53566233a7028449600f66283e3860cadb6422f...51d97bcbfc2cfac701e1628f50bf7b881e79b832,4,13,11,24,12,2011-06-25 04:11:50,2011-06-25 04:11:50
5997c64e4bac9353f5a00c99e23016537808a908...fcdf4115ac92553cfc59d23fab78549ef69c4dda,1,0,19,19,4,2011-06-24 18:01:41,2011-06-24 18:01:41
fcdf4115ac92553cfc59d23fab78549ef69c4dda...72a7bc38676780e398321aaeb1e2f537d48b457c,3,27,1,28,6,2011-06-24 19:40:08,2011-06-24 19:40:08
72a7bc38676780e398321aaeb1e2f537d48b457c...5696b25f0a47f17615adbfab25b48371916ded1c,2,31,2,33,2,2011-06-24 20:07:13,2011-06-24 19:51:13
5696b25f0a47f17615adbfab25b48371916ded1c...317c3a4e3b935a8cedb35eade5bdb304d98b0d22,3,31,3,34,8,2011-06-24 20:07:13,2011-06-24 19:51:25
317c3a4e3b935a8cedb35eade5bdb304d98b0d22...54dbf3aa1c32bd19c05575a4ea7825a79d44b4e5,1,15,12,27,1,2011-06-24 20:23:13,2011-06-24 20:23:13
54dbf3aa1c32bd19c05575a4ea7825a79d44b4e5...23b40a40002f94289b46ffc582a3a4ead4005df3,1,1,1,2,1,2011-06-24 20:39:58,2011-06-24 20:39:58
23b40a40002f94289b46ffc582a3a4ead4005df3...ac1018ca7fd60f37fa06a1b3b22269a3a67bc17b,2,20,1,21,4,2011-06-24 20:50:15,2011-06-24 20:50:15
3bb208a86d6173775bd1d0b3840fbcec6c2ca962...8d7682b0af08bc4f119d86cd0131648c1b8b19ed,1,3,2,5,1,2012-03-19 20:14:51,2012-03-19 20:14:26
8d7682b0af08bc4f119d86cd0131648c1b8b19ed...d500568fe10892eb5a9206fcc7701796809ba2f4,1,0,1,1,1,2012-03-19 21:09:33,2012-03-19 21:09:33
d500568fe10892eb5a9206fcc7701796809ba2f4...8afdf255412d51955179607b5cf1129971e48e38,1,1,1,2,1,2012-03-20 15:13:41,2012-03-20 15:13:41
8afdf255412d51955179607b5cf1129971e48e38...a2e2cca83fa21ff8a79df6327a4424f9bf7fbf14,1,83,73,156,14,2012-03-20 15:15:23,2012-03-20 15:15:23
2e4f02012cff3e775a8e8ff432b034cbec885817...5d065652e1318dcab9ddaf54eaea763f7d8caf6a,1,1,1,2,1,2012-03-01 22:48:55,2012-03-01 22:48:55
5d065652e1318dcab9ddaf54eaea763f7d8caf6a...372d940d6ec3f645e63c9d9a87541ca0db985b35,3,14,7,21,3,2012-03-02 13:16:08,2012-03-02 01:14:51
372d940d6ec3f645e63c9d9a87541ca0db985b35...af8dcb5123c4d98882dc039a57a2e4057260c9a9,1,1,1,2,1,2012-03-02 14:39:09,2012-03-01 18:17:58
af8dcb5123c4d98882dc039a57a2e4057260c9a9...26268d011686f3aa30d82e4a71ffd1b4762933d1,1,2,2,4,2,2012-03-02 14:39:09,2012-03-01 18:19:19
26268d011686f3aa30d82e4a71ffd1b4762933d1...a8cf52512e6c2356f3a64008d43ec366dd5fdcee,1,3,1,4,1,2012-03-02 14:39:09,2012-03-02 14:38:44
a8cf52512e6c2356f3a64008d43ec366dd5fdcee...78ddcdf876e6b18edafaf0f71fad7d15339b6ab3,1,12,4,16,5,2012-03-02 16:36:18,2012-03-02 16:36:18
78ddcdf876e6b18edafaf0f71fad7d15339b6ab3...f5e212e1b2a71f22b5a48bc8ef79632d2bc81220,2,13,2,15,3,2012-03-02 17:00:46,2012-03-02 17:00:46
f5e212e1b2a71f22b5a48bc8ef79632d2bc81220...1ca88b01887a1dc07d2295447f803a4f83ad62aa,1,1,1,2,1,2012-03-02 17:07:50,2012-03-02 17:07:50
1ca88b01887a1dc07d2295447f803a4f83ad62aa...a4eb62ddb242ebadd14894adae85220e8b5ef305,1,1,0,1,1,2012-03-02 17:10:50,2012-02-29 16:49:33
a4eb62ddb242ebadd14894adae85220e8b5ef305...5acc61c6377e29ac25dbd105bf026be4eb8ee27a,2,8,1,9,2,2012-03-02 19:38:14,2012-03-02 19:38:14
5acc61c6377e29ac25dbd105bf026be4eb8ee27a...5b59f48f527511396c27e35996340f15747cd6c1,1,11,9,20,7,2012-03-02 19:55:42,2012-03-02 19:51:26
5b59f48f527511396c27e35996340f15747cd6c1...2f744edba75bc015a402a7ccc6b8d2c6d7012f1f,1,1,1,2,1,2012-03-02 19:55:42,2012-03-02 19:55:11
2f744edba75bc015a402a7ccc6b8d2c6d7012f1f...6827918b74d9e45b1bd9e5b72463ae5b1fc5aced,1,1,1,2,1,2012-03-02 19:57:52,2012-03-02 19:57:02
6827918b74d9e45b1bd9e5b72463ae5b1fc5aced...c72786cdd14767f8d700fc0994ac3a3627524ef7,1,5,0,5,2,2012-03-02 20:54:11,2012-03-02 20:36:33
c72786cdd14767f8d700fc0994ac3a3627524ef7...9c3a70d7cc2fae5ec5dc020a9c5c109bbc97d289,2,18,1,19,3,2012-03-02 20:54:11,2012-03-02 20:47:14
9c3a70d7cc2fae5ec5dc020a9c5c109bbc97d289...b4e9b28b111c177565c68de3939b4af096451a0c,1,12,3,15,2,2012-03-02 20:54:11,2012-03-02 20:53:51
b4e9b28b111c177565c68de3939b4af096451a0c...42642db1e2772b66e30870f50619bbbf58bc98ec,3,82,24,106,21,2012-03-02 21:03:57,2012-03-02 17:07:47
42642db1e2772b66e30870f50619bbbf58bc98ec...d8b56da1fbdd629e8ab8a2e4a2a2889ab789eecf,1,1,1,2,1,2012-03-02 21:51:36,2012-03-02 21:11:54
d8b56da1fbdd629e8ab8a2e4a2a2889ab789eecf...02889f2e00dc889b770facb715e38a8246eac9d7,5,35,1,36,8,2012-03-02 21:51:36,2012-03-02 21:50:55
e27fd9a8a471bb6a09fef7eccd9b2a9a09e6bfaa...3ea739ba8d3cafade93b03a42eabda335159cbcb,2,5,1,6,2,2011-06-03 19:47:07,2011-06-03 19:47:07
3ea739ba8d3cafade93b03a42eabda335159cbcb...8f6f0614bcf134352d3ff39fb136b9a9075efc21,2,30,2,32,2,2011-06-03 20:00:06,2011-06-03 20:00:06
8f6f0614bcf134352d3ff39fb136b9a9075efc21...36a3b7aed3470677944ebf75ee8d018ead897d72,2,12,1,13,2,2011-06-03 20:27:31,2011-06-03 18:01:41
36a3b7aed3470677944ebf75ee8d018ead897d72...e329ba1baea62adcca1a2882592cbc1df89f9d31,2,2,7,9,2,2011-06-03 21:15:25,2011-06-03 14:46:45
e329ba1baea62adcca1a2882592cbc1df89f9d31...6a1bc036308fdd1b867a072e5ba70afc04556e07,3,20,5,25,10,2011-06-03 21:15:25,2011-06-03 20:23:36
51d97bcbfc2cfac701e1628f50bf7b881e79b832...1665b5be87bdd5d7fb6e01d676efc8417c06d187,1,12,3,15,2,2011-06-26 02:18:04,2011-06-26 02:18:04
51d97bcbfc2cfac701e1628f50bf7b881e79b832...7a225bd2710cf6e4752d6311f3a33cc726365577,1,2,2,4,1,2011-06-26 01:51:40,2011-06-26 01:51:40
7a225bd2710cf6e4752d6311f3a33cc726365577...4cf035b90379168aac0920b63434d4c6807cc36d,1,4,0,4,1,2011-06-26 02:16:09,2011-06-26 02:16:09
a2e2cca83fa21ff8a79df6327a4424f9bf7fbf14...d171e4a0d368bedf87bfb3ab5b02ee208328440e,1,1,1,2,1,2012-03-20 15:50:37,2012-03-20 15:50:37
a2e2cca83fa21ff8a79df6327a4424f9bf7fbf14...4b740e9f025daccd2c89981856b91fc28a15c21e,2,18,11,29,8,2012-03-20 15:30:12,2012-03-20 15:27:11
4b740e9f025daccd2c89981856b91fc28a15c21e...2dc4657bfc7ca079a9076887652b5b01f644ac63,1,5,13,18,3,2012-03-20 17:50:15,2012-03-20 14:22:08
02889f2e00dc889b770facb715e38a8246eac9d7...b3f4d6c4b7aab682376a4503d6f76d698d08d799,1,3,2,5,3,2012-03-05 15:25:19,2012-03-05 15:25:19
02889f2e00dc889b770facb715e38a8246eac9d7...e33a4d0aa8e8a3e53fdc0ed89224ae1ddb5bf2ef,2,2,2,4,2,2012-03-03 11:34:48,2012-03-03 11:34:48
e33a4d0aa8e8a3e53fdc0ed89224ae1ddb5bf2ef...915ef6cd2ef940ccb263d697b71ccf770dfda189,1,138,0,138,1,2012-03-03 18:44:08,2012-03-02 23:08:10
915ef6cd2ef940ccb263d697b71ccf770dfda189...f1bfa9d78159f576f4dc43137f205eb82ba5a9f4,1,1,0,1,1,2012-03-03 22:40:31,2012-03-03 22:40:31
6a1bc036308fdd1b867a072e5ba70afc04556e07...fe93879d71ac57ec3ee980a937031cd693a0b663,1,1,1,2,1,2011-06-03 22:36:23,2011-06-03 22:36:23
6a1bc036308fdd1b867a072e5ba70afc04556e07...a0a0d98f39ed51716f4c6e353e4466cfb2307e65,1,4,4,8,5,2011-06-03 22:14:25,2011-06-03 22:14:25
6a1bc036308fdd1b867a072e5ba70afc04556e07...1cc69e30ad84a166ac1d48f68b20efa52c40fcc8,2,23,8,31,6,2011-06-03 21:58:26,2011-06-03 21:58:26
eac151bfd25215b454effc8ecfc47fe25f457672...6aabf0d8c92b51dc1ba6c76844adc591d59bceb1,5,118,50,168,45,2011-06-27 04:14:53,2011-06-27 04:14:53
eac151bfd25215b454effc8ecfc47fe25f457672...bef400c02b91ed83d1cb190511dcf6534c32857e,7,82,76,158,8,2011-06-26 03:24:44,2011-06-26 03:08:33
bef400c02b91ed83d1cb190511dcf6534c32857e...01e8230724dc7e3cd694dafc0b4482fe1b24f59f,1,0,2,2,1,2011-06-26 03:24:44,2011-06-26 03:14:30
01e8230724dc7e3cd694dafc0b4482fe1b24f59f...800d32536ba0a47518e53d855cbfc30ee0db265c,3,22,5,27,6,2011-06-26 03:24:44,2011-06-26 03:14:35
800d32536ba0a47518e53d855cbfc30ee0db265c...3c8ea8795cc3afc1dc889919f7cefb7444cd222a,1,3,0,3,1,2011-06-26 03:24:44,2011-06-26 03:24:34
3c8ea8795cc3afc1dc889919f7cefb7444cd222a...3314bda6e17ac078595c51388ead97335ad466ff,1,2,1,3,2,2011-06-26 04:22:44,2011-06-26 04:22:44
3314bda6e17ac078595c51388ead97335ad466ff...5cbe8caea270c855fa2698f9e73da07a2d6f5a29,1,1,1,2,1,2011-06-26 05:14:06,2011-06-26 05:14:06
5cbe8caea270c855fa2698f9e73da07a2d6f5a29...efeae2a3691bc500744611bc1e6e5c5fcaad92da,2,8,3,11,5,2011-06-26 15:33:40,2011-06-26 15:33:40
efeae2a3691bc500744611bc1e6e5c5fcaad92da...5c2153e14abd56c7b42179f06284470b27b7ef52,2,25,27,52,5,2011-06-26 16:01:25,2011-06-26 16:01:25
5c2153e14abd56c7b42179f06284470b27b7ef52...a79ef49abe8f7f8fe3324ad49f1173c76250ff4a,1,0,18,18,1,2011-06-26 20:30:07,2011-06-26 20:30:07
a79ef49abe8f7f8fe3324ad49f1173c76250ff4a...0f297a215523295d47d7fb00aa1703d775a37006,6,8,8,16,6,2011-06-26 20:44:38,2011-06-26 20:44:38
0f297a215523295d47d7fb00aa1703d775a37006...ee6255fbecdf2e83ec7ab52ed1b893e81f0fb2f4,8,14,14,28,12,2011-06-26 20:54:38,2011-06-26 20:54:38
ee6255fbecdf2e83ec7ab52ed1b893e81f0fb2f4...3b185eeee34f764fceb314257de3f97698bc676c,6,12,11,23,9,2011-06-26 20:59:10,2011-06-26 20:59:10
3b185eeee34f764fceb314257de3f97698bc676c...142a86b237c98eeb73b7c9658df8c232e02dda8f,41,59,57,116,48,2011-06-26 21:13:54,2011-06-26 21:13:54
142a86b237c98eeb73b7c9658df8c232e02dda8f...ddde89b8cfb567480c7db6b2832eb6280974ea2a,5,9,12,21,10,2011-06-26 21:31:07,2011-06-26 21:31:07
ddde89b8cfb567480c7db6b2832eb6280974ea2a...0594b8a6ab5ba1561e1fe760e755f2a055beb699,14,58,266,324,25,2011-06-26 21:56:43,2011-06-26 21:56:43
0594b8a6ab5ba1561e1fe760e755f2a055beb699...3a77049fda79bb8a5ddf240d3f871eaf6025c7b1,18,414,63,477,18,2011-06-26 22:11:45,2011-06-26 22:11:45
3a77049fda79bb8a5ddf240d3f871eaf6025c7b1...82efb130c83cdf404bde8c29bd53dec9390b38d5,2,251,228,479,8,2011-06-26 22:18:07,2011-06-26 22:18:07
82efb130c83cdf404bde8c29bd53dec9390b38d5...1d623367c8c1bd2719b8cdaa61e7d8d6cf259b41,3,19,494,513,7,2011-06-26 22:23:57,2011-06-26 22:23:57
1d623367c8c1bd2719b8cdaa61e7d8d6cf259b41...cf51af10c5f8eb3790282ea195d3832f6c400575,5,9,11,20,9,2011-06-26 22:28:45,2011-06-26 22:28:45
cf51af10c5f8eb3790282ea195d3832f6c400575...7794a82e5e322673948204a0a97b44faffa477f7,6,37,35,72,6,2011-06-26 22:36:05,2011-06-26 22:36:05
7794a82e5e322673948204a0a97b44faffa477f7...e1e7abee65b0aea063f8897c1e2f5cada28013fb,4,3,2,5,4,2011-06-26 22:41:08,2011-06-26 22:41:08
e1e7abee65b0aea063f8897c1e2f5cada28013fb...5a2f4ceb93b44283500f1ed346898439ca33b137,1,506,0,506,1,2011-06-26 22:42:34,2011-06-26 22:42:34
5a2f4ceb93b44283500f1ed346898439ca33b137...1388ecbdb76160bbfbb2df018ed860c2c81f592a,7,160,105,265,46,2011-06-27 02:00:52,2011-06-27 01:59:37
b7f74030594025392d65aa17dd840f3fc483a87c...e240ec0cf9fd952e35a970322fbe38fad7f6c101,1,8,8,16,6,2012-03-20 18:39:39,2012-03-20 18:39:39
e240ec0cf9fd952e35a970322fbe38fad7f6c101...39c86dcde16aa6485a444ef0629d4beda5146640,1,4,0,4,4,2012-03-20 19:09:30,2012-03-20 19:09:30
39c86dcde16aa6485a444ef0629d4beda5146640...2ba612172edcbbf4d5b04a8b21d0b53b2ece8e53,1,1,1,2,1,2012-03-20 21:13:26,2012-03-20 21:13:26
2ba612172edcbbf4d5b04a8b21d0b53b2ece8e53...0c1a6bdbe1d8aaadfdb34d71c238d96f0984227a,3,82,49,131,22,2012-03-20 21:37:45,2012-03-20 21:35:01
0c1a6bdbe1d8aaadfdb34d71c238d96f0984227a...3ca90a1f7a6069ad5325e2543147d1215e339dc0,1,16,0,16,1,2012-03-21 10:29:48,2012-03-21 10:29:48
3ca90a1f7a6069ad5325e2543147d1215e339dc0...5d3433eb31a58a4fcd242f8a0437819f63df723e,2,2,2,4,2,2012-03-21 13:21:26,2012-03-21 13:21:05
24a0d2fe97f60d58a84edf9ea4b2a49f6870cad9...ac5a8cb182c0d687967cc729108f95e6b4b33aea,1,0,39,39,1,2011-06-05 22:07:20,2011-06-05 22:07:20
ac5a8cb182c0d687967cc729108f95e6b4b33aea...c35d24d64d03f939c619507a57003f40a5e5c190,1,0,11,11,1,2011-06-05 22:07:43,2011-06-05 22:07:43
c35d24d64d03f939c619507a57003f40a5e5c190...d6c5a2336447182d1882d5b5db04384151bc4670,1,3,6,9,3,2011-06-05 22:07:59,2011-06-05 22:07:59
d6c5a2336447182d1882d5b5db04384151bc4670...c7724b405ab3966bd61c50a6b147752b9c63a6f5,1,1,13,14,2,2011-06-05 22:09:14,2011-06-05 22:09:14
c7724b405ab3966bd61c50a6b147752b9c63a6f5...93b67ef211bad8756e33bf7fe2430cb8d6932297,2,156,154,310,7,2011-06-05 22:10:07,2011-06-05 22:10:07
93b67ef211bad8756e33bf7fe2430cb8d6932297...896e10bb8dfe6c5cde815b9a930d59f7553ac683,1,1,1,2,1,2011-06-05 22:10:46,2011-06-05 22:10:46
896e10bb8dfe6c5cde815b9a930d59f7553ac683...6da748760cbcf8be3a319b2f03ed2a0fa778cdeb,1,8,1,9,1,2011-06-05 22:11:16,2011-06-05 22:11:16
6da748760cbcf8be3a319b2f03ed2a0fa778cdeb...69186d293c430c27bc9d1655a13d9f721eb85542,2,160,2,162,4,2011-06-05 22:12:43,2011-06-05 22:12:43
69186d293c430c27bc9d1655a13d9f721eb85542...4d5715086f6e3530c5fc0e2fa6816cfc18e90e48,7,57,51,108,28,2011-06-05 22:13:18,2011-06-05 22:13:18
d63d962f063cdb83a47637a7d9fe3a65ff9622bc...c9cdd3d920010447eec2f6714897066c445a7c9b,1,12,7,19,5,2011-06-05 22:00:09,2011-06-05 22:00:09
e6e129ae44d56a1da14e0ce40cfa6aedecc51233...b131098761601f228be1d80044e8972e78cf985b,1,1,4,5,2,2011-06-27 04:46:15,2011-06-27 04:46:15
b131098761601f228be1d80044e8972e78cf985b...1056d38ce5e9a8be098d41e1e887c8dce3527231,11,47,38,85,29,2011-06-27 13:13:59,2011-06-27 13:13:59
1056d38ce5e9a8be098d41e1e887c8dce3527231...4f87fbb17c2d24dd065c450f072669bd63856908,3,42,18,60,3,2011-06-27 13:14:55,2011-06-27 13:14:55
4f87fbb17c2d24dd065c450f072669bd63856908...f3b92cc241fdbbea0f06b7a9b66a6703ec7fffc9,1,3,2,5,3,2011-06-27 13:15:28,2011-06-27 13:15:28
f3b92cc241fdbbea0f06b7a9b66a6703ec7fffc9...f346f3e6742a7e309138128450509c8fec610623,1,1,1,2,1,2011-06-27 13:15:53,2011-06-27 13:15:53
f346f3e6742a7e309138128450509c8fec610623...fb4e554a99bdf512def422cc04fa52b69414a535,1,0,23,23,1,2011-06-27 13:16:14,2011-06-27 13:16:14
1388ecbdb76160bbfbb2df018ed860c2c81f592a...38743180c04f8090292a2eec35d1345cb8216611,1,11,0,11,4,2011-06-27 06:09:12,2011-06-27 06:08:56
5d3433eb31a58a4fcd242f8a0437819f63df723e...96d2b35c0bb9a843a7ed2c121f2b646c791c6168,1,15,4,19,2,2012-03-21 17:46:49,2012-03-21 17:46:49
96d2b35c0bb9a843a7ed2c121f2b646c791c6168...f3bbe516bd6a22e8bff86a17cae20df0d2eef151,1,17,2,19,2,2012-03-21 17:54:04,2012-03-21 17:54:04
f3bbe516bd6a22e8bff86a17cae20df0d2eef151...0e140e78621fddc6da7a3e223cb6d6b887ef697c,5,117,54,171,43,2012-03-21 20:13:43,2012-03-21 20:13:43
5d3433eb31a58a4fcd242f8a0437819f63df723e...5bff60e820f8fed08d9580c64a57879d2c77d44a,1,1,1,2,1,2012-03-21 15:38:07,2012-03-21 15:38:07
86c592fb3eea9c7fbe765c6b05c446d64643f331...e6cd19a8f22d0f0119f0afeaaa9e485999b7e0e1,1,0,1,1,1,2011-06-05 22:16:57,2011-06-05 22:16:57
79d4e4076735bd67c9b657bc3b7544013f4d860c...c00eb658444a9f8d38187d27e34d70eb8a02a85c,1,3,1,4,1,2011-06-27 13:58:44,2011-06-27 13:58:44
0e140e78621fddc6da7a3e223cb6d6b887ef697c...ae6d102ae55cc3269007e93e2759baab93b6adb5,1,1,0,1,1,2012-03-21 20:35:42,2012-03-21 20:35:42
0e140e78621fddc6da7a3e223cb6d6b887ef697c...ef8b8deeb6f0ed02c1fa51ddd24527e167d5e66e,1,1,1,2,1,2012-03-21 20:32:26,2012-03-21 15:45:09
ef8b8deeb6f0ed02c1fa51ddd24527e167d5e66e...047bf554f6ea02330d2c6cd04a6abe6707804b67,2,4,9,13,4,2012-03-21 20:32:39,2012-03-21 16:04:36
49d94427a44a8e14e65f997683007076da798e00...11ec084ec441ed5860e9a1a6b9d6acf9efd1b335,6,2,2,4,2,2012-04-06 18:35:48,2012-04-06 12:33:32
11ec084ec441ed5860e9a1a6b9d6acf9efd1b335...a86a64c5f91d242f035c5ebec290c8cdd93a7f65,3,1235,700,1935,558,2012-04-06 18:35:48,2012-04-06 17:15:58
a86a64c5f91d242f035c5ebec290c8cdd93a7f65...5ed8c55d43d708e924ba77612bec64dd8af91dd6,5,37,26,63,35,2012-04-06 18:35:49,2012-04-06 18:30:53
5ed8c55d43d708e924ba77612bec64dd8af91dd6...77f18cdbfbb96273d45267a46110a8f073730146,1,9,6,15,2,2012-04-06 19:11:09,2012-04-06 19:10:59
77f18cdbfbb96273d45267a46110a8f073730146...16b12c311f8bd5356910d2d70f8cc33e8c1904bb,1,2,2,4,2,2012-04-06 20:25:42,2012-04-05 06:11:48
16b12c311f8bd5356910d2d70f8cc33e8c1904bb...b782d6db8bcf16b4a33103ea5aa227d55a7b97a2,2,21,3,24,4,2012-04-06 20:26:01,2012-04-06 19:44:29
b782d6db8bcf16b4a33103ea5aa227d55a7b97a2...c394b6d67fcbcd653ca9be60cc356f58261a52a4,3,19,16,35,6,2012-04-06 20:59:54,2012-04-06 20:28:43
c394b6d67fcbcd653ca9be60cc356f58261a52a4...483397298791cc3c4d3b4f1c1c7696212a8d125a,19,149,103,252,23,2012-04-06 20:59:54,2012-04-06 20:59:48
483397298791cc3c4d3b4f1c1c7696212a8d125a...f250562ae34b912f2b17e136497696da1bf460e8,5,21,9,30,11,2012-04-06 21:32:30,2012-04-06 19:46:30
f250562ae34b912f2b17e136497696da1bf460e8...4963d046a273cb89a32fe8503dceee787a12086c,3,17,10,27,3,2012-04-06 21:32:30,2012-04-06 20:35:46
4963d046a273cb89a32fe8503dceee787a12086c...ddf63bb2751d2b4f1b8d34e0203ea7d6027c7ccd,3,39,1,40,3,2012-04-06 21:32:30,2012-04-06 21:32:02
ddf63bb2751d2b4f1b8d34e0203ea7d6027c7ccd...85e2b2f140dba6cfe053bb5a53d1acc40443a3fd,1,1,0,1,1,2012-04-06 22:45:50,2012-04-06 22:45:10
85e2b2f140dba6cfe053bb5a53d1acc40443a3fd...741a8d982e7aa5db0509820da32d10aed624c86c,2,4,2,6,4,2012-04-06 23:02:04,2012-04-06 23:02:04
741a8d982e7aa5db0509820da32d10aed624c86c...1f552a7be4e367a297dcbae9f86c075a7a48eb2d,3,7,25,32,4,2012-04-06 23:27:51,2012-04-06 23:27:51
1f552a7be4e367a297dcbae9f86c075a7a48eb2d...a6ce776bd7591fdebb280dc920b0eafbdc33adf0,1,1,1,2,1,2012-04-06 23:30:01,2012-04-06 23:30:01
a6ce776bd7591fdebb280dc920b0eafbdc33adf0...e67332fc7893790933caa7cd694d93f86e0869f5,5,49,27,76,23,2012-04-07 03:52:12,2012-04-07 03:52:12
e67332fc7893790933caa7cd694d93f86e0869f5...a4a68cde4aedbd653fa8516bfe3e29491d871d8c,1,7,7,14,7,2012-04-07 04:48:52,2012-03-25 02:35:06
a4a68cde4aedbd653fa8516bfe3e29491d871d8c...176f3b14324aaa6f631154581f8549e0a7c1ec5b,2,1,32,33,4,2012-04-07 04:48:52,2012-03-26 23:14:06
176f3b14324aaa6f631154581f8549e0a7c1ec5b...0feaee859f670d676d342473dd8a0d10107f830c,1,15,8,23,1,2012-04-07 04:48:53,2012-03-26 23:33:46
0feaee859f670d676d342473dd8a0d10107f830c...b697fb2695fece8cc5bf4e29c0c6187363e34431,5,44,32,76,20,2012-04-07 04:48:53,2012-03-27 00:28:08
b697fb2695fece8cc5bf4e29c0c6187363e34431...b887582118d3535a77051cfc68a20b39fb859bb5,10,157,162,319,138,2012-04-07 04:48:53,2012-03-27 02:51:23
b887582118d3535a77051cfc68a20b39fb859bb5...583860de512767cd30822a59a32616d624327084,4,7,6,13,5,2012-04-07 04:48:53,2012-03-27 03:29:59
583860de512767cd30822a59a32616d624327084...84a160ca6823782b6b3ca6268d4a5cd1e7aeba28,1,1,0,1,1,2012-04-07 04:48:53,2012-03-27 03:30:39
84a160ca6823782b6b3ca6268d4a5cd1e7aeba28...8102ea18a6d9f3b521025dccadbd94598b6acc32,2,8,4,12,3,2012-04-07 04:48:53,2012-03-27 04:46:15
8102ea18a6d9f3b521025dccadbd94598b6acc32...067d69e8cbd14ad4f7f6a2621a0c998d3d8a4f52,1,2,2,4,2,2012-04-07 04:48:53,2012-03-27 05:07:49
067d69e8cbd14ad4f7f6a2621a0c998d3d8a4f52...c38f075321524306f8913f6c76a5a85180b3d901,2,175,1,176,3,2012-04-07 04:48:53,2012-03-30 01:01:13
c38f075321524306f8913f6c76a5a85180b3d901...6a8f01b10c055ca8a3bf3ce1eaf7893a1b92b1c6,3,89,33,122,28,2012-04-07 04:48:54,2012-03-30 01:22:38
6a8f01b10c055ca8a3bf3ce1eaf7893a1b92b1c6...a4cd061f60ed902ffd4e4f7aae688623565a2d78,3,102,46,148,9,2012-04-07 04:48:54,2012-03-30 06:09:10
a4cd061f60ed902ffd4e4f7aae688623565a2d78...3ddea194923c9dd6f75999707d4445d5f59fe189,1,36,38,74,4,2012-04-07 04:48:54,2012-03-30 06:23:38
3ddea194923c9dd6f75999707d4445d5f59fe189...5e5f224044f902bc65ee614c1a0e955a6966e864,3,108,34,142,18,2012-04-07 04:48:54,2012-04-01 03:16:36
5e5f224044f902bc65ee614c1a0e955a6966e864...e8bd69844d785100f78d931c647e496f4cb6e523,4,239,22,261,13,2012-04-07 04:48:54,2012-04-02 01:10:36
e8bd69844d785100f78d931c647e496f4cb6e523...2a447b7e4ffc1ee408d2c9376114fbcb97b5133f,2,16,11,27,7,2012-04-07 04:48:54,2012-04-02 18:29:43
2a447b7e4ffc1ee408d2c9376114fbcb97b5133f...7cacde89bb37051549b38abaf4d6b591b199b243,12,982,97,1079,91,2012-04-07 04:48:54,2012-04-02 22:59:45
7cacde89bb37051549b38abaf4d6b591b199b243...3895127504ee12d3da3e36485453f281af8f347a,2,2,2,4,2,2012-04-07 04:48:54,2012-04-05 00:19:25
3895127504ee12d3da3e36485453f281af8f347a...d6f2b190bab407a87ab8139894af93df7829808b,2,30,32,62,3,2012-04-07 04:48:55,2012-04-05 17:36:19
d6f2b190bab407a87ab8139894af93df7829808b...87e50e739b8537088f4eafe627aacba58fe2d6e9,2,13,13,26,3,2012-04-07 04:48:55,2012-04-07 04:45:54
87e50e739b8537088f4eafe627aacba58fe2d6e9...5824872d99167f0c092cd5292fa6c03c0145b775,7,49,44,93,26,2012-04-07 04:48:55,2012-04-07 04:48:28
5824872d99167f0c092cd5292fa6c03c0145b775...93ba93ae3a8d0ccffca8535584b7b783e533d56a,26,25,34,59,39,2012-04-07 04:49:55,2012-04-07 04:48:40
93ba93ae3a8d0ccffca8535584b7b783e533d56a...086a243b5dead37583f46de88766ebcb2887a53f,1,2,1,3,1,2012-04-07 17:33:40,2012-04-07 17:33:40
086a243b5dead37583f46de88766ebcb2887a53f...02ce58ef478d0b920fbd917af9a66a97f844af90,1,10,5,15,10,2012-04-07 18:39:11,2012-04-07 18:39:11
02ce58ef478d0b920fbd917af9a66a97f844af90...69e1b79f36a8c64884bed3b1790220785b54cff0,2,2,13,15,4,2012-04-07 19:43:08,2012-04-07 19:43:08
69e1b79f36a8c64884bed3b1790220785b54cff0...6ca732d038405fd541da068ffa577324a57af715,13,64,53,117,46,2012-04-07 20:14:53,2012-04-07 20:14:53
6ca732d038405fd541da068ffa577324a57af715...1d605e6a9f610a3113783fcc4351ade26f067950,1,2,2,4,2,2012-04-07 20:40:42,2012-04-07 20:40:42
1d605e6a9f610a3113783fcc4351ade26f067950...ea6fb0bcc1233b8439e57225df3d4b088e019662,1,1,0,1,1,2012-04-08 13:52:52,2012-04-08 13:52:52
ea6fb0bcc1233b8439e57225df3d4b088e019662...dca03811cb778279eb4ee02f9e2970858516e66a,1,10,0,10,4,2012-04-09 02:33:44,2012-04-09 02:33:44
dca03811cb778279eb4ee02f9e2970858516e66a...e30ff0b4d0968f4f5247dbc147487af27c723dc1,2,25,4,29,3,2012-04-09 02:40:30,2012-04-09 02:40:30
e30ff0b4d0968f4f5247dbc147487af27c723dc1...dd9a1bdc3f506bc3eb62d84ad48e629cb9377377,1,1,1,2,1,2012-04-09 02:48:18,2012-04-09 02:48:18
dd9a1bdc3f506bc3eb62d84ad48e629cb9377377...71553961e097e84dd3e2040cbed53dc4e52b7710,2,11,2,13,4,2012-04-09 02:48:30,2012-04-09 02:48:30
71553961e097e84dd3e2040cbed53dc4e52b7710...a42cfdb963f789721053bade0f0582e3ec8cce4b,12,68,7,75,23,2012-04-09 03:39:11,2012-04-09 03:39:11
a42cfdb963f789721053bade0f0582e3ec8cce4b...9db48575869a11b65b6c20ba86e124836f8f1668,1,1,1,2,1,2012-04-09 03:39:22,2012-04-09 03:39:22
9db48575869a11b65b6c20ba86e124836f8f1668...e6047d268004e220521bdf10c3b86c0efce45c7b,1,1,1,2,1,2012-04-09 13:22:22,2012-04-09 13:22:22
e6047d268004e220521bdf10c3b86c0efce45c7b...ad2dc0f0bf353deb3e358a630126b369572c5b1e,1,1,1,2,1,2012-04-09 14:01:53,2012-04-09 14:01:53
ad2dc0f0bf353deb3e358a630126b369572c5b1e...4e83108fd947530a14729d9cebd0c3a8f3704620,2,285,241,526,49,2012-04-09 14:06:56,2012-04-06 21:34:46
4e83108fd947530a14729d9cebd0c3a8f3704620...035bbe2496cd3729b0954578c80481b2a111884b,8,52,40,92,52,2012-04-09 14:51:11,2012-04-09 14:51:11
035bbe2496cd3729b0954578c80481b2a111884b...fb40b7d90564d4d33fb2e211d6a962d4afc83a8e,1,0,8,8,8,2012-04-09 15:01:44,2012-04-09 15:01:44
fb40b7d90564d4d33fb2e211d6a962d4afc83a8e...17e7397812f2343a60f2fc1d29b4ea596e9f157c,1,2,2,4,4,2012-04-09 15:34:58,2012-04-09 15:34:22
17e7397812f2343a60f2fc1d29b4ea596e9f157c...fb015977937efb462fbe093b76bac9b335b6c91f,1,9,12,21,5,2012-04-09 17:01:13,2012-04-09 17:01:13
e6cd19a8f22d0f0119f0afeaaa9e485999b7e0e1...4d5c40c5256d850cfb15393500711785a5b6e65c,1,6,6,12,6,2011-06-05 22:26:29,2011-06-05 22:26:29
e6cd19a8f22d0f0119f0afeaaa9e485999b7e0e1...ff25eaadaebc2ca824b5c5123cbdad42b3237eab,1,1,1,2,1,2011-06-05 22:20:43,2011-06-05 22:20:43
c00eb658444a9f8d38187d27e34d70eb8a02a85c...b61fb234caca47c6202f5b1dfed371430eb10bf3,3,6,2,8,4,2011-06-27 14:15:53,2011-06-27 14:15:53
c00eb658444a9f8d38187d27e34d70eb8a02a85c...258a85334f14fe43312134390227ffcdd8a22e32,1,1,1,2,1,2011-06-27 13:58:27,2011-06-27 13:58:27
b12918ac0cad922eab06e47143b4e8a7b4fa2421...269217c81184591a0bd99c18f6d4a328f0c3adc4,1,3,0,3,2,2012-03-22 00:13:27,2012-03-20 02:53:59
269217c81184591a0bd99c18f6d4a328f0c3adc4...210bfbabffd2c8ab5be80019a288f91345f114da,1,3,5,8,3,2012-03-22 00:13:27,2012-03-20 20:43:59
210bfbabffd2c8ab5be80019a288f91345f114da...0950cc1f03b12cf1e27222825ab196ae7a9ecc0f,1,7,1,8,5,2012-03-22 03:16:43,2012-03-22 03:16:43
0950cc1f03b12cf1e27222825ab196ae7a9ecc0f...60a69eb339e4b1a950efe306566c00ffd0ca3b9b,1,1,0,1,1,2012-03-22 04:11:09,2012-03-22 04:11:09
60a69eb339e4b1a950efe306566c00ffd0ca3b9b...03b3123b8b2f0aacaca29cd121807da9f50e8904,3,11,5,16,6,2012-03-22 04:11:40,2012-03-22 04:11:40
03b3123b8b2f0aacaca29cd121807da9f50e8904...d691ad27067d08a8b708cf716cc302c5f629c0f2,2,19,7,26,4,2012-03-22 05:14:27,2012-03-22 05:14:27
d691ad27067d08a8b708cf716cc302c5f629c0f2...c955cad81d39ad402120de05a7389c66d0ebad9f,1,12,9,21,9,2012-03-22 13:51:44,2012-03-15 13:57:56
c955cad81d39ad402120de05a7389c66d0ebad9f...2992cda30157bd4a4562608bcbca47fd774b285f,1,5,2,7,2,2012-03-22 13:53:43,2012-03-22 13:52:25
2992cda30157bd4a4562608bcbca47fd774b285f...95e4630a7ef89cc7030544984cc4ed5f09408e67,3,452,2,454,4,2012-03-22 14:03:34,2012-03-22 14:03:34
95e4630a7ef89cc7030544984cc4ed5f09408e67...04507d983dd1715ae4213485d1faf23f6d64b1a8,6,174,0,174,9,2012-03-22 14:18:39,2012-03-22 14:12:10
04507d983dd1715ae4213485d1faf23f6d64b1a8...113a9443f37f514d85c0cc31d00acead20b7f375,1,2,1,3,1,2012-03-22 14:30:53,2012-03-22 14:30:20
113a9443f37f514d85c0cc31d00acead20b7f375...f550a8c6fe642733bb09689180b0a8d2021814b0,1,13,1,14,3,2012-03-22 14:32:11,2012-03-21 15:17:21
f550a8c6fe642733bb09689180b0a8d2021814b0...129b9bf73f8b37aa2e86812a5831c02c2790d7c9,1,1,1,2,1,2012-03-22 15:58:08,2012-03-22 15:58:08
129b9bf73f8b37aa2e86812a5831c02c2790d7c9...4c2e511ef57c000f8530d02965da5e1cc070a68f,2,4,0,4,2,2012-03-22 16:00:56,2012-03-22 15:59:58
4c2e511ef57c000f8530d02965da5e1cc070a68f...36cca0760c56cd24575000e6b86db612b5847b26,1,2,2,4,1,2012-03-22 17:22:54,2012-03-22 17:22:37
36cca0760c56cd24575000e6b86db612b5847b26...71c195887ee391f42afb0e5bbd8ba182b6f09c1a,1,19,1,20,1,2012-03-22 17:28:46,2012-03-22 17:28:24
71c195887ee391f42afb0e5bbd8ba182b6f09c1a...c741ded21b940289ab3402104d34c7a50c527645,1,3,3,6,2,2012-03-22 18:12:47,2012-03-22 00:33:13
c741ded21b940289ab3402104d34c7a50c527645...e2c12ed81f65efe0525c64c64bef8c88175e65ec,1,2,1,3,1,2012-03-22 18:12:47,2012-03-22 00:36:55
e2c12ed81f65efe0525c64c64bef8c88175e65ec...8b7859835387ff9d31416caa5916d12d9408a8fb,1,1,0,1,1,2012-03-22 18:12:47,2012-03-22 00:38:45
8b7859835387ff9d31416caa5916d12d9408a8fb...ddc9c57b5bb51022daf7adcb75f3256d40f9c0be,1,4,4,8,1,2012-03-22 18:12:47,2012-03-22 17:33:36
ddc9c57b5bb51022daf7adcb75f3256d40f9c0be...b03653c7660475f135e5e2f20d135e541d4ce8d0,6,18,16,34,13,2012-03-22 18:39:59,2012-03-13 00:02:16
b03653c7660475f135e5e2f20d135e541d4ce8d0...89c3584982835054a5912fa5f121cfa541dfa05a,1,128,0,128,1,2012-03-22 18:40:01,2012-03-16 22:54:26
89c3584982835054a5912fa5f121cfa541dfa05a...c286a150ff6341faf0c97976748b186ea50b3575,2,29,10,39,6,2012-03-22 18:40:02,2012-03-19 22:31:44
c286a150ff6341faf0c97976748b186ea50b3575...08589bfccd2a6be6552aebad215c5dc0746a9b1b,1,2,2,4,2,2012-03-22 18:40:03,2012-03-20 23:55:59
08589bfccd2a6be6552aebad215c5dc0746a9b1b...c7c3b36e36c6ba621c10b246415b07189d67cea0,1,2,2,4,2,2012-03-22 18:40:04,2012-03-22 17:18:46
c7c3b36e36c6ba621c10b246415b07189d67cea0...3363b199e72a7b41c965fea9483d7825fd353d70,6,93,5,98,13,2012-03-22 18:47:16,2012-03-22 17:05:45
fb015977937efb462fbe093b76bac9b335b6c91f...cd7c9cc352514104e672dcf1081f66f7c6e16171,1,6,4,10,4,2012-04-09 19:38:17,2012-04-09 19:38:17
fb015977937efb462fbe093b76bac9b335b6c91f...4adc117fbc5937b7f4f1f050c47e30121d859ab4,1,11,19,30,11,2012-04-09 19:00:12,2012-04-09 19:00:12
85e1e5dbf46856fd9d85454726d7c1137eb4f412...5dcd98f9be082c585e4b53b186827a2d3b260d0d,1,5,4,9,2,2011-06-05 22:36:13,2011-06-05 22:36:13
184d653da333c90293855495285760c52df556dd...e27fa36b4c47b277b6e140f641a1187b712d99ca,2,5,5,10,5,2011-07-01 19:57:35,2011-07-01 19:57:35
184d653da333c90293855495285760c52df556dd...685203a89cc8f25d01bc197a2224c1ccaa6519f6,3,34,1,35,3,2011-06-27 18:18:53,2011-06-24 20:43:39
184d653da333c90293855495285760c52df556dd...b5993b38ce7bdce775d706f10f11a82338c343a6,3,15,4,19,6,2011-06-27 16:51:30,2011-06-27 16:51:30
b5993b38ce7bdce775d706f10f11a82338c343a6...e39dfdf08badc59282c9a583a9b5e977b35708cc,9,38,25,63,31,2011-06-27 18:11:46,2011-06-27 18:11:46
e39dfdf08badc59282c9a583a9b5e977b35708cc...619650a6d0bf299cf14270d1783428564e841da7,1,1,3,4,1,2011-06-27 18:26:18,2011-06-27 18:26:18
619650a6d0bf299cf14270d1783428564e841da7...45032b5487575c4f9200472e6552cc9167b8ebea,4,13,7,20,9,2011-06-27 18:38:10,2011-06-27 18:38:10
3363b199e72a7b41c965fea9483d7825fd353d70...5c5a90d9aa05b0058c414bda0ab4496806383b28,1,8,0,8,1,2012-03-22 19:53:54,2012-03-22 19:53:54
3363b199e72a7b41c965fea9483d7825fd353d70...c59fd7cbc1623d6bf60e8ff24ff08aa589b1ef87,1,10,4,14,4,2012-03-22 19:40:56,2012-03-21 20:30:41
3f9a0d0b338cf5cb6a668fd776500d7e0a518842...c520d67e73f76914e945444045202642b430d59b,2,29,2,31,4,2012-04-09 20:16:48,2012-04-09 20:16:48
5dcd98f9be082c585e4b53b186827a2d3b260d0d...bc9b23b14d220734c1920b2046fe3012db4f8743,3,41,9,50,4,2011-06-06 12:17:55,2011-06-06 12:17:55
5dcd98f9be082c585e4b53b186827a2d3b260d0d...70ea4cafb6025ea65e783a8ebeb0bcdd1d63b3ac,2,10,2,12,4,2011-06-06 04:31:37,2011-06-06 04:31:37
8c11a51d629fa3a0a1cb11990ffb1a6e77d98fd0...28a46041cab843f559091837833f8af37ff315d4,2,7,0,7,2,2011-07-01 21:38:26,2011-07-01 21:38:26
28a46041cab843f559091837833f8af37ff315d4...b8a42e880b0749660332c5c418997975be9d6f70,3,3,3,6,3,2011-07-02 01:03:34,2011-07-02 01:03:34
466da42da2dec2727d4523da5702f41f42fee499...fd3938aba48ae1f61a67c1e379bb1ea1774bf70f,2,44,52,96,19,2011-06-27 20:30:19,2011-06-27 20:29:30
3d8adc091015f90acc239ad2c20d3cf05f5d4831...6501a582a0bd97cd126b0257b29e7749869a95cc,3,44,16,60,17,2012-03-22 20:09:51,2012-03-15 05:18:12
6501a582a0bd97cd126b0257b29e7749869a95cc...245468533a48c850d7d894950b047d9252707629,1,9,6,15,3,2012-03-22 20:32:56,2012-03-20 15:45:59
245468533a48c850d7d894950b047d9252707629...a83608054570eb89397f55471493616e7fe6bbfc,1,1,1,2,1,2012-03-22 21:08:26,2012-03-22 21:08:26
a83608054570eb89397f55471493616e7fe6bbfc...589cd70e74fa778cb08f41bd44675197a35b7bc0,2,38,2,40,3,2012-03-22 22:51:57,2012-03-19 23:42:42
589cd70e74fa778cb08f41bd44675197a35b7bc0...321b3ee65a08599724f0b15f5ea2fb3f3d976eaf,1,70,1,71,3,2012-03-22 22:51:58,2012-03-20 00:30:27
321b3ee65a08599724f0b15f5ea2fb3f3d976eaf...d265d5fdb9830b051ba8aa5dc37f54304c3931ea,4,209,0,209,4,2012-03-22 22:51:58,2012-03-20 17:44:40
d265d5fdb9830b051ba8aa5dc37f54304c3931ea...e4340b9c4338ee7829624a237e1b71d418852af8,4,13,15,28,10,2012-03-22 22:51:58,2012-03-13 01:47:27
e4340b9c4338ee7829624a237e1b71d418852af8...70bc2ce86c6b950d83e062c80129c4bb7103d79b,9,42,30,72,18,2012-03-22 22:51:58,2012-03-13 03:59:51
70bc2ce86c6b950d83e062c80129c4bb7103d79b...57cb14ae9efb5ac446ae16f5fc15c09b4a7135c7,1,8,8,16,1,2012-03-22 22:51:58,2012-03-13 04:02:19
57cb14ae9efb5ac446ae16f5fc15c09b4a7135c7...123bd867602d1103439cbe1642654f03b53dea18,1,0,1,1,1,2012-03-22 22:51:58,2012-03-13 04:52:15
123bd867602d1103439cbe1642654f03b53dea18...95c447fec2dcf7c2f3cb611693ccf09f5a82e6e9,1,70,3,73,6,2012-03-22 22:51:58,2012-03-13 05:39:18
95c447fec2dcf7c2f3cb611693ccf09f5a82e6e9...aa69814d172ab3a6ea04e2af110a8a00494c3ecc,4,55,7,62,16,2012-03-22 22:51:58,2012-03-13 06:29:01
aa69814d172ab3a6ea04e2af110a8a00494c3ecc...708047ab122004fdaa6618131d0f24d6d810fb6d,2,24,5,29,6,2012-03-22 22:51:59,2012-03-13 06:46:45
708047ab122004fdaa6618131d0f24d6d810fb6d...bae4737b585f3e32b893e26dbe65e3e61947a76d,2,27,0,27,2,2012-03-22 22:51:59,2012-03-17 03:34:29
bae4737b585f3e32b893e26dbe65e3e61947a76d...657ed3c491a6d6a5216c900df2b34d8ff7a9489d,1,21,15,36,13,2012-03-22 22:51:59,2012-03-17 04:00:22
657ed3c491a6d6a5216c900df2b34d8ff7a9489d...fe485a09544bfc761c312e29db359b8e290f5155,2,6,2,8,3,2012-03-22 22:51:59,2012-03-19 18:17:32
fe485a09544bfc761c312e29db359b8e290f5155...03aa01eb85b5b45beada9bb75a537d29295a51bf,5,20,12,32,14,2012-03-22 22:51:59,2012-03-20 23:15:23
03aa01eb85b5b45beada9bb75a537d29295a51bf...1d7481fd32d49e6dacc884e1107607ee7bdd5cea,13,41,41,82,36,2012-03-22 22:51:59,2012-03-20 23:26:03
1d7481fd32d49e6dacc884e1107607ee7bdd5cea...7775a2710b1455815e441edc0866260ea2964d26,4,95,8,103,6,2012-03-22 22:52:00,2012-03-12 19:22:54
7775a2710b1455815e441edc0866260ea2964d26...a615a34a77450b803d5313236b16a7c81ae1f84c,1,28,31,59,9,2012-03-22 22:52:00,2012-03-13 16:50:18
a615a34a77450b803d5313236b16a7c81ae1f84c...44c4a5d8d122881c91db3ce06498b89f76877035,3,123,112,235,46,2012-03-22 22:52:00,2012-03-14 04:20:49
44c4a5d8d122881c91db3ce06498b89f76877035...5e36329307c9c884200a72b1659e2f886a0a84df,2,18,14,32,10,2012-03-22 22:52:00,2012-03-20 18:38:34
5e36329307c9c884200a72b1659e2f886a0a84df...8310ae91a569159cdf325985fd7b178194d7d53a,2,2,2,4,2,2012-03-22 22:52:00,2012-03-22 21:38:23
8310ae91a569159cdf325985fd7b178194d7d53a...0dd9c69f2352958ee2905505a541b47027c4ce4f,1,2,0,2,1,2012-03-23 00:35:10,2012-03-23 00:35:10
0dd9c69f2352958ee2905505a541b47027c4ce4f...f6f104dac1959e4294e26ae3cb0bd78cd2ff460a,1,3,5,8,4,2012-03-23 01:38:49,2012-03-23 01:38:49
f6f104dac1959e4294e26ae3cb0bd78cd2ff460a...d0f0f5b3530cad0ae3c2c0ff49cebfbfe0594366,1,21,16,37,7,2012-03-23 04:34:35,2012-03-23 04:34:13
d0f0f5b3530cad0ae3c2c0ff49cebfbfe0594366...da292a8d8eef9c1adc98bcd9e50a3f5eb81bb3ba,6,32,32,64,26,2012-03-23 04:46:36,2012-03-23 04:46:36
da292a8d8eef9c1adc98bcd9e50a3f5eb81bb3ba...c5aba00d1226eb4267028775b898f26734495092,2,12,1,13,5,2012-03-23 10:22:53,2012-03-23 10:22:53
c5aba00d1226eb4267028775b898f26734495092...f9c8560b866b3b286dc67548cbb82975fd4add46,1,2,2,4,2,2012-03-23 13:12:20,2012-03-23 13:12:20
f9c8560b866b3b286dc67548cbb82975fd4add46...d67ce1cd31f6ea2e766d5c201ab5430735cbb3b8,43,3328,2920,6248,161,2012-03-23 14:35:31,2012-03-07 17:09:42
d67ce1cd31f6ea2e766d5c201ab5430735cbb3b8...000ffd66a4e70b5788a7c01c6da33896987bf6be,1,1,2,3,3,2012-03-23 16:51:26,2012-03-23 16:51:26
000ffd66a4e70b5788a7c01c6da33896987bf6be...31c48fa6bd479fb7d4ef34351097597f2c1c9665,7,18,21,39,19,2012-03-23 17:38:40,2012-03-23 16:02:09
31c48fa6bd479fb7d4ef34351097597f2c1c9665...4b486084c097a07f4eb9e8980726f791efde4277,19,20,18,38,19,2012-03-23 18:07:15,2012-03-23 17:00:02
4b486084c097a07f4eb9e8980726f791efde4277...a1f3bbaf6ac35312a2e00d68ac4cf031f1b41035,1,1,1,2,1,2012-03-23 18:07:15,2012-03-23 17:02:00
a1f3bbaf6ac35312a2e00d68ac4cf031f1b41035...e39f860fe8544f22a0f28804865c2bdbc48c66a9,4,18,4,22,10,2012-03-23 18:43:13,2012-03-23 18:43:13
e39f860fe8544f22a0f28804865c2bdbc48c66a9...90a52eea10d4010b2721007fb459f7cf9ea721cf,1,1,1,2,1,2012-03-23 19:05:36,2012-03-23 19:05:32
90a52eea10d4010b2721007fb459f7cf9ea721cf...7b39ed703416d8d1060702c7eca6a32a93a60845,1,1,1,2,1,2012-03-23 19:20:37,2012-03-23 19:20:37
7b39ed703416d8d1060702c7eca6a32a93a60845...41db66ef99fbc0e499a366db8d341e787d17a7b1,3,376,12,388,11,2012-03-23 19:47:30,2012-02-27 19:38:33
41db66ef99fbc0e499a366db8d341e787d17a7b1...c0ed1fde6a726909ae99b928a711e3c38837a4ae,1,30,5,35,3,2012-03-23 20:30:06,2012-03-23 10:51:40
c0ed1fde6a726909ae99b928a711e3c38837a4ae...41fa2ad7f51f5bb30f13b7ba971467e95945fcfa,1,2,0,2,1,2012-03-24 11:28:30,2012-03-24 11:28:30
41fa2ad7f51f5bb30f13b7ba971467e95945fcfa...982d585da1ae217e68dd37dcf3ab4bef08eb745f,1,2,0,2,1,2012-03-24 14:27:30,2012-03-24 14:27:30
982d585da1ae217e68dd37dcf3ab4bef08eb745f...691d78523a618b752ccf8aac1f356e2bd617776f,1,3,0,3,1,2012-03-24 16:11:08,2012-03-24 16:11:08
691d78523a618b752ccf8aac1f356e2bd617776f...8ae80f452f0ab34b172f8dd4cedf6115b7a6ec98,2,0,4,4,2,2012-03-24 17:47:06,2012-03-24 17:47:06
8ae80f452f0ab34b172f8dd4cedf6115b7a6ec98...fdbb5f9829595342d21e3311ce291d98ea0ae9b0,1,0,3,3,1,2012-03-24 20:10:08,2012-03-24 20:10:08
fdbb5f9829595342d21e3311ce291d98ea0ae9b0...6b9742a730f5cf53a33cac8a45178ed2660af985,1,1,0,1,1,2012-03-25 13:23:50,2012-03-25 13:23:50
6b9742a730f5cf53a33cac8a45178ed2660af985...8de42a1889738c87fa186af5aec941feea57152a,1,3,3,6,3,2012-03-25 13:34:33,2012-03-25 13:34:33
8de42a1889738c87fa186af5aec941feea57152a...80e6aee73d2c8b192d2088feb5045a7f69bdcf7f,2,10,2,12,4,2012-03-26 00:45:32,2012-03-26 00:45:32
80e6aee73d2c8b192d2088feb5045a7f69bdcf7f...76b6144b89fdea578d01221785021f1833fcee91,1,12,12,24,7,2012-03-26 05:18:57,2012-03-23 19:16:56
76b6144b89fdea578d01221785021f1833fcee91...a2d6f752d56aa446220b9f14c8ad3865c2fb5db8,1,8,9,17,7,2012-03-26 05:18:57,2012-03-26 05:18:22
a2d6f752d56aa446220b9f14c8ad3865c2fb5db8...85f5e091eeac1a15a948dd510fcfb4c4c95660b1,7,10,10,20,10,2012-03-26 15:02:09,2012-03-26 15:02:09
c520d67e73f76914e945444045202642b430d59b...8dd03fbf0afdef795378d4fdd37009e672dae640,1,12,0,12,2,2012-04-09 22:19:13,2012-04-09 22:19:13
8dd03fbf0afdef795378d4fdd37009e672dae640...c6431502ce9793a116a60b708a32f35cc92084d9,3,123,5,128,7,2012-04-09 22:19:32,2012-04-09 22:19:32
c520d67e73f76914e945444045202642b430d59b...493a19e39fcd68f97ca47cdbc7b3b5f41ba3cb77,1,13,6,19,1,2012-04-09 20:33:31,2012-04-09 20:31:30
493a19e39fcd68f97ca47cdbc7b3b5f41ba3cb77...ee33c0b90fd74c0c3c48e2437648b1c2f3339dc5,4,20,1,21,5,2012-04-09 21:43:10,2012-03-22 21:10:00
020a5f122d07fdd0f021fc3610d749acd2ad8bdc...6ff53f162eea0fccae21189055a358649b5358b3,1,1,1,2,1,2011-06-06 22:38:30,2011-06-06 22:38:30
020a5f122d07fdd0f021fc3610d749acd2ad8bdc...89581c108f6419973d154374a5f33febe04f1a32,3,14,4,18,3,2011-06-06 16:40:41,2011-06-06 16:40:41
020a5f122d07fdd0f021fc3610d749acd2ad8bdc...74ddb407d9fcb62b5e90d1310457d9593cd19698,2,15,13,28,5,2011-06-06 15:16:57,2011-06-06 15:16:57
74ddb407d9fcb62b5e90d1310457d9593cd19698...5ae6c18fcdb537a663cc21ca78a9025cd2011896,1,1,0,1,1,2011-06-06 16:01:35,2011-06-06 16:01:35
5ae6c18fcdb537a663cc21ca78a9025cd2011896...8561e862e30418bd56ed25362f0efe6630dea61e,1,9,1,10,5,2011-06-06 16:02:14,2011-06-06 16:02:14
085ce764570c06eb5589ca0c4a0a7ec5d2f9683e...eb5c2318c7c953d81386f73489afd59d90e49083,6,102,17,119,20,2011-07-02 23:01:48,2011-07-02 23:00:35
eb5c2318c7c953d81386f73489afd59d90e49083...758a9c734164ecda21cdc5f96436fed88bdfd24f,1,6,6,12,2,2011-07-03 08:19:14,2011-07-03 08:19:14
758a9c734164ecda21cdc5f96436fed88bdfd24f...5dcc4f9d49173b5e67909714f3bf39f918d2398a,4,99,7,106,10,2011-07-04 01:47:14,2011-07-04 01:47:14
5dcc4f9d49173b5e67909714f3bf39f918d2398a...cd7944acd456f4e25b8c76e7e560886e27d321b9,1,3,3,6,3,2011-07-04 02:21:45,2011-07-04 02:21:45
cd7944acd456f4e25b8c76e7e560886e27d321b9...2b6bd331d6ad557819d61182b7de3ba32bedbbba,1,1,1,2,1,2011-07-04 18:21:21,2011-07-04 18:21:21
fd3938aba48ae1f61a67c1e379bb1ea1774bf70f...7b28e6f93fdf000029ddab10f99ec9b84f51047e,1,13,10,23,9,2011-06-27 20:52:14,2011-06-27 20:52:14
7b28e6f93fdf000029ddab10f99ec9b84f51047e...a538179ca4a68890847823ac9914170a1fa6a766,3,8,5,13,7,2011-06-27 21:40:05,2011-06-27 21:40:05
fd3938aba48ae1f61a67c1e379bb1ea1774bf70f...29156d4a006df61acabb2807387b3089002bf8e3,1,1,1,2,1,2011-06-27 20:28:55,2011-06-27 20:28:55
29156d4a006df61acabb2807387b3089002bf8e3...17ba23539c86aa8b8c3bedc6bf6898a51ca12017,1,0,8,8,4,2011-06-27 20:53:24,2011-06-27 20:52:12
17ba23539c86aa8b8c3bedc6bf6898a51ca12017...4fdb96d39226408e8e841a01d5534a432f7ea567,1,1,1,2,1,2011-06-27 21:10:38,2011-06-27 21:10:38
85f5e091eeac1a15a948dd510fcfb4c4c95660b1...2aa0eb068833e9a467448c8af3aaecc208b10149,1,4,1,5,3,2012-03-26 17:18:53,2012-03-26 17:18:53
85f5e091eeac1a15a948dd510fcfb4c4c95660b1...a1c41fa4cc8b909bbcd703da0d0e65a3c7912fbb,1,3,3,6,3,2012-03-26 15:11:51,2012-03-26 15:11:51
a1c41fa4cc8b909bbcd703da0d0e65a3c7912fbb...bf8e75aa2d8c908a8d6d205da9705faff09df6bd,1,7,5,12,3,2012-03-26 15:39:22,2012-03-26 15:38:52
bf8e75aa2d8c908a8d6d205da9705faff09df6bd...2bd824ce85427664a68913df01cb8ea2c6bdf93a,5,31,15,46,10,2012-03-26 16:51:42,2012-03-23 21:55:03
2bd824ce85427664a68913df01cb8ea2c6bdf93a...8a4b1033064057929f8bf69b0220f1aa3a82ce88,9,14,14,28,13,2012-03-26 16:58:52,2012-03-26 15:00:30
8a4b1033064057929f8bf69b0220f1aa3a82ce88...136c74632c10224b48c76d4861b0f56c7af2d851,2,10,10,20,9,2012-03-26 16:58:52,2012-03-26 15:04:28
136c74632c10224b48c76d4861b0f56c7af2d851...a56eef7bd9a5d390182ea64118e11420b052a380,5,14,14,28,14,2012-03-26 16:58:52,2012-03-26 15:08:15
a56eef7bd9a5d390182ea64118e11420b052a380...bd6d0c99195e324e14390205e2bc6ff88c01e365,275,2590,2611,5201,1596,2012-03-26 16:58:52,2012-03-26 16:58:35
bd6d0c99195e324e14390205e2bc6ff88c01e365...72fb624f068b0f156d1ba95317ba8656f6a67988,1,1,6,7,2,2012-03-26 17:10:41,2012-03-26 17:10:41
1e6d6ae3887409b8a6c707e9ed966fa4e56d413c...decfc7c724fc62887e67041749b66d8b9035ab40,1,1,1,2,1,2012-04-09 21:49:45,2012-04-09 21:49:45
decfc7c724fc62887e67041749b66d8b9035ab40...2e1f5392c55d196648911fc774c292f1b0c6e321,1,1,1,2,1,2012-04-09 21:52:40,2012-04-09 21:52:40
2e1f5392c55d196648911fc774c292f1b0c6e321...3609145e1bc425f8578754d9e5a8a6e96f2be884,1,1,1,2,1,2012-04-10 06:08:18,2012-04-10 06:08:18
3609145e1bc425f8578754d9e5a8a6e96f2be884...a7275844651805898da47c3a2ea5d3cd0763e4dc,1,2,2,4,2,2012-04-10 14:18:20,2012-04-10 14:17:11
a7275844651805898da47c3a2ea5d3cd0763e4dc...b26343ac7b71376e5635f5ba84c7e5497381aedb,1,1,1,2,1,2012-04-10 14:57:54,2012-04-10 14:56:32
b26343ac7b71376e5635f5ba84c7e5497381aedb...4f468e2e5258041b005abce8d70aa1bf8edbb3f8,1,23,0,23,1,2012-04-10 14:57:54,2012-04-10 14:56:51
4f468e2e5258041b005abce8d70aa1bf8edbb3f8...0730ff3ae1d15f66e0e03c7dc8d4d8910b76fd16,2,8,0,8,4,2012-04-10 15:30:08,2012-04-10 15:30:08
0730ff3ae1d15f66e0e03c7dc8d4d8910b76fd16...6097787b1f3c7f9b4f8dca68f66d474eaa60b1d1,8,84,29,113,16,2012-04-10 16:25:24,2012-04-09 16:21:32
6097787b1f3c7f9b4f8dca68f66d474eaa60b1d1...8ea68f28c358558779f73930e3f637519f0eeb27,11,163,155,318,43,2012-04-10 18:09:36,2012-04-10 15:27:44
5f5b1e4de4f6a5205edd3f4e03a222753c1523a9...c38947fe02dcc5986d001d93ed250c02e6854afe,3,6,3,9,4,2011-06-06 23:53:49,2011-06-06 23:53:49
c38947fe02dcc5986d001d93ed250c02e6854afe...4490b40bc6f36bb2abd047d16ad372310e9a22e5,1,1,1,2,1,2011-06-06 23:57:41,2011-06-06 23:57:41
4490b40bc6f36bb2abd047d16ad372310e9a22e5...edf8f859578c2c877bea92fc9c8dc9122f6c3f22,1,4,5,9,5,2011-06-08 19:26:46,2011-06-08 19:26:46
edf8f859578c2c877bea92fc9c8dc9122f6c3f22...3900cfcf8c7c229e0268208c0b90db9f208dffa9,1,2,2,4,1,2011-06-09 04:20:53,2011-06-09 04:20:30
3900cfcf8c7c229e0268208c0b90db9f208dffa9...c5b9318b6d8100fd264fff49aae4a0e333507b17,1,18,16,34,1,2011-06-09 04:21:29,2011-06-09 04:21:09
c5b9318b6d8100fd264fff49aae4a0e333507b17...50b5572b0859da1a6d6f266397dc20f4e5af55f9,1,5,1,6,1,2011-06-09 15:07:30,2011-06-09 15:07:30
50b5572b0859da1a6d6f266397dc20f4e5af55f9...ead33091f0726dc6304304956d461ece816666a8,1,41,18,59,15,2011-06-09 15:45:20,2011-06-06 03:53:20
ead33091f0726dc6304304956d461ece816666a8...c79ca08c9d3ca006377de654407477881dfc8c82,2,39,1,40,3,2011-06-09 15:45:20,2011-06-06 14:34:20
c79ca08c9d3ca006377de654407477881dfc8c82...0badca8e5bc860e38608ac9e1816a384fb029c0f,1,1,1,2,1,2011-06-09 15:45:20,2011-06-06 14:37:38
0badca8e5bc860e38608ac9e1816a384fb029c0f...19e4da397533e2b7bbd1c217d70a98a72093738f,2,21,11,32,7,2011-06-09 15:45:21,2011-06-07 18:24:17
19e4da397533e2b7bbd1c217d70a98a72093738f...5369770ecc8b32c813c28ebe5641c301bd2ddb63,1,2,2,4,2,2011-06-09 16:51:35,2011-06-09 16:51:35
5369770ecc8b32c813c28ebe5641c301bd2ddb63...e9d037a76f5ae2e5c9a20c274dac0768a559d72e,4,34,25,59,24,2011-06-09 17:25:46,2011-06-09 17:24:46
e9d037a76f5ae2e5c9a20c274dac0768a559d72e...687b0d6175a8080942f37fcfb506720c5cb94874,3,374,44,418,14,2011-06-09 19:04:07,2011-06-09 19:04:07
687b0d6175a8080942f37fcfb506720c5cb94874...f0337ae981d6a2d8e81282559e13af72a5400208,8,107,88,195,28,2011-06-09 19:05:34,2011-06-09 19:05:34
f0337ae981d6a2d8e81282559e13af72a5400208...8e9d70a66fc8b6a5a64a94a9c18847c0917b84af,4,175,8,183,12,2011-06-09 19:06:35,2011-06-09 19:06:35
8e9d70a66fc8b6a5a64a94a9c18847c0917b84af...ea0f21e2800217b1fa7168cfaa3ccea9ac61989d,1,1,1,2,1,2011-06-09 19:26:10,2011-06-09 19:26:10
ea0f21e2800217b1fa7168cfaa3ccea9ac61989d...fcd1ff5edb1a243014ac3edfb8de6a008439ea5e,1,2,2,4,2,2011-06-09 19:36:34,2011-06-09 19:36:34
fcd1ff5edb1a243014ac3edfb8de6a008439ea5e...1f20d1e6f81b0203f101bb456e7d3d14de5a5e65,2,8,7,15,4,2011-06-09 20:16:18,2011-06-09 20:16:18
1f20d1e6f81b0203f101bb456e7d3d14de5a5e65...17f2e3d7e25a5d149f0e67ba85ec823ce47bf082,1,4,4,8,4,2011-06-09 20:36:08,2011-06-09 20:36:08
17f2e3d7e25a5d149f0e67ba85ec823ce47bf082...3d909045d30dcd6af39bf21dd62a379275262ccd,1,4,0,4,2,2011-06-09 22:59:56,2011-06-09 22:59:56
3d909045d30dcd6af39bf21dd62a379275262ccd...ab883bc2ed0ca0f152352afc098b7cde34b034ca,2,2,2,4,2,2011-06-10 13:59:17,2011-06-10 13:59:17
ab883bc2ed0ca0f152352afc098b7cde34b034ca...0180e84034448d695ca9b442faf580723aba3435,2,72,1,73,4,2011-06-10 14:56:46,2011-06-10 14:56:46
0180e84034448d695ca9b442faf580723aba3435...5a450f3c4cf4132ed9e82a66f8614064448c3231,1,21,8,29,7,2011-06-10 15:13:29,2011-06-10 15:13:29
5a450f3c4cf4132ed9e82a66f8614064448c3231...0e8b348a82c7a60c2d6d153f94e25e57de7ab9df,1,1,0,1,1,2011-06-10 15:20:34,2011-06-10 15:20:34
0e8b348a82c7a60c2d6d153f94e25e57de7ab9df...ae2f32f4fbe64db8205e074b60ad8f3b6f5da98b,1,2,1,3,2,2011-06-10 15:47:37,2011-06-10 15:47:37
ae2f32f4fbe64db8205e074b60ad8f3b6f5da98b...dd0aea34979aa1885a1bbcce1e632d59326ad6ef,4,88,68,156,9,2011-06-10 16:35:33,2011-06-10 16:35:33
dd0aea34979aa1885a1bbcce1e632d59326ad6ef...30679312d1b11e6ed3c2fece3fcc0b4819142ce6,1,27,17,44,6,2011-06-10 18:22:44,2011-06-10 18:22:44
30679312d1b11e6ed3c2fece3fcc0b4819142ce6...510c4a6fc3eff8569c5d45e611037a9f412cfe8d,1,4,2,6,3,2011-06-10 18:36:41,2011-06-10 18:36:41
510c4a6fc3eff8569c5d45e611037a9f412cfe8d...f5f44f51b7fee32da20ed2030e04579d85068ad4,1,4,0,4,1,2011-06-10 19:25:31,2011-06-10 19:25:31
f5f44f51b7fee32da20ed2030e04579d85068ad4...8db6995de230148d4187e8880408c0f4bb29698a,1,27,7,34,11,2011-06-10 19:27:56,2011-06-10 19:27:47
8db6995de230148d4187e8880408c0f4bb29698a...bfe34b198501dba079ecc33b2c2b36d4d60ae564,6,33,17,50,17,2011-06-11 16:55:46,2011-06-11 16:55:46
bfe34b198501dba079ecc33b2c2b36d4d60ae564...c156124f3726b84b385aca5127be1fa672a1daf3,1,4,0,4,1,2011-06-11 18:28:17,2011-06-11 18:28:17
c156124f3726b84b385aca5127be1fa672a1daf3...96b2c2e35e6e7bb45391849e39c1dcae879d0d08,2,10,6,16,11,2011-06-11 23:45:03,2011-06-11 23:45:03
96b2c2e35e6e7bb45391849e39c1dcae879d0d08...a74672f5a85d34856da6c22db79680e1b2102a68,1,4,11,15,5,2011-06-12 00:34:27,2011-06-12 00:34:27
a74672f5a85d34856da6c22db79680e1b2102a68...0a10d173c14b2b4501d2dd6fe5a3083ab33c747d,1,3,0,3,1,2011-06-12 16:56:23,2011-06-12 16:56:23
0a10d173c14b2b4501d2dd6fe5a3083ab33c747d...921c40d1083c709f5873477723e069b22bc43792,1,1,1,2,1,2011-06-12 17:08:49,2011-06-12 17:08:49
921c40d1083c709f5873477723e069b22bc43792...e1781e2c4eba47b5e74aeea1d48329c06237ea8e,2,69,2,71,2,2011-06-13 15:27:00,2011-06-13 15:27:00
b87035b83dfd343790b20f7351805aecaafadecf...e593a577ddda212a0175e20399de2fbd70a71480,2,11,6,17,5,2011-06-06 17:06:43,2011-06-06 17:06:43
2b6bd331d6ad557819d61182b7de3ba32bedbbba...5961cc9ddc44eb8a5ed2cf36d672f04411fbbe52,6,82,50,132,25,2011-07-05 15:17:05,2011-07-05 15:17:05
2b6bd331d6ad557819d61182b7de3ba32bedbbba...74cd733b1bcd5d6dba129657a9342613fb852eae,3,83,2,85,5,2011-07-04 22:44:27,2011-07-04 22:44:27
74cd733b1bcd5d6dba129657a9342613fb852eae...91efa3fcd9881484d4bb5da14a307c0f06d4c4d5,2,6,6,12,4,2011-07-05 04:46:50,2011-07-05 04:46:50
91efa3fcd9881484d4bb5da14a307c0f06d4c4d5...1c44a0e5b55ef69196fe46b96a7a583292983501,1,4,3,7,2,2011-07-05 04:47:04,2011-07-05 04:47:04
1c44a0e5b55ef69196fe46b96a7a583292983501...5385a59f6dc438f15d276ddc0d2a26d3bac33a04,2,28,12,40,14,2011-07-05 05:39:06,2011-07-05 05:39:06
5385a59f6dc438f15d276ddc0d2a26d3bac33a04...bae8a58301a91103a028695fbabe3d42b8579758,1,2,2,4,2,2011-07-05 06:29:36,2011-07-05 06:29:36
bae8a58301a91103a028695fbabe3d42b8579758...14688132ca56d89f2c6d45e6cac0caa6c5e91b94,1,6,0,6,1,2011-07-05 06:42:31,2011-07-05 06:42:31
14688132ca56d89f2c6d45e6cac0caa6c5e91b94...cc919ccfe717b1d8f21218193055e719b5f96f87,1,2,2,4,2,2011-07-05 07:27:16,2011-07-05 07:27:16
cc919ccfe717b1d8f21218193055e719b5f96f87...c6de22b767ad43a250ea4651d8fe0fcf8c1e9146,1,2,2,4,2,2011-07-05 13:12:19,2011-07-05 13:12:19
c6de22b767ad43a250ea4651d8fe0fcf8c1e9146...c50af352fd5050fe6382f0417b8f476bbf9657a2,1,593,587,1180,122,2011-07-05 13:12:27,2011-07-05 13:12:27
b0ed0dcee4d96729e87e8d48e5f9c8738a8c122f...01e780019a472045bd2dc09ea0ae759d35359c4d,2,4,1,5,2,2011-06-27 21:45:31,2011-06-27 21:45:31
70fbb3c95847225da73af93534851db1b32d9f50...87a4604930a9f4e2324bf5d5ccbec106d2a84e7f,1,10,0,10,2,2012-03-26 17:23:23,2012-03-26 17:21:30
87a4604930a9f4e2324bf5d5ccbec106d2a84e7f...e1f684532131ac579c0f4e35a46e1a28da6567d8,1,2,2,4,2,2012-03-26 17:23:23,2012-03-26 17:22:42
8ea68f28c358558779f73930e3f637519f0eeb27...94dbedebde3ee6acbcaa5868e034ddc62126294e,3,8,1,9,4,2012-04-10 18:50:54,2012-04-10 18:50:54
8ea68f28c358558779f73930e3f637519f0eeb27...1732d0a4d5ac2ed4112bd81600b0cc3d98e20249,1,159,4,163,7,2012-04-10 18:09:58,2012-04-01 23:54:36
e1781e2c4eba47b5e74aeea1d48329c06237ea8e...4fcedbefd7c956e640b8ebec42ee2469d56c4008,2,21,25,46,6,2011-06-13 20:57:19,2011-06-13 20:57:19
4fcedbefd7c956e640b8ebec42ee2469d56c4008...90ac687ee050e00cb42c17c4c82fddaf1949b906,2,2,4,6,4,2011-06-13 20:57:34,2011-06-13 20:57:34
e1781e2c4eba47b5e74aeea1d48329c06237ea8e...5be2a96b0ac4990ee3df323a94e5c9cf36b7cbe1,3,16,13,29,7,2011-06-13 17:09:26,2011-06-13 17:09:26
e593a577ddda212a0175e20399de2fbd70a71480...bf856b75d94a9ef60ce5786dd848dd380d20f1a1,4,217,203,420,56,2011-06-06 18:41:56,2011-06-06 18:41:37
e593a577ddda212a0175e20399de2fbd70a71480...98b52c0994b90e707ec7612a850b1fe69320ec0f,1,1,1,2,1,2011-06-06 18:03:10,2011-06-06 18:03:10
98b52c0994b90e707ec7612a850b1fe69320ec0f...64973c66d8e4c6b3eb9d2b99c3aea6b58bb7a4f8,2,9,1,10,2,2011-06-06 19:14:51,2011-06-06 19:14:51
971d621533c04020d112b6ddce6f00269619a4ed...611a71264a008ff8c53a3c37ea4e092a72b78258,1,2,2,4,2,2011-07-05 15:22:02,2011-07-05 15:22:02
01e780019a472045bd2dc09ea0ae759d35359c4d...9bbe38a24c74f10f025f6820e514f64e8e0d7c29,2,8,10,18,10,2011-06-27 22:56:09,2011-06-27 22:56:09
01e780019a472045bd2dc09ea0ae759d35359c4d...cbe9ebfeaf312e2a3e687e79657d0cc5a4157e60,1,14,7,21,5,2011-06-27 21:53:21,2011-06-27 21:44:32
cbe9ebfeaf312e2a3e687e79657d0cc5a4157e60...23a6515a8994ce2c70dbe3a86d684873ffe44526,2,10,3,13,4,2011-06-28 04:37:42,2011-06-28 04:37:42
23a6515a8994ce2c70dbe3a86d684873ffe44526...947a5de44d30cb96de7dff146229baed45278ef8,1,1,1,2,1,2011-06-28 04:38:08,2011-06-28 04:38:08
947a5de44d30cb96de7dff146229baed45278ef8...70040db8d0bed4ec8c8e16eb49a16ee8f1658b79,3,39,21,60,7,2011-06-28 04:55:06,2011-06-28 04:55:06
70040db8d0bed4ec8c8e16eb49a16ee8f1658b79...7f37213fc9249e8005e3d365c621d0f3cd2051a2,6,143,133,276,12,2011-06-28 05:44:43,2011-06-28 05:44:43
e1f684532131ac579c0f4e35a46e1a28da6567d8...43907e2a7cf00353e5344ff6a9ea6f9ad8368235,1,3,3,6,2,2012-03-26 18:57:34,2012-03-26 18:57:34
e1f684532131ac579c0f4e35a46e1a28da6567d8...c8dc9110a12fa6d310ef29f4be78e6f0244871ab,1,7,3,10,5,2012-03-26 18:15:43,2012-03-26 18:15:43
c8dc9110a12fa6d310ef29f4be78e6f0244871ab...88fbe9ab9e47e5d1e254c72c1eff573d9afba06c,1,2,1,3,1,2012-03-26 18:54:14,2012-03-26 18:52:07
14e5f5e54b1b8d8d370657bfd32f2525ab7ee499...d9ed3cad70fca82a56c08e6e5d2c52cfb2e58ad8,5,59,28,87,19,2012-04-10 19:21:36,2012-04-10 19:21:36
d9ed3cad70fca82a56c08e6e5d2c52cfb2e58ad8...790a7d0655f6ac9a772641c4af15dccd09817aed,1,0,159,159,5,2012-04-10 20:10:25,2012-04-10 20:10:14
790a7d0655f6ac9a772641c4af15dccd09817aed...8b4d9dbe20e0f3f75a62d5ababe12e50f1d935ab,1,17,17,34,3,2012-04-10 20:39:48,2012-04-10 17:37:48
8b4d9dbe20e0f3f75a62d5ababe12e50f1d935ab...6fcb4179839fcfa94fc219407d617558419208a7,1,11,4,15,4,2012-04-10 20:39:48,2012-04-10 17:38:37
6fcb4179839fcfa94fc219407d617558419208a7...c28d97d1a14a36ffc056bfd9ba7262b0a1509b5b,1,0,16,16,1,2012-04-10 22:06:27,2012-04-10 21:34:52
c28d97d1a14a36ffc056bfd9ba7262b0a1509b5b...88e3526a22a2daf1c892e2fd9ac39544d2bb3976,3,1,13,14,3,2012-04-11 03:21:43,2012-04-05 21:34:39
88e3526a22a2daf1c892e2fd9ac39544d2bb3976...6a001b8a0759c72c2bca75d013453b6b6ac5f329,3,3,3,6,3,2012-04-11 03:21:43,2012-04-05 22:04:37
6a001b8a0759c72c2bca75d013453b6b6ac5f329...1c5caba23c150970eb8ad8aab25608ee31b7c197,1,1,11,12,6,2012-04-11 03:21:44,2012-04-05 22:29:52
1c5caba23c150970eb8ad8aab25608ee31b7c197...35c3230e24b6cb86e88ca2fcee4982b34c8d8aba,1,2,4,6,1,2012-04-11 03:21:44,2012-04-05 23:15:38
35c3230e24b6cb86e88ca2fcee4982b34c8d8aba...db5cb2f6748ed2481c61ee61aca6c6da9db98387,1,3,2,5,1,2012-04-11 03:21:44,2012-04-05 23:25:51
db5cb2f6748ed2481c61ee61aca6c6da9db98387...3a851a5e964ccae8c7dba2746966ed96815baff1,1,0,13,13,3,2012-04-11 03:21:45,2012-04-05 23:31:17
3a851a5e964ccae8c7dba2746966ed96815baff1...b7d83f82c7a985f92cbd3bd2912dbd68d1a636e1,1,0,4,4,1,2012-04-11 03:21:45,2012-04-05 23:52:06
b7d83f82c7a985f92cbd3bd2912dbd68d1a636e1...4328493f9a65187e91a2053677559918ced0b18a,1,7,1,8,2,2012-04-11 03:21:45,2012-04-06 00:33:37
4328493f9a65187e91a2053677559918ced0b18a...286122945af26464c95480c4f283ad7b9eac9aa7,1,1,5,6,1,2012-04-11 03:21:46,2012-04-06 01:08:27
286122945af26464c95480c4f283ad7b9eac9aa7...eaa316bf29117152a828b06bb3e5845b2a2ad6a3,6,704,620,1324,18,2012-04-11 03:21:46,2012-04-06 02:34:10
eaa316bf29117152a828b06bb3e5845b2a2ad6a3...aa50a6ce7a0497159ac91e9833f06e4729ec311c,5,6,6,12,7,2012-04-11 03:21:47,2012-04-06 02:39:23
aa50a6ce7a0497159ac91e9833f06e4729ec311c...4ea1ee39c88c15f0bfdc325710fd64bafa9b87c8,7,270,212,482,20,2012-04-11 03:21:47,2012-04-06 03:03:03
4ea1ee39c88c15f0bfdc325710fd64bafa9b87c8...dfd3eb776c84ef961b7d0988507431770ce74ed4,2,0,15,15,4,2012-04-11 03:21:47,2012-04-06 03:08:13
dfd3eb776c84ef961b7d0988507431770ce74ed4...59e1f36fe259862e10bfe6d1eece87ee5919f780,2,231,219,450,46,2012-04-11 03:21:48,2012-04-06 03:25:38
59e1f36fe259862e10bfe6d1eece87ee5919f780...ecd7eceef41b2777d1d969236c3f2377fa6f4eac,2,11,13,24,6,2012-04-11 03:21:48,2012-04-06 03:28:59
ecd7eceef41b2777d1d969236c3f2377fa6f4eac...d6df6d4d35d0c2f9327dbee755d9d32f8bba769e,2,82,82,164,33,2012-04-11 03:21:49,2012-04-06 03:37:13
d6df6d4d35d0c2f9327dbee755d9d32f8bba769e...f9a5a4885dfebe154a483baec152d4b3ee2ba5a7,2,5,5,10,2,2012-04-11 03:21:49,2012-04-06 03:45:27
f9a5a4885dfebe154a483baec152d4b3ee2ba5a7...b3eb9c13e98795c82e530879c5f179cf7eb1be32,2,38,19,57,13,2012-04-11 03:21:49,2012-04-06 05:59:16
b3eb9c13e98795c82e530879c5f179cf7eb1be32...9e2f201db7afc942aab7ea4db012e270c3862e79,2,40,36,76,8,2012-04-11 03:21:50,2012-04-08 07:27:41
9e2f201db7afc942aab7ea4db012e270c3862e79...473a59f7d3719e1eb9b5fd91043742f7be223b93,2,0,4,4,3,2012-04-11 03:21:50,2012-04-08 07:30:06
473a59f7d3719e1eb9b5fd91043742f7be223b93...2684b7b6dc10663b8908c08fa167c1d0d13126c8,3,93,38,131,6,2012-04-11 03:21:51,2012-04-08 20:08:11
2684b7b6dc10663b8908c08fa167c1d0d13126c8...caed163e648d31c50c2b80ec99cface928f94b7a,4,15,15,30,14,2012-04-11 03:21:51,2012-04-08 20:21:33
caed163e648d31c50c2b80ec99cface928f94b7a...f3740a9b25e6816e5a1fae96fad24f43c1ed9619,2,77,35,112,21,2012-04-11 03:21:51,2012-04-08 23:43:09
f3740a9b25e6816e5a1fae96fad24f43c1ed9619...cd2e250d19ce77cd91098c42f604a4704fa40b78,2,15,9,24,5,2012-04-11 03:21:51,2012-04-09 02:00:15
cd2e250d19ce77cd91098c42f604a4704fa40b78...9faec17a662ed1d69d0fb7289c557ee0f601a281,1,0,12,12,2,2012-04-11 03:21:51,2012-04-09 02:23:52
9faec17a662ed1d69d0fb7289c557ee0f601a281...c4ae3bc07b9264b4f57027fae2563b8f281fc387,2,4,10,14,6,2012-04-11 03:21:52,2012-04-09 02:24:47
c4ae3bc07b9264b4f57027fae2563b8f281fc387...24e00b1535433d1078ead934d2cea103a3ba15bf,1,5,2,7,5,2012-04-11 03:21:52,2012-04-09 02:33:09
24e00b1535433d1078ead934d2cea103a3ba15bf...864508a042e707edba366e39d3f18c8a2b305058,2,64,40,104,4,2012-04-11 03:21:52,2012-04-09 02:38:13
864508a042e707edba366e39d3f18c8a2b305058...6c1cd0407427fb455f550ab77976d57683aa756f,2,13,2,15,13,2012-04-11 03:21:53,2012-04-09 02:58:13
6c1cd0407427fb455f550ab77976d57683aa756f...4335c677ac95929bb6942f9715e3e8b3b295cd0d,2,64,56,120,42,2012-04-11 03:21:53,2012-04-09 05:11:18
4335c677ac95929bb6942f9715e3e8b3b295cd0d...f056a3ae467c9b897a96bdf156c8781bf776a273,1,7,5,12,4,2012-04-11 03:21:54,2012-04-09 06:58:13
f056a3ae467c9b897a96bdf156c8781bf776a273...3da1a81c1082f4c9e726be8da8c725311b83ff90,3,16,17,33,14,2012-04-11 03:21:54,2012-04-09 07:04:08
3da1a81c1082f4c9e726be8da8c725311b83ff90...d4c4efde1b009552cde987460483f98d31292428,1,27,11,38,9,2012-04-11 03:21:54,2012-04-09 19:11:19
d4c4efde1b009552cde987460483f98d31292428...74f43b7276c1c0ec3fa1c90bd91e47b4d6b81841,1,9,9,18,3,2012-04-11 03:21:55,2012-04-09 19:53:30
74f43b7276c1c0ec3fa1c90bd91e47b4d6b81841...375f6ac87c1d3ae185e00e97696ba11b9ce28592,1,5,5,10,4,2012-04-11 03:21:55,2012-04-09 19:55:02
375f6ac87c1d3ae185e00e97696ba11b9ce28592...7d23c581e858b6888f2261311b09efbcf9a2530a,1,1,1,2,1,2012-04-11 03:21:55,2012-04-09 19:59:25
7d23c581e858b6888f2261311b09efbcf9a2530a...459d1f8b0d9b92581a5be293f78de88f7ca9220e,1,1,1,2,1,2012-04-11 03:21:55,2012-04-09 21:40:35
459d1f8b0d9b92581a5be293f78de88f7ca9220e...e909c2f3aa58b7c986546e7752a7d688397dcba0,3,12,3,15,4,2012-04-11 03:21:56,2012-04-09 22:08:31
e909c2f3aa58b7c986546e7752a7d688397dcba0...0907e792cf1450659dc37d09a835fb41587c0217,4,12,11,23,4,2012-04-11 03:21:56,2012-04-09 23:26:18
0907e792cf1450659dc37d09a835fb41587c0217...ab23ff16425d04ef26b23a710825c38c9e4ad428,9,23,23,46,23,2012-04-11 03:21:56,2012-04-10 16:25:54
ab23ff16425d04ef26b23a710825c38c9e4ad428...5d0392b1a26ce7e01f6ef19d9d828484d1604f17,1,1,3,4,2,2012-04-11 03:21:57,2012-04-10 16:28:13
5d0392b1a26ce7e01f6ef19d9d828484d1604f17...942f0243acd3728dd2b348b27e04a22f5f5bc3e8,1,4,0,4,1,2012-04-11 04:11:45,2012-04-11 04:11:45
942f0243acd3728dd2b348b27e04a22f5f5bc3e8...00f143066ab862977c008843173cbe82234d8668,1,2,0,2,2,2012-04-11 04:23:28,2012-04-11 04:23:28
00f143066ab862977c008843173cbe82234d8668...112ebda4be002cd421213d246f2cfad5900b0a28,2,0,208,208,2,2012-04-11 05:51:02,2012-04-11 05:51:02
112ebda4be002cd421213d246f2cfad5900b0a28...4f52acec85df522497f874f4661a3d022a25b624,2,20,4,24,5,2012-04-11 09:40:26,2012-04-11 09:40:26
4f52acec85df522497f874f4661a3d022a25b624...ab60e77554527f22626d050fe6b01ee44fb55e01,1,2,1,3,1,2012-04-11 14:01:20,2012-04-10 22:09:36
ab60e77554527f22626d050fe6b01ee44fb55e01...3fa261b2489f09254c956329ac10e7a874f2b66b,1,3,2,5,2,2012-04-11 14:44:56,2012-04-11 14:44:56
3fa261b2489f09254c956329ac10e7a874f2b66b...b038ae0bae369b2883536016924836d70c9c17db,1,2,1,3,2,2012-04-11 14:50:04,2012-04-11 08:31:56
b038ae0bae369b2883536016924836d70c9c17db...82b5219b3a2989f99bd33f3300eae22aeeac947c,1,2,1,3,2,2012-04-11 15:36:21,2012-04-11 15:36:21
82b5219b3a2989f99bd33f3300eae22aeeac947c...ca19efe60ee4c17619606fecee03553bd7f8b10a,1,2,2,4,1,2012-04-11 16:00:48,2012-04-11 16:00:48
ca19efe60ee4c17619606fecee03553bd7f8b10a...a23f2cde7cb4b22152b6b15438d67abb971f402f,1,1,1,2,1,2012-04-11 16:11:27,2012-04-11 16:11:27
a23f2cde7cb4b22152b6b15438d67abb971f402f...1413ccf13522394dfc87af4edd403b2d1610de87,1,1,1,2,1,2012-04-11 16:14:06,2012-04-11 16:13:54
1413ccf13522394dfc87af4edd403b2d1610de87...6628c4eaaef626b661eb681880e3e5b674ca953a,1,1,5,6,1,2012-04-11 17:48:08,2012-04-11 17:48:08
6628c4eaaef626b661eb681880e3e5b674ca953a...f23c11d81717d0a162c6bc9cb05600ddff26d81f,2,10,0,10,2,2012-04-11 19:22:40,2012-04-11 18:12:38
f23c11d81717d0a162c6bc9cb05600ddff26d81f...47c3a3ea636dcc5313e3f6700a4743a11db64eae,1,1,1,2,1,2012-04-11 19:28:44,2012-04-11 17:51:30
47c3a3ea636dcc5313e3f6700a4743a11db64eae...9ea3d35a18be3ec7ed787b19638526a5057494e5,1,2,2,4,2,2012-04-11 19:28:44,2012-04-11 18:59:39
9ea3d35a18be3ec7ed787b19638526a5057494e5...892331fa9fe5dfdd0403882b219284f1cd199d9c,2,6,6,12,3,2012-04-11 20:38:18,2012-04-11 20:36:26
892331fa9fe5dfdd0403882b219284f1cd199d9c...869e8b4ace0d6f7e0379ca412f73a118b1ab3312,10,2276,2097,4373,16,2012-04-12 10:50:35,2012-04-12 10:50:35
869e8b4ace0d6f7e0379ca412f73a118b1ab3312...e819261720e48699679c511c69f2f82c2c6a94ab,1,6,6,12,2,2012-04-12 14:00:22,2012-04-12 14:00:22
e819261720e48699679c511c69f2f82c2c6a94ab...6ae3906856e44147061a7fe7d60a1e73445ee40a,7,190,39,229,15,2012-04-12 16:22:05,2012-04-11 20:04:22
6ae3906856e44147061a7fe7d60a1e73445ee40a...2123b4991c3754fcaad038f300bdeb0a2993c244,3,60,0,60,4,2012-04-12 17:22:05,2012-04-11 21:32:38
2123b4991c3754fcaad038f300bdeb0a2993c244...330f8820c636e18d8166f78db74f8d66129832e0,2,84,7,91,9,2012-04-12 17:22:06,2012-04-11 23:16:19
330f8820c636e18d8166f78db74f8d66129832e0...7cb696d7761b56ac87e70f140bb351478e5a5898,2,22,7,29,10,2012-04-12 17:36:51,2012-04-11 20:05:01
7cb696d7761b56ac87e70f140bb351478e5a5898...890d3b586d95761f041eb7afe0032c7e18737890,7,69,41,110,10,2012-04-12 18:00:21,2012-04-05 19:44:23
890d3b586d95761f041eb7afe0032c7e18737890...6828426a66621e52e0be0efa50957597dff2f492,2,15,0,15,2,2012-04-12 18:00:21,2012-04-05 20:50:10
6828426a66621e52e0be0efa50957597dff2f492...77c70ec818a517736c2a3ca1b4c28562e6ecd469,1,6,4,10,1,2012-04-12 18:34:36,2012-04-12 17:06:30
77c70ec818a517736c2a3ca1b4c28562e6ecd469...7c024a1dd496da0e8975e7ab6b6d4cbfa47f5d51,1,1,1,2,1,2012-04-12 20:23:04,2012-04-12 20:14:58
7c024a1dd496da0e8975e7ab6b6d4cbfa47f5d51...5c8053463a38a8c554e0d8a02bef8e5942df8aee,2,21,0,21,4,2012-04-12 21:36:24,2012-04-11 14:57:25
5c8053463a38a8c554e0d8a02bef8e5942df8aee...06e99af88d14406e8b85d660625e1f75938f9a09,3,97,4,101,5,2012-04-12 22:19:21,2012-04-12 22:19:21
7d9067216abe2cd67192780731e0ed03ef801027...e31b0ce2efcc56ab45eac42f66c1fdeb1b4bad7c,1,1,0,1,1,2011-06-14 21:25:36,2011-06-14 21:25:36
e31b0ce2efcc56ab45eac42f66c1fdeb1b4bad7c...73b97fda112e0ade208f1120b7c34a0eb6829a3c,1,6,1,7,3,2011-06-14 21:26:27,2011-06-14 21:26:27
73b97fda112e0ade208f1120b7c34a0eb6829a3c...ac1232db80be19e662d3bdd14985036d19467e22,1,15,8,23,7,2011-06-16 18:46:27,2011-06-16 18:46:27
ac1232db80be19e662d3bdd14985036d19467e22...c5e3605f3734318f54e02c04b1474a4f18dda726,1,2,2,4,2,2011-06-16 20:24:08,2011-06-16 20:24:08
c5e3605f3734318f54e02c04b1474a4f18dda726...14711f4ef153087dfabb911528ea390412bbc7c8,7,54,32,86,36,2011-06-16 20:35:07,2011-06-16 20:35:07
7d9067216abe2cd67192780731e0ed03ef801027...74589826a70211331119d63a27b620b8e07f433f,1,2,0,2,2,2011-06-13 21:00:05,2011-06-13 21:00:05
74589826a70211331119d63a27b620b8e07f433f...abcf32bd289dd2099dd98f43d45a49e651fc7084,3,35,10,45,17,2011-06-13 21:06:57,2011-06-13 21:05:23
abcf32bd289dd2099dd98f43d45a49e651fc7084...dda653aae03b9250646d6701de1c909dc9282726,2,11,6,17,9,2011-06-13 21:19:23,2011-06-13 21:19:23
dda653aae03b9250646d6701de1c909dc9282726...ec68f3c6d5e16d55b87e0981d6a5ef6819115997,11,839,67,906,35,2011-06-13 21:33:38,2011-06-13 21:25:44
ec68f3c6d5e16d55b87e0981d6a5ef6819115997...7ac2b5bef21b30f63996561e5696ab462e380e8e,5,221,220,441,50,2011-06-13 21:53:33,2011-06-13 21:53:33
7ac2b5bef21b30f63996561e5696ab462e380e8e...ebd06a579b175aafbd28996dd6ec747dc056806e,1,15,2,17,2,2011-06-13 23:19:06,2011-06-13 23:19:06
ebd06a579b175aafbd28996dd6ec747dc056806e...6296e8c7633af418c4ff3e69b59e8c7597c0d1d1,2,26,14,40,9,2011-06-13 23:19:31,2011-06-13 23:19:31
6296e8c7633af418c4ff3e69b59e8c7597c0d1d1...436a4edd9fafc134fbf86c3b127d4714de609044,6,67,28,95,32,2011-06-13 23:43:38,2011-06-08 17:00:09
436a4edd9fafc134fbf86c3b127d4714de609044...95cac3dad87231ac65dfa5b6ad7dde4d7fc587e2,1,4,4,8,1,2011-06-14 00:00:05,2011-06-14 00:00:05
95cac3dad87231ac65dfa5b6ad7dde4d7fc587e2...a2714c023c1e054708a7f66ff0b66856573fbd3a,3,24,16,40,7,2011-06-14 00:15:32,2011-06-14 00:15:32
a2714c023c1e054708a7f66ff0b66856573fbd3a...0592a5f6d6f31bff2d1d3ae72a0406b87f6e4187,2,22,6,28,5,2011-06-14 07:11:25,2011-06-14 07:10:42
0592a5f6d6f31bff2d1d3ae72a0406b87f6e4187...fe4587a317ab8f377cdcbe1653496a3bc2a0f633,1,11,11,22,11,2011-06-14 13:34:22,2011-06-14 13:33:58
fe4587a317ab8f377cdcbe1653496a3bc2a0f633...759e1e646df90b5ac858e2ccd6d587ef59912353,4,17,33,50,9,2011-06-14 20:05:44,2011-06-14 20:05:44
759e1e646df90b5ac858e2ccd6d587ef59912353...aa4edc53fb07a89b74977c9654b0f216b1582b07,4,43,15,58,11,2011-06-14 20:22:51,2011-06-14 20:22:51
aa4edc53fb07a89b74977c9654b0f216b1582b07...30ed7953ecdea5bf26513e1a76950f7b27f8818e,1,0,2,2,2,2011-06-14 20:40:17,2011-06-14 18:13:55
30ed7953ecdea5bf26513e1a76950f7b27f8818e...951957f8646ba9b64473141adce9d2253afcc740,1,4,0,4,1,2011-06-14 20:40:17,2011-06-14 20:39:43
951957f8646ba9b64473141adce9d2253afcc740...1c180c6a60126e8468e71d7b36b29ee0d7b7bdb9,1,7,2,9,2,2011-06-15 17:42:21,2011-06-15 15:35:46
272367a8a17a80555d169a1abe304c075d804167...20387254439815ccc7368dd3291613288ec7d45a,1,10,1,11,1,2011-06-06 19:38:51,2011-06-06 19:38:51
20387254439815ccc7368dd3291613288ec7d45a...99992e780d062102a9de0e1817071a6dac949891,2,60,8,68,12,2011-06-06 19:39:27,2011-06-06 19:38:40
99992e780d062102a9de0e1817071a6dac949891...0d7aa757ed00b6e428dbb85b81e17b4734b203c7,1,10,0,10,4,2011-06-06 19:39:47,2011-06-06 19:39:47
0d7aa757ed00b6e428dbb85b81e17b4734b203c7...a2ddbd3946fd56d78f37313130d2aab35345e90d,1,0,11,11,4,2011-06-06 19:44:23,2011-06-06 19:44:23
a2ddbd3946fd56d78f37313130d2aab35345e90d...89ab76c4447ddd974f13dd8dd8695962f34f50c9,1,1,1,2,1,2011-06-06 22:25:50,2011-06-06 22:25:50
611a71264a008ff8c53a3c37ea4e092a72b78258...e9170171f9f55e18a2bdf13d8d0b1dbfb2e71b8f,3,17,1,18,3,2011-07-05 15:39:36,2011-07-05 15:39:36
611a71264a008ff8c53a3c37ea4e092a72b78258...aacc4d5f8a113a3c01b0cc2e6232b363a9a3b47c,1,0,2,2,1,2011-07-05 15:14:09,2011-07-05 15:14:09
3d3dba30c4b072cc67c90498b38a54ccd29f45c6...d185863adae310aec020e382a67977718492cf7e,1,0,1,1,1,2011-06-28 18:08:33,2011-06-28 18:08:33
7f37213fc9249e8005e3d365c621d0f3cd2051a2...ddc9c33d2dcfcb34a0646e3fdced74a79d948d35,2,53,1,54,3,2011-06-28 16:16:24,2011-06-28 16:15:01
f631d11dc97e46f98ec4473ea013b7db83683add...6c05a8e9158f629b612f7e3ba2372bce48c9c3e5,9,34,14,48,19,2012-03-26 20:25:06,2012-03-26 20:25:06
6c05a8e9158f629b612f7e3ba2372bce48c9c3e5...d4c663405f3ea1577a146549e73f428f55840aa2,1,3,2,5,3,2012-03-26 21:13:29,2012-03-26 21:13:29
d4c663405f3ea1577a146549e73f428f55840aa2...fc6d869bd26c0e569e112b8331ac75c1c14dace9,1,2,0,2,1,2012-03-26 23:42:00,2012-03-26 23:42:00
fc6d869bd26c0e569e112b8331ac75c1c14dace9...bf20c28c9b5051d190def49860026813badae988,1,3,1,4,2,2012-03-26 23:42:16,2012-03-26 23:42:16
bf20c28c9b5051d190def49860026813badae988...69db073a3e35083f6c6216b550fe72a7572ba7f9,4,1,22,23,4,2012-03-27 01:39:10,2012-03-26 21:07:30
69db073a3e35083f6c6216b550fe72a7572ba7f9...8bd22928b9ab630f74f5c10124f7662ce91c484d,3,15,1,16,3,2012-03-27 04:56:08,2012-03-27 04:56:08
8bd22928b9ab630f74f5c10124f7662ce91c484d...b5a14dd396630e3429491d4abc256a54b7bfb595,1,3,1,4,3,2012-03-27 09:46:34,2012-03-27 09:46:34
b5a14dd396630e3429491d4abc256a54b7bfb595...38712f421b93e9c329b7613557da48ac3235a68f,1,1,1,2,1,2012-03-27 14:19:57,2012-03-26 12:58:31
38712f421b93e9c329b7613557da48ac3235a68f...45d046474786d747cd5ca0b51eb718de24b171e2,2,43,23,66,3,2012-03-27 15:06:48,2012-03-27 15:06:48
45d046474786d747cd5ca0b51eb718de24b171e2...8e11b452992743908b2943ce1ba0d119cd92abc5,2,25,16,41,5,2012-03-27 15:56:58,2012-03-27 15:56:58
8e11b452992743908b2943ce1ba0d119cd92abc5...3a431673f4659f3ddf58c2727ac18cfd28ed34ab,1,1,1,2,1,2012-03-27 17:18:11,2012-03-27 17:18:11
3a431673f4659f3ddf58c2727ac18cfd28ed34ab...0b22e48edb239767103c7225bb9d3ba988972e8f,1,19,2,21,3,2012-03-27 18:35:03,2012-03-27 18:35:03
0b22e48edb239767103c7225bb9d3ba988972e8f...b7a9e128f51583abe204f31fcfdfd241b6e942f0,1,42,31,73,5,2012-03-28 04:11:25,2012-03-28 04:10:47
b7a9e128f51583abe204f31fcfdfd241b6e942f0...38aaee4cd3ad67aa963eedf01297319dd4b18546,1,1,1,2,1,2012-03-28 09:11:28,2012-03-28 09:11:28
38aaee4cd3ad67aa963eedf01297319dd4b18546...0bba3a3e7ad9a7350c6a09f5be02a9e24feef270,1,1,0,1,1,2012-03-28 15:25:04,2012-03-28 15:25:04
0bba3a3e7ad9a7350c6a09f5be02a9e24feef270...6a1cf3e57e79cb001147d63d35af0f3e69d9cd6d,1,1,0,1,1,2012-03-28 15:25:29,2012-03-28 15:25:29
6a1cf3e57e79cb001147d63d35af0f3e69d9cd6d...a3e51b6721b907b9d5038ce6caea1f52fa329f01,1,0,1,1,1,2012-03-28 15:42:08,2012-03-26 21:15:10
a3e51b6721b907b9d5038ce6caea1f52fa329f01...0d40ba0044a2348139400dc197397a431cabad4a,1,20,121,141,19,2012-03-28 15:42:59,2012-03-23 21:18:40
0d40ba0044a2348139400dc197397a431cabad4a...77e7786e7aae1d6446ad5f9357ced5973ed0a6b6,6,12,0,12,6,2012-03-28 20:37:08,2012-03-28 20:36:30
77e7786e7aae1d6446ad5f9357ced5973ed0a6b6...46f203192c459ebdd3e3278de4f92e6d21f44e0d,2,102,104,206,2,2012-03-28 20:43:13,2012-03-28 20:24:30
46f203192c459ebdd3e3278de4f92e6d21f44e0d...7655aa54ea4904d445644c3f9c0bfd7957355ee6,2,11,9,20,10,2012-03-29 00:23:09,2012-03-24 14:26:41
7655aa54ea4904d445644c3f9c0bfd7957355ee6...4de8795575e1e65f920aa155a1702a10b37abcb0,1,24,24,48,16,2012-03-29 00:23:09,2012-03-24 15:05:08
4de8795575e1e65f920aa155a1702a10b37abcb0...fba1ca674b59ddcc1ade1cf586ea9a6106e6baf2,7,34,21,55,11,2012-03-29 00:23:09,2012-03-24 14:42:10
fba1ca674b59ddcc1ade1cf586ea9a6106e6baf2...9d92f4014f89c948f49e7d018ac08cfdc74c79f8,6,106,161,267,18,2012-03-29 00:23:09,2012-03-26 14:33:16
9d92f4014f89c948f49e7d018ac08cfdc74c79f8...3693972015a4e61efa8543eb7d532b9bbf4d44de,1,12,1,13,1,2012-03-29 15:54:46,2012-03-07 18:26:57
3693972015a4e61efa8543eb7d532b9bbf4d44de...8784441ef2a234025a57213335fbd5c1fea64564,1,37,35,72,7,2012-03-29 16:03:15,2012-03-29 16:03:15
8784441ef2a234025a57213335fbd5c1fea64564...94f908ccb3423d0bbccda05a569fdee6fafb8fdc,8,312,25,337,35,2012-03-29 16:28:43,2012-03-06 01:23:06
94f908ccb3423d0bbccda05a569fdee6fafb8fdc...f2bba30d010351fd1f26eb491eda3e5169a9784c,1,1,1,2,1,2012-03-29 16:28:43,2012-03-06 20:10:33
f2bba30d010351fd1f26eb491eda3e5169a9784c...0163f1c4b0670d16179053dbefc18d3196c30471,1,6,6,12,4,2012-03-29 16:58:23,2012-03-29 16:58:23
0163f1c4b0670d16179053dbefc18d3196c30471...b2a3475432ec99adf3b25e43a76f79707a7ae963,1,1,2,3,1,2012-03-29 20:22:38,2012-03-29 20:20:50
b2a3475432ec99adf3b25e43a76f79707a7ae963...692d3301b4049dd5082064cfe5e36e6820187e2d,1,1,0,1,1,2012-03-29 20:24:30,2012-03-29 20:24:30
692d3301b4049dd5082064cfe5e36e6820187e2d...fceb1efdabfba8ee49246f96bd85f677b954b757,1,3,0,3,1,2012-03-29 20:26:20,2012-03-29 20:25:02
06e99af88d14406e8b85d660625e1f75938f9a09...73cbee72047d81e758b7a2e8c1397e4e8fefdd73,2,26,0,26,2,2012-04-13 14:46:45,2012-04-13 14:46:45
06e99af88d14406e8b85d660625e1f75938f9a09...c6bc7907749ac7dc849607addd144647cd4dca89,1,6,3,9,4,2012-04-13 02:25:36,2012-04-13 02:18:27
c6bc7907749ac7dc849607addd144647cd4dca89...78db2c718496fa2c74cd7a454d1387ef1376f227,1,1,1,2,1,2012-04-13 09:16:18,2012-04-13 09:16:18
78db2c718496fa2c74cd7a454d1387ef1376f227...769ca68ecdf0892d84877c01b19c7d8f1846e684,13,96,8,104,34,2012-04-13 13:06:40,2012-04-13 13:06:40
1c180c6a60126e8468e71d7b36b29ee0d7b7bdb9...06ed5bd1986e8bfc7f49401ddb464f8afd8b4e3b,1,1,1,2,1,2011-06-15 20:48:12,2011-06-15 20:48:12
06ed5bd1986e8bfc7f49401ddb464f8afd8b4e3b...5a5a18228173a9bb8b345f5695e8126e6d288312,3,258,1,259,6,2011-06-15 21:28:52,2011-06-15 21:28:52
5a5a18228173a9bb8b345f5695e8126e6d288312...037cf2ea57f27e11a28cf54f3b6bf98944230f93,3,17,6,23,10,2011-06-15 21:29:18,2011-06-15 21:29:18
037cf2ea57f27e11a28cf54f3b6bf98944230f93...9ce1c143b4ee27782123224fe6ddf1a4be13849e,1,5,3,8,4,2011-06-15 21:45:57,2011-06-15 21:45:57
9ce1c143b4ee27782123224fe6ddf1a4be13849e...07695200a1c0e2fbb1b4c2462eb263e639a2db31,1,1,1,2,1,2011-06-15 21:46:25,2011-06-15 21:46:25
07695200a1c0e2fbb1b4c2462eb263e639a2db31...d194a8bccae8b1860915dbbf21ec2dad1867ab87,1,0,6,6,1,2011-06-15 21:53:38,2011-06-15 21:53:38
d194a8bccae8b1860915dbbf21ec2dad1867ab87...85a009c44a64bc47b471fb95508a60659a1a01f5,1,3,2,5,1,2011-06-15 22:02:15,2011-06-15 22:02:15
85a009c44a64bc47b471fb95508a60659a1a01f5...55851c70e51cac1c489eb3d18c65a90e83465fe0,7,17,8,25,14,2011-06-16 01:24:50,2011-06-16 01:24:50
55851c70e51cac1c489eb3d18c65a90e83465fe0...8fe3bcbcfdf65d8e081f32e8767e33cd9624a5a4,2,13,10,23,10,2011-06-16 02:07:31,2011-06-16 02:07:31
1c180c6a60126e8468e71d7b36b29ee0d7b7bdb9...2fdf334c6b9526e6997a7812c09371921867ddf1,1,4,4,8,2,2011-06-15 20:27:20,2011-06-15 18:51:52
2fdf334c6b9526e6997a7812c09371921867ddf1...a65dd3a524feabcd4449412d803197dd9559e7db,1,9,3,12,3,2011-06-15 20:32:58,2011-06-15 20:32:58
a65dd3a524feabcd4449412d803197dd9559e7db...1d19f0498ccdb0478ae0b5bf350080c9e82f0b74,1,1,1,2,1,2011-06-15 20:37:23,2011-06-15 20:37:23
bfa8fd99d1bbbcdb26de87b6846b67427c14d626...6a83cf2cf92c118794e981e5be10985ddfcc5116,1,1,1,2,1,2011-07-05 16:10:13,2011-07-05 14:24:41
6a83cf2cf92c118794e981e5be10985ddfcc5116...2116b44647b7ebd13c0757ec03c56c028714ab97,1,9,0,9,1,2011-07-05 16:10:13,2011-07-05 14:52:13
2116b44647b7ebd13c0757ec03c56c028714ab97...8113df798dbca9766a7b781fb7282842272cfc87,1,9,3,12,5,2011-07-05 16:10:13,2011-07-05 16:09:57
8113df798dbca9766a7b781fb7282842272cfc87...087c23c6ffa2f2201bd0e0b573f1856a6f58f54b,2,2,2,4,2,2011-07-05 17:15:33,2011-07-05 17:14:37
087c23c6ffa2f2201bd0e0b573f1856a6f58f54b...e94b9d40d0834a865de45d89822767904831ba81,3,3,3,6,3,2011-07-05 17:42:19,2011-07-05 17:42:19
e94b9d40d0834a865de45d89822767904831ba81...4a790c6ae42c5cea4426e486927df68ba87d06ab,5,5,7,12,5,2011-07-05 20:12:11,2011-07-05 20:12:11
4a790c6ae42c5cea4426e486927df68ba87d06ab...c0130065860db820488cdfaa55b43805a017e7ed,1,17,1,18,1,2011-07-06 03:55:24,2011-07-06 03:55:24
c0130065860db820488cdfaa55b43805a017e7ed...9dc66207d394619c0eaa3d0a031601ec046232c1,1,68,56,124,3,2011-07-06 05:17:39,2011-07-06 05:17:39
9dc66207d394619c0eaa3d0a031601ec046232c1...f37b39fab89f4f0ef8d3f728ba85a2ca13979517,1,2,2,4,2,2011-07-06 14:21:06,2011-07-06 14:21:06
f37b39fab89f4f0ef8d3f728ba85a2ca13979517...6c1b310ccc9ca5aef4b85948367f44d388f57a92,2,7,3,10,2,2011-07-06 15:15:56,2011-07-06 15:15:56
08fb2d17a4ef3c48c96e3b1c674e5fab3f5a0634...dd627743dd98e10523f981706cd944d3a7159eb7,1,39,39,78,2,2011-06-28 20:22:25,2011-06-28 20:22:25
dd627743dd98e10523f981706cd944d3a7159eb7...2aa64fb929114812c453d52614fe318fc9ddcedb,3,32,27,59,13,2011-06-29 04:49:30,2011-06-29 04:49:30
2aa64fb929114812c453d52614fe318fc9ddcedb...f444ceb0ca0c54203596a069a0a1fc16ff1b4108,2,22,3,25,5,2011-06-29 05:08:32,2011-06-29 05:08:32
f444ceb0ca0c54203596a069a0a1fc16ff1b4108...119c26808eee20b320465ef59fcf360768b17adc,1,2,2,4,2,2011-06-29 12:26:18,2011-06-29 12:26:18
fceb1efdabfba8ee49246f96bd85f677b954b757...7d069f92855e6a401cfac0efbacad6dd083c2356,1,20,12,32,3,2012-03-30 03:11:14,2012-03-29 20:20:45
7d069f92855e6a401cfac0efbacad6dd083c2356...ea51197d72e1ccf7de8819ab0f173656a844077a,1,1,1,2,1,2012-03-30 03:23:40,2012-03-30 03:23:40
fceb1efdabfba8ee49246f96bd85f677b954b757...0aa7959ca70ddd9cef8b6308966cd2043ea906fc,1,3,0,3,1,2012-03-30 02:08:52,2012-03-30 02:07:54
5bac8e03e58828e60d6cc90bbdaa771036312d90...458ef44a0812dc5bbe893642ed3f50d92f274751,1,3,3,6,2,2012-04-13 15:17:52,2012-04-13 02:20:14
458ef44a0812dc5bbe893642ed3f50d92f274751...559ecef8fb93f33df77405f4ee67ed40c9cd42c9,1,1,1,2,1,2012-04-13 15:26:20,2012-04-13 15:26:07
559ecef8fb93f33df77405f4ee67ed40c9cd42c9...67abadc4f54cc31735504081fee230a64e19d24f,1,58,36,94,8,2012-04-13 16:27:59,2012-04-13 15:48:21
67abadc4f54cc31735504081fee230a64e19d24f...4bac4b0711b84e566a24cc29c57b08b769b7ca1f,1,4,0,4,1,2012-04-13 17:49:36,2012-04-13 17:48:58
6c1b310ccc9ca5aef4b85948367f44d388f57a92...2d1a803e679ae48e0ca33191803db3d511ce6337,1,4,1,5,3,2011-07-08 21:38:29,2011-07-08 21:38:29
6c1b310ccc9ca5aef4b85948367f44d388f57a92...7b24e34433882d414f587aa7f7c02840e2e56255,1,4,4,8,2,2011-07-06 19:05:57,2011-07-06 19:05:57
7b24e34433882d414f587aa7f7c02840e2e56255...a057d6d68e7a730bcf4a49dba51d9f617c234f32,2,6,3,9,3,2011-07-06 20:28:41,2011-07-06 20:27:46
a057d6d68e7a730bcf4a49dba51d9f617c234f32...787d7e44a1f7fd6ca4f441bc723d546db3610490,1,29,0,29,1,2011-07-06 21:24:11,2011-07-06 21:24:11
787d7e44a1f7fd6ca4f441bc723d546db3610490...1e32965aebfe1d007a9ca5d581ca887f7ce914ab,3,20,4,24,6,2011-07-06 21:50:09,2011-07-06 15:16:11
1e32965aebfe1d007a9ca5d581ca887f7ce914ab...b382625b8ed2e775011dd47a16ec8ff60989010b,1,0,84,84,1,2011-07-06 21:50:09,2011-07-06 15:27:43
b382625b8ed2e775011dd47a16ec8ff60989010b...836db45ecf1d6154b226f35823ef51e1a2db773b,2,1,11,12,3,2011-07-06 21:50:09,2011-07-06 15:31:29
836db45ecf1d6154b226f35823ef51e1a2db773b...36f0e51d71eb0dd7c5e5f598e0db383c48830382,1,27,20,47,6,2011-07-06 21:50:09,2011-07-06 15:34:07
36f0e51d71eb0dd7c5e5f598e0db383c48830382...f66685c0a7ef7a9a2a2e21e39578db557ba8fc3c,2,110,87,197,10,2011-07-06 21:50:09,2011-07-06 15:44:47
f66685c0a7ef7a9a2a2e21e39578db557ba8fc3c...0d698d52277b31e3b5cbcdb5b65126e7513e6b90,7,292,258,550,37,2011-07-06 21:50:09,2011-07-06 18:56:58
0d698d52277b31e3b5cbcdb5b65126e7513e6b90...c5ceaccdb305245fe4fc59fa3476dee8ca5cdbaa,2,7,9,16,3,2011-07-06 21:50:09,2011-07-06 21:04:58
c5ceaccdb305245fe4fc59fa3476dee8ca5cdbaa...607e946f62c45b06001dffd317bf6d110534a821,2,38,30,68,5,2011-07-06 21:50:09,2011-07-06 21:07:58
607e946f62c45b06001dffd317bf6d110534a821...6db9fbfe3bb0e36e3d44b79e7143014c24816566,1,12,1,13,4,2011-07-06 21:50:09,2011-07-06 21:09:40
6db9fbfe3bb0e36e3d44b79e7143014c24816566...7ba50fb1793c20a6375f115be2d8b2fbce626470,4,47,8,55,7,2011-07-06 21:50:09,2011-07-06 21:18:55
7ba50fb1793c20a6375f115be2d8b2fbce626470...b85443f54f076e374d7aa264c7a225844a23978f,1,1,1,2,1,2011-07-06 21:50:09,2011-07-06 21:49:54
b85443f54f076e374d7aa264c7a225844a23978f...880d735d4cc6cc39d2ba0b9765308c35aab9c3ad,1,16,5,21,11,2011-07-07 06:08:55,2011-07-07 06:08:55
880d735d4cc6cc39d2ba0b9765308c35aab9c3ad...b82b1a1a37b2867a4a6e7fc952cb42571e9bc2eb,1,3,1,4,4,2011-07-07 07:29:52,2011-07-07 07:29:52
b82b1a1a37b2867a4a6e7fc952cb42571e9bc2eb...10d2d10f7f3e04f1f6eae7467137bb127458b9ee,1,1,1,2,1,2011-07-07 12:16:53,2011-07-07 12:16:53
10d2d10f7f3e04f1f6eae7467137bb127458b9ee...d1f8260ff29c34cd254659a9dda4eee91efd6591,1,1,1,2,1,2011-07-07 12:27:31,2011-07-07 12:27:31
d1f8260ff29c34cd254659a9dda4eee91efd6591...20b60c29948b30b6ff9c989d67eaf0c61d653709,1,3,3,6,3,2011-07-07 12:29:15,2011-07-07 12:29:15
20b60c29948b30b6ff9c989d67eaf0c61d653709...c08f11d5a386a1315a4dcfc299f2e4c6ab3884e9,1,2,2,4,2,2011-07-07 14:42:40,2011-07-07 14:42:33
c08f11d5a386a1315a4dcfc299f2e4c6ab3884e9...385049aa0a0f19e2e9cd15b118bdc87401e8cfe8,3,14,3,17,9,2011-07-07 18:19:59,2011-07-07 18:19:59
385049aa0a0f19e2e9cd15b118bdc87401e8cfe8...e987d4c8ad2e2cd37d128d595111611bc8d88aad,1,3,0,3,1,2011-07-07 19:16:40,2011-07-07 19:16:40
e987d4c8ad2e2cd37d128d595111611bc8d88aad...5f70df96b5ef7877f8a0e4ef79a8dd69be7109bf,2,11,9,20,5,2011-07-07 19:48:06,2011-07-07 19:48:06
5f70df96b5ef7877f8a0e4ef79a8dd69be7109bf...30037ebe7cbaabd9c8932e395319b15133e5395c,1,21,19,40,5,2011-07-07 20:42:36,2011-07-07 20:40:28
30037ebe7cbaabd9c8932e395319b15133e5395c...5a09532d76d33a1d92f80cca06ec15cab3e83515,1,1,1,2,1,2011-07-07 21:09:32,2011-07-07 21:09:09
5a09532d76d33a1d92f80cca06ec15cab3e83515...556538105c0e39ee69a3595422cef7b473cce7a1,1,2,2,4,1,2011-07-07 23:38:06,2011-07-07 22:12:53
556538105c0e39ee69a3595422cef7b473cce7a1...d64e03262cc5ab3d02c085ea5885ee229c5bdfcf,1,1,1,2,1,2011-07-08 02:14:13,2011-07-08 02:14:13
d64e03262cc5ab3d02c085ea5885ee229c5bdfcf...5a0da82ab2c507737a0b1f5d98b8dbc65c4e7fcd,1,1,1,2,1,2011-07-08 15:57:18,2011-07-08 15:57:18
5a0da82ab2c507737a0b1f5d98b8dbc65c4e7fcd...4934f03169abc8aec9048df495defaa5cb3fcb5a,1,4,1,5,1,2011-07-08 17:22:29,2011-07-08 17:22:29
4934f03169abc8aec9048df495defaa5cb3fcb5a...c5f45d1ebd7943386d957ba1909b3f8cb6e1e5f9,1,3,0,3,1,2011-07-08 17:22:45,2011-07-08 17:22:45
c5f45d1ebd7943386d957ba1909b3f8cb6e1e5f9...f22068616311810fe01d87a6746ab248c5f3fa95,3,53,28,81,7,2011-07-08 17:23:25,2011-07-08 17:23:25
119c26808eee20b320465ef59fcf360768b17adc...9beab845f35cc8a5fdbc94b50d6e0c92221d29e9,1,35,3,38,8,2011-07-08 16:05:46,2011-07-01 18:00:50
9beab845f35cc8a5fdbc94b50d6e0c92221d29e9...265557cfe00fe25af0109a717a6f0374f260b732,1,63,0,63,1,2011-07-08 16:05:49,2011-07-07 21:54:20
265557cfe00fe25af0109a717a6f0374f260b732...a2716f3b5f4f1525829241db9383fdc1b8ca2c96,1,1,3,4,1,2011-07-26 20:22:39,2011-07-26 20:22:39
119c26808eee20b320465ef59fcf360768b17adc...a5abf45dfe4240fc76fbb69c38d4c3517852adb6,2,13,5,18,5,2011-06-29 14:49:30,2011-06-29 14:49:30
a5abf45dfe4240fc76fbb69c38d4c3517852adb6...8b8bc2506cc57f47042dec20452cd9c07cb8e9bd,1,2,9,11,2,2011-06-29 14:56:00,2011-06-29 14:56:00
8b8bc2506cc57f47042dec20452cd9c07cb8e9bd...98c7e12a1a5134b9e68ca7fd9a5e144bcf6f2d4c,1,6,0,6,2,2011-06-29 19:06:12,2011-06-29 19:06:12
98c7e12a1a5134b9e68ca7fd9a5e144bcf6f2d4c...7868057763ce0ba0d5b2030207588d3983d39fcf,1,14,14,28,4,2011-06-29 22:45:35,2011-06-29 22:43:54
7868057763ce0ba0d5b2030207588d3983d39fcf...f822a3e0291744378214ba095b5d1ca51353e584,1,7,5,12,2,2011-06-30 16:25:50,2011-06-28 19:44:39
f822a3e0291744378214ba095b5d1ca51353e584...a55f19fc477ba83f6fd6660c91d132a4a8446336,1,3,2,5,2,2011-06-30 22:27:58,2011-06-30 22:27:58
4ef689ffcd6ffc079207a28bb700d2253d2d20a6...294540f6095c6805ab9c9398f0830859b9a6da2d,3,11,6,17,8,2012-03-30 14:28:03,2012-03-30 14:26:22
294540f6095c6805ab9c9398f0830859b9a6da2d...5455f1d95c232c92647e3e0cfda4f52b28a08ef7,1,18,2,20,5,2012-03-30 17:20:40,2012-03-30 17:20:40
5455f1d95c232c92647e3e0cfda4f52b28a08ef7...0546c22c22b237e89eefb7ef7ed33acf311ec4be,2,2,1,3,2,2012-03-30 18:05:09,2012-03-30 18:05:09
0546c22c22b237e89eefb7ef7ed33acf311ec4be...6c2d4e5362e5e608ee48cfc254ef5164578f050d,1,1,1,2,1,2012-03-30 19:41:43,2012-03-30 19:41:43
6c2d4e5362e5e608ee48cfc254ef5164578f050d...b816896ebf5892c64c7c64b46721bc8167f59b96,1,2,2,4,2,2012-03-30 20:12:27,2012-03-30 13:19:24
b816896ebf5892c64c7c64b46721bc8167f59b96...8f5c537d6e51eeee5aa8e5e6bafe50cbb1ec7560,1,0,2,2,1,2012-03-30 20:12:27,2012-03-30 16:14:46
8f5c537d6e51eeee5aa8e5e6bafe50cbb1ec7560...aa161911ee890e16ba42a6d9ef4134019ccc15a6,1,1,0,1,1,2012-03-30 20:12:27,2012-03-30 20:06:38
aa161911ee890e16ba42a6d9ef4134019ccc15a6...1097dd796e624103023a69bc4347dabc8198e91e,10,98,69,167,48,2012-03-30 20:12:27,2012-03-30 20:12:01
1097dd796e624103023a69bc4347dabc8198e91e...41100feec23f2030db1fd3fc5dc99d4ef10096ad,1,1,1,2,1,2012-03-30 20:30:44,2012-03-30 20:30:44
41100feec23f2030db1fd3fc5dc99d4ef10096ad...bed1efe7769b9c0eb3be4cbe9e623998b137593e,8,83,63,146,42,2012-03-30 22:47:25,2012-03-30 22:47:25
bed1efe7769b9c0eb3be4cbe9e623998b137593e...b16f57d81a31a8a88167de7eb9fa81414864c5b3,4,12,24,36,9,2012-03-30 23:19:01,2012-03-30 23:19:01
b16f57d81a31a8a88167de7eb9fa81414864c5b3...08c25de4e5a9889735a8aea6182c784af3342314,1,1,1,2,1,2012-03-31 01:46:26,2012-03-31 01:46:26
08c25de4e5a9889735a8aea6182c784af3342314...d5cb09f6d92ccbcfab685b7d7c102a5e45a74eda,1,2,2,4,2,2012-03-31 01:55:42,2012-03-31 01:20:43
d5cb09f6d92ccbcfab685b7d7c102a5e45a74eda...9b739251b5805d5c87090d33c6cc8491776baca1,2,4,2,6,3,2012-03-31 03:03:45,2012-03-31 03:03:24
9b739251b5805d5c87090d33c6cc8491776baca1...0fbbd2c08ae2141bbf30b691ac981280dce3dd8b,1,1,1,2,1,2012-04-01 04:00:48,2012-04-01 04:00:48
0fbbd2c08ae2141bbf30b691ac981280dce3dd8b...fa8e77b819ed29358a11da843463d6754831c9ad,1,1,1,2,2,2012-04-01 04:01:18,2012-04-01 04:01:18
fa8e77b819ed29358a11da843463d6754831c9ad...b2697c5ff541080e3488b696f659b2b7cfaf81e7,3,37,1,38,4,2012-04-01 05:02:54,2012-04-01 05:02:54
b2697c5ff541080e3488b696f659b2b7cfaf81e7...2d134f71c43446e9d5b0775045d19f334a3dc845,1,4,4,8,2,2012-04-01 05:26:18,2012-04-01 05:26:18
2d134f71c43446e9d5b0775045d19f334a3dc845...66d49d6309e201309e402acb2f3ce0fedb9e3822,1,1,0,1,1,2012-04-01 05:37:57,2012-04-01 05:37:57
66d49d6309e201309e402acb2f3ce0fedb9e3822...787414c9788ba4e4d462cd5a10253370ba1f5d2c,1,4,0,4,2,2012-04-01 06:04:07,2012-04-01 06:04:07
787414c9788ba4e4d462cd5a10253370ba1f5d2c...297f257fc94f18412d9061875f4414f3e559dd99,1,5,2,7,2,2012-04-01 06:48:42,2012-04-01 06:48:42
297f257fc94f18412d9061875f4414f3e559dd99...8b7cb5697c6c31954016fb51ec854c7071a0191b,1,1,1,2,1,2012-04-01 06:53:18,2012-04-01 06:53:18
8b7cb5697c6c31954016fb51ec854c7071a0191b...2a5a7f90b17062264c77d712178d72afd1350f3b,1,2,1,3,1,2012-04-01 13:53:59,2012-04-01 13:53:59
2a5a7f90b17062264c77d712178d72afd1350f3b...93a0a782d9d593f6f20c542d4b1897c4a214bc23,3,3,8,11,3,2012-04-02 03:47:24,2012-04-02 03:46:44
93a0a782d9d593f6f20c542d4b1897c4a214bc23...8cec238ce8f6bd784e278d50998fb9e275865835,1,1,2,3,1,2012-04-02 03:47:34,2012-04-02 02:12:05
8cec238ce8f6bd784e278d50998fb9e275865835...ad977248699234e4a16f247a775c3af2865eb4c9,1,4,4,8,3,2012-04-02 03:47:34,2012-04-02 03:46:25
ad977248699234e4a16f247a775c3af2865eb4c9...c6dc2074a1b1fa5755070964f0e77c3cd48d00b5,1,5,2,7,3,2012-04-02 18:10:21,2012-04-02 18:10:21
c6dc2074a1b1fa5755070964f0e77c3cd48d00b5...0d44f42712197c01c9e494c425e7b24a82f1763f,1,2,0,2,2,2012-04-02 18:10:48,2012-04-02 18:10:48
0d44f42712197c01c9e494c425e7b24a82f1763f...6e4aa245bbf233b6acc7b1ebf77ad59cc5d200d8,1,17,10,27,5,2012-04-02 18:16:10,2012-04-02 18:16:10
4bac4b0711b84e566a24cc29c57b08b769b7ca1f...de4a9b97e601e12101a6077584099a8071f1b102,2,15,15,30,9,2012-04-13 18:31:20,2012-04-13 18:31:20
4bac4b0711b84e566a24cc29c57b08b769b7ca1f...3bc6dc6e4519f3a61808e2256c32498a1559a353,8,12,5,17,11,2012-04-13 18:19:10,2012-04-13 18:17:17
61643ad84bba4ebec74244728299a5bd0bcc516a...9b51ac0d19624fddd9820808a95fda07c0eff0af,1,32,32,64,1,2011-07-09 15:03:42,2011-07-09 15:03:42
61643ad84bba4ebec74244728299a5bd0bcc516a...39d23681601e6fafd5307f9714df6c4b423d0b60,1,1,1,2,1,2011-07-08 22:15:36,2011-06-23 15:38:30
39d23681601e6fafd5307f9714df6c4b423d0b60...5a1d526d7ac5eb02961495764f67b676d9ac4c5b,1,10,2,12,1,2011-07-08 22:15:36,2011-07-07 21:26:17
5a1d526d7ac5eb02961495764f67b676d9ac4c5b...fb88b80ce4353b7f25914f07210e9f328ae7f922,1,4,4,8,4,2011-07-08 22:15:36,2011-07-08 21:33:21
a55f19fc477ba83f6fd6660c91d132a4a8446336...b454e1563fc1b3518830bd8a1438655f8912a21a,1,3,3,6,1,2011-07-01 15:25:48,2011-07-01 15:25:48
b454e1563fc1b3518830bd8a1438655f8912a21a...5c83a738e0b64d01fbc303fd88864427a1ac3a88,1,15,0,15,1,2011-07-01 16:39:50,2011-07-01 16:39:50
5c83a738e0b64d01fbc303fd88864427a1ac3a88...57743f02b712611d4c9c62c711020f0839e892a1,2,2,0,2,2,2011-07-01 17:29:04,2011-07-01 17:29:04
57743f02b712611d4c9c62c711020f0839e892a1...3f169b963ef76ccd758a9fd63555bb907d23da51,1,3,1,4,1,2011-07-01 17:29:37,2011-07-01 17:29:37
3f169b963ef76ccd758a9fd63555bb907d23da51...a7ca16a65141da6cef00313b984c694fc65e8fc3,4,33,16,49,11,2011-07-01 17:30:13,2011-07-01 17:30:13
a55f19fc477ba83f6fd6660c91d132a4a8446336...3a5096deb4c733a35d910d57ca3d523037d1517a,2,10,7,17,7,2011-07-01 14:07:38,2011-07-01 14:07:38
3a5096deb4c733a35d910d57ca3d523037d1517a...224dc66eb9e0456ea5eb37ca45588e4b96204eac,3,12,6,18,6,2011-07-01 14:07:52,2011-07-01 14:07:52
224dc66eb9e0456ea5eb37ca45588e4b96204eac...ae569f11965345f9d09905c0670fbd25890feab0,1,93,93,186,22,2011-07-01 15:42:23,2011-07-01 15:42:23
ae569f11965345f9d09905c0670fbd25890feab0...5ae35bc47b3b116b345e3fb5c5f4069ede084277,1,9,5,14,4,2011-07-01 16:02:09,2011-07-01 16:02:09
5ae35bc47b3b116b345e3fb5c5f4069ede084277...cc85a824878fb2fd7f04f7051f890d349c8a07e3,1,27,0,27,1,2011-07-01 16:02:20,2011-07-01 16:02:20
6e4aa245bbf233b6acc7b1ebf77ad59cc5d200d8...f261de46e7b18d0853e29072c83cb7f65c18abdb,1,1,1,2,1,2012-04-03 16:54:11,2012-04-03 16:54:11
6e4aa245bbf233b6acc7b1ebf77ad59cc5d200d8...8b1c9bd361bd002980266c5269e5eab4ba62a7f5,1,4,3,7,1,2012-04-02 18:48:07,2012-04-02 18:48:07
8b1c9bd361bd002980266c5269e5eab4ba62a7f5...45f30389a9128fe2216371cabbe8426b634d68e9,115,234,181,415,236,2012-04-02 18:59:48,2012-04-02 18:55:19
45f30389a9128fe2216371cabbe8426b634d68e9...4867dbe5e0b25affb8c84566fac2e048d024c7c0,1,1,1,2,1,2012-04-02 19:06:44,2012-04-02 19:06:44
4867dbe5e0b25affb8c84566fac2e048d024c7c0...ea33c3ac12968086d9313c22d4e79c2dfaab27ff,1,1,1,2,1,2012-04-02 19:30:04,2012-04-02 19:30:04
ea33c3ac12968086d9313c22d4e79c2dfaab27ff...9f65f192302a4d35bae633cc5e46b400fd4d714e,1,1,1,2,1,2012-04-02 19:46:19,2012-04-02 19:45:48
9f65f192302a4d35bae633cc5e46b400fd4d714e...ccb12ad3bf91f2bea6e046f021e08e90690c8f33,3,31,18,49,14,2012-04-02 23:37:46,2012-04-02 23:37:20
ccb12ad3bf91f2bea6e046f021e08e90690c8f33...6c2bc1e8d3babd21ab49ec805b17a9c2e4c70fed,1,1,0,1,1,2012-04-02 23:40:41,2012-04-02 23:40:41
6c2bc1e8d3babd21ab49ec805b17a9c2e4c70fed...d1840e9605d3ac7023d87d72c09a6b2c4e32ec66,7,131,110,241,71,2012-04-02 23:49:32,2012-03-27 20:23:43
d1840e9605d3ac7023d87d72c09a6b2c4e32ec66...0fa0a688835886d3009497bf4459ee1f369b4a91,1,2,1,3,1,2012-04-03 00:23:46,2012-04-03 00:23:46
0fa0a688835886d3009497bf4459ee1f369b4a91...7265e4e401c6db401c28d3f8efb609b1a0c49d0f,2,10,11,21,6,2012-04-03 00:50:35,2012-04-03 00:50:35
7265e4e401c6db401c28d3f8efb609b1a0c49d0f...19d5b5bde3ec5950b78953290d93d7445c9f1016,2,49,21,70,4,2012-04-03 03:42:04,2012-04-02 21:31:56
19d5b5bde3ec5950b78953290d93d7445c9f1016...b099fd4ba8c01742ae367979531e6774f0ff19c7,2,23,6,29,7,2012-04-03 03:43:47,2012-04-02 14:47:30
b099fd4ba8c01742ae367979531e6774f0ff19c7...74f5cb1fa33b56e7179a68217febc3c000a6b834,1,5,1,6,1,2012-04-03 03:45:50,2012-04-03 03:45:39
74f5cb1fa33b56e7179a68217febc3c000a6b834...5d468c6ee1caff7f65644c87b061eacdfcfe4826,9,51,38,89,31,2012-04-03 14:13:19,2012-04-03 14:11:47
5d468c6ee1caff7f65644c87b061eacdfcfe4826...51e9cc2895caf46b496a039f4f7cf72fac9e510a,2,8,25,33,7,2012-04-03 14:59:12,2012-04-03 14:59:12
51e9cc2895caf46b496a039f4f7cf72fac9e510a...8dd9661ca70d362a9bb5fc3a57581ac458752af1,1,9,0,9,2,2012-04-03 15:17:18,2012-04-03 15:17:18
8dd9661ca70d362a9bb5fc3a57581ac458752af1...0723ecbbef37eb91668a6746c2d34262529b0c17,1,1,1,2,1,2012-04-03 16:07:44,2012-04-03 16:07:44
a4c934d2f8a026f51866bda365d2ffbbfd70795b...6b2fdc37fffd959cb948fe9fc7e3f0032e841778,1,23,14,37,2,2012-04-13 20:45:36,2012-04-13 20:45:23
6b2fdc37fffd959cb948fe9fc7e3f0032e841778...cc1d653e00cad3f4ffab47af3f1b3489c6cdd55f,1,1,1,2,1,2012-04-13 20:46:08,2012-04-13 18:18:27
cc1d653e00cad3f4ffab47af3f1b3489c6cdd55f...b4052ecccf00f87cad5e72b5bf56829fce0c7410,4,70,7,77,11,2012-04-13 20:56:47,2012-04-11 23:06:30
b4052ecccf00f87cad5e72b5bf56829fce0c7410...8473a9247a7f8286d3e1b73b0b28432c298671ef,1,1,1,2,1,2012-04-13 21:07:43,2012-04-13 21:06:05
8473a9247a7f8286d3e1b73b0b28432c298671ef...66b15e93e2da8344c01cfc8ecf45906212c71107,1,1,1,2,1,2012-04-14 18:30:10,2012-04-14 18:30:10
66b15e93e2da8344c01cfc8ecf45906212c71107...2ab1c27d3e0c92137eb3aec0b60d2f43582c0591,1,6,1,7,1,2012-04-14 18:45:20,2012-04-14 18:45:20
2ab1c27d3e0c92137eb3aec0b60d2f43582c0591...7acafe5df00a1e72890d474b8d145136800fdd68,1,1,1,2,1,2012-04-14 19:11:01,2012-04-14 19:11:01
7acafe5df00a1e72890d474b8d145136800fdd68...3e9bb8cd9c1aecd3f4748bdc3c73a89c7ec53f15,1,1,1,2,1,2012-04-15 09:41:07,2012-04-15 09:41:07
3e9bb8cd9c1aecd3f4748bdc3c73a89c7ec53f15...37558f81d00978216462888e4ba35c89fb588531,1,2,1,3,2,2012-04-16 00:41:54,2012-04-16 00:41:54
37558f81d00978216462888e4ba35c89fb588531...fc923dbad70755f8c98a8774299bd5061454a69d,9,1244,473,1717,285,2012-04-16 11:17:56,2012-03-22 21:11:58
fc923dbad70755f8c98a8774299bd5061454a69d...03b7caca51f1772f009a031eaeb197b54e3cf409,1,7,0,7,2,2012-04-16 13:46:27,2012-04-16 13:46:27
8e93668c4169c1e25a40fe255a370e46a6cc9cb2...45d0c6e38a787099ba29165b1e8704e1a1f3c304,1,22,34,56,14,2011-07-09 15:10:34,2011-07-09 15:10:34
45d0c6e38a787099ba29165b1e8704e1a1f3c304...40d1b5d2d079bdefa6656bd2282052525f768f3a,1,4,7,11,4,2011-07-09 15:22:50,2011-07-09 15:22:50
40d1b5d2d079bdefa6656bd2282052525f768f3a...0f3baac66794e65eeb80263c3c3ee1454cb8c732,1,29,21,50,3,2011-07-09 15:38:30,2011-07-09 15:38:30
0f3baac66794e65eeb80263c3c3ee1454cb8c732...41224c8fbf8be4241c81be43ddea07f3fed48399,1,18,2,20,3,2011-07-09 18:11:42,2011-07-09 18:11:42
41224c8fbf8be4241c81be43ddea07f3fed48399...18a3dfff06174e8ee1a5c762997b539cfb0b9da0,1,56,2,58,3,2011-07-09 18:15:39,2011-07-09 18:15:39
18a3dfff06174e8ee1a5c762997b539cfb0b9da0...757b692b0e90fba7fd8ae3ed4ea5e054ccc902e4,1,14,18,32,11,2011-07-10 01:57:58,2011-07-10 01:57:58
757b692b0e90fba7fd8ae3ed4ea5e054ccc902e4...3731e71d77f63a78abf713f52a77bd019e59c3d2,1,8,1,9,2,2011-07-10 04:25:43,2011-07-10 04:25:43
3731e71d77f63a78abf713f52a77bd019e59c3d2...550af81d774215724b5e32a9927399b0376e8558,3,49,20,69,17,2011-07-11 00:12:47,2011-07-11 00:10:42
550af81d774215724b5e32a9927399b0376e8558...d507628f09d04c8091c57c7ad06aedbc30fb4b59,4,17,3,20,5,2011-07-11 00:37:12,2011-07-11 00:37:12
d507628f09d04c8091c57c7ad06aedbc30fb4b59...fc329825652a2d3fdbd3cdb64ec9e129f4a7974a,4,1,7,8,6,2011-07-11 02:42:54,2011-07-11 02:42:30
fc329825652a2d3fdbd3cdb64ec9e129f4a7974a...1cf548fce008223adc4126c3b52195203d425ca8,1,5,2,7,2,2011-07-11 12:02:44,2011-07-11 12:02:44
1cf548fce008223adc4126c3b52195203d425ca8...ba44bb0a7c6b7ed0f242ff15a2c5dd82c4b07b7c,1,58,1,59,3,2011-07-11 12:07:59,2011-07-11 12:07:59
ba44bb0a7c6b7ed0f242ff15a2c5dd82c4b07b7c...55379b1f5044ba1d90fd115aa3997129b65d158d,1,20,4,24,9,2011-07-11 12:08:20,2011-07-11 12:08:20
55379b1f5044ba1d90fd115aa3997129b65d158d...3021bbf4e23cef402f4b10c936994fd208af32ab,3,10,4,14,7,2011-07-11 12:11:38,2011-07-11 12:11:38
3021bbf4e23cef402f4b10c936994fd208af32ab...984dc80a022f3e8f6a6187dbd75cd910fcb2b83e,6,93,22,115,14,2011-07-11 13:31:33,2011-07-11 13:31:33
984dc80a022f3e8f6a6187dbd75cd910fcb2b83e...9547bb58301339b420de71fddb73487a76643327,1,24,24,48,1,2011-07-11 14:10:50,2011-07-11 14:10:50
9547bb58301339b420de71fddb73487a76643327...2750ffbb3ca36ff2b737017b7738a03f1c15b28c,1,2,2,4,2,2011-07-11 14:15:20,2011-07-11 14:15:20
2750ffbb3ca36ff2b737017b7738a03f1c15b28c...2982ab07d0dc70ff73f21f13d0c44e1456f57fa4,1,3,1,4,3,2011-07-11 14:27:15,2011-07-11 14:27:15
3411f98c3895eb0f74c4f869d190115b3f213a34...48c0fe0085959f890b6d9b2f462093cb5808a3ad,1,1,1,2,1,2011-09-26 17:08:39,2011-09-26 17:08:39
48c0fe0085959f890b6d9b2f462093cb5808a3ad...b866ce0f17b07d2fb65cef700c3525cb7177e68d,1,1,1,2,1,2011-09-26 20:54:36,2011-09-26 20:54:36
b866ce0f17b07d2fb65cef700c3525cb7177e68d...7fcb73791cbdc8b0bb87fa1b28461b2ac168ef2d,1,11,2,13,2,2011-09-26 22:48:46,2011-09-26 22:48:11
fe93ef7589e3741d9ffc602f324d5f9db6a21879...fa9f1a7b85014d6677c883d22321b4539b6e50f4,1,1,1,2,1,2011-07-01 17:32:07,2011-07-01 17:32:07
cce1be94a8e661a7a92af2e179136495d795b6d4...95725b980bb33395216b55f61fbcdc2a893d8f5c,1,1,3,4,2,2012-04-03 18:39:22,2012-04-03 18:39:22
95725b980bb33395216b55f61fbcdc2a893d8f5c...1dacd20021e5797915da62e97867aa62ac3ae34e,2,109,0,109,3,2012-04-03 18:53:14,2012-02-27 23:28:09
1dacd20021e5797915da62e97867aa62ac3ae34e...3c046f865fb248785c55c7128dfaf3c731f0aa2f,1,11,7,18,4,2012-04-03 18:53:14,2012-04-03 16:20:02
3c046f865fb248785c55c7128dfaf3c731f0aa2f...a51d192e46a7f2851b286736d80b9537cab34423,1,109,123,232,20,2012-04-03 19:26:42,2012-04-03 14:31:33
a51d192e46a7f2851b286736d80b9537cab34423...62de272536969bebab1072eb85b5523ac1517f12,2,0,12,12,5,2012-04-03 19:41:27,2012-04-03 19:41:27
62de272536969bebab1072eb85b5523ac1517f12...d1a452ef2c502d7537cbf40047f30740d9111183,12,570,424,994,37,2012-04-03 19:54:11,2012-04-02 20:10:58
d1a452ef2c502d7537cbf40047f30740d9111183...aa9915a6d68864b15094494ce86edc05b53a0690,1,4,1,5,3,2012-04-03 20:59:48,2012-04-03 19:48:38
aa9915a6d68864b15094494ce86edc05b53a0690...ec1dfbd4d7baa79d1f74d6325383461d371142fe,2,184,64,248,47,2012-04-03 21:04:46,2012-03-21 20:01:05
ec1dfbd4d7baa79d1f74d6325383461d371142fe...2d4b9583c9de3c5ac2a39e59c2dcaafaf582c194,6,23,13,36,13,2012-04-03 21:32:54,2012-04-03 19:59:04
2d4b9583c9de3c5ac2a39e59c2dcaafaf582c194...27ec7867ed05d2f55218f74d191c15c3f14385d8,1,1,1,2,1,2012-04-03 21:55:47,2012-04-03 21:42:49
27ec7867ed05d2f55218f74d191c15c3f14385d8...bf3852692d8dfa56ad013b4f11ced2f7f5a215af,2,25,23,48,6,2012-04-03 22:03:19,2012-04-03 22:02:22
bf3852692d8dfa56ad013b4f11ced2f7f5a215af...f3059e380d6057d9b2299495b19e3e5f28fe8234,1,1,1,2,1,2012-04-03 22:13:20,2012-04-03 22:13:20
f3059e380d6057d9b2299495b19e3e5f28fe8234...6980e9f942291028b6327a1565be26ebb072086f,1,4,8,12,2,2012-04-04 01:02:02,2012-04-04 01:02:02
6980e9f942291028b6327a1565be26ebb072086f...2b8a0d7380802acf54a4f5b7190d3dd6784e8107,1,2,1,3,2,2012-04-04 14:09:51,2012-04-04 14:09:51
2b8a0d7380802acf54a4f5b7190d3dd6784e8107...159f33561fbb1076098338fa746f4d1cf63f59cc,1,1,1,2,1,2012-04-04 14:49:47,2012-04-04 14:49:01
159f33561fbb1076098338fa746f4d1cf63f59cc...2db6342ad7e7b486664bc7b09d1774674ec7941b,1,1,1,2,1,2012-04-04 14:51:13,2012-04-04 14:40:34
2db6342ad7e7b486664bc7b09d1774674ec7941b...00e41e8e6e2e7cbf0ac32edae3668d99eaa340c0,1,7,7,14,3,2012-04-04 17:19:48,2012-04-03 17:51:28
00e41e8e6e2e7cbf0ac32edae3668d99eaa340c0...090476bf93e79687111d5310a658030b18b8dac0,1,10,10,20,6,2012-04-04 17:19:48,2012-04-03 17:54:52
090476bf93e79687111d5310a658030b18b8dac0...0d5b0e67d37e896df3e932da1dfd0b38d591ff87,1,29,37,66,7,2012-04-04 17:19:48,2012-04-04 16:35:58
0d5b0e67d37e896df3e932da1dfd0b38d591ff87...3ae516c69c16be09f5c7dd1c8c1d1069efc0cc00,1,98,0,98,4,2012-04-04 17:19:48,2012-04-04 16:37:22
3ae516c69c16be09f5c7dd1c8c1d1069efc0cc00...a1bda3f6077fc8496a421e235a6a95293548835a,1,1,1,2,1,2012-04-04 17:56:52,2012-04-04 17:56:52
a1bda3f6077fc8496a421e235a6a95293548835a...50304f5ad87115a2a5de1cb391fa540d57cbdff2,1,37,29,66,7,2012-04-04 18:17:12,2012-04-04 18:17:12
50304f5ad87115a2a5de1cb391fa540d57cbdff2...8bbd9f1eff6691968cad5a45469da0293a9f43e8,1,10,10,20,5,2012-04-04 19:36:39,2012-04-04 19:36:39
8bbd9f1eff6691968cad5a45469da0293a9f43e8...78d16e4666691fcd9dcc6c1cac0b5f8ebd2ea533,2,38,57,95,9,2012-04-04 19:37:26,2012-04-03 17:23:57
78d16e4666691fcd9dcc6c1cac0b5f8ebd2ea533...c1cb3fec7d5596235ff0fa41e205b8ad11ae3851,1,18,11,29,12,2012-04-04 20:36:43,2012-04-04 19:36:43
c1cb3fec7d5596235ff0fa41e205b8ad11ae3851...4f4ad3e12dd8198e11ead328fba0bc3ce2aa0491,1,2,2,4,4,2012-04-05 01:00:16,2012-04-05 00:59:55
4f4ad3e12dd8198e11ead328fba0bc3ce2aa0491...6fa89a50aba53d6b749d7e9f07efd5bc4ef4e7bc,1,20,27,47,7,2012-04-05 13:36:14,2012-04-05 13:36:14
6fa89a50aba53d6b749d7e9f07efd5bc4ef4e7bc...1f1fc2fd60db412a4911397745ac838d49b1a064,3,19,0,19,4,2012-04-05 14:04:45,2012-04-05 14:04:45
1f1fc2fd60db412a4911397745ac838d49b1a064...3fe4d97df6059ec30c2087f4ce722168602535cc,1,8,7,15,6,2012-04-05 15:09:07,2012-04-05 15:09:07
3fe4d97df6059ec30c2087f4ce722168602535cc...f911ed2058ad99047ac0d8922ee63c188e6189fe,2,2,0,2,2,2012-04-05 15:16:20,2012-04-05 15:16:20
03b7caca51f1772f009a031eaeb197b54e3cf409...c251c719722f1af49c02ce083b2c69b7eccc123a,3,62,52,114,6,2012-04-19 15:19:46,2012-04-19 15:19:46
03b7caca51f1772f009a031eaeb197b54e3cf409...aa7709fb3c8cb6f431be1eb904749521a4534ef6,1,0,7,7,2,2012-04-16 15:20:00,2012-04-16 15:20:00
aa7709fb3c8cb6f431be1eb904749521a4534ef6...722f85676e15e91d13bfe6e992e4b9b24527571a,1,17,8,25,3,2012-04-16 15:43:45,2012-04-16 15:43:45
722f85676e15e91d13bfe6e992e4b9b24527571a...b5348b5dc61afe0377ab06003b51029810f40b55,1,1,1,2,1,2012-04-16 18:24:46,2012-04-16 18:24:46
b5348b5dc61afe0377ab06003b51029810f40b55...0f24625d844cbd5ff939e177a7c29a528e4995bc,1,22,19,41,18,2012-04-16 18:26:02,2012-04-16 18:26:02
0f24625d844cbd5ff939e177a7c29a528e4995bc...458f5d6e356bb2ff18fbfb58d3fa069d8edaf6c7,1,2,2,4,1,2012-04-16 21:12:16,2012-04-16 21:12:16
458f5d6e356bb2ff18fbfb58d3fa069d8edaf6c7...4b8f8cd98ef47c575e3234d0b496a21bf71f1970,2,759,356,1115,124,2012-04-17 14:40:36,2012-04-11 20:05:13
4b8f8cd98ef47c575e3234d0b496a21bf71f1970...9f100d97b48868d28c0d3017cb9b461ac6c62d54,1,12,7,19,7,2012-04-17 14:40:36,2012-04-12 20:03:08
9f100d97b48868d28c0d3017cb9b461ac6c62d54...8648fdcbb644ca693177cff05287fe27124d38cb,1,2,2,4,2,2012-04-17 15:03:45,2012-04-17 15:03:45
8648fdcbb644ca693177cff05287fe27124d38cb...57d9a672dc4dda75e4bf36752678609f8ebce7da,1,3,0,3,1,2012-04-17 16:08:37,2012-04-04 19:15:24
57d9a672dc4dda75e4bf36752678609f8ebce7da...2526f0d8144d211187fb1571e33f24f32aa64d2e,2,120,2,122,3,2012-04-17 16:08:37,2012-04-17 16:06:53
2982ab07d0dc70ff73f21f13d0c44e1456f57fa4...830a73f1acc7c8025792839e1857b49609ec4d70,1,2,2,4,2,2011-07-11 18:51:44,2011-07-11 18:51:44
830a73f1acc7c8025792839e1857b49609ec4d70...eecddcd7de059b17437858d83f2b7f3174abb477,2,80,41,121,26,2011-07-11 19:50:27,2011-07-11 19:50:27
2982ab07d0dc70ff73f21f13d0c44e1456f57fa4...330cbb684145225861e8d2add0c6962ff16f305d,1,4,4,8,2,2011-07-11 17:09:08,2011-07-11 17:09:08
330cbb684145225861e8d2add0c6962ff16f305d...48342721bb42f23197d447acccd2775d52a219f3,2,4,6,10,4,2011-07-11 18:42:55,2011-07-11 18:42:14
7fcb73791cbdc8b0bb87fa1b28461b2ac168ef2d...2fd1d8d5a8e2f2ce0e556db689d30806c6f34d23,1,2,1,3,2,2011-09-28 20:03:30,2011-09-28 20:03:30
7fcb73791cbdc8b0bb87fa1b28461b2ac168ef2d...e570d7e9dd92b45537c9b59071320f128cd6d4ae,2,28,1,29,2,2011-09-27 21:11:52,2011-09-27 21:11:52
e570d7e9dd92b45537c9b59071320f128cd6d4ae...5468b4e829d981daeccbcf1fc9603ddb130854e0,1,13,3,16,4,2011-09-27 22:10:17,2011-09-27 22:10:17
5468b4e829d981daeccbcf1fc9603ddb130854e0...f1aaad3d7be209b7ff3604cfc9cfda58a432f817,1,4,1,5,2,2011-09-27 23:18:00,2011-09-27 23:18:00
f1aaad3d7be209b7ff3604cfc9cfda58a432f817...19058fad75e1136e32b86936e496fb000bec1089,1,11,26,37,4,2011-09-28 01:08:21,2011-09-28 01:08:21
19058fad75e1136e32b86936e496fb000bec1089...90588437c3ab1fbbdc076787a440252fd684a060,1,1,1,2,1,2011-09-28 02:16:08,2011-09-28 02:16:08
90588437c3ab1fbbdc076787a440252fd684a060...77a43260c11679209f677efe30828aafc50b3e30,1,5,5,10,4,2011-09-28 02:47:11,2011-09-28 02:47:11
77a43260c11679209f677efe30828aafc50b3e30...f5b5fb59930e39ee6e74888e346b61d4d8b01747,1,8,4,12,7,2011-09-28 13:03:44,2011-09-28 13:03:44
f5b5fb59930e39ee6e74888e346b61d4d8b01747...14925b2cc95c39c9366a0798f583090a486cf503,1,1,1,2,1,2011-09-28 12:14:46,2011-09-28 12:14:46
14925b2cc95c39c9366a0798f583090a486cf503...f40de804ef93c0b49942f82e702e845286999fb3,2,4,2,6,2,2011-09-28 14:20:29,2011-09-27 21:11:31
f40de804ef93c0b49942f82e702e845286999fb3...0a8ecda9a73399b91923342290f5302cb449abdd,1,1,1,2,1,2011-09-28 15:51:46,2011-09-28 15:51:46
0a8ecda9a73399b91923342290f5302cb449abdd...bd31bb40a66b33ca785d8aeaf79d46b936772295,2,11,5,16,4,2011-09-28 17:10:51,2011-09-28 17:10:51
bd31bb40a66b33ca785d8aeaf79d46b936772295...ec950e4106c27f57dde6aa28795fb2597b15ba60,2,2,2,4,2,2011-09-28 19:30:19,2011-09-28 19:01:41
ec950e4106c27f57dde6aa28795fb2597b15ba60...fd8e560143f5f6a38dcf2b3648f7c43d73724dd3,1,1,1,2,1,2011-09-28 19:49:48,2011-09-28 19:49:48
fa9f1a7b85014d6677c883d22321b4539b6e50f4...811070210957af7172da7835ca791ebfb9398225,1,1,0,1,1,2011-07-01 21:57:34,2011-07-01 21:57:34
811070210957af7172da7835ca791ebfb9398225...6e14a2af919698208a940ef36b77275a1ee4e522,2,17,15,32,11,2011-07-02 02:12:57,2011-07-02 02:12:57
fa9f1a7b85014d6677c883d22321b4539b6e50f4...821d177661eb0eaca45cdf6ecd6fbe45c4cb1eff,2,2,2,4,2,2011-07-01 17:37:53,2011-07-01 17:37:53
f911ed2058ad99047ac0d8922ee63c188e6189fe...9674bede1aae665624295404792084e5ad39edac,1,10,5,15,2,2012-04-05 16:24:45,2012-04-05 15:39:55
9674bede1aae665624295404792084e5ad39edac...8f672e468f079d2481c3a28cd2b2e8e061b3c65c,1,4,0,4,4,2012-04-05 17:01:33,2012-04-05 12:43:05
8f672e468f079d2481c3a28cd2b2e8e061b3c65c...b987d96067b24e4d1eb6dede4c204f2dc0db8f57,1,1,0,1,1,2012-04-05 18:31:15,2012-04-05 18:27:48
b987d96067b24e4d1eb6dede4c204f2dc0db8f57...1c58a7b5a1a3d36dd0bef9f9073a17897fd47495,1,3,6,9,3,2012-04-05 18:50:42,2012-04-05 17:59:31
f911ed2058ad99047ac0d8922ee63c188e6189fe...c4bf0391e0a7579f164d1a6b7dacba3b5dc3f22d,1,0,1,1,1,2012-04-05 15:19:21,2012-04-05 15:19:21
c4bf0391e0a7579f164d1a6b7dacba3b5dc3f22d...1880dcc4d2ada10894b8e2efafcc6727e2470e0a,1,1,1,2,1,2012-04-05 18:55:54,2012-04-05 18:55:54
2526f0d8144d211187fb1571e33f24f32aa64d2e...7ee1654cb4bb676e9a85bcf5eda8bdf57757c812,1,6,2,8,4,2012-04-17 21:20:03,2012-04-17 21:20:03
7ee1654cb4bb676e9a85bcf5eda8bdf57757c812...e0c1bf1f261484f275b37c62e6567079237fd8cf,11,22,50,72,21,2012-04-17 21:34:58,2012-04-17 21:34:58
e0c1bf1f261484f275b37c62e6567079237fd8cf...ab9909346d10543d585e02ec3c0113801e44fb38,1,2,0,2,2,2012-04-17 21:39:28,2012-04-17 21:39:28
ab9909346d10543d585e02ec3c0113801e44fb38...09804cb1b1a8ca04824d917b6a58f730bf8efaba,1,6,0,6,3,2012-04-18 18:43:59,2012-04-18 18:43:59
09804cb1b1a8ca04824d917b6a58f730bf8efaba...1a8d40ea8e2c1045134adf04c4173e88bf4c5257,3,9,20,29,7,2012-04-18 20:03:19,2012-04-18 20:03:19
1a8d40ea8e2c1045134adf04c4173e88bf4c5257...858acc681374664dda940450180a825dec5fede4,1,16,16,32,10,2012-04-18 21:54:40,2012-04-18 21:54:40
858acc681374664dda940450180a825dec5fede4...9185a4bfe54b59214f50c68604b6b6de1f7308af,1,6,8,14,3,2012-04-18 21:59:43,2012-04-18 21:59:43
9185a4bfe54b59214f50c68604b6b6de1f7308af...dda8961cc4b604b633efbdc547677ee96a16c6e7,25,88,110,198,68,2012-04-18 22:06:06,2012-04-18 22:06:06
dda8961cc4b604b633efbdc547677ee96a16c6e7...349d959379e8dd7fc039d3bc15e3757b93a9a500,1,2,0,2,2,2012-04-19 00:26:25,2012-04-19 00:26:25
349d959379e8dd7fc039d3bc15e3757b93a9a500...e17e230ac042859819d0ba08bc7f68333fb1ec37,4,17,17,34,9,2012-04-19 01:54:47,2012-04-19 01:54:47
2526f0d8144d211187fb1571e33f24f32aa64d2e...04d218a7061f30e3750a8080ba2a26a8ec6df650,1,18,18,36,16,2012-04-17 20:33:15,2012-04-17 20:17:53
04d218a7061f30e3750a8080ba2a26a8ec6df650...d21c5973fb87360c62a00a31b4fe42fa6eabc8a2,1,4,2,6,2,2012-04-17 20:33:19,2012-04-17 20:32:11
d21c5973fb87360c62a00a31b4fe42fa6eabc8a2...8448f0aba635205bce0b3846af2027f7f0245904,1,1,1,2,1,2012-04-17 22:03:09,2012-04-17 22:03:09
8448f0aba635205bce0b3846af2027f7f0245904...1fd8c6cb530c0564a58de4ab4b03dcd62f328b26,2,30,1,31,19,2012-04-18 16:20:24,2012-04-18 16:20:24
1fd8c6cb530c0564a58de4ab4b03dcd62f328b26...b17c562f428af2f5301e987c43d379fe3de41f15,1,18,8,26,4,2012-04-18 18:29:24,2012-04-18 18:29:24
b17c562f428af2f5301e987c43d379fe3de41f15...8a0836beb86b21fa7deaf60776fb1269be0906a2,1,4,1,5,2,2012-04-18 18:49:14,2012-04-18 18:49:14
8a0836beb86b21fa7deaf60776fb1269be0906a2...23d3ac6904b62a84814e75ea405c7b7626b69eac,1,1,1,2,1,2012-04-18 19:21:30,2012-04-18 19:21:30
23d3ac6904b62a84814e75ea405c7b7626b69eac...8c6c559e7d97321fdb14793d098016cd1b105fe5,1,6,6,12,5,2012-04-18 19:39:25,2012-04-18 19:36:38
8c6c559e7d97321fdb14793d098016cd1b105fe5...a4eca301313b738d57b3574f4860d0c95afe35ea,1,6,6,12,4,2012-04-19 07:34:59,2012-04-19 07:34:59
a4eca301313b738d57b3574f4860d0c95afe35ea...a96ec246c847beb73afa7162c8187333119cd60f,1,22,1,23,2,2012-04-19 12:41:08,2012-04-18 21:06:43
2373b058fdf5243b24ac8c82fdcae47f6168c96b...ab5d034f2d6b1efa3324d3b81be6592d5771f196,1,12,0,12,3,2011-07-11 20:09:18,2011-07-11 20:09:18
2373b058fdf5243b24ac8c82fdcae47f6168c96b...7b47fff52c8dd6da36dfc8b810397d7757171c1a,1,7,1,8,1,2011-07-11 19:04:06,2011-07-11 19:04:06
9a1ec6f4ecd3cdcc12f76b5272a57195383e0614...3d4ac7f41fc9d75e5ea87ce33d3180d6f02e9346,1,1,2,3,2,2011-09-28 20:13:13,2011-09-28 20:13:13
3d4ac7f41fc9d75e5ea87ce33d3180d6f02e9346...a53f2a58d7b21f93b200c263fc1784649a7090d3,5,29,2,31,8,2011-09-29 06:49:45,2011-09-29 06:48:13
a53f2a58d7b21f93b200c263fc1784649a7090d3...47f28e90744aa3f116cf38a517d2213e4065da51,4,12,19,31,11,2011-09-29 07:38:02,2011-09-29 07:38:02
47f28e90744aa3f116cf38a517d2213e4065da51...a18dcc76ff649274799f5cbdb008fa023f49bcb3,1,14,10,24,4,2011-09-29 15:53:12,2011-09-29 15:53:12
a18dcc76ff649274799f5cbdb008fa023f49bcb3...df3231c83dca1914d4e3dd21e3ea26cf83b4a6eb,2,35,11,46,9,2011-09-29 16:23:15,2011-09-29 14:41:10
df3231c83dca1914d4e3dd21e3ea26cf83b4a6eb...e73943d75e9046e4fedb5953ba5a9f749fab8493,1,1,1,2,1,2011-09-29 16:23:15,2011-09-29 14:54:52
e73943d75e9046e4fedb5953ba5a9f749fab8493...898e3ae4e78d6a514171821541f688e327a4ed80,3,24,1,25,3,2011-09-29 16:45:09,2011-09-29 16:22:30
898e3ae4e78d6a514171821541f688e327a4ed80...991bfa6eae1d63ccc4a78901bca5ebea7645c251,5,10,17,27,10,2011-09-29 17:07:14,2011-09-29 17:06:32
991bfa6eae1d63ccc4a78901bca5ebea7645c251...f17810799b107bebdfe3fd1d3a4780f72d10f246,2,26,15,41,17,2011-09-29 17:51:17,2011-09-29 17:50:25
f17810799b107bebdfe3fd1d3a4780f72d10f246...e86718e4d39f9ac290dcbfce789debffe067e583,1,2,8,10,1,2011-09-29 17:58:30,2011-09-29 17:58:30
e86718e4d39f9ac290dcbfce789debffe067e583...38fe35874d8074bbc44632871a02d33686a87f79,7,33,20,53,17,2011-09-29 18:48:17,2011-09-28 21:23:22
38fe35874d8074bbc44632871a02d33686a87f79...4621d26de71bc67d0d78f6ebb2c43555d8abf0c9,2,44,2,46,4,2011-09-29 18:48:28,2011-09-29 18:47:25
4621d26de71bc67d0d78f6ebb2c43555d8abf0c9...d419e25c8313b38ac9eba546b82fbbd910e2f5d6,3,73,17,90,9,2011-09-29 19:15:43,2011-08-17 15:46:30
d419e25c8313b38ac9eba546b82fbbd910e2f5d6...52d261771240ddbe95c4f3544acffc0f78efb3dc,1,21,0,21,1,2011-09-29 19:42:34,2011-08-17 15:53:18
52d261771240ddbe95c4f3544acffc0f78efb3dc...6ff18f1db90d7d18e25b7cda735fdd5d0e2ac595,2,92,0,92,2,2011-09-29 19:42:45,2011-08-18 15:53:50
6ff18f1db90d7d18e25b7cda735fdd5d0e2ac595...509704ea36d9ff75431e08be1538391f7a090bb9,3,8,7,15,11,2011-09-29 19:45:25,2011-09-29 19:41:52
509704ea36d9ff75431e08be1538391f7a090bb9...bb2913e56f1a717dc3a437a4ff890fed3b866b83,1,1,1,2,1,2011-09-29 21:45:34,2011-09-29 21:45:34
bb2913e56f1a717dc3a437a4ff890fed3b866b83...4193d05ba7ca659b78d561ae00ce7eefd7b38dd9,1,6,0,6,1,2011-09-29 22:25:30,2011-09-29 22:25:30
4193d05ba7ca659b78d561ae00ce7eefd7b38dd9...8e75d326a62dd24ecb9b47e35264ff035c05da11,3,109,14,123,17,2011-09-29 23:41:05,2011-09-29 23:40:40
8e75d326a62dd24ecb9b47e35264ff035c05da11...f8a70a8865d3e48354f15947aa0d159a3fdac5a4,3,5,0,5,3,2011-09-30 04:43:36,2011-09-30 04:43:36
f8a70a8865d3e48354f15947aa0d159a3fdac5a4...97f9755a60da5286a811150e63c1962ffc8ab1bf,1,0,2,2,1,2011-09-30 15:25:41,2011-09-29 20:39:11
97f9755a60da5286a811150e63c1962ffc8ab1bf...d1971ceebde51446fd5773f3578fd9eee9bd5cb1,1,6,0,6,2,2011-09-30 15:25:41,2011-09-30 15:25:22
d1971ceebde51446fd5773f3578fd9eee9bd5cb1...ce2148699b30f457c42461e29dd3a7c8ddd6eeda,1,2,2,4,1,2011-09-30 16:06:14,2011-09-30 16:06:14
ce2148699b30f457c42461e29dd3a7c8ddd6eeda...a5cfd6af349660c81aa4d51400aa525423bffc18,6,21,12,33,10,2011-09-30 17:11:21,2011-09-30 17:11:03
a5cfd6af349660c81aa4d51400aa525423bffc18...528aba2d8f5cb50c9bdefe573f3250b727484b88,1,9,0,9,2,2011-09-30 19:38:09,2011-09-30 19:38:09
528aba2d8f5cb50c9bdefe573f3250b727484b88...98bb7a2142975f658f3bccc2878287b5828da43c,1,9,2,11,3,2011-09-30 19:46:38,2011-09-30 19:46:06
98bb7a2142975f658f3bccc2878287b5828da43c...147777066672a402c633b1e3380253f8d07d3329,1,53,0,53,1,2011-10-01 07:19:40,2011-10-01 07:19:40
147777066672a402c633b1e3380253f8d07d3329...8ce081f169a5f75d9cdc52bb14b0ba49c9ec2763,1,1,0,1,1,2011-10-01 15:21:13,2011-10-01 15:21:13
8ce081f169a5f75d9cdc52bb14b0ba49c9ec2763...310e250fd3936a4a959bb7e2387642c11d4e23e8,10,15,5,20,12,2011-10-02 17:38:29,2011-10-02 17:38:29
310e250fd3936a4a959bb7e2387642c11d4e23e8...98865b3bc01dac19ea11e2a4059ef3074ab7a5a6,2,8,1,9,3,2011-10-02 17:41:51,2011-10-02 17:41:51
98865b3bc01dac19ea11e2a4059ef3074ab7a5a6...b02aa297bc9fe08cab44b4ce0f594dfda82ddf1b,2,3,0,3,2,2011-10-02 16:53:13,2011-10-02 16:53:13
b02aa297bc9fe08cab44b4ce0f594dfda82ddf1b...bc9d347ff8594819b586e6b33da78a79f12dbefd,4,4,1,5,4,2011-10-02 18:04:31,2011-10-02 18:04:31
bc9d347ff8594819b586e6b33da78a79f12dbefd...670e541090c23ddcf0c3045c775803b34af3d3c3,3,866,838,1704,4,2011-10-02 18:20:22,2011-10-02 18:20:22
670e541090c23ddcf0c3045c775803b34af3d3c3...0ff4555e3a0551d83a5e8aee36c713c6fdc3ce97,1,41,9,50,15,2011-10-03 01:30:32,2011-10-03 01:30:32
0ff4555e3a0551d83a5e8aee36c713c6fdc3ce97...7fc75d8760a55b5f4e56d0da098b1b8ffcda122f,1,4,0,4,3,2011-10-03 01:59:57,2011-10-03 01:59:57
7fc75d8760a55b5f4e56d0da098b1b8ffcda122f...96a765d41ca880f42e7ff0caeceaafb771918d8b,1,4,5,9,4,2011-10-03 02:52:37,2011-10-03 02:51:51
96a765d41ca880f42e7ff0caeceaafb771918d8b...2ce2b1aba261abc5e6cefa09b6b4d6796b5f44e3,1,3,0,3,1,2011-10-03 02:52:37,2011-10-03 02:52:14
2ce2b1aba261abc5e6cefa09b6b4d6796b5f44e3...85ea4bce56b58f45113df08d5450f2e64463be77,1,55,1,56,2,2011-10-03 13:33:20,2011-10-03 13:24:02
85ea4bce56b58f45113df08d5450f2e64463be77...c2b87b47344613aec46e46591506ebb058b97efd,4,26,61,87,16,2011-10-03 13:33:22,2011-10-03 13:26:58
c2b87b47344613aec46e46591506ebb058b97efd...3f05f1da08026c6e901563b93fa8d4caf478ff11,1,1,1,2,1,2011-10-03 14:17:23,2011-10-03 14:17:23
3f05f1da08026c6e901563b93fa8d4caf478ff11...fa1ec1c6eedeba0e77096102f075b0c3b3c718c0,3,17,15,32,16,2011-10-03 14:25:47,2011-10-03 14:25:47
fa1ec1c6eedeba0e77096102f075b0c3b3c718c0...ffc77a17edc8b86496ef200b9a568ca9c6aeace9,1,1,1,2,1,2011-10-03 13:42:31,2011-10-03 13:42:31
821d177661eb0eaca45cdf6ecd6fbe45c4cb1eff...69e3ae24a26e6df2a7729841520fca2bc15953cc,1,11,7,18,7,2011-07-01 18:59:13,2011-07-01 18:59:13
821d177661eb0eaca45cdf6ecd6fbe45c4cb1eff...d5c05abcef431d83f475366009491961fc6cde6b,2,4,4,8,4,2011-07-01 18:54:40,2011-07-01 18:54:40
42842e527700c8876f66b5f79c783b9c520c7c72...a703303b2f6308c9acc8f11644c439b9c83e6dd1,1,1,1,2,1,2012-04-05 19:12:45,2012-04-05 19:12:45
a703303b2f6308c9acc8f11644c439b9c83e6dd1...de834d925921c3be654a12e339400d790ab653f7,6,58,20,78,10,2012-04-05 19:50:46,2012-04-05 19:50:46
de834d925921c3be654a12e339400d790ab653f7...d0235e5499f7d484d767fe8cfb792440d5efbd96,34,106,87,193,68,2012-04-05 20:25:41,2012-04-03 19:01:01
d0235e5499f7d484d767fe8cfb792440d5efbd96...1d0aa0508067701394b597b982a9a804adb7f208,16,78,86,164,26,2012-04-05 20:54:11,2012-04-05 20:21:23
1d0aa0508067701394b597b982a9a804adb7f208...ea220e2daee85cdf917f83d586c0b142826610de,4,10,0,10,5,2012-04-05 22:09:00,2012-04-05 21:51:53
ea220e2daee85cdf917f83d586c0b142826610de...061d2e3a2adf2c9f3ba39c252ff6a140a6fd31c2,2,2,2,4,2,2012-04-05 22:16:21,2012-04-05 22:16:21
061d2e3a2adf2c9f3ba39c252ff6a140a6fd31c2...a139832baaf9a4e1e3a4658ab1ced12f0e68b41c,2,10,2,12,3,2012-04-06 01:00:06,2012-04-03 05:37:27
a139832baaf9a4e1e3a4658ab1ced12f0e68b41c...7ded96c40088c935aa4bdc1381a1fab1078033b3,2,1,9,10,2,2012-04-06 01:00:06,2012-04-06 00:59:41
1b1d0a04c1013bee41d522f16ac54b3231e319fc...d187a30e162ee2b4fb050916b5558f7825155281,5,144,87,231,21,2012-04-19 13:50:34,2012-04-18 14:52:12
d187a30e162ee2b4fb050916b5558f7825155281...adbd9e45e3398f6683a37ac00fa56678fcb736c4,1,67,0,67,1,2012-04-19 13:55:49,2012-04-19 13:55:49
adbd9e45e3398f6683a37ac00fa56678fcb736c4...b682f1071a3c5febd8e4d122187635b2548b882e,1,4,1,5,1,2012-04-19 14:01:54,2012-04-19 14:01:54
b682f1071a3c5febd8e4d122187635b2548b882e...f118b7bb4842dc9d09f9ec445514d3e793ec333c,1,6,0,6,1,2012-04-19 14:55:36,2012-03-27 21:15:48
ab5d034f2d6b1efa3324d3b81be6592d5771f196...27d004087c5e8ad051ce9625f0e207e1f103e8fe,6,33,33,66,18,2011-07-11 21:19:11,2011-07-11 21:19:11
ae30374ed8d08950880558eb6dd0e545629c716f...9f93f2ec55a3abfa9c47a2e2e4bad521510a4979,3,21,44,65,17,2011-10-03 18:32:27,2011-10-03 18:32:27
ae30374ed8d08950880558eb6dd0e545629c716f...45219ef7ea4a4ee5b389dfb93420f520411e06b9,2,2,1,3,2,2011-10-03 17:35:36,2011-10-03 17:35:36
7ded96c40088c935aa4bdc1381a1fab1078033b3...87589db6fc1b7135ae54bfb0a921ca6c3fde89bf,1,1,1,2,1,2012-04-06 13:31:42,2012-04-06 13:31:42
7ded96c40088c935aa4bdc1381a1fab1078033b3...99450a39058e3c029c3dd307bc97e43c46860a3e,2,18,25,43,18,2012-04-06 13:23:21,2012-04-06 13:23:21
9d3c23497313f65fc91541106c71fc93238fbd09...e063faa315fddcd7276f4d21dfd2fa00870ae703,1,9,1,10,1,2012-04-19 17:38:08,2012-04-19 17:38:08
e063faa315fddcd7276f4d21dfd2fa00870ae703...13bb9abf36e21da868168e796c1867141cee4855,1,0,5,5,1,2012-04-19 17:45:44,2012-04-19 17:45:44
13bb9abf36e21da868168e796c1867141cee4855...aa78733b74bfeafd7e7890929b3bcabb88216dd8,1,4,0,4,1,2012-04-20 00:25:39,2012-04-20 00:25:39
aa78733b74bfeafd7e7890929b3bcabb88216dd8...f1f8e8628f7826eb21e2bf11ee962a722d4da28c,7,79,41,120,25,2012-04-20 02:00:18,2012-04-03 04:35:05
f1f8e8628f7826eb21e2bf11ee962a722d4da28c...8e2f16e2264d2c5da7957490157f026b57d158ee,1,69,0,69,3,2012-04-20 02:00:18,2012-04-13 02:47:37
8e2f16e2264d2c5da7957490157f026b57d158ee...c8ac89fba0bcc12ff8c5b3fc81224535eaffe565,1,1,1,2,1,2012-04-20 02:00:18,2012-03-20 23:59:34
c8ac89fba0bcc12ff8c5b3fc81224535eaffe565...a9930f559f2fa641ccfc8de3acc0f3a67e35f34c,3,16,23,39,5,2012-04-20 02:00:19,2012-03-21 02:39:19
a9930f559f2fa641ccfc8de3acc0f3a67e35f34c...1cb761cf35c111ca9cdb430b024b7b4b78c328bf,7,42,17,59,29,2012-04-20 02:00:19,2012-04-03 04:52:39
1cb761cf35c111ca9cdb430b024b7b4b78c328bf...8ab597e160d62fc307e5fb3a16627088a74f88cb,2,15,2,17,3,2012-04-20 02:00:19,2012-03-21 21:56:09
8ab597e160d62fc307e5fb3a16627088a74f88cb...b3f20617d7c871ad829b0f66ca15dd5af71c1732,1,0,6,6,1,2012-04-20 02:00:19,2012-04-13 05:40:04
b3f20617d7c871ad829b0f66ca15dd5af71c1732...ffaa9d7b2b00157f318581008b1c89e9468b5da3,1,1,1,2,1,2012-04-20 02:00:20,2012-04-13 05:49:48
ffaa9d7b2b00157f318581008b1c89e9468b5da3...4a4bb19808c32d29cdac876bc3b6a6fac1190e50,2,9,7,16,3,2012-04-20 02:00:20,2012-04-16 03:57:51
4a4bb19808c32d29cdac876bc3b6a6fac1190e50...870e5cf7e25951c6dc8ed75e2d7343db4f0bfd8c,8,128,18,146,25,2012-04-20 02:00:20,2012-04-16 06:26:01
870e5cf7e25951c6dc8ed75e2d7343db4f0bfd8c...72e76dd5d8dc2a85ac1973e2bd00c5c2496c833c,4,120,12,132,18,2012-04-20 02:00:21,2012-04-16 06:29:24
72e76dd5d8dc2a85ac1973e2bd00c5c2496c833c...c960bff8fc62c81ef55c519fb4d604cb82562706,5,25,24,49,7,2012-04-20 02:00:21,2012-04-03 10:57:27
c960bff8fc62c81ef55c519fb4d604cb82562706...40329ed29b27ba1854aef18b923eb0634a6d37ed,1,3,3,6,3,2012-04-20 02:00:21,2012-04-16 17:44:47
40329ed29b27ba1854aef18b923eb0634a6d37ed...131dd557b9ea7d7088198c6558bb91d835294693,10,160,80,240,55,2012-04-20 02:00:21,2012-04-16 19:45:47
131dd557b9ea7d7088198c6558bb91d835294693...4a17a039e05076364049d3903da4c6cb5b562c69,9,52,41,93,24,2012-04-20 02:00:21,2012-04-20 00:51:54
4a17a039e05076364049d3903da4c6cb5b562c69...96f3d49ad9cd72e98f4f89d5b0e0234f2c4b1fe1,1,1,1,2,1,2012-04-20 02:01:35,2012-04-20 02:01:35
96f3d49ad9cd72e98f4f89d5b0e0234f2c4b1fe1...1c3d440182a8294a427a50f4fdff9ae4d56c7cae,3,6,12,18,7,2012-04-20 02:02:32,2012-04-20 02:02:32
f118b7bb4842dc9d09f9ec445514d3e793ec333c...85d00273ecec288fad7e5091bf13a679cc7bf14b,2,2,2,4,2,2012-04-19 16:05:07,2012-04-19 16:04:55
39ff82a10c5b6a2d26c50c64ffaf69cbe189f8f1...f3600a55605bc8a252ed43019df9748cd5add0cc,1,2,2,4,1,2011-07-11 23:19:32,2011-07-11 23:19:32
c697728f3c3779baa0ce055e511117a4a138336f...b12de69636d6d3749beec635f1ab10728446abed,6,87,56,143,26,2011-10-03 22:14:34,2011-10-03 22:14:34
b12de69636d6d3749beec635f1ab10728446abed...18737bcb6d228cd3129e6e0674639d6b98c939de,4,23,5,28,11,2011-10-04 02:31:33,2011-10-04 02:31:33
c41a10681b3783b6f309622f72e99d04ad5ae0af...dce324f99b05859968ab66d186366be88849fd9f,1,8,8,16,8,2012-04-06 14:17:51,2012-04-06 14:16:42
dce324f99b05859968ab66d186366be88849fd9f...0489c0a2f6090ea2167a612b713a56fa6eabb635,2,5,2,7,3,2012-04-06 14:20:22,2012-04-06 14:18:10
0489c0a2f6090ea2167a612b713a56fa6eabb635...6a58832dc9d898b23112ee8ddd3d0322b552c089,1,11,0,11,3,2012-04-06 15:36:53,2012-04-06 15:36:53
6a58832dc9d898b23112ee8ddd3d0322b552c089...45533bd0bfc8c75e5719f0347cc60d951a16daba,2,6,0,6,2,2012-04-06 15:37:10,2012-04-06 15:37:10
45533bd0bfc8c75e5719f0347cc60d951a16daba...be60d3bfb386b30c96aba1b2a30eab8909379413,1,12,2,14,3,2012-04-06 15:32:11,2012-04-06 15:32:11
1c3d440182a8294a427a50f4fdff9ae4d56c7cae...be880126d87aae49479c06fb24afdabf03093f62,5,17,1,18,8,2012-04-20 14:57:47,2012-04-20 14:57:47
be880126d87aae49479c06fb24afdabf03093f62...4ced9a9bb39c6addb87e8557afb6ec74d7bcbb52,1,1,1,2,1,2012-04-20 15:21:07,2012-04-20 15:19:55
4ced9a9bb39c6addb87e8557afb6ec74d7bcbb52...d11336c018e63c3c83548039d9a4f2079109d705,1,6,6,12,6,2012-04-20 15:21:07,2012-04-20 15:20:12
d11336c018e63c3c83548039d9a4f2079109d705...387bf222e9de8a249722376e914b4a86fd92dbaa,1,2,2,4,2,2012-04-20 15:21:07,2012-04-20 15:20:35
387bf222e9de8a249722376e914b4a86fd92dbaa...adea4823ac14e6bb5dda017c666d45c0eaecb748,1,1,1,2,1,2012-04-20 17:39:43,2012-04-20 17:39:43
adea4823ac14e6bb5dda017c666d45c0eaecb748...175b144ccc7f5a48c6fb7bfbcd9ec0fa97d37245,1,94,25,119,16,2012-04-20 17:50:03,2012-04-20 17:45:28
175b144ccc7f5a48c6fb7bfbcd9ec0fa97d37245...18c952897bbdddd99bbb734c0cc75b712fe49625,3,0,43,43,3,2012-04-20 17:50:03,2012-04-20 17:49:53
18c952897bbdddd99bbb734c0cc75b712fe49625...b85ad82930961b292e24def7c6e5579bc556115b,1,4,1,5,1,2012-04-20 18:10:11,2012-04-20 18:10:07
b85ad82930961b292e24def7c6e5579bc556115b...3fd396db3f9386cf715b73f6b7176be024e4ab2c,1,1,1,2,1,2012-04-20 18:39:47,2012-04-20 18:39:47
3fd396db3f9386cf715b73f6b7176be024e4ab2c...4bf154f26eacca48211e4474b35d816d1d977471,1,6,0,6,2,2012-04-20 19:24:48,2012-04-20 19:24:27
4bf154f26eacca48211e4474b35d816d1d977471...ced3b7b5ba7211c8adb064cdbcc6306a7390d18b,1,2,1,3,1,2012-04-20 20:06:55,2012-04-20 20:06:26
ced3b7b5ba7211c8adb064cdbcc6306a7390d18b...7399b791675c31fd53d9bc759db3197b36c6ae68,4,96,25,121,27,2012-04-20 21:36:42,2012-04-18 20:50:14
1c3d440182a8294a427a50f4fdff9ae4d56c7cae...9ec3fe27441065687ce37e06572a172f26c80e26,4,40,29,69,4,2012-04-20 03:21:19,2012-04-20 03:21:19
85d00273ecec288fad7e5091bf13a679cc7bf14b...d74e506c5d7e00cfefe097c4c9a82d70709d5bbd,2,11,2,13,5,2012-04-19 16:31:31,2012-04-19 16:31:31
d74e506c5d7e00cfefe097c4c9a82d70709d5bbd...4224195cd1fe4ce9a8e6f166f492948ba6e3b906,3,81,94,175,3,2012-04-19 16:31:47,2012-04-19 16:31:47
f3600a55605bc8a252ed43019df9748cd5add0cc...b25dcc742ef574f2d2f0f337ed0dc509a50b4557,2,3,1,4,3,2011-07-12 01:50:42,2011-07-11 15:00:14
b25dcc742ef574f2d2f0f337ed0dc509a50b4557...9dab4d8bb1568b1a049d0f2d5d023bf45649a08b,1,11,6,17,10,2011-07-12 01:50:42,2011-07-12 00:22:27
9dab4d8bb1568b1a049d0f2d5d023bf45649a08b...7f3d1bf0562a8ffdafbab977c33a810f670d2894,1,11,1,12,2,2011-07-12 01:50:42,2011-07-12 01:50:33
f3600a55605bc8a252ed43019df9748cd5add0cc...bac5bc016f1e1c2dc4671ac0599401caf03b2f57,1,8,12,20,6,2011-07-12 00:00:54,2011-07-12 00:00:54
bac5bc016f1e1c2dc4671ac0599401caf03b2f57...e4e52150dcca1994cbb3811b76f0ac1713afcf4b,1,2,5,7,1,2011-07-12 00:54:33,2011-07-12 00:54:33
18737bcb6d228cd3129e6e0674639d6b98c939de...a3761a1c05e415250918a02f5d71ffc1f4800ed4,3,4,2,6,3,2011-10-04 13:39:10,2011-10-04 13:39:10
a3761a1c05e415250918a02f5d71ffc1f4800ed4...bd73d829faaceab71ca25402e640253325ce19a7,1,2,2,4,3,2011-10-04 13:49:11,2011-10-04 13:49:11
bd73d829faaceab71ca25402e640253325ce19a7...e60017cd86cd30da21671281981d6540b5ae13f0,1,1,1,2,1,2011-10-04 14:06:47,2011-10-04 14:06:47
e60017cd86cd30da21671281981d6540b5ae13f0...71bfe096862e176b6e3f6dee077e175babd9cf17,1,4,0,4,1,2011-10-04 15:27:41,2011-09-16 18:16:29
71bfe096862e176b6e3f6dee077e175babd9cf17...8c2a396be396e56da602aa4d49199db586a6ebcb,3,28,9,37,11,2011-10-04 15:27:42,2011-09-16 18:18:25
8c2a396be396e56da602aa4d49199db586a6ebcb...4a376eab5bcf481554fda0671d98f130869b7b7b,3,9,3,12,6,2011-10-04 15:27:42,2011-09-16 18:19:31
4a376eab5bcf481554fda0671d98f130869b7b7b...16b9edd56dfb5d6f3ec76a53f43cae4915d9e51f,3,370,93,463,52,2011-10-04 15:27:42,2011-09-16 18:24:15
16b9edd56dfb5d6f3ec76a53f43cae4915d9e51f...3b61574f18e644f94058f1400b2e5ac01dc30677,2,52,11,63,11,2011-10-04 15:27:43,2011-09-16 18:25:03
3b61574f18e644f94058f1400b2e5ac01dc30677...09bf4a167af6ef9ca4c82f55af6f0db72aeab8b0,3,90,5,95,8,2011-10-04 15:27:43,2011-09-16 18:28:34
09bf4a167af6ef9ca4c82f55af6f0db72aeab8b0...c13de89d5283420c4cfec80fed4b94bfcb13460d,3,21,9,30,9,2011-10-04 15:27:43,2011-09-29 21:38:42
c13de89d5283420c4cfec80fed4b94bfcb13460d...98f68e445e7ebb0b1bb38ced6ceb6a2c3d94436e,2,38,11,49,22,2011-10-04 15:27:43,2011-10-04 15:22:55
18737bcb6d228cd3129e6e0674639d6b98c939de...8652841fb3db06d69cc352a5feefdfcd0ecb47b3,1,4,1,5,2,2011-10-04 04:13:56,2011-10-04 04:13:56
be60d3bfb386b30c96aba1b2a30eab8909379413...73644533fa83d8043f61b76eaea3fbd18cef310e,5,31,0,31,5,2012-04-06 16:52:35,2012-04-06 16:52:35
be60d3bfb386b30c96aba1b2a30eab8909379413...53dda3d5aa72ef9e2d0bf21619e87179db4b5d01,4,21,8,29,12,2012-04-06 16:49:18,2012-04-06 09:51:27
7399b791675c31fd53d9bc759db3197b36c6ae68...5173201c78db71eb99527d2c3b4c4a6dc5c25224,1,4,0,4,1,2012-04-23 18:57:50,2012-04-23 18:57:50
5173201c78db71eb99527d2c3b4c4a6dc5c25224...84614c30a3cf272c6ca2a975421a445b026915c2,11,154,17,171,19,2012-04-23 20:11:11,2012-04-20 21:45:13
84614c30a3cf272c6ca2a975421a445b026915c2...ef446f655bdb63d57babaefb928b4e81fd43610c,3,8,7,15,7,2012-04-23 20:11:12,2012-04-23 19:42:24
7399b791675c31fd53d9bc759db3197b36c6ae68...c7c2a3dbe423942507e9ec0f7da78cdcd6b8243e,1,1,1,2,1,2012-04-23 17:02:07,2012-04-23 17:01:52
c7c2a3dbe423942507e9ec0f7da78cdcd6b8243e...90b1798f9ebafc9508d1a4ed177cf17cd966a45b,2,237,163,400,94,2012-04-23 18:44:07,2012-04-23 18:44:07
90b1798f9ebafc9508d1a4ed177cf17cd966a45b...e4f613fd7b51865a5397f14022b7157838b9975c,1,0,27,27,1,2012-04-23 19:55:12,2012-04-23 19:55:12
e4f613fd7b51865a5397f14022b7157838b9975c...eaa3f62450b6a78f172458600c53f9121b84285b,1,2,0,2,1,2012-04-23 19:55:17,2012-04-23 19:55:17
eaa3f62450b6a78f172458600c53f9121b84285b...9b749e74e2b7e9a5ebacd2db195355ac173b5ad5,2,42,37,79,3,2012-04-23 20:02:05,2012-04-23 20:02:05
9b749e74e2b7e9a5ebacd2db195355ac173b5ad5...01b95f91393b4b88172f55f3ec0a518e82039750,1,1,1,2,1,2012-04-23 20:02:51,2012-04-23 20:02:51
01b95f91393b4b88172f55f3ec0a518e82039750...3143af5511c2f77bb1e10b099ed6c0d3f5ea7371,1,2,2,4,1,2012-04-23 20:27:57,2012-04-23 20:27:57
3143af5511c2f77bb1e10b099ed6c0d3f5ea7371...cfba82194a364ac0da47d98d21eeee77611e3aae,5,8,12,20,10,2012-04-23 20:32:01,2012-04-23 20:32:01
cfba82194a364ac0da47d98d21eeee77611e3aae...65cba25c31f942c1ee6d407005a2ceb05618af5c,12,12,24,36,15,2012-04-23 20:42:02,2012-04-23 20:42:02
65cba25c31f942c1ee6d407005a2ceb05618af5c...2cd00ee64c18de472e53c09bbf5fc7265d672f2e,1,0,31,31,1,2012-04-23 20:42:16,2012-04-23 20:42:16
2cd00ee64c18de472e53c09bbf5fc7265d672f2e...7cd8e73b93bc309faee7152df66b1eacbb88276d,7,8,24,32,10,2012-04-23 22:14:01,2012-04-23 22:14:01
0e6aae4f8c9817a6ca3e45eb90d68fd1f1c72106...71064737f16c7154030e4873a11696f54b166a09,1,5,2,7,2,2011-07-12 02:49:20,2011-07-12 02:49:20
71064737f16c7154030e4873a11696f54b166a09...7affa19eebff6e19429a68cc33282f265754a8b9,1,10,10,20,2,2011-07-12 02:56:20,2011-07-12 02:56:20
7affa19eebff6e19429a68cc33282f265754a8b9...8d1314b61e117fdf2a0d0ef1517fda5787fc2b06,1,5,2,7,1,2011-07-12 02:57:26,2011-07-12 02:57:26
8d1314b61e117fdf2a0d0ef1517fda5787fc2b06...c85b48ce58215eb40f192f61118d3012073a917e,1,10,2,12,3,2011-07-12 03:49:17,2011-07-12 03:48:25
c85b48ce58215eb40f192f61118d3012073a917e...9958fc16cad0df53ddd3218c6fd9f0e88cdaa87d,1,4,2,6,1,2011-07-12 03:49:18,2011-07-12 03:49:04
9958fc16cad0df53ddd3218c6fd9f0e88cdaa87d...9dfbe88e65a830fc2d382f3d21c8769b20864114,1,2,4,6,1,2011-07-12 05:52:33,2011-07-12 05:52:33
9dfbe88e65a830fc2d382f3d21c8769b20864114...62060e62f7f909cb9c4863c9d97c18e3e2bf17c5,1,2,10,12,3,2011-07-12 05:52:41,2011-07-12 05:52:41
62060e62f7f909cb9c4863c9d97c18e3e2bf17c5...958e539327f7c8ad3f7ddf0580469f5e5787c842,3,16,16,32,14,2011-07-12 14:58:42,2011-07-12 14:58:42
958e539327f7c8ad3f7ddf0580469f5e5787c842...db033b9c7e836ab5f814718c2dc646976a3c2326,1,5,1,6,3,2011-07-12 15:25:22,2011-06-30 18:13:48
db033b9c7e836ab5f814718c2dc646976a3c2326...68e0ade1059ad93a62e47eb0cff6602f0e854614,6,66,21,87,25,2011-07-12 17:48:20,2011-07-12 17:48:02
68e0ade1059ad93a62e47eb0cff6602f0e854614...01267c88bd32c2c654a026d0cbc77183d8b142df,1,4,2,6,1,2011-07-12 18:10:43,2011-07-12 03:49:04
01267c88bd32c2c654a026d0cbc77183d8b142df...f5a56c1cccdc8390d3aa7070302a743468b927e6,1,6,1,7,1,2011-07-12 18:10:56,2011-07-12 18:07:56
f5a56c1cccdc8390d3aa7070302a743468b927e6...b0361242aa4688ca0987c9b55835e0abf0a460dd,1,1,1,2,1,2011-07-12 22:27:19,2011-07-12 22:27:19
b0361242aa4688ca0987c9b55835e0abf0a460dd...a0f61e484d5bf90eab7367860c0ec3a28a7f874c,1,3,3,6,3,2011-07-13 05:13:03,2011-07-13 05:13:03
a0f61e484d5bf90eab7367860c0ec3a28a7f874c...90492cab19180f3c8c45552d2b8101840c2859c9,1,1,1,2,1,2011-07-13 08:19:08,2011-07-13 08:19:08
90492cab19180f3c8c45552d2b8101840c2859c9...ec180477cbe490c1b731d9f9fc3fa2fce5b31d4f,1,18,9,27,8,2011-07-13 15:05:44,2011-07-13 15:05:44
ec180477cbe490c1b731d9f9fc3fa2fce5b31d4f...fe6dbb36fc0d94efa500228aee7c8d9d7eb7e5c7,1,7,6,13,4,2011-07-13 15:56:23,2011-07-13 15:56:23
fe6dbb36fc0d94efa500228aee7c8d9d7eb7e5c7...e87ff94b16f5957eb5e77267546be5876a3f3764,1,3,4,7,2,2011-07-13 16:03:23,2011-07-13 16:03:23
e87ff94b16f5957eb5e77267546be5876a3f3764...ca128efeea7ac7ff9b7687beba8d16a56621a139,1,11,3,14,3,2011-07-13 16:30:02,2011-07-13 16:30:02
ca128efeea7ac7ff9b7687beba8d16a56621a139...2fbb9ff8893b47372dc8fa97dd02bed94501646d,1,14,2,16,3,2011-07-13 18:09:06,2011-07-13 18:08:54
2fbb9ff8893b47372dc8fa97dd02bed94501646d...4ef7ea1b95d1fa36eb34bef0d231a120435efc52,1,0,1,1,1,2011-07-13 20:35:46,2011-07-13 20:35:46
4ef7ea1b95d1fa36eb34bef0d231a120435efc52...146ef71a1754a44ba6c3763ddeda0d69398fe458,1,8,1,9,1,2011-07-14 15:20:58,2011-07-14 15:20:58
146ef71a1754a44ba6c3763ddeda0d69398fe458...253f05dfb5692318103e84a364bfd07a22158d14,1,37,0,37,1,2011-07-14 15:29:16,2011-07-14 15:29:16
253f05dfb5692318103e84a364bfd07a22158d14...f873cfb0b4b59265135caef883c720024d850137,1,3,3,6,3,2011-07-14 15:45:27,2011-07-14 15:41:35
f873cfb0b4b59265135caef883c720024d850137...0b26301e0430437f44085370b0e57a399af522a9,1,3,0,3,1,2011-07-14 16:36:07,2011-07-14 16:36:07
0b26301e0430437f44085370b0e57a399af522a9...db06c7a6d351f99e736eff0fbf10bd685924503d,3,10,10,20,9,2011-07-14 17:40:22,2011-07-14 17:35:16
db06c7a6d351f99e736eff0fbf10bd685924503d...f1cd4e99c2194bb9bc26919590813acfebfb321b,3,8,11,19,4,2011-07-14 19:44:34,2011-07-14 19:44:34
f1cd4e99c2194bb9bc26919590813acfebfb321b...7fe29b26b0fbf23b3abcfbffa32fd77a5238169c,1,1,1,2,1,2011-07-14 22:15:09,2011-07-14 22:15:09
7fe29b26b0fbf23b3abcfbffa32fd77a5238169c...73fb557e9fedc551f2722d0b93722b6e649bc0d8,1,6,2,8,1,2011-07-15 14:59:13,2011-07-15 14:59:13
73fb557e9fedc551f2722d0b93722b6e649bc0d8...d5bb38763da7a94e2fa702faa060d9f70b821f35,1,2,2,4,2,2011-07-15 14:59:24,2011-07-15 14:59:24
d5bb38763da7a94e2fa702faa060d9f70b821f35...9c69f606fffd3975bffeb63adaa494b6259493b9,1,3,1,4,1,2011-07-15 17:59:16,2011-07-15 17:25:28
9c69f606fffd3975bffeb63adaa494b6259493b9...5eaf9a15c9bbe3341270c9cfed53245d9e288ef5,1,13,2,15,2,2011-07-15 17:59:16,2011-07-15 17:59:06
5eaf9a15c9bbe3341270c9cfed53245d9e288ef5...b3fc313dc0fd96eef3280f7dd8d3566b77f6ed39,1,3,3,6,3,2011-07-15 20:40:40,2011-07-15 20:40:40
b3fc313dc0fd96eef3280f7dd8d3566b77f6ed39...0ed5ef7b067abe8fde6a695f9d488586119c9d69,2,13,0,13,3,2011-07-15 21:17:31,2011-07-15 21:16:36
0ed5ef7b067abe8fde6a695f9d488586119c9d69...d71afc52d72c515a64a2a59f3e3128197e258c05,1,5,2,7,3,2011-07-15 21:58:29,2011-07-15 21:58:29
d71afc52d72c515a64a2a59f3e3128197e258c05...07e069fdc4e8c92574dc032e4948d650d5672f3c,1,3,3,6,2,2011-07-16 00:48:40,2011-07-16 00:48:40
07e069fdc4e8c92574dc032e4948d650d5672f3c...c08570d8034469fb9479aaa403ce5f2fd1bca39d,2,23,14,37,7,2011-07-16 06:58:00,2011-07-16 06:57:08
c08570d8034469fb9479aaa403ce5f2fd1bca39d...408ec2e0dab91720d6fb3efaa37a79c963686cba,1,4,1,5,2,2011-07-16 11:32:53,2011-07-16 11:32:53
408ec2e0dab91720d6fb3efaa37a79c963686cba...beb8dc708477a6500810d81ec9ceb722fdf03ac8,2,1,7,8,3,2011-07-16 11:33:01,2011-07-16 11:33:01
beb8dc708477a6500810d81ec9ceb722fdf03ac8...a1ab42a2811b6984ab11c018ebb7b240fad4c705,2,47,26,73,17,2011-07-16 12:03:52,2011-07-16 12:03:52
a1ab42a2811b6984ab11c018ebb7b240fad4c705...1e3e443740b01e0e97cb393b74f910cd8e798ddc,1,4,0,4,1,2011-07-16 12:48:56,2011-07-16 12:48:56
1e3e443740b01e0e97cb393b74f910cd8e798ddc...99f3c03839321a95fe2d45bab2d5f8e9588b71b8,1,7,7,14,1,2011-07-16 12:49:36,2011-07-16 12:49:36
99f3c03839321a95fe2d45bab2d5f8e9588b71b8...80b34c1b3c5fb33749752744770311186afddedd,1,10,3,13,2,2011-07-16 16:14:31,2011-07-16 16:14:31
80b34c1b3c5fb33749752744770311186afddedd...d3de3070eff732369d760b1ff6721641103d41f9,1,1,1,2,1,2011-07-16 17:05:33,2011-07-16 17:05:17
c2b9f746e0237b605285d074a96e785034b04918...d570e5e14c76c9c65224cf4d47283dbb106d2799,1,1,3,4,1,2011-10-04 17:24:21,2011-10-04 17:24:21
d570e5e14c76c9c65224cf4d47283dbb106d2799...5007bfc8faa0abe95b18712f4ae96b8adbdb8e4e,1,1,1,2,1,2011-10-04 18:24:39,2011-10-04 18:20:10
5007bfc8faa0abe95b18712f4ae96b8adbdb8e4e...860310acd48fdcbf1b78ad0c956e44dca5248622,1,1,1,2,1,2011-10-04 20:21:22,2011-10-04 17:05:54
860310acd48fdcbf1b78ad0c956e44dca5248622...8e9cebc95ef51a12a658eddd62a7bd8ff5028c18,2,16,0,16,3,2011-10-04 20:21:23,2011-10-04 17:34:15
8e9cebc95ef51a12a658eddd62a7bd8ff5028c18...3ad01731f68c49690f61bf6df808b79c8e37e990,2,25,2,27,7,2011-10-04 20:21:23,2011-10-04 18:01:20
3ad01731f68c49690f61bf6df808b79c8e37e990...8593d9caadea8d0c39d609787c34c0872cdd1d45,1,2,2,4,1,2011-10-04 20:49:23,2011-10-04 20:49:23
8593d9caadea8d0c39d609787c34c0872cdd1d45...785a715e6795338771fcc2411db9d88585c18ed5,2,9,2,11,4,2011-10-04 21:30:57,2011-10-04 21:19:44
785a715e6795338771fcc2411db9d88585c18ed5...34174c2f4972307f2776b160cb26ce88cb93080d,1,4,4,8,4,2011-10-04 22:10:50,2011-10-04 22:08:54
34174c2f4972307f2776b160cb26ce88cb93080d...2fb57a8d5eb9756feafa86c4bc66460cf7b92222,5,7,7,14,6,2011-10-04 23:30:26,2011-10-04 23:29:59
2fb57a8d5eb9756feafa86c4bc66460cf7b92222...f3563c4bd73ba4ae8a62f1b41f6730d6936890fc,1,14,11,25,10,2011-10-05 02:46:41,2011-10-05 02:42:40
f3563c4bd73ba4ae8a62f1b41f6730d6936890fc...1128196b74838d5d683dae870d24225692610251,3,95,12,107,12,2011-10-05 02:46:43,2011-10-05 02:46:22
1128196b74838d5d683dae870d24225692610251...2c2e5809dc8e3ca09e8c0198b899781d16e0e43d,1,0,842,842,2,2011-10-05 02:52:46,2011-10-05 02:52:46
2c2e5809dc8e3ca09e8c0198b899781d16e0e43d...d7c826bc6268e73e29b016f37a31ecae9f75dfaa,1,50,0,50,1,2011-10-05 02:53:11,2011-10-05 02:53:11
d7c826bc6268e73e29b016f37a31ecae9f75dfaa...a9614810d9859589213324d1105de627ecc4477f,1,3,1,4,1,2011-10-05 03:05:18,2011-10-05 03:05:18
a9614810d9859589213324d1105de627ecc4477f...f895b46f9e858dd0ae3a268da66cd6f9c526e9dc,1,2,0,2,1,2011-10-05 04:14:20,2011-10-05 04:13:56
f895b46f9e858dd0ae3a268da66cd6f9c526e9dc...1a93a3e7da6055bedb5d9d9b78492e86dbbc3e8f,5,31,9,40,9,2011-10-05 06:41:04,2011-10-05 06:41:04
1a93a3e7da6055bedb5d9d9b78492e86dbbc3e8f...8e700feac97a8b5ccd34fcca653870380dcd3dec,1,1,1,2,1,2011-10-05 15:32:26,2011-10-05 15:32:26
8e700feac97a8b5ccd34fcca653870380dcd3dec...d8f91a17afa59a31222eeb377690a88af74be498,1,3,1,4,1,2011-10-05 15:40:43,2011-10-05 15:39:59
d8f91a17afa59a31222eeb377690a88af74be498...40abbe965482c99879017472fc14b458c3218897,2,20,3,23,2,2011-10-05 16:04:45,2011-10-05 16:03:51
40abbe965482c99879017472fc14b458c3218897...eb91538e2b5a3c1e260805c0ffef1647f12c9ea4,1,2,1,3,3,2011-10-05 16:37:54,2011-10-05 16:37:01
eb91538e2b5a3c1e260805c0ffef1647f12c9ea4...6078b567e8c1461a5e3d9e547b32afb42a4f91af,1,3,2,5,3,2011-10-05 16:43:42,2011-10-05 16:43:42
6078b567e8c1461a5e3d9e547b32afb42a4f91af...13a291156db6d30587cfb4461c818b81b214d3cb,1,3,0,3,1,2011-10-05 18:19:28,2011-10-04 20:41:04
13a291156db6d30587cfb4461c818b81b214d3cb...c2c9eeb4f12e70eec2364291f603874bb366c037,1,1,2,3,2,2011-10-05 20:27:54,2011-10-05 20:27:54
c2c9eeb4f12e70eec2364291f603874bb366c037...ba817fbd9acb69d3a252ff4da88315263ed0432d,3,30,20,50,14,2011-10-05 20:52:59,2011-10-05 20:48:47
ba817fbd9acb69d3a252ff4da88315263ed0432d...203f41d92de68af298acc390f771dcf882c594d1,1,29,17,46,7,2011-10-05 20:56:06,2011-10-05 20:49:20
203f41d92de68af298acc390f771dcf882c594d1...d21c163de24219fa238cd92e492d8d27cdc2a55f,9,303,89,392,31,2011-10-05 20:56:06,2011-10-05 20:55:55
d21c163de24219fa238cd92e492d8d27cdc2a55f...c59d5c43e6f71065c0fb4f780e103ca3e9db5b2b,1,1,0,1,1,2011-10-05 21:58:46,2011-10-05 21:57:13
c59d5c43e6f71065c0fb4f780e103ca3e9db5b2b...ca9770abb5df39938b0e086c66f77bc08a8f00e7,5,37,12,49,6,2011-10-05 22:34:13,2011-10-05 22:34:13
ca9770abb5df39938b0e086c66f77bc08a8f00e7...5a318188bb152a0cde95de9b574fcf86a051efc5,2,22,2,24,3,2011-10-05 23:36:49,2011-10-05 16:50:41
5a318188bb152a0cde95de9b574fcf86a051efc5...7bbc02cbf03956b29bd211dfa940d1be37a9beb3,2,48,13,61,9,2011-10-05 23:36:49,2011-10-05 21:26:02
7bbc02cbf03956b29bd211dfa940d1be37a9beb3...2ebc3ba2c8c2eb2ad022edbd600545ebdd5f2989,1,6,1,7,1,2011-10-05 23:36:49,2011-10-05 23:32:00
7efd1ca05a5fe4108107a8c5e4d573123a3ddcdf...5c1c6b27c6d491ec514a901ced6db8a390ebc5fd,2,14,8,22,10,2012-04-24 00:49:26,2012-04-24 00:49:26
5c1c6b27c6d491ec514a901ced6db8a390ebc5fd...9d5ed67a2575316504679f9b53f9f554723d1868,1,1,1,2,1,2012-04-24 01:49:31,2012-04-24 01:49:31
9d5ed67a2575316504679f9b53f9f554723d1868...31bdfd739ea47d46c011a642acc3c37c3932dc14,10,6,31,37,10,2012-04-24 01:54:41,2012-04-24 01:54:41
202000055fe3927a91adca190e7f4fc8d8e7a88f...ed7f678d702ca53a08bd144da17abe8d976818ee,1,1,1,2,1,2012-04-25 01:50:31,2012-04-25 01:50:31
ed7f678d702ca53a08bd144da17abe8d976818ee...6e12471dad9b863542ff116559261ac94bf9a7ce,1,21,11,32,12,2012-04-25 02:56:25,2012-04-24 18:22:23
6e12471dad9b863542ff116559261ac94bf9a7ce...aa9d0f6557965862f10cea9824d0025de8cfd92b,1,0,0,0,0,2012-04-25 02:56:25,2012-04-24 18:23:27
aa9d0f6557965862f10cea9824d0025de8cfd92b...a819ffa4b40cc3905fac6a11db9ae04da9bd401d,1,4,2,6,3,2012-04-25 02:56:25,2012-04-24 18:37:32
a819ffa4b40cc3905fac6a11db9ae04da9bd401d...961ce2b665e97251ed988f20ba3dff09209aaab9,1,22,4,26,7,2012-04-25 02:56:25,2012-04-24 20:36:16
961ce2b665e97251ed988f20ba3dff09209aaab9...46ad79fdf5769e6adb5aeda1aac6b92b471dcd75,5,117,25,142,10,2012-04-25 02:56:26,2012-04-22 19:01:52
46ad79fdf5769e6adb5aeda1aac6b92b471dcd75...b60b052d574662ff02dabeca8c762fdeac07cf23,2,22,22,44,4,2012-04-25 02:56:26,2012-04-22 19:20:00
b60b052d574662ff02dabeca8c762fdeac07cf23...8484ceba8881090748560d5675229b9262512407,1,0,17,17,1,2012-04-25 02:56:26,2012-04-22 19:35:33
8484ceba8881090748560d5675229b9262512407...f9ccd0dd94bbb72ac7d1e95a8f77f5080750a036,2,15,13,28,12,2012-04-25 02:56:26,2012-04-22 20:26:18
f9ccd0dd94bbb72ac7d1e95a8f77f5080750a036...04be4bbe7ba0d1c4c02bb50270afb714ea314539,2,30,40,70,16,2012-04-25 02:56:27,2012-04-22 22:09:10
04be4bbe7ba0d1c4c02bb50270afb714ea314539...64a84f3c9aafc042b73b224442f9a5cd5ea9a8a6,1,10,11,21,3,2012-04-25 02:56:27,2012-04-22 22:46:47
64a84f3c9aafc042b73b224442f9a5cd5ea9a8a6...e72155eecfd6e579745a92bab221e3ca3c41e5d6,2,1,3,4,3,2012-04-25 02:56:27,2012-04-22 23:33:48
e72155eecfd6e579745a92bab221e3ca3c41e5d6...fd4ed51a775999a4d9cfc8960cbd83f6c2733eb3,2,7,8,15,6,2012-04-25 02:56:27,2012-04-23 05:26:10
fd4ed51a775999a4d9cfc8960cbd83f6c2733eb3...82d92c3964f500776f4a9ba428bca2b88956006c,4,290,224,514,68,2012-04-25 02:56:27,2012-04-23 05:38:27
82d92c3964f500776f4a9ba428bca2b88956006c...e6b729d3958be380a37e255c4b6c2cf86ecbe335,2,9,8,17,9,2012-04-25 02:56:27,2012-04-23 05:50:12
e6b729d3958be380a37e255c4b6c2cf86ecbe335...d0bf3a4f8d3f5b24394c5e623c18108e24dd5b40,2,109,76,185,13,2012-04-25 02:56:28,2012-04-23 06:49:49
d0bf3a4f8d3f5b24394c5e623c18108e24dd5b40...83ba53920874b30c7375402160f1ffaa50f72816,2,22,23,45,3,2012-04-25 02:56:28,2012-04-23 20:28:48
83ba53920874b30c7375402160f1ffaa50f72816...8ac5f94385d2443635d6bbea03058ef528942e95,2,34,26,60,4,2012-04-25 02:56:28,2012-04-23 20:52:02
8ac5f94385d2443635d6bbea03058ef528942e95...6861ad3c4f479e2a0d965021e29330078e745c49,2,8,7,15,6,2012-04-25 02:56:28,2012-04-23 20:56:07
6861ad3c4f479e2a0d965021e29330078e745c49...0819049f2c54a174b843e34d5927c16132288680,1,8,1,9,7,2012-04-25 02:56:28,2012-04-23 21:06:19
0819049f2c54a174b843e34d5927c16132288680...282ef9960c66dc41c116a5f3bfdfc1c524910be8,1,1,1,2,1,2012-04-25 02:56:28,2012-04-25 00:29:29
282ef9960c66dc41c116a5f3bfdfc1c524910be8...127b0b78ae3ac9b2bc0a54bcd3c097c0e2a91e79,6,19,18,37,8,2012-04-25 13:45:31,2012-04-24 19:25:57
127b0b78ae3ac9b2bc0a54bcd3c097c0e2a91e79...5ce0795fc6d4c7713615e9a0be23805e8c66980d,1,2,2,4,3,2012-04-25 14:29:11,2012-04-25 14:29:02
5ce0795fc6d4c7713615e9a0be23805e8c66980d...27a283cfea5597e4a296954e43a71f987a5b6b49,1,1,1,2,1,2012-04-25 15:39:39,2012-04-25 15:39:39
27a283cfea5597e4a296954e43a71f987a5b6b49...007d202d65682847e7ba0cc281a7650a5604e069,6,32,16,48,24,2012-04-25 15:45:06,2012-04-25 07:14:09
007d202d65682847e7ba0cc281a7650a5604e069...50a2d2cacc5c3233abf573c75bc0c7af9056e642,2,6,1,7,2,2012-04-25 18:49:17,2012-04-25 18:49:17
50a2d2cacc5c3233abf573c75bc0c7af9056e642...f460ae61beaed965a54649b703f03095a6ac055e,1,4,1,5,2,2012-04-25 20:14:12,2012-04-25 16:32:30
f460ae61beaed965a54649b703f03095a6ac055e...d8462a26b9089c5e58d1e340dcada83719ea4e47,1,2,0,2,1,2012-04-25 20:47:13,2012-04-25 20:47:13
d8462a26b9089c5e58d1e340dcada83719ea4e47...3a0087aef01559874dc03a346b96e3d5592287e5,1,22,4,26,3,2012-04-25 21:28:01,2012-04-25 21:16:06
3a0087aef01559874dc03a346b96e3d5592287e5...bba9d9a5d6373b9fb2fa5e7e0e0e589dbc9d683e,1,10,2,12,4,2012-04-27 16:10:36,2012-04-18 22:18:46
bba9d9a5d6373b9fb2fa5e7e0e0e589dbc9d683e...558966d2b05283edb37622aeddc3712b8234b5ae,1,1,1,2,1,2012-04-27 16:44:10,2012-04-27 16:41:57
558966d2b05283edb37622aeddc3712b8234b5ae...8dc5617a4d474d8342472f21bcb1cbebfc25b038,1,0,5,5,1,2012-04-27 21:20:44,2012-04-26 23:09:03
8dc5617a4d474d8342472f21bcb1cbebfc25b038...557f0c1433f131fc68bfefbdf85bf54df4470788,4,35,2,37,6,2012-04-27 22:54:51,2012-04-27 21:11:45
557f0c1433f131fc68bfefbdf85bf54df4470788...b3c9b5c9068aaa35d1e9a91a35cdb0f7227e98fd,2,34,3,37,3,2012-04-28 18:22:57,2012-04-24 01:37:54
b3c9b5c9068aaa35d1e9a91a35cdb0f7227e98fd...19af6d4f3b19f0042b8b6f1a078f207ae27d6098,2,4,4,8,4,2012-04-28 18:22:57,2012-04-24 02:17:03
19af6d4f3b19f0042b8b6f1a078f207ae27d6098...2de4a517f69a974db109e2459d7b2e4681c640d4,2,7,10,17,8,2012-04-28 18:22:58,2012-04-24 03:41:43
2de4a517f69a974db109e2459d7b2e4681c640d4...2c739c63f15a8120a7af89a5d174c7681f8ccb70,2,18,28,46,4,2012-04-28 18:22:58,2012-04-26 05:10:22
2c739c63f15a8120a7af89a5d174c7681f8ccb70...6d8b3d274fdb572806972c235736251b258fe96d,1,2,2,4,2,2012-04-28 18:22:58,2012-04-24 04:04:19
6d8b3d274fdb572806972c235736251b258fe96d...f329362ee024f7f57c9229a6934948ecba8a9282,2,10,10,20,8,2012-04-28 18:22:58,2012-04-25 20:23:01
f329362ee024f7f57c9229a6934948ecba8a9282...4da8a5df4b979ff426ccf6377e6e0bcf1f880111,1,2,0,2,1,2012-04-28 18:22:58,2012-04-25 21:12:31
4da8a5df4b979ff426ccf6377e6e0bcf1f880111...2054d7ec88640bc2fe1a87f2a84caa7636bd106a,20,10767,5500,16267,562,2012-04-29 15:22:39,2012-04-29 13:49:29
2054d7ec88640bc2fe1a87f2a84caa7636bd106a...786d64a7027fde85e4f3374eb12ed3ceea607c0a,2,128,75,203,29,2012-04-29 17:59:39,2012-04-29 00:22:32
d3de3070eff732369d760b1ff6721641103d41f9...542e6d18478bfa558c2a2ea13f21b27d9e5669ce,2,66,63,129,49,2011-07-16 22:11:35,2011-07-16 22:11:35
542e6d18478bfa558c2a2ea13f21b27d9e5669ce...09a6f288b21b3f51f9682553eb5ec7e0ee857a5b,5,6,6,12,6,2011-07-16 22:18:03,2011-07-16 22:18:03
d3de3070eff732369d760b1ff6721641103d41f9...65e14132a54705a5ac6c3098e868b815ef76e81b,1,19,16,35,4,2011-07-16 17:28:00,2011-07-16 17:26:37
65e14132a54705a5ac6c3098e868b815ef76e81b...8e477b32eea5f9eede4bd60b67a4befad4c2d5b6,1,3,1,4,1,2011-07-16 19:06:43,2011-07-16 19:06:43
8e477b32eea5f9eede4bd60b67a4befad4c2d5b6...be97415494a5580b82ebe3a12064924ccac7b068,1,2,2,4,1,2011-07-16 20:49:52,2011-07-16 20:49:52
be97415494a5580b82ebe3a12064924ccac7b068...1a2e5dffc452c2d9eb24568c9fc42cece202caa9,1,2,1,3,2,2011-07-16 22:05:10,2011-07-16 22:05:10
1a2e5dffc452c2d9eb24568c9fc42cece202caa9...b128aeaf2b59508bbaa27ce337a74ced4640a3af,1,4,3,7,3,2011-07-16 22:06:14,2011-07-16 21:48:42
2ebc3ba2c8c2eb2ad022edbd600545ebdd5f2989...bbf97f794228cd6a2ce6c03e4db6820d1877c920,2,17,1,18,3,2011-10-06 17:07:44,2011-10-06 17:07:44
2ebc3ba2c8c2eb2ad022edbd600545ebdd5f2989...cade80c5d168253242127e35730d76874d0ee7ed,3,19,15,34,8,2011-10-06 02:03:16,2011-10-06 02:02:34
cade80c5d168253242127e35730d76874d0ee7ed...f60ba0af6448174a0d79e3c348c864265e9dc5e9,1,1,0,1,1,2011-10-06 02:36:15,2011-10-06 02:35:21
f60ba0af6448174a0d79e3c348c864265e9dc5e9...97c7de268e7799bb532f4a24a1244bf707de72cb,1,7,0,7,2,2011-10-06 13:58:18,2011-10-06 02:31:51
97c7de268e7799bb532f4a24a1244bf707de72cb...deb6498c0b82aea2d8fab203cd677884d356bc32,2,43,0,43,2,2011-10-06 14:26:03,2011-10-06 14:26:03
deb6498c0b82aea2d8fab203cd677884d356bc32...9b37bd734a82f39b1fb2e7ff3d3c008ae6b158ea,1,4,0,4,1,2011-10-06 14:26:37,2011-10-06 14:26:37
9b37bd734a82f39b1fb2e7ff3d3c008ae6b158ea...aa1e1ed57664ba12d66840f550c5258e520763e7,1,2,1,3,2,2011-10-06 14:35:11,2011-10-06 14:34:37
aa1e1ed57664ba12d66840f550c5258e520763e7...0ad766835b0dc6f21643501fd38bc4cabd306878,1,3,1,4,1,2011-10-06 14:38:18,2011-10-06 14:37:00
31bdfd739ea47d46c011a642acc3c37c3932dc14...6797ff911da4dc5307d02ebc86a07537d96b7ed4,9,407,351,758,123,2012-04-24 13:11:59,2012-04-24 13:11:59
6797ff911da4dc5307d02ebc86a07537d96b7ed4...82e407ad5ee9ea9c69c6d68c3c92e79934739a88,2,2,3,5,3,2012-04-24 14:19:58,2012-04-24 14:17:40
82e407ad5ee9ea9c69c6d68c3c92e79934739a88...0be87b207cca5eac3368be11f82276e131ec6017,4,3,23,26,6,2012-04-24 14:33:34,2012-04-24 14:17:42
0be87b207cca5eac3368be11f82276e131ec6017...847a67bf60807b4327b6d0d173c61ed84f522e79,5,3,10,13,5,2012-04-24 14:33:34,2012-04-24 14:26:28
847a67bf60807b4327b6d0d173c61ed84f522e79...6f576584b157e065d0addd43b5d86392f3628b81,7,16,13,29,17,2012-04-24 15:06:04,2012-04-24 15:06:04
6f576584b157e065d0addd43b5d86392f3628b81...adb534e4dcbfd7c78026a56df8316b5d11ee7997,5,14,13,27,8,2012-04-24 15:20:10,2012-04-24 15:04:45
adb534e4dcbfd7c78026a56df8316b5d11ee7997...2a68c8581ac6e333bb6ceee11dba0d7fc12414cf,1,6,0,6,3,2012-04-24 17:17:03,2012-04-24 17:16:15
2a68c8581ac6e333bb6ceee11dba0d7fc12414cf...464a9cec614243c782a9a3cb2127b7aaf671aff9,1,2,2,4,2,2012-04-24 17:55:39,2012-04-24 17:55:39
464a9cec614243c782a9a3cb2127b7aaf671aff9...fff16be71711c6edc2115696f582b7fd5eebe999,1,2,2,4,3,2012-04-24 18:03:06,2012-04-24 18:02:04
fff16be71711c6edc2115696f582b7fd5eebe999...5897f03e1526988a38b3b83be4867f9366865503,3,4,4,8,4,2012-04-24 18:03:20,2012-04-17 21:50:04
5897f03e1526988a38b3b83be4867f9366865503...4746c5f2802ab14551f1652d6618d0dd08459e1c,6,7,11,18,6,2012-04-24 18:05:01,2012-04-24 17:24:23
4746c5f2802ab14551f1652d6618d0dd08459e1c...a486732a251c80b4df9a04be3ef0ef34e7167e3b,1,17,15,32,7,2012-04-24 18:34:17,2012-04-24 18:34:17
a486732a251c80b4df9a04be3ef0ef34e7167e3b...f1eced224de959059275ff814fe1215845ac5b27,2,6,11,17,4,2012-04-24 19:41:24,2012-04-24 15:50:27
f1eced224de959059275ff814fe1215845ac5b27...5dda12ce95f136a06ad24cc3cf58606a51d058e5,2,4,0,4,2,2012-04-24 20:00:09,2012-04-24 20:00:09
5dda12ce95f136a06ad24cc3cf58606a51d058e5...86b4fde37e0b12ba38ace49157d1804b2d5e2983,2,46,1,47,4,2012-04-24 20:24:35,2012-04-24 20:16:37
86b4fde37e0b12ba38ace49157d1804b2d5e2983...ccd75a2f3f45d617d9585a45ab8ae8121dae5054,1,1,0,1,1,2012-04-24 23:19:24,2012-04-24 23:19:11
786d64a7027fde85e4f3374eb12ed3ceea607c0a...c865d831777986b7a90dfd1d39975f792174c715,1,2,2,4,2,2012-04-30 16:39:38,2012-04-30 06:35:28
786d64a7027fde85e4f3374eb12ed3ceea607c0a...100b489788f4c335e6df88606804c589f7cd6a5b,1,1,1,2,1,2012-04-30 16:29:56,2012-04-30 06:57:19
100b489788f4c335e6df88606804c589f7cd6a5b...8b099a96ac9b5a1f73954204806ef8e0c77d481a,1,9,0,9,2,2012-04-30 17:42:17,2012-04-30 17:42:02
8b099a96ac9b5a1f73954204806ef8e0c77d481a...fb6faacbd8562186b65c335f8b3d1a4bdd936beb,1,2,2,4,2,2012-04-30 18:42:39,2012-04-30 18:42:39
fb6faacbd8562186b65c335f8b3d1a4bdd936beb...7c50f4320f11865483541c8c092a0b482f5c51fc,1,8,0,8,2,2012-04-30 18:43:50,2012-04-30 14:50:17
7c50f4320f11865483541c8c092a0b482f5c51fc...f31d4d9acaee1e11f2ff0f1e84929ffb684ae053,1,25,10,35,14,2012-04-30 18:43:50,2012-04-30 15:26:55
f31d4d9acaee1e11f2ff0f1e84929ffb684ae053...a3551eadc4857ac4daf07837157909dc2d474c08,2,4,4,8,4,2012-04-30 19:10:02,2012-04-30 19:00:46
a3551eadc4857ac4daf07837157909dc2d474c08...912bc3c25f46041ee1a69a8bef1e6b083475392d,5,26,24,50,18,2012-04-30 20:10:21,2012-04-30 19:02:41
912bc3c25f46041ee1a69a8bef1e6b083475392d...ccd418fbda022c92b7f461716d1a1e95040ad149,6,24,0,24,12,2012-05-01 01:22:16,2012-05-01 01:22:16
ccd418fbda022c92b7f461716d1a1e95040ad149...6c1c98b332a4ebe2604462ccbf9f1af475734460,2,2,2,4,2,2012-05-01 13:47:14,2012-05-01 13:47:14
6c1c98b332a4ebe2604462ccbf9f1af475734460...e19932e004e63e9cf7808b9257e3925e8ef8bb3b,2,2,2,4,2,2012-05-02 02:42:06,2012-05-02 02:42:06
e19932e004e63e9cf7808b9257e3925e8ef8bb3b...edef03051328da75f30724be20b89bac73ab524d,1,1,2,3,2,2012-05-02 13:36:17,2012-04-30 18:56:47
edef03051328da75f30724be20b89bac73ab524d...b2161363a448a18755212103d6fe068d0ed44b0c,1,2,2,4,1,2012-05-02 13:36:17,2012-05-01 15:12:42
b2161363a448a18755212103d6fe068d0ed44b0c...5659bac32def14108aa1257bd06ae4f555cdbc4e,1,4,2,6,3,2012-05-02 13:36:17,2012-05-01 20:48:47
5659bac32def14108aa1257bd06ae4f555cdbc4e...90ea55df72b77558c7822d1a7d76991c415a5376,2,8,0,8,4,2012-05-02 14:00:11,2012-05-01 15:16:13
90ea55df72b77558c7822d1a7d76991c415a5376...c95d8f2fb93e3e9231a50ca4edfce447bd369b6b,2,0,0,0,0,2012-05-02 15:54:31,2012-05-02 15:54:04
c95d8f2fb93e3e9231a50ca4edfce447bd369b6b...6036305d64a81c3d52b2a023ffd02a8e222e19a3,1,3,0,3,1,2012-05-02 17:22:08,2012-05-02 17:22:08
6036305d64a81c3d52b2a023ffd02a8e222e19a3...15386cca10dbacebd4fc89754bfe152a0cdfd118,1,1,1,2,1,2012-05-02 17:42:50,2012-05-02 17:42:50
15386cca10dbacebd4fc89754bfe152a0cdfd118...caef9697736be733e83c3d3366354b70b8a87b89,1,4,4,8,3,2012-05-02 18:19:33,2012-05-02 18:18:53
caef9697736be733e83c3d3366354b70b8a87b89...e8d47fec603ef28a750a42f860ebe572007ddd10,1,0,16,16,1,2012-05-02 18:23:36,2012-05-01 18:04:20
e8d47fec603ef28a750a42f860ebe572007ddd10...e7f372246bacc255231d9b2c5a8d8483881ecdad,1,6,2,8,2,2012-05-02 18:43:43,2012-04-27 06:59:48
e7f372246bacc255231d9b2c5a8d8483881ecdad...fd58d40dc9685306676a5557a00eff202ed39369,1,22,22,44,16,2012-05-02 18:54:03,2012-05-02 18:53:38
fd58d40dc9685306676a5557a00eff202ed39369...a105cf0bb3b8bc8aac662441f53deae5e4e83462,1,0,3,3,1,2012-05-02 19:00:24,2012-05-01 21:39:31
a105cf0bb3b8bc8aac662441f53deae5e4e83462...8e5ae62d12cc50fcc7d85dae7804acae932433e1,14,73,77,150,70,2012-05-02 19:27:19,2012-05-02 19:26:44
8e5ae62d12cc50fcc7d85dae7804acae932433e1...1f29035b3bdf83c8c88b53749885cd3fff4e79e8,1,1,1,2,1,2012-05-02 19:42:26,2012-05-02 19:41:50
1f29035b3bdf83c8c88b53749885cd3fff4e79e8...481771ee5de7d1b4f70889685ca38d2cb6dffde9,1,1,1,2,1,2012-05-02 19:42:58,2012-05-02 19:42:58
481771ee5de7d1b4f70889685ca38d2cb6dffde9...dab5a8e8098dd99c962e05d1de801bed11aab84f,1,1,1,2,1,2012-05-02 19:45:16,2012-05-02 19:45:00
dab5a8e8098dd99c962e05d1de801bed11aab84f...d08d88535e30ffbee1c318cb8dfae537980c11d9,2,8,8,16,6,2012-05-02 22:04:11,2012-05-02 22:04:11
d08d88535e30ffbee1c318cb8dfae537980c11d9...0e527a87debcbb3074feafd796142f22f75e231b,2,12,0,12,2,2012-05-02 23:11:59,2012-05-02 21:45:31
0e527a87debcbb3074feafd796142f22f75e231b...b9f721a6f499a605d04da1579ded521fc0261b50,1,2,2,4,2,2012-05-03 00:10:20,2012-05-02 19:58:02
b9f721a6f499a605d04da1579ded521fc0261b50...dc5c2f528a870bab543e308f608036ecfb6441dd,1,23,30,53,4,2012-05-03 14:00:28,2012-05-03 14:00:28
af648971a8ffaf4742e5e9d7da48ad68c7bcfb9e...25fe57b9a377605d72bb65d1721f8bfd16e84987,1,7,7,14,2,2011-07-16 22:19:30,2011-07-16 22:19:30
4412a27087ae1e3d63d92d17bc3043c8997c7b32...b28ef7426abcebda1108bbf4217c36f371f62dc6,1,3,1,4,1,2011-10-06 18:55:30,2011-10-06 18:55:30
4412a27087ae1e3d63d92d17bc3043c8997c7b32...61d26a0e8cc53ce383ef69e8311de2decd37b057,1,1,6,7,1,2011-10-06 18:39:11,2011-10-06 18:37:01
61d26a0e8cc53ce383ef69e8311de2decd37b057...61bb89fb9cfa47f8ceab6cc37f4b7c74fe005d23,1,5,4,9,3,2011-10-06 18:39:11,2011-10-06 18:38:54
61bb89fb9cfa47f8ceab6cc37f4b7c74fe005d23...280b4857f6bd947f167b696a70f8a60c90b030a2,1,1,1,2,1,2011-10-06 18:59:21,2011-10-06 18:59:21
280b4857f6bd947f167b696a70f8a60c90b030a2...f2c8a4ca7782d214260fc9f0d713bbf558ca6a12,1,2,2,4,2,2011-10-06 19:43:17,2011-10-06 19:43:17
0ad766835b0dc6f21643501fd38bc4cabd306878...bd23dadfa472e937791d493cd5e2ef462f775652,1,1,1,2,1,2011-10-06 18:00:43,2011-10-06 18:00:43
bd23dadfa472e937791d493cd5e2ef462f775652...710c4d523695709266b911249141fb746f5b9046,3,10,5,15,7,2011-10-06 18:01:05,2011-10-06 18:01:05
0ad766835b0dc6f21643501fd38bc4cabd306878...3db92ac2093712967fa73da5a23ba8fd8a2e11d9,1,7,2,9,4,2011-10-06 15:25:13,2011-10-06 15:25:13
3db92ac2093712967fa73da5a23ba8fd8a2e11d9...243aaea5176106a04160b53a628954a8c3451250,1,1,1,2,1,2011-10-06 15:26:28,2011-10-04 20:53:48
243aaea5176106a04160b53a628954a8c3451250...850df11d14ee5b4ff0393d072b101cb1445ddd74,1,5,7,12,2,2011-10-06 15:26:28,2011-10-04 20:53:15
850df11d14ee5b4ff0393d072b101cb1445ddd74...e6722c36eae612754af5a7da499021b434600872,1,1,1,2,1,2011-10-06 15:27:18,2011-10-06 15:27:18
4aec455d992e716b7cf0ae2eb77022e606a00648...1ddfb03f5f6a905e53018cd99c70bf0d6b45c7cf,1,1,12,13,1,2012-05-03 19:55:56,2012-05-03 19:11:14
1ddfb03f5f6a905e53018cd99c70bf0d6b45c7cf...b118ba77c541b5f952cc9c3e418fee0644ee4c7f,2,54,76,130,15,2012-05-04 14:40:50,2012-04-27 08:25:46
b118ba77c541b5f952cc9c3e418fee0644ee4c7f...d75eb705da9cdaf506da3c65535ea9a1d72d09b4,2,19,2,21,7,2012-05-04 14:44:05,2012-05-01 02:43:54
d75eb705da9cdaf506da3c65535ea9a1d72d09b4...f0b25bf511f337d41ed39dc3bd87f3b0fba2bc29,1,1,1,2,1,2012-05-04 14:48:49,2012-05-04 08:33:43
f0b25bf511f337d41ed39dc3bd87f3b0fba2bc29...c29e53d9140f643846801b7b77bd98b0e074bb00,3,1,8,9,3,2012-05-04 17:03:12,2012-05-04 17:02:05
c29e53d9140f643846801b7b77bd98b0e074bb00...82a329872a7b77217f222705ec6f200f117824f1,2,216,0,216,2,2012-05-04 18:30:54,2012-05-04 18:20:25
82a329872a7b77217f222705ec6f200f117824f1...124323ab756f950700ead71821fe6337cefc2762,6,885,35,920,22,2012-05-04 19:09:13,2012-04-29 23:52:10
124323ab756f950700ead71821fe6337cefc2762...fd316dab6fdf5387c3195e2d10226d872e35854c,3,115,14,129,15,2012-05-04 19:09:13,2012-04-29 23:53:47
fd316dab6fdf5387c3195e2d10226d872e35854c...3e696b2c0d35167007ec443d80467bd54e1f6906,2,86,10,96,12,2012-05-04 19:09:13,2012-04-30 00:21:10
3e696b2c0d35167007ec443d80467bd54e1f6906...8871fb9e2fdb6845814177d39dbe62f8e142d488,6,61,41,102,21,2012-05-04 19:09:13,2012-05-04 18:01:28
8871fb9e2fdb6845814177d39dbe62f8e142d488...d61dfb6f36488d50236ba28a37a9c68326f6e46b,2,51,32,83,11,2012-05-04 19:09:14,2012-05-04 19:07:54
d61dfb6f36488d50236ba28a37a9c68326f6e46b...659fdc26b676bba513762b78c4526b6bb848e4ad,1,1,1,2,1,2012-05-04 19:14:58,2012-05-04 19:14:58
659fdc26b676bba513762b78c4526b6bb848e4ad...6e94259dfbcc301d00b36932dc501a634c3a794c,2,300,0,300,2,2012-05-04 19:52:15,2012-05-04 19:00:14
6e94259dfbcc301d00b36932dc501a634c3a794c...1f3ac382c4892f03a0d2c5da076fa5271867fbbc,2,76,54,130,15,2012-05-04 19:55:29,2012-05-04 19:51:21
1f3ac382c4892f03a0d2c5da076fa5271867fbbc...6999e383c698d7497b9e4e16b98422010f096321,1,2,2,4,2,2012-05-04 20:05:35,2012-05-04 19:53:35
6999e383c698d7497b9e4e16b98422010f096321...3126c21d8acb267a4d9fca4169927ccd0f7a29e8,16,26,567,593,24,2012-05-04 21:02:12,2012-05-04 21:02:12
3126c21d8acb267a4d9fca4169927ccd0f7a29e8...9939bf94c302b40681ec0c11da79c887274eb696,1,2,2,4,2,2012-05-04 21:07:08,2012-05-04 21:05:39
9939bf94c302b40681ec0c11da79c887274eb696...6a1df891eb93cf0f873943c7974ff2e3bb8c45e3,5,11,9,20,8,2012-05-05 00:54:31,2012-05-05 00:54:31
6a1df891eb93cf0f873943c7974ff2e3bb8c45e3...e5896ba5eec6ebed7369ff86b0c6273ff4beb776,9,27,27,54,25,2012-05-05 18:04:05,2012-04-28 05:33:57
e5896ba5eec6ebed7369ff86b0c6273ff4beb776...6fd439105bc2d94c216f9bc7a8180800ba7572fc,1,13,11,24,3,2012-05-05 18:04:05,2012-04-28 05:38:47
6fd439105bc2d94c216f9bc7a8180800ba7572fc...8434786dd10a0316d2a35329a57eeb6f115a8d90,2,5,4,9,5,2012-05-05 18:04:06,2012-04-29 00:06:19
8434786dd10a0316d2a35329a57eeb6f115a8d90...11491b034fd9d65356e548ba85659fef8e83d2f3,4,103,25,128,10,2012-05-05 18:04:06,2012-04-30 02:50:04
11491b034fd9d65356e548ba85659fef8e83d2f3...bfaff395710f25937141fcbfc9f1c062a1ae251d,1,12,11,23,3,2012-05-05 18:04:06,2012-04-30 02:55:45
bfaff395710f25937141fcbfc9f1c062a1ae251d...a1d10192150fe646ffde4db8041395c372b624cb,2,2,1,3,2,2012-05-05 18:04:06,2012-04-30 18:29:09
a1d10192150fe646ffde4db8041395c372b624cb...c9ca4235f0bbe11731263d512d2a5c96a78e57b4,1,1,1,2,1,2012-05-05 19:35:37,2012-05-05 19:35:37
c9ca4235f0bbe11731263d512d2a5c96a78e57b4...fed63e0abb8bfefeb1d4cd8e5e065019ccab9307,1,24,6,30,3,2012-05-06 13:41:38,2012-05-06 13:41:38
fed63e0abb8bfefeb1d4cd8e5e065019ccab9307...1ea09fe1acb0592c1d63a91a8655bb51b1f65085,1,17,7,24,9,2012-05-06 22:49:37,2012-05-06 22:49:37
1ea09fe1acb0592c1d63a91a8655bb51b1f65085...7ffdfd59814d73c483d7d507a6181b54bf52f304,2,42,0,42,8,2012-05-07 14:02:01,2012-05-07 14:02:01
7ffdfd59814d73c483d7d507a6181b54bf52f304...84e3c010d4e672751c7e96e169faa3f1d1c5c90f,1,25,3,28,4,2012-05-07 14:17:19,2012-05-06 20:58:49
84e3c010d4e672751c7e96e169faa3f1d1c5c90f...94559111b0c2e754bb9b16863de8f96fff83819e,2,56,46,102,35,2012-05-07 14:35:36,2012-04-25 18:59:03
94559111b0c2e754bb9b16863de8f96fff83819e...e322222f11d715fb66b9bf9f7b43f7fad244dace,2,27,44,71,11,2012-05-07 14:35:36,2012-04-25 19:33:59
e322222f11d715fb66b9bf9f7b43f7fad244dace...a412d552b19299faadc967fe1f4d91cb1bd36dde,2,35,20,55,8,2012-05-07 14:35:36,2012-04-27 16:05:05
a412d552b19299faadc967fe1f4d91cb1bd36dde...798548691180ea5c7b35ead49361b4def3c82fac,3,63,54,117,3,2012-05-07 14:35:36,2012-04-27 16:12:46
798548691180ea5c7b35ead49361b4def3c82fac...a890dea68e9f415346db3e69608612843005acec,6,283,256,539,10,2012-05-07 14:35:36,2012-04-27 19:05:30
a890dea68e9f415346db3e69608612843005acec...79c22f5fc15d746e3ca2064b4e138db61f132811,1,129,122,251,29,2012-05-07 14:35:36,2012-04-27 21:49:45
79c22f5fc15d746e3ca2064b4e138db61f132811...ea480461f0ba0af13d0849f9a3427a0150e57082,1,2,2,4,2,2012-05-07 14:35:36,2012-04-28 05:21:01
ea480461f0ba0af13d0849f9a3427a0150e57082...57ce7507c8407d002ab8f87754a180247cd7482f,6,104,0,104,6,2012-05-07 14:35:36,2012-04-28 05:21:17
57ce7507c8407d002ab8f87754a180247cd7482f...2c70064990628ec70af2c302946b154aa73c995d,3,3,3,6,3,2012-05-07 14:35:36,2012-04-28 07:42:44
2c70064990628ec70af2c302946b154aa73c995d...819caabaf91d994406786bcca68b3efd9fc25535,1,2,0,2,1,2012-05-07 14:35:36,2012-04-28 15:51:05
819caabaf91d994406786bcca68b3efd9fc25535...5a3c5863da0c5290f8b4b7156049f4ac9b96e0f8,1,1,1,2,1,2012-05-07 14:35:36,2012-05-07 14:35:17
5a3c5863da0c5290f8b4b7156049f4ac9b96e0f8...ffd0be5ee040354620422c01503de6b5ab31f782,2,42,37,79,6,2012-05-07 16:49:19,2012-05-07 16:47:56
ffd0be5ee040354620422c01503de6b5ab31f782...e1c61e1e80a901b7471dfa85e79becaf36843039,9,276,4563,4839,300,2012-05-07 17:57:59,2012-05-07 17:57:59
e1c61e1e80a901b7471dfa85e79becaf36843039...33730732395c1e6eeb9eb3468593fd69ee3e3f93,1,0,1,1,1,2012-05-07 21:49:10,2012-05-05 02:20:47
33730732395c1e6eeb9eb3468593fd69ee3e3f93...82cdd3bacbcd75e720ccfef88742d8c028480e9d,1,1,1,2,1,2012-05-08 12:45:37,2012-05-08 12:45:37
82cdd3bacbcd75e720ccfef88742d8c028480e9d...a69c9e92ba41cf05c0bb383af12e40466a3b802a,1,1,1,2,1,2012-05-08 16:10:03,2012-05-08 16:10:03
a69c9e92ba41cf05c0bb383af12e40466a3b802a...499f7cb1eec62e19e6566b41c53b9c5c9f5478fb,2,24,16,40,5,2012-05-08 16:26:23,2012-05-08 16:26:23
499f7cb1eec62e19e6566b41c53b9c5c9f5478fb...b7aec8e578bfaca25506f3f540364b40525ee303,1,1,5,6,1,2012-05-08 16:30:32,2012-05-08 16:30:32
b7aec8e578bfaca25506f3f540364b40525ee303...822d02fb1030fda3a9ae8a79049a788d68b78897,1,2,3,5,2,2012-05-08 16:38:08,2012-05-08 16:38:08
822d02fb1030fda3a9ae8a79049a788d68b78897...4664de378f0281354067e4623ac6b395395f120c,1,1,1,2,1,2012-05-08 16:50:35,2012-05-08 16:50:35
25fe57b9a377605d72bb65d1721f8bfd16e84987...dc21c06d0f672167c12a8b84a3d68da33e76e77a,2,11,11,22,7,2011-07-16 22:42:29,2011-07-16 22:42:29
25fe57b9a377605d72bb65d1721f8bfd16e84987...3a5ebf3c855df76c97c917539d080ac50dee9b7d,1,2,2,4,1,2011-07-16 22:41:10,2011-07-16 22:39:38
1f8f805cbfcfece80ebb9760687dc527fc5dbb3e...56dcba4d28a1b147c2beeb66860e1fe1b78df923,2,27,22,49,4,2011-10-07 17:40:20,2011-10-07 17:40:20
1f8f805cbfcfece80ebb9760687dc527fc5dbb3e...9ee903691100cdc1968a494fefd0991db6e51f04,1,4,2,6,2,2011-10-06 20:36:59,2011-10-06 20:36:39
9ee903691100cdc1968a494fefd0991db6e51f04...bcd56a1ebcca7459a4b9e8997c298e4c24e5fc1f,2,9,1,10,2,2011-10-06 20:57:40,2011-10-06 20:51:28
bcd56a1ebcca7459a4b9e8997c298e4c24e5fc1f...fe53945762ac548cd06814c1fdfbd07469471091,1,2,2,4,2,2011-10-06 21:05:48,2011-10-06 21:05:48
fe53945762ac548cd06814c1fdfbd07469471091...553cf24b3689322814dd6af4705f5092756d25a7,1,1,1,2,1,2011-10-06 21:14:36,2011-10-06 21:14:36
553cf24b3689322814dd6af4705f5092756d25a7...a1982dd5ba86f6ce7617a83f63b45444af20e9c2,1,2,0,2,1,2011-10-06 21:22:12,2011-10-06 21:22:12
a1982dd5ba86f6ce7617a83f63b45444af20e9c2...dfdb07b116bef4c8a39700667cc4ec7559b9bbe5,3,19,3,22,8,2011-10-06 21:29:50,2011-10-06 21:26:39
dfdb07b116bef4c8a39700667cc4ec7559b9bbe5...7aeb465f363fc0af44adad7cb468b6d1c228695d,1,2,0,2,1,2011-10-06 21:31:32,2011-10-06 14:01:03
7aeb465f363fc0af44adad7cb468b6d1c228695d...671f4e1afb4bc16a718809f0dbe48a00e517ea72,1,2,4,6,2,2011-10-06 21:36:52,2011-10-06 21:30:04
671f4e1afb4bc16a718809f0dbe48a00e517ea72...0bb6c4774a5e338ea77df82db0117d243288f41f,4,7,17,24,6,2011-10-06 22:09:32,2011-10-06 22:09:04
0bb6c4774a5e338ea77df82db0117d243288f41f...dfd49fc99cdaaa8857b6d5b7e0282c9bb2b11dbe,2,16,5,21,6,2011-10-06 22:16:51,2011-10-06 19:38:56
dfd49fc99cdaaa8857b6d5b7e0282c9bb2b11dbe...def4d0cb8d3f657b013f6c06c8d923079ceed755,1,2,2,4,2,2011-10-06 22:44:40,2011-10-06 22:44:40
def4d0cb8d3f657b013f6c06c8d923079ceed755...fedce713e91f0a664cf244bafa730898f73d98c8,4,82,4,86,6,2011-10-06 23:55:51,2011-10-06 23:54:59
fedce713e91f0a664cf244bafa730898f73d98c8...d312c1abe458919c977cbb82ba3970f8af456478,1,2,2,4,2,2011-10-07 00:30:14,2011-10-07 00:30:14
d312c1abe458919c977cbb82ba3970f8af456478...e03ce18ac0ddce659e808256bedcbb4acd8fb080,2,94,73,167,25,2011-10-07 07:33:51,2011-10-07 07:33:51
e03ce18ac0ddce659e808256bedcbb4acd8fb080...2ed73366ebd945895fe1b3882f4978a866722259,1,25,0,25,1,2011-10-07 07:35:52,2011-10-07 07:35:52
2ed73366ebd945895fe1b3882f4978a866722259...5810ac31bda6588dd2651eecac8bce48c907a827,2,26,11,37,14,2011-10-07 08:05:08,2011-10-07 08:05:08
4664de378f0281354067e4623ac6b395395f120c...4cc8a4b19400d98ad1564c57010db68b4dc4b6f4,3,14,5,19,9,2012-05-09 18:28:31,2012-05-09 18:28:31
4664de378f0281354067e4623ac6b395395f120c...f799d9d40e4e14249a11cdf1e9fdb31a5bb09325,2,1,6,7,3,2012-05-08 23:01:20,2012-05-03 00:31:00
f799d9d40e4e14249a11cdf1e9fdb31a5bb09325...abbd41d2ea694f1e708ff86be7c70f1d5139c584,2,4,4,8,4,2012-05-09 12:53:00,2012-05-09 12:51:45
abbd41d2ea694f1e708ff86be7c70f1d5139c584...ecc718874c226c0670700298f3f3e03ed7f82a62,1,1,1,2,1,2012-05-09 13:34:13,2012-05-04 15:33:49
ecc718874c226c0670700298f3f3e03ed7f82a62...a0d04bc7edb687ad58eff4ba6c7369190d62ada4,3,18,36,54,15,2012-05-09 13:34:13,2012-05-04 15:54:53
a0d04bc7edb687ad58eff4ba6c7369190d62ada4...15770de1f88984d5dc54650061d340fbaa1b0586,5,489,174,663,65,2012-05-09 13:56:29,2012-05-04 21:07:38
15770de1f88984d5dc54650061d340fbaa1b0586...9e1d746c9c7865c5644ec623b63d4cc6e6249c74,1,7,0,7,1,2012-05-09 14:00:33,2012-05-09 04:26:55
9e1d746c9c7865c5644ec623b63d4cc6e6249c74...d07386582932b442c9bab58dec1e44d2b67c0d6b,4,36,36,72,20,2012-05-09 14:12:28,2012-05-09 14:12:28
d07386582932b442c9bab58dec1e44d2b67c0d6b...ea82f5b5be6f73634c73ce031434ae32c4c66c59,7,564,8,572,16,2012-05-09 14:30:23,2012-05-03 21:37:28
ea82f5b5be6f73634c73ce031434ae32c4c66c59...9752fd84d5bf78b9f8ee8fdfb2276090e015311f,1,2,2,4,2,2012-05-09 14:48:23,2012-05-09 14:48:23
9752fd84d5bf78b9f8ee8fdfb2276090e015311f...8e80bc36e29cdb47eb07e13d14ae0a0af6cd3084,1,4,4,8,4,2012-05-09 17:02:15,2012-05-09 16:41:23
8e80bc36e29cdb47eb07e13d14ae0a0af6cd3084...ccc9b9e5139188fd80a278ef94453e6c905d2639,3,6,1,7,4,2012-05-09 17:21:19,2012-05-09 17:21:19
ccc9b9e5139188fd80a278ef94453e6c905d2639...f15931d902441c5d3b881a0ab8222a5ca8e8303c,1,14,13,27,4,2012-05-09 17:25:23,2012-05-09 17:25:23
f15931d902441c5d3b881a0ab8222a5ca8e8303c...d755084b016461e4deed7712467575d0e075a983,3,15,21,36,9,2012-05-09 18:30:20,2012-05-09 18:09:32
d755084b016461e4deed7712467575d0e075a983...46ec6774dbafb1b53c1a4aebaf98596aa4b96a86,6,58,30,88,9,2012-05-09 18:31:00,2012-05-09 18:29:07
247428114d2ee82b19b391b41ac18b38ae55c22f...c0f7225c6221ac0dd9f361323153aad9c7c9fb95,2,12,8,20,8,2011-07-16 22:56:59,2011-07-16 22:56:59
c0f7225c6221ac0dd9f361323153aad9c7c9fb95...6064eb3b40a0548cd1d0039d0539c91f4c9773ec,1,1,1,2,1,2011-07-17 03:22:55,2011-07-17 03:22:55
6064eb3b40a0548cd1d0039d0539c91f4c9773ec...ab60ebb7ae8143021a67968d899c0ffd601971a4,4,15,24,39,10,2011-07-17 13:07:15,2011-07-17 13:07:15
ab60ebb7ae8143021a67968d899c0ffd601971a4...1ab3f66a6e7852c55c2cd5a5b60793a431a7764a,2,16,8,24,5,2011-07-17 14:07:42,2011-07-17 14:07:42
1ab3f66a6e7852c55c2cd5a5b60793a431a7764a...bf0e20d28fd1bc78558e30f94beaef76e8d6f3ef,3,50,5,55,11,2011-07-17 14:31:25,2011-07-17 14:31:25
bf0e20d28fd1bc78558e30f94beaef76e8d6f3ef...40da397926132458f45255253c5c8ea6279fe872,1,1,1,2,1,2011-07-17 19:15:18,2011-07-17 19:15:18
40da397926132458f45255253c5c8ea6279fe872...0ba84cb05156f1f3a1af90ad6ab598acc32d3c15,1,12,11,23,7,2011-07-17 19:17:23,2011-07-17 19:17:23
0ba84cb05156f1f3a1af90ad6ab598acc32d3c15...befcc695533aa9cb7275fb7cdac0844a695c72d5,1,5,1,6,5,2011-07-17 19:28:01,2011-07-17 19:28:01
befcc695533aa9cb7275fb7cdac0844a695c72d5...f8a3803df94ac10ddda274b97506e4961aada11d,1,1,1,2,1,2011-07-18 00:52:57,2011-07-18 00:52:57
f8a3803df94ac10ddda274b97506e4961aada11d...5060fd51cb8b76c21bfda7f1656fb364bed3e588,1,3,3,6,1,2011-07-18 02:58:40,2011-07-18 02:58:40
5060fd51cb8b76c21bfda7f1656fb364bed3e588...495bd6a90b0034f9ef5064601bec12535dbec898,2,2,2,4,2,2011-07-18 03:04:40,2011-07-18 03:04:40
495bd6a90b0034f9ef5064601bec12535dbec898...70ef42d2235a48ab95e923135292873670956b29,1,1,1,2,1,2011-07-18 12:17:51,2011-07-18 12:17:51
70ef42d2235a48ab95e923135292873670956b29...994f0a6a01fce88ce96a792f966e81c675d884c9,1,51,18,69,4,2011-07-18 15:54:50,2011-07-18 15:54:50
994f0a6a01fce88ce96a792f966e81c675d884c9...802c28809cef43ff012788ead822622dd05138fa,1,16,9,25,7,2011-07-18 20:22:19,2011-07-18 20:22:04
802c28809cef43ff012788ead822622dd05138fa...11c37403d9249ed92393015e0d69bb6d9f961157,1,1,1,2,1,2011-07-18 20:29:59,2011-07-18 20:29:59
11c37403d9249ed92393015e0d69bb6d9f961157...8165107bdac52a0bf34ea75e54335086e04a51cb,1,1,1,2,1,2011-07-18 20:32:15,2011-07-18 20:32:15
8165107bdac52a0bf34ea75e54335086e04a51cb...0adffac1b2dd31105666047e67f04a46c24816a0,2,6,1,7,2,2011-07-18 21:01:44,2011-07-18 21:01:44
0adffac1b2dd31105666047e67f04a46c24816a0...662f3f6611ac69b4b63dddb48cf750daf6b768b7,2,6,1,7,5,2011-07-18 21:06:22,2011-07-18 21:06:06
662f3f6611ac69b4b63dddb48cf750daf6b768b7...b3e61c8c6bfc59641895e247e48da7ffaca37e57,1,31,28,59,11,2011-07-18 22:08:12,2011-07-18 22:07:47
b3e61c8c6bfc59641895e247e48da7ffaca37e57...bb7a5f9f7b01b11419dbcf26a537f1d1c5e8f6d8,1,8,7,15,3,2011-07-19 00:18:44,2011-07-19 00:18:44
bb7a5f9f7b01b11419dbcf26a537f1d1c5e8f6d8...d69d4be02e19beb491bb94b3e9876c175613a399,1,0,1,1,1,2011-07-19 01:31:28,2011-07-19 01:23:43
d69d4be02e19beb491bb94b3e9876c175613a399...b9270b6e5e103613aee015e72d278ef6cd79140e,2,12,5,17,5,2011-07-19 06:02:12,2011-07-19 05:44:33
b9270b6e5e103613aee015e72d278ef6cd79140e...fe780890af176df004060960e668c633af5d2a21,2,159,10,169,20,2011-07-19 14:44:52,2011-07-19 14:44:52
fe780890af176df004060960e668c633af5d2a21...d5b424de15da09f13ddfb8e1c10cd39a06bf5907,1,4,1,5,1,2011-07-19 14:46:48,2011-07-19 14:46:48
d5b424de15da09f13ddfb8e1c10cd39a06bf5907...ddc126039306b4d5166a01f4eabe9aeeea8e282c,1,2,0,2,1,2011-07-19 15:53:41,2011-07-19 15:53:41
ddc126039306b4d5166a01f4eabe9aeeea8e282c...5af8429d976d9c49722bb6b5b471bc22acd18f8d,1,14,5,19,5,2011-07-19 18:17:08,2011-07-19 18:17:08
5af8429d976d9c49722bb6b5b471bc22acd18f8d...5ec2c61413351ae1f9f5e4b4c1a22b9bbf77903a,1,4,0,4,3,2011-07-19 18:59:10,2011-07-19 18:59:10
5ec2c61413351ae1f9f5e4b4c1a22b9bbf77903a...8e0ccdf43fd21d36e9e1f5047afe6f690ef17f54,1,13,4,17,4,2011-07-19 20:46:40,2011-07-19 20:46:40
76ea72711cd6e28c44368d29782afca64b206a01...359a4fe9283f2e4b8300b26a07602e9d0df308d0,1,1,0,1,1,2011-10-07 21:10:54,2011-10-07 21:10:54
359a4fe9283f2e4b8300b26a07602e9d0df308d0...201bda78ec4801c6cf2f6b615760c49b6710e8ba,1,1,1,2,1,2011-10-07 21:11:06,2011-10-07 21:11:06
5810ac31bda6588dd2651eecac8bce48c907a827...9587418f27b39ff78290517856bfca2b69a2fd15,2,26,8,34,6,2011-10-07 15:35:56,2011-10-07 15:35:56
9587418f27b39ff78290517856bfca2b69a2fd15...7d1f8704dddd74678653c4f951528e4a5a31cb05,1,26,31,57,20,2011-10-07 15:55:04,2011-10-07 15:54:58
5810ac31bda6588dd2651eecac8bce48c907a827...5fc6cf8da8fe99ce291062827812a1c03deaa38d,1,2,2,4,2,2011-10-07 15:04:51,2011-10-07 15:04:51
0a20dadfa07130eee928be4150247025793fdf68...7d4361545584baaddc7b8aa5500bc5da42d0a6f2,1,5,5,10,1,2012-05-09 18:38:01,2012-05-09 18:38:01
7d4361545584baaddc7b8aa5500bc5da42d0a6f2...d4424fa5fbbed61d6bb229cf6f7f32f89fee6aa1,1,18,10,28,6,2012-05-09 19:57:48,2012-05-08 16:10:35
d4424fa5fbbed61d6bb229cf6f7f32f89fee6aa1...577a0c207e8ddb3fb9a18574654d80c670e2613f,1,0,240,240,2,2012-05-09 20:17:24,2012-05-09 20:16:23
577a0c207e8ddb3fb9a18574654d80c670e2613f...e89e5504a42cac38fc238789b116f06e6be2fe65,1,1,1,2,1,2012-05-09 21:12:26,2012-05-09 21:12:26
e89e5504a42cac38fc238789b116f06e6be2fe65...c6577a355862b5cc7c058701dd1a30dad3fd115f,1,4,2,6,3,2012-05-09 21:15:02,2012-05-09 21:12:17
c6577a355862b5cc7c058701dd1a30dad3fd115f...e7e665ca44e2b93bb08b78d0e116e4ebf5bb2c41,2,32,7,39,6,2012-05-09 22:06:07,2012-05-09 21:56:55
e7e665ca44e2b93bb08b78d0e116e4ebf5bb2c41...1d335a6c1b59432af84f60a01b1ec6fed170b18c,4,83,21,104,23,2012-05-09 23:14:14,2012-05-09 23:14:14
1d335a6c1b59432af84f60a01b1ec6fed170b18c...471c7fd33b379dc424d8ce803c48c2de4b05f5e3,1,7,26,33,17,2012-05-10 03:17:31,2012-05-10 03:17:31
471c7fd33b379dc424d8ce803c48c2de4b05f5e3...9c1fde019c6d1f6023e7576de58865bab06741a2,1,8,0,8,2,2012-05-10 03:38:25,2012-05-10 03:38:25
9c1fde019c6d1f6023e7576de58865bab06741a2...c8396e3ec32f3716a20de2d0c9a13b5b2d466d69,3,5,14,19,9,2012-05-10 14:31:04,2012-05-10 14:29:15
c8396e3ec32f3716a20de2d0c9a13b5b2d466d69...cec032b7977f65f405235d705f944965656876c5,19,42,0,42,20,2012-05-10 15:22:33,2012-05-10 14:44:18
cec032b7977f65f405235d705f944965656876c5...ee890995017005e64840723e6e1de39fcbf0845a,1,2,2,4,2,2012-05-10 15:33:57,2012-05-10 15:33:07
ee890995017005e64840723e6e1de39fcbf0845a...3e72e558321bfee0c36d886daf298a4074a50c66,1,47,2,49,18,2012-05-10 15:41:12,2012-05-10 15:41:12
3e72e558321bfee0c36d886daf298a4074a50c66...9b8f51ca857ef6c5191e5cb7d58a5a3c51ee97cf,1,3,0,3,1,2012-05-10 16:15:52,2012-05-10 16:15:18
9b8f51ca857ef6c5191e5cb7d58a5a3c51ee97cf...07fe3c72816a6e6fbed0505387f222fb968b66f8,1,26,23,49,8,2012-05-10 17:26:05,2012-05-10 16:13:20
07fe3c72816a6e6fbed0505387f222fb968b66f8...c0ca6541e89e5490a84e32ec792428f4a4d12f50,5,272,223,495,19,2012-05-10 17:28:58,2012-05-10 14:43:53
8e0ccdf43fd21d36e9e1f5047afe6f690ef17f54...dced9acda8be7c6aa22658d582cd17442efc9281,1,20,5,25,2,2011-07-22 06:10:21,2011-07-22 06:10:21
dced9acda8be7c6aa22658d582cd17442efc9281...eced9583f77c6fb5ec02cb6aac1d77b8a8e877c2,1,1,1,2,1,2011-07-22 15:46:49,2011-07-22 15:46:49
eced9583f77c6fb5ec02cb6aac1d77b8a8e877c2...643c49042ff73366870f2567159ae436c278fc09,3,11,2,13,4,2011-07-22 16:44:28,2011-07-22 16:44:28
643c49042ff73366870f2567159ae436c278fc09...c98880c44af9725e785d387691d1b9ea7bf9465e,2,42,27,69,5,2011-07-22 17:36:24,2011-07-22 17:36:24
c98880c44af9725e785d387691d1b9ea7bf9465e...f6b83ae5777f47660e0e0cc64042c35eeee9176b,1,25,6,31,5,2011-07-23 15:54:34,2011-07-23 15:54:34
f6b83ae5777f47660e0e0cc64042c35eeee9176b...46524b3be5c086b946da4935606da6354c56b686,1,2,0,2,1,2011-07-24 04:55:57,2011-07-24 04:55:57
46524b3be5c086b946da4935606da6354c56b686...a33ed96808bbeaac501e94885bc1f9fdbde42ee2,1,21,10,31,7,2011-07-24 04:56:06,2011-07-24 04:56:06
a33ed96808bbeaac501e94885bc1f9fdbde42ee2...6dc1f0470801ef1b617ec8ecacc4979f58add07f,1,20,20,40,2,2011-07-24 05:06:31,2011-07-24 05:06:31
6dc1f0470801ef1b617ec8ecacc4979f58add07f...6bbb403dfee641428f16c156458214ed60e3e173,1,19,6,25,5,2011-07-24 05:11:20,2011-07-24 05:11:20
6bbb403dfee641428f16c156458214ed60e3e173...d539be551039c51415db9a887f8d01abf7a20290,2,14,2,16,4,2011-07-24 15:20:43,2011-07-24 15:20:43
d539be551039c51415db9a887f8d01abf7a20290...89e2cce2c86693fde7a1ec88a80c21eb7a24f8c7,1,6,0,6,1,2011-07-24 15:20:53,2011-07-24 15:20:53
89e2cce2c86693fde7a1ec88a80c21eb7a24f8c7...3bd8786b0d3e800b464af3f8985ceda5a024465e,1,4,15,19,1,2011-07-24 15:35:14,2011-07-24 15:35:14
3bd8786b0d3e800b464af3f8985ceda5a024465e...d234f39997f97f0ad526640790fbc4711dd3f8fc,1,38,38,76,7,2011-07-24 16:15:38,2011-07-24 16:06:50
d234f39997f97f0ad526640790fbc4711dd3f8fc...81e1e071ce415c93cb81d3fa69f2eb4a42d83dd5,1,81,71,152,1,2011-07-24 16:15:40,2011-07-24 16:14:08
81e1e071ce415c93cb81d3fa69f2eb4a42d83dd5...04b1ee487423c7ab36ee93d310ffd8effe7974f5,1,8,6,14,2,2011-07-25 03:34:16,2011-07-25 03:33:46
04b1ee487423c7ab36ee93d310ffd8effe7974f5...46352846f5abfda31263dadc710a993358ba27b5,1,2,1,3,2,2011-07-25 05:35:13,2011-07-25 05:34:42
46352846f5abfda31263dadc710a993358ba27b5...06aa6738902eb1caa92b86501940ee69d1ba1bb5,1,5,9,14,2,2011-07-25 14:31:41,2011-07-25 14:31:41
06aa6738902eb1caa92b86501940ee69d1ba1bb5...79fcca753b6ea2f6b3d9285a58e23ace4c8707a0,2,42,19,61,14,2011-07-25 16:29:30,2011-07-25 16:27:36
79fcca753b6ea2f6b3d9285a58e23ace4c8707a0...84066dcac9e67e3c371ca3f655fd2deb9c37a9e3,3,9,7,16,6,2011-07-25 17:20:25,2011-07-25 17:20:25
84066dcac9e67e3c371ca3f655fd2deb9c37a9e3...20d187b43113abdb4f07c93e1275119d8d04d960,1,1,1,2,1,2011-07-25 19:17:55,2011-07-25 19:15:37
20d187b43113abdb4f07c93e1275119d8d04d960...4b6271dffc6f3e36d0277ba7e0654039201074dd,1,12,0,12,2,2011-07-25 19:52:36,2011-07-25 19:51:42
4b6271dffc6f3e36d0277ba7e0654039201074dd...176dad642aac428be5634a5ad0359441de277aac,1,3,0,3,1,2011-07-25 19:52:36,2011-07-25 19:52:00
176dad642aac428be5634a5ad0359441de277aac...a08904e8868a10ba677ebb04dcd5586b83460551,1,7,4,11,1,2011-07-25 19:52:36,2011-07-25 19:52:19
a08904e8868a10ba677ebb04dcd5586b83460551...62961e21202b4161376aa4c0fa484e0eb6cf559a,1,69,55,124,2,2011-07-25 21:51:53,2011-07-25 21:51:53
62961e21202b4161376aa4c0fa484e0eb6cf559a...d54ce5475c30358887c5d385714e96daa337c761,1,6,2,8,1,2011-07-25 23:03:56,2011-07-25 23:03:56
d54ce5475c30358887c5d385714e96daa337c761...302856ab3292acd58052e5e4a8af9389f6bd7f3f,1,17,2,19,2,2011-07-26 02:14:14,2011-07-26 02:14:14
302856ab3292acd58052e5e4a8af9389f6bd7f3f...dfcdcf1853aeccad42741e8fe858dd5c3056f888,4,9,3,12,4,2011-07-26 05:27:03,2011-07-26 05:27:03
dfcdcf1853aeccad42741e8fe858dd5c3056f888...927f3ace92c4c2dac484de159ba1fce58f63b0dc,2,2,2,4,2,2011-07-26 14:22:12,2011-07-26 14:22:12
927f3ace92c4c2dac484de159ba1fce58f63b0dc...7ab832da996558f05cfbeea69c40d2852cf6d68a,1,3,3,6,3,2011-07-26 14:33:00,2011-07-12 21:29:43
7ab832da996558f05cfbeea69c40d2852cf6d68a...eaf7961e83afb62e65e9f6993127700f677c7dff,1,141,91,232,29,2011-07-26 14:33:00,2011-06-30 16:07:43
eaf7961e83afb62e65e9f6993127700f677c7dff...f44433b04cf079fac0300a33798d62a3754af7d3,3,157,77,234,28,2011-07-26 14:33:01,2011-06-30 21:22:27
f44433b04cf079fac0300a33798d62a3754af7d3...bcf0b72b4afcf2cc54feb14300309351f6c3ee69,4,154,1,155,5,2011-07-26 14:33:01,2011-07-06 21:44:53
bcf0b72b4afcf2cc54feb14300309351f6c3ee69...3da3871e653ba2cfdaa2183da5bbf9fc563e817e,1,5,1,6,2,2011-07-26 14:33:01,2011-07-12 20:07:23
3da3871e653ba2cfdaa2183da5bbf9fc563e817e...39032a0f977ca4360fa9077dd24b5e03269db993,3,48,4,52,4,2011-07-26 14:33:01,2011-07-22 22:32:36
39032a0f977ca4360fa9077dd24b5e03269db993...8e6949567a1c329f26a675fd9160e1f2f7f251ff,1,1,1,2,1,2011-07-26 14:58:01,2011-07-26 14:58:01
8e6949567a1c329f26a675fd9160e1f2f7f251ff...7cf75927e2bcd77906b02eab5ed2c8edbc0aa6f2,1,4,1,5,1,2011-07-26 15:42:51,2011-07-26 15:42:51
7cf75927e2bcd77906b02eab5ed2c8edbc0aa6f2...6e071cc384a730088c32395fe7e00635eff13e75,1,2,1,3,2,2011-07-26 18:34:24,2011-07-26 18:34:24
6e071cc384a730088c32395fe7e00635eff13e75...6683d09c4c98de7d2dc2b8025bb29a82b5bd0197,2,3,1,4,2,2011-07-26 21:38:00,2011-07-26 21:38:00
6683d09c4c98de7d2dc2b8025bb29a82b5bd0197...20a0374718d9b1031cd1e023e3b131ee9c0370ff,3,59,1,60,8,2011-07-26 22:07:29,2011-07-26 22:07:29
20a0374718d9b1031cd1e023e3b131ee9c0370ff...d7c3dc68378e366ad261131c5d39545f3d5a1abf,1,19,5,24,6,2011-07-26 22:08:19,2011-07-26 22:08:19
d7c3dc68378e366ad261131c5d39545f3d5a1abf...639571e9665af55784ec7172958d605c84c0a4f6,6,228,29,257,32,2011-07-27 13:48:35,2011-07-13 22:37:26
639571e9665af55784ec7172958d605c84c0a4f6...5ae3b3bc3f348b51696cdae9cf77320e3a764514,8,24,12,36,13,2011-07-27 13:48:35,2011-07-14 14:38:32
5ae3b3bc3f348b51696cdae9cf77320e3a764514...8b1fdeb8cb8650a10004af9e3eb241d0244aea41,2,10,14,24,3,2011-07-27 13:48:35,2011-07-14 14:41:34
8b1fdeb8cb8650a10004af9e3eb241d0244aea41...aca86b476f84848c0d6cec7dc55d2fb4cdc03131,1,1,3,4,1,2011-07-27 13:48:35,2011-07-14 15:06:28
aca86b476f84848c0d6cec7dc55d2fb4cdc03131...4f688e70552d4b899decfbb59d034bf86f3798f6,1,4,5,9,5,2011-07-27 13:48:35,2011-07-14 15:08:48
4f688e70552d4b899decfbb59d034bf86f3798f6...efae0e1fffe89143b76376d2626d187381dd9512,2,28,1,29,7,2011-07-27 13:48:35,2011-07-15 21:56:15
efae0e1fffe89143b76376d2626d187381dd9512...aa71b5a74523807fe6596e83c4441246b83420c5,2,3,0,3,2,2011-07-27 13:48:35,2011-07-15 21:56:40
aa71b5a74523807fe6596e83c4441246b83420c5...eebca3c6a847a87270b892dcf1dfa8ac9c720aec,5,128,24,152,18,2011-07-27 13:48:35,2011-07-18 21:37:04
eebca3c6a847a87270b892dcf1dfa8ac9c720aec...446252880c37545f45d5b77a25f89579a6e47460,3,1,7,8,4,2011-07-27 13:48:35,2011-07-18 21:37:12
446252880c37545f45d5b77a25f89579a6e47460...23af33c9f804e60067cb03b351d7017f00a1f77a,1,5,5,10,5,2011-07-27 13:48:35,2011-07-26 19:33:17
23af33c9f804e60067cb03b351d7017f00a1f77a...f84bf1a41a3416b68aeb1e855602dfa8765fb19f,6,82,1,83,15,2011-07-27 13:48:35,2011-07-26 21:23:42
f84bf1a41a3416b68aeb1e855602dfa8765fb19f...b49d787b3347546c3e5f7bf232bc85af65837b80,1,1,1,2,1,2011-07-27 13:48:35,2011-07-27 10:35:52
b49d787b3347546c3e5f7bf232bc85af65837b80...8f27050318e29fe960326979a959966dc7a7b0ad,2,5,3,8,4,2011-07-27 13:48:35,2011-07-27 10:36:01
8f27050318e29fe960326979a959966dc7a7b0ad...44fef992596053404de0f390530689340141cc8e,1,2,2,4,2,2011-07-27 13:48:35,2011-07-27 10:52:50
44fef992596053404de0f390530689340141cc8e...dde81190587628f352952c1eb782abb031fab3d2,1,1,1,2,1,2011-07-27 13:48:35,2011-07-27 13:40:32
dde81190587628f352952c1eb782abb031fab3d2...fdfbffbc2be88c29a9b9b412a3ad632b5db7adb8,1,5,1,6,3,2011-07-27 13:50:17,2011-07-27 13:50:17
fdfbffbc2be88c29a9b9b412a3ad632b5db7adb8...7f492a7c6b3093da364c9679c047e359c5711b4e,2,2,2,4,2,2011-07-27 15:32:35,2011-07-27 15:32:35
7f492a7c6b3093da364c9679c047e359c5711b4e...e6996263b682f88dad11ef3e5fb288a30740d967,1,1,1,2,1,2011-07-27 16:44:35,2011-07-27 16:44:35
e6996263b682f88dad11ef3e5fb288a30740d967...4b13175cdcc9927bb251194bb46bff07a8e7078e,2,387,375,762,49,2011-07-27 16:37:45,2011-06-20 18:41:59
4b13175cdcc9927bb251194bb46bff07a8e7078e...0490cd8a76495fd83830053b50bb9aab2f439acc,1,15,14,29,16,2011-07-27 16:37:45,2011-06-21 23:56:27
0490cd8a76495fd83830053b50bb9aab2f439acc...91904ad820329c5a42695b08b6ffb8832e53f0ef,2,98,76,174,46,2011-07-27 16:37:45,2011-06-22 16:44:48
91904ad820329c5a42695b08b6ffb8832e53f0ef...2c5d3f57a0228533758b72ecec121328a39ff77b,2,334,91,425,59,2011-07-27 16:37:45,2011-06-24 21:38:15
2c5d3f57a0228533758b72ecec121328a39ff77b...06018555df923acc9b8f15d359fb4336aff3f5e1,1,2,1,3,1,2011-07-27 16:37:45,2011-07-06 17:08:46
06018555df923acc9b8f15d359fb4336aff3f5e1...06ad5c3a9a5809f3578b21279e51362ea12b9ee2,1,1,1,2,1,2011-07-27 16:37:45,2011-07-06 17:20:57
06ad5c3a9a5809f3578b21279e51362ea12b9ee2...e5335c24fc8cda377aa089051bde35747b364eb6,1,98,0,98,1,2011-07-27 16:37:45,2011-07-06 17:37:23
e5335c24fc8cda377aa089051bde35747b364eb6...1d93455733495101f17fd3149d15b7c4d7596d3a,1,39,43,82,20,2011-07-27 16:37:45,2011-07-06 20:15:16
1d93455733495101f17fd3149d15b7c4d7596d3a...0105586b17e7c0fbbb42317dfd73e3d7f33d3e35,1,19,4,23,6,2011-07-27 16:37:45,2011-07-07 15:16:22
0105586b17e7c0fbbb42317dfd73e3d7f33d3e35...9f635c77d59bacad2941fd8559fcefdb31af1a99,1,31,7,38,10,2011-07-27 16:37:45,2011-07-07 16:08:26
9f635c77d59bacad2941fd8559fcefdb31af1a99...1a1233fd6711985956712e93b09ac72d23e15af6,2,4,0,4,2,2011-07-27 16:37:46,2011-07-07 16:09:11
1a1233fd6711985956712e93b09ac72d23e15af6...6ce2ed33329ea9d9ca9e21448096728f7d1428ea,1,2,2,4,2,2011-07-27 16:37:46,2011-07-08 20:20:37
6ce2ed33329ea9d9ca9e21448096728f7d1428ea...23cce73285ae7edbffbae0c0e57ec04608def021,1,13,1,14,3,2011-07-27 16:37:46,2011-07-08 20:28:44
23cce73285ae7edbffbae0c0e57ec04608def021...4af8e70402b6b73f98178cc74e485f291a63475a,1,31,2,33,7,2011-07-27 16:37:46,2011-07-08 20:31:35
4af8e70402b6b73f98178cc74e485f291a63475a...9d058fb0422a4889dba10d2cb5440edd8c59cee8,1,7,2,9,3,2011-07-27 16:37:46,2011-07-08 20:32:04
9d058fb0422a4889dba10d2cb5440edd8c59cee8...a0f84c7f22fc8d23dcfeb572cd0a1840fae841d8,3,3,3,6,3,2011-07-27 16:37:46,2011-07-08 20:34:10
a0f84c7f22fc8d23dcfeb572cd0a1840fae841d8...4e35995b5ea2c89e7c4ea703d310234d161f1d68,1,1,1,2,1,2011-07-27 16:37:46,2011-07-08 20:35:21
4e35995b5ea2c89e7c4ea703d310234d161f1d68...3d1a47381aa0222c955f49b867b4ab0008137ab5,1,12,0,12,1,2011-07-27 16:37:46,2011-07-08 22:26:53
3d1a47381aa0222c955f49b867b4ab0008137ab5...5c9b154159bc3bd2392e9cf7d5292e50efc8f4c9,1,34,6,40,5,2011-07-27 16:37:46,2011-07-08 22:27:53
5c9b154159bc3bd2392e9cf7d5292e50efc8f4c9...b0fa1f80f3b8ecb9b2d75ec910b393b83cf35cc7,1,5,5,10,2,2011-07-27 16:37:46,2011-07-26 16:27:37
b0fa1f80f3b8ecb9b2d75ec910b393b83cf35cc7...0084b65772783eefb88f9666ac0c716a37abf1d8,2,13,1,14,2,2011-07-27 17:47:13,2011-07-27 17:47:13
0084b65772783eefb88f9666ac0c716a37abf1d8...9551880b41944ef200d244f616b46466b906691c,1,6,2,8,2,2011-07-27 19:34:45,2011-07-27 19:34:45
9551880b41944ef200d244f616b46466b906691c...0a3a147ffb9e726dec50bf121ba82e9b650f6e2b,8,115,20,135,27,2011-07-27 19:59:26,2011-07-12 22:24:03
0a3a147ffb9e726dec50bf121ba82e9b650f6e2b...cc43fc3e4acce9b6bf5558f6f61f828b9a7b6fb9,14,87,82,169,74,2011-07-27 19:59:27,2011-07-18 18:25:18
cc43fc3e4acce9b6bf5558f6f61f828b9a7b6fb9...a1b65c6c7608e38bda2eefdd78b8e0c1ecb8eba1,1,63,0,63,1,2011-07-27 19:59:27,2011-07-18 18:26:27
a1b65c6c7608e38bda2eefdd78b8e0c1ecb8eba1...e5d902202fdd4fe396ed3a404594e7eade3dfa90,32,95,102,197,95,2011-07-27 19:59:27,2011-07-18 19:23:37
e5d902202fdd4fe396ed3a404594e7eade3dfa90...a6f8968570f2d8b47c406473d32d2a7fd9b3614d,1,6,6,12,6,2011-07-27 19:59:27,2011-07-19 13:53:10
a6f8968570f2d8b47c406473d32d2a7fd9b3614d...d42d4c2a0c95bb62f203fc0269b343c318d2020d,3,13,11,24,11,2011-07-27 19:59:27,2011-07-19 13:53:36
d42d4c2a0c95bb62f203fc0269b343c318d2020d...adec8da1fa6e3eb0d01c1245259896d11f044daa,1,5,5,10,2,2011-07-27 20:26:19,2011-07-27 20:25:31
adec8da1fa6e3eb0d01c1245259896d11f044daa...b776b8c9d35f711fcaba51be068d0570637993db,1,25,3,28,10,2011-07-28 14:45:41,2011-07-28 14:45:41
b776b8c9d35f711fcaba51be068d0570637993db...a3ff513b093fae29c8dd5e3ca6174367d6b5371b,1,1,0,1,1,2011-07-28 16:21:13,2011-07-28 16:21:13
a3ff513b093fae29c8dd5e3ca6174367d6b5371b...0479284afc0da63a1650990ef83767d56bbae2d8,2,40,0,40,4,2011-07-28 16:56:48,2011-07-28 16:18:11
0479284afc0da63a1650990ef83767d56bbae2d8...befbd5d49b2ebac2de0768c0f46a7377de0729d5,2,8,1,9,3,2011-07-28 16:56:48,2011-07-28 16:39:06
befbd5d49b2ebac2de0768c0f46a7377de0729d5...dad6351cfbbe6aa5e2d686c54445a0c578b7e658,1,6,4,10,4,2011-07-28 16:56:48,2011-07-28 14:51:02
dad6351cfbbe6aa5e2d686c54445a0c578b7e658...d1968d0838c96eb784bbd7f69e085a5cd7843a47,1,3,1,4,2,2011-07-28 16:56:49,2011-07-28 16:56:31
d1968d0838c96eb784bbd7f69e085a5cd7843a47...8ac0b95fee11a72b4596677a3af5f118a8381ff7,1,1,1,2,1,2011-07-28 17:24:59,2011-07-28 17:24:59
8ac0b95fee11a72b4596677a3af5f118a8381ff7...d676de2512bf7b5dbcb8ebb4c9ea3d6ae549b426,1,5,1,6,2,2011-07-28 18:18:48,2011-07-28 18:18:19
d676de2512bf7b5dbcb8ebb4c9ea3d6ae549b426...d6cce7e211a45dbb1962c8c750f9d98e35bae897,3,77,0,77,3,2011-07-28 18:25:27,2011-07-19 18:18:37
d6cce7e211a45dbb1962c8c750f9d98e35bae897...05ed9407e35a03fb3fecd577471205cc6c659b50,3,46,20,66,14,2011-07-28 18:25:27,2011-07-26 19:15:09
05ed9407e35a03fb3fecd577471205cc6c659b50...af93c5d8771461d85052bcda918179c8259a387c,1,1,1,2,1,2011-07-28 18:25:27,2011-07-26 20:08:49
af93c5d8771461d85052bcda918179c8259a387c...8ca09e494dbe144cbd38714b00b7d1f0bfdca845,1,5,4,9,1,2011-07-28 19:53:50,2011-07-28 19:53:50
8ca09e494dbe144cbd38714b00b7d1f0bfdca845...cd85624ed50ba1283304f1c16e23808534c147e6,1,1,1,2,1,2011-07-28 21:24:42,2011-07-28 21:23:40
cd85624ed50ba1283304f1c16e23808534c147e6...724fc134c4a9855b66a8c6f594a354ea888f60a8,4,85,6,91,10,2011-07-28 21:24:42,2011-07-28 21:23:59
724fc134c4a9855b66a8c6f594a354ea888f60a8...63afd29155fb2747e8e70eeff47953d8d3cd1444,1,1,0,1,1,2011-07-28 21:57:53,2011-07-28 21:57:14
63afd29155fb2747e8e70eeff47953d8d3cd1444...64ae794bd8236baa444fc4e998faeab0c53cf810,1,1,1,2,1,2011-07-28 23:08:35,2011-07-28 23:08:35
64ae794bd8236baa444fc4e998faeab0c53cf810...b1ec2058673f8ca582a490c2dd4a8405698221ae,2,4,2,6,3,2011-07-28 23:54:51,2011-07-28 23:54:51
b1ec2058673f8ca582a490c2dd4a8405698221ae...e78187243d36bfd7d1372f762e67bf71cb962c25,1,0,10,10,3,2011-07-29 07:06:30,2011-07-29 07:06:30
e78187243d36bfd7d1372f762e67bf71cb962c25...f1c3bbd199b226c3ae691726920d09bc3ae2cd23,1,0,1,1,1,2011-07-29 14:13:16,2011-07-29 14:13:16
f1c3bbd199b226c3ae691726920d09bc3ae2cd23...75c91de77403241176a3d3de6c6778d8f939ddd1,1,4,2,6,1,2011-07-29 14:14:54,2011-07-29 14:14:54
75c91de77403241176a3d3de6c6778d8f939ddd1...1154090a71d2188f2e1c6d1c27e8bfc86b1ce506,1,7,4,11,3,2011-07-29 15:31:20,2011-07-27 16:46:31
1154090a71d2188f2e1c6d1c27e8bfc86b1ce506...4a62ca8bb3baa5de10e113f61563de15ecadb99a,3,11,2,13,6,2011-07-29 15:32:01,2011-07-27 18:49:27
4a62ca8bb3baa5de10e113f61563de15ecadb99a...2035656b204c6cbcd04dc515a87d6c675373bf94,2,9,5,14,4,2011-07-29 15:47:06,2011-07-29 15:47:06
2035656b204c6cbcd04dc515a87d6c675373bf94...c84f98ab806b621366d9525121aafcac0a1244a7,7,93,6,99,18,2011-07-29 15:48:09,2011-07-26 20:43:21
c84f98ab806b621366d9525121aafcac0a1244a7...c2e54020bdd648c52c4e2202fc02087756a5d5fb,4,41,6,47,12,2011-07-29 15:49:14,2011-07-29 15:49:14
c2e54020bdd648c52c4e2202fc02087756a5d5fb...9a79fd710beaf93969f4aa8c79f6a4217107dcf2,1,2,0,2,1,2011-07-29 15:51:22,2011-06-27 18:33:01
9a79fd710beaf93969f4aa8c79f6a4217107dcf2...093b04d395c1cacfcde76da13f2eb62667ec8b3d,4,48,1,49,6,2011-07-29 15:52:21,2011-07-27 19:18:06
093b04d395c1cacfcde76da13f2eb62667ec8b3d...38d6167603cd9edc3575b94972f0d0de2821c171,3,22,2,24,4,2011-07-29 15:52:31,2011-07-28 15:36:16
38d6167603cd9edc3575b94972f0d0de2821c171...b02f72021a302e8c0984cab301d25ca73dea8b0b,1,2,1,3,1,2011-07-29 17:32:08,2011-07-29 17:32:08
b02f72021a302e8c0984cab301d25ca73dea8b0b...d7dd936cb317ebe31b4684a5fbe7a3bef7b9f350,1,16,9,25,7,2011-07-29 19:08:18,2011-07-29 19:08:18
d7dd936cb317ebe31b4684a5fbe7a3bef7b9f350...3c55e8ccbaa9acff4cf9594771f67e935b18d9a4,2,65,3,68,6,2011-07-29 22:37:54,2011-07-28 22:15:28
3c55e8ccbaa9acff4cf9594771f67e935b18d9a4...fb8b8936656d94617e3c3b416c24e4660706610c,6,38,8,46,13,2011-07-31 12:36:46,2011-07-31 12:36:46
fb8b8936656d94617e3c3b416c24e4660706610c...c698874735ae6d315d6a71b1695f9e04cc275437,5,671,114,785,45,2011-07-31 15:51:41,2011-07-31 15:36:17
c698874735ae6d315d6a71b1695f9e04cc275437...8d324fca47193e58da4a82ff6fe401f1fc4c8e03,1,21,13,34,5,2011-07-31 15:51:43,2011-07-31 15:38:28
8d324fca47193e58da4a82ff6fe401f1fc4c8e03...3dd98984c7dc3d3299eda1fd3f387f7c720f0d3d,1,0,2,2,2,2011-07-31 15:51:43,2011-07-31 15:39:57
3dd98984c7dc3d3299eda1fd3f387f7c720f0d3d...57701af677e59a3a328ba79a4bd04fa915fca146,1,1,4,5,3,2011-07-31 15:51:43,2011-07-31 15:40:24
57701af677e59a3a328ba79a4bd04fa915fca146...e44abd016d702c43519f2efc091c6a4ca0707994,1,2,2,4,1,2011-07-31 15:51:43,2011-07-31 15:40:51
e44abd016d702c43519f2efc091c6a4ca0707994...b95f39557a5818bd9dc2f37f5abc0e54a298a2b4,1,0,4,4,4,2011-07-31 15:51:43,2011-07-31 15:41:09
b95f39557a5818bd9dc2f37f5abc0e54a298a2b4...7fa4d070e7cffcb2c9ea8637711db9a7c363aa65,1,0,2,2,2,2011-07-31 15:51:43,2011-07-31 15:41:25
7fa4d070e7cffcb2c9ea8637711db9a7c363aa65...0141015c83c0fc70f5bb40c55ed62e21aab0cfb7,1,6,5,11,3,2011-07-31 15:51:44,2011-07-31 15:44:07
0141015c83c0fc70f5bb40c55ed62e21aab0cfb7...ec1ea9cfaa71557ed8df2ea42e5acef5c1a169f2,1,22,0,22,1,2011-07-31 15:51:44,2011-07-31 15:44:33
ec1ea9cfaa71557ed8df2ea42e5acef5c1a169f2...fb01e867bff48cc6591eb4c227fca4b624a64ecc,1,23,0,23,1,2011-07-31 15:51:44,2011-07-31 15:45:26
fb01e867bff48cc6591eb4c227fca4b624a64ecc...d7b89e22586ff1525152bf7a3d637b472aebfa5f,1,21,0,21,1,2011-07-31 15:51:44,2011-07-31 15:45:48
d7b89e22586ff1525152bf7a3d637b472aebfa5f...811d98e6a0002ba235c830fe444926008b0df5c1,1,137,0,137,1,2011-07-31 15:51:44,2011-07-31 15:46:08
811d98e6a0002ba235c830fe444926008b0df5c1...b65d137c6a8cd94f00668662ca39b3438f1eae9f,1,18,0,18,1,2011-07-31 15:51:44,2011-07-31 15:47:35
b65d137c6a8cd94f00668662ca39b3438f1eae9f...10dd86fb966fc6cfa81c4337414ab9ad53ffda66,3,41,12,53,13,2011-07-31 15:59:00,2011-07-31 15:49:21
10dd86fb966fc6cfa81c4337414ab9ad53ffda66...1e226c16b714e4c7e5f498d18e5d2303de61dd12,1,8,2,10,3,2011-07-31 15:59:00,2011-07-26 04:59:00
1e226c16b714e4c7e5f498d18e5d2303de61dd12...175e0392475935552f83b1719936750e362f45cc,4,78,10,88,14,2011-07-31 15:59:00,2011-07-31 15:51:14
175e0392475935552f83b1719936750e362f45cc...1c434d10f9637ebeefae0d48a17ec122183a2f23,2,60,4,64,4,2011-07-31 15:59:01,2011-07-12 20:45:32
1c434d10f9637ebeefae0d48a17ec122183a2f23...218a7f560204f7750a7e6294b41a5fbffaeaf3a7,1,38,0,38,1,2011-07-31 15:59:01,2011-07-12 20:46:37
218a7f560204f7750a7e6294b41a5fbffaeaf3a7...a30a6a05fa0b94a89acc994cf2895c227e76f645,1,28,0,28,1,2011-07-31 15:59:01,2011-07-13 05:18:00
a30a6a05fa0b94a89acc994cf2895c227e76f645...23c7fefdfe2a798027e47bb684424feeb130ad91,3,81,6,87,13,2011-07-31 15:59:01,2011-07-18 21:51:07
23c7fefdfe2a798027e47bb684424feeb130ad91...789bd622ae3e5199a5a9f8dde7bd1c2882d3b8e9,4,34,12,46,15,2011-07-31 15:59:01,2011-07-18 22:25:08
789bd622ae3e5199a5a9f8dde7bd1c2882d3b8e9...1df742557ac82a54c1c935ba026aac73d836203d,1,13,0,13,1,2011-07-31 15:59:01,2011-07-19 02:49:06
1df742557ac82a54c1c935ba026aac73d836203d...8b35cf0f945c5636df17709bf03a03f63217273f,1,11,0,11,1,2011-07-31 15:59:01,2011-07-19 03:15:19
8b35cf0f945c5636df17709bf03a03f63217273f...7a9337b122d569b467a74ef16b5ef8b27ccf69e4,1,20,18,38,3,2011-07-31 15:59:02,2011-07-19 07:30:40
7a9337b122d569b467a74ef16b5ef8b27ccf69e4...44ca61eafb112231367f012f80b38d66feadd055,4,52,7,59,9,2011-07-31 15:59:02,2011-07-31 15:31:44
44ca61eafb112231367f012f80b38d66feadd055...0798086e4ffa65d52b96c5c14a098eb9956a2fbb,4,8,8,16,5,2011-07-31 16:34:04,2011-07-31 16:34:04
0798086e4ffa65d52b96c5c14a098eb9956a2fbb...26e10443f5a8530853756f00ffe4aae77e6f9cae,3,10,5,15,6,2011-07-31 17:12:25,2011-07-31 17:12:25
26e10443f5a8530853756f00ffe4aae77e6f9cae...f10ca8d09e73776af66c1475ebd657484c240764,1,1,1,2,1,2011-07-31 17:56:38,2011-07-31 17:56:38
f10ca8d09e73776af66c1475ebd657484c240764...20b7e94cba2fc8d1c7a63f7b7c4fb028a7456546,1,14,0,14,1,2011-07-31 18:28:48,2011-07-31 18:28:48
20b7e94cba2fc8d1c7a63f7b7c4fb028a7456546...d51eaa08066b335ff5a700239846aa8628cb4a75,1,11,5,16,5,2011-07-31 23:14:28,2011-07-31 23:14:28
d51eaa08066b335ff5a700239846aa8628cb4a75...688d45894d10c91bdb299d7d3fc56568d5cfa273,1,1,0,1,1,2011-07-31 23:15:48,2011-07-31 23:15:48
688d45894d10c91bdb299d7d3fc56568d5cfa273...3d9117aa30468ff151d9a37412f7e8a9b9bb015b,1,2,1,3,2,2011-08-01 00:30:55,2011-08-01 00:30:55
3d9117aa30468ff151d9a37412f7e8a9b9bb015b...3ca14baf413c06eaf547ab548bd909c1edc8387d,2,6,6,12,6,2011-08-01 15:07:45,2011-08-01 15:07:45
3ca14baf413c06eaf547ab548bd909c1edc8387d...9561aabe7c4af4239f66349583630070d5e97bc1,1,10,7,17,4,2011-08-01 15:24:11,2011-08-01 15:22:39
9561aabe7c4af4239f66349583630070d5e97bc1...53965e6f0375850b58f6207c9ba9f0902db4ee1f,3,20,3,23,10,2011-08-01 16:44:11,2011-08-01 16:36:31
53965e6f0375850b58f6207c9ba9f0902db4ee1f...336f3b4d277725ac2cbc58f4a3467724f587d373,1,5,0,5,1,2011-08-01 17:12:28,2011-08-01 17:12:28
336f3b4d277725ac2cbc58f4a3467724f587d373...a5bf7c89b1706c40a63f3768b11610b3d074fbc6,1,1,0,1,1,2011-08-01 20:47:56,2011-08-01 20:47:32
a5bf7c89b1706c40a63f3768b11610b3d074fbc6...c7f7ba2098661cbc2d135928efdd459aac13ef35,1,3,1,4,2,2011-08-01 21:37:38,2011-08-01 21:36:37
c7f7ba2098661cbc2d135928efdd459aac13ef35...d8d05fdc71fa1368bcaa8de65c868a984e588d4e,3,106,70,176,9,2011-08-01 21:51:13,2011-08-01 21:51:13
d8d05fdc71fa1368bcaa8de65c868a984e588d4e...b7789923b374237054713ae255979c73ca937f23,2,5,3,8,4,2011-08-01 21:54:35,2011-08-01 21:54:35
b7789923b374237054713ae255979c73ca937f23...c4852ebb0509d692afc3e5f59e9fbd4d3fcf570a,1,3,0,3,1,2011-08-01 22:03:39,2011-08-01 22:03:05
c4852ebb0509d692afc3e5f59e9fbd4d3fcf570a...fff9db5a8d5dab5cb2ec7dcd8d785859bb62f8ea,1,6,5,11,3,2011-08-01 23:14:03,2011-07-29 21:40:32
fff9db5a8d5dab5cb2ec7dcd8d785859bb62f8ea...7c2bd1f36f3bb5066bf9f9d7f23eb9b85635e701,4,29,4,33,7,2011-08-01 23:14:03,2011-07-29 22:39:56
7c2bd1f36f3bb5066bf9f9d7f23eb9b85635e701...d3ff333690bff9a52543a7cd9ffb6a3df481c0cd,2,12,22,34,4,2011-08-01 23:14:03,2011-07-30 00:54:00
d3ff333690bff9a52543a7cd9ffb6a3df481c0cd...ad9b50e4e45ec704305173f7081100a0090de672,1,1,2,3,1,2011-08-01 23:14:03,2011-08-01 15:15:45
ad9b50e4e45ec704305173f7081100a0090de672...b4f185e7de1c9917b6469ecb0709933d1cffd201,2,25,0,25,4,2011-08-01 23:14:03,2011-08-01 17:00:09
b4f185e7de1c9917b6469ecb0709933d1cffd201...bf4a31eef08d2671bce2821570558ec33fd4df00,4,8,29,37,7,2011-08-01 23:14:03,2011-08-01 17:01:05
bf4a31eef08d2671bce2821570558ec33fd4df00...431da10ff63a92187bca0eea80a5c672fda2e80a,2,7,3,10,4,2011-08-01 23:14:03,2011-08-01 17:11:06
431da10ff63a92187bca0eea80a5c672fda2e80a...02c6910265e55f5f2e75f1843a92f38007c5e9e9,1,24,17,41,10,2011-08-01 23:14:03,2011-08-01 22:35:58
02c6910265e55f5f2e75f1843a92f38007c5e9e9...4f8df957c49edac8159fcdaa394f1f0bab12c8d9,1,13,0,13,2,2011-08-01 23:14:03,2011-08-01 23:11:52
4f8df957c49edac8159fcdaa394f1f0bab12c8d9...8521b85b0e4447db8c5da6f0db249901608cc874,1,13,0,13,1,2011-08-01 23:14:03,2011-08-01 23:13:08
8521b85b0e4447db8c5da6f0db249901608cc874...aea06e1fd63370d310b93c285eda26dfa4218606,1,4,1,5,1,2011-08-01 23:34:33,2011-08-01 23:34:33
aea06e1fd63370d310b93c285eda26dfa4218606...31ff54ebc2ac381d316484f4caaace523809dd14,1,1,1,2,1,2011-08-02 00:11:28,2011-08-02 00:11:28
31ff54ebc2ac381d316484f4caaace523809dd14...20dfe3edf116970c3566ba417c14fc14612f6855,1,2,1,3,2,2011-08-02 01:47:14,2011-08-02 01:47:14
20dfe3edf116970c3566ba417c14fc14612f6855...b1a62743d1ab7f1986bbe7faf36640fc16236b15,1,2,8,10,4,2011-08-02 06:35:55,2011-07-15 18:09:52
b1a62743d1ab7f1986bbe7faf36640fc16236b15...81fece68e9b0f1723b9c5d2e468fd2e43794022d,13,92,8,100,12,2011-08-02 06:36:36,2011-07-15 18:14:08
81fece68e9b0f1723b9c5d2e468fd2e43794022d...96b6b65530faefa2ed7c1d25ec545f7cdac1aa3a,2,3,1,4,3,2011-08-02 06:36:39,2011-07-15 18:27:12
96b6b65530faefa2ed7c1d25ec545f7cdac1aa3a...b01e3a19715f636ad544221ab32c5c307283e4a6,2,26,9,35,8,2011-08-02 06:36:41,2011-07-16 03:20:44
b01e3a19715f636ad544221ab32c5c307283e4a6...7c8cfd9eb51a4e54200a6ad5fb28f97b9b06d902,1,116,111,227,10,2011-08-02 06:36:44,2011-07-16 16:04:54
7c8cfd9eb51a4e54200a6ad5fb28f97b9b06d902...63c87fe20c42a21eae42052531589f7547748e69,7,20,21,41,20,2011-08-02 06:36:46,2011-07-16 16:43:51
63c87fe20c42a21eae42052531589f7547748e69...57b8eaa186ed07844f5eb563850e7a12704e3007,19,2625,7,2632,37,2011-08-02 06:38:00,2011-07-18 13:28:26
57b8eaa186ed07844f5eb563850e7a12704e3007...c72fb702dc909a12410dd83bbe78e84425c50185,1,13,1,14,1,2011-08-02 06:38:02,2011-07-18 23:57:53
c72fb702dc909a12410dd83bbe78e84425c50185...c716fa537d4e3df408175464dcd577529459e228,8,76,10,86,14,2011-08-02 06:39:04,2011-07-18 23:58:50
c716fa537d4e3df408175464dcd577529459e228...4d3fe8b73a889bc9604df9c9460a1165f6a7a211,2,7,2,9,3,2011-08-02 06:39:06,2011-07-19 17:32:03
4d3fe8b73a889bc9604df9c9460a1165f6a7a211...1eb21fc88b3aeb2b72d506379019dcdf0c509ded,1,2,1,3,2,2011-08-02 06:39:09,2011-07-21 21:08:25
1eb21fc88b3aeb2b72d506379019dcdf0c509ded...97e6514ff2d579a434f2e4a0a1858304549711b1,1,7,5,12,3,2011-08-02 06:39:11,2011-07-21 21:09:04
97e6514ff2d579a434f2e4a0a1858304549711b1...9a30ac81c4fa07cf05a19be1d3c465591c05cc44,12,155,74,229,52,2011-08-02 06:39:51,2011-07-21 21:41:30
9a30ac81c4fa07cf05a19be1d3c465591c05cc44...b6200ff73e68ced96513f453b7941a6934264a9a,1,3,1,4,3,2011-08-02 06:39:53,2011-07-25 01:00:48
b6200ff73e68ced96513f453b7941a6934264a9a...50902acb9acc68b3215d1cf312a3e9c9406e517c,10,165,144,309,73,2011-08-02 06:41:45,2011-07-25 16:45:03
50902acb9acc68b3215d1cf312a3e9c9406e517c...59b8f97084727925faa7bd656c1eaebb59cff7c1,1,2,0,2,1,2011-08-02 06:41:49,2011-07-25 23:08:22
59b8f97084727925faa7bd656c1eaebb59cff7c1...dc422fb82f838303ba0a980fec6741abcd4d81b9,5,7,1,8,5,2011-08-02 13:53:35,2011-08-02 13:53:35
dc422fb82f838303ba0a980fec6741abcd4d81b9...a541e65d0580be32bdebe7c8783faebf051dd44e,1,1,1,2,1,2011-08-02 15:16:49,2011-08-02 15:16:49
a541e65d0580be32bdebe7c8783faebf051dd44e...6b7c5b006368f55c615f5e89dc6b751f0d99970c,2,7,2,9,2,2011-08-02 14:20:06,2011-08-02 14:20:06
6b7c5b006368f55c615f5e89dc6b751f0d99970c...8919d7686edc92f29c3fb3e7a15ab5bff4f8a4d4,5,16,9,25,14,2011-08-02 14:37:48,2011-08-02 14:37:48
8919d7686edc92f29c3fb3e7a15ab5bff4f8a4d4...681a4c7225eed0cf813f7cb5d7c1079dde9175b5,1,17,0,17,1,2011-08-02 19:56:39,2011-08-02 19:56:39
681a4c7225eed0cf813f7cb5d7c1079dde9175b5...3a59b011f2cc2a3092caac13663053422e4feada,1,1,0,1,1,2011-08-02 21:50:48,2011-08-02 21:50:48
3a59b011f2cc2a3092caac13663053422e4feada...36c6e78f18db101ea2e23c0f748be85845020e66,1,7,2,9,3,2011-08-02 21:51:05,2011-08-02 21:51:05
36c6e78f18db101ea2e23c0f748be85845020e66...a83ddcd22c6d60f050cccc95a6c3231376292add,1,1,0,1,1,2011-08-02 22:03:46,2011-08-02 22:03:46
a83ddcd22c6d60f050cccc95a6c3231376292add...e2778cdf78239e136eaa36680869608441fc9934,9,18,18,36,13,2011-08-02 22:50:04,2011-08-02 22:50:04
e2778cdf78239e136eaa36680869608441fc9934...36e008d653a7d9e0dff5cfad897c424ba39adc8b,2,9,5,14,5,2011-08-02 23:13:48,2011-08-02 23:13:48
36e008d653a7d9e0dff5cfad897c424ba39adc8b...5a4f19c8295dedf05387be3ff4ee5262f6d37d12,1,10,3,13,4,2011-08-03 00:05:25,2011-08-03 00:05:25
5a4f19c8295dedf05387be3ff4ee5262f6d37d12...9c8141de814be00554371ce8ba7686bca8146dca,1,7,5,12,3,2011-08-03 00:59:22,2011-08-03 00:59:22
9c8141de814be00554371ce8ba7686bca8146dca...9f4fb59256f078f340f5b7fae5cda1e114b4e8af,2,3,2,5,2,2011-08-03 01:30:42,2011-08-03 01:30:42
9f4fb59256f078f340f5b7fae5cda1e114b4e8af...2be0270affd748187dd081e33872e4090bfcddba,1,1,1,2,1,2011-08-03 02:47:13,2011-08-03 02:47:13
2be0270affd748187dd081e33872e4090bfcddba...3b4b0026cd2e018346bf068109ba0a9368a07eeb,2,68,60,128,14,2011-08-03 03:02:03,2011-08-03 00:40:57
3b4b0026cd2e018346bf068109ba0a9368a07eeb...e7b9f3424237add1eba82310a4611377ec79687c,3,0,0,0,0,2011-08-03 03:03:03,2011-08-03 03:03:03
e7b9f3424237add1eba82310a4611377ec79687c...13a9e04fd23bf90b4fa705377f0763d20165a1d3,1,2,2,4,2,2011-08-03 03:23:44,2011-08-03 03:23:44
13a9e04fd23bf90b4fa705377f0763d20165a1d3...b1c8a8c3aa472dc7133132f73889b50dad4090e9,1,0,4,4,2,2011-08-03 13:07:43,2011-08-03 13:07:07
b1c8a8c3aa472dc7133132f73889b50dad4090e9...e786370a9e82543cb2942c20aea972d7debfff86,1,1,0,1,1,2011-08-03 13:07:43,2011-08-03 13:07:22
e786370a9e82543cb2942c20aea972d7debfff86...5fafbffa275f7f877c55236ee5a92a27b0ce284b,7,56,4,60,9,2011-08-03 15:05:31,2011-08-03 15:04:48
5fafbffa275f7f877c55236ee5a92a27b0ce284b...5833aa3be3d20686fa8c9c129fae71c261d51b71,3,9,4,13,6,2011-08-03 21:11:16,2011-08-02 22:22:40
5833aa3be3d20686fa8c9c129fae71c261d51b71...5bd4f5885c6f920f1c5a3c0fd335cc8095c43ad2,1,10,3,13,6,2011-08-03 21:11:43,2011-08-03 21:11:43
5bd4f5885c6f920f1c5a3c0fd335cc8095c43ad2...16955912bc669d05541b87dd69999f89e892f35c,2,6,2,8,4,2011-08-03 21:35:43,2011-08-03 21:35:43
16955912bc669d05541b87dd69999f89e892f35c...62993481e9c9f1edf0448eccb78a24fdfb890a7d,4,16,1,17,5,2011-08-03 22:12:46,2011-08-03 22:00:02
62993481e9c9f1edf0448eccb78a24fdfb890a7d...7dd8b4c1dc20f1a5bd84efae63fdca1d8cfd1bc6,2,60,68,128,14,2011-08-04 14:40:34,2011-08-04 14:40:34
7dd8b4c1dc20f1a5bd84efae63fdca1d8cfd1bc6...4e3c9e90e3a774e7922f2ce2560a57477d7da043,2,85,3,88,3,2011-08-04 15:18:28,2011-08-04 15:17:45
4e3c9e90e3a774e7922f2ce2560a57477d7da043...9fd0090766816bd6401c3287808126756b9bfbdd,5,24,4,28,7,2011-08-04 15:35:00,2011-08-04 15:06:48
9fd0090766816bd6401c3287808126756b9bfbdd...a97a8ef72e543833b3df74f784823fd2e0ed989d,2,70,0,70,2,2011-08-04 15:35:00,2011-08-04 15:34:40
a97a8ef72e543833b3df74f784823fd2e0ed989d...a4acc55a2ca0ffe366604f7cd30b2f67d4c9f3a0,1,2,2,4,2,2011-08-04 16:18:37,2011-08-04 16:18:37
a4acc55a2ca0ffe366604f7cd30b2f67d4c9f3a0...3bef4ac063a65990215d6f641a79efb707d41bab,1,1,2,3,2,2011-08-04 16:20:47,2011-08-04 16:20:47
3bef4ac063a65990215d6f641a79efb707d41bab...6bf06f445ea9e6e912ed16c6e8f4286ef0d85ef8,6,164,13,177,16,2011-08-04 16:54:16,2011-07-28 23:59:51
6bf06f445ea9e6e912ed16c6e8f4286ef0d85ef8...88094494077b407bf1cf2ce6351252ab4b0d0d60,1,11,0,11,6,2011-08-04 16:57:44,2011-08-04 16:01:15
88094494077b407bf1cf2ce6351252ab4b0d0d60...ec9147aaeb0a10c0f40ab962056ba7c7dacdab8c,2,29,2,31,7,2011-08-04 17:44:30,2011-08-04 17:44:30
ec9147aaeb0a10c0f40ab962056ba7c7dacdab8c...dceaf5bb0b3bdd9362fe27081d3b01e9eec35267,2,2,2,4,2,2011-08-04 17:59:37,2011-08-04 17:59:37
dceaf5bb0b3bdd9362fe27081d3b01e9eec35267...5716363c93f2483ad467fa8c4ad02c616b964a16,1,21,21,42,3,2011-08-04 19:10:08,2011-08-04 18:43:49
5716363c93f2483ad467fa8c4ad02c616b964a16...ca53a39715435935a4902c9fc3419f273a199b54,1,5,4,9,2,2011-08-04 19:10:08,2011-08-04 19:09:53
ca53a39715435935a4902c9fc3419f273a199b54...adb19a7c759ce45896014717e0ca00f12a0b0b5b,1,7,1,8,2,2011-08-04 19:10:09,2011-08-04 19:09:58
adb19a7c759ce45896014717e0ca00f12a0b0b5b...51438c11220ca83fe8985a5e2a84cee8e1b5084c,1,2,2,4,2,2011-08-04 21:53:28,2011-08-04 21:53:28
51438c11220ca83fe8985a5e2a84cee8e1b5084c...50d396b3f4b516cb125fa33c20e018f9a485c909,1,9,0,9,2,2011-08-04 20:13:47,2011-08-04 20:09:18
50d396b3f4b516cb125fa33c20e018f9a485c909...53a69ce6c98be5fafe1dd864d595fe8755b8ded8,2,18,9,27,2,2011-08-04 23:01:49,2011-08-04 23:01:22
53a69ce6c98be5fafe1dd864d595fe8755b8ded8...d58c4c23f6f2ff45f9cec2f3761becfaba13cbba,6,118,98,216,55,2011-08-05 05:10:34,2011-08-03 03:32:42
d58c4c23f6f2ff45f9cec2f3761becfaba13cbba...f1373a1ed08e5763e6c0ce8eb0d1ea1bf55517e8,2,35,1,36,7,2011-08-05 05:10:35,2011-08-03 05:00:08
f1373a1ed08e5763e6c0ce8eb0d1ea1bf55517e8...470aac09a264d7b119c74c3dd45317d10d05f0f3,1,2,2,4,1,2011-08-05 05:10:35,2011-08-05 05:10:17
470aac09a264d7b119c74c3dd45317d10d05f0f3...949a69ca837804c2410c8ea9b7b239f32937cefd,1,1,1,2,1,2011-08-05 05:46:52,2011-08-05 05:46:52
949a69ca837804c2410c8ea9b7b239f32937cefd...aa0421d693716d8ec78ec5c85fe68718007822c9,1,11,5,16,4,2011-08-05 06:29:07,2011-08-05 06:29:07
aa0421d693716d8ec78ec5c85fe68718007822c9...8f31837c7484397fa7f5fb73b852e6fde809d422,1,20,0,20,1,2011-08-05 13:18:26,2011-08-05 13:18:26
8f31837c7484397fa7f5fb73b852e6fde809d422...a3f80b90b2bcf4551046024061702cf70e43b348,2,18,14,32,4,2011-08-05 13:18:31,2011-08-05 13:18:31
a3f80b90b2bcf4551046024061702cf70e43b348...a30b27a87322addd9d9be9543fa318c8bedc4c07,1,7,2,9,4,2011-08-05 14:42:01,2011-08-05 14:42:01
a30b27a87322addd9d9be9543fa318c8bedc4c07...33fe71e636512388ed14f2dd73d7c73d8ac1060a,1,0,3,3,1,2011-08-05 15:14:05,2011-08-05 15:14:05
33fe71e636512388ed14f2dd73d7c73d8ac1060a...f6896afc92b454409e218b4dc4d1e25f92646b21,2,25,0,25,3,2011-08-05 15:42:56,2011-08-05 15:42:56
f6896afc92b454409e218b4dc4d1e25f92646b21...72db2c419781158ece1e68302d753d49478ef1cd,2,44,1,45,3,2011-08-05 15:43:09,2011-08-05 15:43:09
72db2c419781158ece1e68302d753d49478ef1cd...2249ea9d7d05fcefe40eae5fd83937107877eeee,1,31,0,31,1,2011-08-05 16:22:30,2011-08-02 17:17:58
2249ea9d7d05fcefe40eae5fd83937107877eeee...b96bd28ad5171a4246aca4417ef7e481d0116d05,4,32,10,42,9,2011-08-05 16:22:30,2011-08-03 21:10:51
b96bd28ad5171a4246aca4417ef7e481d0116d05...478b0818cf737b810f4c10bd0877890670ff7364,2,7,1,8,3,2011-08-05 16:22:30,2011-08-04 21:01:52
478b0818cf737b810f4c10bd0877890670ff7364...a19bd10c50c12a03fc894c8b3d19bc75a6826121,3,10,17,27,3,2011-08-05 16:22:30,2011-08-05 15:28:28
a19bd10c50c12a03fc894c8b3d19bc75a6826121...4e25a6d588c4eaa8495066e292e5908f05eeb926,2,10,0,10,3,2011-08-05 19:31:34,2011-08-05 19:31:34
4e25a6d588c4eaa8495066e292e5908f05eeb926...57cacffe3ead7c2c55bfcca8761c9647daab5f06,1,2,1,3,2,2011-08-05 19:31:55,2011-08-05 19:31:55
57cacffe3ead7c2c55bfcca8761c9647daab5f06...9af0b0f16186375c9159710da0a82bcc43b69957,1,1,1,2,1,2011-08-05 19:45:13,2011-08-05 17:54:28
9af0b0f16186375c9159710da0a82bcc43b69957...26dbb2113c19d8e4063bbffde4b3d937b3cc3d4b,1,7,6,13,3,2011-08-05 19:45:13,2011-08-05 18:35:12
26dbb2113c19d8e4063bbffde4b3d937b3cc3d4b...efd0b8d1050d6aa9ea231f4fd9d16d22f62848b2,1,8,8,16,6,2011-08-05 19:58:02,2011-08-05 19:58:02
efd0b8d1050d6aa9ea231f4fd9d16d22f62848b2...abf6327727be5a0b2fb0f072f0bf5c282d0aa8ad,1,19,4,23,4,2011-08-05 20:15:56,2011-08-05 20:15:56
abf6327727be5a0b2fb0f072f0bf5c282d0aa8ad...d2092af24507de48d496354eedf8e190abf7b7e1,3,2,3,5,3,2011-08-05 21:59:59,2011-08-05 21:59:59
d2092af24507de48d496354eedf8e190abf7b7e1...bd1ed814176784d24ba5ab8041280e48374d98bf,1,1,1,2,1,2011-08-05 22:47:17,2011-08-05 22:47:17
bd1ed814176784d24ba5ab8041280e48374d98bf...7cc114bbc0b5f8af2b7d891906b32bc85aed6fc9,2,12,5,17,2,2011-08-06 00:41:03,2011-08-06 00:41:03
7cc114bbc0b5f8af2b7d891906b32bc85aed6fc9...d095b538b8b12cd4bba25e957fe126e77771d537,1,3,0,3,1,2011-08-06 04:12:01,2011-08-06 04:12:01
d095b538b8b12cd4bba25e957fe126e77771d537...6121d0c551850b68d623b0cf666287118c3de93d,1,3,1,4,1,2011-08-06 13:36:34,2011-08-06 13:36:34
6121d0c551850b68d623b0cf666287118c3de93d...53b2475015244a0176d7e2a1d3035a1572cfd881,1,16,7,23,6,2011-08-06 14:17:33,2011-08-06 14:17:33
53b2475015244a0176d7e2a1d3035a1572cfd881...4e995b98e5892dffaba20fa2ed14c15de1857923,1,1,1,2,1,2011-08-06 14:17:41,2011-08-06 14:17:41
4e995b98e5892dffaba20fa2ed14c15de1857923...7355a811bac3b021bd066a5a4ddcb4b47cb721a3,1,9,4,13,3,2011-08-06 19:02:15,2011-08-06 19:02:15
7355a811bac3b021bd066a5a4ddcb4b47cb721a3...41f43db6e267a1007800a324cc9e5735fc37a06c,1,3,7,10,3,2011-08-06 23:50:16,2011-08-06 23:50:16
41f43db6e267a1007800a324cc9e5735fc37a06c...7967140bf623984901446bb1add6270b513b2a62,1,4,1,5,2,2011-08-07 00:40:37,2011-08-07 00:39:44
7967140bf623984901446bb1add6270b513b2a62...36f0f03adbffcd8a63d6f7d45ce6cd0fef51b930,1,0,1,1,1,2011-08-07 22:09:50,2011-08-07 05:45:56
36f0f03adbffcd8a63d6f7d45ce6cd0fef51b930...94412807e6ac42dfe21ba62a4f39c2fdc55ed2cd,4,28,12,40,12,2011-08-07 22:09:50,2011-08-07 22:09:19
94412807e6ac42dfe21ba62a4f39c2fdc55ed2cd...c22ef261c9701e742d0ec2a970822bc135a83c1b,1,7,4,11,3,2011-08-08 05:13:53,2011-08-08 05:13:53
c22ef261c9701e742d0ec2a970822bc135a83c1b...4c53a82ac58ed2e5cf268cac60a4ef86be36c7a1,1,1,1,2,1,2011-08-08 05:19:01,2011-08-08 05:19:01
4c53a82ac58ed2e5cf268cac60a4ef86be36c7a1...00b751f2d0ee0adc10dc7216fdc8e55f1e4cec98,1,3,3,6,2,2011-08-08 05:39:33,2011-08-08 05:38:48
00b751f2d0ee0adc10dc7216fdc8e55f1e4cec98...345793af4d3bd6b245bad444f5f2e46d6675d2e3,5,40,15,55,16,2011-08-08 13:06:19,2011-08-08 13:05:54
345793af4d3bd6b245bad444f5f2e46d6675d2e3...690505dee9f6b6f56e0c81fd1da27e45dda1f711,2,8,1,9,3,2011-08-08 15:07:11,2011-08-08 15:07:11
690505dee9f6b6f56e0c81fd1da27e45dda1f711...c9e50b7eaa38d51ec5e5f8a61509e04992bee184,1,1,1,2,1,2011-08-08 15:10:57,2011-08-08 15:10:57
c9e50b7eaa38d51ec5e5f8a61509e04992bee184...4edfb8e35c876e0e166dd5f9d5436294503ce56d,1,1,1,2,1,2011-08-08 15:12:19,2011-08-08 15:12:19
4edfb8e35c876e0e166dd5f9d5436294503ce56d...3a52f00ede5a8c2507cf3f7bd345c204dc1acf61,3,14,8,22,10,2011-08-08 16:25:38,2011-08-08 16:25:38
3a52f00ede5a8c2507cf3f7bd345c204dc1acf61...7ca73907386ff3385f47b3e46858f17ef5a14e59,1,0,2,2,1,2011-08-08 16:44:51,2011-08-05 15:47:27
7ca73907386ff3385f47b3e46858f17ef5a14e59...dd520e59a580764cf73eef813f37a45dfeab016f,6,43,3,46,11,2011-08-08 16:44:52,2011-08-05 21:54:15
dd520e59a580764cf73eef813f37a45dfeab016f...60b85175fef9522452fd86862789a2c745b35a75,2,12,1,13,3,2011-08-08 16:44:52,2011-08-08 15:09:54
60b85175fef9522452fd86862789a2c745b35a75...689469c2de631b6d530e378897558f972513a116,5,6,6,12,6,2011-08-08 16:44:52,2011-08-08 16:42:05
689469c2de631b6d530e378897558f972513a116...5657637bd93afcf4f5d5a1a964a6c433375e70ca,1,10,11,21,7,2011-08-08 19:33:38,2011-08-08 19:32:52
5657637bd93afcf4f5d5a1a964a6c433375e70ca...760f0b28d4b6540923f51ad7a4e33bae43d343ff,3,142,37,179,43,2011-08-08 23:00:59,2011-08-08 23:00:59
760f0b28d4b6540923f51ad7a4e33bae43d343ff...2749b350f11be618fcd0cbf3b550c2142c231801,3,21,0,21,3,2011-08-08 23:10:24,2011-08-08 22:53:48
2749b350f11be618fcd0cbf3b550c2142c231801...c69a6247ed2b849503d1964674efd71cd3c65ffa,2,18,2,20,3,2011-08-08 23:52:56,2011-08-08 21:04:23
c69a6247ed2b849503d1964674efd71cd3c65ffa...0045301af9f756c6ef6de83373e502c1fa281a88,1,7,5,12,3,2011-08-08 23:52:56,2011-08-08 21:28:32
0045301af9f756c6ef6de83373e502c1fa281a88...0e20be567e38e835d8a2df17ba030391bbbb00ee,18,64,64,128,61,2011-08-08 23:52:56,2011-08-08 21:37:04
0e20be567e38e835d8a2df17ba030391bbbb00ee...e0391514a811bbb404397a74e7ce631d80581d6e,1,25,9,34,3,2011-08-08 23:52:56,2011-08-08 22:12:15
e0391514a811bbb404397a74e7ce631d80581d6e...04261c7d15308d2b20edf61b9c8ee175f6c21ad4,1,13,0,13,2,2011-08-08 23:52:56,2011-08-08 22:56:17
04261c7d15308d2b20edf61b9c8ee175f6c21ad4...b3204f84900ce4bba3b21902360463e4215defcd,1,1,1,2,1,2011-08-08 23:57:36,2011-08-08 23:57:36
b3204f84900ce4bba3b21902360463e4215defcd...b6010485ee059a23daed5a6b0c3f68704ddecaf4,1,34,16,50,5,2011-08-09 02:43:10,2011-08-09 02:43:10
b6010485ee059a23daed5a6b0c3f68704ddecaf4...67cf81180f4da1c50064cffc1d2b0e61f51f374e,1,6,4,10,2,2011-08-09 03:37:44,2011-08-09 03:33:51
67cf81180f4da1c50064cffc1d2b0e61f51f374e...5598fe195b1ed70bfd83523457198793595df64b,2,25,18,43,5,2011-08-09 03:37:44,2011-08-09 03:37:32
5598fe195b1ed70bfd83523457198793595df64b...fd441b9d08fc0ffcab3bbee0499c90ca20e2d9fb,1,2,2,4,2,2011-08-09 04:34:15,2011-08-09 04:33:24
fd441b9d08fc0ffcab3bbee0499c90ca20e2d9fb...509d753a17c086ac63fb57738b6426d83180a374,1,26,0,26,1,2011-08-09 06:16:00,2011-08-09 06:16:00
509d753a17c086ac63fb57738b6426d83180a374...1436fe459591edc34478bff2172de33f75e7b5fc,6,28,16,44,13,2011-08-09 06:16:54,2011-08-08 23:54:53
1436fe459591edc34478bff2172de33f75e7b5fc...4d3fdcfc10de6d4628e7b4cdcde0348f8264c2d7,8,24,11,35,14,2011-08-09 06:16:54,2011-08-09 01:37:33
4d3fdcfc10de6d4628e7b4cdcde0348f8264c2d7...e8f069d8a2c88819a9c478e71faf16c179fbc519,2,3,3,6,3,2011-08-09 06:16:54,2011-08-09 03:18:32
e8f069d8a2c88819a9c478e71faf16c179fbc519...709c5f262803d2b2f2f5e5787a5a5eff9e4296bd,1,1,1,2,1,2011-08-09 06:16:54,2011-08-09 03:36:12
709c5f262803d2b2f2f5e5787a5a5eff9e4296bd...b52af9b709dfa905eb4585c537b69b32da1caaaa,5,40,13,53,14,2011-08-09 06:29:41,2011-08-09 06:29:41
b52af9b709dfa905eb4585c537b69b32da1caaaa...ad2f56a651b0b25f7a63ca4f533bdbc48b8c6ef0,1,29,0,29,1,2011-08-09 13:22:34,2011-08-09 13:22:34
ad2f56a651b0b25f7a63ca4f533bdbc48b8c6ef0...bbee2207bec7d8c0d19c39900a42f2d33a99ba21,1,3,0,3,1,2011-08-09 17:42:24,2011-08-09 17:42:24
bbee2207bec7d8c0d19c39900a42f2d33a99ba21...f86448f78b656f082ba6905747dca172ad78bec9,1,1,1,2,1,2011-08-09 18:00:02,2011-08-09 18:00:02
f86448f78b656f082ba6905747dca172ad78bec9...7cad9757de992d4db6f6e991dedd970d9a17d0c0,1,2,0,2,2,2011-08-09 19:41:01,2011-08-09 19:39:35
7cad9757de992d4db6f6e991dedd970d9a17d0c0...c5b4ec9445b559ecb032db1a04188cc50cb9b635,2,9,0,9,7,2011-08-10 10:54:36,2011-08-09 15:44:17
c5b4ec9445b559ecb032db1a04188cc50cb9b635...6f6ba51e04d8787ebcab9852e01912c6670e5a3b,2,1,8,9,5,2011-08-10 10:54:39,2011-08-09 16:03:17
6f6ba51e04d8787ebcab9852e01912c6670e5a3b...fcf1abff4017a9dc5652cdf6b0753d7609dbc096,1,15,10,25,4,2011-08-10 10:54:42,2011-08-10 10:53:27
fcf1abff4017a9dc5652cdf6b0753d7609dbc096...6beeeee10daa4e0addbd879bfb31b548a4e42409,1,6,1,7,1,2011-08-10 14:06:34,2011-08-10 14:06:08
8e0ccdf43fd21d36e9e1f5047afe6f690ef17f54...23a5653a0deb61762aa6084494e6047e1da1fc4c,1,0,4,4,2,2011-07-20 18:24:17,2011-07-12 13:35:16
23a5653a0deb61762aa6084494e6047e1da1fc4c...d8abc202d58e268f1d3697d04c6c24147dfad835,4,178,210,388,18,2011-07-20 18:24:18,2011-07-15 14:21:16
d8abc202d58e268f1d3697d04c6c24147dfad835...386cfe378ec8c88de8e18293b48e17b326ce0822,1,1,1,2,1,2011-07-20 18:24:20,2011-07-15 14:37:07
386cfe378ec8c88de8e18293b48e17b326ce0822...1e211ec9fadb613ef2c791f76270b4cffc8035c8,4,13,9,22,10,2011-07-20 18:24:21,2011-07-15 15:10:46
1e211ec9fadb613ef2c791f76270b4cffc8035c8...b1c10b9e17e48fae10fc8252cab5219f32fba893,2,10,3,13,3,2011-07-20 18:24:23,2011-07-15 16:13:28
b1c10b9e17e48fae10fc8252cab5219f32fba893...f4975805642c084844a8525a8ae2eb2f88a10f95,2,56,5,61,5,2011-07-20 18:24:24,2011-07-15 18:04:45
f4975805642c084844a8525a8ae2eb2f88a10f95...3b8380de65c3279d5af499c6f208a2a029dd3a1d,9,180,193,373,26,2011-07-20 18:24:26,2011-07-18 17:35:26
3b8380de65c3279d5af499c6f208a2a029dd3a1d...d9535ed1e3de8a86b5731320b46e3027b997f488,1,13,1,14,3,2011-07-20 18:24:27,2011-07-20 18:24:03
d9535ed1e3de8a86b5731320b46e3027b997f488...1e74c6519d92a813ce2286f940c11c93a9820a45,1,10,10,20,1,2011-07-20 19:28:06,2011-07-20 19:28:06
1e74c6519d92a813ce2286f940c11c93a9820a45...351b732795500444984e6b1f48bd2c171f64b662,1,4,1,5,1,2011-07-20 19:28:23,2011-07-20 19:28:23
351b732795500444984e6b1f48bd2c171f64b662...9ce68d36823c22f641f705928f1c1b22f6206d76,3,24,4,28,8,2011-08-17 19:00:01,2011-08-17 19:00:01
6ffd32490b6e29de611eab7d5ebc8bcf3c0286a7...aa9e7443ab22410fe35437760deea643f57375d4,2,98,92,190,31,2011-10-11 19:16:55,2011-10-11 19:16:55
bcf1fab6d70979a24163348f30219bd71e539bda...e35994823ac59fbb3e65ee236add1e45f227db87,1,7,2,9,3,2011-10-07 16:44:55,2011-10-07 16:44:36
c0ca6541e89e5490a84e32ec792428f4a4d12f50...c280fb2019086298c0042f54b0746cec8c108e56,2,4,0,4,2,2012-05-11 20:58:10,2012-05-11 20:58:10
c0ca6541e89e5490a84e32ec792428f4a4d12f50...214a8cd3ff18819c7e3c300ffbd4295a0eb014c0,1,3,0,3,1,2012-05-10 19:18:58,2012-05-10 19:18:58
214a8cd3ff18819c7e3c300ffbd4295a0eb014c0...dd7ae3ef3d806706b7b79856ea9ebb3ff06fe71f,3,16,7,23,7,2012-05-10 20:36:21,2012-05-10 20:29:53
dd7ae3ef3d806706b7b79856ea9ebb3ff06fe71f...e43051588c306c0cc20e91f83104d7b940ea5c61,2,0,9,9,2,2012-05-10 21:21:34,2012-05-08 21:13:44
e43051588c306c0cc20e91f83104d7b940ea5c61...9c86584ee59d9033e9ec4e2b8278a9d59f82dd4d,1,33,0,33,1,2012-05-10 21:31:14,2012-05-10 16:26:14
9c86584ee59d9033e9ec4e2b8278a9d59f82dd4d...e385621d87ac747c088d0c1885f450e3cbd4f456,4,64,27,91,15,2012-05-11 02:42:26,2012-05-09 15:53:45
e385621d87ac747c088d0c1885f450e3cbd4f456...d1db793b8a1b47499cda510765c13137d24b93ba,1,15,1,16,2,2012-05-11 02:42:40,2012-05-11 02:07:39
d1db793b8a1b47499cda510765c13137d24b93ba...0a8b446ad74b066db926d37f990224deddf1695f,1,1,1,2,1,2012-05-11 03:30:20,2012-05-11 03:30:20
0a8b446ad74b066db926d37f990224deddf1695f...9b42753b049f2a21dbdda45d0bfe685a8882bc8a,1,9,0,9,2,2012-05-11 05:26:33,2012-05-10 18:46:08
9b42753b049f2a21dbdda45d0bfe685a8882bc8a...844026a1c9fec4152aebb1641bf6b6047f8d3ad7,1,2,0,2,2,2012-05-11 05:26:33,2012-05-10 19:19:16
844026a1c9fec4152aebb1641bf6b6047f8d3ad7...25bdc679a0e559d64ec7f22b0468cf5b1671c4e7,5,159,1,160,6,2012-05-11 05:26:33,2012-05-10 21:33:30
25bdc679a0e559d64ec7f22b0468cf5b1671c4e7...572fc330d8688892c861080c790d46ef1dac709c,2,4,2,6,4,2012-05-11 05:26:33,2012-05-11 02:36:21
572fc330d8688892c861080c790d46ef1dac709c...499678422da4f7ee822d6cfb88f5a149f0c2cfb0,2,115,2,117,4,2012-05-11 05:26:33,2012-05-11 05:26:03
499678422da4f7ee822d6cfb88f5a149f0c2cfb0...ab23d5632760fda9a706465e96c634e1554df738,1,1,1,2,1,2012-05-11 05:29:38,2012-05-11 05:29:38
ab23d5632760fda9a706465e96c634e1554df738...6e8d1cbc6e90171d476c94d38638b213621536f2,10,44,0,44,20,2012-05-11 13:29:58,2012-05-11 13:29:58
6e8d1cbc6e90171d476c94d38638b213621536f2...d155dd1687ef77cfb332f55a9e698ba6813d41f6,1,3,0,3,1,2012-05-11 17:56:52,2012-05-11 17:55:47
d155dd1687ef77cfb332f55a9e698ba6813d41f6...68874e89a8a8d4fa02de9c8479a536490115054c,1,38,29,67,5,2012-05-11 17:56:52,2012-05-11 17:55:59
68874e89a8a8d4fa02de9c8479a536490115054c...cca4fc03d8f4570ad4645bec41ad2dfa0be83613,6,671,0,671,6,2012-05-11 17:56:52,2012-05-11 17:56:34
cca4fc03d8f4570ad4645bec41ad2dfa0be83613...88bd3acc4f2fd69720509f69fe097fcf7e568c5a,2,7,1,8,2,2012-05-11 18:05:29,2012-05-11 18:05:29
88bd3acc4f2fd69720509f69fe097fcf7e568c5a...2b2892fa8b26e00ad398e7da8374b6ab9634c8e3,2,64,64,128,29,2012-05-11 19:45:23,2012-05-11 19:45:23
2b2892fa8b26e00ad398e7da8374b6ab9634c8e3...c9819685b10108ed14aa4efc886950bf8b78a3c9,2,67,69,136,54,2012-05-11 20:02:12,2012-05-11 20:02:12
c9819685b10108ed14aa4efc886950bf8b78a3c9...9f39db5aaa6168c2b227b8d23917d163efb39143,2,13,10,23,4,2012-05-11 20:11:28,2012-05-11 20:11:28
9f39db5aaa6168c2b227b8d23917d163efb39143...2f3f627f810e3cd1073edc8fdffb2d3763845ff3,2,126,45,171,22,2012-05-11 20:48:17,2012-05-11 20:48:17
6beeeee10daa4e0addbd879bfb31b548a4e42409...ee938e39a1336eb0eea1df14a68ec1ec61fe7db4,1,0,6,6,1,2011-08-10 21:47:21,2011-08-10 21:47:21
ee938e39a1336eb0eea1df14a68ec1ec61fe7db4...be8931b7eee5f6efa111cd0ad8f45ccfcffca6ca,4,9,3,12,4,2011-08-11 05:29:21,2011-08-11 05:29:21
be8931b7eee5f6efa111cd0ad8f45ccfcffca6ca...f95d8d5594077358e7932a1781dad56f1dd7ad66,3,5,5,10,5,2011-08-12 15:23:06,2011-08-12 15:23:06
f95d8d5594077358e7932a1781dad56f1dd7ad66...94ce2d93733dcbc515a1325d759b8312962279db,1,16,4,20,2,2011-08-12 20:28:36,2011-08-12 20:27:33
94ce2d93733dcbc515a1325d759b8312962279db...4a85b6e6dc3e1e0cd52ae8b8b0409bc031e266b8,2,2,2,4,2,2011-08-15 14:18:09,2011-08-15 14:18:09
4a85b6e6dc3e1e0cd52ae8b8b0409bc031e266b8...d203268f7450b43f849144d954955702c75100b2,1,24,0,24,1,2011-08-15 22:46:58,2011-08-15 22:44:23
d203268f7450b43f849144d954955702c75100b2...5696d8190bc97fc782ca0346d96a7afdc54ecc5f,1,8,8,16,8,2011-08-15 22:59:19,2011-08-15 22:59:19
5696d8190bc97fc782ca0346d96a7afdc54ecc5f...861bc071b86f03816beb7e63e65f242d4cf504c4,1,1,1,2,1,2011-08-15 23:12:37,2011-08-15 23:11:15
861bc071b86f03816beb7e63e65f242d4cf504c4...4edeb8f2b0050dc918a7d935afd458dd05ff515a,1,1,0,1,1,2011-08-15 23:16:40,2011-08-15 23:15:57
6beeeee10daa4e0addbd879bfb31b548a4e42409...891b621617e7ea17a181a9fd506b66ba6c364ae2,1,6,0,6,1,2011-08-10 14:49:27,2011-08-10 14:49:27
e35994823ac59fbb3e65ee236add1e45f227db87...96d3a48bbedafc4e18b5279fa3a12361b20fc70e,1,2,0,2,1,2011-10-07 20:58:25,2011-10-07 20:58:15
96d3a48bbedafc4e18b5279fa3a12361b20fc70e...10599e0f5b93ba74179929cc23a4f20c60329dfb,1,8,4,12,4,2011-10-07 21:05:05,2011-10-07 21:05:05
10599e0f5b93ba74179929cc23a4f20c60329dfb...6fee908ce602f3f6b7763f21ca35dca3766d7443,1,22,4,26,8,2011-10-07 22:11:09,2011-10-07 22:09:35
e35994823ac59fbb3e65ee236add1e45f227db87...f2cbb543899dc8414d365ecd458c9715ea18eaff,1,7,7,14,4,2011-10-07 16:54:57,2011-10-07 16:54:57
827a97a89bd6986bf5c6162557a9687fb5a8d909...bdd2e7442504ca141a639016c0cd4fff20a2ecf6,2,8,8,16,8,2012-05-11 21:37:23,2012-05-11 21:37:23
bdd2e7442504ca141a639016c0cd4fff20a2ecf6...91efed21d2be0871d30e2f83a6ae03ec7828d52d,2,4,4,8,4,2012-05-11 21:54:07,2012-05-11 21:54:07
91efed21d2be0871d30e2f83a6ae03ec7828d52d...3260cdeb442d65058ea2cb29348902a7d3c77413,6,1619,1563,3182,12,2012-05-11 22:52:39,2012-05-11 22:52:39
3260cdeb442d65058ea2cb29348902a7d3c77413...80ff8f73f9c0da7fb0636a48c3c2562eed01aba4,6,23,9,32,13,2012-05-12 00:12:34,2012-05-12 00:12:34
80ff8f73f9c0da7fb0636a48c3c2562eed01aba4...4951e568672740b8bd783402afcb03dfd2db1d9c,1,14,2,16,2,2012-05-13 01:07:09,2012-05-13 01:07:09
4951e568672740b8bd783402afcb03dfd2db1d9c...b2d0883ba1450073e2b7fdd11fda8bbbbc26cee0,2,100,0,100,3,2012-05-13 23:06:27,2012-04-28 04:45:54
b2d0883ba1450073e2b7fdd11fda8bbbbc26cee0...e19cd475fbc39a1d596855fe8a86f7f18a7b6f2b,2,11,8,19,5,2012-05-13 23:06:27,2012-04-28 04:55:55
e19cd475fbc39a1d596855fe8a86f7f18a7b6f2b...d22b0b35ab5d09c0b4f881bd69a4f43ae7199586,1,98,2,100,4,2012-05-13 23:06:28,2012-05-11 00:33:00
d22b0b35ab5d09c0b4f881bd69a4f43ae7199586...713627d22201a9698f106bb331a35c1ac61a5cde,7,30,19,49,11,2012-05-13 23:06:28,2012-04-30 03:43:01
713627d22201a9698f106bb331a35c1ac61a5cde...39cee2f29437364f2f53cd7673ff373a74b781cf,5,8,3,11,5,2012-05-13 23:06:28,2012-04-30 17:34:51
39cee2f29437364f2f53cd7673ff373a74b781cf...97db2e76d14c2b15512139fca7cd40d8768ebd5b,2,1,5,6,2,2012-05-13 23:06:28,2012-04-30 19:35:24
97db2e76d14c2b15512139fca7cd40d8768ebd5b...f34ec97947ea227145b402ed0329b583881f4d39,1,30,0,30,1,2012-05-13 23:06:28,2012-04-30 20:50:26
f34ec97947ea227145b402ed0329b583881f4d39...50f4b38c00e014095237d4d9ea406620e8f01396,1,8,15,23,12,2012-05-13 23:06:28,2012-05-11 00:08:25
50f4b38c00e014095237d4d9ea406620e8f01396...dff8cd5e31ddb04aea422641cc2e9e3b2eebe48c,5,48,51,99,11,2012-05-13 23:06:28,2012-05-11 01:00:38
dff8cd5e31ddb04aea422641cc2e9e3b2eebe48c...1a51bec9780e7337f6b4a09e33244df70204aad0,1,4,7,11,5,2012-05-13 23:06:28,2012-05-11 01:28:21
1a51bec9780e7337f6b4a09e33244df70204aad0...4142a5ba5f6e2416b161dc05ceaf329a51c21929,1,2,3,5,1,2012-05-13 23:06:28,2012-05-11 01:41:12
4142a5ba5f6e2416b161dc05ceaf329a51c21929...871128194bbd5a605430d7924970f2d464ddfe69,1,22,4,26,8,2012-05-13 23:06:29,2012-05-11 05:37:51
871128194bbd5a605430d7924970f2d464ddfe69...2959f00b6182ff7b357b5db095e681dbe9e48e48,1,1,1,2,1,2012-05-14 00:26:51,2012-05-14 00:26:51
2959f00b6182ff7b357b5db095e681dbe9e48e48...be434049cc0df125eddd3865cd640c25681f7dd8,1,3,1,4,1,2012-05-14 14:56:58,2012-05-14 14:56:58
be434049cc0df125eddd3865cd640c25681f7dd8...dcaefd8cd633cc89bc41f9cc6340c2ad8f65c1f1,8,25,9,34,9,2012-05-14 18:21:28,2012-05-14 18:21:28
dcaefd8cd633cc89bc41f9cc6340c2ad8f65c1f1...b2bd2a532d7de4183ac26961456e59fe6f7d9792,1,2,0,2,1,2012-05-14 20:16:38,2012-05-14 16:51:22
b2bd2a532d7de4183ac26961456e59fe6f7d9792...e3306d5cadc9fc379330ed38e131985f74c7db32,1,1,0,1,1,2012-05-14 20:36:29,2012-05-11 18:57:09
e3306d5cadc9fc379330ed38e131985f74c7db32...46294ab848a441c496d4055ce0839628a258b0d4,2,129,14,143,5,2012-05-14 20:36:29,2012-05-14 20:36:13
46294ab848a441c496d4055ce0839628a258b0d4...9520853dc422d9a0dc3ef4ea13d7bb79a187ed06,1,1,1,2,1,2012-05-15 13:17:13,2012-05-15 13:17:13
9520853dc422d9a0dc3ef4ea13d7bb79a187ed06...af2e70582f728ebf0485603a84d17650db8d2bdc,2,34,41,75,40,2012-05-15 17:14:38,2012-05-15 17:14:38
4edeb8f2b0050dc918a7d935afd458dd05ff515a...eaf7bd21e5f9cc0ecfdc14926a82d0642d3720c1,3,21,3,24,6,2011-08-16 16:09:09,2011-08-16 16:09:09
4edeb8f2b0050dc918a7d935afd458dd05ff515a...1014eba2d3a6f63fb137beabf3277d1249d6a827,5,65,12,77,16,2011-08-16 15:53:09,2011-08-16 15:52:48
ba9a7c9c8551dc87938c5e1592e97f778c3e07a0...62f34935f79a5e43852b102fc7f40e7604532af6,2,50,6,56,8,2011-09-22 17:11:07,2011-09-22 17:11:07
62f34935f79a5e43852b102fc7f40e7604532af6...03866e5cb8a60a389c1c68eb38ff65a29390c988,2,3,3,6,2,2011-09-22 17:52:25,2011-09-22 17:52:25
03866e5cb8a60a389c1c68eb38ff65a29390c988...295dd2221580dc3fe8ca451cb1192d660948a3b8,3,7,5,12,6,2011-09-22 18:27:24,2011-09-22 18:27:24
295dd2221580dc3fe8ca451cb1192d660948a3b8...84816a694455521ecd292a23e4072f11258232a8,1,2,2,4,2,2011-09-22 20:17:12,2011-09-22 20:17:12
84816a694455521ecd292a23e4072f11258232a8...6a5bed92f5ba424b965f4c3552cd5dc2b0dc28ce,2,34,2,36,4,2011-09-22 21:08:03,2011-09-22 21:08:03
6a5bed92f5ba424b965f4c3552cd5dc2b0dc28ce...5bc9ef436a40c6002b4c9f1229c17aab96e01710,1,9,2,11,2,2011-09-22 22:09:06,2011-09-22 22:09:06
5bc9ef436a40c6002b4c9f1229c17aab96e01710...00ebd4c1f9272dffa901634b715111f7b5136200,1,19,13,32,2,2011-09-23 02:34:54,2011-09-23 02:34:54
00ebd4c1f9272dffa901634b715111f7b5136200...a0288e57f0bf22781ec7a7e44820a11d18e3582a,3,7,3,10,4,2011-09-23 02:44:06,2011-09-23 02:44:06
a0288e57f0bf22781ec7a7e44820a11d18e3582a...68773c1816e297500c0727ea8037e5377550d171,2,15,0,15,2,2011-09-23 03:37:41,2011-09-23 03:37:41
422ad22e0bdcb1f462b565ca00fa53c129395b75...182cd993f40554fdcd510d087b96ffd2c100d73a,1,5,11,16,6,2011-10-11 23:13:31,2011-10-11 23:13:31
422ad22e0bdcb1f462b565ca00fa53c129395b75...b167d01deb21c672822bde0f4d8d317aeb5d980a,1,1,1,2,1,2011-10-11 19:09:40,2011-10-11 19:09:40
b167d01deb21c672822bde0f4d8d317aeb5d980a...1ea7e499bc0c2d8e8c56c6e2a159f92804f1f649,1,1,1,2,1,2011-10-11 22:37:58,2011-10-11 22:37:58
1ea7e499bc0c2d8e8c56c6e2a159f92804f1f649...6d573a9a6e2de66241be53f5eef6873ae2cc12f6,3,10,1,11,3,2011-10-11 22:48:51,2011-10-11 22:44:29
025c8988b6f2fc7ce14152c43deb23de71fe7c5a...a6bfe265732c01c7ea2626b6889dbc9bba6918ca,5,107,56,163,41,2011-10-07 22:40:13,2011-10-07 22:39:26
a6bfe265732c01c7ea2626b6889dbc9bba6918ca...fccf1190d8ad44e553e80938916bcd111d95b9a4,2,2,2,4,2,2011-10-07 23:29:26,2011-10-07 23:29:26
fccf1190d8ad44e553e80938916bcd111d95b9a4...f727f3b6feadd2583417eddb0991175c62183b33,1,1,1,2,1,2011-10-08 00:52:20,2011-10-08 00:51:10
af2e70582f728ebf0485603a84d17650db8d2bdc...d1ac9d3d385d2ab1c5b1845d2487f0f34597b315,1,1,1,2,1,2012-05-15 18:05:36,2012-05-15 18:05:36
d1ac9d3d385d2ab1c5b1845d2487f0f34597b315...25d28227cef651581d0484c8ed7fd3cc79cca8e2,3,16,1,17,7,2012-05-15 18:14:14,2012-05-15 18:14:14
af2e70582f728ebf0485603a84d17650db8d2bdc...1b4fc46b1af93fe1b664c174dfe9462e53a4948e,1,1,1,2,1,2012-05-15 17:22:24,2012-05-15 17:22:20
1b4fc46b1af93fe1b664c174dfe9462e53a4948e...d29b88b629a3deab6f39da1996ec0061d90957cf,1,2,0,2,2,2012-05-15 18:03:12,2012-05-15 18:02:37
d29b88b629a3deab6f39da1996ec0061d90957cf...c84b884d83250c97f88fd94f2b4420918a4b6825,2,15,30,45,6,2012-05-15 18:08:02,2012-03-30 14:26:19
8a01511716442f90f2ca58fe4c4b1751e6c7e4e6...bec867911ee3bd9b373ea5ea9a3d14a31d02985b,4,58,92,150,16,2011-08-16 17:50:10,2011-08-16 17:49:57
bec867911ee3bd9b373ea5ea9a3d14a31d02985b...d790a3ec6d6729da69e92ac2b11d491139b692a0,4,9,9,18,8,2011-08-16 18:19:44,2011-08-16 16:18:32
d790a3ec6d6729da69e92ac2b11d491139b692a0...c7af2b967374ff4b18e069e274c060ac1cc2b805,1,1,0,1,1,2011-08-16 18:19:44,2011-08-16 18:19:32
c7af2b967374ff4b18e069e274c060ac1cc2b805...912924dd7029eedf88e8314ad90bed0a94ba0e14,2,39,0,39,2,2011-08-16 21:23:59,2011-08-16 21:10:46
912924dd7029eedf88e8314ad90bed0a94ba0e14...6ebfbc789e051993918d4322abf8c30566218934,1,1,1,2,1,2011-08-16 21:23:59,2011-08-16 21:22:54
6ebfbc789e051993918d4322abf8c30566218934...f1681e269520e8f7ab4ed2502a2978f52a9ce37c,1,26,0,26,1,2011-08-17 14:13:01,2011-08-17 14:13:01
f1681e269520e8f7ab4ed2502a2978f52a9ce37c...ed52408bf3f6709d41b9d48506bdfe1ae6529e0a,1,2,2,4,2,2011-08-17 14:26:22,2011-08-17 14:26:22
ed52408bf3f6709d41b9d48506bdfe1ae6529e0a...7cf4d7ce6cc36525b4c17aea4d4e75d33b422356,1,10,0,10,1,2011-08-17 14:26:27,2011-08-17 14:26:27
7cf4d7ce6cc36525b4c17aea4d4e75d33b422356...328ca2cdef89c55bc06180769618fff275fbd503,1,40,0,40,1,2011-08-17 14:46:58,2011-08-17 14:46:58
328ca2cdef89c55bc06180769618fff275fbd503...c3e0e5253cb3aaeee0e5e32d44d38fd6add65c5e,1,1,1,2,1,2011-08-17 15:15:09,2011-08-17 15:15:09
c3e0e5253cb3aaeee0e5e32d44d38fd6add65c5e...661827cc85cbc500d7638c63b6edba947e4e84cb,1,1,0,1,1,2011-08-17 17:02:41,2011-08-17 17:02:27
661827cc85cbc500d7638c63b6edba947e4e84cb...741b459171ef903afa0e8b2124c1e06072836060,1,6,0,6,1,2011-08-17 17:24:46,2011-08-17 17:24:46
741b459171ef903afa0e8b2124c1e06072836060...e9759a516c6ecd82a991f2150cbc7767f0eccb0e,1,6,2,8,1,2011-08-17 18:47:40,2011-08-17 18:45:14
e9759a516c6ecd82a991f2150cbc7767f0eccb0e...e4a084bdab0e2a61e81476068ed494e346715d41,1,1,1,2,1,2011-08-17 18:47:40,2011-08-17 18:47:15
42a06904e7624aa3cc9962e384ebdbb91fdd33b7...3c712b18936a7d3e2f74e7bb9c8d6cbbe076ba10,1,7,2,9,1,2011-09-23 03:44:38,2011-09-23 03:44:16
3c712b18936a7d3e2f74e7bb9c8d6cbbe076ba10...6f154bdb998e239362ef455cfd220246cc625967,1,16,1,17,1,2011-09-23 21:00:09,2011-09-23 21:00:09
5f94b6b331a124d41803d063dc1e34a758d11659...bab879f96beaaa166c9cfd908864102700c898e5,1,9,6,15,3,2011-10-12 02:38:17,2011-10-12 02:38:17
bab879f96beaaa166c9cfd908864102700c898e5...0198a3c09726c3e85956e8cbd0bf363d05c74ac4,1,12,8,20,4,2011-10-12 05:41:17,2011-10-12 05:39:34
0198a3c09726c3e85956e8cbd0bf363d05c74ac4...23a75f9cf4ef9de37928bb0d495dfc214837964f,2,10,2,12,3,2011-10-12 05:55:02,2011-10-12 05:55:02
23a75f9cf4ef9de37928bb0d495dfc214837964f...c5e9162870e1fbf060ba5b20cb57e13ae9fff877,1,4,2,6,2,2011-10-12 16:36:22,2011-10-12 16:36:22
f727f3b6feadd2583417eddb0991175c62183b33...d6f97c514b2a374ec4e7e9aa1c501acaaa3197e9,4,8,7,15,7,2011-10-10 07:26:10,2011-10-10 07:26:10
f727f3b6feadd2583417eddb0991175c62183b33...193a18925c6ea10f4f86574cbc87bb541e720ff2,1,1,1,2,1,2011-10-09 14:40:25,2011-10-06 11:58:14
f727f3b6feadd2583417eddb0991175c62183b33...0e33f55dbb83046134fc600fccfe493a42ed1e6e,1,0,2,2,1,2011-10-09 06:05:47,2011-10-07 13:59:41
a356a2b254d3617c48267dfe49a90bfda527f544...14005315d71200db241834668cc9d85525fdc00e,1,5,1,6,4,2012-05-15 18:30:24,2012-05-15 18:29:21
e4a084bdab0e2a61e81476068ed494e346715d41...e52a031a3272a78e25ce71829a730ef8501a1c85,4,14,7,21,5,2011-08-17 21:49:19,2011-08-17 21:49:03
e52a031a3272a78e25ce71829a730ef8501a1c85...44939bd8634abc88115a8916d03a37de19a0641c,2,28,0,28,3,2011-08-18 04:03:54,2011-08-16 03:26:14
44939bd8634abc88115a8916d03a37de19a0641c...755b58fa1acbc2add57b99e51be205f54a66a1f3,2,2,2,4,2,2011-08-18 04:03:54,2011-08-18 04:02:17
755b58fa1acbc2add57b99e51be205f54a66a1f3...41847975454d3466744717049da08eb28e465936,6,80,35,115,43,2011-08-18 04:03:54,2011-08-18 04:03:35
41847975454d3466744717049da08eb28e465936...294340b750905c6377d97be500336999d1fc46df,1,22,0,22,1,2011-08-18 04:03:54,2011-08-18 04:03:43
294340b750905c6377d97be500336999d1fc46df...61b7f4c41f5137df1f173d2703322d0382d9c048,1,8,4,12,1,2011-08-18 05:45:53,2011-08-18 05:45:53
6f154bdb998e239362ef455cfd220246cc625967...6249553faa8da3468397309a68e1abc45f1d0a72,2,32,1,33,2,2011-09-23 21:26:42,2011-09-23 20:30:45
6249553faa8da3468397309a68e1abc45f1d0a72...131bdebc90c8a1c30ecb35452060c63ca5f33d0d,1,1,0,1,1,2011-09-23 22:07:56,2011-09-23 22:07:56
131bdebc90c8a1c30ecb35452060c63ca5f33d0d...6978f76e224b7d3711b697ed39398a1e940f2c81,1,1,1,2,1,2011-09-26 01:35:12,2011-09-25 20:06:45
6978f76e224b7d3711b697ed39398a1e940f2c81...11d51d22046e62728124e6827374e091d11f0965,1,3,2,5,2,2011-09-26 01:35:12,2011-09-26 01:34:52
11d51d22046e62728124e6827374e091d11f0965...299620984586bdb497342d7ba60a4fb967e4ccb3,1,1,1,2,1,2011-09-26 04:26:10,2011-09-26 04:26:10
299620984586bdb497342d7ba60a4fb967e4ccb3...a6316f049b8a3d904754f4ca9850246212b06087,1,1,1,2,1,2011-09-26 04:34:30,2011-09-26 04:34:30
a6316f049b8a3d904754f4ca9850246212b06087...4bd1cdf8b16e1a6ea8606b5a3ee5201b6d4f1143,1,1,1,2,1,2011-09-26 04:36:01,2011-09-26 04:36:01
4bd1cdf8b16e1a6ea8606b5a3ee5201b6d4f1143...8acb9cdcd1799a65817d6872f07b647cfddf9497,2,32,0,32,2,2011-09-26 05:50:48,2011-09-26 05:50:20
8acb9cdcd1799a65817d6872f07b647cfddf9497...5238cccca6ce47f9b427ace48cd57a4fa225ba74,3,14,5,19,7,2011-09-26 06:22:27,2011-09-26 06:22:27
923f3de85721b474e1895b32f7080f3a1ef04996...1fa05e4ea5d45c238784a236639cdc64b3435fdb,2,32,859,891,22,2011-08-29 20:01:43,2011-08-29 20:01:43
1fa05e4ea5d45c238784a236639cdc64b3435fdb...be1e9a5ab7e177868a9421014f731c5dda68ea03,1,3,1,4,1,2011-09-06 20:21:44,2011-09-06 20:21:44
be1e9a5ab7e177868a9421014f731c5dda68ea03...a7500b9bc03a274c73dc9111e177618d9eccb3cd,1,2,2,4,2,2011-09-06 20:22:10,2011-09-06 20:22:10
a7500b9bc03a274c73dc9111e177618d9eccb3cd...a739d964f9264dc73e7efac913fc5d088614b1eb,1,26,0,26,1,2011-09-06 20:23:19,2011-09-06 20:23:19
a739d964f9264dc73e7efac913fc5d088614b1eb...296e4e15da3d13ce7d098c80fbde355d731cc46c,1,1,1,2,1,2011-09-20 19:58:20,2011-09-20 19:58:20
296e4e15da3d13ce7d098c80fbde355d731cc46c...bb43338c2ec412ac4858a004c3c3f8f92f5bb811,4,80,28,108,32,2011-09-26 16:59:33,2011-09-26 16:59:33
bb43338c2ec412ac4858a004c3c3f8f92f5bb811...6d7e7fdf0d48c7e674dab1989e884a2b9aa02ed1,1,1,0,1,1,2011-10-03 17:07:06,2011-10-03 17:07:06
c5e9162870e1fbf060ba5b20cb57e13ae9fff877...862dc0f71176b38a8c8b74cf5e89cd1589a41efe,1,12,5,17,5,2011-10-13 11:54:51,2011-10-13 11:54:51
c5e9162870e1fbf060ba5b20cb57e13ae9fff877...8434e67a31627e7c26117c49ba18e2d625c3eb99,1,5,12,17,4,2011-10-13 11:28:22,2011-10-13 11:28:22
c5e9162870e1fbf060ba5b20cb57e13ae9fff877...5eb65e7d66ac080b47e7b4c1b87f58d828b14554,1,3,1,4,1,2011-10-13 03:47:37,2011-10-11 22:19:57
5eb65e7d66ac080b47e7b4c1b87f58d828b14554...3e153de2b9e4fa4acf4b1e513a96c0ac0dc2cb84,1,5,8,13,3,2011-10-13 05:03:24,2011-10-12 21:29:15
3e153de2b9e4fa4acf4b1e513a96c0ac0dc2cb84...8631cd3aa42c3c3be15c231aac752b3a5976a3ea,2,2,49,51,2,2011-10-13 05:03:24,2011-10-12 21:43:51
8631cd3aa42c3c3be15c231aac752b3a5976a3ea...a087cc3e72a960f95ce7a297b30cbe51cc31fd12,3,40,6,46,6,2011-10-13 05:03:24,2011-10-13 05:02:15
a087cc3e72a960f95ce7a297b30cbe51cc31fd12...e3552a8abddbd6dc68beb467537a4dc10303bd52,1,0,5,5,1,2011-10-13 14:44:21,2011-10-13 14:44:21
e3552a8abddbd6dc68beb467537a4dc10303bd52...b9a31adaf216643f687a3a70cf96530e11785b5e,1,7,0,7,1,2011-10-13 15:23:12,2011-10-13 15:22:19
b9a31adaf216643f687a3a70cf96530e11785b5e...983d18b904300a4780b05d7190449f1399effc42,3,25,3,28,10,2011-10-13 15:37:30,2011-10-13 15:34:58
983d18b904300a4780b05d7190449f1399effc42...3cf3191a4f74830bf81f9098e56b3a6085bcc120,1,6,6,12,6,2011-10-13 16:40:30,2011-10-13 16:40:30
3cf3191a4f74830bf81f9098e56b3a6085bcc120...6867235eb7f33aca43a9d8f4e4afc46c492dcf24,2,38,3,41,5,2011-10-13 16:55:03,2011-10-13 16:54:44
6867235eb7f33aca43a9d8f4e4afc46c492dcf24...f0a76d4deda4ab356a967c9abfab6a574be10cf2,1,48,0,48,1,2011-10-13 17:31:17,2011-10-13 17:31:17
f0a76d4deda4ab356a967c9abfab6a574be10cf2...c6891bbb029a6bf7e39d5dfa1883cb72ad1fd217,1,4,2,6,2,2011-10-13 18:19:05,2011-10-13 18:19:05
c6891bbb029a6bf7e39d5dfa1883cb72ad1fd217...a2d39ce4db48edfa98ab571a406288f3ed157c4f,2,18,18,36,2,2011-10-13 18:46:00,2011-10-13 18:45:38
a2d39ce4db48edfa98ab571a406288f3ed157c4f...5c527e31fbfc23cf6218e952c74bd83cf5a66280,2,14,15,29,10,2011-10-13 19:04:26,2011-10-13 19:04:26
5c527e31fbfc23cf6218e952c74bd83cf5a66280...ffa338a9df43b42e94cff3d032d9aab5c4c57f22,1,3,3,6,3,2011-10-13 19:24:29,2011-10-13 19:23:31
ffa338a9df43b42e94cff3d032d9aab5c4c57f22...a0407a42bfa57322feebd7286bd168233e5c699d,1,82,97,179,40,2011-10-13 19:45:35,2011-10-11 14:36:35
a0407a42bfa57322feebd7286bd168233e5c699d...9b12a1c446fc4c21bd833e6b3b1a34d2c15af5bd,2,5,3,8,3,2011-10-13 19:51:43,2011-10-13 19:51:05
9b12a1c446fc4c21bd833e6b3b1a34d2c15af5bd...89271fb8acde5b1ccb523ab1f48c1728e6dc3aae,2,90,13,103,18,2011-10-13 21:43:35,2011-10-13 21:43:35
89271fb8acde5b1ccb523ab1f48c1728e6dc3aae...08cc9293c061567070880a65c98542d6d2eccab8,1,3,1,4,2,2011-10-14 13:52:44,2011-10-14 13:52:44
c5e9162870e1fbf060ba5b20cb57e13ae9fff877...443ecbfb44e7a474749f3f40f4f877aa41b28e6e,1,4,1,5,1,2011-10-12 19:50:31,2011-10-12 19:50:31
c5e9162870e1fbf060ba5b20cb57e13ae9fff877...7d45ecb7d2e0344b425c7ec39aa6d2c0f47e3598,1,6,5,11,1,2011-10-12 19:24:24,2011-10-12 19:24:24
c5e9162870e1fbf060ba5b20cb57e13ae9fff877...294bec31d9aa9baa048ed2bf2355f366828d5333,1,1,1,2,1,2011-10-12 18:47:28,2011-10-12 18:47:28
a67d3bb4d58f881ba006412e5941a0866dfdd57c...30b5c677c7d7f3b87df1d9132f48cb55b3e448a6,1,2,1,3,2,2011-10-10 16:22:41,2011-10-06 03:57:42
30b5c677c7d7f3b87df1d9132f48cb55b3e448a6...797aef7d4a7173f64a7516a10a03cf743ddf55fc,1,1,1,2,1,2011-10-10 19:18:56,2011-10-10 19:18:56
797aef7d4a7173f64a7516a10a03cf743ddf55fc...f32f57710adf03581f36c63791e2c0f41938b145,1,1,0,1,1,2011-10-10 21:57:34,2011-10-10 21:57:34
f32f57710adf03581f36c63791e2c0f41938b145...6eda02ee54ee83217dcbd60b6a0aba8f599cefdb,1,10,1,11,4,2011-10-10 22:10:26,2011-10-10 22:10:26
6eda02ee54ee83217dcbd60b6a0aba8f599cefdb...0e0bc692990632f9ce89b35a3cb58fe699be171b,1,15,2,17,2,2011-10-10 22:11:06,2011-10-10 22:11:06
83392d42f976211d32cdbc1104993beb16c142f6...615e95459ed462e8fe20eaaa5d888c611427ada8,2,31,2,33,5,2011-10-10 05:58:20,2011-10-10 05:56:45
615e95459ed462e8fe20eaaa5d888c611427ada8...e3294065ef9a0aa5250ce00817cc228037a47f4b,1,2,2,4,2,2011-10-10 06:44:43,2011-10-10 06:44:43
be9716c0e4a347ae75c04b7386116647c58b6570...f14315265113e7e9a00b06125b6b285dd71ab162,1,3,1,4,2,2011-10-11 07:40:04,2011-10-11 07:40:04
f14315265113e7e9a00b06125b6b285dd71ab162...31bb33c1207a288c49748c869681d96be808622b,1,6,2,8,2,2011-10-11 13:52:02,2011-10-11 13:52:02
31bb33c1207a288c49748c869681d96be808622b...27927dc47b9199e263198d34565f9a25c92b1d83,1,1,1,2,1,2011-10-11 14:04:02,2011-10-11 14:04:02
14005315d71200db241834668cc9d85525fdc00e...c78371347eb8a8fa0a64a58877b0520efa076eec,1,1,1,2,1,2012-05-15 21:40:01,2012-05-15 21:40:01
61b7f4c41f5137df1f173d2703322d0382d9c048...5bd3f44d5ce76fb44a83e8e278c062c83e5ccaa0,57,74,51,125,24,2011-08-18 14:49:50,2011-08-18 14:49:50
5bd3f44d5ce76fb44a83e8e278c062c83e5ccaa0...93ce4de477c610b8ba667b22b72121bd00a40d0b,1,9,0,9,1,2011-08-18 15:25:58,2011-08-18 15:25:58
93ce4de477c610b8ba667b22b72121bd00a40d0b...57b9824bfa3bd9d4784ec74845d9f9615040adf6,1,11,2,13,2,2011-08-18 15:41:05,2011-08-18 15:41:05
57b9824bfa3bd9d4784ec74845d9f9615040adf6...80e1959f1c6825e562e7d9c9ca7e8a7d4e330907,1,4,0,4,2,2011-08-18 16:09:12,2011-08-18 16:09:12
80e1959f1c6825e562e7d9c9ca7e8a7d4e330907...02ab18d5fdead80828e7feb8060a89ccfd6b2b0b,1,12,13,25,2,2011-08-18 17:12:43,2011-08-18 17:12:37
02ab18d5fdead80828e7feb8060a89ccfd6b2b0b...0e297b70f122ecb8220eb351f5456d3c30910b71,3,16,10,26,5,2011-08-18 17:24:59,2011-08-18 17:24:59
0e297b70f122ecb8220eb351f5456d3c30910b71...6a34e4c98fd4d7cc20e37561311a3c0ac2425a67,1,0,1,1,1,2011-08-18 17:47:57,2011-08-18 17:44:42
6a34e4c98fd4d7cc20e37561311a3c0ac2425a67...20f2d1669f16247f70d8e4a62c3b870dcf1018aa,1,1,1,2,1,2011-08-18 17:47:58,2011-08-18 17:47:18
20f2d1669f16247f70d8e4a62c3b870dcf1018aa...76f4adcc5f2ff290dddf9a88aceb3a516a01855b,1,10,15,25,4,2011-08-18 17:54:09,2011-08-18 17:54:09
76f4adcc5f2ff290dddf9a88aceb3a516a01855b...209689f23055c2e5fcd1e764f33be3a11f15a6a4,1,1,1,2,1,2011-08-18 18:50:27,2011-08-18 18:50:27
209689f23055c2e5fcd1e764f33be3a11f15a6a4...68d95172a7e975156d6ffa4244b5a72ee01fa0d5,1,24,0,24,1,2011-08-18 19:49:14,2011-08-18 19:31:22
68d95172a7e975156d6ffa4244b5a72ee01fa0d5...09670c72f6ebadd972bba779fb4a33ca52d18ae9,4,4,4,8,4,2011-08-19 05:00:21,2011-08-19 05:00:21
09670c72f6ebadd972bba779fb4a33ca52d18ae9...db5ace7c7c837502b6c21f99ac0c8ace4520d679,1,6,1,7,1,2011-08-19 05:06:11,2011-08-19 05:06:11
5238cccca6ce47f9b427ace48cd57a4fa225ba74...5b39cc6b52893b54d021e3014380b6d9cf9f9eed,1,22,18,40,2,2011-09-26 15:49:32,2011-09-26 15:49:32
5b39cc6b52893b54d021e3014380b6d9cf9f9eed...d65ada091f100383ebe5299f08712437a82203ee,1,1,1,2,1,2011-09-26 16:05:00,2011-09-26 16:05:00
d65ada091f100383ebe5299f08712437a82203ee...cd335640b633738bae9d1f15ad0e584b110e1cf2,2,4,2,6,3,2011-09-26 16:18:50,2011-09-26 16:18:50
cd335640b633738bae9d1f15ad0e584b110e1cf2...66a752ea8ea32936a6895af274a5b937e90a9556,1,4,0,4,1,2011-09-26 16:42:26,2011-09-26 16:42:26
751896bafd129f851d334035e7a79ca51be5eeea...f212548acebb75a8d543cea70217b654e750bfbe,1,0,3,3,2,2011-11-01 04:53:04,2011-11-01 04:53:04
f212548acebb75a8d543cea70217b654e750bfbe...41e5ee7a2fc5a47786ec9af9887cf86cec24defd,1,16,7,23,4,2011-11-01 04:56:17,2011-11-01 04:56:17
41e5ee7a2fc5a47786ec9af9887cf86cec24defd...72e20613b6c428cb3dbe6ea1ebdaa72b99aa0093,2,38,16,54,5,2011-11-01 14:12:11,2011-11-01 14:11:21
72e20613b6c428cb3dbe6ea1ebdaa72b99aa0093...4f9e3778a17e397400978985f312bc91c927040f,1,2,0,2,1,2011-11-01 14:20:29,2011-11-01 14:20:29
4f9e3778a17e397400978985f312bc91c927040f...7c59742f5cc890be76d2c79b9cea50b1fe095dae,1,86,0,86,1,2011-11-01 16:21:49,2011-11-01 16:21:25
7c59742f5cc890be76d2c79b9cea50b1fe095dae...f3f72f6c948837ac6a03e73832a4712d886dba09,1,1,0,1,1,2011-11-01 16:46:08,2011-11-01 16:35:49
f3f72f6c948837ac6a03e73832a4712d886dba09...8d0de8ead92e400676663db62bdd4cf05907d79d,1,1,1,2,1,2011-11-01 16:46:08,2011-11-01 16:45:34
8d0de8ead92e400676663db62bdd4cf05907d79d...6934c1fa0463d7b6f2755735ff9fe66cd33b89b5,1,17,4,21,4,2011-11-01 21:33:19,2011-11-01 21:32:46
6934c1fa0463d7b6f2755735ff9fe66cd33b89b5...280710fd1b120fd1f89f54a8d5ea9c43d226ee75,1,7,16,23,4,2011-11-01 22:04:34,2011-11-01 22:04:34
280710fd1b120fd1f89f54a8d5ea9c43d226ee75...c96569dc11ed389c7ea279d52b65753aa9946b18,1,1,1,2,1,2011-11-01 22:40:39,2011-11-01 22:26:05
c96569dc11ed389c7ea279d52b65753aa9946b18...19b3476f6ae88ac580d3da944a95c9d5e99874a6,1,3,0,3,1,2011-11-02 01:28:01,2011-11-02 01:27:51
19b3476f6ae88ac580d3da944a95c9d5e99874a6...a377165b1795652b122a85943d8f1b5ba288fe24,1,1,1,2,1,2011-11-02 04:44:40,2011-10-28 15:14:29
a377165b1795652b122a85943d8f1b5ba288fe24...c52c4b53fee060ec1bf77d223ce01dad64e4b1af,1,6,5,11,3,2011-11-02 05:23:32,2011-11-02 05:23:32
c52c4b53fee060ec1bf77d223ce01dad64e4b1af...8a4acb13d2dd36e31171f4c65d1a2ca4195ef433,1,1,1,2,1,2011-11-02 05:34:24,2011-11-02 05:34:24
8a4acb13d2dd36e31171f4c65d1a2ca4195ef433...26e54bc6956dcc5b4f8ce1825ddb4fe94daa50f6,1,36,5,41,7,2011-11-02 05:34:33,2011-11-02 05:34:33
08cc9293c061567070880a65c98542d6d2eccab8...0d5841326875bedd727fa2a5f79a7939cbf68391,1,2,2,4,2,2011-10-14 16:27:39,2011-10-14 16:27:39
0d5841326875bedd727fa2a5f79a7939cbf68391...44115bda3cc73ad916e39f570331b96317bd10fc,1,14,0,14,2,2011-10-14 16:27:58,2011-10-14 16:27:58
08cc9293c061567070880a65c98542d6d2eccab8...92624b2c83e54ef01c9962888a92c2c12cf6f1ca,2,27,36,63,15,2011-10-14 15:29:11,2011-10-14 15:29:11
795c7023663347cd78771bed749795e69ecd7213...9c6d24ad3a483219eb19f1b2e8f2643f72b12e78,2,15,0,15,2,2011-10-16 05:53:38,2011-10-16 05:53:38
9c6d24ad3a483219eb19f1b2e8f2643f72b12e78...eb6cf5a8b744ae1ddc4768d170b5e1a44a01e8c3,1,1,1,2,1,2011-10-16 22:12:26,2011-10-16 22:12:26
eb6cf5a8b744ae1ddc4768d170b5e1a44a01e8c3...ef03c91415753ee793c5512bf8588f3e60ff8d40,1,1,1,2,1,2011-10-16 22:12:35,2011-10-16 22:08:53
ef03c91415753ee793c5512bf8588f3e60ff8d40...b45634307b09030fe8e157120d616464ed947129,1,23,0,23,1,2011-10-16 22:12:35,2011-10-16 22:10:09
b45634307b09030fe8e157120d616464ed947129...4b26a9beb38dcdeddf2f0b1d752873723d33fbb2,1,1,1,2,1,2011-10-17 02:03:09,2011-10-17 02:03:09
4b26a9beb38dcdeddf2f0b1d752873723d33fbb2...8e7706edafefc9f3a4ec9a14206887b15604cc85,2,7,5,12,5,2011-10-17 06:14:12,2011-10-14 21:32:15
8e9e697a7b30a79e1425764098c781d824035b4e...78b691ac625c92e3ec4a2701fd4dd56e18e9c277,1,1,0,1,1,2012-05-16 10:48:28,2012-05-16 10:48:28
78b691ac625c92e3ec4a2701fd4dd56e18e9c277...76632d922ccd3be2fb4374ff5fdf1d8803be0c07,1,40,0,40,1,2012-05-16 12:42:29,2012-05-16 12:42:23
76632d922ccd3be2fb4374ff5fdf1d8803be0c07...bd1e31f9b56e8761d0b608095a635b65e820950e,1,2,0,2,1,2012-05-16 13:03:32,2012-05-16 13:01:12
bd1e31f9b56e8761d0b608095a635b65e820950e...3509a34e11f43e7556d1be41d389b2e23982ab2d,1,3,1,4,2,2012-05-16 13:15:49,2012-05-16 13:15:29
3509a34e11f43e7556d1be41d389b2e23982ab2d...87dfeb1ec0e56759dd6a171e2589bdb42e2e51d3,3,18,14,32,16,2012-05-16 17:38:19,2012-05-16 17:38:19
87dfeb1ec0e56759dd6a171e2589bdb42e2e51d3...f6fe56804714e5f2e786deebf5b8c21de3338144,4,150,3,153,11,2012-05-16 18:04:01,2012-04-27 23:53:01
f6fe56804714e5f2e786deebf5b8c21de3338144...233a46cdcbb60d8beb709c017d2f9dc0c2568c60,1,3,1,4,3,2012-05-16 20:10:13,2012-05-16 20:10:13
233a46cdcbb60d8beb709c017d2f9dc0c2568c60...f93d92bbcffaeaa9e328a862e38fb31349e0e942,1,90,42,132,16,2012-05-16 20:10:25,2012-05-16 20:09:20
f93d92bbcffaeaa9e328a862e38fb31349e0e942...4579836ce62ee460db66965b3a430de6d15fd3f6,2,112,12,124,15,2012-05-16 20:31:14,2012-05-16 20:31:14
4579836ce62ee460db66965b3a430de6d15fd3f6...4d49c3d96f96189b1ef1d08d058511186183b972,2,1,1,2,1,2012-05-16 20:48:28,2012-05-16 20:48:28
4d49c3d96f96189b1ef1d08d058511186183b972...4c8fe7514e624bb00965ee11b7f65866c9f06b66,2,58,68,126,42,2012-05-16 20:53:09,2012-05-16 20:53:09
4c8fe7514e624bb00965ee11b7f65866c9f06b66...83447912f127019bf4e0270cdd3bec8fb9e483ea,3,88,64,152,3,2012-05-16 21:08:45,2012-04-19 15:48:44
83447912f127019bf4e0270cdd3bec8fb9e483ea...e6e92ac7aaf625c0fa12455118e522ae77ce2b51,3,44,37,81,3,2012-05-16 21:08:45,2012-04-19 16:04:40
e6e92ac7aaf625c0fa12455118e522ae77ce2b51...4d2b8d30f3f730a42cfaba7697b4acf19e339612,5,215,3,218,9,2012-05-16 21:08:45,2012-04-19 17:04:25
4d2b8d30f3f730a42cfaba7697b4acf19e339612...adfe6f647fcbf7737c81fa747d8bf3599cc7d84c,4,26,28,54,20,2012-05-16 21:08:45,2012-04-20 14:32:18
adfe6f647fcbf7737c81fa747d8bf3599cc7d84c...5ba5abbb01583e637e7d380ab869bf4d695848af,11,577,342,919,119,2012-05-16 21:08:46,2012-04-20 19:54:26
5ba5abbb01583e637e7d380ab869bf4d695848af...0a74230201ff628cc71e71bc1cf8efc108850e65,5,238,37,275,41,2012-05-16 21:08:46,2012-04-23 20:06:13
0a74230201ff628cc71e71bc1cf8efc108850e65...39629ff51d5f2b2361328681e63b742e601f307a,6,47,28,75,28,2012-05-16 21:08:46,2012-05-11 19:32:35
39629ff51d5f2b2361328681e63b742e601f307a...2fb9e3407939acdead413af39605e176172daf58,1,57,11,68,14,2012-05-16 21:08:46,2012-05-16 19:50:24
2fb9e3407939acdead413af39605e176172daf58...235ea9fd797d8c41422f65602b307a39ded59cdb,2,35,59,94,23,2012-05-16 21:08:46,2012-05-16 19:50:50
235ea9fd797d8c41422f65602b307a39ded59cdb...53671c4877320460a64949b214f0585dd8b5c7ff,3,24,3,27,9,2012-05-16 21:08:46,2012-05-16 19:51:16
53671c4877320460a64949b214f0585dd8b5c7ff...79b4b771caa796774ee8ea07f4aa013050975118,1,3,3,6,2,2012-05-16 21:08:46,2012-05-15 16:24:12
79b4b771caa796774ee8ea07f4aa013050975118...cf6a249630605d3e9f1bcb7ab83172413970a890,2,8,7,15,7,2012-05-16 21:08:46,2012-05-16 19:51:50
cf6a249630605d3e9f1bcb7ab83172413970a890...27f31c1ea7431be2777fa1a679c892bbd6b03bd2,1,1,1,2,1,2012-05-16 21:13:15,2012-05-16 21:13:15
27f31c1ea7431be2777fa1a679c892bbd6b03bd2...8878424d9cbbbdbe011e7d035ce6f37e6da329c2,1,3,0,3,1,2012-05-16 21:43:23,2012-05-16 21:43:23
8878424d9cbbbdbe011e7d035ce6f37e6da329c2...bb5002579d8b4d3462d2e19bc0461711b1be8680,1,18,1,19,1,2012-05-16 21:51:44,2012-05-16 21:51:19
bb5002579d8b4d3462d2e19bc0461711b1be8680...e422ec341c86a65348812344f607b3d46d086e75,2,7,0,7,2,2012-05-16 21:56:07,2012-05-16 21:22:38
e422ec341c86a65348812344f607b3d46d086e75...5afb3891b8aa2fc1fd2355377af3f47af0e68e5b,1,1,1,2,1,2012-05-16 22:12:46,2012-05-16 22:12:16
5afb3891b8aa2fc1fd2355377af3f47af0e68e5b...308f286001d0b00ab1a936df9c497f15ef8a338a,1,0,3,3,1,2012-05-16 22:12:46,2012-05-16 22:12:35
308f286001d0b00ab1a936df9c497f15ef8a338a...7cd26291593d76cd5a280b5df4fedf03687a04bd,1,23,19,42,2,2012-05-16 22:22:19,2012-05-15 18:06:09
7cd26291593d76cd5a280b5df4fedf03687a04bd...10d7e8e7166010e41b52a14081572b859d5f84ba,3,169,0,169,6,2012-05-16 22:22:19,2012-05-15 18:35:56
10d7e8e7166010e41b52a14081572b859d5f84ba...6ce99c45a6ef986ea3bdf59f7c477f484e256c11,1,36,1,37,4,2012-05-16 22:22:19,2012-05-15 18:51:51
6ce99c45a6ef986ea3bdf59f7c477f484e256c11...efa3358d03a197cd8e520a17826bfb9ec469ba24,2,18,5,23,7,2012-05-16 22:22:19,2012-05-15 19:38:23
efa3358d03a197cd8e520a17826bfb9ec469ba24...ed1bc019e56dbbb67bc095a4fc7794fdb1a0f3f8,2,97,73,170,12,2012-05-16 22:22:19,2012-05-16 14:06:19
ed1bc019e56dbbb67bc095a4fc7794fdb1a0f3f8...90aa3acaa7ef9421fc96867734cf5973e4e14b77,2,14,1,15,2,2012-05-16 22:22:19,2012-05-16 14:10:18
90aa3acaa7ef9421fc96867734cf5973e4e14b77...28e26dfa20b48c4aa983199b59f95d67a7259c2b,1,17,16,33,6,2012-05-16 22:22:19,2012-05-16 14:11:29
28e26dfa20b48c4aa983199b59f95d67a7259c2b...0c08bf72d47ba88799560f00b28a413b0adfe418,2,20,3,23,10,2012-05-16 22:22:20,2012-05-16 19:13:47
0c08bf72d47ba88799560f00b28a413b0adfe418...81d0c2663fe8f81bb4549b553557263905c5af0d,2,4,4,8,4,2012-05-16 22:22:20,2012-05-16 19:14:06
81d0c2663fe8f81bb4549b553557263905c5af0d...b9d814037c36f758c4e844c088a8a5f88547dd91,1,2,2,4,1,2012-05-16 22:22:20,2012-05-16 21:04:21
b9d814037c36f758c4e844c088a8a5f88547dd91...d3fd10a9ebc885bec5657a414f47f97c18231789,2,82,120,202,22,2012-05-16 22:22:20,2012-05-16 21:53:06
d3fd10a9ebc885bec5657a414f47f97c18231789...4b381330a0e9c13c9fb84812476e288350c76830,10,19,24,43,17,2012-05-16 22:22:20,2012-05-16 22:01:22
4b381330a0e9c13c9fb84812476e288350c76830...67ccb204be8806d6b81d010df2bfe56adcc0a54f,1,25,17,42,16,2012-05-16 22:22:20,2012-05-16 22:02:32
67ccb204be8806d6b81d010df2bfe56adcc0a54f...93d01b1aacfdc983cfdc6465d3c1d7b4ef3fde94,1,1,0,1,1,2012-05-16 22:22:20,2012-05-16 22:12:04
93d01b1aacfdc983cfdc6465d3c1d7b4ef3fde94...63b3df2c1c704ae7ae58d3f559e626c5eefea26f,5,4,144,148,8,2012-05-16 22:22:48,2012-05-16 22:22:48
63b3df2c1c704ae7ae58d3f559e626c5eefea26f...8a3dce11f53c78756d8c1ec2d3cbf08b530a530b,1,1,1,2,1,2012-05-16 22:27:10,2012-05-16 22:27:10
8a3dce11f53c78756d8c1ec2d3cbf08b530a530b...0b6503d3b48991f7e80b6d104f72e6d73961bb91,1,0,1,1,1,2012-05-16 22:27:21,2012-05-16 22:27:21
0b6503d3b48991f7e80b6d104f72e6d73961bb91...8f9635209eace0cf3a972b6dea2d82776d57629e,2,180,0,180,2,2012-05-16 23:11:07,2012-05-16 23:11:07
8f9635209eace0cf3a972b6dea2d82776d57629e...f70a2da841a4faf18acac940b7b742fbbb496af1,1,1,1,2,1,2012-05-17 00:49:44,2012-05-17 00:49:44
f70a2da841a4faf18acac940b7b742fbbb496af1...f122115c48b766156c7735d70ee5a2277a4c1689,1,1,1,2,1,2012-05-17 00:58:56,2012-05-17 00:58:56
f122115c48b766156c7735d70ee5a2277a4c1689...77a14a14b04d959a5e5bdb2aa116646b2a59bded,2,28,14,42,12,2012-05-17 04:34:03,2012-05-17 04:34:03
77a14a14b04d959a5e5bdb2aa116646b2a59bded...ec167af220c9ccda1e3fa0fc80545a476b1bd363,2,9,3,12,5,2012-05-17 04:46:16,2012-05-17 01:50:06
ec167af220c9ccda1e3fa0fc80545a476b1bd363...530644eb8afa6522edd6cba1f5b86a15489dfba4,2,6,0,6,2,2012-05-17 04:46:16,2012-05-17 03:47:17
530644eb8afa6522edd6cba1f5b86a15489dfba4...ee741ea0ac4d637797e5d1b1a20d5b99e2715f17,2,3,11,14,6,2012-05-17 04:46:16,2012-05-17 03:47:24
ee741ea0ac4d637797e5d1b1a20d5b99e2715f17...7bd246b2375dc1653de7afa311dc6c7ad450a1a3,1,1,1,2,1,2012-05-17 04:46:16,2012-05-17 04:44:10
7bd246b2375dc1653de7afa311dc6c7ad450a1a3...e20271c43c713617d07ae700b4c668edb2631f9f,1,22,0,22,2,2012-05-17 04:46:16,2012-05-17 04:45:42
e20271c43c713617d07ae700b4c668edb2631f9f...4f0de51153d76e20e3395ae3cb35d03bba2a4bfa,1,1,1,2,1,2012-05-17 04:49:14,2012-05-17 04:49:14
4f0de51153d76e20e3395ae3cb35d03bba2a4bfa...9ca76e84a46f3d2fc04783554b1ac59ea45902aa,2,8,0,8,3,2012-05-17 15:10:31,2012-05-17 15:10:31
9ca76e84a46f3d2fc04783554b1ac59ea45902aa...a60ef31c4981f49523908c7b237f2cba0b751814,1,5,0,5,2,2012-05-17 15:40:45,2012-05-17 15:40:21
a60ef31c4981f49523908c7b237f2cba0b751814...521f995dc2f58b6a0e29d4aeea6a2e4b4ddd7f64,4,22,2,24,10,2012-05-17 17:07:09,2012-05-17 17:07:09
521f995dc2f58b6a0e29d4aeea6a2e4b4ddd7f64...bc6a90645eb0153ff6d46b63d1368dc87d0bf331,10,270,29,299,20,2012-05-17 17:44:32,2012-03-19 18:52:43
bc6a90645eb0153ff6d46b63d1368dc87d0bf331...51628b7c098484c83cd7b6f06d4b64b7d0cfbe11,3,7,7,14,6,2012-05-17 18:43:32,2012-05-17 18:43:32
51628b7c098484c83cd7b6f06d4b64b7d0cfbe11...83b94eeccee965156b21e3e180ea0059269f9351,1,1,1,2,1,2012-05-17 18:49:12,2012-05-17 18:49:12
83b94eeccee965156b21e3e180ea0059269f9351...bddf3c83e70cd15ce35e9707c8f426adb8771a53,2,12,0,12,5,2012-05-17 18:50:24,2012-05-17 18:50:24
bddf3c83e70cd15ce35e9707c8f426adb8771a53...02e4b71879058cd9cf5cb3fe1dba38e014a3cf61,1,0,3,3,1,2012-05-17 18:58:24,2012-05-17 18:58:06
02e4b71879058cd9cf5cb3fe1dba38e014a3cf61...13347e455937d9fe65c6da539ac145509002f094,2,8,0,8,4,2012-05-17 20:06:06,2012-05-17 20:06:06
13347e455937d9fe65c6da539ac145509002f094...39206090720e914a5810ae02ae6f7c1212b59ca5,12,384,4,388,21,2012-05-17 20:17:45,2012-05-12 11:14:16
39206090720e914a5810ae02ae6f7c1212b59ca5...8afc2008ca040ab6fda5694dcbebd5920a1337f8,1,2,0,2,2,2012-05-17 20:32:25,2012-05-17 20:32:25
8afc2008ca040ab6fda5694dcbebd5920a1337f8...0cc4f7308391d6746c183944efec9d42c1d8f528,6,7,7,14,7,2012-05-17 20:45:01,2012-05-17 20:45:01
0cc4f7308391d6746c183944efec9d42c1d8f528...eb3c3111392a71c964514700f4d924a08fce17a7,2,11,2,13,5,2012-05-17 20:59:44,2012-05-17 20:35:51
eb3c3111392a71c964514700f4d924a08fce17a7...0cfed30dbbe2aa0b82db1c56ab81422d8f77dc34,1,1,1,2,1,2012-05-17 22:09:13,2012-05-17 22:09:13
0cfed30dbbe2aa0b82db1c56ab81422d8f77dc34...7f42a432292c48941b566e53a774d8262ece8fc4,1,15,1,16,2,2012-05-18 01:13:32,2012-05-17 22:15:03
7f42a432292c48941b566e53a774d8262ece8fc4...d78bee2f283950fe4940e908e3b4dc3f57e7a0f2,1,10,12,22,5,2012-05-18 08:30:15,2012-05-18 08:30:15
d78bee2f283950fe4940e908e3b4dc3f57e7a0f2...e2ff1100dc1c8298de8b9f1b482553c6a5d1ac0e,2,2,2,4,2,2012-05-18 09:27:47,2012-05-18 09:27:47
e2ff1100dc1c8298de8b9f1b482553c6a5d1ac0e...f645120867b38ead8ce3508eac1a60e67b8fb869,1,4,0,4,1,2012-05-18 13:33:08,2012-05-17 20:12:04
f645120867b38ead8ce3508eac1a60e67b8fb869...351e57361855b395214a84c9fe2d33693a0f8460,1,4,1,5,1,2012-05-18 13:33:08,2012-05-17 20:31:24
351e57361855b395214a84c9fe2d33693a0f8460...daafc561fee90357ae45d20a0040f4f69a65fdef,1,4,1,5,1,2012-05-18 15:53:54,2012-05-18 15:53:54
daafc561fee90357ae45d20a0040f4f69a65fdef...76609617aa70abd9433a4443ac667e831082e868,10,197,108,305,25,2012-05-18 18:39:12,2012-05-17 16:43:47
76609617aa70abd9433a4443ac667e831082e868...161960373175779914c093be70fa06dde3b60909,2,47,40,87,2,2012-05-18 18:43:55,2012-05-18 13:18:41
161960373175779914c093be70fa06dde3b60909...fdc9fead639e96af96a0ed33d67576043fa7bb6c,3,14,7,21,8,2012-05-18 18:43:55,2012-05-18 14:33:40
fdc9fead639e96af96a0ed33d67576043fa7bb6c...c0c8e05f4a1cca33a5a10ed26020200a48d01e2d,12,14,3,17,12,2012-05-18 19:00:55,2012-05-18 19:00:55
c0c8e05f4a1cca33a5a10ed26020200a48d01e2d...fcf64614759d8a6f92836d3eb37939c1ab856bb3,1,1,0,1,1,2012-05-18 19:20:48,2012-05-18 19:20:48
fcf64614759d8a6f92836d3eb37939c1ab856bb3...e3211d9b3967e5f46e826c1745f67e0f26d67c88,1,1,0,1,1,2012-05-18 20:15:05,2012-05-18 20:14:59
e3211d9b3967e5f46e826c1745f67e0f26d67c88...228b2aa0ab7203686bdfaac874f18645a159ecd8,2,66,1,67,2,2012-05-18 20:30:18,2012-04-27 14:17:37
228b2aa0ab7203686bdfaac874f18645a159ecd8...4a7d8710bac850052aa61b300730acd55217ba32,9,417,3,420,9,2012-05-18 21:03:11,2012-05-18 20:57:38
4a7d8710bac850052aa61b300730acd55217ba32...9997c571681443cbef566a877c2e3cf61b2761a9,1,13,1,14,1,2012-05-18 23:02:02,2012-05-18 23:01:46
9997c571681443cbef566a877c2e3cf61b2761a9...17d5c68dd66c869296818a1e45f0210d62fe30c4,1,3,6,9,3,2012-05-19 06:13:42,2012-05-19 06:12:05
17d5c68dd66c869296818a1e45f0210d62fe30c4...70e30e98de2065fe869a6d405fc9165705e49ac7,6,76,0,76,20,2012-05-19 10:48:59,2012-05-19 10:48:59
70e30e98de2065fe869a6d405fc9165705e49ac7...686b2b375dfe233032e2eb80e8c9a0175db53ca2,2,8,8,16,8,2012-05-19 11:26:14,2012-05-18 19:55:48
686b2b375dfe233032e2eb80e8c9a0175db53ca2...9ced057a15dbaee10e8d87fad7943a2031fd44de,1,2,4,6,2,2012-05-19 13:52:03,2012-05-19 13:52:03
9ced057a15dbaee10e8d87fad7943a2031fd44de...145b99af8a1e067e1d5f24713a76b80b13a7e9e8,6,91,23,114,14,2012-05-20 00:13:44,2012-05-20 00:13:44
145b99af8a1e067e1d5f24713a76b80b13a7e9e8...fa79e6978f17d9db78d71bbcfffb1032a83f7c09,7,71,8,79,16,2012-05-20 14:26:50,2012-05-20 14:26:50
fa79e6978f17d9db78d71bbcfffb1032a83f7c09...0a5953d46bb50c12095054ab434a56fd9e7f1172,27,168,159,327,74,2012-05-20 20:30:21,2012-05-20 14:38:53
0a5953d46bb50c12095054ab434a56fd9e7f1172...68d4809273949e6948da804c788b5cd35199b33f,1,6,0,6,5,2012-05-21 15:58:23,2012-05-21 15:58:23
68d4809273949e6948da804c788b5cd35199b33f...79dbe4ebc120c1e6ab756193675774e6c6457606,1,4,0,4,2,2012-05-21 15:58:33,2012-05-21 15:58:33
79dbe4ebc120c1e6ab756193675774e6c6457606...ecb169181524f17a7777aa396065c57dca2550fb,1,18,18,36,2,2012-05-21 16:29:47,2012-05-21 16:29:47
db5ace7c7c837502b6c21f99ac0c8ace4520d679...bf16a99d979d54a6275140975abc0f70336762dd,1,12,17,29,6,2011-08-19 22:20:52,2011-08-19 22:20:52
db5ace7c7c837502b6c21f99ac0c8ace4520d679...dfdfac782d51b28752fa44b1b0d97ce424a37868,1,3,0,3,2,2011-08-19 14:34:08,2011-08-19 14:34:08
826cc12608d11a7fa2fa010a136ef3a3c4ef219f...8f19eec99d2051186c576003cc759a61cde13d36,1,1,1,2,1,2011-09-26 16:46:23,2011-09-26 16:46:23
31f83055750d68b123bd113d537d37ea81987192...d81d20efad07709487743db824ff8e74ceee2d7a,1,1,1,2,1,2011-09-26 16:42:54,2011-09-26 16:42:54
26e54bc6956dcc5b4f8ce1825ddb4fe94daa50f6...fd9c60804a9a686cf039e14014bcb5884b9eec2c,1,10,2,12,1,2011-11-02 14:38:08,2011-11-02 14:38:08
26e54bc6956dcc5b4f8ce1825ddb4fe94daa50f6...36521f7f5459362cad646fd4c060d012008537ff,1,4,0,4,1,2011-11-02 12:58:12,2011-10-27 21:50:20
127251ffd6a0be4e1aa5441b8c0c49bd96030c71...9a02f4a03fa11e0f1eab4b8169b94f4a0615923c,2,86,76,162,10,2011-10-14 17:44:23,2011-10-14 17:44:23
9a02f4a03fa11e0f1eab4b8169b94f4a0615923c...cf6c1129fc85e6ebd71759f4062b953466abd260,1,12,9,21,3,2011-10-14 19:04:35,2011-10-14 18:31:20
cf6c1129fc85e6ebd71759f4062b953466abd260...89c48968b0f635495e20c67902bd85653a0a3f5f,1,2,2,4,2,2011-10-15 03:34:35,2011-10-15 03:34:35
8e7706edafefc9f3a4ec9a14206887b15604cc85...1c12c5f98c005d5b006b5b0c565bdd401da14f88,1,9,14,23,4,2011-10-17 11:58:16,2011-10-17 11:58:16
8e7706edafefc9f3a4ec9a14206887b15604cc85...6133ec7139732d1bd8b8e24765b3b2b605588826,2,2,2,4,2,2011-10-17 09:47:14,2011-10-17 09:47:14
24a1d6e5d78a6213a93f1dfe032ca280dd0c02c0...16a811b0376916b897e34d90004f966d54b2b0cb,4,495,19,514,28,2011-10-11 16:18:59,2011-10-11 14:30:10
16a811b0376916b897e34d90004f966d54b2b0cb...bef29305f04164738a4c2850bb94e009d4ad8550,1,8,0,8,1,2011-10-11 16:19:00,2011-10-11 14:31:06
bef29305f04164738a4c2850bb94e009d4ad8550...d936e4e4c5e2ce71a99219d5b910ba03d1433049,1,271,0,271,1,2011-10-11 16:39:03,2011-10-11 14:33:19
d936e4e4c5e2ce71a99219d5b910ba03d1433049...b2cfdbc61b0335a69fe21d03a301a44b2fce6e25,9,24,0,24,9,2011-10-11 17:01:05,2011-10-11 17:00:28
b2cfdbc61b0335a69fe21d03a301a44b2fce6e25...5b228813c32a3cc43c8c439f8af123adda512404,1,193,79,272,23,2011-10-11 18:42:46,2011-10-11 14:35:43
5b228813c32a3cc43c8c439f8af123adda512404...97014453e0bd7d829142db5a12a23d31a341fce7,1,1,1,2,1,2011-10-11 18:53:38,2011-10-11 18:53:38
97014453e0bd7d829142db5a12a23d31a341fce7...08c3888312f26a5bc0560bead47059992009826a,17,97,33,130,43,2011-10-11 19:16:01,2011-10-11 19:13:51
ecb169181524f17a7777aa396065c57dca2550fb...73aa870d129bd7d51de946b91c16cc056aaacbc7,3,35,5,40,12,2012-05-22 16:00:51,2012-05-22 16:00:51
ecb169181524f17a7777aa396065c57dca2550fb...d6e95bb1b294e3df541c74aa739d129a6b3d5f68,1,2,0,2,1,2012-05-21 17:48:10,2012-05-21 17:47:36
d6e95bb1b294e3df541c74aa739d129a6b3d5f68...489bc6a6766460b4d625db5f429c28cf9fbcaf28,1,10,3,13,1,2012-05-21 18:00:43,2012-05-21 18:00:22
489bc6a6766460b4d625db5f429c28cf9fbcaf28...03cd7b93e666d80a3640171ba1af8407b0591591,1,1,1,2,1,2012-05-21 18:06:08,2012-05-21 18:06:02
03cd7b93e666d80a3640171ba1af8407b0591591...847b343fa5a23b02fddb29b12dd689fde0e1fe91,6,37,18,55,11,2012-05-21 19:34:58,2012-05-21 19:34:58
847b343fa5a23b02fddb29b12dd689fde0e1fe91...c13ff660e615ef76f6f4dbc8c62d24c6b4ae54cc,21,860,71,931,67,2012-05-21 19:40:38,2012-05-17 22:17:57
c13ff660e615ef76f6f4dbc8c62d24c6b4ae54cc...54f86fa31d31b90bfa9d086520821e402cc5589a,22,547,553,1100,18,2012-05-21 19:40:39,2012-05-21 18:28:44
54f86fa31d31b90bfa9d086520821e402cc5589a...ef05c4ef68afe4b9db9e5604e017235e79a3fab1,1,7,7,14,3,2012-05-21 19:40:41,2012-05-21 18:58:47
ef05c4ef68afe4b9db9e5604e017235e79a3fab1...4628bb410e21e681bc43d4d70918aee72f0ea76e,1,0,2,2,1,2012-05-21 20:17:03,2012-05-21 20:17:03
4628bb410e21e681bc43d4d70918aee72f0ea76e...51b19f8296d62c2f518bd9edae2a5056d51acd8c,2,74,53,127,7,2012-05-21 20:47:22,2012-05-21 20:47:22
51b19f8296d62c2f518bd9edae2a5056d51acd8c...1647933b0f953badcdecd6b3941db7aeca2e7aba,9,40,40,80,40,2012-05-21 22:07:18,2012-05-17 20:54:21
1647933b0f953badcdecd6b3941db7aeca2e7aba...345151f79d48a634526c7114f77a30405437e200,4,16,6,22,10,2012-05-21 22:07:18,2012-05-17 21:22:34
345151f79d48a634526c7114f77a30405437e200...98fcfbaa35a32d68f6b47475c13acd24fcf2829a,5,22,33,55,20,2012-05-21 22:22:39,2012-05-09 17:44:01
98fcfbaa35a32d68f6b47475c13acd24fcf2829a...76d99d60cad11017c00a832e2bc467f1c46fa5fc,21,293,168,461,130,2012-05-21 22:22:40,2012-05-14 17:58:36
76d99d60cad11017c00a832e2bc467f1c46fa5fc...4c1699f9bc6a10c82746b78ea86bb947e7033038,6,300,123,423,55,2012-05-21 22:22:40,2012-05-15 21:48:31
4c1699f9bc6a10c82746b78ea86bb947e7033038...fcec232397f37d84084980972628ea27d9153138,1,3,3,6,3,2012-05-22 01:55:52,2012-05-20 02:29:42
fcec232397f37d84084980972628ea27d9153138...ca81d0a51a34fa3e77eeebee57ef184afbc4fd6d,1,1,1,2,1,2012-05-22 02:08:50,2012-05-22 02:08:50
ca81d0a51a34fa3e77eeebee57ef184afbc4fd6d...c6fcfa252d168407b7b07bac34d14778c5e79fe0,1,4,0,4,2,2012-05-22 04:20:24,2012-05-22 04:20:24
c6fcfa252d168407b7b07bac34d14778c5e79fe0...cf398f5b85ab33e4b839d400e9c8f3466b777897,1,1,1,2,1,2012-05-22 11:50:41,2012-05-22 11:50:41
cf398f5b85ab33e4b839d400e9c8f3466b777897...ff4e90dc7bc91e7334349e233ccadf4680a2687b,1,1,1,2,1,2012-05-22 11:50:47,2012-05-22 11:50:47
ff4e90dc7bc91e7334349e233ccadf4680a2687b...c55782c2eecd42cf240f2b5ce5be4ca2862625db,4,16,6,22,8,2012-05-22 13:01:14,2012-05-19 20:33:06
c55782c2eecd42cf240f2b5ce5be4ca2862625db...13a9b34ae4ff54c29d2aac485168b6c6f4c77da9,1,0,0,0,0,2012-05-22 14:49:02,2012-05-22 14:49:02
13a9b34ae4ff54c29d2aac485168b6c6f4c77da9...4a9a294376f6d4d599244154e0b1e49d0172aed7,10,170,133,303,31,2012-05-22 14:50:53,2012-05-14 14:05:51
4a9a294376f6d4d599244154e0b1e49d0172aed7...e2a664776ef3ff6f128fa03f639dfd3e83f62f5d,1,6,2,8,4,2012-05-22 15:56:39,2012-05-22 15:55:12
dfdfac782d51b28752fa44b1b0d97ce424a37868...94e8447e815fbe6656995f4a47d54e7f5e39bdca,6,2228,2407,4635,10,2011-08-19 18:27:18,2011-08-19 18:27:18
dfdfac782d51b28752fa44b1b0d97ce424a37868...9fd1a048ec48d8e4e4ca75025d0c7225fc07eb8e,1,1,1,2,1,2011-08-19 16:08:07,2011-08-19 16:07:53
9fd1a048ec48d8e4e4ca75025d0c7225fc07eb8e...51a05ba7a3a5b742934b0f30ee3e8fcd0437c272,1,7,0,7,1,2011-08-19 17:59:40,2011-08-19 17:59:40
967c7cca6e4850d526892faa4f74a3e9a640e563...6c994c3fc98d55c7184cb11559fabd76c4250c94,1,1,1,2,1,2011-11-02 14:41:18,2011-11-02 14:41:05
6c994c3fc98d55c7184cb11559fabd76c4250c94...3c5b99cbd63af217b92283f56ba6744215ce5eee,1,2,1,3,1,2011-11-02 14:50:45,2011-11-02 14:50:45
88dbf90b81dd843939e4cd3a8d052dd1373017c1...24209dde0fc482cf80757e72ac66833d0330085d,2,17,0,17,2,2011-10-17 16:11:43,2011-10-14 21:17:50
24209dde0fc482cf80757e72ac66833d0330085d...c9ad86209d86c8133ac3f6f71deed742ff9adf38,2,25,1,26,3,2011-10-17 16:11:43,2011-10-14 21:18:37
c9ad86209d86c8133ac3f6f71deed742ff9adf38...5695e02c166c4df433c6d47e8bfda1712373ea1f,1,1,1,2,1,2011-10-17 16:11:43,2011-10-17 14:58:03
5695e02c166c4df433c6d47e8bfda1712373ea1f...c7e57d1c946d7558ab7b016f921287485970c664,1,4,1,5,2,2011-10-17 16:11:43,2011-10-17 14:59:02
c7e57d1c946d7558ab7b016f921287485970c664...20a1c7ae3294f9e475adf2a0212726d2dc21b69b,4,57,22,79,12,2011-10-17 17:28:40,2011-10-17 17:28:06
20a1c7ae3294f9e475adf2a0212726d2dc21b69b...2a8522c03f0259bbc9134a93b88bb00f5f2c58ce,4,22,57,79,12,2011-10-17 18:16:11,2011-10-17 18:16:11
2a8522c03f0259bbc9134a93b88bb00f5f2c58ce...ff0a56cbe55b198776d43ac3c31fc7752dce6023,1,6,0,6,1,2011-10-17 19:14:28,2011-10-17 18:33:05
ff0a56cbe55b198776d43ac3c31fc7752dce6023...189c2fc8549e24543a5d2b9ce4dbcb693d3d9715,1,9,8,17,3,2011-10-17 20:10:48,2011-10-17 20:10:48
189c2fc8549e24543a5d2b9ce4dbcb693d3d9715...42d9b82e816d8de09eee3d3801abb0197c337deb,1,16,5,21,4,2011-10-17 21:10:09,2011-10-17 21:02:25
42d9b82e816d8de09eee3d3801abb0197c337deb...aff5b255dae46acd8aa462564a186c21e83ebd10,2,71,11,82,8,2011-10-17 21:10:09,2011-10-17 21:09:58
aff5b255dae46acd8aa462564a186c21e83ebd10...125103fc008b48be497f0418151b852e273e9b65,7,53,184,237,17,2011-10-18 00:47:12,2011-10-18 00:45:53
125103fc008b48be497f0418151b852e273e9b65...23c33b2f8f6da5f498b06d191cde6916d3f07025,2,6,4,10,4,2011-10-18 01:12:17,2011-10-18 01:12:17
08c3888312f26a5bc0560bead47059992009826a...c7a57645756a5744af96668f828507ced37cc6c3,1,4,2,6,3,2011-10-11 19:24:04,2011-10-11 19:23:07
c7a57645756a5744af96668f828507ced37cc6c3...5a31fcebb36a7b08c094b2d445ba562130bc5b9d,1,5,1,6,3,2011-10-11 19:24:04,2011-10-11 19:23:50
5a31fcebb36a7b08c094b2d445ba562130bc5b9d...98410078caf81d8e7b2457e55e9025d8ec11f231,1,1,1,2,1,2011-10-11 19:27:53,2011-10-11 19:27:53
bb17904d0b1538a597b1b01f2b09cc2165445e7b...f0fc395bf2dcffcd7cf54253ddc34d9809fe9817,1,4,0,4,1,2012-05-22 16:08:10,2012-05-22 16:08:10
f0fc395bf2dcffcd7cf54253ddc34d9809fe9817...e0b4139c982842a4dfb6fec3213e8278b6b72e6c,2,3,1,4,2,2012-05-22 18:51:56,2012-05-16 21:44:41
e0b4139c982842a4dfb6fec3213e8278b6b72e6c...8c3c2034e610904d2eb68fd7bc2cf3ea237b9cf6,2,13,7,20,4,2012-05-22 18:52:17,2012-05-09 21:27:51
8c3c2034e610904d2eb68fd7bc2cf3ea237b9cf6...9b83485bb1cf8813d22690f6a2518e6d80f8ef1f,1,3,1,4,2,2012-05-22 18:52:17,2012-05-07 21:10:16
9b83485bb1cf8813d22690f6a2518e6d80f8ef1f...3015a51ef202e2f70e37ebd6c44650cdbb052aab,1,3,0,3,1,2012-05-22 18:52:17,2011-11-03 22:04:22
3015a51ef202e2f70e37ebd6c44650cdbb052aab...e6617d62f0163595d2fe9257158fa47a3da205b2,4,187,14,201,12,2012-05-22 18:56:35,2012-05-09 00:16:40
e6617d62f0163595d2fe9257158fa47a3da205b2...65cae6cccb63c46dab62bb2fb53223050af2a016,1,4,1,5,2,2012-05-22 19:23:31,2012-05-22 19:23:31
65cae6cccb63c46dab62bb2fb53223050af2a016...d1fd245ea8ec1a75974169fc0f07d21dc3217a96,4,116,1,117,7,2012-05-22 20:32:21,2012-05-15 21:58:27
d1fd245ea8ec1a75974169fc0f07d21dc3217a96...db8767913cc81b84bc1ba837fcdab905799f88c7,5,10,10,20,10,2012-05-22 20:32:57,2012-05-22 20:32:57
db8767913cc81b84bc1ba837fcdab905799f88c7...048ea9e913cc083fce81efdc6a6947c55721a923,1,1,1,2,1,2012-05-22 20:49:16,2012-05-22 20:49:16
048ea9e913cc083fce81efdc6a6947c55721a923...cb54322328f3143a1985d131fb95a3333ad7a949,1,2,1,3,1,2012-05-22 22:35:16,2012-05-22 22:33:57
cb54322328f3143a1985d131fb95a3333ad7a949...65303070c9c302793515085681d6b2daceedac69,3,77,0,77,3,2012-05-22 22:43:04,2012-05-22 22:12:16
65303070c9c302793515085681d6b2daceedac69...b594f8a458322e174d5278a13ced4f1f48ffa75b,2,11,1,12,4,2012-05-22 23:00:19,2012-05-22 22:59:21
b594f8a458322e174d5278a13ced4f1f48ffa75b...3e9cbcf422d4e57bdd4dd13ff0761360d57c232f,1,2,2,4,2,2012-05-23 01:29:23,2012-05-23 01:29:23
3e9cbcf422d4e57bdd4dd13ff0761360d57c232f...7369ca3a05b6bb08900b054ce0ea40a67b781a28,1,0,6,6,1,2012-05-23 02:52:26,2012-05-23 02:52:26
7369ca3a05b6bb08900b054ce0ea40a67b781a28...d1418e3783564e27b637cdf9062bf7c54074a3a2,1,0,61,61,1,2012-05-23 11:26:06,2012-05-23 11:26:06
d1418e3783564e27b637cdf9062bf7c54074a3a2...220150db81ea754fc94cc402d957626a7961278e,2,4,0,4,2,2012-05-23 13:47:32,2012-05-23 13:47:32
220150db81ea754fc94cc402d957626a7961278e...e6f9efc3c372f5bc8871df838c6e891117655a88,2,55,3,58,4,2012-05-24 13:41:37,2012-05-24 13:41:37
e6f9efc3c372f5bc8871df838c6e891117655a88...71f9205daf1b47dd15ac927e5a2b824a66d3212d,2,54,16,70,9,2012-05-24 13:55:14,2012-05-24 13:54:06
71f9205daf1b47dd15ac927e5a2b824a66d3212d...7c608e90c32c33e2a39e29ca88e0ce3fccddf480,1,2,1,3,1,2012-05-24 17:27:58,2012-05-24 17:27:58
7c608e90c32c33e2a39e29ca88e0ce3fccddf480...229931979ff59c9092bc39de9f5e72a35207a74e,1,6,0,6,1,2012-05-24 17:34:37,2012-05-24 17:25:41
229931979ff59c9092bc39de9f5e72a35207a74e...a7be5e92b29cf21ccee24ab26fbdb8c76082eb2c,2,3,55,58,4,2012-05-24 17:48:36,2012-05-24 17:47:48
a7be5e92b29cf21ccee24ab26fbdb8c76082eb2c...b45a2ff6e0b1d91da406c52a328d9d9aea08be6b,1,4,2,6,4,2012-05-24 18:38:16,2012-05-22 23:22:58
b45a2ff6e0b1d91da406c52a328d9d9aea08be6b...496d1a9f849ec76a1d12546c5ab73f533b7b44d9,1,61,0,61,1,2012-05-24 19:31:26,2012-05-24 17:48:00
496d1a9f849ec76a1d12546c5ab73f533b7b44d9...582dda88547aa91626046230bbacd9e183359461,1,17,19,36,9,2012-05-24 19:31:26,2012-05-24 17:55:25
582dda88547aa91626046230bbacd9e183359461...5d7a4110b8a07ff5f8f9c197ee99ca0b550a1595,1,0,8,8,2,2012-05-25 01:19:14,2012-05-06 20:37:24
5d7a4110b8a07ff5f8f9c197ee99ca0b550a1595...7cd6e4a24055eec2a5b2b7fea71c71f3526778e8,1,1,6,7,2,2012-05-25 01:19:15,2012-05-25 00:14:14
7cd6e4a24055eec2a5b2b7fea71c71f3526778e8...16ccddb3f7ea362c52deed9b592c13ec5dd4ef00,2,26,3,29,4,2012-05-25 01:19:16,2012-05-25 00:15:54
16ccddb3f7ea362c52deed9b592c13ec5dd4ef00...6fc8a949132d3abcdcd685a2cecd4db8311b02b9,3,5,21,26,6,2012-05-25 01:19:16,2012-05-25 00:24:06
6fc8a949132d3abcdcd685a2cecd4db8311b02b9...31be905b79c95b13d2f1dab3450066cd456b10e3,5,92,50,142,17,2012-05-25 01:19:16,2012-05-25 00:30:14
31be905b79c95b13d2f1dab3450066cd456b10e3...1e3d54d6a9e942853d2147bdf461a86954d68422,2,9,7,16,6,2012-05-25 01:19:16,2012-05-08 03:15:55
1e3d54d6a9e942853d2147bdf461a86954d68422...9660b195a3bb676d5009a7d59aa80888b963bf12,2,8,8,16,4,2012-05-25 01:19:16,2012-05-25 00:33:59
9660b195a3bb676d5009a7d59aa80888b963bf12...65d8d9c2a7bce409a88f09c6faf4df4aaef8bde8,1,1,1,2,1,2012-05-25 01:19:17,2012-05-25 00:34:29
65d8d9c2a7bce409a88f09c6faf4df4aaef8bde8...3934e39f62e7e1a2ae7a0636a0410c9ed4a6bea7,4,21,9,30,9,2012-05-25 01:19:17,2012-05-08 03:57:33
3934e39f62e7e1a2ae7a0636a0410c9ed4a6bea7...94e52ea931812c873d7540244b0d335bb4d26df5,1,3,0,3,1,2012-05-25 01:19:17,2012-05-17 01:23:44
94e52ea931812c873d7540244b0d335bb4d26df5...b0859f25d276d2e069342d733da1718419caa41d,2,43,0,43,3,2012-05-25 01:19:17,2012-05-25 00:39:25
b0859f25d276d2e069342d733da1718419caa41d...e7ddc0133699f7230212355bc2234a7007b352f3,3,26,20,46,20,2012-05-25 01:19:17,2012-05-25 00:54:43
e7ddc0133699f7230212355bc2234a7007b352f3...136d85916899a87ff970517c948a821166f5bb64,1,4,1,5,1,2012-05-25 01:19:17,2012-05-25 00:58:36
136d85916899a87ff970517c948a821166f5bb64...f4a6f122c7f3bf7b6dace1b6ce4cb8216f21812f,4,18,39,57,15,2012-05-25 01:19:17,2012-05-25 01:17:35
f4a6f122c7f3bf7b6dace1b6ce4cb8216f21812f...9e4abe3c2ad87c8ac13024b8525a14e6e9989b07,1,2,2,4,2,2012-05-25 02:12:58,2012-05-25 02:12:58
9e4abe3c2ad87c8ac13024b8525a14e6e9989b07...392dc7199af9e11ee1e19cc48d0bf6bf946ea070,1,1,1,2,1,2012-05-25 12:46:19,2012-05-25 12:46:19
392dc7199af9e11ee1e19cc48d0bf6bf946ea070...1713c71f15b18ab166a54aa3d064180b209264a5,1,3,0,3,3,2012-05-25 15:10:58,2012-05-25 15:01:05
1713c71f15b18ab166a54aa3d064180b209264a5...ccf15960ec68ae8a7a64e04a7a561c92005b5788,1,1,1,2,1,2012-05-25 15:11:21,2012-05-25 14:56:10
ccf15960ec68ae8a7a64e04a7a561c92005b5788...40d3419601ed15ae872717fc7d82d9a27f1cdd7e,1,6,6,12,6,2012-05-25 15:22:17,2012-05-25 15:15:58
40d3419601ed15ae872717fc7d82d9a27f1cdd7e...1aa4aa5efd184a07421fd3d4be996912cc2bfdd4,3,84,59,143,41,2012-05-25 15:22:17,2012-05-25 15:18:09
1aa4aa5efd184a07421fd3d4be996912cc2bfdd4...9cfddde50b136106e35bf6ee9170a0f4a62483d5,1,20,17,37,2,2012-05-25 15:22:17,2012-05-25 15:21:20
9cfddde50b136106e35bf6ee9170a0f4a62483d5...ec8c7bc9b505d5d9f198ce83d3285bce05181dbf,2,49,21,70,5,2012-05-25 15:22:17,2012-05-25 15:22:04
ec8c7bc9b505d5d9f198ce83d3285bce05181dbf...08727fb0e8089b869fe179be6fcc1eaa1e76e5b1,1,2,0,2,1,2012-05-25 16:05:30,2012-05-25 15:51:59
08727fb0e8089b869fe179be6fcc1eaa1e76e5b1...0f39e448ca7287efa8081452a825ea3ff2b7a602,1,1,0,1,1,2012-05-25 17:15:55,2012-05-25 17:15:55
0f39e448ca7287efa8081452a825ea3ff2b7a602...9739a5516610bbe2943d9e525b204254df9a559a,2,29,0,29,2,2012-05-25 17:34:27,2012-05-25 03:55:28
9739a5516610bbe2943d9e525b204254df9a559a...7479fc37f2b2b110dae38865f8d91d770120a149,1,1,1,2,1,2012-05-25 19:05:07,2012-05-24 21:50:37
7479fc37f2b2b110dae38865f8d91d770120a149...0a8e145fab1ed1648d7a06ea31ad669c4033d851,1,5,4,9,2,2012-05-25 19:05:07,2012-05-24 21:51:08
0a8e145fab1ed1648d7a06ea31ad669c4033d851...99d6bfd5a8832ef8b2b35684f2459065fba69006,1,1,0,1,1,2012-05-25 19:05:07,2012-05-25 19:04:17
99d6bfd5a8832ef8b2b35684f2459065fba69006...087253be5766e74881b7964a726257f407b340cd,3,266,18,284,32,2012-05-25 19:05:07,2012-05-25 19:04:31
087253be5766e74881b7964a726257f407b340cd...07b2553a1b49f7cdd9f21cb1c4b1f417f224b81a,1,2,0,2,1,2012-05-25 19:06:17,2012-05-25 19:06:17
07b2553a1b49f7cdd9f21cb1c4b1f417f224b81a...81c3b82384ea75be18c8da4a9c97dc52bd6a2c08,1,3,3,6,3,2012-05-25 20:06:49,2012-05-25 20:02:46
81c3b82384ea75be18c8da4a9c97dc52bd6a2c08...ec0ca41bdc2a80454fb7d89d4e40d6d7479b769a,1,58,30,88,9,2012-05-25 20:26:12,2012-05-25 12:11:02
ec0ca41bdc2a80454fb7d89d4e40d6d7479b769a...0fca372695ed3de0173da9ebcc95cc1a7c8e79e3,1,9,7,16,4,2012-05-25 20:26:13,2012-05-25 12:18:06
0fca372695ed3de0173da9ebcc95cc1a7c8e79e3...cfbcdfe8e6caf68128ba7402e28f9e76e046c7db,1,1,1,2,1,2012-05-25 20:29:24,2012-05-25 20:29:24
cfbcdfe8e6caf68128ba7402e28f9e76e046c7db...6b882b6d47edd14bb83259386d4fff7f987e2381,2,20,1,21,5,2012-05-25 20:30:12,2012-05-24 14:53:00
6b882b6d47edd14bb83259386d4fff7f987e2381...640fbbe0f31a2909dbae09c394418bb76b06fd90,1,12,0,12,1,2012-05-25 20:53:20,2012-05-25 19:23:51
640fbbe0f31a2909dbae09c394418bb76b06fd90...57cbc35794c5d9a75a3b4a1523b653d8c39e9be8,1,2,0,2,1,2012-05-25 21:57:32,2012-05-25 21:57:32
57cbc35794c5d9a75a3b4a1523b653d8c39e9be8...e5118d36ada90fad51606b5518326b3cbe48044f,3,159,2,161,10,2012-05-25 21:58:14,2012-05-25 21:58:14
e5118d36ada90fad51606b5518326b3cbe48044f...b64f53a3eaa0003f02ed174a7af958a3cdf33fda,4,289,13,302,15,2012-05-25 22:07:21,2012-05-25 22:07:21
b64f53a3eaa0003f02ed174a7af958a3cdf33fda...073f9ec84eb5e198e95ab19bdde3f04761c14234,5,416,316,732,45,2012-05-25 22:41:18,2012-05-25 22:41:18
073f9ec84eb5e198e95ab19bdde3f04761c14234...41e1c9c10baf1d64397030c7d9466722da05fbaf,4,122,73,195,30,2012-05-25 22:41:27,2012-05-20 06:30:35
41e1c9c10baf1d64397030c7d9466722da05fbaf...d7dad49026bf566904a38b750221c15b77efc1ea,6,68,36,104,15,2012-05-25 22:41:33,2012-05-20 20:41:25
d7dad49026bf566904a38b750221c15b77efc1ea...7e20afe8f43b689f7e1364ae7636af05557f923c,3,28,20,48,14,2012-05-25 22:41:37,2012-05-20 21:05:09
7e20afe8f43b689f7e1364ae7636af05557f923c...9064017c02475db4c3bcba842bca1c3991581a4a,2,35,18,53,15,2012-05-25 22:41:46,2012-05-21 00:30:23
9064017c02475db4c3bcba842bca1c3991581a4a...b45a090c0f4f6c313c1ef2c9ed7029da0a41f047,1,37,23,60,3,2012-05-25 22:41:58,2012-05-21 00:44:17
b45a090c0f4f6c313c1ef2c9ed7029da0a41f047...48b8dc97c4c1e15746a077f64a63a0346e5db980,1,0,7,7,1,2012-05-25 22:42:10,2012-05-21 00:59:25
48b8dc97c4c1e15746a077f64a63a0346e5db980...e15ed2dc0651e35cba5e6c4b4ca76d3d0037e3ec,2,33,8,41,2,2012-05-25 23:08:56,2012-05-25 18:57:39
e15ed2dc0651e35cba5e6c4b4ca76d3d0037e3ec...c24dd200345d61b1acc199089ddc48d8472b690f,3,9,72,81,27,2012-05-26 20:34:30,2012-05-26 20:34:30
c24dd200345d61b1acc199089ddc48d8472b690f...ea5f8bc08b8d9d68cdfd2d0c8c5e4962590f9b52,1,1,2,3,2,2012-05-27 00:42:40,2012-05-27 00:42:40
ea5f8bc08b8d9d68cdfd2d0c8c5e4962590f9b52...08e79fde14acc9eeaaf4364f9b95a2ade60a6832,7,87,3,90,14,2012-05-27 15:22:47,2012-05-25 18:16:15
08e79fde14acc9eeaaf4364f9b95a2ade60a6832...0735336834dd9e55a62c6ce6baa0b1b525d7bd65,1,15,13,28,5,2012-05-27 17:54:01,2012-05-27 17:54:01
0735336834dd9e55a62c6ce6baa0b1b525d7bd65...dfcd7034073f74c05137f87d0683482af7edeffd,1,11,11,22,8,2012-05-28 01:05:17,2012-05-28 01:05:17
dfcd7034073f74c05137f87d0683482af7edeffd...fd847074a412eb8e6a96d8d65f27c220d65bdbff,1,7,2,9,1,2012-05-28 01:05:25,2012-05-28 01:05:25
fd847074a412eb8e6a96d8d65f27c220d65bdbff...6e3e0e8eb8d2bf711d83ea1ccbebb0bb57e6899f,1,4,0,4,1,2012-05-28 01:11:09,2012-05-28 01:11:09
6e3e0e8eb8d2bf711d83ea1ccbebb0bb57e6899f...46f97f8fe758d97033d1e0319ab029e0906e43a2,1,1,1,2,1,2012-05-28 02:19:58,2012-05-28 02:19:58
46f97f8fe758d97033d1e0319ab029e0906e43a2...3d47fb727f5e6b1128e5617b4119a55bc7b988b1,1,4,2,6,2,2012-05-28 02:38:58,2012-05-28 02:38:58
3d47fb727f5e6b1128e5617b4119a55bc7b988b1...7c6ad5669d859fe6e2fbbdd5233c69fb7536db73,1,4,0,4,4,2012-05-29 00:22:56,2012-05-29 00:22:56
7c6ad5669d859fe6e2fbbdd5233c69fb7536db73...3f33add676650e5dcdd5f805249f251bb87dbcf2,1,8,0,8,3,2012-05-29 03:39:16,2012-05-29 03:38:49
3f33add676650e5dcdd5f805249f251bb87dbcf2...1c002b2f63eb209e0fcaba7b65c7a42fce0c18c1,1,15,3,18,1,2012-05-29 15:59:57,2012-05-29 15:58:05
1c002b2f63eb209e0fcaba7b65c7a42fce0c18c1...2330b03cbaf302d26f410f3c75d65f8428325081,1,1,1,2,1,2012-05-29 16:31:37,2012-05-29 16:30:45
2330b03cbaf302d26f410f3c75d65f8428325081...7ec502d1c6b9b0cd900796bc91a511ffbe644314,1,109,0,109,1,2012-05-29 17:53:41,2012-05-22 19:19:15
7ec502d1c6b9b0cd900796bc91a511ffbe644314...9848a871312baab5f73ee1aa7dd2cbcb65387113,5,438,261,699,64,2012-05-29 18:25:05,2012-05-08 23:45:47
9848a871312baab5f73ee1aa7dd2cbcb65387113...012f1a16ba2630f16eb4329e37627a4868f6e4c8,1,2,0,2,1,2012-05-29 18:38:21,2012-05-29 18:37:57
012f1a16ba2630f16eb4329e37627a4868f6e4c8...31f479ac753d442d8c75272aff4c16c76c3d056b,29,486,316,802,208,2012-05-29 19:13:02,2012-05-27 20:24:20
31f479ac753d442d8c75272aff4c16c76c3d056b...5e5de9b4299727dc4fca78f6cf6cffc07b2d7c8b,2,2,1,3,3,2012-05-29 19:26:24,2012-05-29 17:32:08
5e5de9b4299727dc4fca78f6cf6cffc07b2d7c8b...12c581c1ebddcb934deaabb0b10487e787214479,2,3,110,113,10,2012-05-29 19:30:52,2012-05-29 18:06:37
12c581c1ebddcb934deaabb0b10487e787214479...5aa8ac2e82eaf2546bff2249cb717371f9ebae23,1,5,0,5,1,2012-05-29 19:30:52,2012-05-29 18:11:04
5aa8ac2e82eaf2546bff2249cb717371f9ebae23...2572d9ad5710905b57760366d7722a247f4c5618,2,4,0,4,2,2012-05-29 20:26:55,2012-05-29 20:26:55
2512b21a99a405471c23f8d7354e548774a68042...dfd532e631e1021af3b92e69ad83ce7cdec6e62e,1,2,1,3,3,2011-08-20 00:11:05,2011-08-20 00:11:05
dfd532e631e1021af3b92e69ad83ce7cdec6e62e...4f0d2349c7ac87c6d365e261ee5ed882a0ab0fde,1,2,3,5,1,2011-08-20 05:08:24,2011-08-20 05:08:24
4f0d2349c7ac87c6d365e261ee5ed882a0ab0fde...f33cd59e7439f886681ff0b145fcb592187dc217,1,0,1,1,1,2011-08-21 05:34:14,2011-08-21 05:34:14
f33cd59e7439f886681ff0b145fcb592187dc217...d40cad9feb14c0a2be44ddbe693a178181c4dbb1,247,132877,86,132963,257,2011-08-21 05:34:54,2011-08-19 22:09:18
d40cad9feb14c0a2be44ddbe693a178181c4dbb1...f97d900e5a1096471679ec5c640b1176d2b78594,2,1,1,2,1,2011-08-21 05:47:27,2011-08-21 05:47:27
f97d900e5a1096471679ec5c640b1176d2b78594...b5343d9319390cd1adc4028bd47e16d064be6280,2,3,0,3,1,2011-08-21 14:40:24,2011-08-21 14:40:24
b5343d9319390cd1adc4028bd47e16d064be6280...2890a4ed0c4d573baa621bca4ae591f24c4266be,1,4,0,4,1,2011-08-21 16:20:15,2011-08-21 16:20:15
2890a4ed0c4d573baa621bca4ae591f24c4266be...ea8b5df21770f45c4efdb7a6d03fbbb711f25f1f,1,1,2,3,1,2011-08-22 04:40:49,2011-08-22 04:40:49
ea8b5df21770f45c4efdb7a6d03fbbb711f25f1f...229e06bae5998cb70aa041b02fd4a440ef0b4f64,1,3,0,3,1,2011-08-22 04:43:01,2011-08-22 04:43:01
229e06bae5998cb70aa041b02fd4a440ef0b4f64...cc8730d27fdb58aa482c9b582d4b6dc67dd9a50a,1,1,1,2,1,2011-08-22 04:51:34,2011-08-22 04:51:34
cc8730d27fdb58aa482c9b582d4b6dc67dd9a50a...ed9f00aa1a15287124a0b676855bec3909efbbb9,2,5,1,6,3,2011-08-22 06:17:21,2011-08-22 06:17:21
ed9f00aa1a15287124a0b676855bec3909efbbb9...b3f8d89a7171aa40e4dbb3106215efb2989217b4,1,5,5,10,3,2011-08-22 17:32:59,2011-08-22 17:32:59
b3f8d89a7171aa40e4dbb3106215efb2989217b4...68085eb00e6d7395cc3deeb9dcb3a027f87ecf89,1,109,0,109,1,2011-08-22 18:08:14,2011-08-22 18:07:50
68085eb00e6d7395cc3deeb9dcb3a027f87ecf89...f7e97e0b769d8bec50e27fa0c459e096621fc0c0,2,5,5,10,3,2011-08-22 18:27:43,2011-08-22 18:27:21
f7e97e0b769d8bec50e27fa0c459e096621fc0c0...96063f8a6554b66c450c928a09907da9ab39a170,4,4,4,8,4,2011-08-22 19:35:38,2011-08-22 19:35:38
96063f8a6554b66c450c928a09907da9ab39a170...fe08b2ee5a787d915488ebce6eecceea2323ae01,1,5,3,8,1,2011-08-22 19:40:13,2011-08-22 19:40:13
fe08b2ee5a787d915488ebce6eecceea2323ae01...b31c71b298852586dbc5017d2070a4bb5e1dd93c,1,12,0,12,4,2011-08-22 19:42:20,2011-08-22 19:36:50
b31c71b298852586dbc5017d2070a4bb5e1dd93c...eb03b83deadc451c23b7169c7a96c8b9c4c6fb88,1,1,1,2,1,2011-08-22 20:07:35,2011-08-22 20:07:04
eb03b83deadc451c23b7169c7a96c8b9c4c6fb88...afa9b2b469b9f31ddb33d644de2d468c3a42c549,1,1,1,2,1,2011-08-22 20:07:35,2011-08-22 20:07:22
afa9b2b469b9f31ddb33d644de2d468c3a42c549...18fa82a72b791289f3f4dfc5f3e3f2e998788c4a,2,56,4,60,6,2011-08-22 21:03:56,2011-08-22 21:01:38
18fa82a72b791289f3f4dfc5f3e3f2e998788c4a...acebc5e05e97b6a6d3d0c2d217f63058b1987b13,3,35,13,48,14,2011-08-23 02:53:48,2011-08-22 22:53:10
acebc5e05e97b6a6d3d0c2d217f63058b1987b13...278f5cee2c98f9f0edac641111a6794e9c828f96,2,2,2,4,2,2011-08-23 03:03:10,2011-08-23 03:03:10
278f5cee2c98f9f0edac641111a6794e9c828f96...452256db6c681cc92d881bd99fe4cb2ade71d5c0,1,3,1,4,1,2011-08-23 15:13:20,2011-08-23 15:12:59
452256db6c681cc92d881bd99fe4cb2ade71d5c0...51493ee6425646f175718d8320f12550d8743f21,5,20,2,22,8,2011-08-23 16:08:37,2011-08-23 16:08:37
51493ee6425646f175718d8320f12550d8743f21...3e1729e2b6c3668712c3f0197e09a55386e008a6,1,12,4,16,2,2011-08-23 18:29:30,2011-08-23 17:56:06
3e1729e2b6c3668712c3f0197e09a55386e008a6...febe8962d0ef76dcbf55a82bd91701a3cb21f965,1,1,0,1,1,2011-08-23 19:53:44,2011-08-23 19:53:44
febe8962d0ef76dcbf55a82bd91701a3cb21f965...0fa2156404a615b188a1ebb05998dad2c13a0721,1,4,12,16,2,2011-08-23 20:03:56,2011-08-23 20:03:56
0fa2156404a615b188a1ebb05998dad2c13a0721...c4639a3e612a7b14a98f306d013f096f123dd78a,1,2,1,3,1,2011-08-23 20:05:44,2011-08-23 20:05:44
c4639a3e612a7b14a98f306d013f096f123dd78a...5940dfb327ad73dffe8bbf01ff96a36a562648c7,1,21,1,22,2,2011-08-23 21:17:30,2011-08-23 21:17:30
5940dfb327ad73dffe8bbf01ff96a36a562648c7...ae17b51c4a5425b8c901b41afd466b768e006a57,1,1,1,2,1,2011-08-24 00:31:48,2011-08-24 00:31:41
ae17b51c4a5425b8c901b41afd466b768e006a57...cad7aba1d3e336654e86eb5001d1667cde022b10,1,16,0,16,2,2011-08-24 03:03:44,2011-08-24 03:03:44
cad7aba1d3e336654e86eb5001d1667cde022b10...a1b1601affd2f412e830115694177be3298a358e,1,1,21,22,2,2011-08-24 04:08:27,2011-08-24 04:08:27
a1b1601affd2f412e830115694177be3298a358e...0dd179510c64c16713215632d31afbdaebe71399,2,6,1,7,2,2011-08-24 15:13:57,2011-08-24 15:09:26
0dd179510c64c16713215632d31afbdaebe71399...25c2fbff89d19b86183032b12f9752985ad7a6d1,1,4,2,6,3,2011-08-24 19:07:30,2011-08-24 19:07:30
25c2fbff89d19b86183032b12f9752985ad7a6d1...8d4bf50111352cee5a4f1abf25b63442d6c45dc4,3,3,3,6,3,2011-08-25 05:50:35,2011-08-25 05:50:35
8d4bf50111352cee5a4f1abf25b63442d6c45dc4...812e49a673293f34a09f091cb5e9124cc5685c6d,2,48,16,64,2,2011-08-25 16:32:59,2011-08-25 16:31:06
812e49a673293f34a09f091cb5e9124cc5685c6d...1450e4ccdf72c77f9e5b8d037bcaff732d863ab3,1,20,20,40,6,2011-08-25 16:50:25,2011-08-25 16:50:25
1450e4ccdf72c77f9e5b8d037bcaff732d863ab3...7edca83b5f1a8f7dd77556cfd10786e83c6465f3,2,2,2,4,2,2011-08-26 06:57:01,2011-08-25 19:11:18
7edca83b5f1a8f7dd77556cfd10786e83c6465f3...c591921a2ad1bce49ad9fd04553c29b60367a793,1,1,0,1,1,2011-08-26 23:09:14,2011-08-26 23:09:14
c591921a2ad1bce49ad9fd04553c29b60367a793...a61217961f655ec76e4abbcf7ae36c9f1913e298,3,8,2,10,3,2011-08-29 14:44:16,2011-08-29 14:44:16
a61217961f655ec76e4abbcf7ae36c9f1913e298...cbba880bd437449490c70dc4c4c00d6aa2930c24,2,5,3,8,4,2011-08-29 15:41:16,2011-08-29 15:41:16
cbba880bd437449490c70dc4c4c00d6aa2930c24...7b84ebe8279d7da46dd61e685a4fb474497ca48a,1,6,1,7,1,2011-08-29 15:45:11,2011-08-29 15:45:11
3c5b99cbd63af217b92283f56ba6744215ce5eee...14adf2b29acaaa2db635bad3e574667079e6a28e,1,1,1,2,1,2011-11-02 17:59:40,2011-11-02 17:59:40
3c5b99cbd63af217b92283f56ba6744215ce5eee...d121b7ba4e40ff6b8aee657ed36094f1a9eb3dce,1,6,3,9,4,2011-11-02 16:58:25,2011-11-02 16:58:25
d121b7ba4e40ff6b8aee657ed36094f1a9eb3dce...dd126232cda262c069d0802c3031529ceac25977,2,104,2,106,4,2011-11-02 17:06:37,2011-11-02 17:06:37
23c33b2f8f6da5f498b06d191cde6916d3f07025...acd8935b0e392cb11271bd81581154da79ba5be7,1,1,1,2,1,2011-10-20 02:43:40,2011-10-20 02:29:22
23c33b2f8f6da5f498b06d191cde6916d3f07025...b8d9f892bef2d2304efd97ec12f734e912a2ba58,1,1,0,1,1,2011-10-18 18:49:11,2011-10-18 18:49:11
b8d9f892bef2d2304efd97ec12f734e912a2ba58...257dc88e46733c6be76f7082b783ae340b947429,1,4,0,4,1,2011-10-18 19:03:18,2011-10-18 17:47:26
257dc88e46733c6be76f7082b783ae340b947429...210b59d855530115508ce3a1d64fa9b3ccba0ff3,1,4,2,6,2,2011-10-18 19:03:18,2011-10-18 18:01:56
210b59d855530115508ce3a1d64fa9b3ccba0ff3...00752854b568832b8df39ba301205d762b199c5b,1,4,0,4,1,2011-10-18 19:03:18,2011-10-18 18:24:42
00752854b568832b8df39ba301205d762b199c5b...c9b4c08409b4de2c0a030c455de607966b3761c7,1,5,3,8,3,2011-10-18 23:26:17,2011-10-18 23:26:17
c9b4c08409b4de2c0a030c455de607966b3761c7...7445905037ceba090d8b14efd4320385744c4b9c,1,3,5,8,3,2011-10-19 03:06:14,2011-10-19 03:06:14
7445905037ceba090d8b14efd4320385744c4b9c...4e0321c714096aca5821575fb5a48235f9ad5b3a,1,11,12,23,4,2011-10-19 03:18:58,2011-10-19 03:18:58
4e0321c714096aca5821575fb5a48235f9ad5b3a...7c4fd4b18af6fd42e9898bc16f716cc76921a7a7,1,1,0,1,1,2011-10-19 05:20:10,2011-10-19 05:20:10
7c4fd4b18af6fd42e9898bc16f716cc76921a7a7...397660d0b0731b3684b9f084984b9594f6876091,1,1,0,1,1,2011-10-19 05:22:08,2011-10-19 05:22:08
397660d0b0731b3684b9f084984b9594f6876091...ad39dc9944e93094e262558d3cb1cd093dc46174,1,11,0,11,3,2011-10-19 16:13:07,2011-10-19 16:12:37
ad39dc9944e93094e262558d3cb1cd093dc46174...068cad4fbe97d9d004601cca08c5720c88acd8c9,2,9,6,15,7,2011-10-19 16:34:35,2011-10-19 16:34:21
2572d9ad5710905b57760366d7722a247f4c5618...1be00adfec6df46222a211ffe21b3e4d574e8768,2,4,0,4,2,2012-05-30 16:48:06,2012-05-30 16:48:06
2572d9ad5710905b57760366d7722a247f4c5618...8bc8e7eb979e14fca20168adfe12658e4d4d2080,6,16,0,16,8,2012-05-29 22:02:13,2012-05-29 22:02:13
8bc8e7eb979e14fca20168adfe12658e4d4d2080...bf2835ad7548362ceec3e202f1e77a96ef45eb17,2,15,14,29,6,2012-05-29 22:04:06,2012-05-27 12:40:22
bf2835ad7548362ceec3e202f1e77a96ef45eb17...3144160583c0ced974a7a428a12d7e561d35c182,1,1,1,2,1,2012-05-30 02:52:50,2012-05-30 02:52:50
3144160583c0ced974a7a428a12d7e561d35c182...62db9a328c30f497960fd10b7be2f34990dcdbd3,1,21,22,43,7,2012-05-30 09:17:18,2012-05-30 09:17:18
62db9a328c30f497960fd10b7be2f34990dcdbd3...3db1b3d878aae7899f8a2965cafd8b9ac05be003,1,3,2,5,2,2012-05-30 15:59:12,2012-05-30 15:59:12
3db1b3d878aae7899f8a2965cafd8b9ac05be003...08cf8964c3bb095d9f4114157bdf456c195ed510,1,74,53,127,16,2012-05-30 15:59:40,2012-05-30 15:59:40
08cf8964c3bb095d9f4114157bdf456c195ed510...62a5882e24d1ff5d8f70854f03b78f0ee8fac6d6,1,16,0,16,1,2012-05-30 15:59:58,2012-05-30 15:59:58
7b84ebe8279d7da46dd61e685a4fb474497ca48a...cfcc0d3972660c38eb37d8d97b7a813ddc7513b0,1,2,1,3,1,2011-08-29 18:57:47,2011-08-29 18:57:47
7b84ebe8279d7da46dd61e685a4fb474497ca48a...3fc16f4e36aed091877448e9366b6b0949c686db,1,7,1,8,2,2011-08-29 17:16:58,2011-08-29 17:16:58
3fc16f4e36aed091877448e9366b6b0949c686db...75eb7ca39ab4d5180078402bb3c4ed948705c83f,1,21,11,32,4,2011-08-29 18:19:41,2011-08-29 18:18:17
75eb7ca39ab4d5180078402bb3c4ed948705c83f...cba958b22301f26c9f29a37a533eb9a31d7c77b8,2,9,1,10,2,2011-08-29 18:39:43,2011-08-29 18:38:31
98d5685751fd8e95922fe0da6271f5e7d8ac88ba...618f349e2322e7f4b04e7f7aeae4e84aa89019e9,1,10,3,13,2,2011-11-02 18:01:47,2011-11-02 18:01:10
1903a071fa6427737817d9f8414f91c83c24674d...44f61f31f75b0ecbb02ee8cc6576e115590c06a2,2,2,0,2,2,2011-10-28 13:33:20,2011-10-28 13:26:14
44f61f31f75b0ecbb02ee8cc6576e115590c06a2...9ec7b6be01451798c5c711c61df0aad92bdb4f7f,2,635,633,1268,12,2011-10-28 13:33:22,2011-10-28 13:26:35
9ec7b6be01451798c5c711c61df0aad92bdb4f7f...4bf4bcf0b4574ee09c9ae9f35c404f51a46b6640,10,75,23,98,22,2011-10-28 13:33:24,2011-10-28 13:32:58
4bf4bcf0b4574ee09c9ae9f35c404f51a46b6640...dae93e9262afa7d333f093dac1ddf7b3fc82008d,3,12,1,13,4,2011-10-28 13:43:41,2011-10-28 13:43:41
068cad4fbe97d9d004601cca08c5720c88acd8c9...b168674141ea4f7e8c5cb832b978204f61ab3eda,2,2,2,4,2,2011-10-24 15:05:35,2011-09-26 15:46:21
068cad4fbe97d9d004601cca08c5720c88acd8c9...f93918db8ec15c9de7c884d0a560a185a8ef423d,3,66,24,90,10,2011-10-20 17:31:18,2011-10-20 17:31:18
f93918db8ec15c9de7c884d0a560a185a8ef423d...748b88f682759dc699aa9093e28bc26fc9e8fb43,4,10,10,20,10,2011-10-20 17:44:36,2011-10-20 17:44:36
748b88f682759dc699aa9093e28bc26fc9e8fb43...42ab1fdd123a79b54420ff7de75e955c77d7dccf,1,2,2,4,2,2011-10-20 20:42:51,2011-10-20 20:42:51
42ab1fdd123a79b54420ff7de75e955c77d7dccf...3243b6827aaec2ee3b24210410f8f10f5e0d41f0,1,2,1,3,1,2011-10-20 20:59:26,2011-10-20 20:59:26
3243b6827aaec2ee3b24210410f8f10f5e0d41f0...8a93ffd3f8aa8d607c0450433a501cdea42cea06,1,1,1,2,1,2011-10-20 23:19:39,2011-10-20 23:19:39
8a93ffd3f8aa8d607c0450433a501cdea42cea06...64de8768221d87ec6d67838743e040960fc309a2,1,1,0,1,1,2011-10-21 13:56:01,2011-10-21 13:55:38
64de8768221d87ec6d67838743e040960fc309a2...1700fe29bc88a3343508c460d7341c83568d6095,1,3,0,3,1,2011-10-21 14:02:56,2011-10-21 14:02:56
1700fe29bc88a3343508c460d7341c83568d6095...3e478e686c35290fa10237cd2591b1eba3284e1e,1,3,3,6,3,2011-10-21 14:17:48,2011-10-21 14:17:48
3e478e686c35290fa10237cd2591b1eba3284e1e...5f7feee66ca6c1c915852de83a93502a26f64d8e,4,78,57,135,16,2011-10-22 15:54:32,2011-10-19 16:13:04
5f7feee66ca6c1c915852de83a93502a26f64d8e...a1e68969d48bbb47c893870f6428048a602faf90,4,9,9,18,6,2011-10-22 16:03:38,2011-10-22 16:03:38
a1e68969d48bbb47c893870f6428048a602faf90...6311f3df9f2de517b40ccf2dbd5a58776119c251,2,3,0,3,2,2011-10-22 16:07:32,2011-10-14 15:08:51
6311f3df9f2de517b40ccf2dbd5a58776119c251...03dbe744434b95f1ded1c6941f169cd2d67e4112,2,2,3,5,3,2011-10-22 16:07:37,2011-10-14 17:03:24
03dbe744434b95f1ded1c6941f169cd2d67e4112...e25062faf5045009d2fad4698792eae4419a6f36,1,4,7,11,5,2011-10-22 16:07:43,2011-10-14 22:54:17
e25062faf5045009d2fad4698792eae4419a6f36...99db06077e305885ebad0f9c6b7704aeadb322b9,1,1,1,2,1,2011-10-24 03:34:27,2011-10-24 03:34:27
62a5882e24d1ff5d8f70854f03b78f0ee8fac6d6...d4db8209e94433281c9c27adca26bb8846ab186b,1,5,8,13,4,2012-05-30 17:26:47,2012-05-30 16:21:46
b969ac49be00a472c51898397f81f1dee2d0f48d...ab2b5d24d6f668b842651166656d5e023a0c129b,1,6,0,6,2,2011-08-29 19:36:41,2011-08-29 18:13:21
ab2b5d24d6f668b842651166656d5e023a0c129b...8c0e882052259000c665b7ad28f27118bba0ad6f,3,90,5,95,10,2011-08-29 19:36:41,2011-08-29 19:35:41
9ae770203f54015f10b99ba58f9da915ddf67b13...a8db5a959a20006fa9b33829740da41326addd97,1,1,1,2,1,2011-11-02 18:04:16,2011-11-02 18:04:16
a8db5a959a20006fa9b33829740da41326addd97...e48d88a9abd62222377bc6611bfc6784d218b77d,1,1,1,2,1,2011-11-02 18:34:10,2011-11-02 18:34:10
dae93e9262afa7d333f093dac1ddf7b3fc82008d...cd057a21ea42fcf5df04ee905d9866a254d1c0e9,3,194,11,205,7,2011-10-28 16:06:29,2011-10-28 16:06:29
dae93e9262afa7d333f093dac1ddf7b3fc82008d...f9a94a82e8a6145711d5f924070401c502629ec0,1,6,0,6,1,2011-10-28 15:39:07,2011-10-28 15:39:07
aac7de71db70ea679341281982b49bd8d87f7c7f...3733a988c5e7b68c61d08f21d0bd1eec84da66d2,2,5,3,8,5,2011-10-24 19:07:24,2011-10-24 19:07:24
3733a988c5e7b68c61d08f21d0bd1eec84da66d2...617e9ff8ec1ecd134c7e6e42c85983ff8873a30d,1,4,0,4,1,2011-10-24 19:20:03,2011-10-24 19:20:03
617e9ff8ec1ecd134c7e6e42c85983ff8873a30d...112eb0cf9eccce614a784d61f9f7652b61bd2340,1,1,0,1,1,2011-10-24 21:09:56,2011-10-24 21:09:56
112eb0cf9eccce614a784d61f9f7652b61bd2340...28dd8fcd389d90a4177542a3071841a6b44a6f82,2,104,19,123,8,2011-10-24 21:10:04,2011-10-24 21:10:04
28dd8fcd389d90a4177542a3071841a6b44a6f82...3e9dfebcf135501213edfae66499bfbffb84a666,5,102,30,132,13,2011-10-24 21:39:54,2011-10-24 21:35:51
99db06077e305885ebad0f9c6b7704aeadb322b9...0a1936069076e1077fb4494a351fa05c3807efe0,1,1,1,2,1,2011-10-24 15:14:21,2011-10-07 12:46:36
a6059f4b286021d6edc073a9b9040e605aed3fce...72e14b4afbb2777281eb0c40612596ed1223730e,2,1401,777,2178,255,2012-05-30 18:28:58,2012-05-22 21:01:39
72e14b4afbb2777281eb0c40612596ed1223730e...d66742bd06a203ae5858d104477e7d8aaac3424a,2,13,11,24,3,2012-05-30 19:49:36,2012-05-30 19:49:36
d66742bd06a203ae5858d104477e7d8aaac3424a...eef1039951718a1337967a373d5abecfaff47877,3,48,0,48,3,2012-05-30 20:14:06,2012-05-30 14:35:16
eef1039951718a1337967a373d5abecfaff47877...d54bc803f9226b57a7eb58f07f856beb361fb658,1,30,0,30,5,2012-05-30 21:43:15,2012-05-30 21:43:15
d54bc803f9226b57a7eb58f07f856beb361fb658...36d03b8192abc6acb523f43f7c2266274b417a45,6,39,0,39,6,2012-05-30 21:50:39,2012-05-30 21:20:40
36d03b8192abc6acb523f43f7c2266274b417a45...135bbe4cc95023348feb05e3bbc59892b9edf23d,1,5,0,5,1,2012-05-30 22:05:37,2012-05-30 20:15:40
135bbe4cc95023348feb05e3bbc59892b9edf23d...d0e8e4f665c69e2ee384c0828457038d40b1498e,1,11,1,12,1,2012-05-31 13:14:40,2012-05-31 11:05:35
d0e8e4f665c69e2ee384c0828457038d40b1498e...ef4d5cbf766a99dddb886ffbadceef0def82beb8,10,25,39,64,20,2012-05-31 13:50:29,2012-05-30 21:40:24
ef4d5cbf766a99dddb886ffbadceef0def82beb8...5abe8976e51bb2f1be6ae49015d31aa5e21c6ea4,1,3,3,6,1,2012-05-31 14:00:59,2012-05-31 02:53:49
5abe8976e51bb2f1be6ae49015d31aa5e21c6ea4...7b6db539971b671d6e05d8de0c5182a263f856a7,1,0,1,1,1,2012-05-31 14:11:58,2012-05-31 14:11:58
7b6db539971b671d6e05d8de0c5182a263f856a7...70265f0d0ee3492c2453857de14acd2fbe70ef59,1,2,0,2,1,2012-05-31 14:16:37,2012-05-31 14:16:37
70265f0d0ee3492c2453857de14acd2fbe70ef59...ba2e27e2843d1c7518059cc9565a07aefc4b0262,1,4,0,4,3,2012-05-31 14:17:28,2012-05-30 21:47:33
ba2e27e2843d1c7518059cc9565a07aefc4b0262...a42e4da9aef50df7c6a776cc64e624e1f13e4a6b,1,11,6,17,5,2012-05-31 14:25:40,2012-05-30 21:48:39
a42e4da9aef50df7c6a776cc64e624e1f13e4a6b...318aef0938832a1b8fb6136d9c14282422ac39cc,2,2,2,4,2,2012-05-31 16:27:46,2012-05-31 16:27:46
318aef0938832a1b8fb6136d9c14282422ac39cc...fa6f08bfa19215181fc8c3be156304418af3954e,1,2,3,5,2,2012-05-31 17:08:47,2012-05-31 17:08:47
fa6f08bfa19215181fc8c3be156304418af3954e...da894a5500d87a35a5d6574d363e681487bf64d1,4,60,2,62,5,2012-05-31 17:34:37,2012-05-31 15:30:53
da894a5500d87a35a5d6574d363e681487bf64d1...fcf121792af0ea41f31e3a17b90d62687d065c5b,7,193,28,221,23,2012-05-31 18:21:37,2012-05-29 20:09:32
fcf121792af0ea41f31e3a17b90d62687d065c5b...d0790729c406ee25e7bb77f5f594e573f654d2b3,5,18,26,44,17,2012-05-31 18:21:39,2012-05-31 18:17:25
d0790729c406ee25e7bb77f5f594e573f654d2b3...ffa7c4dcce075a6d18de13b7c05fd0dae16bfa7e,1,4,2,6,3,2012-05-31 19:03:44,2012-05-31 18:40:09
ffa7c4dcce075a6d18de13b7c05fd0dae16bfa7e...610eb7840cbd073d499c9d2c6eff2b1bba5ba973,2,34,44,78,13,2012-05-31 21:00:30,2012-05-31 19:31:15
610eb7840cbd073d499c9d2c6eff2b1bba5ba973...9eb4a521d3f17b1707c9ad3b7261031673f4e4a1,1,4,1,5,1,2012-05-31 21:00:32,2012-05-31 20:48:25
9eb4a521d3f17b1707c9ad3b7261031673f4e4a1...b8bff69057ff01df7a0e81017d304c6ae50ecaa0,1,1,1,2,1,2012-05-31 21:00:34,2012-05-31 20:57:51
b8bff69057ff01df7a0e81017d304c6ae50ecaa0...b26bb992b458fa45af01d3f51e4ce8725f96ee70,2,11,1,12,3,2012-05-31 23:52:31,2012-05-31 17:24:03
b26bb992b458fa45af01d3f51e4ce8725f96ee70...4e4e5b1f48799a8dcaf993e4bd3d4c439d50b7fa,1,13,10,23,3,2012-06-01 09:18:31,2012-06-01 09:18:31
4e4e5b1f48799a8dcaf993e4bd3d4c439d50b7fa...b536718ba45bafeae7913b9ab6a5eadebfe562ed,4,12,23,35,13,2012-06-01 12:44:12,2012-06-01 12:44:12
b536718ba45bafeae7913b9ab6a5eadebfe562ed...32c4381ffa76c651c825bae3249f566493d12c8f,1,1,0,1,1,2012-06-01 13:32:42,2012-05-10 10:00:21
32c4381ffa76c651c825bae3249f566493d12c8f...09b2bccae988d1030a3295c3af32b3ee9571d818,5,19,10,29,10,2012-06-01 14:10:14,2012-05-30 17:55:50
09b2bccae988d1030a3295c3af32b3ee9571d818...8957d3849edc9a94ab6057ce51ff3830c9522073,5,636,523,1159,10,2012-06-01 14:12:54,2012-05-30 19:10:40
8957d3849edc9a94ab6057ce51ff3830c9522073...25ee6dfdc9e52ab93e664d166352d6787af6a4e3,4,21,6,27,7,2012-06-01 14:12:54,2012-05-31 13:10:02
25ee6dfdc9e52ab93e664d166352d6787af6a4e3...77649a165ee800c7b519b91461084b7a619d279e,2,131,0,131,2,2012-06-01 19:12:28,2012-05-31 15:04:06
77649a165ee800c7b519b91461084b7a619d279e...bc4b27c7a84e1172dc32809603c425abf9e97050,1,0,14,14,2,2012-06-01 19:12:28,2012-05-31 17:40:04
bc4b27c7a84e1172dc32809603c425abf9e97050...e1aa2fd708382e48a6e01ce46b988fb0d8abec07,1,61,0,61,1,2012-06-01 20:19:31,2012-06-01 15:08:45
e1aa2fd708382e48a6e01ce46b988fb0d8abec07...aee30f4ebad8e4a3fd9447ee6f49773947a06a8d,2,15,1,16,3,2012-06-01 21:36:56,2012-05-29 20:23:57
aee30f4ebad8e4a3fd9447ee6f49773947a06a8d...97007458ad56f5ab2270499036412a248c4f3503,3,16,4,20,7,2012-06-01 21:36:56,2012-05-29 23:35:21
97007458ad56f5ab2270499036412a248c4f3503...ca02fab3d15f1075235cf80d271e8a2c77bf1217,1,3,6,9,4,2012-06-01 21:36:56,2012-05-30 00:00:54
ca02fab3d15f1075235cf80d271e8a2c77bf1217...86b5b89c2785f3f45ad2674f48fe3189c137904c,5,66,5,71,6,2012-06-01 23:25:03,2012-05-31 01:04:13
86b5b89c2785f3f45ad2674f48fe3189c137904c...7e3ec9e15190fec7123690804b426a1a1f58733f,3,22,3,25,5,2012-06-01 23:36:33,2012-05-31 16:51:39
7e3ec9e15190fec7123690804b426a1a1f58733f...9ce4fc4eebc2e6f8a388fc3205bee0d463696354,4,32,0,32,12,2012-06-02 00:45:10,2012-06-02 00:45:10
9ce4fc4eebc2e6f8a388fc3205bee0d463696354...f5fa68b120c00b0ccd9dbc95fe18502eb490feba,2,29,2,31,2,2012-06-02 21:29:52,2012-06-02 21:29:52
f5fa68b120c00b0ccd9dbc95fe18502eb490feba...24f8f39c669437692e247c152e553a278c1b878d,1,0,0,0,0,2012-06-02 21:35:04,2012-06-02 21:35:04
24f8f39c669437692e247c152e553a278c1b878d...52bb10b65be3f618d94d1e9b127b829afaa20e7f,3,60,24,84,5,2012-06-03 04:06:40,2012-05-30 20:01:52
52bb10b65be3f618d94d1e9b127b829afaa20e7f...0578c56f6bfb592ce56c7518a6fd7d25b82e6851,1,7,1,8,1,2012-06-03 04:06:40,2012-06-03 04:04:09
0578c56f6bfb592ce56c7518a6fd7d25b82e6851...a061e153b2f3c9e669e78aa17bea82d87b868cd7,2,53,45,98,5,2012-06-03 04:06:40,2012-06-03 04:04:54
a061e153b2f3c9e669e78aa17bea82d87b868cd7...787fcbb20b08cff122e43bacdd74b1d87d8930fd,3,131,65,196,16,2012-06-03 04:06:41,2012-06-03 04:05:53
787fcbb20b08cff122e43bacdd74b1d87d8930fd...87dbe44764b11117723c2c0ca96c212fdcc97c31,1,3,2,5,2,2012-06-03 04:19:58,2012-06-03 04:19:58
87dbe44764b11117723c2c0ca96c212fdcc97c31...c1e18f235597bd1678ee68361934321c0d599a63,4,49,29,78,7,2012-06-03 14:41:19,2012-06-03 14:41:19
c1e18f235597bd1678ee68361934321c0d599a63...f0f2d4dab8f5e1cdeff71b58b292bda3d320cc06,1,80,37,117,25,2012-06-03 21:41:16,2012-06-03 21:41:16
f0f2d4dab8f5e1cdeff71b58b292bda3d320cc06...5665dddac29e77195be73f5cda5cd776c810f6ab,6,106,99,205,8,2012-06-03 21:48:34,2012-06-03 20:18:14
5665dddac29e77195be73f5cda5cd776c810f6ab...8128a0e505edca3e697cfbcfaa17e234478fce47,2,24,0,24,2,2012-06-03 21:48:34,2012-06-03 21:27:57
8128a0e505edca3e697cfbcfaa17e234478fce47...334b09b0bccd0d4475b92f17b81e5c532713aec8,2,34,0,34,2,2012-06-03 21:48:34,2012-06-03 21:28:59
334b09b0bccd0d4475b92f17b81e5c532713aec8...0e3ab7697c907405a86cb52635d54f76d6a2d231,2,42,1,43,4,2012-06-03 21:48:34,2012-06-03 21:29:15
0e3ab7697c907405a86cb52635d54f76d6a2d231...57de5d8e6bf2ab5a73bfe337eb7e7ba981981f82,1,1,2,3,2,2012-06-04 00:54:54,2012-06-04 00:54:54
57de5d8e6bf2ab5a73bfe337eb7e7ba981981f82...1f623deae00812c4048e3195f2ca886d5e750f04,1,1,0,1,1,2012-06-04 01:21:39,2012-06-04 01:21:39
1f623deae00812c4048e3195f2ca886d5e750f04...4f6acf38db83f71cd0c8a63903389d8cccb9c05d,1,2,1,3,2,2012-06-04 08:52:59,2012-06-04 08:52:59
4f6acf38db83f71cd0c8a63903389d8cccb9c05d...a3bc187bf10be829f65a21b8b080fc739ce00d6b,2,16,17,33,16,2012-06-04 09:52:08,2012-06-04 09:52:08
a3bc187bf10be829f65a21b8b080fc739ce00d6b...f771b167bf6edc931a37436e7b3463759ed7e915,1,193,2,195,5,2012-06-04 13:46:28,2012-06-02 13:35:36
f771b167bf6edc931a37436e7b3463759ed7e915...05e09a4763902a17c76b091b2e3f292948199fcd,1,76,0,76,1,2012-06-04 14:06:31,2012-05-30 22:10:53
05e09a4763902a17c76b091b2e3f292948199fcd...67964f27dd5268b3c35a45386878c8f655565274,1,2,0,2,1,2012-06-04 15:14:41,2012-06-01 19:35:07
67964f27dd5268b3c35a45386878c8f655565274...18b5d970338707f2d0e78c2b87610e5f1ee53065,1,29,25,54,3,2012-06-04 15:46:03,2012-06-04 15:37:56
18b5d970338707f2d0e78c2b87610e5f1ee53065...aca83097ebcb23bc2397c61cc52a02f09b84b2df,1,10,1,11,6,2012-06-04 15:46:03,2012-06-04 15:45:29
aca83097ebcb23bc2397c61cc52a02f09b84b2df...e40f557c79582738b55943e4f564c0eb234af772,1,11,1,12,3,2012-06-04 15:46:03,2012-06-04 15:45:40
e40f557c79582738b55943e4f564c0eb234af772...0adfc2f9274379e797d7c4d685abfac6047372c7,4,35,5,40,9,2012-06-04 15:47:59,2012-06-04 14:12:59
0adfc2f9274379e797d7c4d685abfac6047372c7...8889bd4583c841bfe232684caf4f2077550859c5,1,2,1,3,2,2012-06-04 16:48:44,2012-06-04 16:04:43
8889bd4583c841bfe232684caf4f2077550859c5...7cb8e1f11959d8cb45954fcb1cfe13cdc6caa169,1,10,7,17,1,2012-06-04 17:04:03,2012-06-04 17:04:03
7cb8e1f11959d8cb45954fcb1cfe13cdc6caa169...c04922ad14ebe43d99ba056b7b3ae79860b8cd91,9,535,177,712,94,2012-06-04 17:08:27,2012-05-30 21:48:52
c04922ad14ebe43d99ba056b7b3ae79860b8cd91...82544c7d08c033184104a5c9ab115e4047fdbdbd,3,40,5,45,4,2012-06-04 17:08:27,2012-06-01 19:26:04
82544c7d08c033184104a5c9ab115e4047fdbdbd...82811e8dc84a7f59e8f1dc00187a3863f8fb349f,1,1,1,2,1,2012-06-04 17:27:00,2012-06-04 17:27:00
82811e8dc84a7f59e8f1dc00187a3863f8fb349f...5975ab63216078b444b531fb87486a4c1e7bf64b,2,40,40,80,38,2012-06-04 17:42:11,2012-06-04 17:42:11
5975ab63216078b444b531fb87486a4c1e7bf64b...715e9514b5ac623d71a9f0c87f7dc803d4c050fe,1,11,14,25,10,2012-06-04 17:59:12,2012-06-04 17:59:12
715e9514b5ac623d71a9f0c87f7dc803d4c050fe...dd9649652b3cf603a1a09490354a1c2e0dc1c98d,3,4,3,7,4,2012-06-04 23:13:33,2012-06-04 23:13:20
dd9649652b3cf603a1a09490354a1c2e0dc1c98d...b4fcede6c839ea0afcc217063a2309281ae99fc2,1,1,1,2,2,2012-06-04 23:21:10,2012-06-04 23:17:38
b4fcede6c839ea0afcc217063a2309281ae99fc2...924c3ffadf41e973d778a7cfd3e294e832e63a34,3,33,8,41,4,2012-06-04 23:27:28,2012-06-04 23:27:28
924c3ffadf41e973d778a7cfd3e294e832e63a34...60dd33d4815b50aca3a4f829cf87b4573e64095d,8,28,16,44,22,2012-06-05 00:33:57,2012-06-05 00:33:57
60dd33d4815b50aca3a4f829cf87b4573e64095d...02042806f3a8110d6291799bc3e05c5251c11f67,1,2,0,2,1,2012-06-05 03:41:32,2012-06-04 15:55:58
02042806f3a8110d6291799bc3e05c5251c11f67...20ddcb42a39673f8be73e4555390a417aaa047e3,1,1,0,1,1,2012-06-05 03:41:32,2012-06-04 19:27:16
20ddcb42a39673f8be73e4555390a417aaa047e3...78f183186136b8271af4ec253e4bcb2bf0bbdbac,1,8,0,8,2,2012-06-05 03:41:32,2012-06-04 21:23:43
78f183186136b8271af4ec253e4bcb2bf0bbdbac...bc777ecffcd13674129f5205a63d45ea8707dd4b,3,45,0,45,5,2012-06-05 03:41:32,2012-06-05 03:38:38
bc777ecffcd13674129f5205a63d45ea8707dd4b...d602f15f5529ab8b5f104bb9d30ab6255db96985,2,17,0,17,3,2012-06-05 03:41:32,2012-06-05 03:39:04
d602f15f5529ab8b5f104bb9d30ab6255db96985...65e59a86036e57c0dbe6ea5f0999a14f7c12e9ad,2,8,8,16,4,2012-06-05 03:41:32,2012-06-05 03:39:33
65e59a86036e57c0dbe6ea5f0999a14f7c12e9ad...219eb0fac079030a16ae6a9b09ebbe4e696808ab,1,1,1,2,1,2012-06-05 03:41:32,2012-06-05 03:40:49
219eb0fac079030a16ae6a9b09ebbe4e696808ab...e0c7e39f0b78c0d5515336177287359f6d9faf6b,1,1,1,2,1,2012-06-05 11:09:11,2012-06-05 11:09:11
e0c7e39f0b78c0d5515336177287359f6d9faf6b...b61345ee9078805458b580a57385efdf9509669d,2,5,0,5,3,2012-06-05 16:58:08,2012-06-05 16:58:08
b61345ee9078805458b580a57385efdf9509669d...3aca308a1cf6e8f2e796354b6ce15611684357cb,1,130,101,231,15,2012-06-05 19:17:24,2012-06-05 14:58:38
3aca308a1cf6e8f2e796354b6ce15611684357cb...27f31f8f40410a2cffb0d4496f79b39733b528e7,2,57,6,63,6,2012-06-06 03:49:21,2012-06-06 03:25:09
27f31f8f40410a2cffb0d4496f79b39733b528e7...c9f6e23817e2f67a8c264e9ee217abc5621bad15,3,16,2,18,5,2012-06-06 03:49:21,2012-06-06 03:49:00
c9f6e23817e2f67a8c264e9ee217abc5621bad15...b710d5c4559b5eac786078a6c3b648b66832e87b,1,1,1,2,1,2012-06-06 03:53:36,2012-06-06 03:53:36
b710d5c4559b5eac786078a6c3b648b66832e87b...28738bb734ad6c8ed7f88ae8ac5eb855b8883f71,1,11,0,11,2,2012-06-06 04:46:16,2012-06-06 04:46:16
28738bb734ad6c8ed7f88ae8ac5eb855b8883f71...06fab23c488e70f1b2705e09ad3ed56601dfe81e,1,6,0,6,2,2012-06-06 17:28:29,2012-06-06 17:26:01
06fab23c488e70f1b2705e09ad3ed56601dfe81e...fd5a63e6df4d38510c36ebb57d5f7ebaad5719cc,6,48,12,60,13,2012-06-06 18:08:01,2012-06-06 18:08:01
fd5a63e6df4d38510c36ebb57d5f7ebaad5719cc...e3c91147497d5ef7b28b61a0b859485fa7700cf4,7,517,1,518,7,2012-06-06 18:51:00,2012-06-01 20:09:01
e3c91147497d5ef7b28b61a0b859485fa7700cf4...359c38ff920c06e037ac567fe6aa7942439d392c,1,22,1,23,1,2012-06-06 18:51:00,2012-06-05 21:00:57
359c38ff920c06e037ac567fe6aa7942439d392c...c506f3baa9ff074c9fa2d7b2979daee8ed305074,2,37,1,38,3,2012-06-06 18:51:00,2012-06-05 21:18:55
c506f3baa9ff074c9fa2d7b2979daee8ed305074...188084dfb313fa2eef68975d8bc5107d5c1b7d60,3,59,8,67,13,2012-06-06 18:51:00,2012-06-06 16:04:48
188084dfb313fa2eef68975d8bc5107d5c1b7d60...9e26a3a8a468540481d9f4763c77b654921b1ddc,1,1,1,2,1,2012-06-06 18:52:55,2012-06-06 18:52:55
9e26a3a8a468540481d9f4763c77b654921b1ddc...f06fb74c75d64d7d4d4f1b8ba49b2dfba8a98b06,1,46,41,87,2,2012-06-06 19:56:34,2012-06-06 15:28:11
f06fb74c75d64d7d4d4f1b8ba49b2dfba8a98b06...f0b2f294f7bc71baea52433bc24dde6f2a968ddd,1,1,0,1,1,2012-06-06 19:56:34,2012-06-06 19:51:00
f0b2f294f7bc71baea52433bc24dde6f2a968ddd...16012c629f3352cff680124df1122a9ab3939f03,1,15,4,19,1,2012-06-06 19:56:34,2012-06-06 19:53:24
16012c629f3352cff680124df1122a9ab3939f03...4f7b2fb3681c1a567b8f313b44bbee059ccf2029,1,24,1,25,1,2012-06-06 19:56:34,2012-06-06 19:55:04
4f7b2fb3681c1a567b8f313b44bbee059ccf2029...3b952626471b80fb2a1309b44ae1d8bf8ac56011,1,15,3,18,3,2012-06-06 19:56:34,2012-06-06 19:55:13
3b952626471b80fb2a1309b44ae1d8bf8ac56011...9848ba541515fb459d1b266d2acbc9935057f80e,1,50,41,91,5,2012-06-06 19:56:34,2012-06-06 19:56:06
9848ba541515fb459d1b266d2acbc9935057f80e...f60f9a32257c9e9c08b204ae6a405932f1964108,4,37,3,40,7,2012-06-06 20:03:58,2012-05-30 19:05:42
f60f9a32257c9e9c08b204ae6a405932f1964108...27501514d1b9a938f50441691819fd8968d0cf3b,1,1,1,2,1,2012-06-06 20:35:17,2012-06-06 18:58:59
27501514d1b9a938f50441691819fd8968d0cf3b...c0016bd4f852a13740be5ab05743b92d954b5c28,1,4,2,6,1,2012-06-06 21:19:20,2012-06-06 20:50:23
c0016bd4f852a13740be5ab05743b92d954b5c28...fa19fb21f892677c1e8ff26ee3839a8b00be56a1,1,8,11,19,3,2012-06-06 21:19:20,2012-06-06 21:19:08
fa19fb21f892677c1e8ff26ee3839a8b00be56a1...35555727b51aadfb1fc2ce7ec741eac742ee1b17,1,17,2,19,4,2012-06-06 21:43:53,2012-06-06 18:55:02
35555727b51aadfb1fc2ce7ec741eac742ee1b17...cc8310563189736f6baf57f95102b0370eb8da2c,4,63,129,192,26,2012-06-06 23:05:33,2012-05-28 16:35:45
cc8310563189736f6baf57f95102b0370eb8da2c...b2c99f16345d64b3f165d1338e484c3fcac5ff29,5,125,31,156,36,2012-06-06 23:07:16,2012-06-06 23:07:16
b2c99f16345d64b3f165d1338e484c3fcac5ff29...a655e0e5968eea448ac5c2b2eed50c56e7500e6c,3,5,3,8,3,2012-06-06 23:07:27,2012-06-06 22:14:43
a655e0e5968eea448ac5c2b2eed50c56e7500e6c...8bed868653a503c91f33e591965fe910afbfa64a,9,171,24,195,29,2012-06-06 23:07:31,2012-05-28 18:06:48
8bed868653a503c91f33e591965fe910afbfa64a...68cd2ddd79c416ddeef450a57b48cdf80c789720,1,3,0,3,1,2012-06-07 01:38:44,2012-06-07 01:38:44
68cd2ddd79c416ddeef450a57b48cdf80c789720...11076998213e0cdfdf156f82c7f52c32560d15da,1,3,0,3,1,2012-06-07 02:20:41,2012-06-07 02:20:41
11076998213e0cdfdf156f82c7f52c32560d15da...285360d3c6d8e3d3d7c684b1cca64d59f947d8fe,3,270,51,321,5,2012-06-07 02:34:24,2012-06-06 13:51:51
285360d3c6d8e3d3d7c684b1cca64d59f947d8fe...1c3be5814406e3a03afc8cbdaa3ebe8814013271,1,4,2,6,3,2012-06-07 03:28:19,2012-06-06 23:06:23
1c3be5814406e3a03afc8cbdaa3ebe8814013271...9bb422bbce703da9913d807123480f00908de075,5,22,98,120,15,2012-06-07 03:28:19,2012-06-05 21:34:43
9bb422bbce703da9913d807123480f00908de075...140fadcc3ef548e1d547ec20d79e17cd82dead04,1,4,4,8,4,2012-06-07 03:30:12,2012-06-07 03:29:52
140fadcc3ef548e1d547ec20d79e17cd82dead04...9af1f00e6d9b7696cb78460885ece9fd790dcee9,8,144,0,144,13,2012-06-07 07:50:37,2012-06-07 07:50:37
9af1f00e6d9b7696cb78460885ece9fd790dcee9...5e41dd2b7bde5cfb48e9e90817aa76348d08b14c,8,44,21,65,18,2012-06-07 12:54:22,2012-06-06 20:25:07
5e41dd2b7bde5cfb48e9e90817aa76348d08b14c...b46ec68eb5c78ae645f31016c956720fe98dcc12,1,38,12,50,9,2012-06-07 13:23:33,2012-06-05 18:50:28
b46ec68eb5c78ae645f31016c956720fe98dcc12...f95ee0bea2636a42d451d904672666f7726fdb1c,4,405,3,408,7,2012-06-07 13:47:31,2012-06-06 15:07:53
f95ee0bea2636a42d451d904672666f7726fdb1c...a584a0900ec7e1b203491b9bdda04efedb8ff6bd,1,3,1,4,1,2012-06-07 14:15:30,2012-06-07 14:15:30
a584a0900ec7e1b203491b9bdda04efedb8ff6bd...5d0285f42e7161376b8e46233294fa5da6553ecf,1,1,1,2,1,2012-06-07 14:23:29,2012-06-07 14:22:26
5d0285f42e7161376b8e46233294fa5da6553ecf...79011cd076f2b319d056440a282dc0c348a7fa41,1,2,1,3,2,2012-06-07 15:34:14,2012-06-07 15:34:05
79011cd076f2b319d056440a282dc0c348a7fa41...d00925cb37e3f8dd134d7e71a86e98b7158d714f,1,2,1,3,1,2012-06-07 15:58:24,2012-06-07 15:58:09
d00925cb37e3f8dd134d7e71a86e98b7158d714f...9c26b81edd9bfaf4b61e49333141bc9c851e6e74,1,3,0,3,1,2012-06-07 16:23:53,2012-06-07 16:23:53
9c26b81edd9bfaf4b61e49333141bc9c851e6e74...171b237832b7f5422b9dce7ce9130d523192abb0,1,17,7,24,11,2012-06-07 17:05:23,2012-06-06 20:37:34
171b237832b7f5422b9dce7ce9130d523192abb0...27fe29cefe90f46a99533209e606f9663f213530,1,74,41,115,33,2012-06-07 17:05:23,2012-06-07 14:22:51
27fe29cefe90f46a99533209e606f9663f213530...b5eab3d57098c48853b718ea98efa94c0b02843f,1,7,17,24,11,2012-06-07 17:09:35,2012-06-07 17:09:35
b5eab3d57098c48853b718ea98efa94c0b02843f...fb3dab498a111382df1dbfab99c8392c1b55822e,1,12,7,19,10,2012-06-07 17:11:18,2012-06-07 17:10:45
fb3dab498a111382df1dbfab99c8392c1b55822e...339a5fd026b593014a9589155935735347cdaa17,1,1,1,2,1,2012-06-07 17:20:00,2012-06-07 17:16:35
339a5fd026b593014a9589155935735347cdaa17...4c5319c46f492f00a39ded6f056151ec650abb54,1,7,12,19,10,2012-06-07 18:35:25,2012-06-07 18:35:25
4c5319c46f492f00a39ded6f056151ec650abb54...84aeb0ef2e6ce205853129199ff2656a44ea4b18,3,44,10,54,6,2012-06-07 18:46:34,2012-06-07 17:21:19
84aeb0ef2e6ce205853129199ff2656a44ea4b18...753c001845de3e51d007f99dce20ae5a04fa11d9,5,26,17,43,20,2012-06-07 19:41:30,2012-06-07 04:09:29
753c001845de3e51d007f99dce20ae5a04fa11d9...9c1139192172d8839be9b9ddcd37d655303a133d,2,22,15,37,4,2012-06-07 19:41:30,2012-05-02 20:03:37
9c1139192172d8839be9b9ddcd37d655303a133d...c42e156843c0b57a9ec19e44293d8739ea7698da,5,106,21,127,10,2012-06-07 20:55:08,2012-06-06 17:19:35
c42e156843c0b57a9ec19e44293d8739ea7698da...23b004a80dba68de6f7ad56e8d22dd0aa014a157,1,2,0,2,1,2012-06-07 22:02:56,2012-06-07 21:29:28
23b004a80dba68de6f7ad56e8d22dd0aa014a157...12bd69c8f652668fb7798691dbfdd3bc05a6bd8a,1,3,0,3,1,2012-06-07 22:02:56,2012-06-07 21:30:10
12bd69c8f652668fb7798691dbfdd3bc05a6bd8a...daeae64c40ae8ad030d21b4d2fd547bf67fac3b4,1,2,0,2,1,2012-06-07 22:02:56,2012-06-07 21:31:00
daeae64c40ae8ad030d21b4d2fd547bf67fac3b4...10c508566d0b90482644d23f1e37769f3537597b,3,24,0,24,3,2012-06-07 22:49:34,2012-06-07 22:49:34
10c508566d0b90482644d23f1e37769f3537597b...9e7c382aef5b696fe425a07ba7635e2051e85479,1,3,0,3,2,2012-06-07 22:50:04,2012-06-07 22:50:04
9e7c382aef5b696fe425a07ba7635e2051e85479...94f51ccf64f73e7bc711c1ab8f9d0ad062c2e006,1,46,1,47,2,2012-06-07 22:50:21,2012-06-07 22:50:21
94f51ccf64f73e7bc711c1ab8f9d0ad062c2e006...b8f243007335717179222237f315c8f62afd280f,5,20,10,30,8,2012-06-07 23:40:56,2012-06-07 20:45:46
b8f243007335717179222237f315c8f62afd280f...3db7b0e18e0babd6de23b48efd08c42bd17dbf4a,2,10,11,21,7,2012-06-07 23:40:56,2012-06-07 21:20:05
3db7b0e18e0babd6de23b48efd08c42bd17dbf4a...2914dfcaeba178002987678b29f0f0b064da80e5,3,29,17,46,13,2012-06-07 23:40:56,2012-06-07 21:20:51
2914dfcaeba178002987678b29f0f0b064da80e5...9ce898f9812b9493c19f3d7b729a61aadc7325c4,3,21,8,29,7,2012-06-07 23:44:23,2012-06-07 23:44:23
9ce898f9812b9493c19f3d7b729a61aadc7325c4...58189e7c1e46700a081b5b1c14f679fbc2edffdd,2,24,42,66,13,2012-06-08 00:16:32,2012-06-08 00:16:32
58189e7c1e46700a081b5b1c14f679fbc2edffdd...3db2a58dcbf890adc97da97091de32da7d63fb0f,2,3,2,5,2,2012-06-08 03:35:38,2012-06-07 23:27:42
3db2a58dcbf890adc97da97091de32da7d63fb0f...8a6d9952fb5a86e8604fcf806aa266b854ec18c5,1,17,17,34,13,2012-06-08 05:53:17,2012-06-08 05:53:17
8a6d9952fb5a86e8604fcf806aa266b854ec18c5...b46118ed7ab672188ce238b8eaceb4667d00af85,2,2,2,4,2,2012-06-08 06:06:24,2012-06-08 06:06:24
b46118ed7ab672188ce238b8eaceb4667d00af85...b43868a944d0d7964e5559ac5ba6baf798a7763c,1,7,0,7,1,2012-06-08 06:17:04,2012-06-08 06:17:04
b43868a944d0d7964e5559ac5ba6baf798a7763c...990f4171c2a25eeda3952029cc8d77a0420a8b92,4,79,0,79,4,2012-06-08 07:15:07,2012-06-08 06:59:43
990f4171c2a25eeda3952029cc8d77a0420a8b92...048f738b5b407097f5cecd93044bd62d631295bf,6,145,38,183,43,2012-06-08 07:31:57,2012-06-08 07:31:57
048f738b5b407097f5cecd93044bd62d631295bf...293a6244b8507f28c26a904f1e0be40b363c4138,3,0,82,82,3,2012-06-08 07:38:32,2012-06-08 07:38:32
293a6244b8507f28c26a904f1e0be40b363c4138...ba74fff122e7c7a4883ed0328d599bb20bd8bde4,4,0,16,16,8,2012-06-08 09:54:12,2012-06-08 09:54:12
ba74fff122e7c7a4883ed0328d599bb20bd8bde4...1776769915d653c5f5c33aa457bf8ea5163fba00,1,28,18,46,4,2012-06-08 14:31:58,2012-06-08 14:31:58
1776769915d653c5f5c33aa457bf8ea5163fba00...211656449f4402e803733eabd2ddba69def63acb,4,10,6,16,6,2012-06-08 16:08:29,2012-06-08 15:50:47
211656449f4402e803733eabd2ddba69def63acb...cf883e49794762eddb44f66277a06108ba15ea27,3,70,73,143,16,2012-06-08 18:17:35,2012-06-08 18:17:35
cf883e49794762eddb44f66277a06108ba15ea27...279cb83a6fc9382e8e355cb913cdbf14e08c9b51,1,0,3,3,1,2012-06-08 19:08:36,2012-06-08 19:08:36
279cb83a6fc9382e8e355cb913cdbf14e08c9b51...2c2e0fe57af35e4bfe6453298b16838a06529eea,3,29,3,32,6,2012-06-08 19:22:33,2012-06-08 19:22:33
2c2e0fe57af35e4bfe6453298b16838a06529eea...42cbf8e5bbfa0762c662a380cdb9bfb700808d5e,1,9,6,15,3,2012-06-08 19:59:56,2012-06-08 19:59:56
42cbf8e5bbfa0762c662a380cdb9bfb700808d5e...827bd4a9aa483bec4a0b1f237a6423c3b2489135,6,224,39,263,33,2012-06-08 20:12:15,2012-05-21 04:49:58
827bd4a9aa483bec4a0b1f237a6423c3b2489135...03e443e874e3e04de1f3ef87bc2aef629afbdaec,1,35,12,47,10,2012-06-08 20:12:16,2012-05-21 04:53:18
03e443e874e3e04de1f3ef87bc2aef629afbdaec...b5367c120d2bbf7432419bbf769628468c8d57fa,3,61,66,127,22,2012-06-08 20:12:16,2012-05-21 04:58:05
b5367c120d2bbf7432419bbf769628468c8d57fa...c2895e67e383fe6af4355454cbe363a0bd8487a0,7,408,42,450,45,2012-06-08 20:12:16,2012-05-21 05:02:20
c2895e67e383fe6af4355454cbe363a0bd8487a0...67a98ea6a8b8c099b6d89a25d8b828b49e6dedd1,1,0,92,92,1,2012-06-08 20:12:16,2012-06-04 23:31:38
67a98ea6a8b8c099b6d89a25d8b828b49e6dedd1...b0a992a951ba20ff56782769306c36e6df292bed,2,184,23,207,18,2012-06-08 20:12:16,2012-06-05 00:26:13
b0a992a951ba20ff56782769306c36e6df292bed...d5dd0299041af8858b89199d019dfdcc7c4ca8eb,3,15,5,20,5,2012-06-08 20:12:16,2012-06-05 00:33:12
d5dd0299041af8858b89199d019dfdcc7c4ca8eb...1fc1648c10942e44243d9c8f699fb27087cc1d6e,1,4,4,8,2,2012-06-08 20:12:17,2012-06-05 00:36:56
1fc1648c10942e44243d9c8f699fb27087cc1d6e...72853a054d26271cc10249a84f94aa5c6697c34f,1,9,12,21,3,2012-06-08 20:12:17,2012-06-05 00:39:57
72853a054d26271cc10249a84f94aa5c6697c34f...e14233f0213fd446381bbccdbf9b9c63b485c1c1,2,39,3,42,10,2012-06-08 20:12:17,2012-06-05 00:41:38
e14233f0213fd446381bbccdbf9b9c63b485c1c1...529820fd434192470a91ef1cd257ee58bb0e22a5,4,21,8,29,4,2012-06-08 20:12:17,2012-06-05 00:49:33
529820fd434192470a91ef1cd257ee58bb0e22a5...eb6e62a8eb28ec87f30dbaad0ffecee8f89d4e27,4,58,30,88,14,2012-06-08 20:12:17,2012-06-05 01:01:36
eb6e62a8eb28ec87f30dbaad0ffecee8f89d4e27...717f72638db7686e59c05405673a0e783ff2e600,1,4,1,5,2,2012-06-08 20:12:17,2012-06-05 01:03:45
717f72638db7686e59c05405673a0e783ff2e600...7b491d422e691365c84e5cb6d13a230c1bf307f4,2,2,2,4,2,2012-06-08 20:12:18,2012-06-08 17:03:49
7b491d422e691365c84e5cb6d13a230c1bf307f4...77b4827482d186a2f823267333ae684f9c358af7,2,4,163,167,4,2012-06-08 21:23:23,2012-06-08 19:16:13
77b4827482d186a2f823267333ae684f9c358af7...57f64fe508006d82b5af4c1460a938bfc4396331,1,1,0,1,1,2012-06-08 21:59:21,2012-06-08 21:37:38
57f64fe508006d82b5af4c1460a938bfc4396331...a0a9c81ca415f9c9b3c5e7bc2379a147d85e67dc,5,149,21,170,20,2012-06-09 02:40:30,2012-06-05 01:33:48
a0a9c81ca415f9c9b3c5e7bc2379a147d85e67dc...96b1b65dc66966fe8f17a30c5bde6036e2c8588d,2,40,20,60,4,2012-06-09 02:40:40,2012-06-05 14:14:08
96b1b65dc66966fe8f17a30c5bde6036e2c8588d...5390d21c7d997ba2447d8a0a58e95d208b5d4218,2,140,63,203,20,2012-06-09 02:40:46,2012-06-05 18:22:06
5390d21c7d997ba2447d8a0a58e95d208b5d4218...9494663f0ab571215dba96f10cdca78a1a36cddc,7,276,102,378,43,2012-06-09 02:40:52,2012-06-05 18:47:11
9494663f0ab571215dba96f10cdca78a1a36cddc...d7f89643a917538fa953a17d80acc164fb4885ad,8,158,58,216,30,2012-06-09 02:41:12,2012-06-05 19:36:19
d7f89643a917538fa953a17d80acc164fb4885ad...bc4475ebcb2548e21fadf44549b73f61f0c577ce,1,96,30,126,11,2012-06-09 02:41:22,2012-06-05 19:41:32
bc4475ebcb2548e21fadf44549b73f61f0c577ce...12f5147fef50060852881f65ab02f72a8bfebf3f,1,5,0,5,1,2012-06-09 02:41:53,2012-06-05 19:43:30
12f5147fef50060852881f65ab02f72a8bfebf3f...a65d2bc01f263ccefc1a7392f48b362338c83daf,2,92,2,94,2,2012-06-09 02:42:01,2012-06-07 21:53:00
a65d2bc01f263ccefc1a7392f48b362338c83daf...4c881e3c93ee29fa4ca22d9da7b7a45150448455,1,1,1,2,1,2012-06-09 02:42:16,2012-06-08 20:07:10
4c881e3c93ee29fa4ca22d9da7b7a45150448455...53f2e42ee37d870ef8f23976de52bf4e37480094,1,3,10,13,4,2012-06-09 02:42:16,2012-06-08 20:37:20
53f2e42ee37d870ef8f23976de52bf4e37480094...13aa0a0276eb239454da00d65f8f15aa1a97bb10,1,2,7,9,2,2012-06-09 02:42:16,2012-06-09 02:37:08
13aa0a0276eb239454da00d65f8f15aa1a97bb10...5de67f3238a631388eea6dc729c62e5c9f5537fd,2,4,0,4,2,2012-06-09 16:32:59,2012-06-09 16:32:59
5de67f3238a631388eea6dc729c62e5c9f5537fd...68775795d16f6a3854341f16d4cab32d1bc76830,5,79,27,106,16,2012-06-09 16:40:02,2012-06-05 04:31:33
68775795d16f6a3854341f16d4cab32d1bc76830...2b572b9c07d8d3feda949153e20b9eee8706ff7d,6,355,87,442,22,2012-06-09 16:40:02,2012-06-09 16:39:10
2b572b9c07d8d3feda949153e20b9eee8706ff7d...ab0bfed139f35ab5a3e1de7241ebfb5922faf2ee,8,116,102,218,89,2012-06-09 16:40:03,2012-06-06 21:56:45
ab0bfed139f35ab5a3e1de7241ebfb5922faf2ee...bb0fd337ac9498a5642986bba162880fa3030ce0,6,331,39,370,40,2012-06-09 16:40:03,2012-06-07 17:41:23
bb0fd337ac9498a5642986bba162880fa3030ce0...af775374ea8b2184cd4c311468c2f86338876d9c,1,18,0,18,2,2012-06-09 16:48:07,2012-06-08 23:58:39
af775374ea8b2184cd4c311468c2f86338876d9c...20fae4312bf08b06508c0897d71daf173266238e,2,0,4,4,2,2012-06-09 19:08:33,2012-06-09 19:08:33
20fae4312bf08b06508c0897d71daf173266238e...f1852efa8e4e5d702c472c35fb45d0a29a90d7d3,1,7,2,9,2,2012-06-09 19:08:43,2012-06-09 19:08:43
f1852efa8e4e5d702c472c35fb45d0a29a90d7d3...5ebe3b63d49130e410253a2d33e2ec209c741042,1,10,3,13,4,2012-06-09 19:08:46,2012-06-09 19:08:46
5ebe3b63d49130e410253a2d33e2ec209c741042...2deb6a2f1b457adc58436f11dd730d1fcc525084,1,1,1,2,1,2012-06-09 19:08:48,2012-06-09 19:08:48
2deb6a2f1b457adc58436f11dd730d1fcc525084...ccd568b6e292b4641f60c704ddf983240e8f23a4,2,2,92,94,2,2012-06-09 19:08:52,2012-06-09 19:08:52
ccd568b6e292b4641f60c704ddf983240e8f23a4...af40021dbeb849e0de8c3659509f36e5ea51ebf4,1,0,5,5,1,2012-06-09 19:08:55,2012-06-09 19:08:55
af40021dbeb849e0de8c3659509f36e5ea51ebf4...38a258f13283440eb3f19afbb653d872b04d0d98,1,30,96,126,11,2012-06-09 19:08:59,2012-06-09 19:08:59
38a258f13283440eb3f19afbb653d872b04d0d98...2e12c38432817131bfa463e763198436ac82d115,8,58,158,216,30,2012-06-09 19:09:01,2012-06-09 19:09:01
2e12c38432817131bfa463e763198436ac82d115...e123c445170548c0eb248dc1b221dfb09aa9b1ec,7,102,276,378,41,2012-06-09 19:09:04,2012-06-09 19:09:04
e123c445170548c0eb248dc1b221dfb09aa9b1ec...4e1b5c81b5b61d09c3b1e81ad663b61bb1857243,1,3,0,3,1,2012-06-10 00:12:54,2012-06-10 00:12:54
4e1b5c81b5b61d09c3b1e81ad663b61bb1857243...1c7dca59fbfd2b2f042e2745a1ee58f2c48760d8,3,18,2,20,4,2012-06-10 04:18:37,2012-06-10 04:18:37
1c7dca59fbfd2b2f042e2745a1ee58f2c48760d8...587e650de53c2e44abcf30bec38ba5e4995dda56,3,2,18,20,4,2012-06-10 05:20:37,2012-06-10 05:20:37
587e650de53c2e44abcf30bec38ba5e4995dda56...60feb24defa2cc85d82ac5e80be6bdf13521ef0b,3,14,17,31,6,2012-06-10 05:23:29,2012-06-10 05:23:29
60feb24defa2cc85d82ac5e80be6bdf13521ef0b...edbdfe32ce35e47b2fd11f7ca413353017f138c1,1,10,1,11,2,2012-06-10 13:53:23,2012-06-10 13:53:23
edbdfe32ce35e47b2fd11f7ca413353017f138c1...9a5324a03581753b7c1e7a66959d3c60e7ed7a85,3,51,28,79,21,2012-06-11 01:51:57,2012-06-11 01:51:57
9a5324a03581753b7c1e7a66959d3c60e7ed7a85...5b5dee6354a998da9c567b42a5153ef795085202,4,26,60,86,12,2012-06-11 15:40:18,2012-06-11 15:40:18
5b5dee6354a998da9c567b42a5153ef795085202...fd5eb17c32cbbf4a639ed930a658609f3b8a2211,3,25,18,43,6,2012-06-11 16:04:56,2012-06-11 15:51:20
fd5eb17c32cbbf4a639ed930a658609f3b8a2211...936c03f4adab997257057458a9cb730753712d8a,2,123,51,174,12,2012-06-11 16:10:05,2012-06-11 13:56:07
936c03f4adab997257057458a9cb730753712d8a...e8f0424f33455017086b2c986fdb572c4cad2dbd,7,276,102,378,43,2012-06-11 16:45:05,2012-06-11 16:45:05
e8f0424f33455017086b2c986fdb572c4cad2dbd...74d284ac1cbd4ce36d0396d7c6ac18821aba1fa2,8,158,58,216,30,2012-06-11 16:45:34,2012-06-11 16:45:34
74d284ac1cbd4ce36d0396d7c6ac18821aba1fa2...ec289d975679f18661f191776b1fca8d0bf4b14d,1,96,30,126,11,2012-06-11 16:46:00,2012-06-11 16:46:00
ec289d975679f18661f191776b1fca8d0bf4b14d...4c85d369b96007f54abd0110357783fcfae71a27,1,5,0,5,1,2012-06-11 16:46:51,2012-06-11 16:46:51
4c85d369b96007f54abd0110357783fcfae71a27...5283419448b2251d20a6e0e084c5fb70c4b6bd49,2,92,2,94,2,2012-06-11 16:47:11,2012-06-11 16:47:11
5283419448b2251d20a6e0e084c5fb70c4b6bd49...c11ff4259ba77a037afb075786e3f3fec92c5a33,1,1,1,2,1,2012-06-11 16:48:05,2012-06-11 16:48:05
c11ff4259ba77a037afb075786e3f3fec92c5a33...41d4d2731b0f6e18127a6274370e24cf90d19b85,1,3,10,13,4,2012-06-11 16:48:26,2012-06-11 16:48:26
41d4d2731b0f6e18127a6274370e24cf90d19b85...66eb52c108d9d91fed9e2bfffe52b28e4418aea3,1,2,7,9,2,2012-06-11 16:48:46,2012-06-11 16:48:46
66eb52c108d9d91fed9e2bfffe52b28e4418aea3...629e6583fa56b5689fb80192896a050e85f3edba,3,79,2,81,6,2012-06-11 17:10:16,2012-06-08 16:50:06
629e6583fa56b5689fb80192896a050e85f3edba...1f02c2d4f3350cea1f28a889283c25083b6bcf4e,1,6,1,7,1,2012-06-11 18:40:55,2012-06-11 18:40:21
1f02c2d4f3350cea1f28a889283c25083b6bcf4e...d27fa2fd6b121916a804cd61cbde806fb6a22e8a,4,628,5,633,13,2012-06-11 19:41:42,2012-06-08 17:31:22
d27fa2fd6b121916a804cd61cbde806fb6a22e8a...11da8181ead847d3a48e7953a18bdb4e1f347ae9,2,71,4,75,2,2012-06-11 20:25:23,2012-06-11 16:58:46
11da8181ead847d3a48e7953a18bdb4e1f347ae9...701df8345f2f7bdf254c56f6f490df787ac03752,2,19,4,23,3,2012-06-11 20:25:24,2012-06-11 16:59:58
701df8345f2f7bdf254c56f6f490df787ac03752...88100232912f0b9af6a01f454072ed723f3c830e,1,109,75,184,27,2012-06-11 20:25:24,2012-06-11 20:23:58
88100232912f0b9af6a01f454072ed723f3c830e...edf51280e9df73508cbff3faaf02f091b68e6d8b,2,27,5,32,6,2012-06-11 22:15:57,2012-06-04 22:21:40
edf51280e9df73508cbff3faaf02f091b68e6d8b...114dd3225eec57aeb27f00ad7877a4c14a38c68c,1,1,1,2,1,2012-06-11 22:23:55,2012-06-11 22:23:55
114dd3225eec57aeb27f00ad7877a4c14a38c68c...b5661e1cc5cc2278aa9bd13de7e031ce02fe6d83,1,4,1,5,4,2012-06-12 05:50:04,2012-06-10 22:42:30
b5661e1cc5cc2278aa9bd13de7e031ce02fe6d83...fe9822e8d65948060f29fcc86349144877f376b2,1,1,3,4,1,2012-06-12 05:50:04,2012-06-12 05:49:19
fe9822e8d65948060f29fcc86349144877f376b2...79c71a1028ddf4e2dcc6cfb086c410d1248b6df3,2,2,2,4,2,2012-06-12 05:52:26,2012-06-11 13:55:14
79c71a1028ddf4e2dcc6cfb086c410d1248b6df3...5569a64a41a0f07860acf21bf0c6c2c531de1fc3,1,75,45,120,5,2012-06-12 05:52:26,2012-06-11 13:59:00
5569a64a41a0f07860acf21bf0c6c2c531de1fc3...68a8f8a93c835a449206709289b4a039b022bc6a,1,6,4,10,3,2012-06-12 05:52:26,2012-06-11 14:01:17
68a8f8a93c835a449206709289b4a039b022bc6a...aaa79d47de287720c9d55943d4c29fbef2e54d9e,1,10,4,14,5,2012-06-12 05:52:26,2012-06-11 15:03:35
aaa79d47de287720c9d55943d4c29fbef2e54d9e...871a8feda497650c3a13dfb53a58108b9e51bc20,4,22,17,39,11,2012-06-12 05:52:26,2012-06-11 15:38:42
871a8feda497650c3a13dfb53a58108b9e51bc20...ea5f7a757789ba0ddaf9dfcab4fac8ab4050ae43,1,134,78,212,24,2012-06-12 05:52:26,2012-06-12 03:44:02
ea5f7a757789ba0ddaf9dfcab4fac8ab4050ae43...f58ba6e38cb3e3f62d6cbacdfd646364b005a17e,15,223,193,416,100,2012-06-12 05:52:26,2012-06-12 04:49:13
f58ba6e38cb3e3f62d6cbacdfd646364b005a17e...efdd6fa2b146b17f2e86eefe95e517561b1169c0,1,2,2,4,3,2012-06-12 05:52:26,2012-06-12 05:15:18
efdd6fa2b146b17f2e86eefe95e517561b1169c0...a0bb40436fc96a1c9d1f3360d48d82952085dc06,9,4,81,85,13,2012-06-12 05:52:26,2012-06-12 05:15:29
a0bb40436fc96a1c9d1f3360d48d82952085dc06...d2a281541fc52b5607859ad1f0405e23031ad072,1,6,1,7,4,2012-06-12 05:52:27,2012-06-12 05:52:03
d2a281541fc52b5607859ad1f0405e23031ad072...1a3a69d8b9358d67cf219ea66b1fe2078bd7cbb8,1,0,1,1,1,2012-06-12 06:13:07,2012-06-12 06:13:07
1a3a69d8b9358d67cf219ea66b1fe2078bd7cbb8...16aedcce6cb912bb2459b4316fcf54f370466536,1,42,42,84,4,2012-06-12 11:50:39,2012-06-12 11:50:39
16aedcce6cb912bb2459b4316fcf54f370466536...c2ce73b66eef5c47fca71b3a0d1608b07c58c63e,2,9,8,17,8,2012-06-12 11:57:38,2012-06-12 11:57:38
c2ce73b66eef5c47fca71b3a0d1608b07c58c63e...2a9e8882d54b58ee13fba7c38753e5430e15af6a,1,1,1,2,1,2012-06-12 13:11:54,2012-06-12 09:32:53
2a9e8882d54b58ee13fba7c38753e5430e15af6a...21d62332b014389af4636ec81b51d7e3a3152081,1,12,1,13,2,2012-06-12 13:43:35,2012-06-12 13:04:42
21d62332b014389af4636ec81b51d7e3a3152081...32f3e9a4d2f627c56094e6cc1dc3b5ab8cda4171,2,9,1,10,2,2012-06-12 15:10:27,2012-06-12 15:10:02
32f3e9a4d2f627c56094e6cc1dc3b5ab8cda4171...d011b4283cbd43d2e45fe062c385baff173a15bb,8,61,9,70,18,2012-06-12 15:29:49,2012-06-12 15:29:49
d011b4283cbd43d2e45fe062c385baff173a15bb...72e7302efc3a87b33ac5b833d3cc21087648fa00,1,4,1,5,2,2012-06-12 16:14:29,2012-06-12 16:13:02
72e7302efc3a87b33ac5b833d3cc21087648fa00...4af8516d396ab23c755ce97b4dba6cf649b9d4e8,3,277,4,281,9,2012-06-12 17:38:19,2012-06-07 17:13:52
4af8516d396ab23c755ce97b4dba6cf649b9d4e8...85f7ff2b8ae4555bdf4531bb8805f852286069c7,1,1,0,1,1,2012-06-12 17:57:32,2012-06-12 17:24:02
85f7ff2b8ae4555bdf4531bb8805f852286069c7...661790cc272929dd698e2c5a5679f47ea3cf1ea8,4,79,12,91,13,2012-06-12 17:57:32,2012-06-12 17:54:17
661790cc272929dd698e2c5a5679f47ea3cf1ea8...76ab87d23347fdd841624d8f15687f898647816a,5,13,10,23,12,2012-06-12 17:57:32,2012-06-12 17:57:14
76ab87d23347fdd841624d8f15687f898647816a...1f59c1d8d8ee4481c881a31ae3aebd0dbcd16fca,1,0,37,37,7,2012-06-12 17:59:11,2012-05-27 20:37:17
1f59c1d8d8ee4481c881a31ae3aebd0dbcd16fca...40a00a7595606e850af4c5b4734bfa850b8342ff,1,6,7,13,7,2012-06-12 18:19:42,2012-06-12 16:34:14
40a00a7595606e850af4c5b4734bfa850b8342ff...675ddf06b7f64188f2ac753bf01ec77145f6e459,15,130,42,172,41,2012-06-12 18:52:24,2012-06-12 18:43:33
675ddf06b7f64188f2ac753bf01ec77145f6e459...a08fda2923682973b26db2784af709b6e0585103,2,56,3,59,3,2012-06-12 18:59:41,2012-06-11 20:33:01
a08fda2923682973b26db2784af709b6e0585103...17ffcb08ac1d62ce8cd4296f5a42850abb070a22,1,25,4,29,7,2012-06-12 18:59:41,2012-06-11 20:34:20
17ffcb08ac1d62ce8cd4296f5a42850abb070a22...26411490539e1c3a6a3cac9bec8a7ef5a164ff95,1,2,2,4,2,2012-06-12 19:24:32,2012-06-12 19:24:32
26411490539e1c3a6a3cac9bec8a7ef5a164ff95...43a21549e7f80042a79adc2e55787a13f44787b6,1,28,7,35,13,2012-06-12 19:45:55,2012-06-12 19:07:06
43a21549e7f80042a79adc2e55787a13f44787b6...b841f84e8a6106027b996f1a1ab1cbbf2854cf01,1,4,4,8,4,2012-06-12 19:45:55,2012-06-12 19:07:23
b841f84e8a6106027b996f1a1ab1cbbf2854cf01...058b56c391c8b5892b9d8d366a9cf70863ea6a36,1,2,1,3,1,2012-06-12 19:48:27,2012-06-12 17:26:31
058b56c391c8b5892b9d8d366a9cf70863ea6a36...665c1cfeac637465bb4ed8d24b7b76cec835fbea,1,2,2,4,1,2012-06-12 19:53:35,2012-06-12 19:53:35
665c1cfeac637465bb4ed8d24b7b76cec835fbea...9ab21eeb9443c41455a18f3ff7016166a16a6425,10,350,56,406,64,2012-06-12 20:51:25,2012-03-26 18:31:33
9ab21eeb9443c41455a18f3ff7016166a16a6425...8c5c4ce733e8d49e5940be377628144f768b0734,1,2,1,3,1,2012-06-12 21:29:06,2012-06-12 21:27:21
8c5c4ce733e8d49e5940be377628144f768b0734...cdabc02ec2144d1dcbfff49199121181af77a22c,3,139,87,226,23,2012-06-12 21:38:54,2012-06-12 21:37:27
cdabc02ec2144d1dcbfff49199121181af77a22c...ab4fa8f8056f779d6facb3269bb85430aea58155,1,2,1,3,1,2012-06-12 23:06:59,2012-06-12 23:06:47
ab4fa8f8056f779d6facb3269bb85430aea58155...490eb9671455c6137c67cf7c45369fa9ddde2271,1,79,0,79,2,2012-06-13 01:57:26,2012-06-13 01:57:03
490eb9671455c6137c67cf7c45369fa9ddde2271...cac29a48c7965a633e68f8d4af788fce9ffbdd72,2,19,12,31,7,2012-06-13 01:57:26,2012-06-13 01:54:21
cac29a48c7965a633e68f8d4af788fce9ffbdd72...bbc3ee201c0cd0a01d15c486ddfba0fb353f46e9,2,3,3,6,3,2012-06-13 02:24:37,2012-06-13 02:24:37
bbc3ee201c0cd0a01d15c486ddfba0fb353f46e9...86bc0d2c3d6a820776fd093f9473e700ffbb2982,1,0,33,33,2,2012-06-13 04:01:20,2012-06-13 03:25:05
86bc0d2c3d6a820776fd093f9473e700ffbb2982...43d4ee8b3bf5dabec8ec726c88f9704994cfd1ba,1,6,5,11,2,2012-06-13 04:01:20,2012-06-13 03:57:08
43d4ee8b3bf5dabec8ec726c88f9704994cfd1ba...daa210b1e676db4cfd1e5780e63861269ef30881,1,1,3,4,2,2012-06-13 04:01:20,2012-06-13 03:57:43
daa210b1e676db4cfd1e5780e63861269ef30881...fe8816c7644eb1c89c7dce43083abb0d7c65c41c,4,48,0,48,5,2012-06-13 04:01:20,2012-06-13 03:59:44
fe8816c7644eb1c89c7dce43083abb0d7c65c41c...e55e9b51215712123994d00036e6e6179a03c821,1,1,1,2,1,2012-06-13 12:23:53,2012-06-13 12:23:53
e55e9b51215712123994d00036e6e6179a03c821...163a2d64ee88f7a4efb604f6208578ef117c4bc3,1,14,8,22,4,2012-06-13 13:31:48,2012-06-13 13:31:48
163a2d64ee88f7a4efb604f6208578ef117c4bc3...70546ba57409051eeef817304955a411f46b763b,5,83,36,119,15,2012-06-13 17:28:16,2012-06-13 09:03:21
70546ba57409051eeef817304955a411f46b763b...4383b3de114404a485d3ad91110ea0fbff2c7790,1,11,0,11,1,2012-06-13 19:13:13,2012-06-13 16:57:43
4383b3de114404a485d3ad91110ea0fbff2c7790...65a908408782dd34424206084029f28222e984ed,1,2,4,6,1,2012-06-13 19:13:13,2012-06-13 17:06:24
65a908408782dd34424206084029f28222e984ed...d5d9725f43b0deeeeb90b09fc2d0b53a88d8127c,1,4,1,5,2,2012-06-13 19:13:13,2012-06-13 17:10:56
d5d9725f43b0deeeeb90b09fc2d0b53a88d8127c...a041d4d61ae075a46cc17a1929be8eedd6586525,1,4,0,4,2,2012-06-13 19:13:13,2012-06-13 19:13:06
a041d4d61ae075a46cc17a1929be8eedd6586525...57058157c96c24336089c96ff2dd19e5bf1519b3,2,27,20,47,14,2012-06-13 19:14:35,2012-06-13 15:01:37
57058157c96c24336089c96ff2dd19e5bf1519b3...4778d51c02fbbcb0d9ded0440320ac19cec156f3,6,34,34,68,21,2012-06-13 19:24:31,2012-06-13 17:04:30
4778d51c02fbbcb0d9ded0440320ac19cec156f3...002f57193d41f0b8499245958653aa599699b93d,10,43,53,96,24,2012-06-13 19:24:31,2012-06-13 17:13:15
002f57193d41f0b8499245958653aa599699b93d...be32f9f467972ffd2e9f37e244c09f88d354faf0,1,12,2,14,1,2012-06-13 19:24:31,2012-06-13 18:34:36
be32f9f467972ffd2e9f37e244c09f88d354faf0...2111a63b4e36225c47dab62a69cfbe411b70f16c,4,52,81,133,28,2012-06-13 19:24:31,2012-06-13 18:34:55
2111a63b4e36225c47dab62a69cfbe411b70f16c...fc7a84dd03e2d950a719cbadd72c53c6d1e53e79,1,1,0,1,1,2012-06-13 19:24:31,2012-06-13 18:45:49
fc7a84dd03e2d950a719cbadd72c53c6d1e53e79...7add28460bf2aefef4f5e7d91804b028d9634a80,1,1,0,1,1,2012-06-13 19:24:31,2012-06-13 18:46:02
7add28460bf2aefef4f5e7d91804b028d9634a80...652d8ba4fd86daf5fec272bc960e9c1a7e4e6c67,1,0,8,8,1,2012-06-13 19:24:31,2012-06-13 19:24:09
652d8ba4fd86daf5fec272bc960e9c1a7e4e6c67...8203059e99b52a88f37d23a6221a6687876ead2f,1,3,2,5,3,2012-06-13 19:24:31,2012-06-13 19:24:22
8203059e99b52a88f37d23a6221a6687876ead2f...b6e94fc4eae8c805672cc6c6f8f9338576e2a2ce,1,9,0,9,2,2012-06-13 20:03:59,2012-06-13 20:02:51
b6e94fc4eae8c805672cc6c6f8f9338576e2a2ce...39031a8d3909b1d85b45b60655cb1dd7c226ad96,1,1,1,2,1,2012-06-13 20:30:09,2012-06-11 14:35:52
39031a8d3909b1d85b45b60655cb1dd7c226ad96...89fc01bee31cf4812a737123a755ed79452ed2db,5,57,50,107,35,2012-06-13 20:33:30,2012-06-13 19:43:37
89fc01bee31cf4812a737123a755ed79452ed2db...b058a65565045c5e16ae64b78bf257fb658a2951,1,0,17,17,2,2012-06-13 21:46:08,2012-06-13 21:46:08
b058a65565045c5e16ae64b78bf257fb658a2951...2fa9ed2b53890824bc99d130593982a585441a00,1,0,2,2,1,2012-06-13 21:46:56,2012-06-13 21:46:56
2fa9ed2b53890824bc99d130593982a585441a00...0729e02da009429683b791949e7c2a2912f2428c,1,5,3,8,5,2012-06-13 21:49:53,2012-06-13 21:49:53
0729e02da009429683b791949e7c2a2912f2428c...87f77f7efdbf1924fdca06c6de77886af9633e4f,2,18,16,34,6,2012-06-13 21:50:03,2012-06-13 21:50:03
87f77f7efdbf1924fdca06c6de77886af9633e4f...9f04fc794002cece8961306c60db3884da64f818,1,3,0,3,1,2012-06-13 21:59:36,2012-06-13 21:59:36
9f04fc794002cece8961306c60db3884da64f818...f710e51faa3085fe879e39717bc2f160bcb9ecd9,1,2,1,3,2,2012-06-13 22:35:29,2012-06-11 20:28:11
f710e51faa3085fe879e39717bc2f160bcb9ecd9...a5899a16df9ca29e73b3d3040437d3e9d4d0bf49,2,172,0,172,2,2012-06-13 22:36:17,2012-06-11 20:28:55
a5899a16df9ca29e73b3d3040437d3e9d4d0bf49...497caa1edc3e1cacdb675b50b68159f4f2364748,2,4,7,11,3,2012-06-13 22:42:27,2012-06-13 19:01:07
497caa1edc3e1cacdb675b50b68159f4f2364748...60c041e473b59e9451da79ac32b9f1cd2c686b28,5,160,176,336,48,2012-06-13 23:04:56,2012-06-13 22:24:54
60c041e473b59e9451da79ac32b9f1cd2c686b28...79595b9b6871a96c71898ec56a9c8bfc7f6e6216,2,25,13,38,7,2012-06-13 23:21:42,2012-06-12 20:18:52
79595b9b6871a96c71898ec56a9c8bfc7f6e6216...4d787f2622a2d99b7e85d8768546d9ff428bba18,8,668,170,838,114,2012-06-13 23:21:42,2012-06-13 22:38:16
4d787f2622a2d99b7e85d8768546d9ff428bba18...b3933459dedfd8dbd68f3ac284d50cba0504e75d,1,0,15,15,1,2012-06-14 02:57:30,2012-06-14 02:57:30
b3933459dedfd8dbd68f3ac284d50cba0504e75d...cd37e19333d65dae40e019d57a089c277ddc5db3,5,100,97,197,28,2012-06-14 03:05:22,2012-06-14 03:05:22
cd37e19333d65dae40e019d57a089c277ddc5db3...69207de5e627c50231f297f390d9b79eec267173,4,34,11,45,9,2012-06-14 03:16:11,2012-06-14 03:16:11
69207de5e627c50231f297f390d9b79eec267173...add7dc54daafacc914f8fdfa442e0d7af6988412,1,1,1,2,1,2012-06-14 13:44:05,2012-06-14 13:43:34
add7dc54daafacc914f8fdfa442e0d7af6988412...ca5557fde09a9c6302f501998527d17d5acd6252,1,2,2,4,2,2012-06-14 14:16:32,2012-06-14 14:16:32
ca5557fde09a9c6302f501998527d17d5acd6252...236c41c7766eb4d24716b4b24fd8b76bc6ebc79d,5,259,138,397,30,2012-06-14 16:56:26,2012-06-14 16:54:02
236c41c7766eb4d24716b4b24fd8b76bc6ebc79d...18f345f2edff28870b301334ebc840595ed2c043,1,1,1,2,1,2012-06-14 18:59:30,2012-06-14 18:34:54
18f345f2edff28870b301334ebc840595ed2c043...953d3f82031680c867c2e95f1ad087de9f728639,1,0,17,17,1,2012-06-14 19:28:39,2012-06-14 19:28:39
953d3f82031680c867c2e95f1ad087de9f728639...767c0103205728993d735bcbf9e77332ecf05ef1,1,14,0,14,1,2012-06-14 19:48:49,2012-06-14 19:48:11
767c0103205728993d735bcbf9e77332ecf05ef1...9ab72cc8172638d6e3245131ddc271b5fa488b8e,1,3,0,3,3,2012-06-14 20:04:16,2012-06-14 20:04:02
9ab72cc8172638d6e3245131ddc271b5fa488b8e...ed9a76d07c6064718c4ac1945a8d10cede9e200a,1,24,18,42,11,2012-06-14 20:10:22,2012-06-12 21:00:38
ed9a76d07c6064718c4ac1945a8d10cede9e200a...2526e86329dd6ceb73a17318fbb7172ea77a4098,1,1,0,1,1,2012-06-14 21:22:05,2012-06-14 21:20:50
2526e86329dd6ceb73a17318fbb7172ea77a4098...93c8997b3df1492a90ec41b97ec3193c49f460d5,4,20,2,22,4,2012-06-14 23:53:35,2012-06-12 15:25:46
93c8997b3df1492a90ec41b97ec3193c49f460d5...fb39d83af2eb58385940b5b4eb7744afac1775a2,1,1,0,1,1,2012-06-15 00:26:12,2012-06-15 00:26:12
fb39d83af2eb58385940b5b4eb7744afac1775a2...fc41c4af9c054f3db6e86fc7c0eee7870bba127c,3,184,6,190,11,2012-06-15 01:58:38,2012-06-14 15:35:04
fc41c4af9c054f3db6e86fc7c0eee7870bba127c...f507f8b932a358230d41ae1d2b7c77eb03f2b5b9,2,41,66,107,11,2012-06-15 01:58:38,2012-06-14 17:45:15
f507f8b932a358230d41ae1d2b7c77eb03f2b5b9...2232e2c308aac8722e8e77925db33aedb68e021e,2,4,3,7,4,2012-06-15 01:58:38,2012-06-14 17:54:39
2232e2c308aac8722e8e77925db33aedb68e021e...76e8d89b5ca79fdb6033c5663cf14a9cf60f7484,3,190,14,204,24,2012-06-15 01:58:38,2012-06-14 19:40:26
76e8d89b5ca79fdb6033c5663cf14a9cf60f7484...f975fac3887e405eb41452a69ad5be9b1a74ae90,3,202,174,376,52,2012-06-15 01:58:39,2012-06-15 01:57:35
f975fac3887e405eb41452a69ad5be9b1a74ae90...fd8471474acc02f69e60dc73caedf53edc39690a,1,3,1,4,1,2012-06-15 02:16:06,2012-06-15 02:16:06
fd8471474acc02f69e60dc73caedf53edc39690a...b62ea5f5eb0107fe3f50275dda6ee5ffd05be1bb,1,8,7,15,4,2012-06-15 02:28:12,2012-06-15 02:28:12
b62ea5f5eb0107fe3f50275dda6ee5ffd05be1bb...fb66c84bc7bc1ece63a65766bfea2f797f3b7121,10,455,54,509,59,2012-06-15 05:43:20,2012-06-15 05:43:20
fb66c84bc7bc1ece63a65766bfea2f797f3b7121...f9ec6b8c2da49235cc61d2211b25e0a7500d0d17,10,100,14,114,26,2012-06-15 16:39:16,2012-06-15 16:38:48
f9ec6b8c2da49235cc61d2211b25e0a7500d0d17...51222ca1bb0a7464bfe2039545e9e91b8f6e6c81,1,1,1,2,1,2012-06-15 17:47:42,2012-06-15 17:47:32
51222ca1bb0a7464bfe2039545e9e91b8f6e6c81...6edd4d75b3d661e8e447869cdb91931c4ae82f62,4,163,0,163,5,2012-06-15 18:17:11,2012-06-11 16:28:21
6edd4d75b3d661e8e447869cdb91931c4ae82f62...dc39b4ee2a53aa47849f8e4b0c91df2c86ec7228,1,4,17,21,4,2012-06-15 19:42:46,2012-06-15 15:47:39
dc39b4ee2a53aa47849f8e4b0c91df2c86ec7228...7d7a99c936fa25768c2d267ddf7142beee274822,1,8,3,11,2,2012-06-15 20:00:38,2012-06-15 20:00:24
7d7a99c936fa25768c2d267ddf7142beee274822...bf3176051959030ec5785385f007eaee970b08c2,1,53,34,87,21,2012-06-15 21:07:04,2012-06-15 20:06:26
bf3176051959030ec5785385f007eaee970b08c2...b3c3f37dba8102222462cbd3f7406efdf32f54d9,4,20,14,34,6,2012-06-15 21:07:04,2012-06-15 20:17:50
b3c3f37dba8102222462cbd3f7406efdf32f54d9...14f33c4ec4c5785726195224dfd993140de5c158,1,16,4,20,2,2012-06-15 22:12:39,2012-06-15 17:02:32
14f33c4ec4c5785726195224dfd993140de5c158...a289a4809b140c5a24f60b97872d3e68602536a9,1,1,1,2,1,2012-06-15 22:12:39,2012-06-15 17:02:50
a289a4809b140c5a24f60b97872d3e68602536a9...297b940ee79fbba5fa2dd9c15a3af4eb9e87a6d0,3,53,5,58,6,2012-06-15 22:12:39,2012-06-15 19:22:54
297b940ee79fbba5fa2dd9c15a3af4eb9e87a6d0...9d1e4289ddf669a9a4ac6fcfa06cf56ed2f5c81e,3,44,13,57,6,2012-06-15 22:12:39,2012-06-15 21:23:37
9d1e4289ddf669a9a4ac6fcfa06cf56ed2f5c81e...8cb54a63e154cec11f1b07ab124e762c3d0d9dff,4,48,9,57,5,2012-06-15 22:12:39,2012-06-15 22:12:20
8cb54a63e154cec11f1b07ab124e762c3d0d9dff...372ef0946ff5dae940ebc518c85bdbd6338535cf,3,11,32,43,8,2012-06-15 22:33:00,2012-06-15 22:04:27
372ef0946ff5dae940ebc518c85bdbd6338535cf...064aadf45486b3be622cf7973f2cbadc6eac3e9c,1,2,1,3,2,2012-06-16 16:09:01,2012-06-16 16:09:01
064aadf45486b3be622cf7973f2cbadc6eac3e9c...b10b632db5f2d1e86e9f1f125c7a799f8f94720f,29,288,73,361,64,2012-06-16 17:22:30,2012-06-14 01:18:39
b10b632db5f2d1e86e9f1f125c7a799f8f94720f...1cadf6580c97c760bf6e8403b7a81e7f6f671fb8,4,59,1,60,6,2012-06-16 17:22:30,2012-06-14 20:55:35
1cadf6580c97c760bf6e8403b7a81e7f6f671fb8...8eb8e0025d4aa22e7ea43859512619843a50158a,2,227,0,227,2,2012-06-16 17:22:30,2012-06-11 18:32:28
8eb8e0025d4aa22e7ea43859512619843a50158a...43cc27b3c580ff2412dd6e9253d965ac0b93002f,1,3,0,3,1,2012-06-16 21:28:23,2012-06-16 21:28:23
43cc27b3c580ff2412dd6e9253d965ac0b93002f...71c529acb6666d15636edbddef8578290b42ee36,1,1,1,2,2,2012-06-17 00:43:21,2012-06-17 00:43:21
71c529acb6666d15636edbddef8578290b42ee36...e9faeb930edfc3920fbcc4a0f06a491f348f1084,2,7,4,11,3,2012-06-17 01:04:35,2012-06-17 01:04:35
e9faeb930edfc3920fbcc4a0f06a491f348f1084...5b1214043101923f530ab291f5b1e7f93b9547f6,1,4,1,5,2,2012-06-17 01:30:31,2012-06-16 21:47:46
5b1214043101923f530ab291f5b1e7f93b9547f6...81099b05f705dd4f0061acf296ac32a7524cd813,1,1,1,2,1,2012-06-17 03:12:12,2012-06-17 03:12:12
81099b05f705dd4f0061acf296ac32a7524cd813...ef0e5ef75f6f11e4de7a3b31f760e06941b7ee28,1,3,1,4,3,2012-06-17 03:26:06,2012-06-17 03:26:06
ef0e5ef75f6f11e4de7a3b31f760e06941b7ee28...07537987f38f6058e362e40b6bcd18c5299b2b98,1,5,5,10,5,2012-06-17 03:33:18,2012-06-17 03:33:18
07537987f38f6058e362e40b6bcd18c5299b2b98...332d3c2060ae825a64542255603be8ee04bc7f72,2,8,3,11,3,2012-06-17 13:37:46,2012-06-17 13:37:46
332d3c2060ae825a64542255603be8ee04bc7f72...79a08e1d5b12952dc345c6fcdd7e9d4ffad7a8bf,6,37,28,65,22,2012-06-17 17:01:44,2012-06-17 17:01:44
79a08e1d5b12952dc345c6fcdd7e9d4ffad7a8bf...58308f584c357d1953c3978877eb11322ed0a2de,1,40,34,74,16,2012-06-17 19:13:06,2012-06-17 19:13:06
58308f584c357d1953c3978877eb11322ed0a2de...17eab005b239cdedd8b8ac4ab451fe97b3446b6f,1,4,2,6,1,2012-06-17 19:24:53,2012-06-17 19:24:53
17eab005b239cdedd8b8ac4ab451fe97b3446b6f...8e716f263026b05c2d65e7ce4b34341664a1e63a,1,5,0,5,1,2012-06-17 21:29:11,2012-06-17 21:29:11
8e716f263026b05c2d65e7ce4b34341664a1e63a...e12223023c1fa63ac29d17280f59312f5d2020ec,1,4,0,4,2,2012-06-18 14:27:03,2012-05-30 00:47:45
e12223023c1fa63ac29d17280f59312f5d2020ec...a3a690f51f62f9f4440f03ef9f47c98c2ba4d2a5,1,3,2,5,2,2012-06-18 14:27:04,2012-06-18 14:26:20
a3a690f51f62f9f4440f03ef9f47c98c2ba4d2a5...fdc529ce1a31b4edcf705b917c28e6acd1014771,2,379,379,758,2,2012-06-18 20:46:41,2012-06-18 20:03:03
fdc529ce1a31b4edcf705b917c28e6acd1014771...5e2af2d5e1c95c5a0a5b6c97f980628756547494,1,3,3,6,2,2012-06-19 13:47:05,2012-06-19 13:47:05
5e2af2d5e1c95c5a0a5b6c97f980628756547494...06aad51b6b4ac8da1cf3e6b9a8c7032a186ee9ec,1,3,1,4,1,2012-06-19 13:47:29,2012-06-19 13:47:29
06aad51b6b4ac8da1cf3e6b9a8c7032a186ee9ec...13640b3b003c0b5a8cef6e91baffc45c63e35766,1,2,1,3,1,2012-06-19 13:47:54,2012-06-19 13:47:54
13640b3b003c0b5a8cef6e91baffc45c63e35766...d1a4e07a69a04448852e5141ca19b23310929d22,1,5,0,5,3,2012-06-19 13:49:05,2012-06-19 13:49:05
d1a4e07a69a04448852e5141ca19b23310929d22...bdded78e9f2ba6c703811a7e20e0b90adfc0d5b3,6,527,375,902,78,2012-06-19 13:50:18,2012-06-19 13:50:18
bdded78e9f2ba6c703811a7e20e0b90adfc0d5b3...e44e3304b66d3fb778da67c34277d9091abe544a,1,1,1,2,1,2012-06-19 14:50:03,2012-06-19 14:49:54
e44e3304b66d3fb778da67c34277d9091abe544a...99ccda583d4970985c97eaec5b300acdcbdac176,1,1,2,3,1,2012-06-19 17:01:39,2012-06-19 17:01:39
99ccda583d4970985c97eaec5b300acdcbdac176...9fe31fd0eb5d54aa0104096b11c0a38bb9c1afe9,1,7,0,7,2,2012-06-19 17:21:47,2012-06-19 17:21:47
9fe31fd0eb5d54aa0104096b11c0a38bb9c1afe9...7d932daed48e51cea98129be39d2ae296aa27b3f,1,4,7,11,2,2012-06-19 19:08:56,2012-06-19 19:07:58
7d932daed48e51cea98129be39d2ae296aa27b3f...9391ea5abc2fa12a016d14ba23301cabd61afe92,1,1,1,2,1,2012-06-19 19:19:02,2012-06-19 19:17:37
9391ea5abc2fa12a016d14ba23301cabd61afe92...3c75d117debc68b3cd126b9f3d61333084809474,1,3,1,4,2,2012-06-19 19:56:37,2012-06-19 19:55:05
3c75d117debc68b3cd126b9f3d61333084809474...a74c2196cda32f5b7bbaa639ab50745ec6d8d5e1,1,1,0,1,1,2012-06-20 08:37:22,2012-06-20 08:37:22
a74c2196cda32f5b7bbaa639ab50745ec6d8d5e1...de7371889d3604b4c7a67571e3051c3f1d6703cb,1,1,1,2,1,2012-06-20 08:40:28,2012-06-20 08:40:28
de7371889d3604b4c7a67571e3051c3f1d6703cb...d344634b16408dbbdf5b5abd6ab58543d1105b0a,2,8,0,8,4,2012-06-20 08:45:02,2012-06-20 08:45:02
d344634b16408dbbdf5b5abd6ab58543d1105b0a...acfc37626338496a61232cb41775c3ebbf8b9c26,4,40,0,40,10,2012-06-20 08:47:47,2012-06-20 08:47:47
acfc37626338496a61232cb41775c3ebbf8b9c26...bae9a70dbf170f7223fc1807081a03d56df71a96,1,1,1,2,1,2012-06-20 14:27:52,2012-06-20 14:27:48
bae9a70dbf170f7223fc1807081a03d56df71a96...f724e2bac4acd71b1bd0954f7f9da8a32cee8960,1,201,192,393,1,2012-06-20 14:54:28,2012-06-20 14:54:28
f724e2bac4acd71b1bd0954f7f9da8a32cee8960...4c3a53dad00c2686c4eeb0652990c920b86c182f,2,11,6,17,5,2012-06-20 15:31:14,2012-06-20 15:31:07
4c3a53dad00c2686c4eeb0652990c920b86c182f...e56b0144be89e9e70358176792731d5bd07ab9b3,1,2,1,3,1,2012-06-20 15:42:10,2012-06-20 15:41:56
e56b0144be89e9e70358176792731d5bd07ab9b3...ad6c8701bc53afde4212c3eb5f9e1466181296a0,1,10,3,13,3,2012-06-20 16:03:57,2012-06-20 16:03:54
ad6c8701bc53afde4212c3eb5f9e1466181296a0...03c9f7f2a80e775375e249610c3694aaaa71312b,3,36,1,37,9,2012-06-20 16:09:35,2012-06-19 14:56:14
03c9f7f2a80e775375e249610c3694aaaa71312b...9e1526056db6bb63ddd6ed1ef91f1cd5db9d07f3,2,76,18,94,23,2012-06-20 16:45:01,2012-06-18 16:21:12
9e1526056db6bb63ddd6ed1ef91f1cd5db9d07f3...f641164ba14d8064c643c231adf53d8ca9bf4963,1,1,4,5,1,2012-06-20 16:59:38,2012-06-20 16:43:39
f641164ba14d8064c643c231adf53d8ca9bf4963...47ea9f70ddb90ffba8788b5ed4ddfc72237e6c9d,1,15,6,21,1,2012-06-20 17:18:02,2012-06-20 09:07:54
47ea9f70ddb90ffba8788b5ed4ddfc72237e6c9d...4297003598628f541fdd49942837f8ca916164e5,1,1,1,2,1,2012-06-20 17:20:52,2012-06-20 14:46:10
4297003598628f541fdd49942837f8ca916164e5...849a4fa53f6c99b7b72a9772bef908cb7e88a416,2,6,5,11,2,2012-06-20 18:52:03,2012-06-20 18:52:03
849a4fa53f6c99b7b72a9772bef908cb7e88a416...2a2689e7a5823291b125fabddf981ca87ef9a3f0,16,95,43,138,35,2012-06-20 19:25:10,2012-06-18 23:52:22
2a2689e7a5823291b125fabddf981ca87ef9a3f0...d49d729311ac09f9e267b44f94d0a5ec1c5f66e8,1,1,1,2,1,2012-06-20 19:25:10,2012-06-20 17:23:21
8c0e882052259000c665b7ad28f27118bba0ad6f...b9615570452231a87ba14a27cdc36a1708cc6f4c,4,31,1,32,5,2011-08-29 20:14:48,2011-08-29 19:59:39
b9615570452231a87ba14a27cdc36a1708cc6f4c...d43d01444dd6b2c707aa6e7a4d4fcbcb456b2686,1,3,0,3,2,2011-08-29 22:21:16,2011-08-29 22:19:13
d43d01444dd6b2c707aa6e7a4d4fcbcb456b2686...a406f1b8f4adba88b876417df5a8b081695c05a9,1,23,0,23,1,2011-08-29 23:37:39,2011-08-29 23:37:33
a406f1b8f4adba88b876417df5a8b081695c05a9...ae3201b73d06f139912aca4573994f1ed0c68d7b,1,10,4,14,8,2011-08-29 23:50:47,2011-08-29 23:48:15
ae3201b73d06f139912aca4573994f1ed0c68d7b...43744ae3b2198eedccc9f7799214a6892844624a,1,1,1,2,2,2011-08-29 23:56:28,2011-08-29 23:56:28
43744ae3b2198eedccc9f7799214a6892844624a...ad830c9c07b7e99187719ae8d099835fb684d0a4,1,48,0,48,2,2011-08-30 00:17:47,2011-08-30 00:17:47
ad830c9c07b7e99187719ae8d099835fb684d0a4...922398f47c570793463f90268725cb33b33760c1,1,25,0,25,1,2011-08-30 01:00:18,2011-08-30 01:00:18
922398f47c570793463f90268725cb33b33760c1...cba1eb700bdde29f1b67d6cf45a8f1422a7f4bb6,1,1,0,1,1,2011-08-30 03:08:24,2011-08-30 03:08:24
cba1eb700bdde29f1b67d6cf45a8f1422a7f4bb6...9fd22cb86de06cbb4b710e4d399f81b9a709f4f3,1,1,1,2,1,2011-08-30 15:17:39,2011-08-30 15:17:39
9fd22cb86de06cbb4b710e4d399f81b9a709f4f3...6b61f6a212899ebfa21e1ca49d9954fce797bc80,1,1,1,2,1,2011-08-30 15:18:45,2011-08-30 15:18:30
6b61f6a212899ebfa21e1ca49d9954fce797bc80...b7a4d0ff79a344d1208d9a0115adce9da4399344,2,10,8,18,10,2011-08-30 17:59:57,2011-08-30 17:58:35
b7a4d0ff79a344d1208d9a0115adce9da4399344...fff7a4972ea821104707f0e5008e615030fea6b6,1,1,1,2,1,2011-08-30 17:21:34,2011-08-30 17:21:34
fff7a4972ea821104707f0e5008e615030fea6b6...94256036c7edad39b97ecf8a949d7dab6e464819,2,36,1,37,2,2011-08-30 20:23:36,2011-08-30 19:54:10
94256036c7edad39b97ecf8a949d7dab6e464819...640fc155cd9c0527fa29cfff84ec916932e89095,1,2,0,2,1,2011-08-31 03:12:59,2011-08-31 03:12:35
e48d88a9abd62222377bc6611bfc6784d218b77d...655877bf6f2b8e60632e058b4aaaf7b8b69433fa,4,20,8,28,11,2011-11-04 20:52:05,2011-11-04 20:52:05
655877bf6f2b8e60632e058b4aaaf7b8b69433fa...d91640009559ecbb11579b275a58a6b2b4162a20,1,1,1,2,1,2011-11-04 20:52:48,2011-11-04 20:52:48
e48d88a9abd62222377bc6611bfc6784d218b77d...eb60a604a51719184dc2964b39abfa07857c49fe,1,6,1,7,1,2011-11-02 23:21:14,2011-11-02 23:21:00
eb60a604a51719184dc2964b39abfa07857c49fe...bef479c22e5bd48db985fb73ba08650071dd2200,1,9,9,18,1,2011-11-02 23:26:29,2011-11-02 23:26:10
bef479c22e5bd48db985fb73ba08650071dd2200...29b1f8f8f44fb12a54e2ec24e84a53dabba6bd7f,1,7,0,7,4,2011-11-03 00:43:02,2011-11-03 00:43:02
29b1f8f8f44fb12a54e2ec24e84a53dabba6bd7f...138039074bcb647fa4ab790a4ef0911a25b8b70b,1,89,66,155,16,2011-11-03 00:43:14,2011-11-03 00:43:14
138039074bcb647fa4ab790a4ef0911a25b8b70b...0eca9c9a07d7d3bdac342df83a9c175193b6d011,1,3,0,3,1,2011-11-03 13:24:33,2011-11-03 13:22:53
0eca9c9a07d7d3bdac342df83a9c175193b6d011...21f60286a90daa0c46479bba65ff5a69e0ca2ce2,1,6,16,22,4,2011-11-03 13:37:30,2011-11-03 13:37:30
21f60286a90daa0c46479bba65ff5a69e0ca2ce2...6225e4623708714cfc763162032b8d8ba471dd8d,1,4,1,5,2,2011-11-03 14:07:50,2011-11-03 14:07:50
6225e4623708714cfc763162032b8d8ba471dd8d...7a4e3bca9e2dfe4ada9167d22dab0d87ef8fcf63,1,10,4,14,8,2011-11-03 19:50:46,2011-11-03 19:50:46
7a4e3bca9e2dfe4ada9167d22dab0d87ef8fcf63...000b236424c6499eaaf128d618ab37821ebcf35f,1,9,33,42,10,2011-11-03 19:54:50,2011-11-03 19:54:50
000b236424c6499eaaf128d618ab37821ebcf35f...97913ab3f9987053bd7c5b6ec1bd167dd7909e66,1,3,2,5,3,2011-11-03 22:55:39,2011-11-03 22:55:39
97913ab3f9987053bd7c5b6ec1bd167dd7909e66...98314e257e38a1621120bb96e284cf9c8c760ecc,2,15,6,21,8,2011-11-04 00:17:56,2011-11-04 00:17:34
98314e257e38a1621120bb96e284cf9c8c760ecc...33abbf5702ca42f5763b1c5b2e8b285379b56222,1,11,3,14,5,2011-11-04 17:37:02,2011-11-04 17:32:17
33abbf5702ca42f5763b1c5b2e8b285379b56222...bf2fef392d47b8f7784dcbe79112901778945e63,1,14,1,15,2,2011-11-04 19:28:44,2011-11-04 19:28:44
bf2fef392d47b8f7784dcbe79112901778945e63...a0c55aa5f39dec18579d1dbccb1760e831c180b0,3,15,44,59,15,2011-11-04 20:10:09,2011-11-04 20:10:09
c65c75bb10689f419b863c824387444a01582aa4...8a79e63cbc99be8f475fa0451095f07a9ac27e5b,1,5,1,6,2,2011-10-28 20:28:55,2011-10-28 20:27:59
8a79e63cbc99be8f475fa0451095f07a9ac27e5b...1ffc5fd9e578ce5a9c58d04ae7f909cc2241d0f4,1,10,1,11,2,2011-10-28 20:28:55,2011-10-28 20:28:25
1ffc5fd9e578ce5a9c58d04ae7f909cc2241d0f4...e72734b08006348fcfc143a8d279cfabfc9e3f39,1,1,1,2,1,2011-10-29 03:47:27,2011-10-29 03:47:27
e72734b08006348fcfc143a8d279cfabfc9e3f39...45b8c90bbf865008457ffd39543e0fc56f4cd0e9,1,7,1,8,1,2011-10-29 05:14:46,2011-10-29 05:14:46
45b8c90bbf865008457ffd39543e0fc56f4cd0e9...50c851a36e4466ce40c36f78ffe07c955695d0e0,1,3,1,4,2,2011-10-29 05:55:13,2011-10-29 05:54:54
50c851a36e4466ce40c36f78ffe07c955695d0e0...d0510ce9d2a3888243f3b2f6bfa2fa3016b76364,1,3,0,3,2,2011-10-29 13:28:20,2011-10-29 13:28:20
d0510ce9d2a3888243f3b2f6bfa2fa3016b76364...f4997d7a5ba09826fcceb7253282b2c117b675db,1,1,3,4,1,2011-10-30 21:57:10,2011-10-30 21:57:10
f4997d7a5ba09826fcceb7253282b2c117b675db...586693103c2aac736ea79793fb848aba7b825010,2,6,2,8,4,2011-10-31 01:37:30,2011-10-31 01:37:30
586693103c2aac736ea79793fb848aba7b825010...6e0420d335846cc0be61b775b41fb2ae9ff208bd,5,108,43,151,41,2011-10-31 01:40:23,2011-10-31 01:40:23
6e0420d335846cc0be61b775b41fb2ae9ff208bd...204f1999bf71db8b04f92a94bf4f524549d402cd,1,12,0,12,1,2011-10-31 13:28:59,2011-10-26 16:14:24
204f1999bf71db8b04f92a94bf4f524549d402cd...2b087f35438cbb4d3593f3cf92cb409f99f7162a,13,88,31,119,39,2011-10-31 13:28:59,2011-10-28 22:17:17
2b087f35438cbb4d3593f3cf92cb409f99f7162a...54c3904512f5d419347ed53fad8a73a2d528b506,1,1,1,2,1,2011-10-31 13:35:09,2011-10-31 13:35:09
54c3904512f5d419347ed53fad8a73a2d528b506...1fa8066338dd1bc30ca1a07cb93d10d8e1787e6e,2,4,2,6,2,2011-10-31 13:45:26,2011-10-31 13:43:29
1fa8066338dd1bc30ca1a07cb93d10d8e1787e6e...db740f9363693aad5c2087cd106dc9b4972b035f,1,1,1,2,1,2011-10-31 13:49:42,2011-10-31 13:49:42
db740f9363693aad5c2087cd106dc9b4972b035f...50b4d5173800b71962b094a09a1ad518a55417f4,1,10,11,21,6,2011-10-31 14:00:47,2011-10-31 14:00:47
50b4d5173800b71962b094a09a1ad518a55417f4...34ee7fc1184e559d72d10bcf83e9557240a430d6,2,4,0,4,2,2011-10-31 14:00:59,2011-10-31 14:00:59
34ee7fc1184e559d72d10bcf83e9557240a430d6...ff004c977ab551e6e25e5999b061ac45bc5fa4d6,5,75,18,93,16,2011-10-31 14:50:00,2011-10-31 14:41:40
ff004c977ab551e6e25e5999b061ac45bc5fa4d6...83e830d42aa900313901136c4704fe86dac6e8db,1,10,0,10,1,2011-10-31 15:02:06,2011-10-31 15:00:24
83e830d42aa900313901136c4704fe86dac6e8db...61dac94dd60e020bfc11112e80d24ac503c3b119,2,48,13,61,5,2011-10-31 15:02:20,2011-10-31 15:01:36
3e9dfebcf135501213edfae66499bfbffb84a666...a6a6f694d252d106f4dce9c08c64d44290696802,2,7,2,9,3,2011-10-24 21:56:19,2011-10-24 21:56:19
3e9dfebcf135501213edfae66499bfbffb84a666...9c848bff8d8feae067feb2efaa50e2084ac363a1,1,1,1,2,1,2011-10-24 21:48:28,2011-10-24 21:48:28
d49d729311ac09f9e267b44f94d0a5ec1c5f66e8...0bc2a511f8cec36da6700f547b52405d0cac8acb,2,3,0,3,2,2012-06-20 22:41:48,2012-06-20 22:41:48
0bc2a511f8cec36da6700f547b52405d0cac8acb...a4c94408c52f9c484b4f52f447701aa3240f8624,1,1,1,2,1,2012-06-20 22:42:01,2012-06-20 22:42:01
a4c94408c52f9c484b4f52f447701aa3240f8624...81d743f8f44c74d23b54c440e1f9f822c36f1f34,1,4,0,4,1,2012-06-21 15:19:07,2012-06-21 15:19:07
81d743f8f44c74d23b54c440e1f9f822c36f1f34...3b2b606106c4539c0255f946d24179660d69c573,1,2,2,4,2,2012-06-21 15:48:47,2012-06-21 15:43:23
3b2b606106c4539c0255f946d24179660d69c573...bd234e4082b62ff2642dfd2fc60ca64f09293e3b,1,1,1,2,2,2012-06-21 15:48:47,2012-06-21 15:47:49
bd234e4082b62ff2642dfd2fc60ca64f09293e3b...91ccc053a3b48cd7c969ce6c7dae8c24baf022e9,1,2,0,2,1,2012-06-21 17:47:11,2012-06-21 17:47:11
91ccc053a3b48cd7c969ce6c7dae8c24baf022e9...0fb9381b2f725d28450eed62eba8ac4174cd05a4,2,2,2,4,2,2012-06-21 18:08:54,2012-06-21 18:08:54
0fb9381b2f725d28450eed62eba8ac4174cd05a4...a32e41753def3eca8ecd540c7e47d20b2c8002a0,2,219,194,413,9,2012-06-21 19:05:46,2012-06-21 14:01:00
a32e41753def3eca8ecd540c7e47d20b2c8002a0...f93d5c01bdb385ebe3f7df735e6e22961ca04652,1,1,1,2,1,2012-06-21 19:55:04,2012-06-21 19:55:04
f93d5c01bdb385ebe3f7df735e6e22961ca04652...2f2867eae0841ce913b348dd29d372ec7f3f43f8,1,2,2,4,2,2012-06-21 20:30:14,2012-06-21 20:30:14
d49d729311ac09f9e267b44f94d0a5ec1c5f66e8...0fdaf98792034c8e4a39663d915864b215894f9d,1,52,0,52,1,2012-06-20 21:51:00,2012-06-20 21:51:00
0fdaf98792034c8e4a39663d915864b215894f9d...bc8b70aa70db90b9830e8041daefee121a53f195,1,16,13,29,9,2012-06-21 14:04:48,2012-06-21 14:03:49
bc8b70aa70db90b9830e8041daefee121a53f195...3f33b4434a16f6f4f929def4e14d20ed6e686b73,1,3,7,10,4,2012-06-21 14:12:46,2012-06-21 14:11:28
3f33b4434a16f6f4f929def4e14d20ed6e686b73...1842db9d10f977b6fa2115c16df0952ab08b68e3,1,4,6,10,5,2012-06-21 14:28:32,2012-06-21 14:27:52
1842db9d10f977b6fa2115c16df0952ab08b68e3...3a164730310cc2d4e4877cded56759f819eee980,1,6,2,8,3,2012-06-25 13:45:56,2012-06-25 13:44:33
3a164730310cc2d4e4877cded56759f819eee980...ef469e0ee24cc9a3cab6b43d7515ef2093ce753d,1,1,0,1,1,2012-06-25 15:41:48,2012-06-25 15:17:23
640fc155cd9c0527fa29cfff84ec916932e89095...1c5b750fdc624cbbade7e33ccc89c3e55faf5fc5,1,3,3,6,2,2011-08-31 15:26:44,2011-08-31 15:26:44
640fc155cd9c0527fa29cfff84ec916932e89095...8f2b751b77d1f948deb3f902b8213308004f1df1,1,7,6,13,3,2011-08-31 15:14:51,2011-08-31 15:14:51
5852a65a311e6d480cf8e1cc28418a8ffcbc7d45...d373fcc43e26595e72b913aba6359af5793b4d6a,1,1,1,2,1,2011-11-07 06:16:31,2011-11-07 06:16:31
d373fcc43e26595e72b913aba6359af5793b4d6a...90baaedf96c2c1c94f9ff2589d75a5315226d597,2,2,2,4,2,2011-11-07 14:55:16,2011-11-06 22:42:04
90baaedf96c2c1c94f9ff2589d75a5315226d597...58efb8256c4ce136c124a8c93e43e920ec07a3f7,1,1,1,2,1,2011-11-07 14:55:19,2011-11-06 22:42:35
58efb8256c4ce136c124a8c93e43e920ec07a3f7...6a7432868871d63672eec91568fe74aca063090d,4,176,112,288,14,2011-11-07 14:55:21,2011-11-06 22:42:44
6a7432868871d63672eec91568fe74aca063090d...687bf0abbbc89aba3911ff4e1eac1957b704fc84,2,24,3,27,7,2011-11-07 15:25:06,2011-11-07 15:25:06
687bf0abbbc89aba3911ff4e1eac1957b704fc84...2c91cca517f9ffad4753d2e4b6eb863b035f9058,1,40,0,40,1,2011-11-07 15:57:48,2011-11-07 15:57:24
2c91cca517f9ffad4753d2e4b6eb863b035f9058...3c2cfee68f38a09f798269172e5799cdb72dd185,1,7,2,9,2,2011-11-07 17:38:30,2011-11-07 17:38:30
5852a65a311e6d480cf8e1cc28418a8ffcbc7d45...eaeac8f004a234ab7c61d523e79cd28dfe4828ca,2,0,13,13,2,2011-11-05 11:05:00,2011-11-05 11:05:00
61dac94dd60e020bfc11112e80d24ac503c3b119...04ee65d4a0c712c465a8fbc43bc57ad696f747c1,2,30,7,37,9,2011-10-31 22:22:38,2011-10-31 22:22:38
61dac94dd60e020bfc11112e80d24ac503c3b119...33b9bb0628d549cf6828931887f2e0c4de293144,1,0,0,0,0,2011-10-31 16:37:04,2011-10-31 16:37:04
1b1a3ff51c76dc47d85300741c8e428eb2c09517...362c151dacda419a1c94c73ad89599e55b7bad3c,1,9,7,16,6,2011-10-24 22:13:58,2011-10-24 22:11:17
362c151dacda419a1c94c73ad89599e55b7bad3c...5e0672d6deee862820c103b908f1c8844e4b0c66,1,1,0,1,1,2011-10-24 22:19:19,2011-10-24 22:18:52
5e0672d6deee862820c103b908f1c8844e4b0c66...541aa57d8fd4c8c1938daba0f004caa2076b2d08,2,3,5,8,5,2011-10-24 22:21:32,2011-10-24 22:20:30
2f2867eae0841ce913b348dd29d372ec7f3f43f8...7611609b8dec733ce4d27e170a3a0f8aa850da1b,1,5,0,5,2,2012-06-21 22:10:40,2012-06-21 22:10:40
7611609b8dec733ce4d27e170a3a0f8aa850da1b...505e3176436c115183ef59113ad51e152d889cfb,1,0,5,5,2,2012-06-21 22:29:56,2012-06-21 22:29:56
505e3176436c115183ef59113ad51e152d889cfb...f843e4f1cad1dd9ac808f91c3ff323fdd9886860,1,17,8,25,6,2012-07-02 22:39:39,2012-07-02 22:39:39
f843e4f1cad1dd9ac808f91c3ff323fdd9886860...ec10113e02c3e40f1d5374c2578266b96549f706,1,5,10,15,5,2012-07-03 17:05:10,2012-07-03 17:05:10
ec10113e02c3e40f1d5374c2578266b96549f706...a5bc6c4cce0905c642774c6301c0071968d3776e,1,15,4,19,3,2012-07-03 20:57:28,2012-07-03 20:57:28
2f2867eae0841ce913b348dd29d372ec7f3f43f8...3c6c01c1a1dfd3b1a8ab4e0e17623a36befdb2fd,1,17,3,20,4,2012-06-21 21:58:14,2012-06-20 22:06:19
3c6c01c1a1dfd3b1a8ab4e0e17623a36befdb2fd...95cb7b966618b7e3d3e6e792b256ace913bd6a40,1,10,7,17,5,2012-06-21 22:02:24,2012-06-18 15:35:24
95cb7b966618b7e3d3e6e792b256ace913bd6a40...5b9a7cf038a56dbe48e8adb65cf96c1acfa7c4a6,1,12,2,14,2,2012-06-21 22:02:24,2012-06-18 15:35:33
5b9a7cf038a56dbe48e8adb65cf96c1acfa7c4a6...425b09152b338464e1a057cbe6f6f0ae081705f1,1,6,1,7,1,2012-06-21 22:02:24,2012-06-21 21:58:29
425b09152b338464e1a057cbe6f6f0ae081705f1...c921c81d23a8345c2d1a7b3c14fe46b2b4d9b9af,2,31,7,38,5,2012-06-22 14:48:16,2012-06-08 22:50:40
c921c81d23a8345c2d1a7b3c14fe46b2b4d9b9af...a997a0bb15fee4b74216bc29572a3a34b18c5e4a,1,12,4,16,5,2012-06-22 14:48:16,2012-06-21 18:58:46
a997a0bb15fee4b74216bc29572a3a34b18c5e4a...3444ed0ab80db73704002cb44c9aa3f90fdaa253,1,46,1,47,3,2012-06-22 14:48:16,2012-06-21 19:15:15
3444ed0ab80db73704002cb44c9aa3f90fdaa253...64f1404354f65247efdf9fd23aa178cf274f8af8,2,23,17,40,6,2012-06-22 17:41:46,2012-06-20 17:43:56
64f1404354f65247efdf9fd23aa178cf274f8af8...e5b586a0fd0978802560e2319da38e08e3bab7df,1,0,3,3,1,2012-06-22 21:23:44,2012-06-22 21:23:44
e5b586a0fd0978802560e2319da38e08e3bab7df...5bedbe5410c86c7d2ede53f6c61b7866332bb88e,1,1,1,2,1,2012-06-22 21:46:55,2012-06-22 21:46:55
5bedbe5410c86c7d2ede53f6c61b7866332bb88e...6048664354c8f9fccdc18b8196618ed7a6170340,1,3,2,5,2,2012-06-24 00:37:33,2012-06-24 00:37:33
6048664354c8f9fccdc18b8196618ed7a6170340...c1c5469ce96c833476f01d70c052cc74dce9b004,1,1,0,1,1,2012-06-24 00:48:09,2012-06-24 00:48:09
c1c5469ce96c833476f01d70c052cc74dce9b004...52fa01b3700769b2bbf3090b44ea2d3cbd0a2ebb,1,7,5,12,2,2012-06-24 01:06:43,2012-06-24 01:06:43
52fa01b3700769b2bbf3090b44ea2d3cbd0a2ebb...6aeb90d04f7f88218e11f6b81a154899435ac49e,1,1,1,2,1,2012-06-24 23:56:26,2012-06-24 23:56:26
6aeb90d04f7f88218e11f6b81a154899435ac49e...f34e58a18c4c7bc7332b8f426962e09b3258e93d,3,64,0,64,3,2012-06-25 00:38:11,2012-06-25 00:38:11
f34e58a18c4c7bc7332b8f426962e09b3258e93d...82e2bd8b8c155ba01b43815eb3bb0e6c68d7b959,2,11,2,13,3,2012-06-25 00:38:37,2012-06-25 00:38:37
82e2bd8b8c155ba01b43815eb3bb0e6c68d7b959...ac945788df95c93e589735b7c914fd1aef266ac2,1,2,2,4,2,2012-06-25 00:43:34,2012-06-25 00:43:34
ac945788df95c93e589735b7c914fd1aef266ac2...927beb54fb5ec38ccd0ca5fa712564a0696c9003,4,6,6,12,6,2012-06-26 04:20:48,2012-06-26 04:20:48
927beb54fb5ec38ccd0ca5fa712564a0696c9003...0c6b09490ebdc5900e14d28e0b35ed6e8ec52497,2,2,2,4,2,2012-06-26 12:32:36,2012-06-26 12:32:36
0c6b09490ebdc5900e14d28e0b35ed6e8ec52497...63a957eca0eae9fc3e68bf3305bea7cf65b16985,1,4,0,4,1,2012-06-26 12:34:14,2012-06-26 12:34:14
63a957eca0eae9fc3e68bf3305bea7cf65b16985...0d1fd31650d38a64969879bd3875e38946119297,9,31,57,88,13,2012-06-26 12:34:39,2012-06-26 12:34:39
0d1fd31650d38a64969879bd3875e38946119297...e2e10a6567730f7e361a5c747daa4897b3cbfc07,1,4,1,5,1,2012-06-26 12:36:13,2012-06-26 12:36:13
e2e10a6567730f7e361a5c747daa4897b3cbfc07...1dbc9ce2586d9877072eb2769d14bb495b5e7ef6,1,6,1,7,1,2012-06-26 12:37:43,2012-06-26 12:37:43
1dbc9ce2586d9877072eb2769d14bb495b5e7ef6...c35804c9e9ad55511b27eb7b30af8e89902f2eb2,1,41,41,82,1,2012-06-27 12:02:01,2012-06-27 12:02:01
c35804c9e9ad55511b27eb7b30af8e89902f2eb2...24fddec0622f7814652c4b9c4c3189ad1089d567,4,140,7,147,6,2012-06-27 17:37:56,2012-06-18 14:06:30
24fddec0622f7814652c4b9c4c3189ad1089d567...592edc985f601c63951f353e817f9587fd6160d7,1,0,1,1,1,2012-06-27 23:16:34,2012-06-27 23:16:34
592edc985f601c63951f353e817f9587fd6160d7...eb0f551422feaf3aa0f0ced33740509b1cf488e0,1,0,3,3,1,2012-06-28 00:16:53,2012-06-28 00:16:53
eb0f551422feaf3aa0f0ced33740509b1cf488e0...2d1b0bf122d31ed38fd595ee99dd798dfd82d703,1,17,0,17,2,2012-06-28 18:09:24,2012-06-28 18:09:24
2d1b0bf122d31ed38fd595ee99dd798dfd82d703...a232dad39ef2682fdb706d01f470ecd1501d5cb9,3,62,44,106,18,2012-06-28 19:24:48,2012-06-25 15:44:45
a232dad39ef2682fdb706d01f470ecd1501d5cb9...028db4bb3ec21677033924100cb2dcd96678dadf,1,4,1,5,1,2012-06-28 19:58:15,2012-06-28 19:56:20
028db4bb3ec21677033924100cb2dcd96678dadf...29253bec3ba365668d503ca015c4e9a7f4cc3f0d,1,5,1,6,1,2012-06-28 20:16:52,2012-06-28 19:32:50
29253bec3ba365668d503ca015c4e9a7f4cc3f0d...eb7e375dd3c6331f0cc30a42fb6cb86d557b68ac,1,21,15,36,4,2012-06-29 15:07:44,2012-06-29 15:06:46
eb7e375dd3c6331f0cc30a42fb6cb86d557b68ac...22ec5a0e0fc388b2226d51b41b1657367f5f1438,40,9469,9469,18938,49,2012-06-29 17:41:23,2012-06-21 22:10:49
22ec5a0e0fc388b2226d51b41b1657367f5f1438...06616be64e86b1cd17c73b26a52f29d632d09fec,1,6,6,12,4,2012-06-29 17:41:23,2012-06-25 20:37:06
06616be64e86b1cd17c73b26a52f29d632d09fec...dda980dcfda0e05738686fe7fdad6e1e6a6466e3,3,65,7,72,3,2012-06-29 17:41:23,2012-06-25 15:10:06
dda980dcfda0e05738686fe7fdad6e1e6a6466e3...9bfb82ea042d1a21d7058f44367caa9688cb4331,2,40,4,44,3,2012-06-29 17:41:23,2012-06-22 17:23:31
9bfb82ea042d1a21d7058f44367caa9688cb4331...36c78176a97e52874850d38d08ac5f8019055325,3,63,2,65,3,2012-06-29 17:41:29,2012-06-22 15:51:47
36c78176a97e52874850d38d08ac5f8019055325...d22f901e93e50557f25bfd0d507dfc727396a418,30,45,45,90,45,2012-06-29 17:41:29,2012-06-20 19:42:31
d22f901e93e50557f25bfd0d507dfc727396a418...5a55e91e68daa59ca29c1bb1a899fafb6a039b50,1,1,1,2,1,2012-06-29 17:42:25,2012-06-28 23:05:08
5a55e91e68daa59ca29c1bb1a899fafb6a039b50...181ff5d768e45bb4b84622444da9fa3e0181aaa8,1,17,0,17,2,2012-06-29 19:43:22,2012-06-29 19:43:22
181ff5d768e45bb4b84622444da9fa3e0181aaa8...7f47f022739847e211dc8e054098ed8ee7c753c8,1,1,1,2,1,2012-06-29 20:25:28,2012-06-29 20:25:28
c6a6cebea0c16ccf3bd919ba7e18c9b44678e620...c8f4fdb1de2866387644193a467eae935f018b00,1,1,1,2,1,2011-08-31 15:38:09,2011-08-31 15:38:09
c8f4fdb1de2866387644193a467eae935f018b00...cba5d568e9e48398a0fa34aefb4904be464e6570,2,19,5,24,3,2011-08-31 16:48:03,2011-08-31 16:48:03
cba5d568e9e48398a0fa34aefb4904be464e6570...56122624cfaa36058c13b8174c94265ca74c3aa7,1,2,2,4,2,2011-08-31 17:12:24,2011-08-31 17:12:24
56122624cfaa36058c13b8174c94265ca74c3aa7...7f9fa28a4d008582ac63ba31c9f15cdb55913fb3,1,6,3,9,3,2011-08-31 18:59:40,2011-08-31 18:58:44
7f9fa28a4d008582ac63ba31c9f15cdb55913fb3...09164a9fdc0b3871cd51c393477b01dc44fd31d5,1,37,0,37,1,2011-09-01 17:51:29,2011-09-01 17:50:34
09164a9fdc0b3871cd51c393477b01dc44fd31d5...cee4f0ef879d2ec3307957c0e203140f226f9ef8,1,6,5,11,3,2011-09-01 18:31:29,2011-09-01 18:31:29
cee4f0ef879d2ec3307957c0e203140f226f9ef8...4d8cd672bb03d466130ba8a48b828e03bb72b3cf,2,22,0,22,3,2011-09-02 00:29:22,2011-09-02 00:01:57
4d8cd672bb03d466130ba8a48b828e03bb72b3cf...79b292b4456fabac9b11bcd59ee24fd341708519,1,2,0,2,1,2011-09-02 03:16:21,2011-09-02 03:16:21
79b292b4456fabac9b11bcd59ee24fd341708519...f6d544cd6b019d6ff9752909d367410b504fee6b,1,10,0,10,2,2011-09-02 03:21:56,2011-09-02 03:21:56
f6d544cd6b019d6ff9752909d367410b504fee6b...b5dd192afa9ad59e45b660f7193e0d80c59dc6d5,3,3,3,6,3,2011-09-02 03:24:02,2011-09-02 03:24:02
b5dd192afa9ad59e45b660f7193e0d80c59dc6d5...e8f978e25d3d015f97631f4bb211085993aff18f,1,2,3,5,1,2011-09-02 14:34:06,2011-09-02 14:34:06
e8f978e25d3d015f97631f4bb211085993aff18f...68966c1f1b67a5208469a5f7273390bfeee1e328,2,2,2,4,2,2011-09-02 14:53:33,2011-09-02 14:53:33
68966c1f1b67a5208469a5f7273390bfeee1e328...fcf97ff30ec7113e3f2a7669ba17e8df46841a40,1,3,7,10,7,2011-09-02 21:32:20,2011-09-02 20:10:32
fcf97ff30ec7113e3f2a7669ba17e8df46841a40...8d72a36f12c23f6ed7754bd825262e70a6bd426c,1,36,11,47,12,2011-09-04 04:47:56,2011-09-04 04:47:56
8d72a36f12c23f6ed7754bd825262e70a6bd426c...7dc52e245c23d16b5744e92a253afb553620e2d0,1,5,0,5,1,2011-09-04 04:48:26,2011-09-04 04:48:26
7dc52e245c23d16b5744e92a253afb553620e2d0...68c94172053cb15a3692d1f5f933fcfd67bd8add,1,49,0,49,1,2011-09-04 04:48:38,2011-09-04 04:48:38
68c94172053cb15a3692d1f5f933fcfd67bd8add...ce0d6401974d7b26bd1b08a0b1af0ebc196908ba,2,5,5,10,5,2011-09-04 18:08:33,2011-09-04 18:08:33
ce0d6401974d7b26bd1b08a0b1af0ebc196908ba...dc7f6223b72676e45c964d6da6cd4163e86bf6f8,1,1,1,2,1,2011-09-04 21:02:34,2011-09-04 21:02:34
dc7f6223b72676e45c964d6da6cd4163e86bf6f8...b7d7b752a4714a77a9b6ea77dd976c05544047b8,1,2,1,3,2,2011-09-06 01:44:03,2011-09-06 01:44:03
b7d7b752a4714a77a9b6ea77dd976c05544047b8...210e12a17a04fa27c3fa0ae66cdff2b4e78ba605,2,48,5,53,9,2011-09-06 15:58:17,2011-09-06 15:58:17
210e12a17a04fa27c3fa0ae66cdff2b4e78ba605...0568f129bd64ac09ca917e6f2718fc215d0e8719,1,4,4,8,4,2011-09-06 16:11:11,2011-09-02 23:14:02
0568f129bd64ac09ca917e6f2718fc215d0e8719...55ca0b16581375a014e1ccb94a7b07fa83f0658a,1,1,1,2,1,2011-09-06 16:11:11,2011-09-02 23:19:49
55ca0b16581375a014e1ccb94a7b07fa83f0658a...df769f03a45540f475bab0db10a560469a096911,1,2,2,4,2,2011-09-06 16:11:11,2011-09-06 16:07:34
df769f03a45540f475bab0db10a560469a096911...3f7ab8d55bffb2fda0575b0c82eb766c868a5eea,1,38,24,62,7,2011-09-06 16:22:47,2011-09-06 16:22:31
3f7ab8d55bffb2fda0575b0c82eb766c868a5eea...0ad61856a65c6ae5801c7fd666f7e4e6b9b129bd,1,1,1,2,1,2011-09-06 20:59:47,2011-09-06 20:59:47
0ad61856a65c6ae5801c7fd666f7e4e6b9b129bd...333e0276374e229764277053ea4be6b92c6fe3ed,3,54,21,75,14,2011-09-06 21:40:44,2011-09-06 21:35:31
333e0276374e229764277053ea4be6b92c6fe3ed...41f0781429225f979cdd2b19e09ca696729860f5,1,1,1,2,1,2011-09-06 21:51:06,2011-09-06 21:51:06
41f0781429225f979cdd2b19e09ca696729860f5...6362013e418bd0ed854ef6d623e07b44ba2f6b3c,2,14,7,21,10,2011-09-07 03:46:18,2011-09-07 03:41:54
6362013e418bd0ed854ef6d623e07b44ba2f6b3c...afa19a36958852526ed2c74717f505d137575bd2,1,2,1,3,1,2011-09-07 05:05:39,2011-09-07 05:05:39
afa19a36958852526ed2c74717f505d137575bd2...c395a516930b49b21a6f19d810aa79615684827a,3,3,3,6,3,2011-09-07 05:07:35,2011-09-07 04:18:05
c395a516930b49b21a6f19d810aa79615684827a...a881aacb3d9a5032403ad45362f35bc9c640affa,2,32,0,32,2,2011-09-07 16:10:34,2011-09-07 16:10:34
a881aacb3d9a5032403ad45362f35bc9c640affa...83ff070b773fb6c9eadf2e6638bc23e7535ffb3c,2,2,2,4,2,2011-09-07 16:15:02,2011-09-07 16:15:02
83ff070b773fb6c9eadf2e6638bc23e7535ffb3c...1d75a4793a9c7b1586911c2cf3bbe6fe0d5191c8,1,1,1,2,1,2011-09-07 17:02:50,2011-09-07 17:02:50
1d75a4793a9c7b1586911c2cf3bbe6fe0d5191c8...fd0a54bb7361d72f6db7e374c38da60333a55d18,1,35,0,35,1,2011-09-07 18:23:17,2011-09-07 18:22:40
fd0a54bb7361d72f6db7e374c38da60333a55d18...955eca2419545e5f79a690893a264bd2a226f4cb,1,2,0,2,1,2011-09-07 21:29:18,2011-09-07 21:29:18
955eca2419545e5f79a690893a264bd2a226f4cb...399d8bf50b3ac51bc07c8e7b0c4aa9b3b02c3da6,1,3,0,3,1,2011-09-07 22:06:31,2011-09-07 22:05:32
399d8bf50b3ac51bc07c8e7b0c4aa9b3b02c3da6...f9d784faf0f8d6178e2f1758d9b36521ca6acbc8,1,0,0,0,0,2011-09-07 22:07:29,2011-09-07 22:07:29
f9d784faf0f8d6178e2f1758d9b36521ca6acbc8...ff418fdac2591664a9bb1fe76be854483b136e1c,1,1,1,2,1,2011-09-09 17:39:07,2011-09-07 16:24:32
ff418fdac2591664a9bb1fe76be854483b136e1c...21855b87fcee0d4c125ce8c02873e092a8a642bf,1,8,0,8,2,2011-09-09 17:44:15,2011-09-09 16:28:03
21855b87fcee0d4c125ce8c02873e092a8a642bf...211452b5fefbd786544c79e972e9574b267fc14c,1,2,0,2,1,2011-09-09 17:44:15,2011-09-09 16:32:17
211452b5fefbd786544c79e972e9574b267fc14c...870c9906fc94e14a49c7e83b7b079df62c6295d4,1,1,1,2,1,2011-09-09 17:44:16,2011-09-09 17:44:03
3c2cfee68f38a09f798269172e5799cdb72dd185...4158c0c58830fc1e8b7fe5a97e771e5df0ebd61f,1,1,0,1,1,2011-11-07 22:41:24,2011-11-07 22:41:24
3c2cfee68f38a09f798269172e5799cdb72dd185...3a8e94941fdc67f1f26af476370275fb71db8572,1,1,1,2,1,2011-11-07 18:40:54,2011-11-07 16:35:31
3a8e94941fdc67f1f26af476370275fb71db8572...25739dd5eb95ea0b9a48d53169e3f6a881daa1e9,1,4,0,4,2,2011-11-07 18:40:56,2011-11-07 17:48:15
25739dd5eb95ea0b9a48d53169e3f6a881daa1e9...4296b68f2047e9ee66a7161ffb02348578f0256f,5,180,35,215,26,2011-11-07 18:40:58,2011-11-07 18:40:35
4296b68f2047e9ee66a7161ffb02348578f0256f...940708f94e2324b27c6be80a04594f5b28cead00,3,42,10,52,12,2011-11-07 20:36:45,2011-11-07 20:36:45
940708f94e2324b27c6be80a04594f5b28cead00...c2fc3335085bbba8da8ddcbb51f28eaff8aae28c,1,27,2,29,3,2011-11-07 22:25:09,2011-11-07 22:21:25
1bd2c7b940a84a4baefb194a19cbdf620078b39a...ce188d41df932b62591b9681b46787a87c2d3ad4,3,5,2,7,4,2011-11-02 18:01:54,2011-11-02 18:01:54
541aa57d8fd4c8c1938daba0f004caa2076b2d08...c3dc3eb37763d3c4c774f89eaee5cafe7ca7b1d4,1,1,1,2,1,2011-10-25 14:31:52,2011-10-25 14:31:52
c3dc3eb37763d3c4c774f89eaee5cafe7ca7b1d4...4f7d9615530868f2aca24217b07707b4925b21c9,1,17,12,29,12,2011-10-25 14:46:53,2011-10-25 14:39:56
4f7d9615530868f2aca24217b07707b4925b21c9...76c65c947384a1f0de6f2c8ebc41f1adab2780d3,4,94,24,118,12,2011-10-25 15:47:43,2011-10-25 15:41:38
76c65c947384a1f0de6f2c8ebc41f1adab2780d3...fc640ccdca95b3d7eac6a11acab128eba3fd91b3,2,59,3,62,12,2011-10-25 15:57:45,2011-10-25 15:55:39
fc640ccdca95b3d7eac6a11acab128eba3fd91b3...9e4a870471afd6a018ddab16b89c35c88490ce4b,2,5,1,6,3,2011-10-25 15:57:45,2011-10-25 15:56:58
9e4a870471afd6a018ddab16b89c35c88490ce4b...eb7a47ba9193e9221c018a273d7d75e43736ad33,1,1,1,2,1,2011-10-25 15:58:25,2011-10-25 15:40:22
eb7a47ba9193e9221c018a273d7d75e43736ad33...b60b89ce1437db47134034a956c1d0e4e49345e7,2,32,10,42,6,2011-10-25 15:58:29,2011-10-25 15:41:17
b60b89ce1437db47134034a956c1d0e4e49345e7...b5b1c72d4e0fb0eee4d4217a8801d02610c597f8,12,902,863,1765,30,2011-10-25 16:04:59,2011-10-25 15:57:58
b5b1c72d4e0fb0eee4d4217a8801d02610c597f8...d661dd3001855fd73654c1ec4cdf62c10949c075,1,2,2,4,2,2011-10-25 16:09:01,2011-10-25 16:09:01
d661dd3001855fd73654c1ec4cdf62c10949c075...a6cd69c203ad952eff2c8d5e6ea1e489e5e92d81,1,2,1,3,1,2011-10-25 15:23:52,2011-10-25 15:23:52
a6cd69c203ad952eff2c8d5e6ea1e489e5e92d81...1dda8a8c3099f0054c10bfd6ec788ee098821899,4,27,22,49,12,2011-10-25 16:37:35,2011-10-25 16:37:07
1dda8a8c3099f0054c10bfd6ec788ee098821899...338c743a6d5ea9635b29d5e82b26ab196f9772fa,3,11,7,18,7,2011-10-25 18:37:25,2011-10-25 18:37:25
541aa57d8fd4c8c1938daba0f004caa2076b2d08...56d5e59efc28a7c272ce2d984d3253fc9772d45e,1,1,1,2,1,2011-10-24 22:30:33,2011-10-24 22:30:33
7450d9b08210274c184fa2232dd2da0b15c5ade9...374289bb6e043b16fe9bf613bc18e56f6df14a81,1,2,1,3,1,2012-08-30 22:54:30,2012-08-30 22:54:30
7f47f022739847e211dc8e054098ed8ee7c753c8...7a43c2260ee58f82fc44e55c021b74d821e4a16e,3,35,0,35,3,2012-07-02 19:12:34,2012-07-02 19:12:34
7a43c2260ee58f82fc44e55c021b74d821e4a16e...1d58eed0e23bb446388205a1df7f3eebef1f29a2,3,40,16,56,9,2012-07-02 19:16:13,2012-07-02 19:16:04
1d58eed0e23bb446388205a1df7f3eebef1f29a2...78c6a30cb322c077cf5446a86e118ca9c0dd2124,1,1,1,2,1,2012-07-02 19:19:46,2012-07-02 19:19:46
78c6a30cb322c077cf5446a86e118ca9c0dd2124...912e192174edfd5a5bb77712986a734ac2805d14,1,3,1,4,2,2012-07-02 19:19:25,2012-07-02 04:13:49
912e192174edfd5a5bb77712986a734ac2805d14...044844545c419c793d88e5521652a59402b8feb6,1,4,2,6,2,2012-07-02 19:39:41,2012-07-02 19:39:41
044844545c419c793d88e5521652a59402b8feb6...966b8ef4ca58137f96d0dcbae42dd0962323b832,1,0,8,8,1,2012-07-02 21:00:27,2012-07-02 21:00:27
966b8ef4ca58137f96d0dcbae42dd0962323b832...299acc47e664edf1d9b6bf7c0c2996ac1640f4eb,1,1,1,2,1,2012-07-02 21:16:52,2012-07-02 21:14:07
299acc47e664edf1d9b6bf7c0c2996ac1640f4eb...3738f69346b146f7d81f0c1468003c505c467f8f,2,0,16,16,2,2012-07-02 23:15:33,2012-07-02 23:05:27
3738f69346b146f7d81f0c1468003c505c467f8f...2f86d853fc324cd50b4713fab50cda91803d19e5,5,51,5,56,5,2012-07-03 00:09:04,2012-07-02 23:08:27
2f86d853fc324cd50b4713fab50cda91803d19e5...bb3685d04ad800d4812c9d0b5c324ee9819316ed,3,45,0,45,3,2012-07-03 00:09:25,2012-07-02 20:50:28
bb3685d04ad800d4812c9d0b5c324ee9819316ed...9cd23cdee154e440a57eb78f1452b18dc196723c,3,143,9,152,4,2012-07-03 00:09:25,2012-07-02 23:00:13
9cd23cdee154e440a57eb78f1452b18dc196723c...825da30c930a7e8b824bcc355fe1564f278ca7ba,3,9,0,9,3,2012-07-03 08:15:42,2012-07-03 08:15:42
825da30c930a7e8b824bcc355fe1564f278ca7ba...61e1be3e06600312da878c63ac72bb8bc9ac9b8b,2,12,1,13,2,2012-07-03 09:03:30,2012-07-03 09:03:30
61e1be3e06600312da878c63ac72bb8bc9ac9b8b...8dc84057b2a088c6d874f508c424f5f322821458,1,9,3,12,7,2012-07-03 12:36:54,2012-07-03 09:44:44
8dc84057b2a088c6d874f508c424f5f322821458...4843a6b5a213f150712c93d8b2e86c6c95bcbf92,2,5,1,6,2,2012-07-03 13:07:30,2012-07-03 13:07:04
4843a6b5a213f150712c93d8b2e86c6c95bcbf92...2e980914dc19c7c1763cb20fb75ede0f38711b72,1,4,3,7,4,2012-07-03 14:13:29,2012-07-03 14:12:36
2e980914dc19c7c1763cb20fb75ede0f38711b72...d763ef1c9a676c43134b44fdcccddd76a55626d0,1,1,0,1,1,2012-07-03 15:40:44,2012-06-28 15:20:17
d763ef1c9a676c43134b44fdcccddd76a55626d0...67c3bf018684706aac870ff3fc5f82731fa72c61,1,12,1,13,2,2012-07-03 16:54:06,2012-07-03 16:53:46
67c3bf018684706aac870ff3fc5f82731fa72c61...e1f1c959713287df2a6f109ccb441d55d9f048cb,2,2,16,18,4,2012-07-03 17:02:16,2012-07-03 15:57:42
e1f1c959713287df2a6f109ccb441d55d9f048cb...4e368bff9af9effb1659a716be480bb1f82e3158,2,20,5,25,6,2012-07-03 17:11:54,2012-07-03 17:10:09
4e368bff9af9effb1659a716be480bb1f82e3158...19b1fafe6e7d934f7aee2192bef139afc8345d41,1,7,0,7,1,2012-07-03 17:22:01,2012-07-03 17:22:01
19b1fafe6e7d934f7aee2192bef139afc8345d41...ea24f6fe59ff6c18dc5c9cdd32cdda3aeb424e6e,5,26,4,30,9,2012-07-03 17:22:35,2012-06-29 22:36:29
ea24f6fe59ff6c18dc5c9cdd32cdda3aeb424e6e...3be6a34bbee4c9bbabf34485ebf628d850fa11ff,1,6,0,6,2,2012-07-03 20:40:45,2012-07-03 20:40:21
3be6a34bbee4c9bbabf34485ebf628d850fa11ff...744d23102ba273c5060376f152b4774a5e7f896e,1,6,2,8,3,2012-07-03 21:13:18,2012-07-03 21:12:56
744d23102ba273c5060376f152b4774a5e7f896e...ce91fa9de46717ae0d1bbbf85046558ff02f527f,1,5,11,16,5,2012-07-03 21:24:07,2012-06-29 19:22:44
ce91fa9de46717ae0d1bbbf85046558ff02f527f...45b3dae6faea0dbf223acc8e53c34eb11b071fdc,8,31,10,41,15,2012-07-03 21:24:07,2012-06-29 19:41:38
45b3dae6faea0dbf223acc8e53c34eb11b071fdc...e723a1643a6a08188417bacb53547b770705fbcf,2,17,17,34,2,2012-07-03 21:24:07,2012-06-29 19:52:48
e723a1643a6a08188417bacb53547b770705fbcf...6c43500cd82ca14ef278b20eacc7fa032b9dc034,1,23,1,24,1,2012-07-03 21:28:56,2012-07-03 21:28:19
6c43500cd82ca14ef278b20eacc7fa032b9dc034...bdc8d8617f389bbb6825046c0499396c2bc69a3a,1,0,6,6,2,2012-07-03 21:45:11,2012-07-03 20:37:51
bdc8d8617f389bbb6825046c0499396c2bc69a3a...3eb6d841ebd52e5b7ba5ea2b9b437ae8ae2da193,1,2,2,4,2,2012-07-03 21:45:11,2012-07-03 20:38:39
3eb6d841ebd52e5b7ba5ea2b9b437ae8ae2da193...01b6a30140920820ac0e7d9445de90cec335987e,3,3,35,38,6,2012-07-03 21:45:11,2012-07-03 20:39:18
01b6a30140920820ac0e7d9445de90cec335987e...5c0b3ba4ac9e940747cbc9feb51c9cd14a3c5c28,2,10,23,33,9,2012-07-03 21:45:11,2012-07-03 20:40:00
5c0b3ba4ac9e940747cbc9feb51c9cd14a3c5c28...057121832ecbf7bed6b1d83a4a3fa38b6d16143d,4,2,8,10,8,2012-07-03 21:45:12,2012-07-03 20:41:41
057121832ecbf7bed6b1d83a4a3fa38b6d16143d...1407bb116c839f88bf908595e4521fb373689e9c,7,345,61,406,33,2012-07-03 21:45:12,2012-07-03 21:27:47
1407bb116c839f88bf908595e4521fb373689e9c...dfd39b495e3bd5ab6ee7f35edaeb8f17129e7783,1,5,0,5,1,2012-07-03 21:57:30,2012-07-03 21:57:19
dfd39b495e3bd5ab6ee7f35edaeb8f17129e7783...e104c3d1fa47383b0bbee7daf188b2668ad3b75d,4,12,2,14,3,2012-07-03 22:00:07,2012-07-03 17:27:29
e104c3d1fa47383b0bbee7daf188b2668ad3b75d...ce22ca62a1163c2ddfd63d363eaa5285623ab23e,5,54,24,78,19,2012-07-03 22:52:37,2012-07-02 17:41:43
ce22ca62a1163c2ddfd63d363eaa5285623ab23e...38d752f9c7c98ccd3b67965bc1a8b85bba8c2922,7,155,14,169,29,2012-07-03 22:52:37,2012-07-03 14:11:17
38d752f9c7c98ccd3b67965bc1a8b85bba8c2922...d13d5f4016ae3857e719890e09a8aef8dd3c9a5c,3,118,10,128,8,2012-07-03 22:52:38,2012-06-25 15:54:08
d13d5f4016ae3857e719890e09a8aef8dd3c9a5c...c712d74fe40d8cf9fd60b28ef8037803d562a22a,3,87,36,123,10,2012-07-03 22:52:38,2012-06-29 20:36:41
c712d74fe40d8cf9fd60b28ef8037803d562a22a...b84d28b8bd80603ce3c47f2a230914276c1bdb32,1,6,11,17,1,2012-07-04 03:10:51,2012-07-04 03:10:51
b84d28b8bd80603ce3c47f2a230914276c1bdb32...020fec9038c510b1ab7848358c565181becc75dc,1,3,1,4,2,2012-07-04 03:19:20,2012-07-04 03:19:20
020fec9038c510b1ab7848358c565181becc75dc...dd306202cb5312fa8cbdacaefa70063c00d39e1c,1,3,3,6,2,2012-07-04 04:33:43,2012-07-04 04:33:43
dd306202cb5312fa8cbdacaefa70063c00d39e1c...f662d00f1331c85aba533b58b3714611beb9f415,1,2,2,4,2,2012-07-04 12:02:09,2012-07-04 12:02:09
f662d00f1331c85aba533b58b3714611beb9f415...8c95b8e5bd778f499293cf3bf55a8b74dcf89855,1,5,4,9,4,2012-07-05 15:24:35,2012-07-05 15:24:35
8c95b8e5bd778f499293cf3bf55a8b74dcf89855...20947d68f17948cbcba2d3daca106231a0551c6a,1,5,0,5,1,2012-07-05 16:12:20,2012-07-05 14:39:15
7f47f022739847e211dc8e054098ed8ee7c753c8...a66c6f418b40d25702d2a4f4c2064559e04666df,1,4,0,4,1,2012-07-02 15:48:50,2012-07-02 15:48:50
1f8725142aee6cd4598ff360f638055e44557bec...15624a7a7e60ce1f50fc50f6cba54398b2af17d2,92,274,222,496,203,2012-08-31 15:44:37,2012-08-02 09:55:24
15624a7a7e60ce1f50fc50f6cba54398b2af17d2...84de07ea45e206b7c92563f5cb98c570d86ee77d,2,3,2,5,2,2012-09-01 16:37:47,2012-09-01 16:37:47
84de07ea45e206b7c92563f5cb98c570d86ee77d...bed40ed0f9df2dc815df23d5437f1d8ffed5931f,3,35,0,35,4,2012-09-01 19:54:22,2012-05-07 20:32:39
bed40ed0f9df2dc815df23d5437f1d8ffed5931f...e42801cf9d3e8524146b23b5395c40b3137df794,1,1,0,1,1,2012-09-01 23:15:37,2012-09-01 23:15:37
e42801cf9d3e8524146b23b5395c40b3137df794...3f8a82f94aac4d6152038c42e5b1824dc081442c,1,4,4,8,3,2012-09-02 12:21:46,2012-09-02 12:21:46
3f8a82f94aac4d6152038c42e5b1824dc081442c...774bafebf07f662d09f0cce39c62352b8b32bc56,1,1,0,1,1,2012-09-04 15:06:37,2012-08-28 00:10:44
774bafebf07f662d09f0cce39c62352b8b32bc56...814e1526cae18e828c83ab4e6ce40ba8423cd1fe,3,98,46,144,12,2012-09-04 15:54:03,2012-08-21 21:19:11
814e1526cae18e828c83ab4e6ce40ba8423cd1fe...eef1ba232c713f2f63c9595b9a79967da4ee0ee8,2,19,60,79,13,2012-09-04 16:05:48,2012-07-06 19:46:11
eef1ba232c713f2f63c9595b9a79967da4ee0ee8...b35b8e0520d7bc5d1ac3bb96df16c311c685efe2,1,5,1,6,2,2012-09-04 16:33:28,2012-09-03 00:39:50
b35b8e0520d7bc5d1ac3bb96df16c311c685efe2...b39edab11d2af5044e399210492d49855344aa83,1,5,0,5,1,2012-09-04 17:51:04,2012-09-04 16:32:05
b39edab11d2af5044e399210492d49855344aa83...02c7231335b8e500bf810df4fdb165fbcd63dde8,1,1,1,2,1,2012-09-04 18:46:21,2012-09-04 16:19:40
02c7231335b8e500bf810df4fdb165fbcd63dde8...c4e7618b8f88beaf6e0ee7e549cccd2eec9abd27,1,3,3,6,2,2012-09-04 20:02:18,2012-08-09 22:23:42
c4e7618b8f88beaf6e0ee7e549cccd2eec9abd27...91b22ce9bbf990ea4aa67cf7371335d2e9057781,1,9,3,12,4,2012-09-04 20:06:39,2012-08-15 19:44:00
91b22ce9bbf990ea4aa67cf7371335d2e9057781...6907ccf0345bc0306fc8c077f87eb77b27b40f4f,4,54,22,76,12,2012-09-04 20:42:35,2012-09-04 17:43:12
6907ccf0345bc0306fc8c077f87eb77b27b40f4f...b4201a6ec87a1fa0b381bd77977440b7a2fef306,1,4,2,6,1,2012-09-04 20:57:39,2012-08-08 21:57:06
b4201a6ec87a1fa0b381bd77977440b7a2fef306...142f93939e6738310ef3dafab2ea063d173c1c7d,8,48,4,52,20,2012-09-05 08:13:49,2012-09-05 08:13:49
142f93939e6738310ef3dafab2ea063d173c1c7d...2076e065a7bcb9e98333232440652e77c2fc562a,1,1,1,2,1,2012-09-05 08:18:54,2012-09-03 20:06:07
2076e065a7bcb9e98333232440652e77c2fc562a...1e0cb106d3f18645d1eb5b93372f43f37ae8ff76,1,1,1,2,1,2012-09-05 08:26:21,2012-09-03 15:28:45
1e0cb106d3f18645d1eb5b93372f43f37ae8ff76...9756b2f18eb091c9e0c98caf20e28c8e66e712e7,1,2,0,2,1,2012-09-05 14:03:46,2012-09-05 14:03:46
9756b2f18eb091c9e0c98caf20e28c8e66e712e7...f0a27d72c5b41866db1b49b83e4e176e0952ea23,1,5,0,5,1,2012-09-05 14:14:04,2012-09-05 14:11:55
870c9906fc94e14a49c7e83b7b079df62c6295d4...695c67dff0ffc361b8568a13366f027caa406222,4,9,3,12,4,2011-09-11 14:09:34,2011-09-11 14:09:34
695c67dff0ffc361b8568a13366f027caa406222...f2bf86ff3fad768f35777a80556461247fbbda86,2,2,2,4,2,2011-09-12 04:02:17,2011-09-12 04:02:17
f2bf86ff3fad768f35777a80556461247fbbda86...4449aae6e4cf78bfedc69d9a080509b3f99dd166,1,1,1,2,1,2011-09-12 16:39:25,2011-09-12 16:39:02
4449aae6e4cf78bfedc69d9a080509b3f99dd166...1c064ab91579aca2a5a4634c9ad2b64386db98cd,1,42,0,42,1,2011-09-12 18:48:07,2011-09-12 16:28:31
1c064ab91579aca2a5a4634c9ad2b64386db98cd...ade41dcba82cff6ea004d9252ecf90b6a6d0443f,1,6,0,6,1,2011-09-12 18:50:30,2011-09-12 18:26:40
ade41dcba82cff6ea004d9252ecf90b6a6d0443f...692f4ec8dfbb75c5d2f5a28b70231f8f95d4b95e,1,1,1,2,1,2011-09-15 02:51:16,2011-09-15 02:51:16
692f4ec8dfbb75c5d2f5a28b70231f8f95d4b95e...2250ff90c53e486a21ee1f3f2a9de71fdd7743ca,2,15,0,15,2,2011-09-23 03:38:23,2011-09-23 03:37:41
2250ff90c53e486a21ee1f3f2a9de71fdd7743ca...fad753ee002eb823426fa6d315e688364ed60a39,1,7,2,9,1,2011-09-23 03:44:49,2011-09-23 03:44:16
fad753ee002eb823426fa6d315e688364ed60a39...1eb2d4556da2bc30f982538d60f83abb8e78b5d8,1,16,0,16,1,2011-09-23 03:47:27,2011-09-16 18:49:20
1eb2d4556da2bc30f982538d60f83abb8e78b5d8...7ce5d643a0e17b80ac8961ff962b6609948dbcf8,1,23,1,24,3,2011-09-23 03:47:52,2011-09-20 18:50:20
7ce5d643a0e17b80ac8961ff962b6609948dbcf8...99b2d74eb9e8f45fdb2b6da7e57e5faecf9b5ef3,2,32,1,33,2,2011-09-23 21:29:46,2011-09-23 20:30:45
99b2d74eb9e8f45fdb2b6da7e57e5faecf9b5ef3...b6bf498b3cdd4392ffb7c3766b2a140cd017a39d,1,1,0,1,1,2011-09-23 22:25:22,2011-09-23 22:07:56
b6bf498b3cdd4392ffb7c3766b2a140cd017a39d...a05db652579e5a4f6fefb308135b3c9cd9a06a6a,1,1,1,2,1,2011-09-26 04:40:18,2011-09-26 04:34:30
a05db652579e5a4f6fefb308135b3c9cd9a06a6a...2c34a826b61921c1635d83bf726e38acd76c2d7a,1,1,1,2,1,2011-09-26 04:55:36,2011-09-26 04:26:10
2c34a826b61921c1635d83bf726e38acd76c2d7a...44da5dff2ad30390848bca21be7ca2950c68255b,1,1,1,2,1,2011-09-26 04:55:42,2011-09-26 04:36:01
44da5dff2ad30390848bca21be7ca2950c68255b...f5f0053a1f2e7f1ed042b028f495704f985f56ad,5,78,13,91,13,2011-09-28 12:41:03,2011-09-18 21:23:28
f5f0053a1f2e7f1ed042b028f495704f985f56ad...33342ebb7646df324fb2613b44ae651a3baca0ea,1,18,6,24,2,2011-09-28 12:41:09,2011-09-20 01:38:45
33342ebb7646df324fb2613b44ae651a3baca0ea...6aee21133407fd8010b0663c56d3a2a08f580c92,1,19,13,32,2,2011-09-28 12:41:16,2011-09-23 02:34:54
6aee21133407fd8010b0663c56d3a2a08f580c92...47360db9e89f2b80a2da904181e1397e3033e4ab,2,11,5,16,4,2011-09-28 20:48:32,2011-09-28 17:10:51
47360db9e89f2b80a2da904181e1397e3033e4ab...fec06cfe915a53e5e53cd2b8e114c99814fbe436,1,6,0,6,1,2011-09-30 03:18:35,2011-09-19 17:29:37
fec06cfe915a53e5e53cd2b8e114c99814fbe436...0b2cd79560d425fd1b86c1db05e598bc400b13e8,7,33,20,53,17,2011-09-30 15:41:17,2011-09-28 21:23:22
0b2cd79560d425fd1b86c1db05e598bc400b13e8...729ad802c8df1f4537b6d1a2ddcdc9a2b697bb13,2,44,2,46,4,2011-09-30 15:41:52,2011-09-29 18:47:25
729ad802c8df1f4537b6d1a2ddcdc9a2b697bb13...4063312d6044196be67fd29c6daac8768f6f6110,1,4,5,9,4,2011-10-03 02:52:59,2011-10-03 02:51:51
4063312d6044196be67fd29c6daac8768f6f6110...3461007a7a706c9fa06b15a26ca70f5e3eaa7029,2,35,11,46,9,2011-10-04 21:37:54,2011-09-29 14:41:10
3461007a7a706c9fa06b15a26ca70f5e3eaa7029...414d14dbd83de7514584c4530bee418473923213,2,9,2,11,4,2011-10-04 21:38:10,2011-10-04 21:19:44
414d14dbd83de7514584c4530bee418473923213...59aa78ea649ac467edf9c9cecb8b5a89c3919034,1,1,1,2,1,2011-10-04 21:39:33,2011-09-29 14:54:52
59aa78ea649ac467edf9c9cecb8b5a89c3919034...671479a616924e405d25cb79581f27b934c7fcff,1,4,4,8,4,2011-10-04 22:08:54,2011-10-04 22:08:54
671479a616924e405d25cb79581f27b934c7fcff...4eff1007c98e99b0ec0c51c5da3724138f65593b,1,1,1,2,1,2011-10-06 15:29:00,2011-10-06 15:27:18
4eff1007c98e99b0ec0c51c5da3724138f65593b...afa5bc3d0e47ed9f867ea2ef40637f6f13d0fb85,1,5,4,9,3,2011-10-06 18:39:34,2011-10-06 18:38:54
afa5bc3d0e47ed9f867ea2ef40637f6f13d0fb85...6728c042dd09ecb4ec3dada8e15ffb892435f1fc,1,55,1,56,2,2011-10-09 03:19:31,2011-10-03 13:24:02
6728c042dd09ecb4ec3dada8e15ffb892435f1fc...05916b4e7125e1ddeeaaa3cb627fd74e670a6674,1,1,1,2,1,2011-10-09 03:19:37,2011-10-03 14:17:23
05916b4e7125e1ddeeaaa3cb627fd74e670a6674...f394d2c29a3a9486039a234b51e5953dddef1874,1,2,0,2,1,2011-10-09 03:22:26,2011-10-09 03:22:26
f394d2c29a3a9486039a234b51e5953dddef1874...7f6640056249134fc00166eb7029d64d65b84768,1,1,1,2,1,2011-10-09 03:29:45,2011-09-25 20:06:45
7f6640056249134fc00166eb7029d64d65b84768...17caecbd77d209202939107bbbaaf297692ac41e,1,3,2,5,2,2011-10-09 03:29:51,2011-09-26 01:34:52
17caecbd77d209202939107bbbaaf297692ac41e...8814b71b260805dd6afc0cea13acce37cf328e15,1,11,26,37,4,2011-10-09 03:32:01,2011-09-28 01:08:21
8814b71b260805dd6afc0cea13acce37cf328e15...a7796c9c09b1868bf72a28811059d448995e501c,1,5,5,10,4,2011-10-09 03:32:11,2011-09-28 02:47:11
a7796c9c09b1868bf72a28811059d448995e501c...41ff2157a3fa5b0d722043f4db2ec947481897fe,1,14,10,24,4,2011-10-09 03:32:17,2011-09-29 15:53:12
41ff2157a3fa5b0d722043f4db2ec947481897fe...56b7cf65d1e646625af6cc2b0ff5285b6fbcb322,1,6,0,6,2,2011-10-09 03:32:56,2011-09-30 15:25:22
56b7cf65d1e646625af6cc2b0ff5285b6fbcb322...35a196a13eee474f3a5b8e401507173ce885d4ed,1,1,1,2,1,2011-10-09 03:33:24,2011-09-16 18:55:54
35a196a13eee474f3a5b8e401507173ce885d4ed...0f605b5ab37adaa3caa6bfb2ff3526b8202c94dc,2,28,1,29,2,2011-10-09 03:33:49,2011-09-27 21:11:52
0f605b5ab37adaa3caa6bfb2ff3526b8202c94dc...417b9110cecf0bd7aad7e0102d104b45b28c40dc,2,9,7,16,8,2011-10-09 03:35:43,2011-10-09 03:35:43
417b9110cecf0bd7aad7e0102d104b45b28c40dc...a7a36ecbf060624a1bfcf36e0a00de02b907c019,2,7,8,15,8,2011-10-10 04:44:15,2011-10-10 04:44:15
a7a36ecbf060624a1bfcf36e0a00de02b907c019...dda9a7798659cd43e2520be0f253025c2790a6f4,1,1,1,2,1,2011-10-11 12:22:50,2011-10-11 12:22:50
dda9a7798659cd43e2520be0f253025c2790a6f4...3c02b91d0e43d9936e1806c1af070c3e744d65e8,2,2,2,4,2,2011-10-12 05:29:44,2011-10-12 05:29:44
3c02b91d0e43d9936e1806c1af070c3e744d65e8...9e8ae84247b436324c660e1825ec6c6e0b2875b5,2,2,2,4,2,2011-10-13 03:54:19,2011-10-13 03:54:19
9e8ae84247b436324c660e1825ec6c6e0b2875b5...9e642f566fcedad5f8584b09a1a7c0b37622ae88,1,7,0,7,1,2011-10-13 22:15:32,2011-10-13 22:15:32
9e642f566fcedad5f8584b09a1a7c0b37622ae88...b2910bcc5e55ee7d29f83476db0fd1c577690b71,2,38,3,41,5,2011-10-14 03:30:22,2011-10-13 16:54:44
870c9906fc94e14a49c7e83b7b079df62c6295d4...e0c993d0b918d70624430908cbbb1f1349b100c8,2,2,2,4,2,2011-09-10 23:56:56,2011-09-10 23:56:56
e0c993d0b918d70624430908cbbb1f1349b100c8...df2bdb79aa3d6a873d0cf3af5594b05b12effbdb,1,2,2,4,2,2011-09-11 00:37:04,2011-09-10 04:43:52
df2bdb79aa3d6a873d0cf3af5594b05b12effbdb...8778f43d5a6c11c6ce5f15649e15d6b39168195d,1,3,3,6,3,2011-09-12 15:56:55,2011-09-12 15:56:01
fe671eb75a2e017259b13a328f4ecfbffff73e3e...c5b1fd158175de59c5b454312328a9dfb2aefe5a,1,38,0,38,1,2011-11-07 23:09:31,2011-11-07 23:06:06
c5b1fd158175de59c5b454312328a9dfb2aefe5a...fe7f1c66ffa4490b24f5b314e918115afa353db5,1,16,0,16,1,2011-11-08 05:06:14,2011-11-08 05:06:14
fe7f1c66ffa4490b24f5b314e918115afa353db5...024f7daec490322cafabae5243fc4ca60698bf66,1,4,0,4,2,2011-11-08 14:56:42,2011-11-08 14:56:42
024f7daec490322cafabae5243fc4ca60698bf66...dc82da899b71a77e70e57e66e7f306999e3689e1,1,10,4,14,4,2011-11-08 22:42:44,2011-11-08 22:41:19
dc82da899b71a77e70e57e66e7f306999e3689e1...49317fb3114efa0c530a480ae878db1f267cfac9,1,2,1,3,1,2011-11-08 22:45:20,2011-11-08 22:45:20
49317fb3114efa0c530a480ae878db1f267cfac9...391f4e666936192f8848e048a340619f14823306,1,2,2,4,1,2011-11-09 14:02:25,2011-11-09 14:02:25
391f4e666936192f8848e048a340619f14823306...593c0ff88f1798846cf58ddac165fc67c7115525,1,5,8,13,5,2011-11-09 14:30:50,2011-11-09 14:30:50
338c743a6d5ea9635b29d5e82b26ab196f9772fa...95aeb9ed047feabcaefc61456bef2dbc6a3397e9,3,8,6,14,6,2011-10-25 21:40:52,2011-10-25 21:40:52
338c743a6d5ea9635b29d5e82b26ab196f9772fa...f0bc9f913c047bf852d19cdcfb7c76b599bfeb91,3,19,42,61,19,2011-10-25 19:01:14,2011-10-25 19:01:02
f0bc9f913c047bf852d19cdcfb7c76b599bfeb91...07f06f48b2415d0fa34dde0cfd0ed6795a0141f8,2,10,5,15,5,2011-10-25 19:16:03,2011-10-25 19:15:30
07f06f48b2415d0fa34dde0cfd0ed6795a0141f8...b92b87505a4899f4192701533584f077f9a8f5e4,1,4,1,5,2,2011-10-25 20:00:04,2011-10-25 20:00:04
b92b87505a4899f4192701533584f077f9a8f5e4...fcd4ebbc3753864970a72b8eb05352ea0712eea7,1,1,1,2,1,2011-10-25 20:01:47,2011-10-25 20:01:26
fcd4ebbc3753864970a72b8eb05352ea0712eea7...c8ae2c6c5638e5c72edefc912742ed1aa55dd6bc,1,25,2,27,2,2011-10-25 20:11:24,2011-10-25 20:11:24
c8ae2c6c5638e5c72edefc912742ed1aa55dd6bc...01a0610e69ef498137cb8b99af302662d77a6408,1,18,0,18,1,2011-10-25 20:16:53,2011-10-25 20:16:53
01a0610e69ef498137cb8b99af302662d77a6408...1f7b6cd5383ff472d522ac6df8540f04c80817cd,1,5,0,5,1,2011-10-25 20:55:00,2011-10-25 20:55:00
20947d68f17948cbcba2d3daca106231a0551c6a...a8901ef1ddffcfd9dccc9be96aacd927f81052dc,1,3,4,7,4,2012-07-05 18:56:03,2012-07-05 18:56:03
a8901ef1ddffcfd9dccc9be96aacd927f81052dc...f35e2fe831045562679babca946a581813478d47,1,1,1,2,1,2012-07-06 13:57:31,2012-07-06 13:57:31
20947d68f17948cbcba2d3daca106231a0551c6a...09f05b4e72a82a856f125e14bed7df87d8b8d0af,1,5,0,5,1,2012-07-05 17:41:12,2012-07-05 17:40:58
09f05b4e72a82a856f125e14bed7df87d8b8d0af...e53b29a1922fdb173752726c70cbb2c1bf5eac46,1,1,1,2,1,2012-07-05 17:53:58,2012-07-05 17:53:54
e53b29a1922fdb173752726c70cbb2c1bf5eac46...83551169374ded2a86838c6b72c8415adb76b1a4,8,2127,341,2468,179,2012-07-05 18:31:22,2012-06-14 16:58:05
83551169374ded2a86838c6b72c8415adb76b1a4...83418bb235520d8e2d2ee5bd2083a58aadc5eca7,3,5,8,13,7,2012-07-05 19:07:37,2012-07-05 18:49:43
83418bb235520d8e2d2ee5bd2083a58aadc5eca7...67a897f87e85de1a98647b72c5aa831dc0d66b2c,5,55,2,57,7,2012-07-05 19:25:55,2012-07-05 17:42:17
67a897f87e85de1a98647b72c5aa831dc0d66b2c...d0aa1e841770adb612bb63482def974ad341a64d,2,1,1,2,2,2012-07-05 21:03:10,2012-07-05 15:25:02
d0aa1e841770adb612bb63482def974ad341a64d...a73395b046808de8dd2f45b0c60ee6d168e827f2,2,8,19,27,3,2012-07-05 21:03:26,2012-07-05 20:33:34
a73395b046808de8dd2f45b0c60ee6d168e827f2...a50111b72deb6a06fadc09d3555a76b87dedfd20,1,1,1,2,2,2012-07-05 21:49:13,2012-07-05 21:49:13
a50111b72deb6a06fadc09d3555a76b87dedfd20...164ad756cf855aa542d33fdc9e03a780fba1fe50,2,2,2,4,2,2012-07-06 00:01:57,2012-07-06 00:01:57
164ad756cf855aa542d33fdc9e03a780fba1fe50...ed3328acc7cb26b897808f5949d2520ffb2c41ae,1,9,0,9,6,2012-07-06 04:50:13,2012-07-05 22:45:05
ed3328acc7cb26b897808f5949d2520ffb2c41ae...eac92f7a91290f823f030df0209966d50d16d3fe,1,5,2,7,3,2012-07-06 15:01:07,2012-07-06 15:00:52
eac92f7a91290f823f030df0209966d50d16d3fe...a2501496141dd6d7730d499a33adb692f03b3ba4,1,6,6,12,2,2012-07-06 15:16:22,2012-07-05 22:12:12
a2501496141dd6d7730d499a33adb692f03b3ba4...14e19a5c502ae28e9db3c61aab3d91c458c2acaf,1,6,1,7,1,2012-07-06 15:39:48,2012-07-05 21:49:52
8afb1275f3384432a1be43ae7f0e56d8d1b46365...eeb3a1226e2e38789f186a874a5cb2d91c028d48,1,0,83,83,1,2012-07-13 14:31:23,2012-07-13 14:31:23
eeb3a1226e2e38789f186a874a5cb2d91c028d48...fa1b2db53afc5e39e5c9e0b0fd31edc9f248b9ce,1,9,9,18,2,2012-07-13 16:38:49,2012-07-13 16:38:49
fa1b2db53afc5e39e5c9e0b0fd31edc9f248b9ce...479b5b9d963b4899c57a9754f824f3614a8dd941,1,1,0,1,1,2012-07-13 17:18:22,2012-07-13 17:14:25
479b5b9d963b4899c57a9754f824f3614a8dd941...5a55760e7dfa3d637c547d5d8f04719503674e7d,9,191,8,199,16,2012-07-13 18:08:15,2012-07-11 18:07:15
5a55760e7dfa3d637c547d5d8f04719503674e7d...f4280201a774a2bd966cd875a7987c371e6386e1,2,84,1,85,2,2012-07-13 19:09:42,2012-07-13 19:07:35
f4280201a774a2bd966cd875a7987c371e6386e1...ab4fd6ec2a704bacf48ab6c93bf15a7b4f588c0d,1,12,6,18,6,2012-07-13 22:06:56,2012-07-13 22:04:11
ab4fd6ec2a704bacf48ab6c93bf15a7b4f588c0d...6bea062f70ef5593a9510e17bc1dbdda6f631ce5,7,142,20,162,16,2012-07-13 23:44:08,2012-07-13 22:00:39
6bea062f70ef5593a9510e17bc1dbdda6f631ce5...0da867190d44c77ddf5ffd468c0c0028cd9e653f,6,619,239,858,40,2012-07-13 23:44:08,2012-07-13 21:57:59
0da867190d44c77ddf5ffd468c0c0028cd9e653f...7b911f25727e87105bc756ce8eb1b2a994813d75,1,1,1,2,1,2012-07-14 03:08:35,2012-07-14 03:08:35
7b911f25727e87105bc756ce8eb1b2a994813d75...286612a40cdb6000cda7efd19fe0c97c91bba10c,1,3,2,5,2,2012-07-14 03:08:43,2012-07-14 03:08:43
286612a40cdb6000cda7efd19fe0c97c91bba10c...1c03ebb8970acbc9b6990d025f28e83ebf4e939a,1,4,1,5,1,2012-07-14 03:08:53,2012-07-14 03:08:53
1c03ebb8970acbc9b6990d025f28e83ebf4e939a...317f6adf20f4e707335e10316f8f30f8a1d0e48c,1,2,1,3,1,2012-07-14 04:19:39,2012-07-14 04:19:39
317f6adf20f4e707335e10316f8f30f8a1d0e48c...156acb6223642803a616ad4c695035dddff5ac24,1,3,0,3,3,2012-07-14 05:06:20,2012-07-14 05:06:20
156acb6223642803a616ad4c695035dddff5ac24...d70bbba4dfe90d5ad52aa838e4ed762b2d8f8a13,1,3,0,3,2,2012-07-14 05:43:12,2012-07-14 05:43:12
d70bbba4dfe90d5ad52aa838e4ed762b2d8f8a13...e84a8331d93ce3cd0484174ca8e7a2f5654d7b43,1,4,1,5,1,2012-07-14 05:59:25,2012-07-14 05:59:25
e84a8331d93ce3cd0484174ca8e7a2f5654d7b43...5665ee8b85d600c0720cb1e12774f5a660afa456,1,1,1,2,1,2012-07-14 11:54:49,2012-07-14 11:54:49
5665ee8b85d600c0720cb1e12774f5a660afa456...11513316d1bdc9ad9e8a19746fb7a04c15f78b3b,7,23,13,36,17,2012-07-14 22:07:40,2012-07-14 22:07:40
11513316d1bdc9ad9e8a19746fb7a04c15f78b3b...7033636a9fad0228b0d645d689dbc8682ff566d4,1,10,0,10,1,2012-07-16 00:54:56,2012-07-16 00:54:56
7033636a9fad0228b0d645d689dbc8682ff566d4...625863dc70e450e107ecc240b9fdc24bcad3742d,1,2,0,2,1,2012-07-16 02:19:15,2012-07-16 02:19:15
625863dc70e450e107ecc240b9fdc24bcad3742d...47d00c2157f1186527f6915b20c0fa40c208a36d,1,4,0,4,1,2012-07-16 02:24:28,2012-07-16 02:21:50
47d00c2157f1186527f6915b20c0fa40c208a36d...d6a389787548657663282910e02edd59818ea162,1,18,6,24,4,2012-07-16 02:24:29,2012-07-16 02:22:03
d6a389787548657663282910e02edd59818ea162...3b8ad0c803ea0e2d3bf577e68362ddb829cff5d1,1,2,2,4,1,2012-07-16 02:24:29,2012-07-16 02:22:49
3b8ad0c803ea0e2d3bf577e68362ddb829cff5d1...6f6f99241a62f2ea1ee0c41c98adfd2c66c8da12,1,1,0,1,1,2012-07-16 14:34:19,2012-07-16 14:34:19
6f6f99241a62f2ea1ee0c41c98adfd2c66c8da12...0adc5d1cf80419559aabb974474d5edb62d6c357,1,0,4,4,4,2012-07-16 15:41:19,2012-07-16 15:40:09
0adc5d1cf80419559aabb974474d5edb62d6c357...3e54e4c81705617abc25b6b6f1b7f04103b6b7d0,2,5,2,7,4,2012-07-16 16:44:10,2012-07-16 16:40:00
3e54e4c81705617abc25b6b6f1b7f04103b6b7d0...1abe1c594323cc1ba37b65dac965287353fb8a32,1,3,0,3,1,2012-07-16 18:31:38,2012-07-16 18:31:38
1abe1c594323cc1ba37b65dac965287353fb8a32...c32b1e7c07f79b89641f32d6b68a01ea6f22b23b,1,2,3,5,2,2012-07-16 18:39:53,2012-07-16 18:39:53
c32b1e7c07f79b89641f32d6b68a01ea6f22b23b...ec9d17b67cb98c98ed2167f68d7e3a56dec96a73,1,2,1,3,1,2012-07-16 18:51:16,2012-07-16 18:51:16
ec9d17b67cb98c98ed2167f68d7e3a56dec96a73...c40669424e234a4a74dbe10d82ab76fa38ff0be2,1,7,12,19,4,2012-07-16 20:09:20,2012-07-16 18:17:23
c40669424e234a4a74dbe10d82ab76fa38ff0be2...f3ae34261a358a4ae4481c5d3ecf02d647c89fe4,1,3,0,3,1,2012-07-16 21:27:46,2012-07-16 21:21:01
f3ae34261a358a4ae4481c5d3ecf02d647c89fe4...854f9cb23075e666f58d06743f7382f3afd09914,1,2,2,4,2,2012-07-16 21:55:28,2012-07-16 21:55:28
854f9cb23075e666f58d06743f7382f3afd09914...8e26b7b5512ae87afc0ae8198325ac3a7e871273,1,1,1,2,1,2012-07-16 22:03:23,2012-07-16 22:03:23
8e26b7b5512ae87afc0ae8198325ac3a7e871273...d13d99850ea083decb00bd20a56abb5c8f3a05fe,1,4,2,6,2,2012-07-17 05:27:32,2012-07-17 05:27:32
d13d99850ea083decb00bd20a56abb5c8f3a05fe...44c371c77e73b4ceb97110593aa40cd21ef87bbf,1,4,0,4,1,2012-07-17 14:19:21,2012-07-17 14:19:21
44c371c77e73b4ceb97110593aa40cd21ef87bbf...b0b4fd2243c92ef73cf03b01866383c7d32f3504,1,10,2,12,1,2012-07-17 14:28:44,2012-07-17 14:28:26
b0b4fd2243c92ef73cf03b01866383c7d32f3504...957ef41666ef45076f779f36d6bef7ed8dd08405,2,9,2,11,2,2012-07-17 16:47:10,2012-07-16 23:33:07
957ef41666ef45076f779f36d6bef7ed8dd08405...da468fdddfeff6d7a22fd72a0a38a79e19eb61a3,5,91,67,158,28,2012-07-17 17:10:04,2012-07-16 22:43:56
da468fdddfeff6d7a22fd72a0a38a79e19eb61a3...78f93d7a3383b3eff72087f7b1a96930ddb59792,2,6,7,13,5,2012-07-17 17:10:04,2012-07-16 22:48:37
78f93d7a3383b3eff72087f7b1a96930ddb59792...5a63e3766e73a153c47af59acb5cc8941cadbbc9,2,1,5,6,3,2012-07-17 17:10:05,2012-07-17 00:24:05
5a63e3766e73a153c47af59acb5cc8941cadbbc9...527bdc4c5f251422650a3983a7d323248b91b6d5,1,4,1,5,1,2012-07-17 18:41:58,2012-07-17 18:41:39
527bdc4c5f251422650a3983a7d323248b91b6d5...33dc8445316479bbaa062db00f179fa5c39bbddb,2,2,2,4,2,2012-07-18 05:36:40,2012-07-18 05:36:40
33dc8445316479bbaa062db00f179fa5c39bbddb...c7d18420fbd1c718e545dcacbaf457537d4ca823,1,13,3,16,3,2012-07-18 18:33:25,2012-07-13 16:56:03
c7d18420fbd1c718e545dcacbaf457537d4ca823...5557ac6c7835b72da88fee5ed6d47769d6ab90d0,4,28,7,35,12,2012-07-18 19:46:15,2012-07-18 19:46:15
f0a27d72c5b41866db1b49b83e4e176e0952ea23...cebad1a2aee9b5142417f343109ac50f3d7fe70d,1,1,0,1,1,2012-09-05 14:58:25,2012-09-05 14:39:47
cebad1a2aee9b5142417f343109ac50f3d7fe70d...ad912758612956bfad01c5e4e09894adc2e265a8,5,17,22,39,8,2012-09-05 16:15:42,2012-09-05 16:15:36
ad912758612956bfad01c5e4e09894adc2e265a8...0ce3a4e9746939122833bbbe8f0d6395fa5ee25d,1,1,1,2,1,2012-09-05 19:04:32,2012-09-05 17:41:05
0ce3a4e9746939122833bbbe8f0d6395fa5ee25d...1e7734b6adb86a0bcdde97208d102ed51cb08f7f,4,14,3,17,6,2012-09-05 19:39:09,2012-09-05 19:18:18
1e7734b6adb86a0bcdde97208d102ed51cb08f7f...d0bffe83d5c9c4d15347e3ec2a61a83550e770cc,1,3,1,4,1,2012-09-05 20:58:34,2012-09-05 20:58:34
d0bffe83d5c9c4d15347e3ec2a61a83550e770cc...7c389134bd76f193fba819e83f9711b56bfab45d,1,32,11,43,10,2012-09-05 21:12:54,2012-09-05 21:11:28
7c389134bd76f193fba819e83f9711b56bfab45d...29e1815c4551f066a6d40c212941f2a9edccba20,4,36,9,45,11,2012-09-05 23:32:00,2012-09-02 22:34:09
29e1815c4551f066a6d40c212941f2a9edccba20...b6a1e54b56dff1ee4cf3e7e56ec1ae38dd77aa21,3,21,1,22,3,2012-09-05 23:32:00,2012-09-04 19:20:45
b6a1e54b56dff1ee4cf3e7e56ec1ae38dd77aa21...cefa594f3b828a5e50076913609e3b62436431c9,1,1,1,2,2,2012-09-06 14:37:35,2012-09-06 14:37:35
cefa594f3b828a5e50076913609e3b62436431c9...736cfe4115bd96ae909612ab65f9d13eba6acbe3,1,1,0,1,1,2012-09-06 19:21:27,2012-09-06 18:54:44
736cfe4115bd96ae909612ab65f9d13eba6acbe3...00f7df9fb484313af0e6091c83c4112cc1842aff,2,4,2,6,3,2012-09-07 16:38:49,2012-09-06 20:06:18
00f7df9fb484313af0e6091c83c4112cc1842aff...2eeaad837463a929e1bd3d0488cf2884687e9359,2,10,4,14,6,2012-09-07 16:38:49,2012-09-07 16:35:35
2eeaad837463a929e1bd3d0488cf2884687e9359...8fbfada4f4c87f837f459dfdf9b2142615d41a61,1,19,2,21,2,2012-09-07 18:07:34,2012-09-05 22:26:06
8fbfada4f4c87f837f459dfdf9b2142615d41a61...645aa497732e829fd43092f02102ac37cc3a8b08,1,2,2,4,2,2012-09-07 18:18:42,2012-09-07 17:16:24
645aa497732e829fd43092f02102ac37cc3a8b08...d4f46ee169f5bf3d365ed60956bd21a9c4664e97,1,36,27,63,5,2012-09-07 23:39:33,2012-09-07 18:41:06
d4f46ee169f5bf3d365ed60956bd21a9c4664e97...83a4d6c7581c84ef1cc642f4acf474087f94ecdf,1,25,4,29,7,2012-09-08 01:29:36,2012-09-07 17:52:09
83a4d6c7581c84ef1cc642f4acf474087f94ecdf...15b70ce895fd2e56d65988470854014eb735ea3d,3,47,32,79,6,2012-09-09 21:07:03,2012-09-09 21:07:03
15b70ce895fd2e56d65988470854014eb735ea3d...1f4908482e6f1899d151a0f411bc1e1a556a39ad,1,8,8,16,1,2012-09-10 12:21:00,2012-09-10 12:21:00
1f4908482e6f1899d151a0f411bc1e1a556a39ad...c88166b13bd28081f104a483a215c6cb002d6201,2,60,6,66,9,2012-09-10 13:49:18,2012-09-07 20:34:32
c88166b13bd28081f104a483a215c6cb002d6201...0ef0a87a42634aac30f0dbf225e729568de83796,6,75,12,87,9,2012-09-10 13:49:39,2012-09-04 21:12:53
0ef0a87a42634aac30f0dbf225e729568de83796...9f17d4059585e0a9f5d69ed87d8d712eab900260,2,88,0,88,2,2012-09-10 14:01:14,2012-09-08 03:01:32
9f17d4059585e0a9f5d69ed87d8d712eab900260...d989e6ee5e74f08bbd7a812c3893ca6a49049155,1,0,4,4,2,2012-09-10 14:53:28,2012-09-10 14:53:03
d989e6ee5e74f08bbd7a812c3893ca6a49049155...8708317d7155ed086b5d29d2a316d1eba2551c92,1,2,0,2,1,2012-09-10 16:46:25,2012-09-10 16:46:25
8708317d7155ed086b5d29d2a316d1eba2551c92...a977464bfe226dd466aaef73cc63949394d3e3f8,1,5,2,7,2,2012-09-10 20:31:53,2012-08-15 16:17:42
a977464bfe226dd466aaef73cc63949394d3e3f8...bbc53eca04200a1c16d8e202886e4ffe0f595759,2,4,0,4,2,2012-09-10 20:31:53,2012-09-07 20:23:07
bbc53eca04200a1c16d8e202886e4ffe0f595759...4621f058b4546b3ad41877a784e6158cc4a27c02,1,3,3,6,1,2012-09-10 20:34:42,2012-09-10 20:34:42
4621f058b4546b3ad41877a784e6158cc4a27c02...0450cf58f0a7c5cb4beb1622a8fc89f06f90674e,1,2,1,3,1,2012-09-10 21:26:02,2012-09-10 21:26:02
0450cf58f0a7c5cb4beb1622a8fc89f06f90674e...243de0b208795923fd094a7390c0a748d8b5916d,1,2,1,3,1,2012-09-10 21:36:17,2012-09-10 21:12:48
243de0b208795923fd094a7390c0a748d8b5916d...020010166327427f97a2b48f7fa216489612247c,1,33,0,33,1,2012-09-10 22:26:46,2012-09-07 22:00:41
020010166327427f97a2b48f7fa216489612247c...d780f7aa2bda5bb767e09b3632a35cd00ba45a95,1,2,2,4,2,2012-09-11 14:16:13,2012-09-11 14:16:13
d780f7aa2bda5bb767e09b3632a35cd00ba45a95...9a2f402e64cab63c6d94c6a00da0b3578830d6a8,1,2,4,6,2,2012-09-11 15:04:43,2012-09-11 15:04:43
9a2f402e64cab63c6d94c6a00da0b3578830d6a8...eb0006626a6658963e30f6efa5f29b17db79d5f8,1,20,1,21,2,2012-09-11 20:11:22,2012-08-22 21:34:48
eb0006626a6658963e30f6efa5f29b17db79d5f8...5bd5648464b5582c3b3e109f63fc1bf63c1e6148,1,4,4,8,1,2012-09-12 03:54:25,2012-09-12 03:54:25
5bd5648464b5582c3b3e109f63fc1bf63c1e6148...64429ff8c5f485b138f01fb05f2b78cb144d90ff,2,49,1,50,3,2012-09-12 03:57:37,2012-09-12 03:53:13
64429ff8c5f485b138f01fb05f2b78cb144d90ff...d0837c60d6e19f2485f652a740b325e5e5a617b6,1,1,1,2,1,2012-09-12 13:34:44,2012-09-12 13:33:33
d0837c60d6e19f2485f652a740b325e5e5a617b6...c90a18d7e2342fd8425e2ba520f491a57b25de6d,6,16,74,90,11,2012-09-12 17:53:17,2012-09-12 17:53:17
c90a18d7e2342fd8425e2ba520f491a57b25de6d...291b2e263b2ea3d578f183da7a9187c88d498d98,1,3,1,4,1,2012-09-12 22:24:23,2012-09-12 22:24:23
291b2e263b2ea3d578f183da7a9187c88d498d98...3b7bb12a556868be2082dbd9eb81431082a75d7b,2,12,8,20,4,2012-09-13 16:09:11,2012-09-13 16:09:11
3b7bb12a556868be2082dbd9eb81431082a75d7b...e4a55dd9195127c6733d8f7269eea032feafd6ea,2,19,9,28,8,2012-09-13 16:49:32,2012-09-13 15:49:26
e4a55dd9195127c6733d8f7269eea032feafd6ea...4ba934d3459b4ef7384ff55b5f2f0d20380930a1,2,2,2,4,2,2012-09-13 18:18:47,2012-09-12 15:19:22
4ba934d3459b4ef7384ff55b5f2f0d20380930a1...ca91de625f1b565f38621635f595326b70d30f37,2,86,7,93,8,2012-09-14 18:12:38,2012-09-12 16:27:20
ca91de625f1b565f38621635f595326b70d30f37...386b0fd1216879b1a61e2955ecf5a0a74dab0a40,6,396,1,397,6,2012-09-14 18:31:02,2012-09-14 18:31:02
386b0fd1216879b1a61e2955ecf5a0a74dab0a40...b35e7705df9c090fa86db8a2c1ca52437b9aeaf1,4,54,0,54,10,2012-09-14 18:51:23,2012-09-14 18:48:26
b35e7705df9c090fa86db8a2c1ca52437b9aeaf1...4578f79c0324cd133dc5bbcb1a2852c8bbc2445f,1,0,0,0,0,2012-09-14 20:45:46,2012-09-11 04:49:28
4578f79c0324cd133dc5bbcb1a2852c8bbc2445f...a6e307365918cab509812f9311aa43d9d00842aa,3,242,20,262,10,2012-09-14 20:45:46,2012-09-12 19:01:50
a6e307365918cab509812f9311aa43d9d00842aa...b63a368a5ea0df60173d6d55b8663ed56821d86c,3,35,27,62,15,2012-09-14 20:45:46,2012-09-11 17:33:12
b63a368a5ea0df60173d6d55b8663ed56821d86c...eb4fe5bec728325dc05d41c8d26e2cce08c74fdd,1,5,4,9,2,2012-09-14 21:31:26,2012-09-14 19:52:13
eb4fe5bec728325dc05d41c8d26e2cce08c74fdd...b79e7810d6cc6495b971ef645ec63adfe360d335,1,4,3,7,2,2012-09-14 22:42:53,2012-09-14 22:42:47
b79e7810d6cc6495b971ef645ec63adfe360d335...af1ed859ae68b38a46db57e1dc7eff3c6c055782,1,2,0,2,1,2012-09-15 11:20:52,2012-09-15 11:20:52
af1ed859ae68b38a46db57e1dc7eff3c6c055782...12d1566416ced349c7b584b4c0590c5c3fe2228a,1,2,2,4,2,2012-09-15 12:26:55,2012-09-15 12:26:55
12d1566416ced349c7b584b4c0590c5c3fe2228a...3b738b913f169d816cc8ea7bdf6c4c3b51812ea7,1,3,5,8,2,2012-09-17 14:13:32,2012-09-10 14:41:19
3b738b913f169d816cc8ea7bdf6c4c3b51812ea7...ace5fac55b6ec2becf3758b8bdd4039438f23745,8,674,3,677,10,2012-09-17 14:37:54,2012-09-10 14:35:08
ace5fac55b6ec2becf3758b8bdd4039438f23745...6cbd30c06c3c2dc3aa3b51b7e47d84d26caf8e53,6,84,90,174,6,2012-09-17 15:49:29,2012-09-17 15:49:24
6cbd30c06c3c2dc3aa3b51b7e47d84d26caf8e53...b90a2cd16e4f8ee9f2e181d1ac3856b1cfd8f51b,1,18,5,23,2,2012-09-17 18:03:39,2012-09-17 18:03:19
f0a27d72c5b41866db1b49b83e4e176e0952ea23...34996c0f78bff058b6d364e70b3116be88d4c84c,1,150,156,306,1,2012-09-05 14:52:57,2012-09-05 14:52:57
b2910bcc5e55ee7d29f83476db0fd1c577690b71...858d2ad0cd3ae6599ac362aa0beaa12adfe88032,1,1,1,2,1,2011-10-16 22:13:30,2011-10-16 22:08:53
858d2ad0cd3ae6599ac362aa0beaa12adfe88032...4f42dce0dbbcf507112bc35bc4b99dc54ac4e2f5,2,2,2,4,2,2011-10-17 20:11:07,2011-10-17 20:11:07
4f42dce0dbbcf507112bc35bc4b99dc54ac4e2f5...9bf70fe7519cc7b50c1e44101645cb642aedcb05,2,2,2,4,2,2011-10-18 19:01:59,2011-10-18 19:01:59
b2910bcc5e55ee7d29f83476db0fd1c577690b71...de0632c8053629ee373fa4db6ad69eb5d8bbfe3c,2,3,0,3,2,2011-10-14 15:08:51,2011-10-14 15:08:51
de0632c8053629ee373fa4db6ad69eb5d8bbfe3c...6f3f2379b972cfcee92d650302f44bf2ff5165ed,2,2,3,5,3,2011-10-14 17:03:24,2011-10-14 17:03:24
6f3f2379b972cfcee92d650302f44bf2ff5165ed...3bf3ab3bb1a03018c50115a0f00774669dc1e8f3,1,4,7,11,5,2011-10-14 22:54:17,2011-10-14 22:54:17
8778f43d5a6c11c6ce5f15649e15d6b39168195d...5fa00754cd6b6c90998113c71cce8bef5d4178da,8,9,9,18,9,2011-09-12 16:26:01,2011-09-12 16:21:22
5fa00754cd6b6c90998113c71cce8bef5d4178da...cead27e98b4ce867e729ce2f36695687cea12c53,1,42,0,42,1,2011-09-12 16:28:31,2011-09-12 16:28:31
cead27e98b4ce867e729ce2f36695687cea12c53...2f94aedb08bf68685942cf7e47ccc1ff73cf952d,1,1,1,2,1,2011-09-12 16:39:02,2011-09-12 16:39:02
2f94aedb08bf68685942cf7e47ccc1ff73cf952d...09ccdc7c7038d9397dc5f34bf71ced65403536d5,1,2,4,6,2,2011-09-12 16:50:05,2011-09-12 16:48:29
09ccdc7c7038d9397dc5f34bf71ced65403536d5...7f12a2f1cead70815e2ca3a153c56daa693336be,1,1,1,2,1,2011-09-12 17:31:46,2011-09-12 17:31:46
7f12a2f1cead70815e2ca3a153c56daa693336be...bdad14498f2f952c09d285d82d05e8722e331c5c,1,6,0,6,1,2011-09-12 18:26:40,2011-09-12 18:26:40
bdad14498f2f952c09d285d82d05e8722e331c5c...b03eb3499a4ea8303bfedb3014a9e28e9d2f3c0f,1,103,0,103,1,2011-09-12 18:46:18,2011-09-12 18:44:49
b03eb3499a4ea8303bfedb3014a9e28e9d2f3c0f...812b3dbb385c3267f918765fecd6742adda53ce9,1,26,0,26,1,2011-09-12 18:46:18,2011-09-12 18:45:33
812b3dbb385c3267f918765fecd6742adda53ce9...b3a0fdbf7e5b3ec46429479651e0b26c19bc337d,1,20,0,20,1,2011-09-12 18:46:18,2011-09-12 18:46:08
b3a0fdbf7e5b3ec46429479651e0b26c19bc337d...3c7cb7922e7bbe118f8f2fb00d9f3ac0dbdd21b9,1,6,4,10,4,2011-09-12 20:00:55,2011-09-12 20:00:37
3c7cb7922e7bbe118f8f2fb00d9f3ac0dbdd21b9...43cff65e665dcc6ffd866f324fb917e75ba31085,1,2,0,2,1,2011-09-12 21:13:14,2011-09-12 20:37:53
43cff65e665dcc6ffd866f324fb917e75ba31085...0b53c28154b8d22b0cf884f9704ae6354e4f7485,1,19,17,36,8,2011-09-12 21:13:14,2011-09-12 21:12:22
0b53c28154b8d22b0cf884f9704ae6354e4f7485...5f954259f794fc5f69706c937827d6a30ff9ab18,2,11,0,11,2,2011-09-12 22:08:27,2011-09-12 22:08:27
5f954259f794fc5f69706c937827d6a30ff9ab18...367eb8e6b47f6c3b24c8e6c1e88bdbc66b985651,2,10,4,14,2,2011-09-12 22:49:13,2011-09-12 22:49:13
367eb8e6b47f6c3b24c8e6c1e88bdbc66b985651...c131440f1545db86c6f93e727b68e04ed7f2a581,1,1,1,2,1,2011-09-13 01:47:41,2011-09-13 01:47:41
c131440f1545db86c6f93e727b68e04ed7f2a581...1740c0e1fd2d0f8cc085182b42dc34ddd9de0bd3,1,14,2,16,3,2011-09-13 02:17:51,2011-09-13 02:17:51
1740c0e1fd2d0f8cc085182b42dc34ddd9de0bd3...ab7d96f677722abb99f224578c122c6c9286a1a9,2,10,10,20,10,2011-09-13 02:19:02,2011-09-13 02:19:02
ab7d96f677722abb99f224578c122c6c9286a1a9...613bb7ba4a623670c9157c36dfe7328dac1769b7,10,285,11,296,31,2011-09-13 03:22:10,2011-08-14 01:22:45
613bb7ba4a623670c9157c36dfe7328dac1769b7...4bead9d4f56460c70108713cbc6cbef4b1c5bd68,1,0,4,4,4,2011-09-13 03:22:13,2011-08-14 16:23:35
4bead9d4f56460c70108713cbc6cbef4b1c5bd68...60bdbdff559e58b8016c7333eddd55e18943c6f9,1,1,36,37,14,2011-09-13 03:22:15,2011-08-14 16:45:04
60bdbdff559e58b8016c7333eddd55e18943c6f9...84a560fb5aca8e803224bcf10828ef0a79a88d3a,1,14,8,22,2,2011-09-13 03:22:17,2011-08-14 19:59:11
84a560fb5aca8e803224bcf10828ef0a79a88d3a...828ad7b5ffdf9c3d586b370e211422d80e8b2bee,5,85,8,93,20,2011-09-13 03:22:19,2011-08-15 01:06:50
828ad7b5ffdf9c3d586b370e211422d80e8b2bee...a689f903e6f4bd204bc00d20e31bd01a54394840,1,11,7,18,1,2011-09-13 03:22:22,2011-08-15 15:31:17
a689f903e6f4bd204bc00d20e31bd01a54394840...0bac4e3417a4508956c7cd5d399dbf67a39391e7,2,9,5,14,5,2011-09-13 03:22:24,2011-08-16 22:18:41
0bac4e3417a4508956c7cd5d399dbf67a39391e7...0b0e34a4032862aa38ae459c559d13a110b892a8,1,14,1,15,1,2011-09-13 03:22:26,2011-08-16 22:21:43
0b0e34a4032862aa38ae459c559d13a110b892a8...968bd413e950e464d55fde3b4109e36dd8024917,1,18,2,20,5,2011-09-13 03:22:29,2011-08-16 22:38:59
968bd413e950e464d55fde3b4109e36dd8024917...096362155e4a5f9cf1091fc5766020a06ca3fbf0,2,19,8,27,7,2011-09-13 03:22:31,2011-08-16 22:40:17
096362155e4a5f9cf1091fc5766020a06ca3fbf0...d1c54d5c95967db9a5bd538af47a6d4410a23509,1,9,0,9,2,2011-09-13 03:22:33,2011-08-16 22:40:40
d1c54d5c95967db9a5bd538af47a6d4410a23509...895e3e786cb0e44de5c3d193f3f18708dfb7433e,1,1,1,2,1,2011-09-13 03:22:35,2011-08-17 03:04:00
895e3e786cb0e44de5c3d193f3f18708dfb7433e...e78bc26396732b6195ff9d8d035b0481c67f2dec,5,60,42,102,15,2011-09-13 03:32:19,2011-08-18 00:28:32
e78bc26396732b6195ff9d8d035b0481c67f2dec...5995cc1d5b1a4a4a19f8e4d2e0b0be02a6a605c3,3,13,9,22,6,2011-09-13 03:32:22,2011-08-18 20:33:54
5995cc1d5b1a4a4a19f8e4d2e0b0be02a6a605c3...fe53e238717fde11aa0bea241256608368a8f320,1,4,2,6,2,2011-09-13 03:32:24,2011-08-27 00:56:11
fe53e238717fde11aa0bea241256608368a8f320...b01b0c05ad09e1237d248ffa0a017af576e3d389,1,1,1,2,1,2011-09-13 03:32:26,2011-08-27 00:56:28
b01b0c05ad09e1237d248ffa0a017af576e3d389...70e9c2000676d627e3ed30e10555d642edc33657,2,6,6,12,6,2011-09-13 03:32:29,2011-08-27 00:58:17
70e9c2000676d627e3ed30e10555d642edc33657...e916338d81df3d9f327e30de99a95d9e824658b7,1,10,10,20,1,2011-09-13 03:32:31,2011-08-27 00:59:55
e916338d81df3d9f327e30de99a95d9e824658b7...94738d6d8245e1c302d1d4d3233e6340a53701bd,3,71,2,73,4,2011-09-13 03:32:33,2011-08-27 01:01:01
94738d6d8245e1c302d1d4d3233e6340a53701bd...074ae751eafc2526a3ad59029e08eaa6e9344079,1,14,2,16,4,2011-09-13 03:32:36,2011-08-27 01:54:58
074ae751eafc2526a3ad59029e08eaa6e9344079...b619d539fbc82a0fc43977bed22731a25c51fc2b,1,0,1,1,1,2011-09-13 03:32:38,2011-09-04 01:04:51
b619d539fbc82a0fc43977bed22731a25c51fc2b...09b2ccb2870aa64a4626440ddd9155b755f7c3a1,3,8,4,12,5,2011-09-13 03:32:40,2011-09-04 01:20:43
09b2ccb2870aa64a4626440ddd9155b755f7c3a1...be2280c5c874dd4d015d7b05967cf8f653da9f7c,1,69,16,85,20,2011-09-13 03:32:43,2011-09-04 01:27:12
be2280c5c874dd4d015d7b05967cf8f653da9f7c...9c7366f47bca7639f299eab8c00d220ec514a7ca,2,7,4,11,6,2011-09-13 03:32:45,2011-09-05 23:33:46
9c7366f47bca7639f299eab8c00d220ec514a7ca...e5262a9ae0bb2379e714bf42e4a8235fb3efa49d,2,10,4,14,2,2011-09-13 03:32:47,2011-09-06 00:11:29
e5262a9ae0bb2379e714bf42e4a8235fb3efa49d...dfd9245930a1b35e90557a14df24bf23be201e8f,1,1,1,2,1,2011-09-13 03:32:50,2011-09-06 00:11:45
dfd9245930a1b35e90557a14df24bf23be201e8f...610bab3a85774d9268b4206685c8cb49517d1cc5,1,19,13,32,15,2011-09-13 03:32:52,2011-09-06 00:12:42
610bab3a85774d9268b4206685c8cb49517d1cc5...fcbd669098a188b9799896447b775f1253a6c1c3,1,1,1,2,1,2011-09-13 03:32:54,2011-09-06 01:04:37
fcbd669098a188b9799896447b775f1253a6c1c3...7d03d528a1b4f42c86adbd20f2af42425c0e5f08,1,29,22,51,7,2011-09-13 03:32:56,2011-09-06 01:06:53
7d03d528a1b4f42c86adbd20f2af42425c0e5f08...b0add6ccd24f3a7520f034457a64c963c7af3faa,1,16,16,32,10,2011-09-13 03:32:59,2011-09-06 01:07:24
b0add6ccd24f3a7520f034457a64c963c7af3faa...7d67754c9f4d38d14bfff9f2e9e094f32ea8b75f,1,15,0,15,1,2011-09-13 03:33:01,2011-09-10 14:49:06
7d67754c9f4d38d14bfff9f2e9e094f32ea8b75f...81cb3314fdf9b5edf59d85605d4349ee671dd43f,6,13,12,25,12,2011-09-13 14:15:31,2011-09-13 14:15:31
81cb3314fdf9b5edf59d85605d4349ee671dd43f...c7f12b9357c496251ae1cfcc1367d348d800a7e8,2,6,3,9,7,2011-09-13 14:25:43,2011-09-13 14:25:43
c7f12b9357c496251ae1cfcc1367d348d800a7e8...08ff338f3fbb22ce3caa93a99cf753ba3d8f3fb6,1,23,0,23,1,2011-09-13 15:38:18,2011-08-01 19:09:08
08ff338f3fbb22ce3caa93a99cf753ba3d8f3fb6...84e1c55cb4a987f7666b7b984289db15a32e976f,3,3,5,8,4,2011-09-13 15:38:18,2011-08-01 20:54:45
84e1c55cb4a987f7666b7b984289db15a32e976f...32a0818aa97932e46674634e415ae90e09e49e0e,2,11,1,12,3,2011-09-13 15:38:18,2011-08-01 21:37:44
32a0818aa97932e46674634e415ae90e09e49e0e...bc6c199001f000f7ffa1b2327f44d33b442c4fd9,1,32,0,32,1,2011-09-13 15:38:18,2011-09-12 23:20:36
bc6c199001f000f7ffa1b2327f44d33b442c4fd9...e87dd3385c01372a7bbddd69bf9d09829788caf1,3,92,32,124,9,2011-09-13 15:38:18,2011-09-12 23:58:52
e87dd3385c01372a7bbddd69bf9d09829788caf1...5410320e7c70616f3321f76859f8575a68230dd3,1,1,6,7,2,2011-09-13 15:38:19,2011-09-12 23:59:25
5410320e7c70616f3321f76859f8575a68230dd3...9cc4038d7ebaddc01a14d41bc3405a06f9fbeed6,6,69,29,98,13,2011-09-13 15:38:19,2011-09-13 05:51:36
9cc4038d7ebaddc01a14d41bc3405a06f9fbeed6...81cfb2fc942a204ce45c7e082d7805a55067e4d8,1,1,1,2,1,2011-09-13 15:38:19,2011-09-13 06:17:06
81cfb2fc942a204ce45c7e082d7805a55067e4d8...32e2fe526ff322e33de6f7bd9d21503279dd998f,2,1763,1720,3483,5,2011-09-13 15:38:20,2011-09-13 06:28:18
32e2fe526ff322e33de6f7bd9d21503279dd998f...e008357c33256185c4868292425a6ad85547f2b1,2,2,1,3,2,2011-09-13 15:38:20,2011-09-13 07:04:52
e008357c33256185c4868292425a6ad85547f2b1...7a8fa525bb65eedc027cfcbbd783a7e83f5f0319,2,21,24,45,21,2011-09-13 15:38:21,2011-09-13 07:16:54
7a8fa525bb65eedc027cfcbbd783a7e83f5f0319...44a265b7455e807c8da55324c0c0e5741cf7bfb3,1,8,0,8,2,2011-09-13 15:55:55,2011-09-13 15:55:55
44a265b7455e807c8da55324c0c0e5741cf7bfb3...0c8d23acd5f1cfe6a3768c8b009082524eeaa1b3,1,2,2,4,1,2011-09-13 16:23:50,2011-09-13 16:23:50
593c0ff88f1798846cf58ddac165fc67c7115525...741bf2b74e172903b766f94d630b6db7a23c7605,1,8,3,11,3,2011-11-09 17:58:14,2011-11-09 17:58:14
593c0ff88f1798846cf58ddac165fc67c7115525...885f82daf77bd3d183b0c2ec07893162ede7ba80,2,27,18,45,3,2011-11-09 15:44:32,2011-11-09 15:38:48
885f82daf77bd3d183b0c2ec07893162ede7ba80...5b782c8ced503d78f9783d556f92d86941ee5f91,2,11,0,11,2,2011-11-09 15:57:30,2011-11-09 15:57:30
bd8ba715c57754fcfb3b21253f6c679a68c3ccde...a7bf027f519899107432855893fa5aad3c721ddb,2,24,6,30,10,2011-10-25 23:19:23,2011-10-25 23:18:37
a7bf027f519899107432855893fa5aad3c721ddb...16d6cd06425e2adedff330ace6fc7f9bb8894708,1,8,1,9,2,2011-10-26 07:41:54,2011-10-26 07:41:54
16d6cd06425e2adedff330ace6fc7f9bb8894708...bc5547483aec15634ee9ee2be9f8ac13b70f9981,1,18,0,18,1,2011-10-26 07:42:19,2011-10-26 07:42:19
bc5547483aec15634ee9ee2be9f8ac13b70f9981...76b41b888ce890696bd3c97dda0ae2ec2f2810ed,1,1,1,2,1,2011-10-26 14:45:09,2011-10-26 14:36:00
76b41b888ce890696bd3c97dda0ae2ec2f2810ed...8c2a0eace3c603b573b9afbbeaf146b490bedecd,2,8,16,24,7,2011-10-26 17:20:11,2011-10-26 17:20:11
8c2a0eace3c603b573b9afbbeaf146b490bedecd...dfaf90e19fe821a8ced87e8bdcd996c976b0c007,2,9,1,10,4,2011-10-26 17:20:22,2011-10-26 17:20:22
da8f497f6f17050dd401ae37dfefb21f4588533b...571b5d974f90b43cbaa9618d227050d37746d419,5,23,5,28,6,2012-07-06 17:05:40,2012-07-04 00:11:04
571b5d974f90b43cbaa9618d227050d37746d419...da0e72a1004a4abd69e21b2acc5153629de8ac2e,1,11,4,15,3,2012-07-06 17:41:32,2012-07-06 16:05:44
da0e72a1004a4abd69e21b2acc5153629de8ac2e...ed97e4373956a964db22a3f4ae2561f4f6cd3d3e,5,5,6,11,5,2012-07-06 17:45:08,2012-07-05 20:04:23
ed97e4373956a964db22a3f4ae2561f4f6cd3d3e...e327b6788891bc4bcfe96459c01d8a4e784928f5,1,4,5,9,5,2012-07-06 17:45:08,2012-07-05 20:14:33
e327b6788891bc4bcfe96459c01d8a4e784928f5...f5c6734a9c89c218b36ca6f8f71e9183527ba8af,8,207,226,433,191,2012-07-06 17:45:08,2012-07-05 21:53:29
f5c6734a9c89c218b36ca6f8f71e9183527ba8af...c54bf4aa6e95776d093788c3e2b4f54c230ef1ca,3,0,298,298,7,2012-07-06 17:45:08,2012-07-05 13:54:13
c54bf4aa6e95776d093788c3e2b4f54c230ef1ca...f638676c9b6458635e8c05ea44a3771a3d08a46d,1,14,2,16,1,2012-07-06 17:45:08,2012-07-05 14:21:46
f638676c9b6458635e8c05ea44a3771a3d08a46d...b4c6a9a7c259e704093e275f2a5bb512835cb81b,1,2,2,4,1,2012-07-06 17:48:52,2012-07-06 17:48:52
b4c6a9a7c259e704093e275f2a5bb512835cb81b...09c5aff0fe4bfb0c9c3752df720e1cc3c10a23e4,4,114,5,119,7,2012-07-06 20:08:39,2012-07-05 15:54:01
09c5aff0fe4bfb0c9c3752df720e1cc3c10a23e4...6d0f04244230c2ccccedd024c5de29d063b8b084,1,3,0,3,1,2012-07-06 20:32:11,2012-07-06 20:32:11
6d0f04244230c2ccccedd024c5de29d063b8b084...c4623a61c0f1f32e92ac94f961ce9b0963a8a425,1,1,1,2,1,2012-07-06 20:45:24,2012-07-06 20:45:24
c4623a61c0f1f32e92ac94f961ce9b0963a8a425...949349dceb2b11b3c354154ea5c8b42bd3a210ad,2,8,8,16,7,2012-07-07 21:03:02,2012-07-07 13:44:44
949349dceb2b11b3c354154ea5c8b42bd3a210ad...17e5e158d7a35417fdb8adcb89ad18d1de68eedd,2,58,26,84,28,2012-07-07 21:03:02,2012-07-07 14:43:44
17e5e158d7a35417fdb8adcb89ad18d1de68eedd...ef493075bbd005c5450b661600a7bd3cb5849513,2,37,3,40,9,2012-07-09 17:20:05,2012-07-02 16:22:20
ef493075bbd005c5450b661600a7bd3cb5849513...4dbab593203cfdd74fa6d00a2088150e2be399f3,9,106,15,121,31,2012-07-09 17:20:05,2012-07-09 17:19:25
4dbab593203cfdd74fa6d00a2088150e2be399f3...6bd6f1df2c0884bfb6f282076614450fafbf1a3a,1,1,1,2,1,2012-07-09 18:48:01,2012-07-08 11:23:58
6bd6f1df2c0884bfb6f282076614450fafbf1a3a...3b0834143f69813e27cc08fca4a06a1cf1f97c5d,3,188,86,274,175,2012-07-09 18:54:59,2012-07-06 15:47:47
3b0834143f69813e27cc08fca4a06a1cf1f97c5d...a5d502527b6daf931e9ae63ac874821afa04ee30,1,9,5,14,5,2012-07-09 20:18:20,2012-07-09 20:14:41
a5d502527b6daf931e9ae63ac874821afa04ee30...9da54325e89514108956ff72099011aa6866a029,2,10,10,20,9,2012-07-09 20:18:20,2012-07-09 20:16:12
9da54325e89514108956ff72099011aa6866a029...39cb2b8ca7c931496840eafad3c36bc12472e99d,2,4,4,8,3,2012-07-09 20:18:20,2012-07-09 20:18:13
39cb2b8ca7c931496840eafad3c36bc12472e99d...1cd140e61ce33f0fb46f54332d62accaa587c67c,1,5,3,8,4,2012-07-09 20:29:35,2012-07-09 20:28:24
1cd140e61ce33f0fb46f54332d62accaa587c67c...a056a5dfd7840ad7bed1ab4ff6f9c9bc5c49885e,1,29,0,29,1,2012-07-09 21:38:28,2012-07-09 17:59:09
a056a5dfd7840ad7bed1ab4ff6f9c9bc5c49885e...02b30c6fd728a5d3f0dce5d60c74dd9c0a1d775c,2,67,1,68,3,2012-07-09 21:51:06,2012-07-09 19:08:58
02b30c6fd728a5d3f0dce5d60c74dd9c0a1d775c...c5a9bdd97ecc9a13d8593655a77c49c289e196d2,1,43,38,81,21,2012-07-09 21:55:41,2012-07-09 21:08:40
c5a9bdd97ecc9a13d8593655a77c49c289e196d2...c63594e2e06da782e4db695a36d9f932703629e3,1,1,2,3,1,2012-07-10 01:22:15,2012-07-09 16:14:19
c63594e2e06da782e4db695a36d9f932703629e3...72bb1ff4505861377d240d245b8a3396c8643cf3,1,1,1,2,1,2012-07-10 01:27:15,2012-07-10 01:27:15
72bb1ff4505861377d240d245b8a3396c8643cf3...7549b1e951259a565fdeb323a54258a260d0a8d0,1,1,1,2,1,2012-07-10 15:05:05,2012-07-10 15:05:05
7549b1e951259a565fdeb323a54258a260d0a8d0...fd8e1c9fa732f180bed2607f282fc76e45e2fd27,1,34,3,37,3,2012-07-10 15:07:48,2012-07-10 15:07:48
fd8e1c9fa732f180bed2607f282fc76e45e2fd27...c23da7989d506235fcb201f8056f44e54f4ef748,1,1,1,2,1,2012-07-10 15:13:31,2012-07-10 15:13:13
c23da7989d506235fcb201f8056f44e54f4ef748...0cd941df19c89518e7c940f40af4e06d8c5854be,1,1,1,2,1,2012-07-10 15:13:00,2012-07-09 15:36:48
0cd941df19c89518e7c940f40af4e06d8c5854be...a6989ade6202cc24c2f08afcba800dd0e31d550c,4,66,7,73,14,2012-07-10 15:13:00,2012-07-10 15:12:35
a6989ade6202cc24c2f08afcba800dd0e31d550c...a282a39254e776c2302afb48649d7027336043b2,1,1,3,4,1,2012-07-10 15:15:27,2012-07-09 16:24:35
a282a39254e776c2302afb48649d7027336043b2...60ff9c389819077a563af12ba18ce355c48568cd,6,15,15,30,15,2012-07-10 15:15:27,2012-07-10 15:10:10
60ff9c389819077a563af12ba18ce355c48568cd...1bf12d46ccff464e7799c52d7634e1594227977a,1,5,3,8,4,2012-07-10 15:22:41,2012-07-10 15:22:24
1bf12d46ccff464e7799c52d7634e1594227977a...14437a41de691351aede2efd6d73b4733e50092d,1,6,1,7,1,2012-07-10 15:32:05,2012-07-10 15:32:05
14437a41de691351aede2efd6d73b4733e50092d...455986e93daa3fbcbc7bf2e3d7e25bbb36857cef,2,11,1,12,3,2012-07-10 15:40:48,2012-07-10 15:40:09
455986e93daa3fbcbc7bf2e3d7e25bbb36857cef...f860a900877af4763324acdeb5482f01f4f33f06,1,8,7,15,3,2012-07-10 17:34:30,2012-07-10 17:34:30
f860a900877af4763324acdeb5482f01f4f33f06...9284a9a3db7ed4e94827ad1ba323a08ed559d5f4,3,75,6,81,7,2012-07-10 17:53:37,2012-07-10 17:51:19
9284a9a3db7ed4e94827ad1ba323a08ed559d5f4...3a697aa98271c470b769f5347cb164681cf20ed4,1,3,3,6,3,2012-07-10 18:41:37,2012-07-10 18:13:55
3a697aa98271c470b769f5347cb164681cf20ed4...e381b19452b49ef66b107fce7d3dd62336975f4a,1,27,0,27,1,2012-07-10 19:44:20,2012-07-10 18:10:28
e381b19452b49ef66b107fce7d3dd62336975f4a...02e409d26cd9b34eb84ca7425f1b722c34cef21b,4,59,111,170,30,2012-07-10 21:14:57,2012-07-06 21:02:59
02e409d26cd9b34eb84ca7425f1b722c34cef21b...50b1fa1e1eb47d905543bd45bce03dbb5bc4f9c1,2,20,8,28,2,2012-07-10 21:14:57,2012-07-06 21:18:34
50b1fa1e1eb47d905543bd45bce03dbb5bc4f9c1...6e7acaecc93697a9d8052db6814e17e0bf168841,1,10,11,21,5,2012-07-10 21:14:57,2012-07-07 00:09:58
6e7acaecc93697a9d8052db6814e17e0bf168841...1dd2ddb7ec093843583de6343175885a5759ab79,5,82,25,107,11,2012-07-10 21:14:57,2012-07-07 00:56:22
1dd2ddb7ec093843583de6343175885a5759ab79...111fb9e41d6fac036c71f2d43763e3c7d3d492fa,1,3,0,3,1,2012-07-10 21:14:57,2012-07-07 20:59:54
111fb9e41d6fac036c71f2d43763e3c7d3d492fa...e9d9704e00c1c669a5bd078c2e33720a9f936017,1,7,32,39,6,2012-07-10 21:14:57,2012-07-05 19:07:09
e9d9704e00c1c669a5bd078c2e33720a9f936017...6db23108b65870f654e9dc612cc9b2bbc9891b63,1,35,47,82,1,2012-07-10 21:14:57,2012-07-05 19:49:54
6db23108b65870f654e9dc612cc9b2bbc9891b63...fe6b87756b26347961d2cd94f7326c304dd8906f,4,26,42,68,9,2012-07-10 21:14:57,2012-07-06 19:56:09
fe6b87756b26347961d2cd94f7326c304dd8906f...75e0b75d84513c1c9e1408dc3d55466f1aa1cfd4,2,15,0,15,3,2012-07-10 21:14:58,2012-07-06 20:42:37
75e0b75d84513c1c9e1408dc3d55466f1aa1cfd4...19e404b191b046afbb1cc7bd369757f4ce34a1ae,1,0,0,0,0,2012-07-10 21:14:58,2012-07-10 21:13:21
19e404b191b046afbb1cc7bd369757f4ce34a1ae...28abf4c018e77e431197955ace66c7bfb8005b11,1,1,1,2,1,2012-07-10 21:14:58,2012-07-10 21:14:18
28abf4c018e77e431197955ace66c7bfb8005b11...ba2de42618c4e5092a2748ae692218a85c20ea47,2,3,3,6,3,2012-07-10 21:15:23,2012-07-10 21:15:23
ba2de42618c4e5092a2748ae692218a85c20ea47...5dcd31a8f12ab35bfbcd32d59e27065a676264f0,1,2,1,3,1,2012-07-10 21:23:31,2012-07-10 21:22:58
5dcd31a8f12ab35bfbcd32d59e27065a676264f0...b113287f27810722b09fee13d66d4ca307872d96,9,34,33,67,25,2012-07-10 21:56:28,2012-07-09 22:11:54
b113287f27810722b09fee13d66d4ca307872d96...d3570a9ea0bb5dd1f5713ddc3e4da21c2dee5afe,1,5,4,9,5,2012-07-10 21:56:28,2012-07-10 21:55:45
d3570a9ea0bb5dd1f5713ddc3e4da21c2dee5afe...781f22c175e41e30ff217aa87fe93f4c478ede38,3,8,2,10,5,2012-07-10 22:43:20,2012-07-10 00:56:26
781f22c175e41e30ff217aa87fe93f4c478ede38...10df59c5853c680d93769c94f6e82abe4c0eccb0,2,16,5,21,7,2012-07-10 23:04:05,2012-07-10 22:51:02
10df59c5853c680d93769c94f6e82abe4c0eccb0...ebcc8c1b3924e617127efa7426caa0ea585031df,3,41,9,50,6,2012-07-10 23:16:47,2012-07-09 00:40:30
ebcc8c1b3924e617127efa7426caa0ea585031df...fdf5d85618a59eac755896cb0601c48d28324d56,1,3,1,4,2,2012-07-11 04:40:05,2012-07-11 04:40:05
fdf5d85618a59eac755896cb0601c48d28324d56...14bfa6739f70046de8e3bf5e0d1d8ccd10fefdaf,1,1,1,2,1,2012-07-11 04:44:37,2012-07-11 04:44:37
14bfa6739f70046de8e3bf5e0d1d8ccd10fefdaf...3f2b168bcdc5c0910e10eb35e03147c34de8c78e,1,2,1,3,1,2012-07-11 13:23:25,2012-07-11 13:23:13
3f2b168bcdc5c0910e10eb35e03147c34de8c78e...2f5f6a8de139610e5b575913a8b999177376d163,1,3,0,3,1,2012-07-11 13:25:09,2012-07-11 13:25:09
2f5f6a8de139610e5b575913a8b999177376d163...458f0fbfeb27ca8348289dfdd15da2627d309c0b,1,2,0,2,1,2012-07-11 14:12:46,2012-07-11 14:12:46
458f0fbfeb27ca8348289dfdd15da2627d309c0b...82e6e8136a9d1422a091d6b4b721806ef568f9fb,1,9,0,9,1,2012-07-11 15:49:33,2012-07-11 14:16:59
82e6e8136a9d1422a091d6b4b721806ef568f9fb...888ab7b8b855d760da29ab3482cbbcf0fb639ab8,1,2,0,2,1,2012-07-11 15:49:33,2012-07-11 15:48:31
888ab7b8b855d760da29ab3482cbbcf0fb639ab8...3393465287fb835d1c687f7848bba73ac016cfe0,1,1,0,1,1,2012-07-11 16:30:28,2012-07-11 16:30:28
3393465287fb835d1c687f7848bba73ac016cfe0...afdf9f64446c74294cc13a3ac11b9b794cf7ae78,6,29,32,61,18,2012-07-11 17:21:28,2012-07-11 17:20:46
afdf9f64446c74294cc13a3ac11b9b794cf7ae78...cc8aa499ff55fd10dba29afe3a50d997e0c76ab2,1,1,2,3,1,2012-07-11 17:24:31,2012-07-11 17:24:31
cc8aa499ff55fd10dba29afe3a50d997e0c76ab2...de19cb41acdbdbd176e0521ad87af0916d102649,1,1,1,2,1,2012-07-11 17:38:07,2012-07-11 17:37:30
de19cb41acdbdbd176e0521ad87af0916d102649...89bc65edea295ddad64d6869cf4fa7c77434211d,1,27,18,45,2,2012-07-11 17:58:47,2012-07-11 17:58:47
89bc65edea295ddad64d6869cf4fa7c77434211d...0b42de09a94eba7af7105991214d6aa8c7d301e5,1,0,1,1,1,2012-07-11 17:59:39,2012-07-11 17:58:10
0b42de09a94eba7af7105991214d6aa8c7d301e5...f74ba19a1e773bd2cdf578c78c316bb4418dafb6,2,64,16,80,7,2012-07-11 19:24:18,2012-07-11 19:23:59
f74ba19a1e773bd2cdf578c78c316bb4418dafb6...dca801db5e2018d70a3331b9a25ec15f4efe126d,2,18,15,33,3,2012-07-11 19:52:16,2012-07-11 19:30:11
dca801db5e2018d70a3331b9a25ec15f4efe126d...e33068614c0d3fe92bd3cb031312595a3f4f3f29,2,4,4,8,3,2012-07-11 20:32:21,2012-07-11 20:32:21
e33068614c0d3fe92bd3cb031312595a3f4f3f29...7b3330420467f97d7be4602efdad875ce224745a,1,15,2,17,5,2012-07-11 22:20:13,2012-07-11 22:20:13
7b3330420467f97d7be4602efdad875ce224745a...0f29045081d94a36a2f6b494b2f2108c3f4ed4ce,1,2,2,4,2,2012-07-11 22:24:51,2012-07-11 22:24:51
0f29045081d94a36a2f6b494b2f2108c3f4ed4ce...cd76131c99e6b335b1cb305f190680debc50acac,1,1,1,2,1,2012-07-11 22:31:14,2012-07-11 22:31:14
cd76131c99e6b335b1cb305f190680debc50acac...d44927603e299acb940165d47954efc126774d4b,1,6,1,7,2,2012-07-11 23:08:37,2012-07-11 23:08:37
d44927603e299acb940165d47954efc126774d4b...2784aa1252157e2305539eec65d0fca3c9b803d1,1,1,1,2,1,2012-07-11 23:12:26,2012-07-11 23:12:26
2784aa1252157e2305539eec65d0fca3c9b803d1...78998d10520b498ebf44fde623f1fc527888b5df,1,5,0,5,1,2012-07-11 23:37:27,2012-07-11 23:37:27
78998d10520b498ebf44fde623f1fc527888b5df...cbcdc12a99bf342924f9312f669a0434630e10e8,2,29,1,30,7,2012-07-12 04:46:26,2012-07-12 04:46:09
cbcdc12a99bf342924f9312f669a0434630e10e8...64b4f8df5577acbb91d6276d1490c59d7d45252b,1,6,4,10,3,2012-07-11 19:08:33,2012-07-11 19:08:33
5557ac6c7835b72da88fee5ed6d47769d6ab90d0...d911f697f5e7a4fdfda8d9bea030e0e8280414fb,2,2,2,4,2,2012-07-19 02:34:19,2012-07-19 02:34:19
d911f697f5e7a4fdfda8d9bea030e0e8280414fb...7d82a509b3555c5215c4c9a7c6c85d0efa11605f,2,0,7,7,3,2012-07-19 08:07:05,2012-07-19 08:07:05
7d82a509b3555c5215c4c9a7c6c85d0efa11605f...16d10d43fe733d8b88ba6f3dbec81e6918f219de,4,144,26,170,6,2012-07-19 14:02:03,2012-07-13 22:44:59
16d10d43fe733d8b88ba6f3dbec81e6918f219de...dfada51be6da6dd8240a4865a4a6baa659e0205e,2,8,8,16,7,2012-07-19 14:02:03,2012-07-18 16:00:23
dfada51be6da6dd8240a4865a4a6baa659e0205e...7f3b1bc51810a76a75fefbe0db67ced933a40985,2,5,10,15,3,2012-07-19 16:50:38,2012-07-19 16:50:11
7f3b1bc51810a76a75fefbe0db67ced933a40985...0e199098d6904fba981e11a4d4ddaa6e7edef59f,1,3,3,6,3,2012-07-19 17:00:39,2012-07-19 17:00:39
5557ac6c7835b72da88fee5ed6d47769d6ab90d0...5248546455bc0d230fab5f5a13fc58a72fdb5dce,1,70,0,70,1,2012-07-18 21:52:37,2012-07-18 21:52:37
aaf69ad614166d1009b2a820185808989068b7c6...e398691aec2a351426366cf3bc1e10cfcd05ea16,2,36,5,41,5,2012-09-18 06:08:03,2012-09-18 06:08:03
e398691aec2a351426366cf3bc1e10cfcd05ea16...c5382706fad324561e431bf3baa1321d9ace9433,4,192,22,214,16,2012-09-18 15:04:48,2012-08-30 21:00:30
c5382706fad324561e431bf3baa1321d9ace9433...d89071b51774f31bc35416c077f868aa0e6dd2b5,4,22,192,214,16,2012-09-18 21:02:26,2012-09-18 21:02:26
d89071b51774f31bc35416c077f868aa0e6dd2b5...4559b1cfd80b5dc043435cec9959f113f4bb6560,2,16,4,20,6,2012-09-18 21:17:26,2012-09-18 20:23:32
4559b1cfd80b5dc043435cec9959f113f4bb6560...bde4065f5a32c12948460369b3a99d28f1ffda15,1,1,1,2,1,2012-09-18 21:22:05,2012-09-18 21:21:33
bde4065f5a32c12948460369b3a99d28f1ffda15...563d64e6f818ac0ded034e1f3a1ce62c78860df8,1,7,6,13,5,2012-09-18 23:13:08,2012-09-18 23:10:54
563d64e6f818ac0ded034e1f3a1ce62c78860df8...b62e7725b1995a15363c145ad41ff88d8a901e97,2,5,4,9,3,2012-09-19 00:13:17,2012-09-17 22:27:09
b62e7725b1995a15363c145ad41ff88d8a901e97...4cfe47b8c3c529df5cca132a007ad7d2d5b3ba29,2,34,1,35,3,2012-09-19 00:26:54,2012-09-19 00:26:54
4cfe47b8c3c529df5cca132a007ad7d2d5b3ba29...912c13195eec89e99f41385086320b326104a37a,4,595,0,595,5,2012-09-19 15:14:22,2012-09-19 15:14:02
912c13195eec89e99f41385086320b326104a37a...2b48ac27f5feae6c2bdf0ec53912870a8e2ee3e9,1,23,13,36,14,2012-09-19 15:30:24,2012-09-14 19:58:57
2b48ac27f5feae6c2bdf0ec53912870a8e2ee3e9...a9e2902d31bef518a8906f1a8ef72c2d436eaad3,1,1,1,2,1,2012-09-19 16:02:43,2012-08-28 16:16:17
a9e2902d31bef518a8906f1a8ef72c2d436eaad3...68b64f163718063114ede54c25491b73f524c587,2,127,2,129,5,2012-09-19 17:19:36,2012-09-19 17:09:58
68b64f163718063114ede54c25491b73f524c587...e6b9080df18c55065ea329bdefd1b4d8f3ac0736,1,2,2,4,2,2012-09-19 17:23:40,2012-09-19 17:23:30
e6b9080df18c55065ea329bdefd1b4d8f3ac0736...f87f384fc21f3cc928d942c76a9ed1469cba60f5,4,192,22,214,16,2012-09-19 17:32:16,2012-08-30 21:00:30
f87f384fc21f3cc928d942c76a9ed1469cba60f5...edbc802351696521265fddb30f93a35ce417c4ad,1,2,1,3,1,2012-09-19 17:45:57,2012-09-13 19:10:48
edbc802351696521265fddb30f93a35ce417c4ad...512e37fe5aa6ca9c7b84e4f82f2c4e8d78f45660,1,4,0,4,2,2012-09-19 23:04:14,2012-09-19 23:04:07
512e37fe5aa6ca9c7b84e4f82f2c4e8d78f45660...c9867164a4ca0ef6aa58f01d491da2bd937bf2e4,8,32,0,32,16,2012-09-20 14:39:03,2012-09-20 14:39:03
c9867164a4ca0ef6aa58f01d491da2bd937bf2e4...2d54d347b1efb08699acd7a02e3ab29969c773aa,3,5,3,8,4,2012-09-20 20:05:13,2012-09-19 16:53:42
2d54d347b1efb08699acd7a02e3ab29969c773aa...b659b3031e5ced047b490641dc9793620394b880,3,138,0,138,3,2012-09-20 21:17:33,2012-09-20 18:28:50
b659b3031e5ced047b490641dc9793620394b880...fda584530032dd7792789b1db6c1d88ab29c2f75,7,113,80,193,44,2012-09-20 21:17:33,2012-09-20 18:29:42
fda584530032dd7792789b1db6c1d88ab29c2f75...54d3bc66d1931701fbe972eb0a602290daa3b6fb,2,13,13,26,12,2012-09-20 21:17:34,2012-09-02 03:45:59
54d3bc66d1931701fbe972eb0a602290daa3b6fb...7e0408a17daf0b5c09a0b2d315752a958c53eda3,1,2,0,2,1,2012-09-20 21:55:51,2012-09-20 21:55:51
7e0408a17daf0b5c09a0b2d315752a958c53eda3...9b5307e02a12132ff228db4044d425544e4cc5c3,1,0,1,1,1,2012-09-21 01:00:34,2012-09-12 00:04:15
9b5307e02a12132ff228db4044d425544e4cc5c3...ac1521cf43903313bd4d4d36c95b4e5c966ac32c,5,57,9,66,16,2012-09-21 16:24:03,2012-09-21 16:24:03
ac1521cf43903313bd4d4d36c95b4e5c966ac32c...b54e14f8f6f14d1183e5d2a157853b98efedf736,1,11,11,22,10,2012-09-21 18:59:44,2012-09-21 18:59:44
b54e14f8f6f14d1183e5d2a157853b98efedf736...6df07abe328e69666b4ae732d8e38b5880a989bf,1,2,2,4,2,2012-09-21 19:58:56,2012-09-21 17:55:18
6df07abe328e69666b4ae732d8e38b5880a989bf...493858b851eebe24384c9b96b433c06c733411f8,1,11,2,13,3,2012-09-21 20:00:22,2012-09-21 19:58:58
493858b851eebe24384c9b96b433c06c733411f8...0d8d6c8cd18850233bd4f0b2b780b59fa5d22fea,1,7,7,14,1,2012-09-21 20:23:42,2012-09-21 18:26:36
0d8d6c8cd18850233bd4f0b2b780b59fa5d22fea...ec6187aee39291792ea2ffa7295996e079de9f5f,1,0,6,6,1,2012-09-21 20:32:36,2012-09-21 19:10:38
9bf70fe7519cc7b50c1e44101645cb642aedcb05...061c8ca1737f04e1ff463ceb730023320a18fcb1,1,1,1,2,1,2011-10-20 21:27:20,2011-10-20 21:27:20
061c8ca1737f04e1ff463ceb730023320a18fcb1...3a5cf0e2134a830d38d2d1aae7e88cac31bdd684,4,10,3,13,4,2011-10-22 00:52:16,2011-10-22 00:52:16
3a5cf0e2134a830d38d2d1aae7e88cac31bdd684...9c5824c948d936cf89d88c54f42d0b1e799b2299,2,2,2,4,2,2011-10-22 05:23:41,2011-10-22 05:23:41
0c8d23acd5f1cfe6a3768c8b009082524eeaa1b3...7e1e1f5a1f6b4146457405029fbbedc660817a31,3,23,18,41,9,2011-09-14 15:39:20,2011-09-14 15:39:20
0c8d23acd5f1cfe6a3768c8b009082524eeaa1b3...cf953c164861f764eb7b4333cf97e2159a08ab3d,4,37,1,38,10,2011-09-13 16:47:16,2011-08-21 02:15:37
cf953c164861f764eb7b4333cf97e2159a08ab3d...468e1dde9c309791972f0f5d576266c9d8744336,2,8,3,11,4,2011-09-13 16:47:16,2011-08-21 23:33:32
468e1dde9c309791972f0f5d576266c9d8744336...8f74943b0106144563b0b577297d5170114c8471,2,563,509,1072,113,2011-09-13 22:03:53,2011-09-13 22:03:53
8f74943b0106144563b0b577297d5170114c8471...fc49bf2a20cda1dc107f20ce857f24ab8930f5be,2,33,33,66,32,2011-09-13 22:05:45,2011-08-15 17:44:10
fc49bf2a20cda1dc107f20ce857f24ab8930f5be...75f2d53c1f0667e9b5cfab2ecfe71e22f1d6742d,2,16,1,17,4,2011-09-13 22:54:38,2011-09-13 22:54:38
75f2d53c1f0667e9b5cfab2ecfe71e22f1d6742d...de3f4323f985b80dd781c7ebaea0e1593b9e135b,2,22,13,35,10,2011-09-14 14:47:25,2011-09-14 14:47:25
0b418323fec8f3e23d77eb2f50036385831a6d0f...d84274ed6ecaa79ea3dfeaedf700c8360709cfb3,1,10,4,14,4,2011-11-10 17:10:19,2011-11-10 17:10:19
0b418323fec8f3e23d77eb2f50036385831a6d0f...b063594e10b2024c7e39827c4409a0d82462a4e9,1,1,1,2,2,2011-11-09 20:58:38,2011-11-07 23:13:36
b063594e10b2024c7e39827c4409a0d82462a4e9...f2d426df7031ea8aa85ae967b9165851507dcd31,4,182,44,226,35,2011-11-09 23:06:10,2011-11-08 00:36:33
f2d426df7031ea8aa85ae967b9165851507dcd31...72dcc0b296306fc432f52ada8eedf4814c791b68,2,10,5,15,3,2011-11-09 23:45:57,2011-11-09 23:45:29
72dcc0b296306fc432f52ada8eedf4814c791b68...f786c8ef387d19281dd9e2a86d034c71730865cb,1,1,1,2,1,2011-11-10 04:07:21,2011-11-10 04:07:21
f786c8ef387d19281dd9e2a86d034c71730865cb...df07b8f53c14551ab02b5a8aad0866b97f8aa87d,1,4,4,8,2,2011-11-10 16:09:13,2011-11-10 16:09:13
dfaf90e19fe821a8ced87e8bdcd996c976b0c007...3844dd29f85f57ef4e757db0b7ce22920bafa76e,8,78,14,92,18,2011-10-26 19:27:19,2011-10-26 19:27:19
dfaf90e19fe821a8ced87e8bdcd996c976b0c007...d6ed70b4f87820c1a6b66c6499ef2c1b361d3e82,1,8,9,17,2,2011-10-26 17:50:40,2011-10-26 17:39:43
64b4f8df5577acbb91d6276d1490c59d7d45252b...d8a7ced9ca0066f5e4f1679dba8b6e83cd5939b0,2,56,0,56,2,2012-07-12 18:14:38,2012-07-12 18:14:38
64b4f8df5577acbb91d6276d1490c59d7d45252b...e59bd0f8cf3ec6409628a7e8fd4b5c8ef90b0886,1,4,9,13,5,2012-07-12 15:53:30,2012-07-12 15:53:30
a00eb48047afa6b936e6bb62d426473766d0c81f...89e640f8ad9de84c0735dbbb862b5abab4574f02,3,0,162,162,4,2012-07-19 18:27:20,2012-07-19 01:00:05
89e640f8ad9de84c0735dbbb862b5abab4574f02...2a21b2f2802a78d194a1edce2f7005245e065dc1,1,26,0,26,1,2012-07-19 18:27:21,2012-07-19 01:01:03
2a21b2f2802a78d194a1edce2f7005245e065dc1...7d1e8a5090569d4d30bd3ec0dfb76e62baf4f304,2,12,2,14,4,2012-07-20 20:54:33,2012-07-13 00:43:07
7d1e8a5090569d4d30bd3ec0dfb76e62baf4f304...ec18db98680d31b120350ad45d5f74095125e9a5,15,373,554,927,105,2012-07-20 21:54:22,2012-07-14 19:04:12
ec18db98680d31b120350ad45d5f74095125e9a5...6226f70bf6967d87885d2da4f6129404ab238ce7,8,111,72,183,29,2012-07-20 22:01:35,2012-07-17 00:44:07
6226f70bf6967d87885d2da4f6129404ab238ce7...d68b576ba0b77b4b5debf9af239f52c430613c19,6,76,51,127,13,2012-07-20 22:01:43,2012-07-17 01:29:06
d68b576ba0b77b4b5debf9af239f52c430613c19...3e81903a1c824560c3cb77f7b6d6d6cd24860d74,5,52,3,55,11,2012-07-20 22:11:31,2012-07-17 21:04:43
3e81903a1c824560c3cb77f7b6d6d6cd24860d74...94a0643a83b063678907c767a62066679f618981,19,13,404,417,49,2012-07-20 22:16:38,2012-07-17 21:18:49
94a0643a83b063678907c767a62066679f618981...ef878b16bc24fa4667c2ec367200b49df3ebcd94,2,5,42,47,8,2012-07-20 22:18:35,2012-07-19 23:52:01
ef878b16bc24fa4667c2ec367200b49df3ebcd94...dc0b517d81bc01565e3819493c7379182b5625b3,7,102,5,107,13,2012-07-20 22:49:19,2012-07-09 19:55:14
dc0b517d81bc01565e3819493c7379182b5625b3...1e8295b09fac8fce5c8d0cf795594826b63d8424,1,1,2,3,3,2012-07-23 08:43:35,2012-07-23 08:43:35
1e8295b09fac8fce5c8d0cf795594826b63d8424...f0eb14ac75719bb6bb17a8396f95c1030a8724cf,1,1,9,10,2,2012-07-23 14:48:08,2012-07-23 14:48:08
f0eb14ac75719bb6bb17a8396f95c1030a8724cf...0bd94c7513166f47157f48112079160ea1db15b1,1,2,0,2,1,2012-07-23 14:51:11,2012-07-20 17:15:19
0bd94c7513166f47157f48112079160ea1db15b1...f1564284ba6c5801bc9b6e6d9f8299605725a715,10,20,214,234,33,2012-07-23 14:53:34,2012-07-17 14:45:21
f1564284ba6c5801bc9b6e6d9f8299605725a715...e40c25fc61b0c3db0d6fdfab414ad5d0e5da4d19,1,1,1,2,1,2012-07-23 15:29:20,2012-07-23 15:29:17
e40c25fc61b0c3db0d6fdfab414ad5d0e5da4d19...bd766a5148717e236285799cc49e62ed7fea1d60,2,23,9,32,6,2012-07-23 15:42:28,2012-07-23 15:40:38
bd766a5148717e236285799cc49e62ed7fea1d60...a3affc7e65e47b6919e1ee6436582bd2bae4792d,6,4,16,20,10,2012-07-23 19:40:04,2012-07-23 19:40:04
a3affc7e65e47b6919e1ee6436582bd2bae4792d...01389e7f3235a413002b57b727613532995bd489,1,1,1,2,1,2012-07-23 19:42:40,2012-07-23 18:42:15
01389e7f3235a413002b57b727613532995bd489...d1f30eece946361b789812353e2ec2cd546c82ee,5,301,99,400,35,2012-07-24 15:48:00,2012-07-17 17:55:20
d1f30eece946361b789812353e2ec2cd546c82ee...4b497d5a05e4ce80b0cd275e2e53ca82b8411e22,1,1,1,2,1,2012-07-24 15:56:09,2012-07-06 22:18:38
4b497d5a05e4ce80b0cd275e2e53ca82b8411e22...55f708333231bd11120e32f9ca364e406f001d99,2,4,3,7,3,2012-07-24 15:56:09,2012-07-06 21:40:38
55f708333231bd11120e32f9ca364e406f001d99...85044432be8067c764349cfb64d1c595527d9d54,1,4,1,5,2,2012-07-24 16:01:38,2012-07-20 18:36:14
85044432be8067c764349cfb64d1c595527d9d54...5b3d2178975bdae2ca67df14cd4a6bcd93203d8b,1,28,20,48,3,2012-07-24 16:01:42,2012-07-20 18:37:26
5b3d2178975bdae2ca67df14cd4a6bcd93203d8b...6dbeb708c8a5d316d790a59e12513f903e4b6287,1,5,24,29,6,2012-07-24 16:01:42,2012-07-20 18:38:16
6dbeb708c8a5d316d790a59e12513f903e4b6287...e91b8eab100133b40a9f0cc2a790fcfbfa925fe8,1,107,0,107,1,2012-07-24 16:10:05,2012-07-24 16:02:39
e91b8eab100133b40a9f0cc2a790fcfbfa925fe8...249f2211dabf7b23899449c97e91b178fb7cac71,1,1,1,2,1,2012-07-24 16:22:14,2012-07-19 15:06:35
249f2211dabf7b23899449c97e91b178fb7cac71...f24559cf41ca1b9095aec7fc9aa97a8087138bef,1,14,4,18,5,2012-07-24 16:32:24,2012-07-23 22:09:44
f24559cf41ca1b9095aec7fc9aa97a8087138bef...ee1387026cb918a7b9b5dda47a791ea4e3643a41,1,2,2,4,2,2012-07-24 18:22:20,2012-07-24 18:22:20
ee1387026cb918a7b9b5dda47a791ea4e3643a41...6700f1ed58618dbae8e4add1a8f5e87400502bca,1,20,7,27,5,2012-07-24 19:08:49,2012-07-23 20:10:55
6700f1ed58618dbae8e4add1a8f5e87400502bca...3bb2070858b50453923038e2fe9e2797a2e8d035,6,73,4,77,7,2012-07-24 19:08:49,2012-07-23 21:43:40
3bb2070858b50453923038e2fe9e2797a2e8d035...d8e2c96a504a77f732b8f59ad956a6e033c5f1fd,2,511,1,512,3,2012-07-24 19:08:50,2012-07-19 21:32:51
d8e2c96a504a77f732b8f59ad956a6e033c5f1fd...297a506a2efc5eb30cfd490f3941644d9c2538d4,3,1258,2,1260,3,2012-07-24 19:08:50,2012-07-23 04:40:19
297a506a2efc5eb30cfd490f3941644d9c2538d4...bf6ee41c1bcf2b456c872b1417591d6f80f43e32,3,354,2,356,6,2012-07-24 19:08:51,2012-07-23 18:21:10
bf6ee41c1bcf2b456c872b1417591d6f80f43e32...6c772729d46ac0d8024947842adde9940f769725,1,1080,0,1080,1,2012-07-24 19:08:51,2012-07-23 18:21:39
6c772729d46ac0d8024947842adde9940f769725...ace93c13920d6577b53a5547bbe895f89db55717,1,2,0,2,2,2012-07-24 21:23:04,2012-07-24 21:23:04
ace93c13920d6577b53a5547bbe895f89db55717...076139589fbbb7f55b0b1b7a2c7619ce49af4de6,2,81,1,82,3,2012-07-24 21:53:30,2012-07-24 20:05:08
076139589fbbb7f55b0b1b7a2c7619ce49af4de6...21803bd5cf01416fa89691fdd7c08e80f97d8b5b,1,4,4,8,3,2012-07-24 22:16:06,2012-07-24 22:15:51
21803bd5cf01416fa89691fdd7c08e80f97d8b5b...d67cf16e616a888be641a548ca132353ca427919,2,133,1,134,7,2012-07-24 22:21:58,2012-07-23 17:58:38
d67cf16e616a888be641a548ca132353ca427919...a47a1d9a5c2c36b723c4604668ab45781d241d16,1,47,9,56,7,2012-07-24 22:23:16,2012-07-24 20:52:48
a47a1d9a5c2c36b723c4604668ab45781d241d16...eb9b36bf94115dd8f834915df8f9c8249f0336e3,1,1,0,1,1,2012-07-24 22:23:16,2012-07-24 20:54:14
eb9b36bf94115dd8f834915df8f9c8249f0336e3...7525d654b9b741be6848a8eac29b6c69b3ee2a03,1,2,0,2,2,2012-07-24 22:25:14,2012-07-24 22:25:01
7525d654b9b741be6848a8eac29b6c69b3ee2a03...2724a08f46f492bddf5add33e94d5c0b30e2af33,1,1,1,2,1,2012-07-24 23:07:47,2012-07-24 23:04:13
2724a08f46f492bddf5add33e94d5c0b30e2af33...e0beb0053943af6b7caf4cc6bf5319e089ad03d7,1,2,2,4,2,2012-07-24 23:47:37,2012-07-24 23:27:16
e0beb0053943af6b7caf4cc6bf5319e089ad03d7...7bc2734972cf5afaf3f4fa6956e31c6d6c1ee1a4,1,10,26,36,9,2012-07-25 02:42:57,2012-07-24 23:30:09
7bc2734972cf5afaf3f4fa6956e31c6d6c1ee1a4...73b97070259a0e30d5ed35880b11b32078620e42,3,6,4,10,4,2012-07-25 06:27:25,2012-07-25 06:27:25
73b97070259a0e30d5ed35880b11b32078620e42...d6fa8cd89d0e2bb4c1bda0b2f13eed74cd85ab49,2,1,133,134,7,2012-07-25 14:03:23,2012-07-25 14:03:23
d6fa8cd89d0e2bb4c1bda0b2f13eed74cd85ab49...263f86297abfc5612a65e7bcbd23b771f4e26995,2,1,81,82,3,2012-07-25 14:03:47,2012-07-25 14:03:47
263f86297abfc5612a65e7bcbd23b771f4e26995...deeb1d5b2757703bdd928686f83d2cea32cc125e,1,6,3,9,3,2012-07-25 14:52:03,2012-07-25 14:51:38
deeb1d5b2757703bdd928686f83d2cea32cc125e...bc1bd6b98c18cc38222364fc90123ea14189d170,1,3,2,5,2,2012-07-25 15:15:09,2012-07-25 15:14:55
ec6187aee39291792ea2ffa7295996e079de9f5f...aa36e3b343c3a3c23a773e587ab67184e66c9161,1,4,2,6,1,2012-09-23 10:40:22,2012-09-21 19:45:46
9fa387e6f0b8e3192dcd10f636a8912568a5b02c...b81ad0bae002722e6da29c92dd47f46657b40603,1,4,2,6,2,2011-10-23 05:27:01,2011-10-12 16:36:22
b81ad0bae002722e6da29c92dd47f46657b40603...f6c73c58a5ca914837fbb3a449ccc8d17ec8bd71,1,1,1,2,1,2011-10-24 03:54:46,2011-10-24 03:34:27
f6c73c58a5ca914837fbb3a449ccc8d17ec8bd71...774ba877171476e605c59f0b49278ffe25c462bf,4,78,57,135,16,2011-10-24 03:54:58,2011-10-19 16:13:04
774ba877171476e605c59f0b49278ffe25c462bf...ccc60a09489abd279d5ee2270ff043c581fa8192,1,7,6,13,3,2011-10-24 14:23:24,2011-09-19 17:06:04
ccc60a09489abd279d5ee2270ff043c581fa8192...f74345924b6e2381f351337312401539d3156591,1,29,17,46,7,2011-10-24 18:45:25,2011-10-05 20:49:20
f74345924b6e2381f351337312401539d3156591...e65e110553c725939f0706ca42a952855fea388b,9,303,89,392,31,2011-10-24 19:00:33,2011-10-05 20:55:55
e65e110553c725939f0706ca42a952855fea388b...d04d7d118bbed1b532a9f7ade2d064df0b0934bd,1,1,1,2,1,2011-10-24 19:02:33,2011-10-08 00:51:10
d04d7d118bbed1b532a9f7ade2d064df0b0934bd...db49a5ce19d595dac41900551781406c82e99ebe,1,4,0,4,1,2011-10-25 04:02:19,2011-10-24 19:20:03
db49a5ce19d595dac41900551781406c82e99ebe...de05cdff5373ff6d179e16320b39ff41ee55f185,1,1,0,1,1,2011-10-25 04:02:58,2011-10-24 22:18:52
de05cdff5373ff6d179e16320b39ff41ee55f185...0c382de5881ff04a88c3744ef8bb77cf20d94af2,1,16,5,21,4,2011-10-25 04:03:31,2011-10-17 21:02:25
0c382de5881ff04a88c3744ef8bb77cf20d94af2...267bb38b549275200ecb1b17e5c3f351b0896e83,1,3,1,4,2,2011-10-27 18:15:54,2011-10-27 18:15:17
267bb38b549275200ecb1b17e5c3f351b0896e83...65e38831febfbb8b87cd610e05ecc66aa4b1db30,1,7,1,8,1,2011-10-29 05:15:44,2011-10-29 05:14:46
65e38831febfbb8b87cd610e05ecc66aa4b1db30...3e599665f80b6e40bffa1ff7e293d7f92a8f5149,4,10,10,20,10,2011-11-01 01:09:54,2011-10-20 17:44:36
3e599665f80b6e40bffa1ff7e293d7f92a8f5149...d11ede1282801d3b7acca1d8de21627b14a44762,5,102,30,132,13,2011-11-01 01:10:01,2011-10-24 21:35:51
d11ede1282801d3b7acca1d8de21627b14a44762...ebdb2b61f308b4bee2252b2a7effa047b2c71205,1,1,1,2,1,2011-11-01 01:12:32,2011-10-24 21:48:28
ebdb2b61f308b4bee2252b2a7effa047b2c71205...975be960bb8617723b93c971d2f2afdc74550146,1,16,7,23,4,2011-11-01 04:56:47,2011-11-01 04:56:17
975be960bb8617723b93c971d2f2afdc74550146...897466810d7b883fd71792d4fd51d220026dabcf,1,9,5,14,3,2011-11-01 12:05:47,2011-11-01 12:05:47
897466810d7b883fd71792d4fd51d220026dabcf...c74b40f65ae1f88369bce99fe873516f77cbe4cc,1,4,3,7,2,2011-11-01 17:17:52,2011-11-01 17:11:38
c74b40f65ae1f88369bce99fe873516f77cbe4cc...5862ea06eb2bd22e8ab914f22eb1ca2aefd537de,1,1,1,2,1,2011-11-01 17:17:53,2011-11-01 16:45:34
5862ea06eb2bd22e8ab914f22eb1ca2aefd537de...f275d3202ad6dbebad032d20de4b0d1455b2efef,1,17,4,21,4,2011-11-01 21:32:46,2011-11-01 21:32:46
f275d3202ad6dbebad032d20de4b0d1455b2efef...aede6b131dceec59294500b7d73fe7d559e64ad0,1,7,16,23,4,2011-11-01 22:06:18,2011-11-01 22:06:18
aede6b131dceec59294500b7d73fe7d559e64ad0...bcf4ca44072d45f4e8d87a3341350596ef54bff2,1,1,1,2,1,2011-11-01 22:42:28,2011-11-01 22:26:05
bcf4ca44072d45f4e8d87a3341350596ef54bff2...4514def09a5ba6558440acb3186f549687534a9a,1,6,5,11,3,2011-11-03 13:59:28,2011-11-02 05:23:32
4514def09a5ba6558440acb3186f549687534a9a...4b1ac7b2b6ddcc98f449e56c1580d7f91f4abefd,1,2,1,3,1,2011-11-07 07:44:07,2011-11-02 14:50:45
4b1ac7b2b6ddcc98f449e56c1580d7f91f4abefd...04ba3d198ab5eed8cd604d6fe18b753ae050108a,1,6,3,9,4,2011-11-07 17:06:08,2011-11-02 16:58:25
04ba3d198ab5eed8cd604d6fe18b753ae050108a...e76f5276870cf3d9be5cbfc8aeb55d2c209d9ae1,1,42,0,42,1,2011-11-07 17:52:24,2011-11-07 15:57:24
e76f5276870cf3d9be5cbfc8aeb55d2c209d9ae1...0f6d8d7e4c9008bbaa5852a83970778283d6656b,1,10,2,12,1,2011-11-08 00:06:16,2011-11-02 14:38:08
0f6d8d7e4c9008bbaa5852a83970778283d6656b...3e5d0e345bea106e5fb5fd5c7990dc5af7c58ba5,1,4,0,4,2,2011-11-08 14:57:11,2011-11-08 14:56:42
3e5d0e345bea106e5fb5fd5c7990dc5af7c58ba5...d2feeb87c806e9649c79cb229261592225282bba,1,10,3,13,2,2011-11-08 18:31:56,2011-11-02 18:01:10
d2feeb87c806e9649c79cb229261592225282bba...50349cb7601adac56b9aad94bf3a4489533abaf2,3,15,44,59,15,2011-11-09 15:10:46,2011-11-04 20:10:09
50349cb7601adac56b9aad94bf3a4489533abaf2...6cea95fbf5f2bff8809ee9a001ca680460d86a0f,2,28,31,59,12,2011-11-09 21:33:39,2011-11-09 21:33:39
6cea95fbf5f2bff8809ee9a001ca680460d86a0f...d42cf0df2b760e7a5ff04d39312c44715d580187,2,205,0,205,3,2011-11-10 16:27:32,2011-09-14 20:23:56
d42cf0df2b760e7a5ff04d39312c44715d580187...bc9d59f5db73efcb6556ee46fe75e45e351fe13d,1,4,4,8,2,2011-11-10 16:28:00,2011-11-10 16:09:13
bc9d59f5db73efcb6556ee46fe75e45e351fe13d...cc5021feda652b763060ec94a2142a300d86caad,1,2,3,5,2,2011-11-10 17:07:32,2011-11-10 17:07:32
cc5021feda652b763060ec94a2142a300d86caad...d1854d7b70c8b5e02a65ca71ee877a463ac35ca7,1,1,0,1,1,2011-11-10 20:00:29,2011-11-10 20:00:29
d1854d7b70c8b5e02a65ca71ee877a463ac35ca7...e5cd12cde3104326e9572880a0a4fbaded04d612,1,8,0,8,1,2011-11-10 23:38:30,2011-11-10 23:38:30
e5cd12cde3104326e9572880a0a4fbaded04d612...340048ba58d661f386bd80fa0685651a31e70b13,1,11,3,14,5,2011-11-11 17:01:45,2011-11-04 17:32:17
340048ba58d661f386bd80fa0685651a31e70b13...e6e308d2c0a58e6a773a63d93120de6670aa54f4,1,14,1,15,2,2011-11-11 17:02:01,2011-11-04 19:28:44
e6e308d2c0a58e6a773a63d93120de6670aa54f4...154f5545b6c6708146d0215408b4029e72a021dd,5,79,73,152,38,2011-11-14 16:23:29,2011-11-14 16:23:29
154f5545b6c6708146d0215408b4029e72a021dd...0f14f054c2cc5985a372469c009beea21af67ce8,1,11,12,23,6,2011-11-14 16:24:31,2011-11-12 16:06:30
0f14f054c2cc5985a372469c009beea21af67ce8...d4ba20e72751af8982ef1318cd3e61fa17f67fed,1,2,1,3,1,2011-11-14 20:49:58,2011-11-14 20:49:24
d4ba20e72751af8982ef1318cd3e61fa17f67fed...58a501e059ba633bc6e331a8114638ac6fba2ac0,1,1,0,1,1,2011-11-14 20:51:35,2011-11-07 22:41:24
58a501e059ba633bc6e331a8114638ac6fba2ac0...8723be4f957441b3ce5938c6059ed838a51c46f3,1,6,0,6,2,2011-11-14 20:55:05,2011-11-14 20:55:05
8723be4f957441b3ce5938c6059ed838a51c46f3...84a3d7aa3dcb9aef261a365daa862d82d1ba513e,2,15,2,17,7,2011-11-15 17:36:52,2011-09-19 19:07:04
84a3d7aa3dcb9aef261a365daa862d82d1ba513e...b9e8ac58d22612acabd534ccc17ebf503370e752,1,4,5,9,3,2011-11-15 20:06:43,2011-11-15 20:06:43
b9e8ac58d22612acabd534ccc17ebf503370e752...771f7f7dd6a6c5634b5990572f89bdd4b1849182,1,1,0,1,1,2011-11-16 17:34:39,2011-11-16 17:32:42
771f7f7dd6a6c5634b5990572f89bdd4b1849182...a695bea89c338f6f458abc258eee16f415edeae1,3,24,1,25,3,2011-11-16 18:07:32,2011-09-29 16:22:30
a695bea89c338f6f458abc258eee16f415edeae1...e82af25e9cf6a5dd2883506fae938e4b39560ae6,4,48,13,61,10,2011-11-16 18:17:32,2011-11-16 18:17:32
e82af25e9cf6a5dd2883506fae938e4b39560ae6...7e3de32bcced4805b6b4a005f44714a88f504d4a,2,11,1,12,3,2011-11-16 21:11:39,2011-11-16 20:36:13
7e3de32bcced4805b6b4a005f44714a88f504d4a...ada33ce4be46e634e8ac9b727167b2173f90f5c8,2,2,2,4,2,2011-11-17 16:52:18,2011-11-17 16:52:18
ada33ce4be46e634e8ac9b727167b2173f90f5c8...3a57f18f763ee0628badf8375dc41add957eaa67,2,2,2,4,2,2011-11-18 06:42:39,2011-11-18 06:42:39
3a57f18f763ee0628badf8375dc41add957eaa67...163a0ede78d1dcbde86346248ff993db876f2a03,2,30,6,36,4,2011-11-21 06:01:33,2011-11-20 07:29:13
163a0ede78d1dcbde86346248ff993db876f2a03...f48ecaa2c6deceff2df9b8b0d7d266d9ae5b3aef,2,25,2,27,6,2011-11-21 06:01:43,2011-11-20 08:12:55
f48ecaa2c6deceff2df9b8b0d7d266d9ae5b3aef...415486ce5cdc82ab1f8b2f8db92a197535e31d61,1,51,0,51,1,2011-11-21 06:01:49,2011-11-20 08:13:32
415486ce5cdc82ab1f8b2f8db92a197535e31d61...c0588190d401824422ca6c9a0c9744cfcb62e9a1,3,46,3,49,8,2011-11-21 06:02:06,2011-11-21 05:27:20
c0588190d401824422ca6c9a0c9744cfcb62e9a1...d69d52ceef293c7888eb9c507dacf40a48b8abe0,1,5,0,5,1,2011-11-21 18:13:17,2011-11-21 18:12:27
5fde300d90bd58b363562ec9064160b606dc6f6a...e110285281c0fb03c21b292d4321aa84580446f1,2,2,2,4,2,2011-09-14 16:00:54,2011-09-14 16:00:54
e110285281c0fb03c21b292d4321aa84580446f1...7c46fb9ad35c1a29462e6c808986ea45d8486280,4,83,13,96,12,2011-09-14 19:31:26,2011-09-13 21:58:02
7c46fb9ad35c1a29462e6c808986ea45d8486280...2b8753551ade7c9950187473f31075d8c6070e7f,2,14,1,15,3,2011-09-14 19:31:26,2011-09-14 19:31:03
2b8753551ade7c9950187473f31075d8c6070e7f...411236f3abe2663d62e5e3100dd3e6b286c2ac6d,1,83,0,83,4,2011-09-14 19:41:51,2011-09-08 22:49:58
411236f3abe2663d62e5e3100dd3e6b286c2ac6d...9f4f53c3c781fb2d71511620f213ef43b32f1720,1,11,1,12,1,2011-09-14 19:41:51,2011-09-14 18:39:48
9f4f53c3c781fb2d71511620f213ef43b32f1720...10ab1ed6291d85c056f9989db3e5f557374e324b,2,205,0,205,3,2011-09-14 20:24:35,2011-09-14 20:23:56
10ab1ed6291d85c056f9989db3e5f557374e324b...b88b810d28fc0060e3405702dcb492dfe9355af2,2,207,1,208,5,2011-09-14 21:57:47,2011-09-14 21:57:47
b88b810d28fc0060e3405702dcb492dfe9355af2...19a94b8d2db9d2d028cdedba965dc4cae127a692,1,34,0,34,1,2011-09-14 22:23:33,2011-09-14 22:03:38
19a94b8d2db9d2d028cdedba965dc4cae127a692...d280fd8c0b0884a3fd1194743d58b1ba828132fe,2,17,0,17,4,2011-09-14 22:36:03,2011-09-14 22:34:56
d280fd8c0b0884a3fd1194743d58b1ba828132fe...4af4f7e5ea056ccd875319a3cde72cc7efdac0fa,2,3,3,6,3,2011-09-15 00:00:46,2011-09-15 00:00:46
4af4f7e5ea056ccd875319a3cde72cc7efdac0fa...78d9eaf4d31e7a69175c61f6ee0f402dd2678578,3,6,6,12,6,2011-09-15 00:11:28,2011-09-15 00:11:28
78d9eaf4d31e7a69175c61f6ee0f402dd2678578...863608146cd4784f9d3cbde1dba7982177298384,4,40,42,82,10,2011-09-15 02:12:44,2011-09-15 02:12:44
863608146cd4784f9d3cbde1dba7982177298384...8f8c64bef11bc4c9943830ab88fd5137943b2fb2,1,17,3,20,2,2011-09-14 13:25:47,2011-09-14 13:18:35
8f8c64bef11bc4c9943830ab88fd5137943b2fb2...153d07439baab7c12a7d682503e99b286db1b278,1,3,1,4,2,2011-09-14 13:26:05,2011-09-14 13:18:47
4125a4424154c05cc8d3bb568deb82adc70cdb25...caf7d47edf0137e11da9eeb942851ee603f6ff0e,1,10,1,11,1,2011-11-10 17:17:53,2011-11-10 17:17:53
caf7d47edf0137e11da9eeb942851ee603f6ff0e...1624e05909b436d74cbd328f5d974af480db326d,1,2,1,3,2,2011-11-10 18:29:52,2011-11-10 18:28:46
1624e05909b436d74cbd328f5d974af480db326d...ee084750b73a09696ed73711661b788d2be69345,1,6,4,10,3,2011-11-10 18:47:07,2011-11-10 18:41:58
ee084750b73a09696ed73711661b788d2be69345...20e0643c1a285172f3a17d0a110773d4c02aa39c,1,8,3,11,3,2011-11-10 18:47:07,2011-11-10 18:45:28
20e0643c1a285172f3a17d0a110773d4c02aa39c...091b39635498d0e7a4c032cc52f4bb4ebbdc23a9,1,20,7,27,8,2011-11-10 19:23:04,2011-11-10 19:23:04
091b39635498d0e7a4c032cc52f4bb4ebbdc23a9...1b8a09bc333961b83ce1c44d81ef16011bfb544a,1,13,5,18,3,2011-11-10 20:27:54,2011-11-10 20:27:54
1b8a09bc333961b83ce1c44d81ef16011bfb544a...e8c780f22d76412f9ea387197ae056593e092397,4,95,16,111,16,2011-11-10 20:15:54,2011-11-10 20:11:17
e8c780f22d76412f9ea387197ae056593e092397...70acb293e9a8f47c045abb91986baf410c43178d,1,2,2,4,2,2011-11-10 21:15:53,2011-11-10 21:15:53
70acb293e9a8f47c045abb91986baf410c43178d...50151f2834cc34a5c8d32e598b31955deb103828,2,157,171,328,8,2011-11-10 21:35:34,2011-11-10 21:35:34
50151f2834cc34a5c8d32e598b31955deb103828...3bbe355757e323f940337da328eedb0a8d090afc,1,3,3,6,2,2011-11-10 21:56:26,2011-11-10 21:55:58
3bbe355757e323f940337da328eedb0a8d090afc...a9dd16f1b4a7dfacdd3e3538d6e35225a77243e4,1,8,0,8,1,2011-11-10 23:40:56,2011-11-10 23:38:30
a9dd16f1b4a7dfacdd3e3538d6e35225a77243e4...7d69c49e972491e6270b93925d9a02d16c240cf5,1,2,2,4,1,2011-11-11 01:46:03,2011-11-11 00:15:33
7d69c49e972491e6270b93925d9a02d16c240cf5...f259c6979f57841414bba3a539f4ffee5343aa19,1,19,20,39,9,2011-11-11 01:46:03,2011-11-11 01:23:19
f259c6979f57841414bba3a539f4ffee5343aa19...661dbc8b684b5b793823091ab42c3d8400d0e3e2,1,1,1,2,1,2011-11-11 03:08:46,2011-11-11 03:08:08
661dbc8b684b5b793823091ab42c3d8400d0e3e2...7b924940604ee3618ce4635a159bc07e85004484,1,11,3,14,3,2011-11-11 03:27:37,2011-11-11 03:27:37
7b924940604ee3618ce4635a159bc07e85004484...ea662bee6226fa0e6ab7b338bdf6f1ff4190c428,1,1,1,2,1,2011-11-11 04:13:11,2011-11-11 04:13:11
ea662bee6226fa0e6ab7b338bdf6f1ff4190c428...2442d4c6ce6288677171e81dd869441692326d80,1,6,2,8,2,2011-11-11 04:13:54,2011-11-11 04:13:54
2442d4c6ce6288677171e81dd869441692326d80...f61db3d95ff3c114282349f4c6fd0151a6e7f5ad,2,4,9,13,3,2011-11-11 04:21:05,2011-11-11 04:21:05
f61db3d95ff3c114282349f4c6fd0151a6e7f5ad...658b5ca30f20f469f68b2613399da66f88743bec,1,5,12,17,3,2011-11-11 04:43:56,2011-11-11 04:43:56
658b5ca30f20f469f68b2613399da66f88743bec...49c58aa9baccde3ac82ed82f9c5c29286d2a2889,4,109,58,167,30,2011-11-11 05:30:22,2011-11-11 05:29:30
49c58aa9baccde3ac82ed82f9c5c29286d2a2889...a59266c47fc921480789070fa76448159f7cdda3,1,0,1,1,1,2011-11-11 08:56:19,2011-11-11 08:56:19
a59266c47fc921480789070fa76448159f7cdda3...703ca00a5749c8660d7a975c9d03ae585d790ddb,1,1,0,1,1,2011-11-11 14:45:30,2011-11-11 14:45:30
703ca00a5749c8660d7a975c9d03ae585d790ddb...bad807e45b26856cafd583bfbaa7f8dbb13a9c6d,1,1,0,1,1,2011-11-11 16:50:17,2011-11-11 16:50:17
bad807e45b26856cafd583bfbaa7f8dbb13a9c6d...759caebb7382c94f09c2a99a75b34a3b432ad820,2,3,5,8,3,2011-11-11 16:56:52,2011-11-11 04:16:13
759caebb7382c94f09c2a99a75b34a3b432ad820...437a7cc46a36c03af81d0ec8d21f0a40bb8fb333,2,4,4,8,4,2011-11-11 16:56:52,2011-11-11 16:56:33
437a7cc46a36c03af81d0ec8d21f0a40bb8fb333...03f105bd893fb929c6de4b2aa67984aa7fd97029,2,4,4,8,4,2011-11-11 17:13:13,2011-11-11 17:13:13
03f105bd893fb929c6de4b2aa67984aa7fd97029...e49b622e5a84104db6464873cbef568b041aee39,1,0,1,1,1,2011-11-11 17:13:37,2011-11-11 17:13:37
e49b622e5a84104db6464873cbef568b041aee39...6fe20569913bc822db50cff06d55d50b144bce9d,1,25,0,25,1,2011-11-11 17:14:23,2011-11-11 17:14:23
6fe20569913bc822db50cff06d55d50b144bce9d...e2ba7760e0ca0a08e3d8c70b545ec64688ae5ed3,2,24,0,24,3,2011-11-11 18:10:04,2011-11-11 18:10:04
e2ba7760e0ca0a08e3d8c70b545ec64688ae5ed3...9ace10e5f806965e5f092de4016ca824225248de,1,1,1,2,1,2011-11-11 19:05:20,2011-11-11 19:04:39
9ace10e5f806965e5f092de4016ca824225248de...58dcee3a0000a3bafc49afb074bba4fd20f6bbde,1,1,1,2,1,2011-11-11 19:06:24,2011-11-11 19:06:10
58dcee3a0000a3bafc49afb074bba4fd20f6bbde...805982794d33711f538713e193835a405a6293f4,1,1,0,1,1,2011-11-11 21:32:18,2011-11-11 21:15:11
805982794d33711f538713e193835a405a6293f4...cf8368c20aac2ac86d9a127b41064128481eadea,1,11,11,22,10,2011-11-11 21:32:18,2011-11-11 21:15:57
cf8368c20aac2ac86d9a127b41064128481eadea...c99abec538e30a337d911b1f84a1121b6500531c,5,48,44,92,8,2011-11-11 23:24:36,2011-11-11 23:24:27
c99abec538e30a337d911b1f84a1121b6500531c...f511d1d300c9ba46aeeeb68d8c139e3e74393900,1,3,1,4,1,2011-11-12 15:25:00,2011-11-12 15:24:37
f511d1d300c9ba46aeeeb68d8c139e3e74393900...9b2d7f9c4c3beccaa72f1950ce3f489455ee9932,1,11,12,23,6,2011-11-12 16:07:43,2011-11-12 16:06:30
9b2d7f9c4c3beccaa72f1950ce3f489455ee9932...155b6269ee8e738d7b98a5acb139780a7f587966,4,16,10,26,7,2011-11-12 17:01:55,2011-11-12 17:01:55
155b6269ee8e738d7b98a5acb139780a7f587966...ebc078b1505dd97638da576bdfa179751b225e4f,1,2,1,3,1,2011-11-12 20:55:57,2011-11-12 20:55:57
ebc078b1505dd97638da576bdfa179751b225e4f...eccc4cf1020161f97412d6cc50c006764c03d51f,1,5,0,5,1,2011-11-12 20:56:08,2011-11-12 20:56:08
eccc4cf1020161f97412d6cc50c006764c03d51f...c15a488aa9df57d4a35a04d1099f42fdbb1a600e,2,32,31,63,9,2011-11-12 20:56:41,2011-11-12 20:56:41
c15a488aa9df57d4a35a04d1099f42fdbb1a600e...3ecfaf9596b020a30320ae113d05d8dec5841c58,1,17,0,17,2,2011-11-13 15:20:16,2011-11-13 15:20:16
3ecfaf9596b020a30320ae113d05d8dec5841c58...3348083f29edfb63424ad9706075c7720f3d9441,1,8,1,9,1,2011-11-13 17:06:33,2011-11-13 17:06:33
3348083f29edfb63424ad9706075c7720f3d9441...fc7b6ecdb39f1838edc9a60cfc3dcc043af9729d,1,8,6,14,2,2011-11-13 22:20:40,2011-11-13 17:59:59
fc7b6ecdb39f1838edc9a60cfc3dcc043af9729d...a6b6549fef3041f02714b716ecbb20bb6857e049,1,57,9,66,14,2011-11-13 22:20:42,2011-11-13 21:09:52
a6b6549fef3041f02714b716ecbb20bb6857e049...0d2cb3baee872496bfebceae47078b684e1cbb91,2,13,3,16,3,2011-11-13 22:20:44,2011-11-13 22:20:17
0d2cb3baee872496bfebceae47078b684e1cbb91...cf87929abb72fdfc157120da542933911665974b,1,3,2,5,3,2011-11-14 06:31:49,2011-11-14 06:30:12
cf87929abb72fdfc157120da542933911665974b...aa079a1389ff589898194671babcb8307d1d3085,2,58,2,60,2,2011-11-14 06:31:49,2011-11-14 06:30:39
aa079a1389ff589898194671babcb8307d1d3085...e58ca1a7209aff955a5ef1b5c75f62e8a0e68151,1,1,1,2,1,2011-11-14 15:57:41,2011-11-14 15:46:22
e58ca1a7209aff955a5ef1b5c75f62e8a0e68151...408a7cec5e3115cd262e1eeda51fc5aa6aab092d,1,2,3,5,1,2011-11-14 16:32:34,2011-11-14 16:32:34
408a7cec5e3115cd262e1eeda51fc5aa6aab092d...ce03e86df80b8c8e4d3d9c1fc65d5f10365c1fcc,1,12,6,18,3,2011-11-14 19:46:49,2011-11-14 19:46:49
ce03e86df80b8c8e4d3d9c1fc65d5f10365c1fcc...77349350a45b4e7c8b3a6f577fb5f1726aeeb8f9,1,1,0,1,1,2011-11-14 19:59:58,2011-11-14 19:59:58
77349350a45b4e7c8b3a6f577fb5f1726aeeb8f9...fa1c53294c172f15e9a89989c05703585f7f6f05,1,2,1,3,1,2011-11-14 20:49:24,2011-11-14 20:49:24
fa1c53294c172f15e9a89989c05703585f7f6f05...748587a373388bbf26a888eb81651ed661294307,2,2,2,4,3,2011-11-14 21:31:22,2011-11-14 21:30:53
748587a373388bbf26a888eb81651ed661294307...c31b96a8bc41941774e90828a5c5653688f293ee,1,1,1,2,1,2011-11-14 22:05:12,2011-11-14 22:04:57
c31b96a8bc41941774e90828a5c5653688f293ee...98813f312ff9bc0eb5c2751289ac9c02e41e1c0c,1,6,2,8,1,2011-11-14 22:14:09,2011-11-14 20:42:57
98813f312ff9bc0eb5c2751289ac9c02e41e1c0c...b2309995442a897e31797e69e65c35370003d9e0,1,1,0,1,1,2011-11-14 22:24:59,2011-11-14 22:24:59
b2309995442a897e31797e69e65c35370003d9e0...200956560469c1a25ed7078cc541ffa45f3e0c40,3,43,23,66,5,2011-11-14 22:53:54,2011-11-14 22:41:56
200956560469c1a25ed7078cc541ffa45f3e0c40...4c2600d332d367084b8bcf9598aed5f131229c5d,4,52,13,65,11,2011-11-14 23:05:46,2011-11-14 23:05:08
4c2600d332d367084b8bcf9598aed5f131229c5d...d53b28dac32967ca49f3a71ae0a2ff333b8a1759,1,11,11,22,1,2011-11-14 23:38:14,2011-11-14 21:27:01
d53b28dac32967ca49f3a71ae0a2ff333b8a1759...d1a054cac553a6c842d8db39317abe403449cf9d,4,34,36,70,16,2011-11-14 23:38:16,2011-11-14 23:37:50
d1a054cac553a6c842d8db39317abe403449cf9d...6c88cf0b68e8dbec9920125fcdae4bb114be2c59,3,35,2,37,5,2011-11-15 02:18:18,2011-11-15 02:18:18
6c88cf0b68e8dbec9920125fcdae4bb114be2c59...ab709c21922572429f31b78a74c661e64ff84270,1,7,3,10,4,2011-11-15 02:29:44,2011-11-15 02:29:44
ab709c21922572429f31b78a74c661e64ff84270...de2ab329d4c6d16db4d18fbf0e0c24f56d25c054,1,2,2,4,2,2011-11-15 06:36:18,2011-11-11 09:16:32
de2ab329d4c6d16db4d18fbf0e0c24f56d25c054...e11df372b0b63187f1feb8ae1339d934b4a0ecb8,3,59,53,112,31,2011-11-15 06:36:18,2011-11-14 06:27:08
e11df372b0b63187f1feb8ae1339d934b4a0ecb8...d9ee2526f4c46251a32ae3f347bdef80fb466cc3,1,4,0,4,1,2011-11-15 08:40:28,2011-11-15 08:40:28
d9ee2526f4c46251a32ae3f347bdef80fb466cc3...7e14b578ff0b4be95e0373bf265ec23c7715c584,3,19,0,19,7,2011-11-15 16:38:03,2011-11-15 16:34:45
7e14b578ff0b4be95e0373bf265ec23c7715c584...8770fd7de4cf4aae9d4021906300373a932f6b0f,1,4,4,8,3,2011-11-15 16:48:51,2011-11-15 16:48:51
8770fd7de4cf4aae9d4021906300373a932f6b0f...dd8703183c65511765dce1dbf14d9027a166f2ea,3,2,35,37,5,2011-11-15 17:13:49,2011-11-15 17:13:49
dd8703183c65511765dce1dbf14d9027a166f2ea...a1dbfee928851b12c9ef5bdf28a9ed41c99c1a2e,1,6,1,7,3,2011-11-15 17:25:53,2011-11-15 17:25:53
a1dbfee928851b12c9ef5bdf28a9ed41c99c1a2e...1306fee268ef9ee04255e2d9f132eaa63bffe93d,2,21,2,23,9,2011-11-15 18:17:20,2011-11-15 18:17:20
1306fee268ef9ee04255e2d9f132eaa63bffe93d...4b0adb417574b4cbc1ef6d743772e5c385cd9d75,1,0,0,0,0,2011-11-15 20:31:27,2011-11-15 20:31:06
feb31975a3cae69812b42b55cb66e7b4ab015dd8...a9a20a186e1a55bb7cac2359aeeedf7b7df6888d,2,3,3,6,3,2011-10-26 19:55:03,2011-10-26 19:55:03
a9a20a186e1a55bb7cac2359aeeedf7b7df6888d...c0773ef1f19094d72e4cab4161c6107af59d4a42,3,29,12,41,12,2011-10-26 21:43:04,2011-10-26 21:41:55
c0773ef1f19094d72e4cab4161c6107af59d4a42...5a03de8aab3d9b476e46666a722c89a735c9d986,6,13,6,19,10,2011-10-26 21:43:04,2011-10-26 21:42:21
5a03de8aab3d9b476e46666a722c89a735c9d986...2ba6913e2dd2dce74c8a3b67dd4df2ba6d812e8b,1,41,6,47,6,2011-10-26 21:43:04,2011-10-26 21:42:49
2ba6913e2dd2dce74c8a3b67dd4df2ba6d812e8b...576a669d13dc8c5f3500684a0e3d4ddd8e088447,2,2,2,4,2,2011-10-26 22:33:06,2011-10-26 22:33:06
576a669d13dc8c5f3500684a0e3d4ddd8e088447...a5d6f7428060ba08484bc919772791d5939b5dda,2,28,31,59,12,2011-10-27 15:25:48,2011-10-27 15:25:25
a5d6f7428060ba08484bc919772791d5939b5dda...c976f5dae58915413b275a98a185b4a84fa80df3,1,2,2,4,2,2011-10-27 17:29:31,2011-10-27 17:29:31
c976f5dae58915413b275a98a185b4a84fa80df3...7a698ac579010c95ab7672c8c6f924231bb8a033,1,3,1,4,2,2011-10-27 18:15:34,2011-10-27 18:15:17
e59bd0f8cf3ec6409628a7e8fd4b5c8ef90b0886...ff94f30403ebfbd14c92a2ded908adb377a9afbd,1,3,1,4,1,2012-07-12 17:38:00,2012-07-12 17:38:00
ff94f30403ebfbd14c92a2ded908adb377a9afbd...e7b412c8104b620fd74a617403401c9a669bc3e8,1,2,1,3,2,2012-07-12 18:31:35,2012-07-12 18:31:09
e7b412c8104b620fd74a617403401c9a669bc3e8...d5a4b63980103a7bc6d91ad961050e106029d722,3,93,8,101,9,2012-07-12 18:33:54,2012-07-12 17:45:17
d5a4b63980103a7bc6d91ad961050e106029d722...b0e83419925b8cd8b5103fe94cf70a2d6e33fcb8,4,125,21,146,21,2012-07-12 18:33:54,2012-07-09 00:05:31
b0e83419925b8cd8b5103fe94cf70a2d6e33fcb8...779d861eadf31631de8d6c2d7f1b3f020211f255,3,6,0,6,3,2012-07-12 18:54:29,2012-07-12 16:16:14
779d861eadf31631de8d6c2d7f1b3f020211f255...99bd64765e392e4efeb0b049030c4e373556a5cd,4,111,6,117,15,2012-07-12 19:31:19,2012-07-03 17:27:28
99bd64765e392e4efeb0b049030c4e373556a5cd...333ce4f1fe5167081db1c44a31653bcbb3649b71,3,276,0,276,3,2012-07-12 19:31:19,2012-07-03 17:28:53
333ce4f1fe5167081db1c44a31653bcbb3649b71...114174d6dacd1c2e8e363d29f7b3dff81728354f,3,177,1,178,6,2012-07-12 19:31:19,2012-07-05 16:27:04
114174d6dacd1c2e8e363d29f7b3dff81728354f...4a5d0c0265cd2bc08b2f987ce5588dae514e0145,1,12,1,13,2,2012-07-12 19:31:19,2012-07-10 19:37:27
4a5d0c0265cd2bc08b2f987ce5588dae514e0145...66b79cdbf7c1c7db81a4ca469763fee1ed6a441a,1,201,15,216,15,2012-07-12 19:31:20,2012-07-12 13:34:56
66b79cdbf7c1c7db81a4ca469763fee1ed6a441a...afa94d3d099646d58ef13fd60e7cb15e95b06865,1,12,8,20,4,2012-07-12 19:31:20,2012-07-12 19:29:16
afa94d3d099646d58ef13fd60e7cb15e95b06865...e185fe25c2c681bfd902950c09c6c91b6ab90467,1,5,5,10,2,2012-07-12 20:02:38,2012-07-12 19:50:09
e59bd0f8cf3ec6409628a7e8fd4b5c8ef90b0886...e0b58b45dd07a2bf2b7d3b5f0f38b0a47a88e6b2,1,102,0,102,1,2012-07-12 17:33:10,2012-07-12 17:33:10
bc1bd6b98c18cc38222364fc90123ea14189d170...12f558d6ae8196fae38d60bc22f333f02e298641,1,6,12,18,6,2012-08-08 14:21:53,2012-08-08 14:21:53
bc1bd6b98c18cc38222364fc90123ea14189d170...ca6e4a62aa45c02481a93c865e9c7e70c9f42bed,2,19,0,19,3,2012-08-01 18:57:53,2012-08-01 18:57:53
bc1bd6b98c18cc38222364fc90123ea14189d170...3b72b766bd152427a702f29ef8f12454c0e7613d,1,4,0,4,3,2012-07-31 18:27:57,2012-07-31 18:27:57
bc1bd6b98c18cc38222364fc90123ea14189d170...aa966b46a80110b509cf77d82c14ebfa43bd4505,1,9,8,17,5,2012-07-25 17:08:56,2012-07-25 17:08:56
69569e191e44e06e26e288da9eff9044f97b52da...8ce6b0fbef3004c989edc896a88b15e2613dcf13,1,3,0,3,1,2012-09-24 16:38:28,2012-09-24 16:38:28
8ce6b0fbef3004c989edc896a88b15e2613dcf13...1930f5bc9170f2c4b061b8b416bb0a414fba5b7c,2,4,0,4,2,2012-09-24 17:13:14,2012-09-24 17:13:14
1930f5bc9170f2c4b061b8b416bb0a414fba5b7c...a8822b98f8f960ce85e62f5d46cd6c86435e7b71,3,61,18,79,11,2012-09-24 21:19:12,2012-09-24 21:19:12
a8822b98f8f960ce85e62f5d46cd6c86435e7b71...924d00cee993434dd139ade27b358fbc8ce44fe2,2,20,3,23,5,2012-09-25 01:40:25,2012-09-21 20:08:02
924d00cee993434dd139ade27b358fbc8ce44fe2...c470ef7c9c3df63ecf4b06b416292fe0102fe9f2,9,69,61,130,32,2012-09-25 06:00:26,2012-09-25 06:00:26
c470ef7c9c3df63ecf4b06b416292fe0102fe9f2...0e59f675654adbe2ea251dc0e643520508488463,5,158,70,228,7,2012-09-25 13:40:38,2012-09-21 15:24:15
0e59f675654adbe2ea251dc0e643520508488463...ac4eb3fba2927f4f4c7083520cf825dbb74f0c12,2,5,5,10,5,2012-09-25 19:04:03,2012-09-13 14:41:38
ac4eb3fba2927f4f4c7083520cf825dbb74f0c12...3aa13e9159d839760b54419fd54636cd11ae5e8b,7,49,30,79,31,2012-09-25 19:04:52,2012-09-17 16:02:27
3aa13e9159d839760b54419fd54636cd11ae5e8b...801992d49afe770bc2f240735028e161da11c532,6,379,0,379,8,2012-09-25 19:05:32,2012-09-21 18:52:49
801992d49afe770bc2f240735028e161da11c532...ccd3e0333dce5bd96b80b42aaf0dc27ac3bde72a,4,299,2,301,6,2012-09-25 19:05:32,2012-09-11 20:59:48
ccd3e0333dce5bd96b80b42aaf0dc27ac3bde72a...6825307dd6534086ffbf8442eb9b5ac3cd9c13d3,1,6,1,7,2,2012-09-25 19:05:51,2012-09-13 14:43:47
6825307dd6534086ffbf8442eb9b5ac3cd9c13d3...1c9b2a7d236cce265db1b29a708959fe87ba56ca,7,368,0,368,9,2012-09-25 19:43:02,2012-09-13 15:54:44
1c9b2a7d236cce265db1b29a708959fe87ba56ca...635aed09b0de72588422f1b864cca3810979375c,11,432,2,434,13,2012-09-25 19:57:08,2012-09-17 16:19:26
635aed09b0de72588422f1b864cca3810979375c...9424ec487448c6b8ef79ac1eb63e515fa0ed09d2,5,37,4,41,7,2012-09-25 22:35:44,2012-08-27 22:22:12
9424ec487448c6b8ef79ac1eb63e515fa0ed09d2...d0afe16ee4f3de17c6e0f3cf677bab61c7939136,1,10,2,12,2,2012-09-25 23:59:24,2012-09-25 21:40:40
d0afe16ee4f3de17c6e0f3cf677bab61c7939136...b1b1102117f314ee4547fc770cd5f7555b0c6c76,8,581,3,584,32,2012-09-26 10:47:20,2012-09-26 10:47:20
b1b1102117f314ee4547fc770cd5f7555b0c6c76...3e6e7de4c7b5dc8c5a73514709f0dc7bf67564d2,1,3,3,6,3,2012-09-26 14:14:39,2012-09-24 17:49:12
3e6e7de4c7b5dc8c5a73514709f0dc7bf67564d2...1af03cddde9fb4c1207b982d42add6fd9235fc12,3,26,22,48,6,2012-09-26 14:14:40,2012-09-24 17:58:00
1af03cddde9fb4c1207b982d42add6fd9235fc12...41c4c364d1a04de987a1aabe58b38bc4582a534e,20,73,31,104,47,2012-09-26 16:18:12,2012-09-13 14:59:15
41c4c364d1a04de987a1aabe58b38bc4582a534e...1bea35d51c4480482055279a81f0941912d56e59,18,28,30,58,26,2012-09-26 17:30:22,2012-09-26 16:56:41
1bea35d51c4480482055279a81f0941912d56e59...fe8d07dd634839418bbea99f1b570d2d9bc8e968,2,5,5,10,4,2012-09-26 17:36:27,2012-09-26 17:36:27
fe8d07dd634839418bbea99f1b570d2d9bc8e968...deb9d3c4a63f7ef52aca17aa03ef36f6703abe5c,1,2,1,3,1,2012-09-26 19:01:22,2012-09-26 19:01:22
deb9d3c4a63f7ef52aca17aa03ef36f6703abe5c...a77a8a9249b731a59d15d42c3133243f6376cc77,3,45,5,50,5,2012-09-26 19:28:25,2012-09-26 15:54:55
a77a8a9249b731a59d15d42c3133243f6376cc77...ad0cb17b58dfbcaf54c5e77e0ed77e78f303cdf8,1,12,11,23,3,2012-09-26 19:32:04,2012-09-10 22:19:39
ad0cb17b58dfbcaf54c5e77e0ed77e78f303cdf8...c5ba60e6b6be86512904da7f72a88c98609e82a0,7,32,26,58,22,2012-09-27 14:33:52,2012-09-27 14:33:36
c5ba60e6b6be86512904da7f72a88c98609e82a0...54d96ade4e71b6472b99d575dc38e6472b30a8b0,1,1,4,5,1,2012-09-27 19:30:18,2012-09-27 19:15:49
54d96ade4e71b6472b99d575dc38e6472b30a8b0...264318a4b3cc861fc5f47e7154d1debb2929e9bf,1,2,1,3,1,2012-09-27 19:42:19,2012-09-24 14:30:18
264318a4b3cc861fc5f47e7154d1debb2929e9bf...3f02a780112135da725070a8c43b2d8195a9f434,2,71,52,123,39,2012-09-28 02:38:24,2012-09-21 23:04:40
3f02a780112135da725070a8c43b2d8195a9f434...6e555988bff53d807635ef59796c45c824b770ba,7,307,33,340,30,2012-09-28 02:44:44,2012-09-24 17:57:29
6e555988bff53d807635ef59796c45c824b770ba...99bf4aaa6722b5dfd0787c2682e0144cb1325a01,1,1,0,1,1,2012-09-28 03:42:47,2012-09-28 03:42:47
99bf4aaa6722b5dfd0787c2682e0144cb1325a01...559d8c713ec9f81bded92da3af3b7d849756aafb,6,30,15,45,7,2012-09-28 19:00:02,2012-09-28 18:54:44
559d8c713ec9f81bded92da3af3b7d849756aafb...736e1b29a68b83c40ed79cabfd9fccbb28047a0e,1,8,3,11,1,2012-09-28 20:21:13,2012-09-26 20:09:53
736e1b29a68b83c40ed79cabfd9fccbb28047a0e...f0748473dbc00a197b7a886a5002410d15974d2a,1,2,2,4,2,2012-09-28 20:21:13,2012-09-26 20:09:30
f0748473dbc00a197b7a886a5002410d15974d2a...c51c807b7581a3f82c4d57b2b85be1193b2d81f3,1,2,1,3,1,2012-09-28 20:26:34,2012-09-28 20:20:59
c51c807b7581a3f82c4d57b2b85be1193b2d81f3...82578579b6d548c4d641551dd1a61e3703935e15,6,85,16,101,22,2012-09-28 21:36:08,2012-09-28 20:01:07
82578579b6d548c4d641551dd1a61e3703935e15...4603ddc06daefb3b632e4cb78d3458653286cdec,1,1,1,2,1,2012-09-28 21:43:13,2012-09-28 21:43:13
4603ddc06daefb3b632e4cb78d3458653286cdec...4f661b7b3c3ff2412ecc19a45d925c466e848148,1,6,3,9,1,2012-09-29 14:09:18,2012-09-29 14:09:18
4f661b7b3c3ff2412ecc19a45d925c466e848148...c3e637660cb6a5dab79c675dde2d2c04ec85b312,1,6,8,14,3,2012-09-29 14:38:50,2012-09-29 14:38:50
c3e637660cb6a5dab79c675dde2d2c04ec85b312...2e10adf2e4371f32554bb4f97f9f6fa5baeb45fa,1,1,1,2,1,2012-09-30 21:16:04,2012-09-30 21:16:04
2e10adf2e4371f32554bb4f97f9f6fa5baeb45fa...a172d233f310e268285a0b251b5e5bae9748d218,5,141,44,185,37,2012-09-30 22:47:21,2012-09-30 18:30:00
a172d233f310e268285a0b251b5e5bae9748d218...4108427c33b0115022c04db601c3c2a2db5c8da1,1,18,19,37,7,2012-10-01 01:13:50,2012-09-27 20:56:47
4108427c33b0115022c04db601c3c2a2db5c8da1...7ce347287c153ef15067e0e2f8039ea33f1d90df,1,31,0,31,2,2012-10-01 01:13:50,2012-09-28 02:23:42
7ce347287c153ef15067e0e2f8039ea33f1d90df...b897ff2d1d6c32e43f4efbcbd4956b645bd3eb8b,3,96,47,143,14,2012-10-01 01:13:50,2012-09-28 20:25:42
b897ff2d1d6c32e43f4efbcbd4956b645bd3eb8b...8eef85f69b66f87049a6a84cee88a9babb49efee,5,296,5,301,8,2012-10-01 01:13:50,2012-09-26 05:00:04
8eef85f69b66f87049a6a84cee88a9babb49efee...9bc9d5c7b438a9fae57bad9b71cc02fed903bc6d,1,2,2,4,2,2012-10-01 04:33:01,2012-10-01 04:32:18
9bc9d5c7b438a9fae57bad9b71cc02fed903bc6d...5cab507f2de703d5829a9b889a984781da5e959a,5,5,296,301,8,2012-10-01 05:00:51,2012-10-01 05:00:51
5cab507f2de703d5829a9b889a984781da5e959a...afd0caeb66ae9864e634238f1cbfe0867d876470,1,39,0,39,1,2012-10-01 15:29:49,2012-09-28 15:21:43
afd0caeb66ae9864e634238f1cbfe0867d876470...710e71691fab843515bee68476c1b7aa7adbea0d,1,30,1,31,4,2012-10-01 15:29:49,2012-09-28 19:31:41
710e71691fab843515bee68476c1b7aa7adbea0d...d17eb309cf3b35931951a9a5ca4e84a8369d51f0,4,43,20,63,12,2012-10-01 15:29:49,2012-10-01 14:45:29
d17eb309cf3b35931951a9a5ca4e84a8369d51f0...446bd757f1a5d45a69d2023aacbc0e0b66f9455d,2,87,0,87,2,2012-10-01 15:29:49,2012-10-01 14:37:58
d69d52ceef293c7888eb9c507dacf40a48b8abe0...e9ec52c686315e4388a5e26c22f274621339d849,1,15,2,17,2,2011-11-21 22:50:34,2011-10-10 22:11:06
d69d52ceef293c7888eb9c507dacf40a48b8abe0...bc22bd44871ff4d7ab6ff406f341e8e86d039e2f,1,23,2,25,8,2011-11-21 19:53:26,2011-11-21 18:23:13
bc22bd44871ff4d7ab6ff406f341e8e86d039e2f...a91919f7261a24eb43fbe7f9635acabb0b2d157b,2,2,2,4,2,2011-11-22 05:45:21,2011-11-22 05:45:21
153d07439baab7c12a7d682503e99b286db1b278...67fbd576b1905b68175a4c7cac0ec2b827154df1,1,3,3,6,2,2011-09-16 02:22:55,2011-09-16 02:22:43
153d07439baab7c12a7d682503e99b286db1b278...b17768ac0ae208115f8c2e6e130ebedc278e2da9,1,22,7,29,3,2011-09-15 13:25:07,2011-09-15 13:24:27
b17768ac0ae208115f8c2e6e130ebedc278e2da9...f6243e1a268d3d5f3b14f839ac45be395b7cc04d,3,106,1,107,3,2011-09-15 14:50:05,2011-09-15 14:49:45
f6243e1a268d3d5f3b14f839ac45be395b7cc04d...b1bac38dd0f0c5491912b88540477e53c80c265e,1,8,0,8,1,2011-09-15 15:25:52,2011-09-15 15:25:52
b1bac38dd0f0c5491912b88540477e53c80c265e...04a595a82ce16108ed02df5499924d5e2c0c3873,1,1,1,2,1,2011-09-16 00:10:36,2011-09-16 00:10:36
04a595a82ce16108ed02df5499924d5e2c0c3873...5d714b1bee36b0fde44445b1e29bed6af7d7cc6c,2,14,3,17,6,2011-09-16 14:51:06,2011-09-16 14:35:08
5d714b1bee36b0fde44445b1e29bed6af7d7cc6c...723c6fbffbae6107f574e26246b2044a0f7fda56,5,20,20,40,14,2011-09-16 17:05:49,2011-09-16 17:05:49
723c6fbffbae6107f574e26246b2044a0f7fda56...cbc388b37bc2819ed0f112f4ff55052663bf62b4,1,0,36,36,1,2011-09-16 17:06:47,2011-09-16 17:06:47
cbc388b37bc2819ed0f112f4ff55052663bf62b4...86ce04ba5004eacace218c1998f2cce660c03d74,1,8,4,12,2,2011-09-16 17:28:20,2011-09-16 17:28:20
86ce04ba5004eacace218c1998f2cce660c03d74...118d9ed85813a168a96c1e11bc3baf118dac3ab2,1,1,1,2,1,2011-09-16 17:31:34,2011-09-16 17:31:34
118d9ed85813a168a96c1e11bc3baf118dac3ab2...fa47c5e30b31cdc6939fbda27ca72b1ca6a80712,1,1,1,2,1,2011-09-16 18:55:54,2011-09-16 18:55:54
fa47c5e30b31cdc6939fbda27ca72b1ca6a80712...fd7849ec10c06947f51a5e25badd3fb332be7fe7,1,3,0,3,1,2011-09-17 02:40:20,2011-09-17 02:40:20
fd7849ec10c06947f51a5e25badd3fb332be7fe7...6fc17b9c1c74a39f56197eb0b12aea5f953d9fce,1,3,3,6,2,2011-09-17 02:43:01,2011-09-17 01:28:10
6fc17b9c1c74a39f56197eb0b12aea5f953d9fce...81be3aab3f035391b11946e973faa38ad005fb7c,1,2,0,2,1,2011-09-17 02:43:03,2011-09-17 02:42:02
81be3aab3f035391b11946e973faa38ad005fb7c...684fc18ae4c3bdb61c7aa283ac5afc584ca202aa,1,61,0,61,1,2011-09-17 02:43:06,2011-09-17 02:42:41
4b0adb417574b4cbc1ef6d743772e5c385cd9d75...377c4e96f74d3a9fed2adf8fda8e8e6bdfe8bf38,2,42,1,43,4,2011-11-15 21:53:29,2011-11-15 21:53:29
377c4e96f74d3a9fed2adf8fda8e8e6bdfe8bf38...1194acb7fb8d4336f8bb9097f0c847b4b2b3338e,1,262,145,407,58,2011-11-15 22:35:40,2011-11-15 22:35:40
1194acb7fb8d4336f8bb9097f0c847b4b2b3338e...0655ba4ec87e4dd91c5639707d6f6f208d719d61,1,1,1,2,1,2011-11-16 02:21:24,2011-11-16 02:21:15
0655ba4ec87e4dd91c5639707d6f6f208d719d61...279adb20a0d67d6cd6a93eb48338d49d2495d27f,1,1,0,1,1,2011-11-16 17:32:42,2011-11-16 17:32:42
4b0adb417574b4cbc1ef6d743772e5c385cd9d75...db4540d24dad1af2346ab181530a67d5e122d3a8,1,1,1,2,1,2011-11-15 20:43:16,2011-11-15 20:43:16
7a698ac579010c95ab7672c8c6f924231bb8a033...740219aaafa9238b5cb0918df5f883127807f591,2,15,1,16,2,2011-10-27 20:29:28,2011-10-27 20:29:28
740219aaafa9238b5cb0918df5f883127807f591...1dc8aa72b68fb858989b893b03388d4312d854a3,1,27,1,28,2,2011-10-27 20:57:52,2011-10-27 20:56:47
7a698ac579010c95ab7672c8c6f924231bb8a033...d28b1100715cc5d4029ad01db556ac6323ac8dc5,4,72,16,88,19,2011-10-27 19:05:36,2011-10-27 19:05:36
d28b1100715cc5d4029ad01db556ac6323ac8dc5...377f4849ae643e905ea5036470ef511a4cd87bec,1,1,1,2,1,2011-10-27 20:16:46,2011-10-27 20:05:40
18e43af212b9831d44f382d155777bcd2b017e28...5729d591ce83c853eccd082e1afed7ee2261d048,2,32,14,46,16,2012-07-12 21:44:11,2012-07-12 21:19:47
5729d591ce83c853eccd082e1afed7ee2261d048...c62b02c1dbc95d0ed1a57231298aa2d81dd84c39,4,55,20,75,16,2012-07-12 22:42:42,2012-06-29 23:49:56
c62b02c1dbc95d0ed1a57231298aa2d81dd84c39...cfecc76c19634ad47670e187d46de75472512f30,3,52,21,73,16,2012-07-12 22:45:46,2012-07-03 18:17:21
cfecc76c19634ad47670e187d46de75472512f30...24e2a2c5f85a95bbc862630f5c4d16cf4419a1ef,3,34,3,37,6,2012-07-12 22:45:46,2012-07-12 21:34:40
24e2a2c5f85a95bbc862630f5c4d16cf4419a1ef...a807e3ef56902fa67435dc6cef7d0b9714c15a73,3,19,1,20,4,2012-07-12 22:45:46,2012-07-12 21:53:45
a807e3ef56902fa67435dc6cef7d0b9714c15a73...9dbe705fee5612160e321a3e52b07476bad0ff05,1,83,0,83,1,2012-07-12 23:43:12,2012-07-12 23:43:12
70c4ab23f30aff625335635ac2b4b666dedd61c1...be06a7a2ea6bab50452c02cccbbc59e71ea462a4,2,61,5,66,2,2012-07-31 19:39:58,2012-07-31 17:12:35
be06a7a2ea6bab50452c02cccbbc59e71ea462a4...8ab039b576620e0f215edb3c9905bbda80480054,1,246,0,246,1,2012-07-31 21:34:36,2012-07-30 20:51:08
8ab039b576620e0f215edb3c9905bbda80480054...ac2f2b228f12a3a541639e34cd4d8df62bf31351,1,41,114,155,24,2012-08-01 03:09:15,2012-07-27 22:11:03
ac2f2b228f12a3a541639e34cd4d8df62bf31351...7240761aed3ad4cb25d2dfd2a141a5cd9658c165,1,0,2,2,2,2012-08-01 03:09:16,2012-07-27 22:15:56
7240761aed3ad4cb25d2dfd2a141a5cd9658c165...06ed56ef4fed27cb53775b65f71da58e23f4bdd9,2,201,1,202,4,2012-08-01 03:09:16,2012-07-28 06:13:22
06ed56ef4fed27cb53775b65f71da58e23f4bdd9...fb51c008c78c0e5c31a81cbb328918bc8c2d003f,1,59,0,59,8,2012-08-01 03:09:16,2012-07-28 06:37:23
fb51c008c78c0e5c31a81cbb328918bc8c2d003f...242ec02fce2ace1f40b06a8e486e14fd597ebb44,1,110,0,110,1,2012-08-01 03:09:16,2012-07-30 18:41:49
242ec02fce2ace1f40b06a8e486e14fd597ebb44...2d61bc881cb2bee176d1d2a9ed273c66633ddda6,1,193,0,193,1,2012-08-01 03:09:16,2012-07-31 02:24:32
2d61bc881cb2bee176d1d2a9ed273c66633ddda6...5e5a6bac03a5bfc0df492c6147eb636f4aca21b4,1,25,1,26,2,2012-08-01 03:09:17,2012-07-31 02:52:10
5e5a6bac03a5bfc0df492c6147eb636f4aca21b4...2baa7cc10942e5cf1d34c1f382195da268cdc0ab,1,62,0,62,1,2012-08-01 03:09:17,2012-07-31 05:03:49
2baa7cc10942e5cf1d34c1f382195da268cdc0ab...2545a67d031b55a468239f6e2775ba5f4140a0a4,1,61,0,61,1,2012-08-01 03:09:17,2012-07-31 05:04:05
2545a67d031b55a468239f6e2775ba5f4140a0a4...71b146fb95248fcc4d21d6cf70cace97fa90350c,2,434,0,434,2,2012-08-01 03:09:17,2012-07-31 05:14:31
71b146fb95248fcc4d21d6cf70cace97fa90350c...82f2b1e770f3c0587ce1e19766a38f945fc3375d,1,1,1,2,1,2012-08-01 03:52:11,2012-08-01 03:52:11
82f2b1e770f3c0587ce1e19766a38f945fc3375d...ba7f067a2d5de8832702b4617c3dbf6973e77c5b,2,55,2,57,3,2012-08-01 06:04:34,2012-08-01 06:04:34
ba7f067a2d5de8832702b4617c3dbf6973e77c5b...cbc8b6e716a92357655ff9a33d1c5e1e274744a6,2,12,1,13,3,2012-08-01 06:15:15,2012-08-01 06:15:15
cbc8b6e716a92357655ff9a33d1c5e1e274744a6...11559c9bf74be4d4640ba651d98f86909a83bd53,2,28,0,28,3,2012-08-01 06:27:49,2012-08-01 06:27:49
11559c9bf74be4d4640ba651d98f86909a83bd53...8c6dc7989ee94f93d16edd64eadaddcadd372d0b,2,3,3,6,3,2012-08-01 13:49:46,2012-07-30 22:07:42
8c6dc7989ee94f93d16edd64eadaddcadd372d0b...e237b71f06f785a2d7cb5eb2d87b14c270f23e08,1,7,0,7,2,2012-08-01 13:49:46,2012-08-01 13:49:04
e237b71f06f785a2d7cb5eb2d87b14c270f23e08...790a4f7b7097be14709f37729e716862102078dc,16,8,455,463,37,2012-08-01 14:15:33,2012-07-26 13:08:17
790a4f7b7097be14709f37729e716862102078dc...6e08bdcebb0320d20b3963a79568de546bb85f98,1,2,0,2,2,2012-08-01 16:15:36,2012-08-01 16:14:49
6e08bdcebb0320d20b3963a79568de546bb85f98...abe98a51cde828954b7cad0d14994eb0a7a7ed79,1,2,1,3,1,2012-08-01 16:15:36,2012-08-01 16:15:23
abe98a51cde828954b7cad0d14994eb0a7a7ed79...7fcf5c5858adb81ace887c20591bd5aecc475df5,1,1,1,2,1,2012-08-01 16:51:01,2012-08-01 16:51:01
7fcf5c5858adb81ace887c20591bd5aecc475df5...b27bf4b0bce374cacc71740723f1da682d5ac1ed,2,57,42,99,26,2012-08-01 17:22:27,2012-07-19 18:29:00
b27bf4b0bce374cacc71740723f1da682d5ac1ed...96d46ffcb8e7e7446903334345ee61f89d6e8403,1,2,1,3,1,2012-08-01 17:31:31,2012-08-01 17:29:55
96d46ffcb8e7e7446903334345ee61f89d6e8403...95bdb0df18bf8d1ddee7e6cf200f8021d4256c86,1,2,0,2,1,2012-08-01 17:31:40,2012-08-01 17:30:23
95bdb0df18bf8d1ddee7e6cf200f8021d4256c86...3f79f47a48c940ad5dee8e582e818d6e47c9690b,1,0,248,248,1,2012-08-01 17:56:22,2012-08-01 17:55:17
3f79f47a48c940ad5dee8e582e818d6e47c9690b...b54a71fd4838196ba178a56f3b49a02cc94f9e10,2,93,5,98,4,2012-08-01 18:51:17,2012-08-01 18:51:17
b54a71fd4838196ba178a56f3b49a02cc94f9e10...440ea570396eae6481c8fe1134aaa5a43aea1a9c,1,1,1,2,1,2012-08-01 19:27:52,2012-07-27 23:23:57
440ea570396eae6481c8fe1134aaa5a43aea1a9c...b793369a637d4263b4dd957d559dc08b8b6064d9,2,11,3,14,3,2012-08-01 19:27:52,2012-07-27 23:21:57
b793369a637d4263b4dd957d559dc08b8b6064d9...3589f9c1073becaee72abd5dcdcc8f5e3c3ba68e,1,0,0,0,0,2012-08-01 19:27:52,2012-07-31 21:26:33
3589f9c1073becaee72abd5dcdcc8f5e3c3ba68e...672a6f79be4dceb1ce585e5435f6f811573a3c3d,2,52,60,112,40,2012-08-02 00:09:56,2012-07-30 23:46:25
672a6f79be4dceb1ce585e5435f6f811573a3c3d...07e2bbe7293ec7fda7858f141da218477c255f1e,5,162,76,238,40,2012-08-02 00:22:19,2012-07-31 19:56:59
07e2bbe7293ec7fda7858f141da218477c255f1e...09df8c0d19150421e8dd881d3c9b49ca740f433a,3,25,20,45,16,2012-08-02 00:22:36,2012-07-31 22:14:09
09df8c0d19150421e8dd881d3c9b49ca740f433a...6fe9ee4c8841cec85b87e11dbfa6d5aabb38bb6d,2,19,3,22,5,2012-08-02 00:22:36,2012-08-01 18:06:26
6fe9ee4c8841cec85b87e11dbfa6d5aabb38bb6d...38626696cf0103e75ffb917ca6254367b67ee6eb,1,4,3,7,2,2012-08-02 00:22:36,2012-08-02 00:08:29
38626696cf0103e75ffb917ca6254367b67ee6eb...af67eafd77bb5d77218dae510c5241d410f0337f,1,2,1,3,1,2012-08-02 00:35:51,2012-08-02 00:35:51
af67eafd77bb5d77218dae510c5241d410f0337f...b202965c2aa985232699b059c7135dd64f09700e,9,40,48,88,24,2012-08-02 12:14:22,2012-08-02 12:14:22
b202965c2aa985232699b059c7135dd64f09700e...4a9a10f926a8cc027182cd4c71c8aa6c0000dd56,1,1,3,4,1,2012-08-02 16:47:47,2012-08-02 16:47:47
4a9a10f926a8cc027182cd4c71c8aa6c0000dd56...9dca13232a0578e30311f2f27bd150d83bb0b00d,1,4,11,15,7,2012-08-02 17:52:47,2012-08-02 17:52:47
aa966b46a80110b509cf77d82c14ebfa43bd4505...2c07e4029ae74a2a27513358493b7a33ff90a470,1,4,3,7,2,2012-07-26 08:20:14,2012-07-26 08:20:14
2c07e4029ae74a2a27513358493b7a33ff90a470...674079326782d372bd30aa2b5c2839e40415e3ee,2,133,1,134,7,2012-07-26 14:30:27,2012-07-23 17:58:38
674079326782d372bd30aa2b5c2839e40415e3ee...f7fe1378882ddc992ccf9eff8be245336a97c4c3,3,6,4,10,4,2012-07-26 15:27:57,2012-07-25 18:35:07
f7fe1378882ddc992ccf9eff8be245336a97c4c3...2d7f74341a95d28e8fb77dd7d02e662702d1848f,1,3,3,6,2,2012-07-26 15:31:11,2012-07-26 14:04:40
2d7f74341a95d28e8fb77dd7d02e662702d1848f...2af911ee30486574e102278fbb5135716bdbf5da,1,2,0,2,1,2012-07-26 15:51:11,2012-07-26 15:51:11
2af911ee30486574e102278fbb5135716bdbf5da...3e23612e277d68903f36a262c350b5512fcd5440,2,40,2,42,2,2012-07-26 16:21:23,2012-07-26 15:42:27
3e23612e277d68903f36a262c350b5512fcd5440...55b869ce15d07030983f6c38f410574b92d34531,1,1,1,2,2,2012-07-26 16:46:24,2012-07-26 16:45:25
55b869ce15d07030983f6c38f410574b92d34531...9c2c72988f2a0e9718535634b918b873e48a402b,1,6,2,8,1,2012-07-26 16:55:04,2012-07-24 22:43:50
9c2c72988f2a0e9718535634b918b873e48a402b...1a17d25673cff95dffbe692ff54e799d69fda25d,2,16,11,27,7,2012-07-26 19:55:26,2012-07-26 19:55:26
1a17d25673cff95dffbe692ff54e799d69fda25d...d7a5f9060c3bd3b5ba478fde7f98a65ca4ea152f,1,4,1,5,2,2012-07-26 20:17:09,2012-07-26 19:55:15
d7a5f9060c3bd3b5ba478fde7f98a65ca4ea152f...8e6189095eaa2fd517481f3b1c7b757b8dcbe0ad,1,3,3,6,3,2012-07-26 20:50:09,2012-07-26 20:48:49
8e6189095eaa2fd517481f3b1c7b757b8dcbe0ad...6580d32cc4d0792034e470e851a09ade5fd252a9,6,306,65,371,28,2012-07-26 20:57:44,2012-07-26 07:04:46
6580d32cc4d0792034e470e851a09ade5fd252a9...26b87e1fbe606b19e2e243c81f34ed10989f261d,2,74,11,85,6,2012-07-26 21:11:18,2012-07-26 20:11:17
26b87e1fbe606b19e2e243c81f34ed10989f261d...29c5637d9771aacbe7ac89759e5b6585735e62ee,3,9,8,17,4,2012-07-26 21:11:18,2012-07-26 20:49:05
aa966b46a80110b509cf77d82c14ebfa43bd4505...4ad86338dd719d5637b9bc7acf4318f6cc80d58e,2,2,2,4,2,2012-07-25 20:32:59,2012-07-25 20:32:59
446bd757f1a5d45a69d2023aacbc0e0b66f9455d...fcdda06ab1a9951ec5aaa63e3d9b7513397c8daf,1,2,2,4,1,2012-10-01 18:57:30,2012-10-01 18:57:30
446bd757f1a5d45a69d2023aacbc0e0b66f9455d...20701eeb63a48c5a997b33f1b1f0bb7ce00515bc,1,3,2,5,3,2012-10-01 17:30:03,2012-10-01 17:29:58
20701eeb63a48c5a997b33f1b1f0bb7ce00515bc...4b54bd515c29c7710221c0d137f19d00df86080c,1,3,3,6,1,2012-10-01 17:39:29,2012-10-01 17:38:24
4b54bd515c29c7710221c0d137f19d00df86080c...3b9b88caaf9dddedd05d894e257d6b47b3985840,1,7,6,13,6,2012-10-01 17:39:30,2012-10-01 17:38:59
c0044c79fb25b3980999f6ffacfffe00167494c8...48e6b7b16e808d2a05a3749d02913d8b6e8f6d74,2,2,2,4,2,2011-11-22 15:06:28,2011-11-22 15:06:28
48e6b7b16e808d2a05a3749d02913d8b6e8f6d74...2a4486134b96f756e01765d3e9234776051d0ff5,1,16,14,30,7,2011-11-22 19:02:53,2011-11-22 19:02:38
2a4486134b96f756e01765d3e9234776051d0ff5...bd438596e1f9808663af9c476f0a08940b19df35,2,2,1,3,2,2011-11-23 07:35:32,2011-11-23 07:35:13
bd438596e1f9808663af9c476f0a08940b19df35...d99fcfeb751c1019abc0654fa5e863aae3c76bcd,2,32,8,40,5,2011-12-01 05:07:06,2011-11-30 18:33:16
d99fcfeb751c1019abc0654fa5e863aae3c76bcd...468b35887eaec04f0e1dddccfcb5f3a759fff9e0,2,4,0,4,4,2011-12-01 21:35:37,2011-12-01 21:33:35
468b35887eaec04f0e1dddccfcb5f3a759fff9e0...f0d35552f7b982d63362f8221d5a5e87d49fc9af,1,38,18,56,7,2011-12-02 16:33:22,2011-12-02 16:33:22
f0d35552f7b982d63362f8221d5a5e87d49fc9af...85488010f7f553aceea9924da023796fdb308a1e,1,7,2,9,1,2011-12-03 05:12:34,2011-12-03 05:12:34
85488010f7f553aceea9924da023796fdb308a1e...b9e4db5cdc85a2770dd0ffd2527764f3c37a6d5c,1,2,2,4,1,2011-12-06 04:49:17,2011-12-05 22:35:10
b9e4db5cdc85a2770dd0ffd2527764f3c37a6d5c...4d5e2c7b4fdc750f03e9cd0f35814aa6e48aa3b8,2,4,2,6,2,2011-12-06 05:08:53,2011-12-06 05:08:53
4d5e2c7b4fdc750f03e9cd0f35814aa6e48aa3b8...7d32bec61fd25e2d1e728e24d0d127a8a73e38e0,2,2,2,4,2,2011-12-07 21:32:33,2011-12-07 21:32:33
7d32bec61fd25e2d1e728e24d0d127a8a73e38e0...f8a4019253010f3d0bbca3b66e89707c961d6620,2,2,2,4,2,2011-12-08 20:07:57,2011-12-08 20:07:57
f8a4019253010f3d0bbca3b66e89707c961d6620...9179db2dc807de8bb860f7a7800de2630ad04eab,2,59,7,66,2,2011-12-11 05:06:04,2011-12-09 21:51:07
9179db2dc807de8bb860f7a7800de2630ad04eab...9e517db3e1aa09d5cdf5edc5a574f5774af1c92a,2,4,4,8,4,2011-12-12 15:51:10,2011-11-21 22:16:29
9e517db3e1aa09d5cdf5edc5a574f5774af1c92a...6759c3ffa15febc7698442772f8c02075d35641a,1,4,0,4,1,2011-12-12 15:51:10,2011-12-12 15:39:58
6759c3ffa15febc7698442772f8c02075d35641a...a841b2e681610b5eeed206f229ccd4945a1a1bc8,1,5,0,5,1,2011-12-14 02:27:41,2011-12-14 02:27:41
a841b2e681610b5eeed206f229ccd4945a1a1bc8...514b122d308928517f5841888ceaa4246a7f18e3,4,10,3,13,4,2011-12-14 17:18:48,2011-12-14 17:18:48
514b122d308928517f5841888ceaa4246a7f18e3...feb1ef76fcbcec70c7b90d467494c7309201468d,1,1,1,2,1,2011-12-14 23:03:04,2011-12-14 23:03:04
feb1ef76fcbcec70c7b90d467494c7309201468d...3eaa472e9a55c60b58446cc62c4ce3e5d420267e,2,14,4,18,10,2011-12-19 19:49:18,2011-12-19 19:49:18
3eaa472e9a55c60b58446cc62c4ce3e5d420267e...d88037845bd73589a55441765a1fe6b2e6da9cfa,1,1,1,2,1,2011-12-22 16:53:46,2011-11-16 19:33:29
d88037845bd73589a55441765a1fe6b2e6da9cfa...843bc2c58ec03d00479e5d7e20ad86e5e60b7078,4,83,13,96,12,2011-12-22 16:54:35,2011-09-13 21:58:02
843bc2c58ec03d00479e5d7e20ad86e5e60b7078...a719914879ba9fa847bb9df596df956506054acf,2,11,0,11,2,2011-12-22 16:57:30,2011-09-12 22:08:27
a719914879ba9fa847bb9df596df956506054acf...8cd62bc27c3cec5eba8a763c0529637ff6a6f8c3,1,41,25,66,14,2011-12-22 16:57:34,2011-11-23 20:14:39
8cd62bc27c3cec5eba8a763c0529637ff6a6f8c3...45190b81b571d7cc4eaa0b527d8e120e45672612,1,1,1,2,1,2011-12-22 16:58:08,2011-12-20 15:17:10
45190b81b571d7cc4eaa0b527d8e120e45672612...774b90baee5ab571d8b22903cf4baf7ecfb3e1a5,1,6,2,8,3,2011-12-22 16:58:39,2011-12-02 16:46:00
774b90baee5ab571d8b22903cf4baf7ecfb3e1a5...400d7730efb9cd2e2ea7458414c171444741f54c,1,1,1,2,1,2011-12-22 16:58:45,2011-12-20 16:41:06
400d7730efb9cd2e2ea7458414c171444741f54c...5464d74491c39c22114ee61d12bbcda73994dfac,4,94,24,118,12,2011-12-22 16:59:07,2011-10-25 15:41:38
5464d74491c39c22114ee61d12bbcda73994dfac...53bc8fe36122e83157d0840241d24b1f5d69c2ba,1,9,7,16,6,2011-12-22 16:59:59,2011-10-24 22:11:17
53bc8fe36122e83157d0840241d24b1f5d69c2ba...b8447afd0e907e9d9df7f94a98dbbe159fcf9df6,3,49,5,54,12,2011-12-24 19:30:54,2011-12-01 06:20:07
b8447afd0e907e9d9df7f94a98dbbe159fcf9df6...2d5c1aeeb470df3e79b1400a5410b73676d73c97,3,158,35,193,10,2011-12-24 19:30:54,2011-12-23 22:30:11
2d5c1aeeb470df3e79b1400a5410b73676d73c97...6e95d546e21a3b0925dd5d7f4ef4c17564d11ad0,2,11,2,13,3,2012-01-02 18:09:56,2012-01-02 18:09:56
6e95d546e21a3b0925dd5d7f4ef4c17564d11ad0...3aaea5262d761e0bb6bfef5351cfbfca7af06ec2,1,0,68,68,1,2012-01-08 04:00:41,2012-01-08 04:00:41
3aaea5262d761e0bb6bfef5351cfbfca7af06ec2...86e26ee445a85c72d16d2864c2f33e4f6dbaa3fd,2,6,3,9,4,2012-01-13 00:02:19,2012-01-13 00:02:19
86e26ee445a85c72d16d2864c2f33e4f6dbaa3fd...0b38e1009b7e43b84fd791cfc58bf83fb3c6d0eb,5,51,7,58,8,2012-01-17 05:54:07,2012-01-17 05:54:07
0b38e1009b7e43b84fd791cfc58bf83fb3c6d0eb...68e305862aad6c618211d4e100768a62834d6d2a,2,9,1,10,2,2012-01-17 06:11:08,2012-01-17 06:10:31
68e305862aad6c618211d4e100768a62834d6d2a...29f74a507c12350da117f32630ae5a7fc789c578,1,9,3,12,2,2012-01-20 17:14:10,2012-01-20 17:14:10
29f74a507c12350da117f32630ae5a7fc789c578...c91aa2519e94083fde79177803d15b7717a59707,1,5,0,5,1,2012-01-20 22:12:41,2011-12-22 22:35:00
c91aa2519e94083fde79177803d15b7717a59707...c3449caf1a69c0954647a6a421764e3ad59cccbe,1,14,3,17,4,2012-01-20 23:59:21,2012-01-20 23:59:21
c3449caf1a69c0954647a6a421764e3ad59cccbe...41a6f84004c8f199215cbc193afc469a1b363494,1,64,0,64,3,2012-01-24 05:36:10,2012-01-24 05:36:10
41a6f84004c8f199215cbc193afc469a1b363494...078c791acd376d60c770c444b3fcd2f5a006baa1,1,1,2,3,2,2012-01-24 14:16:42,2012-01-16 19:37:42
078c791acd376d60c770c444b3fcd2f5a006baa1...c202889e9c3d50f3e7557ceb2b1e505b519a7955,1,6,5,11,5,2012-01-24 14:18:05,2012-01-17 22:31:32
c202889e9c3d50f3e7557ceb2b1e505b519a7955...937077b4c15b75411c661232236f3b2cae70ce81,1,23,19,42,9,2012-01-24 14:18:16,2012-01-18 21:35:50
937077b4c15b75411c661232236f3b2cae70ce81...5ca3f271093ddd3c454a0aed45e5edddf5beb1c8,1,427,0,427,1,2012-01-24 15:28:09,2011-11-18 15:39:41
5ca3f271093ddd3c454a0aed45e5edddf5beb1c8...076f88cf6fe68d1ae5a404934e5cd492f1436352,1,7,2,9,1,2012-01-24 15:28:12,2012-01-18 21:25:58
076f88cf6fe68d1ae5a404934e5cd492f1436352...ab1e828dd777945a0afe67c66c37ca2deb2c6ee1,2,14,9,23,8,2012-01-26 06:36:41,2012-01-26 06:36:41
ab1e828dd777945a0afe67c66c37ca2deb2c6ee1...6f9da3de694eee253aaa5dc9ed4ffbb7a9a0c4f8,1,5,5,10,4,2012-01-31 15:21:16,2012-01-31 15:21:16
6f9da3de694eee253aaa5dc9ed4ffbb7a9a0c4f8...330e2a74077be803f6301331c489ab181beae1da,1,5,5,10,4,2012-01-31 15:37:22,2012-01-31 15:37:22
330e2a74077be803f6301331c489ab181beae1da...9bc41894719f1ba737d62d4c71e2d55d896b45c1,1,2,2,4,2,2012-01-31 15:37:37,2012-01-31 15:37:37
9bc41894719f1ba737d62d4c71e2d55d896b45c1...9bbdf6d86baf675796cdce0610c4d3de39583079,1,11,2,13,3,2012-01-31 15:48:03,2012-01-31 15:47:49
9bbdf6d86baf675796cdce0610c4d3de39583079...4770f74e6ee5dd6ebc42f0733fa6e25f08192d98,1,16,3,19,1,2012-01-31 16:20:02,2012-01-31 16:19:42
4770f74e6ee5dd6ebc42f0733fa6e25f08192d98...5e29dc25bb05469524e53daf9a9fa1d9e6847056,1,1,2,3,1,2012-01-31 16:32:59,2012-01-31 16:32:59
5e29dc25bb05469524e53daf9a9fa1d9e6847056...527d4d28df94e6cc769d65a94e2827b5b39d6170,1,1,1,2,1,2012-02-01 18:58:04,2012-01-24 22:42:17
527d4d28df94e6cc769d65a94e2827b5b39d6170...9a09c9f1af58f8c3f78848cf4e158c082d1bf6be,1,3,0,3,1,2012-02-01 18:58:17,2012-01-23 18:14:00
9a09c9f1af58f8c3f78848cf4e158c082d1bf6be...6b2231a15c45104c5e8ed292ab4eb5ad3fc94a29,2,165,37,202,27,2012-02-01 19:00:05,2011-12-07 22:15:16
4ee458d6b490e4ba6669f2e861dcec5cbf7142d4...1e2b1b04ab525f6096c5ef86b0f2f4436940d862,1,0,0,0,0,2011-12-06 23:00:13,2011-12-06 23:00:13
1e2b1b04ab525f6096c5ef86b0f2f4436940d862...43fed132660bdfe1b779d0b8893032e92ccd7b84,1,2,2,4,2,2011-12-06 23:04:15,2011-12-06 23:04:15
43fed132660bdfe1b779d0b8893032e92ccd7b84...ac4da93fa146a927bd13dc19bb92e9d329463fbc,1,25,5,30,1,2011-12-06 23:05:27,2011-12-06 23:04:47
684fc18ae4c3bdb61c7aa283ac5afc584ca202aa...ea002ab4b973445e9fb760993d9125d0bf2507ce,3,46,2,48,7,2011-09-18 04:49:25,2011-09-18 04:49:25
ea002ab4b973445e9fb760993d9125d0bf2507ce...d21a268c20dc15a28aa09ac3c7405b01a68a20aa,3,11,0,11,3,2011-09-18 04:57:02,2011-09-18 04:57:02
d21a268c20dc15a28aa09ac3c7405b01a68a20aa...af4722d9fe80e1c4a51b00cdc97bbc6026e4d3a9,1,6,0,6,2,2011-09-18 05:04:44,2011-09-18 05:04:44
af4722d9fe80e1c4a51b00cdc97bbc6026e4d3a9...850392454dc67d3f6869a1e89eef2ebaec3c1ff4,5,18,24,42,6,2011-09-18 05:32:47,2011-09-18 05:32:47
850392454dc67d3f6869a1e89eef2ebaec3c1ff4...4fd059498f0b908d011bef5f4511315a1c554cd4,2,7,0,7,3,2011-09-18 16:52:09,2011-09-18 16:52:09
4fd059498f0b908d011bef5f4511315a1c554cd4...e00aa7eb3223e7b6dcc55af521fccd51e10b0b11,3,4,10,14,6,2011-09-18 19:35:46,2011-09-18 19:35:46
e00aa7eb3223e7b6dcc55af521fccd51e10b0b11...fa6ebc65bee94d2514f28afe5c6094f352dd28d3,5,78,13,91,13,2011-09-18 21:23:28,2011-09-18 21:23:28
fa6ebc65bee94d2514f28afe5c6094f352dd28d3...c85b73a1b0ebdf115f0818bf22f352f92a2c6121,3,35,15,50,10,2011-09-19 15:33:16,2011-09-13 22:18:04
c85b73a1b0ebdf115f0818bf22f352f92a2c6121...1f4be0a35ce8f389aa94d437e39ceef3f4d942e9,1,7,3,10,3,2011-09-19 17:06:04,2011-09-19 17:06:04
1f4be0a35ce8f389aa94d437e39ceef3f4d942e9...40ca7c408d3560a4909627fda6b51b3ee334e667,1,6,0,6,1,2011-09-19 17:29:37,2011-09-19 17:29:37
40ca7c408d3560a4909627fda6b51b3ee334e667...eb490600f60ad1186cc157d6adc77691e8cd1330,1,2,4,6,4,2011-09-19 19:25:36,2011-09-19 19:25:03
eb490600f60ad1186cc157d6adc77691e8cd1330...934614f0dc21653c8f49a1eb7120af029f7b8091,1,1,1,2,1,2011-09-19 19:31:46,2011-09-19 19:31:46
934614f0dc21653c8f49a1eb7120af029f7b8091...a00f768a98f801c7c8535771bf9e8d7fd7085f9f,1,3,0,3,2,2011-09-19 21:42:11,2011-09-19 06:32:59
a00f768a98f801c7c8535771bf9e8d7fd7085f9f...02e37cb0218dc70f8d6fa27966b25f31ddc355d7,2,15,2,17,7,2011-09-19 21:42:11,2011-09-19 19:07:04
02e37cb0218dc70f8d6fa27966b25f31ddc355d7...48ca7cd1de01106566ce790395ba8515d8fb0b85,1,23,0,23,1,2011-09-19 21:56:37,2011-09-19 21:56:37
48ca7cd1de01106566ce790395ba8515d8fb0b85...5857346b9b726637c7bf46d2a8ac4a0539d5da85,1,18,6,24,2,2011-09-20 01:38:45,2011-09-20 01:38:45
684fc18ae4c3bdb61c7aa283ac5afc584ca202aa...c05baff357ff9d3e467aad7c074a85ccd81ff86a,1,2,0,2,1,2011-09-17 15:11:44,2011-09-17 15:11:44
c05baff357ff9d3e467aad7c074a85ccd81ff86a...ebbeded5ba34ed5bef7bfac215786ed3ce441f7e,1,2,2,4,2,2011-09-18 15:40:29,2011-09-18 15:39:55
ebbeded5ba34ed5bef7bfac215786ed3ce441f7e...c27acf3c3160758ab21c9e4867d033dd8f5e7d41,1,23,0,23,1,2011-09-19 12:58:22,2011-09-19 12:58:22
279adb20a0d67d6cd6a93eb48338d49d2495d27f...96eb641a6905670f5d4be4537d38c42508d1f0e9,3,9,4,13,4,2011-11-16 19:21:47,2011-11-16 19:21:47
279adb20a0d67d6cd6a93eb48338d49d2495d27f...8d8b272225b9a2e98f25525e0e2e7f032420388f,3,36,20,56,27,2011-11-16 18:07:37,2011-11-16 18:07:37
8d8b272225b9a2e98f25525e0e2e7f032420388f...62554d064a264f9b6c28099ba71421f250bbbba9,3,45,34,79,12,2011-11-16 18:25:12,2011-11-16 18:25:12
62554d064a264f9b6c28099ba71421f250bbbba9...366553c97e26b82c24fb28265b70c8b11be6f0a9,3,17,17,34,3,2011-11-16 18:51:59,2011-11-16 18:51:59
c879a4c3a04cad2f13c1ced41ac648f93dbbb839...c7d800c733ecbfdde9e2594c11d1b25cd1e7ceeb,8,127,9,136,18,2012-08-08 15:39:46,2012-08-08 15:32:39
c7d800c733ecbfdde9e2594c11d1b25cd1e7ceeb...f7fdee2e22b37c20a2999fe579111f0fb1f5eb91,1,76,2,78,5,2012-08-08 20:47:56,2012-08-08 20:47:24
f7fdee2e22b37c20a2999fe579111f0fb1f5eb91...797654e85cb58cc8fa6310be3b619bb3f568c784,1,11,0,11,1,2012-08-08 20:47:45,2012-08-07 19:52:51
797654e85cb58cc8fa6310be3b619bb3f568c784...e6d8466bc18b4b6c686a745276e745b69abc6ebd,1,2,76,78,5,2012-08-08 20:52:12,2012-08-08 20:50:56
e6d8466bc18b4b6c686a745276e745b69abc6ebd...368c55d0f63a2914ec6c0b6cd30fdaafd1b01090,1,126,5,131,4,2012-08-08 20:59:44,2012-08-08 20:59:44
368c55d0f63a2914ec6c0b6cd30fdaafd1b01090...e6f62bb3cd09822635bb9eb241041acd50aaed92,1,4,2,6,2,2012-08-08 21:46:54,2012-08-08 21:46:48
e6f62bb3cd09822635bb9eb241041acd50aaed92...02ec29038e81588c29cd463fa5e6610c23f20fae,3,30,2,32,5,2012-08-08 21:49:16,2012-08-08 21:10:14
02ec29038e81588c29cd463fa5e6610c23f20fae...e09439b53ea25f7df38b06c159e78d97e0e9f310,1,77,74,151,12,2012-08-08 22:00:21,2012-08-08 21:56:33
e09439b53ea25f7df38b06c159e78d97e0e9f310...a3dd87187cc8788788dc1fe51b71acdfc18b1ffe,1,13,16,29,2,2012-08-08 22:29:47,2012-08-08 22:29:47
a3dd87187cc8788788dc1fe51b71acdfc18b1ffe...f69d15b42a46326aabc436077c047adfa6fa6061,1,2,2,4,2,2012-08-08 22:34:03,2012-08-08 22:34:03
f69d15b42a46326aabc436077c047adfa6fa6061...4e7a01cb208120a7ff956d8ae7d37b8c00a36c71,1,1,1,2,1,2012-08-09 01:22:29,2012-08-09 01:22:29
4e7a01cb208120a7ff956d8ae7d37b8c00a36c71...5d1e7ee54e6e533a708ed02f280edf92cf73ced6,1,12,0,12,2,2012-08-09 02:37:20,2012-08-09 02:37:20
5d1e7ee54e6e533a708ed02f280edf92cf73ced6...78de2819dca377af2e4c26b1160832336a573126,2,45,7,52,4,2012-08-09 05:42:21,2012-08-09 05:41:59
78de2819dca377af2e4c26b1160832336a573126...ea9d4e5c7451b25ac92bb00fa634f97116fdbe50,1,1,0,1,1,2012-08-09 14:28:12,2012-08-09 14:12:57
ea9d4e5c7451b25ac92bb00fa634f97116fdbe50...2b88d81471dd7ebb1e03ec23af125f17babf8944,1,3,1,4,2,2012-08-09 14:35:53,2012-08-09 14:33:18
2b88d81471dd7ebb1e03ec23af125f17babf8944...4301fc45d66930bc1fd89d60afc43dbe25c54e60,1,0,1,1,1,2012-08-09 14:44:41,2012-08-09 14:44:41
4301fc45d66930bc1fd89d60afc43dbe25c54e60...d9086ade1ccadd010a7c253091619d177efee326,3,2,30,32,5,2012-08-09 14:44:48,2012-08-09 14:44:48
d9086ade1ccadd010a7c253091619d177efee326...575b8abf4f2e4adfbab84815f06332044dfec721,1,0,4,4,3,2012-08-09 15:43:16,2012-08-09 15:43:16
575b8abf4f2e4adfbab84815f06332044dfec721...58acf9dc86cb571a18e5b720eff11c5e4b55a598,2,12,9,21,2,2012-08-09 16:20:53,2012-08-09 15:25:33
58acf9dc86cb571a18e5b720eff11c5e4b55a598...8ce807a63f06d045c7801d4273f6589d8720e2c2,1,6,2,8,3,2012-08-09 19:34:28,2012-08-09 19:34:28
8ce807a63f06d045c7801d4273f6589d8720e2c2...33bb2435347e1b5423c05c521e8106b65b0e411b,1,6,0,6,1,2012-08-09 20:23:00,2012-08-09 20:11:41
33bb2435347e1b5423c05c521e8106b65b0e411b...7154c90657c40512b7a40478b19c73bb291e7fa6,1,2,1,3,2,2012-08-09 20:24:46,2012-08-09 20:11:33
9dca13232a0578e30311f2f27bd150d83bb0b00d...528e48fceafa1344109f47ce225bccb001f677a7,1,9,6,15,3,2012-08-02 19:17:13,2012-08-02 19:17:13
9dca13232a0578e30311f2f27bd150d83bb0b00d...45667b3132dcc43204c7058d6db0ef997a053d52,1,7,3,10,3,2012-08-02 18:41:10,2012-08-02 18:41:10
45667b3132dcc43204c7058d6db0ef997a053d52...7d1f0993f5472d8035abbf89814546cf6829aa50,1,3,1,4,1,2012-08-02 18:45:00,2012-08-02 18:45:00
7d1f0993f5472d8035abbf89814546cf6829aa50...b4e02235c4e7d01c33a597baa5b8391fe86d1117,1,9,9,18,3,2012-08-02 19:11:57,2012-08-02 18:31:29
b4e02235c4e7d01c33a597baa5b8391fe86d1117...e1bada0e7d8225a5a6327a4a9ab2158df18754ce,3,36,5,41,18,2012-08-02 19:11:58,2012-08-02 19:02:56
e1bada0e7d8225a5a6327a4a9ab2158df18754ce...1a956a8214513ad827d059e88d6cba2948e03dfd,1,25,2,27,4,2012-08-02 19:11:58,2012-08-02 19:11:24
9627f43e24c0519d57b9e1aef57b37a4228ded7e...7fe6b77cf82cf6c4dba2a0d8be238e20048c37f8,1,2,1,3,1,2012-07-26 22:08:33,2012-07-26 22:08:33
7fe6b77cf82cf6c4dba2a0d8be238e20048c37f8...59ff12af84e2c7e74d7faa8810f44de7af454d99,2,29,14,43,8,2012-07-26 23:52:38,2012-07-20 23:39:02
59ff12af84e2c7e74d7faa8810f44de7af454d99...c41ed5c474f4da4a4bbb3890f2e1d4171de02d42,1,4,1,5,2,2012-07-26 23:52:38,2012-07-26 22:23:34
c41ed5c474f4da4a4bbb3890f2e1d4171de02d42...b83edef89f7f7194fd247c813d9fb0aaf59a3873,3,13,3,16,4,2012-07-27 14:51:17,2012-07-23 18:57:45
b83edef89f7f7194fd247c813d9fb0aaf59a3873...6d21cc3766075927544b4255af3914083724005d,1,4,3,7,3,2012-07-27 16:56:48,2012-07-27 16:53:54
6d21cc3766075927544b4255af3914083724005d...a78612086d9247cfb602f6359fca555bdcdbaf07,1,9,4,13,4,2012-07-27 17:36:59,2012-07-27 17:34:22
a78612086d9247cfb602f6359fca555bdcdbaf07...1856f0b988842e5aba09f9b61622a625927e6244,2,25,0,25,2,2012-07-27 18:30:39,2012-07-23 20:22:43
1856f0b988842e5aba09f9b61622a625927e6244...859c7268aebb0dcd6ce0f67e717bf5a5373dbf3f,2,2,55,57,2,2012-07-27 18:30:40,2012-07-23 22:02:32
859c7268aebb0dcd6ce0f67e717bf5a5373dbf3f...d3b12c40a91d20dc5b86e40402308c7b2320f9a5,8,59,109,168,16,2012-07-27 18:30:40,2012-07-24 13:59:40
d3b12c40a91d20dc5b86e40402308c7b2320f9a5...186c5a411c3a1e616f7e876820a13af46d6faa4c,5,65,100,165,31,2012-07-27 19:21:43,2012-07-23 21:27:55
186c5a411c3a1e616f7e876820a13af46d6faa4c...c86c2aee41cf671066eb46933de15c8df49e615b,5,24,5,29,7,2012-07-27 19:21:43,2012-07-25 14:47:24
c86c2aee41cf671066eb46933de15c8df49e615b...b5a215f3602ff054025732d082453bd503757792,1,11,5,16,4,2012-07-27 19:21:43,2012-07-26 14:29:12
b5a215f3602ff054025732d082453bd503757792...a7258d30d840c0dd030922b4a521a779fc039514,2,13,4,17,5,2012-07-27 19:21:44,2012-07-23 14:34:09
a7258d30d840c0dd030922b4a521a779fc039514...2fe420dad36bc560c5cac1b43901aa3140e706b0,2,18,18,36,10,2012-07-27 19:21:44,2012-07-26 14:59:22
2fe420dad36bc560c5cac1b43901aa3140e706b0...9d1b489590cd526bd1e4ee5f117273dd203acaaf,6,36,15,51,14,2012-07-27 19:21:44,2012-07-27 18:16:59
9d1b489590cd526bd1e4ee5f117273dd203acaaf...e2a134e3b19855af83cb381b48f56d6f7cca9c6c,1,9,41,50,6,2012-07-27 19:35:08,2012-07-27 16:48:32
e2a134e3b19855af83cb381b48f56d6f7cca9c6c...7e3d22d0c4e73eccaf108f0f24faca3f633b63fd,4,9,11,20,6,2012-07-27 19:35:08,2012-07-27 17:15:55
7e3d22d0c4e73eccaf108f0f24faca3f633b63fd...314f893cd192ce579412e2fb4328ddcf0082935e,1,12,7,19,4,2012-07-27 20:08:09,2012-07-25 18:25:13
314f893cd192ce579412e2fb4328ddcf0082935e...f6c3b8012f42d56afaadfcfc76378a975ad116f8,2,81,1,82,3,2012-07-27 20:44:28,2012-07-24 20:05:08
f6c3b8012f42d56afaadfcfc76378a975ad116f8...95dd211996d04e2152a3f38230e82e2c66dc5049,1,0,7,7,1,2012-07-27 20:51:01,2012-07-27 00:27:37
95dd211996d04e2152a3f38230e82e2c66dc5049...ef5020fa5c1d5b25091b4c7a7d7c21bf73eb08e8,2,6,1,7,2,2012-07-28 03:12:08,2012-07-28 03:12:08
ef5020fa5c1d5b25091b4c7a7d7c21bf73eb08e8...dcd590359928f3ef5a225e590bbff35bf4896533,3,33,3,36,4,2012-07-29 00:10:42,2012-07-22 13:04:21
dcd590359928f3ef5a225e590bbff35bf4896533...97356776be244308f4540cb2ca3d5a22a451e23a,2,4,6,10,2,2012-07-29 00:10:42,2012-07-22 19:41:39
97356776be244308f4540cb2ca3d5a22a451e23a...528da0822a1468e9b8ecf01c4cfc08346f621dd9,2,59,4,63,10,2012-07-29 00:10:42,2012-07-28 21:22:52
528da0822a1468e9b8ecf01c4cfc08346f621dd9...bc133a93329bcebc1fe9b313920afd865ecacb99,1,2,0,2,2,2012-07-29 11:53:48,2012-07-29 01:20:20
bc133a93329bcebc1fe9b313920afd865ecacb99...f577ac69a7505a4b2d704a8044829258e8f2388b,2,75,0,75,2,2012-07-29 14:57:33,2012-07-26 22:03:28
f577ac69a7505a4b2d704a8044829258e8f2388b...701117ed39525f6bbda2a91792313734e0ae84de,1,6,3,9,2,2012-07-29 15:12:25,2012-07-29 14:47:39
701117ed39525f6bbda2a91792313734e0ae84de...a2bb2d0bdc92cbfd02f88a0395ad76422dcdea4a,1,2,2,4,1,2012-07-29 15:12:25,2012-07-29 14:54:17
a2bb2d0bdc92cbfd02f88a0395ad76422dcdea4a...6093859119fde2309f70e13d6bcf853cf8f88a88,2,4,27,31,15,2012-07-30 09:12:49,2012-07-30 09:12:49
6093859119fde2309f70e13d6bcf853cf8f88a88...83ec59844bdd629b2b32a9791a4e7a0e93516c02,1,96,24,120,21,2012-07-30 15:04:28,2012-07-28 03:11:08
83ec59844bdd629b2b32a9791a4e7a0e93516c02...c722882f2e33420f5483b0b01b63f7c68097cae0,1,4,4,8,1,2012-07-30 15:09:35,2012-07-30 15:09:14
c722882f2e33420f5483b0b01b63f7c68097cae0...e2172bee7f83d73243f715d6250ebcdd151983d7,1,11,0,11,2,2012-07-30 15:31:05,2012-07-30 15:28:50
e2172bee7f83d73243f715d6250ebcdd151983d7...48f08399e43a2dc33372d59bc60886733dff5679,1,3,2,5,2,2012-07-30 17:41:40,2012-07-30 16:50:50
48f08399e43a2dc33372d59bc60886733dff5679...624bc33260275d1b35c19bd8899ec64de113b2de,1,4,0,4,4,2012-07-30 17:41:49,2012-07-30 16:53:02
624bc33260275d1b35c19bd8899ec64de113b2de...26bac65b80ea0259b67b3d60c4c618bf7d55a094,1,93,27,120,16,2012-07-30 18:27:04,2012-07-30 18:25:09
26bac65b80ea0259b67b3d60c4c618bf7d55a094...b88ce8e3a6dcc435e1f671e1127eedb8a597f8c1,10,759,1,760,7,2012-07-30 18:53:53,2012-07-27 23:23:20
b88ce8e3a6dcc435e1f671e1127eedb8a597f8c1...048e9b2027146a90b05a21564bc0385c290b9eaa,2,23,4,27,4,2012-07-30 19:39:59,2012-07-30 19:39:21
048e9b2027146a90b05a21564bc0385c290b9eaa...3ac0e57723cd6169e305b6795b686ec45b2d4b83,1,5,1,6,2,2012-07-30 20:06:32,2012-07-30 19:01:01
3ac0e57723cd6169e305b6795b686ec45b2d4b83...424df087f9256b85e7b3a9b31d36518081ff2875,5,171,3,174,10,2012-07-30 20:07:09,2012-07-05 19:05:10
424df087f9256b85e7b3a9b31d36518081ff2875...f86f60afe1ee1af619662002e8640cf6555aef02,1,7,4,11,3,2012-07-30 22:17:08,2012-07-30 20:49:31
f86f60afe1ee1af619662002e8640cf6555aef02...4739cf06b933d955ed260dfcbd74f0411c3a5ffa,1,4,1,5,2,2012-07-31 17:08:31,2012-07-31 17:08:31
4739cf06b933d955ed260dfcbd74f0411c3a5ffa...bb2b218b02b60e03ddd3487f7bf159497645f7e9,1,2,3,5,1,2012-07-31 17:24:28,2012-07-31 17:24:28
bb2b218b02b60e03ddd3487f7bf159497645f7e9...5300139ceb188361f773c7a6f3c24f9fe9affd6a,3,23,5,28,5,2012-07-31 18:13:20,2012-07-30 22:33:08
a63b87ae156352f742aa7fe22cbdd9c204c8e3a2...cd68b47b2fdeae382ce82754f7541b4467ce03c8,1,2,2,4,2,2012-10-03 16:36:15,2012-10-03 16:36:15
a63b87ae156352f742aa7fe22cbdd9c204c8e3a2...88f44d3af09e31b13fa10571ade67aa3319900c7,3,47,96,143,14,2012-10-01 19:08:56,2012-10-01 19:08:56
88f44d3af09e31b13fa10571ade67aa3319900c7...122deef984b65d61345eadbfe16c608292a61026,1,0,31,31,2,2012-10-01 19:09:04,2012-10-01 19:09:04
122deef984b65d61345eadbfe16c608292a61026...60285d543afbae6e50944aa0bf3862b9f8c5ab5a,2,11,26,37,7,2012-10-01 20:43:07,2012-10-01 19:35:44
60285d543afbae6e50944aa0bf3862b9f8c5ab5a...a375eb933859da6853789b29c36a0a282690a9d3,1,2,3,5,1,2012-10-02 17:03:09,2012-10-02 17:03:09
a375eb933859da6853789b29c36a0a282690a9d3...670f32edd8451c00a3cf6237231a434c2f7976c4,4,24,13,37,8,2012-10-02 19:42:02,2012-10-02 17:13:15
670f32edd8451c00a3cf6237231a434c2f7976c4...6ebba2b05261798f6da3d03bc7967a09832f242a,1,1,1,2,1,2012-10-02 21:45:42,2012-10-02 21:45:42
6ebba2b05261798f6da3d03bc7967a09832f242a...c1bb1e476d590c696a959b17fe0d1a25a08772b9,2,11,4,15,2,2012-10-02 22:29:39,2012-10-02 22:29:39
c1bb1e476d590c696a959b17fe0d1a25a08772b9...61c48050205153187fb0a2ea40b9b6c417963c52,1,13,5,18,3,2012-10-02 23:07:40,2012-10-02 15:11:44
61c48050205153187fb0a2ea40b9b6c417963c52...8ac89940f1d08b5b8cfd5bf3eeaa0d988c6a3dd4,1,1,1,2,1,2012-10-03 02:06:56,2012-10-03 02:06:43
8ac89940f1d08b5b8cfd5bf3eeaa0d988c6a3dd4...206094501a570a75b2fae5a5eb515dc5b55182bb,5,53,30,83,13,2012-10-03 15:36:03,2012-10-03 15:32:40
206094501a570a75b2fae5a5eb515dc5b55182bb...f59fbbaeec03e453af1db1cb1cfdb00cb7780e48,2,15,7,22,5,2012-10-03 15:49:45,2012-10-03 15:49:45
6b2231a15c45104c5e8ed292ab4eb5ad3fc94a29...3885acaf7a1eb9509c0cc3b12a9c54a259c973f5,1,1,1,2,1,2012-02-03 23:21:20,2012-02-03 23:21:20
3885acaf7a1eb9509c0cc3b12a9c54a259c973f5...2d4f7f4c88b0bce3e96f1098b6d2eecce448388e,1,8,6,14,3,2012-02-03 23:39:54,2012-02-03 23:39:54
2d4f7f4c88b0bce3e96f1098b6d2eecce448388e...9ee926acf4519ada709a0729c9780da98d0748f6,1,7,2,9,3,2012-02-04 00:06:56,2011-10-07 16:44:36
9ee926acf4519ada709a0729c9780da98d0748f6...5c71438495f75c3de4a2f8f8eeb16f226c2f9563,1,5,0,5,2,2012-02-04 00:14:02,2011-12-16 14:48:38
5c71438495f75c3de4a2f8f8eeb16f226c2f9563...5fc7c288e05ef7109e60f08196bd06b4a9ae3ef1,1,1,2,3,2,2012-02-04 06:09:34,2012-01-24 06:00:02
5fc7c288e05ef7109e60f08196bd06b4a9ae3ef1...0bd2737e381f9bb24e6ddf856c9c5db641c4c4b8,1,8,2,10,2,2012-02-04 06:13:02,2012-01-26 04:35:00
0bd2737e381f9bb24e6ddf856c9c5db641c4c4b8...4ef4f1904c55448bb2e197d0dca06b543b1e0a57,1,0,0,0,0,2012-02-04 06:13:58,2012-02-04 06:13:58
4ef4f1904c55448bb2e197d0dca06b543b1e0a57...e74f5546d554f8de441b62f264c73ea86913c4f8,1,1,1,2,1,2012-02-06 05:21:07,2012-02-06 05:20:39
6b2231a15c45104c5e8ed292ab4eb5ad3fc94a29...6b3ab0f6e12da01b2443664534e655aa70685c52,1,8,2,10,2,2012-02-03 04:47:01,2012-01-26 04:35:00
ac4da93fa146a927bd13dc19bb92e9d329463fbc...00742441b924195b2a9d667ca7d72c6306481333,1,50,3,53,5,2011-12-07 10:14:52,2011-12-07 10:14:52
00742441b924195b2a9d667ca7d72c6306481333...b28dd195268b5334f7fd8e81d194392c218feee8,1,4,4,8,3,2011-12-07 14:57:58,2011-12-07 14:57:20
b28dd195268b5334f7fd8e81d194392c218feee8...9ff25c00ba57fcde1ae9b9145b1916fe3060c054,2,4,4,8,4,2011-12-07 16:02:38,2011-12-07 15:39:21
9ff25c00ba57fcde1ae9b9145b1916fe3060c054...ef4eeb2b31c447be757ca3954c37369a97812c56,6,253,27,280,18,2011-12-07 16:35:30,2011-12-07 16:28:12
ef4eeb2b31c447be757ca3954c37369a97812c56...3840cf5b6bb1567307a943ac2d0eb8376c19e982,1,1,0,1,1,2011-12-07 16:37:22,2011-12-07 16:36:28
3840cf5b6bb1567307a943ac2d0eb8376c19e982...a3aaded21e2f306714ebafd3a1e55ef175ce77fc,1,63,4,67,8,2011-12-07 16:37:44,2011-12-05 21:35:29
a3aaded21e2f306714ebafd3a1e55ef175ce77fc...b54e8babe232ef2e9e5c71674b96c22855cc063b,1,128,40,168,14,2011-12-07 16:42:49,2011-12-06 21:53:07
b54e8babe232ef2e9e5c71674b96c22855cc063b...9122c89a7d58a8639e8625e1e4ed8767c4b7dd6b,1,105,0,105,1,2011-12-07 16:42:56,2011-12-06 23:32:11
9122c89a7d58a8639e8625e1e4ed8767c4b7dd6b...ce6a87d9830bdb395e6e3f666e370a3fa498dfdf,5,24,24,48,20,2011-12-07 16:56:06,2011-12-07 16:55:37
ce6a87d9830bdb395e6e3f666e370a3fa498dfdf...9dbed9cb57f1421bb54de0a64efecdd198afab98,1,12,20,32,8,2011-12-07 17:58:53,2011-12-07 17:58:28
9dbed9cb57f1421bb54de0a64efecdd198afab98...e075956715e67e3ce97557e54be3e2eb7926b3f0,1,3,3,6,2,2011-12-07 19:24:03,2011-12-07 19:24:03
e075956715e67e3ce97557e54be3e2eb7926b3f0...4b283c47936ceb85e57e2bfa881f930a274af1d1,1,0,2,2,1,2011-12-07 20:05:49,2011-12-07 20:03:18
4b283c47936ceb85e57e2bfa881f930a274af1d1...73f4ab3c353fbc9572dd2aac539f8bc7abe1b5ab,3,22,3,25,5,2011-12-07 20:34:47,2011-12-07 20:34:47
73f4ab3c353fbc9572dd2aac539f8bc7abe1b5ab...5bd792bd8bf45cc7229119a3e8c62cb71250c500,2,139,27,166,19,2011-12-07 20:51:14,2011-12-02 18:07:56
5bd792bd8bf45cc7229119a3e8c62cb71250c500...4de9280c9924e6a8b48e9abbf15ee887bdfa2c26,1,2,0,2,1,2011-12-07 22:02:09,2011-12-07 22:02:09
4de9280c9924e6a8b48e9abbf15ee887bdfa2c26...e86dbdbe5a9cede162a05702324ec10648f33f11,2,27,139,166,19,2011-12-07 22:11:42,2011-12-07 22:11:42
e86dbdbe5a9cede162a05702324ec10648f33f11...6457aaf593b0ba8c765e261bad8deef2891ab74a,3,41,35,76,13,2011-12-07 22:44:06,2011-12-07 22:42:51
5857346b9b726637c7bf46d2a8ac4a0539d5da85...3fb7da64dffbf224534bc378a4351d5fa4a56495,1,1,1,2,1,2011-09-20 16:10:26,2011-09-20 16:10:17
3fb7da64dffbf224534bc378a4351d5fa4a56495...cfca5a3037c8500fd2e1b999893a85e5fbf80c58,1,16,0,16,1,2011-09-20 18:51:45,2011-09-16 18:49:20
cfca5a3037c8500fd2e1b999893a85e5fbf80c58...6de0bc4ac872269410dbb6477903de507289e75c,1,23,1,24,3,2011-09-20 18:51:45,2011-09-20 18:50:20
6de0bc4ac872269410dbb6477903de507289e75c...b67fee18f481fcc099a5c0d531e51d879c9ee46d,1,2,1,3,1,2011-09-20 20:01:02,2011-09-20 20:01:02
b67fee18f481fcc099a5c0d531e51d879c9ee46d...7399d406b170c2ef7173531c8867f08273f81f58,3,9,3,12,3,2011-09-20 20:05:45,2011-09-20 20:05:45
5857346b9b726637c7bf46d2a8ac4a0539d5da85...11a2a5ea385539dcae09c030199bbb118b7be20c,1,1,1,2,1,2011-09-20 14:42:27,2011-09-20 14:31:50
05f51c94acca6c4ce99aa029bde5b8cd2c367d2b...66697eb748642f57cf7e67a84313ea6c6ca28fb9,3,9,9,18,9,2011-11-17 15:11:10,2011-11-17 15:11:10
05f51c94acca6c4ce99aa029bde5b8cd2c367d2b...d54adbc4c279f3b5a5a30fd95bcf8b529359bf8d,1,23,9,32,4,2011-11-16 19:33:49,2011-11-16 19:32:06
d54adbc4c279f3b5a5a30fd95bcf8b529359bf8d...0b91ed40574ac1835035e7b02ba9bd37af8be871,1,1,1,2,1,2011-11-16 19:33:49,2011-11-16 19:33:29
0b91ed40574ac1835035e7b02ba9bd37af8be871...9bef2fd11e1aa85581c41a7a9ac48ebfb94e7d63,1,79,23,102,13,2011-11-16 20:19:27,2011-11-16 20:19:27
9bef2fd11e1aa85581c41a7a9ac48ebfb94e7d63...51aa7535dbaa360efef413f9c3f489a4b49f573e,2,100,66,166,4,2011-11-16 20:40:58,2011-11-16 20:23:51
51aa7535dbaa360efef413f9c3f489a4b49f573e...2ea225cd7f2aa6fa2f0b93aae375f199a67f9e3f,3,26,8,34,3,2011-11-16 20:40:58,2011-11-16 20:29:43
2ea225cd7f2aa6fa2f0b93aae375f199a67f9e3f...c7af76fe5f01e08d86d34ed2cb2f90677f044a6e,2,7,0,7,3,2011-11-16 20:40:58,2011-11-16 20:30:04
c7af76fe5f01e08d86d34ed2cb2f90677f044a6e...673475764e4a8bebf73cc2e80f7513c263245eb9,2,11,1,12,3,2011-11-16 20:40:58,2011-11-16 20:36:13
673475764e4a8bebf73cc2e80f7513c263245eb9...dfa9b6c2b0a68a57a1d6916467e422fc61cbd64e,3,5,9,14,3,2011-11-16 20:40:58,2011-11-16 20:40:28
dfa9b6c2b0a68a57a1d6916467e422fc61cbd64e...d800b9548e2196f2677870337de017b8b1779e6f,1,6,0,6,1,2011-11-17 07:30:39,2011-11-17 07:30:39
d800b9548e2196f2677870337de017b8b1779e6f...7c8ac68bced92076abdcab3283861116b6a1a841,2,10,12,22,12,2011-11-17 10:41:59,2011-11-17 10:41:59
7c8ac68bced92076abdcab3283861116b6a1a841...25df042c9735700b2540ebcebf005302fb567c22,2,9,0,9,2,2011-11-17 13:05:08,2011-11-17 03:13:42
25df042c9735700b2540ebcebf005302fb567c22...82d29723fc9bf3f20b768cc6d5fcbadce2d96494,1,8,1,9,2,2011-11-17 13:05:10,2011-11-17 03:14:02
82d29723fc9bf3f20b768cc6d5fcbadce2d96494...dddad485197b3a2e6f8fdf8c22aeae75445a06ba,1,1,1,2,1,2011-11-17 13:05:12,2011-11-17 03:14:24
dddad485197b3a2e6f8fdf8c22aeae75445a06ba...0877fc6c93a4a00e013e44cba426ddc3ca335520,8,814,738,1552,15,2011-11-17 13:05:15,2011-11-17 13:04:44
0877fc6c93a4a00e013e44cba426ddc3ca335520...50ac5d623a4d254a8c8892e441b7f91781530d9d,1,4,4,8,1,2011-11-17 13:09:07,2011-11-17 13:09:07
50ac5d623a4d254a8c8892e441b7f91781530d9d...ddadd10a6ea931b6a2c83b741f0032d80cc3a4db,1,0,1,1,1,2011-11-17 12:24:18,2011-11-17 12:24:18
ddadd10a6ea931b6a2c83b741f0032d80cc3a4db...4aa2c8b92b5007f9a8401ccc069b88a3b6a17f3c,2,5,5,10,3,2011-11-17 14:52:51,2011-11-17 14:52:51
7154c90657c40512b7a40478b19c73bb291e7fa6...1c8aa8e544e14a8107c7193d8fca86ed5f4c1d4d,1,5,2,7,2,2012-08-10 20:48:36,2012-08-10 20:27:42
7154c90657c40512b7a40478b19c73bb291e7fa6...8eba6d7ee1660ce55d75d025c246555b2a43dd05,1,2,2,4,2,2012-08-10 20:37:04,2012-08-10 15:54:02
7154c90657c40512b7a40478b19c73bb291e7fa6...767a5a48126b586e13a4af5e1b1e1b7567e8d736,1,1,1,2,2,2012-08-10 14:55:32,2012-08-10 14:55:32
767a5a48126b586e13a4af5e1b1e1b7567e8d736...4de20c728f07f18f6d046967d2c83997bb77d7ae,1,0,10,10,4,2012-08-10 17:19:32,2012-08-10 17:19:32
4de20c728f07f18f6d046967d2c83997bb77d7ae...ff75718dd7ae6c176efab68f91161806ffab3ef0,194,56663,0,56663,194,2012-08-10 19:55:16,2012-08-10 17:45:43
ff75718dd7ae6c176efab68f91161806ffab3ef0...b49bac3c24d57d412a623545c9a3c367ca595b7e,3,403,0,403,3,2012-08-10 19:55:25,2012-08-10 17:47:06
b49bac3c24d57d412a623545c9a3c367ca595b7e...eee3fe4ce66c7bbda9329a3c8bd8e3549b07437c,6,93,10,103,13,2012-08-10 21:19:08,2012-08-10 17:32:42
eee3fe4ce66c7bbda9329a3c8bd8e3549b07437c...066d794339538fb020ec0fe9a27be981ea75b0a9,1,11,5,16,3,2012-08-10 21:38:37,2012-08-10 21:26:06
066d794339538fb020ec0fe9a27be981ea75b0a9...9a3b9ff7e0549dedbb1889b4ef25613fb6351681,1,5,2,7,1,2012-08-10 21:46:14,2012-08-10 21:46:14
9a3b9ff7e0549dedbb1889b4ef25613fb6351681...4c59df9c812fe88f663d102e570c9e5fcf994062,1,2,2,4,2,2012-08-10 21:50:35,2012-08-10 21:50:35
4c59df9c812fe88f663d102e570c9e5fcf994062...572d39f494ea5aa292c03e24c793875a9b059c63,1,2,1,3,1,2012-08-10 22:15:24,2012-08-10 22:15:16
572d39f494ea5aa292c03e24c793875a9b059c63...f9dc7514f4132f6fa5fa695b688aeafb4e63040e,1,7,2,9,4,2012-08-10 22:32:11,2012-08-10 22:11:42
f9dc7514f4132f6fa5fa695b688aeafb4e63040e...296d6e6a52d3583c823cce81b4e1cb89a43b3b36,1,5,16,21,3,2012-08-11 02:50:54,2012-08-11 02:50:54
b2ed1f45159eddd92c01451f99e078127c724e9d...4a192219a4d11fb4f3ac567074f6e6d525e02b92,1,1,1,2,1,2012-08-02 19:56:50,2012-08-02 19:56:50
4a192219a4d11fb4f3ac567074f6e6d525e02b92...910d0198d28f164b7d326a121c012e945aec8953,1,37,0,37,1,2012-08-02 20:19:46,2012-08-02 17:48:10
910d0198d28f164b7d326a121c012e945aec8953...9784f744b0eb46eea4421c7f21d52ab2f9fceab3,1,6,0,6,1,2012-08-02 21:32:47,2012-08-02 21:32:30
9784f744b0eb46eea4421c7f21d52ab2f9fceab3...dd8121057d113c666eadec6dc07b360dea00d385,3,0,52,52,3,2012-08-02 21:47:59,2012-07-12 18:41:44
dd8121057d113c666eadec6dc07b360dea00d385...f3343c4e1cde8517b63f9e3a0673c7a09ddf232d,1,14,2,16,2,2012-08-02 21:47:59,2012-08-02 17:12:37
f3343c4e1cde8517b63f9e3a0673c7a09ddf232d...b9eacf04d88dfa461497ef9dcf2acc771f2ae209,5,14,71,85,10,2012-08-02 21:47:59,2012-08-02 17:17:11
b9eacf04d88dfa461497ef9dcf2acc771f2ae209...e9bfafe93d0509a46f43e1ee8d8cc0a2bb64bd53,2,11,3,14,4,2012-08-02 21:47:59,2012-08-02 17:39:46
e9bfafe93d0509a46f43e1ee8d8cc0a2bb64bd53...3bb4644a36c22179df8decd0152a8c5dd77a852c,13,38,38,76,27,2012-08-02 23:02:17,2012-08-02 23:02:17
3bb4644a36c22179df8decd0152a8c5dd77a852c...47affd0dd493aa30059b8afb7b2860096689cb87,1,3,1,4,2,2012-08-02 23:24:26,2012-08-02 23:24:26
47affd0dd493aa30059b8afb7b2860096689cb87...9052552b34c22d70e41498305909bacbd2bddc64,1,2,2,4,2,2012-08-02 23:27:19,2012-08-02 23:27:19
9052552b34c22d70e41498305909bacbd2bddc64...4aaed4ccfb608db56a269e0422f6d48385c28445,1,2,2,4,1,2012-08-02 23:36:17,2012-08-02 23:36:17
84309bfc21feefb16f784a5f5bd728c498909093...6e692daaa3b6a37aae62d8d959a8efd1ecb96a94,4,15,4,19,7,2012-10-04 17:31:40,2012-10-04 17:31:40
6e692daaa3b6a37aae62d8d959a8efd1ecb96a94...aeb1c98985e65919a05e8337dcf61578eba9f52d,1,15,9,24,5,2012-10-04 17:42:53,2012-10-04 17:42:53
84309bfc21feefb16f784a5f5bd728c498909093...9c963f8a637d84375970ef758e12f5732a47b2a1,1,1,1,2,1,2012-10-03 18:20:24,2012-10-03 18:20:24
43fa534919634758b32353c77f18a4e608a39206...d39bc96a0c15ee6714a53aee21e58f93a284c513,1,9,1,10,1,2012-02-06 05:52:20,2012-02-06 05:52:20
d39bc96a0c15ee6714a53aee21e58f93a284c513...643c3a25c7fa272a3ff343a7ed653f0cef17f60f,2,2,2,4,2,2012-02-06 18:12:10,2012-02-06 18:12:10
643c3a25c7fa272a3ff343a7ed653f0cef17f60f...d77cc8d850c0e27db8684c716af28b05f7ed2de1,2,2,2,4,2,2012-02-07 15:43:31,2012-02-07 15:43:31
d77cc8d850c0e27db8684c716af28b05f7ed2de1...dd046106ba1c8de1c1ae8f5830981e18ce3dd597,2,62,5,67,4,2012-02-10 00:25:00,2012-02-02 19:52:50
dd046106ba1c8de1c1ae8f5830981e18ce3dd597...ad9f37fddbbbf4b4bbcdb2ae1870f0cc9d0f5eb9,1,12,5,17,1,2012-02-15 15:09:25,2012-02-15 15:09:25
ad9f37fddbbbf4b4bbcdb2ae1870f0cc9d0f5eb9...2bedc3cf68bcd4cf6f5690ce5901df5f60b54bcb,1,8,1,9,2,2012-02-15 15:14:17,2012-02-15 15:14:17
2bedc3cf68bcd4cf6f5690ce5901df5f60b54bcb...8c259b9984bb4a791c879438cd1def3b40455041,1,3,1,4,2,2012-02-15 15:16:44,2012-02-15 15:16:44
8c259b9984bb4a791c879438cd1def3b40455041...8849484b70ed0bbaf820e6fc49168fc399129bbc,1,5,5,10,4,2012-02-15 15:19:38,2012-02-15 15:19:38
8849484b70ed0bbaf820e6fc49168fc399129bbc...24e1f0b92e438f336a3d7acac4f341eaddd89af2,1,5,1,6,2,2012-02-15 21:39:20,2011-10-28 20:27:59
24e1f0b92e438f336a3d7acac4f341eaddd89af2...f96f1c70ec5154a07c1171b421953961ea480737,1,14,1,15,2,2012-02-15 21:46:57,2011-10-28 20:28:25
f96f1c70ec5154a07c1171b421953961ea480737...29cd169c4dccacb86d33bc9e30833ea1ae422d3e,1,13,0,13,1,2012-02-15 21:48:45,2011-11-29 22:33:07
29cd169c4dccacb86d33bc9e30833ea1ae422d3e...3b1fecd96836829e8595813d7773d229839a6c25,1,1,1,2,1,2012-02-16 19:19:10,2012-02-16 19:19:10
3b1fecd96836829e8595813d7773d229839a6c25...7948814df6a70e0d616f7804c5ee253d409de0f9,1,1,0,1,1,2012-02-17 03:47:54,2012-02-17 03:47:36
7948814df6a70e0d616f7804c5ee253d409de0f9...ac5eb821bb87bc22fe1b4c9ea763dceec0df9d9a,2,2,2,4,2,2012-02-17 15:49:28,2012-02-17 15:49:28
ac5eb821bb87bc22fe1b4c9ea763dceec0df9d9a...a83ab12c51f9e8cf3457c46a4e1673461b037e79,2,2,2,4,2,2012-02-18 06:49:38,2012-02-18 06:49:38
a83ab12c51f9e8cf3457c46a4e1673461b037e79...3fc4863624c286a12d9c6b85dfd485f7cb87bb95,1,2,0,2,1,2012-02-20 14:29:01,2011-09-12 20:37:53
3fc4863624c286a12d9c6b85dfd485f7cb87bb95...05bb8aa793660af8fce7e36b510ad48c27439697,4,10,3,13,4,2012-02-27 00:44:09,2012-02-27 00:44:09
05bb8aa793660af8fce7e36b510ad48c27439697...05da017dee6c2ca146eeed8c4d14fbbf2c2b6330,2,2,2,4,2,2012-02-28 04:43:29,2012-02-28 04:43:29
05da017dee6c2ca146eeed8c4d14fbbf2c2b6330...c5463305226dfb8f42eb5235ac381442006b29dd,2,25,25,50,4,2012-03-01 22:36:58,2012-03-01 22:36:58
c5463305226dfb8f42eb5235ac381442006b29dd...32cc883b299b6d5f3bf8be4c74c448192453d818,1,4,4,8,2,2012-03-02 18:43:23,2012-03-02 18:43:23
32cc883b299b6d5f3bf8be4c74c448192453d818...816af2185cb85726bf47f4be724bb58ece20703f,2,20,1,21,3,2012-03-02 21:03:09,2012-03-02 21:03:09
816af2185cb85726bf47f4be724bb58ece20703f...5899a6daa5170289b9db04a41670de7677acd03f,2,42,0,42,2,2012-03-05 00:52:10,2012-02-08 21:04:08
5899a6daa5170289b9db04a41670de7677acd03f...b626e959a3283c1b7eec052a372b244505dc81a2,1,1,1,2,1,2012-03-05 01:07:40,2011-10-26 14:36:00
b626e959a3283c1b7eec052a372b244505dc81a2...d13fb74970b28a3df5806f522790fb194724b0a7,1,1,1,2,1,2012-03-05 01:08:46,2012-02-28 22:43:19
d13fb74970b28a3df5806f522790fb194724b0a7...abb62840567ae8e342fcd07c845765f7fca9e7a8,1,6,3,9,3,2012-03-05 01:09:23,2012-02-29 18:10:54
abb62840567ae8e342fcd07c845765f7fca9e7a8...446f597cf423d62df0b4a6c292b57da1f382649c,1,4,1,5,2,2012-03-05 01:13:20,2012-03-05 01:13:20
446f597cf423d62df0b4a6c292b57da1f382649c...edc6a4892119009b514202e4d0c97d5c3bf54e1d,2,25,2,27,6,2012-03-06 17:57:34,2012-03-02 18:55:53
edc6a4892119009b514202e4d0c97d5c3bf54e1d...8983591f83c0817d0bf46a29d338db910399d8e7,3,6,6,12,4,2012-03-06 17:57:59,2012-03-06 16:26:23
8983591f83c0817d0bf46a29d338db910399d8e7...d216bc37c309baa162f3a760ac72f991054703c9,2,2,2,4,2,2012-03-06 18:00:58,2012-02-24 17:57:57
d216bc37c309baa162f3a760ac72f991054703c9...67c9ac45c3c5f9496d10fb8c74cab683c2f5fa2b,2,2,2,4,2,2012-03-06 18:08:38,2012-03-06 18:08:38
67c9ac45c3c5f9496d10fb8c74cab683c2f5fa2b...cc61e1f8fc2cf68aea83dab12f9765ee4b8f51c4,2,2,2,4,2,2012-03-08 06:04:35,2012-03-08 06:04:35
cc61e1f8fc2cf68aea83dab12f9765ee4b8f51c4...22ffe27906c23d1b8567dfc1ab7276f579019b78,3,128,18,146,14,2012-03-08 16:41:58,2012-03-08 16:41:58
22ffe27906c23d1b8567dfc1ab7276f579019b78...240177f3cb3f00641d0f0b706315d724d35b7fbc,2,2,2,4,2,2012-03-12 05:07:40,2012-03-12 05:07:40
240177f3cb3f00641d0f0b706315d724d35b7fbc...9ede2213f3b9d5af63354975c94c233aad00ecc1,2,2,2,4,2,2012-03-12 19:49:07,2012-03-12 19:49:07
9ede2213f3b9d5af63354975c94c233aad00ecc1...329f3c47fe8136c03392c8f0e548506cb21f8ebf,4,10,3,13,4,2012-03-19 16:10:40,2012-03-19 16:10:40
329f3c47fe8136c03392c8f0e548506cb21f8ebf...5893841d961b281661a8cdb3f523d19a2d7b74b5,2,2,2,4,2,2012-03-20 03:54:04,2012-03-20 03:54:04
5893841d961b281661a8cdb3f523d19a2d7b74b5...bb76d2d736570a975ff4f609cae899e11d04eb9e,1,11,1,12,3,2012-03-20 19:09:05,2012-03-20 15:32:19
bb76d2d736570a975ff4f609cae899e11d04eb9e...64f3b376ca0bd04712bb6e02a508a3a0f4fbab63,1,7,5,12,3,2012-03-26 15:40:46,2012-03-26 15:38:52
64f3b376ca0bd04712bb6e02a508a3a0f4fbab63...6a6b4613fc8fd4035a1dee12300dd512411caf10,2,23,8,31,4,2012-03-26 19:31:28,2012-03-26 19:31:28
6a6b4613fc8fd4035a1dee12300dd512411caf10...654b5284e484b8f877bd15771938030c11870c1e,1,1,0,1,1,2012-04-07 13:39:35,2012-03-28 15:25:04
654b5284e484b8f877bd15771938030c11870c1e...dbf67c31dc46b0f5bac2ed8827be2f3cb39a2dda,1,1,0,1,1,2012-04-08 13:51:00,2012-04-08 13:50:33
dbf67c31dc46b0f5bac2ed8827be2f3cb39a2dda...829e3beaa0d55e2231a79725e44fcbd3b1cfa48a,1,4,1,5,1,2012-04-17 17:23:12,2012-04-17 17:23:12
829e3beaa0d55e2231a79725e44fcbd3b1cfa48a...23a1c8019a8f25dab89a55a5f7c84dd19720adff,1,21,12,33,3,2012-04-17 18:15:15,2012-03-29 20:20:45
23a1c8019a8f25dab89a55a5f7c84dd19720adff...a55507d21e53970d324eef2cafc653aea648b885,1,6,4,10,3,2012-04-17 18:18:40,2011-12-25 01:25:24
a55507d21e53970d324eef2cafc653aea648b885...d87357cf26a75dca02407f03326876e1d1803369,1,2,1,3,1,2012-04-17 18:25:36,2012-04-10 22:09:36
d87357cf26a75dca02407f03326876e1d1803369...660f41ad650e711478438f8df0d3ef747c441d10,1,4,2,6,3,2012-04-17 18:29:57,2012-02-09 22:35:06
660f41ad650e711478438f8df0d3ef747c441d10...30f515ac163e4b930fd7c65703d6cab5f7b1a96a,1,1,8,9,1,2012-04-17 18:32:50,2012-03-12 15:51:57
30f515ac163e4b930fd7c65703d6cab5f7b1a96a...b32511d875786fe2428e275e198cdbeccfeb4c1e,1,1,5,6,2,2012-04-17 18:35:17,2012-02-09 21:30:32
b32511d875786fe2428e275e198cdbeccfeb4c1e...aee93cd91ad5e25f6662ccfb26d89d1a1cd06e2b,2,185,64,249,47,2012-04-17 20:30:06,2012-03-21 20:01:05
aee93cd91ad5e25f6662ccfb26d89d1a1cd06e2b...7460b30455b080fcb957248784871aa66538cb1c,1,4,8,12,2,2012-04-17 20:31:23,2012-04-04 01:02:02
7460b30455b080fcb957248784871aa66538cb1c...83fa0f7bc1611e015024b6acac23b14cca44f35e,1,32,5,37,3,2012-04-18 20:25:29,2012-03-23 10:51:40
83fa0f7bc1611e015024b6acac23b14cca44f35e...e69445666bd8acfb1fac1e826e610fac845019a7,1,12,1,13,1,2012-04-18 21:21:08,2012-03-07 18:26:57
e69445666bd8acfb1fac1e826e610fac845019a7...ba8d0f572c9108c0c2f279a393a854c59d475008,1,38,27,65,7,2012-04-18 21:24:51,2012-03-29 16:03:15
ba8d0f572c9108c0c2f279a393a854c59d475008...41be3168d42f058cdda271c7aa077002d3071256,6,81,39,120,63,2012-04-18 21:53:57,2012-04-18 21:53:24
41be3168d42f058cdda271c7aa077002d3071256...05b07daf5be2a90b70aec40328d8c3b20e60d68b,1,2,2,4,2,2012-04-18 22:03:15,2012-04-05 06:11:48
05b07daf5be2a90b70aec40328d8c3b20e60d68b...b39c6a7e185aa19a8029b27a24f27936634b9c17,2,25,0,25,2,2012-04-18 22:15:04,2012-04-13 14:46:45
b39c6a7e185aa19a8029b27a24f27936634b9c17...735e498aa66abdf8e241204a129a7120239abb6f,1,0,24,24,1,2012-04-19 12:45:53,2012-04-19 12:45:53
735e498aa66abdf8e241204a129a7120239abb6f...87374c2c5cb8a7cd8503d83c86913c94d375e7a8,2,4,2,6,3,2012-04-19 19:29:27,2011-09-26 16:18:50
87374c2c5cb8a7cd8503d83c86913c94d375e7a8...df84cb315987723fc3faff5cdd17dc46a6ca778a,2,63,1,64,2,2012-04-19 19:31:56,2011-12-08 21:48:08
df84cb315987723fc3faff5cdd17dc46a6ca778a...d99695ccc20af5a56bd624bf6a3aa66c7493d592,1,2,2,4,2,2012-04-19 19:37:30,2012-03-05 19:27:50
d99695ccc20af5a56bd624bf6a3aa66c7493d592...9bb928d020a8469532a49f32886ee6e978648aec,3,37,1,38,4,2012-04-19 19:38:15,2012-04-01 05:02:54
9bb928d020a8469532a49f32886ee6e978648aec...e1b56eb28a9be9783f4285d40db2bfc099d62e98,1,1,1,2,1,2012-04-19 19:40:12,2012-04-19 19:40:07
e1b56eb28a9be9783f4285d40db2bfc099d62e98...5f4961309049c5bef3b8669e7972a19d52ec85d3,2,14,3,17,3,2012-04-19 19:44:57,2012-02-06 15:40:15
5f4961309049c5bef3b8669e7972a19d52ec85d3...1911459b0dd643506afe9f0280288090fa123a06,1,3,4,7,3,2012-04-19 21:28:36,2012-02-27 16:23:34
1911459b0dd643506afe9f0280288090fa123a06...264b914c4b19e3e6e094d49761e85e9555b49957,1,0,16,16,1,2012-04-19 21:33:04,2012-04-10 21:34:52
264b914c4b19e3e6e094d49761e85e9555b49957...6245495caba8227f08741c8814bcfdc9a8869d25,1,6,6,12,4,2012-04-19 21:54:47,2012-04-19 07:34:59
6245495caba8227f08741c8814bcfdc9a8869d25...bea6d4be2005d0d9bd34a10353e06c472790a949,1,4,4,8,2,2012-04-20 14:16:54,2012-04-01 05:26:18
bea6d4be2005d0d9bd34a10353e06c472790a949...49144209b1c537692945594d909713a2fc669db0,2,45,35,80,9,2012-04-20 14:53:33,2012-02-09 21:19:15
49144209b1c537692945594d909713a2fc669db0...672793ce4f079ee259f149a7b530e42dd09cca0c,1,4,1,5,1,2012-04-20 14:53:42,2012-02-13 18:57:36
672793ce4f079ee259f149a7b530e42dd09cca0c...6477fd1d758682aadd0ef9789e449b85cd8be241,4,76,6,82,8,2012-04-20 15:24:29,2012-01-25 21:31:41
6477fd1d758682aadd0ef9789e449b85cd8be241...e50b2e242875405f2b52d8757139961243b21b78,2,9,11,20,5,2012-04-20 16:21:31,2012-04-20 16:21:31
e50b2e242875405f2b52d8757139961243b21b78...e51ea6f0893cfe62ae84ff570587b2e4df73a40b,2,11,9,20,5,2012-04-20 16:28:38,2012-04-20 16:28:38
e51ea6f0893cfe62ae84ff570587b2e4df73a40b...36ae8786453dff62875d600490db19d47e4975f7,3,22,12,34,6,2012-04-20 16:30:13,2012-04-20 16:30:13
36ae8786453dff62875d600490db19d47e4975f7...6fb6a11f5879d0ca0bc36b07e4b25b03f74a468c,1,4,1,5,2,2012-04-21 18:57:30,2011-12-21 18:05:04
6fb6a11f5879d0ca0bc36b07e4b25b03f74a468c...d861e27e783406217a5d7f945a39169e5ae250a2,1,1,1,2,1,2012-04-24 03:49:37,2012-04-24 03:49:37
d861e27e783406217a5d7f945a39169e5ae250a2...f53de1128ddff7e99c5a6047cf56a6f5000d24c4,2,2,3,5,3,2012-04-24 14:17:40,2012-04-24 14:17:40
f53de1128ddff7e99c5a6047cf56a6f5000d24c4...09db1bc1bedf7ece0a0e12236259ead905eee5de,2,4,0,4,2,2012-04-24 20:03:58,2012-04-24 20:00:09
09db1bc1bedf7ece0a0e12236259ead905eee5de...97ab12742ac1779448d725521f805b8cb2f5f25f,1,1,0,1,1,2012-04-24 23:19:37,2012-04-24 23:19:11
97ab12742ac1779448d725521f805b8cb2f5f25f...947fa6924c873f5df1e1bdce68b22baaf80163d0,1,1,1,2,1,2012-04-25 01:51:17,2012-04-25 01:50:31
947fa6924c873f5df1e1bdce68b22baaf80163d0...1c22afa5d09342d2cd2fd149dbde3ca85eb8e48f,4,10,3,13,4,2012-04-25 14:52:34,2012-04-25 14:52:34
1c22afa5d09342d2cd2fd149dbde3ca85eb8e48f...98c748b29587908d2566fa03f81bd3d3186748bf,1,1,1,2,1,2012-04-26 08:03:28,2012-04-26 08:03:28
98c748b29587908d2566fa03f81bd3d3186748bf...dc2f8cd3df44ea33f9813aadb27804e084abea11,1,1,1,2,1,2012-05-03 13:56:24,2012-05-03 13:56:24
dc2f8cd3df44ea33f9813aadb27804e084abea11...52db24582fca11ed9b0ef378d5c4296f0466de4e,2,2,2,4,2,2012-05-03 14:05:46,2012-05-03 14:05:46
52db24582fca11ed9b0ef378d5c4296f0466de4e...935e22aaed75248b1c9f583fcf7f59cf28c3afd5,1,1,1,2,1,2012-05-03 19:13:15,2012-05-03 19:13:15
935e22aaed75248b1c9f583fcf7f59cf28c3afd5...1bb4de4630302fad8af53824ca4f627db490b753,3,3,3,6,3,2012-05-08 14:51:28,2012-05-08 14:51:28
1bb4de4630302fad8af53824ca4f627db490b753...8f38fc36d11e045fdeb1b669edc78dfb6a6d6e34,2,2,2,4,2,2012-05-09 17:45:42,2012-05-09 17:45:42
8f38fc36d11e045fdeb1b669edc78dfb6a6d6e34...40049a3869bfc143b30b8c2a3a8f8c26d865d780,1,41,20,61,3,2012-05-09 17:56:07,2012-05-09 17:56:07
40049a3869bfc143b30b8c2a3a8f8c26d865d780...4fc6bb1e1768656b638edc0a451bedada07e934d,1,5,5,10,1,2012-05-09 18:43:16,2012-05-09 18:38:01
4fc6bb1e1768656b638edc0a451bedada07e934d...c94a29477ae43133be3a6e47cc2a97ccc01e7469,1,5,0,5,1,2012-05-09 20:49:44,2011-12-01 15:04:00
c94a29477ae43133be3a6e47cc2a97ccc01e7469...77db8a50cfd1825a5848f908bf2860c5495ba528,2,9,6,15,7,2012-05-09 20:50:41,2011-10-19 16:34:21
77db8a50cfd1825a5848f908bf2860c5495ba528...dd21525b0210951619935e0c8964158c12cfe70f,1,9,0,9,1,2012-05-09 20:53:00,2012-01-05 16:08:52
dd21525b0210951619935e0c8964158c12cfe70f...1aaac5eb0dc31c80f82080c9b3e75b49409b74cd,2,62,9,71,5,2012-05-10 15:56:44,2012-05-07 16:47:56
1aaac5eb0dc31c80f82080c9b3e75b49409b74cd...2cf91c83a188f74d726836a7cfdfcb6fa95520e5,2,18,6,24,4,2012-05-10 18:49:37,2012-04-12 22:19:21
2cf91c83a188f74d726836a7cfdfcb6fa95520e5...0397af7906e351942b0c4d228c19ee64ad794bde,1,5,0,5,2,2012-05-10 18:49:37,2012-04-24 17:16:15
0397af7906e351942b0c4d228c19ee64ad794bde...db9d17af5cba0c432269f6e7bd02bac9af60438b,1,1,2,3,2,2012-05-10 18:49:37,2012-05-03 00:31:00
db9d17af5cba0c432269f6e7bd02bac9af60438b...03c34bd5fa1f4ebe9f626306f2c67d507c11a4eb,5,118,18,136,8,2012-05-13 20:48:04,2012-05-13 20:48:04
03c34bd5fa1f4ebe9f626306f2c67d507c11a4eb...ee64e77c32287a174ceb4e51c626b21ce80ccc85,2,30,2,32,2,2012-05-15 17:29:10,2012-05-15 17:29:10
ee64e77c32287a174ceb4e51c626b21ce80ccc85...dbd87d09fd95c10d37bcc8b875e7770043fe219d,1,1,1,2,1,2012-05-15 17:32:46,2012-05-15 17:22:20
dbd87d09fd95c10d37bcc8b875e7770043fe219d...dfbf91e16a8686cac7b58756e4fc63c88d874ec6,1,13,13,26,2,2012-05-16 12:54:32,2011-12-21 19:44:46
dfbf91e16a8686cac7b58756e4fc63c88d874ec6...1d84085365836b38406d2310c4a38b59fd1e4175,1,2,0,2,1,2012-05-16 13:15:26,2012-05-16 13:01:12
1d84085365836b38406d2310c4a38b59fd1e4175...c3d0639c9a6939a279b8ced3d4c210aef1979d2a,1,29,20,49,19,2012-05-18 00:30:52,2012-01-04 18:28:05
c3d0639c9a6939a279b8ced3d4c210aef1979d2a...6b0869166832d3c8f540e451e4b6bf21c1d876f8,3,59,5,64,7,2012-05-18 20:48:34,2012-05-18 14:33:40
6b0869166832d3c8f540e451e4b6bf21c1d876f8...095dc59270af358a67ff2eef6127f37e0ae79a58,1,1,1,2,1,2012-05-19 02:12:08,2012-05-19 02:12:08
095dc59270af358a67ff2eef6127f37e0ae79a58...ec370983a5ad8925d101982cebb17873f5ec6634,4,10,3,13,4,2012-05-22 17:09:43,2012-05-22 17:09:43
ec370983a5ad8925d101982cebb17873f5ec6634...eba41d31367a4ff057607750ae66447cb724af92,1,1,1,2,1,2012-05-23 13:49:47,2012-05-23 13:49:47
eba41d31367a4ff057607750ae66447cb724af92...e1c0cbc25863f6356aa4e31375add7bb49fb05bc,3,3,3,6,3,2012-06-04 13:42:54,2012-06-04 13:42:54
e1c0cbc25863f6356aa4e31375add7bb49fb05bc...9ffb23747255b7d8998fc6c23843d586b6023466,2,2,2,4,2,2012-06-05 03:31:19,2012-06-05 03:31:19
9ffb23747255b7d8998fc6c23843d586b6023466...ef11f578a4cd48c72ea5eb4161adeab7c431b624,3,170,92,262,34,2012-06-10 11:24:45,2012-06-10 11:24:45
ef11f578a4cd48c72ea5eb4161adeab7c431b624...e1504ed07ff7c4b0f1c96da32c36ecf607ac0229,4,51,19,70,16,2012-06-10 20:12:08,2012-06-10 20:12:08
e1504ed07ff7c4b0f1c96da32c36ecf607ac0229...e3120a3fbdb8c24a5a8b0b595dcfed2ebee97022,1,1,0,1,1,2012-06-19 14:21:14,2012-05-25 17:15:55
e3120a3fbdb8c24a5a8b0b595dcfed2ebee97022...f9828af52c7e44270c595a26383d146691f28fe0,1,15,6,21,1,2012-06-20 17:57:59,2012-06-20 17:57:59
f9828af52c7e44270c595a26383d146691f28fe0...4ada6dfbc2aa8e3f6702243c5b29d08949ce7ef9,1,206,1,207,4,2012-06-20 21:33:27,2012-06-20 21:33:27
4ada6dfbc2aa8e3f6702243c5b29d08949ce7ef9...881d6229e1ab58695959862a76f3175e142af84e,3,109,67,176,15,2012-06-20 21:47:51,2012-06-20 21:47:51
881d6229e1ab58695959862a76f3175e142af84e...034b064a043a1ebecb29381a89a9737561729095,1,3,8,11,1,2012-06-22 14:35:38,2012-06-22 14:35:38
034b064a043a1ebecb29381a89a9737561729095...f45435a02258a537d9f6950bb5aedec965526db9,1,2,3,5,3,2012-06-22 15:13:08,2012-06-22 15:13:08
f45435a02258a537d9f6950bb5aedec965526db9...4bb6e76b20a3f8fd49fb4677b189b41088f3a962,1,4,3,7,1,2012-06-22 16:09:41,2012-06-22 16:04:22
4bb6e76b20a3f8fd49fb4677b189b41088f3a962...4ecae7484e4813efc1a81b4f21147632bea8b1aa,2,15,30,45,6,2012-06-25 17:14:52,2012-06-25 16:57:34
4ecae7484e4813efc1a81b4f21147632bea8b1aa...6c19d602f19c696f4231ed5d2da210c1f79c3296,3,66,24,90,10,2012-06-25 18:13:59,2012-06-25 18:10:00
6c19d602f19c696f4231ed5d2da210c1f79c3296...7012a032376651f06eed6f0aaaaa71442693c11e,2,30,15,45,6,2012-06-26 23:55:35,2012-06-26 23:55:35
7012a032376651f06eed6f0aaaaa71442693c11e...75fa25bc1dbdf7f10aa64c98741b8b92134cfee3,3,125,116,241,39,2012-06-27 13:54:12,2012-06-27 13:54:12
75fa25bc1dbdf7f10aa64c98741b8b92134cfee3...dd36d37c09408cd0fac5c40b48c071afd7491b1e,1,1,0,1,1,2012-06-27 17:56:28,2012-06-27 17:41:22
dd36d37c09408cd0fac5c40b48c071afd7491b1e...12de29a40185e24c1bfb2c5d838903c15e8b2a85,2,11,1,12,4,2012-06-27 19:36:51,2012-06-27 19:36:11
12de29a40185e24c1bfb2c5d838903c15e8b2a85...73370d7bc41b093f26adee1c89a92963cdb63d6c,1,6,0,6,2,2012-06-27 20:39:09,2012-06-27 20:37:54
73370d7bc41b093f26adee1c89a92963cdb63d6c...80f143dc95fe93f8f9797de5b45d2d1ea1c07dc4,1,152,3,155,4,2012-06-28 18:16:04,2012-06-28 11:43:55
80f143dc95fe93f8f9797de5b45d2d1ea1c07dc4...9dc4c3fb5b7c1851812752d548fd8813afddde26,1,5,1,6,1,2012-06-28 22:24:43,2012-06-28 22:22:10
9dc4c3fb5b7c1851812752d548fd8813afddde26...ae56ae532ceb3be9d79e367978c50622ed08bb48,2,15,6,21,5,2012-07-02 18:51:30,2012-07-02 18:51:30
ae56ae532ceb3be9d79e367978c50622ed08bb48...bf25d51addc8fee6ca4d280df1da2550e9155629,3,38,0,38,3,2012-07-02 20:40:10,2012-07-02 19:12:34
bf25d51addc8fee6ca4d280df1da2550e9155629...17c3a2c3a705fea3e1f4588fc1890e87043220ca,2,118,48,166,12,2012-07-03 13:57:01,2012-06-11 13:56:07
17c3a2c3a705fea3e1f4588fc1890e87043220ca...16fdca349817b8be0e6a0b5e9c37a2e1d294cf43,1,1,1,2,1,2012-07-03 15:42:18,2012-07-03 15:42:18
16fdca349817b8be0e6a0b5e9c37a2e1d294cf43...b39f7ff6b9eac988569ec7a49f7be97bc58764b4,1,2,1,3,1,2012-07-03 17:54:33,2012-06-12 17:26:31
b39f7ff6b9eac988569ec7a49f7be97bc58764b4...e25d6a41652eaebd1395582261e3c83718d10274,3,48,0,48,3,2012-07-03 17:56:21,2012-05-30 14:35:16
e25d6a41652eaebd1395582261e3c83718d10274...b72aa7471cc8a6dd95c19a3246acb19a65a548eb,7,170,13,183,19,2012-07-04 23:39:39,2012-07-04 23:39:39
b72aa7471cc8a6dd95c19a3246acb19a65a548eb...2ff57e149cbdf05ad5fae25230a6149fb964667e,1,27,31,58,29,2012-07-05 14:08:19,2012-07-05 14:08:19
2ff57e149cbdf05ad5fae25230a6149fb964667e...f198c21e4bd5dbbc9d989ff5ddf2bf05f72ff2a0,5,54,1,55,7,2012-07-06 15:47:58,2012-07-06 15:47:58
f198c21e4bd5dbbc9d989ff5ddf2bf05f72ff2a0...6de83ddbe9c0a34b13559e45e9be18d2565c4707,1,1,1,2,1,2012-07-09 19:25:51,2012-07-08 11:23:58
6de83ddbe9c0a34b13559e45e9be18d2565c4707...97d9c1b81567b76b8a1b111a20024386d39343cd,1,1,1,2,1,2012-07-09 19:52:32,2012-04-13 18:18:27
97d9c1b81567b76b8a1b111a20024386d39343cd...7d3a8463b477b433b90289a35156b078d4c4b451,1,5,3,8,4,2012-07-09 20:31:45,2012-07-09 20:28:24
7d3a8463b477b433b90289a35156b078d4c4b451...b0e8e2bfa99cd6c7c197936d0b9859295c8ab1d4,1,4,1,5,2,2012-07-09 20:57:50,2012-06-12 16:13:02
b0e8e2bfa99cd6c7c197936d0b9859295c8ab1d4...afd5eb4e2cf72b13d8d8c4d96f13347accc19be7,1,2,2,4,2,2012-07-10 13:38:50,2012-07-10 13:38:50
afd5eb4e2cf72b13d8d8c4d96f13347accc19be7...560db9021b8862f307d8255e8c0cc3589273571e,1,0,1,1,1,2012-07-11 18:01:16,2012-07-11 17:58:10
560db9021b8862f307d8255e8c0cc3589273571e...6b24994f08a37739b359aed6950f87286aa562df,2,65,15,80,6,2012-07-11 19:29:39,2012-07-11 19:23:59
6b24994f08a37739b359aed6950f87286aa562df...a31879b251308a14b5414b6a5d3f9dae495b23ea,2,4,4,8,3,2012-07-11 20:33:04,2012-07-11 20:32:21
a31879b251308a14b5414b6a5d3f9dae495b23ea...87c31eb85c48d42e203cdcaf557c2e94c59d4e7d,1,15,2,17,5,2012-07-11 22:23:36,2012-07-11 22:20:13
87c31eb85c48d42e203cdcaf557c2e94c59d4e7d...ea06d5d59af1b41f2f9d40a74dc77ea98aa4ecd2,1,2,2,4,2,2012-07-11 22:25:12,2012-07-11 22:24:51
ea06d5d59af1b41f2f9d40a74dc77ea98aa4ecd2...c6a40c4423762f742bc5f643b169b1bbc612ee3b,1,1,1,2,1,2012-07-11 22:31:38,2012-07-11 22:31:14
c6a40c4423762f742bc5f643b169b1bbc612ee3b...e67589e105d4ed85670e9dd264d0689223d0d324,1,6,1,7,2,2012-07-11 23:09:10,2012-07-11 23:08:37
e67589e105d4ed85670e9dd264d0689223d0d324...8e584c2fe8d29040692d0e44bda695df68e99838,1,1,1,2,1,2012-07-11 23:16:04,2012-07-11 23:12:26
8e584c2fe8d29040692d0e44bda695df68e99838...dc6d43de353f6a6f2d4085b35cd5d620bac16552,1,5,0,5,1,2012-07-11 23:37:47,2012-07-11 23:37:27
dc6d43de353f6a6f2d4085b35cd5d620bac16552...75fe13d0b13b1d297b77b623a9ce9d30520d1d98,1,4,4,8,2,2012-07-12 13:59:07,2012-07-12 13:59:07
75fe13d0b13b1d297b77b623a9ce9d30520d1d98...61d3a31ca408e0338354843a05a79ac51a914707,1,4,9,13,5,2012-07-12 15:58:06,2012-07-12 15:53:30
61d3a31ca408e0338354843a05a79ac51a914707...accb562a78780160e6844863193960b4c9ecc8ca,1,3,1,4,1,2012-07-12 17:38:53,2012-07-12 17:38:00
accb562a78780160e6844863193960b4c9ecc8ca...a56780496bcbd2882fe2fb20f514070f8afe28c4,4,10,3,13,4,2012-07-14 02:19:28,2012-07-14 02:19:28
a56780496bcbd2882fe2fb20f514070f8afe28c4...1ba3671b1ca1d0510e9522d810ba9d54904797c6,1,1,1,2,1,2012-07-15 12:43:34,2012-07-15 12:43:34
1ba3671b1ca1d0510e9522d810ba9d54904797c6...90fa91c352ffef46a4ae9b849e9a17b5ad3bac66,1,1,1,2,1,2012-07-16 12:51:36,2012-07-16 12:51:36
90fa91c352ffef46a4ae9b849e9a17b5ad3bac66...7542d7baa9f529a4dcf6bb7a0be162c8e6949607,1,13,1,14,6,2012-07-27 14:13:08,2012-07-27 14:13:08
7542d7baa9f529a4dcf6bb7a0be162c8e6949607...c88805a6f6447458290719703887fb736692359e,1,10,0,10,2,2012-07-27 14:26:05,2012-04-30 17:42:02
c88805a6f6447458290719703887fb736692359e...6aa80782bc30162efb8f736863ed4b6bf2e94244,1,1,9,10,2,2012-07-27 15:33:21,2012-07-23 14:48:08
6aa80782bc30162efb8f736863ed4b6bf2e94244...6701b6ea856ec2b34fe85429f5e920c86cb8391d,1,4,0,4,1,2012-07-27 20:28:48,2012-07-16 02:21:50
6701b6ea856ec2b34fe85429f5e920c86cb8391d...8e42151eccd3766bd0ad0320340d930ad0cc54ed,1,2,2,4,1,2012-07-27 20:28:58,2012-07-16 02:22:49
8e42151eccd3766bd0ad0320340d930ad0cc54ed...de0cfcd8de67c52b8206a27b7a5a939e70520051,1,18,6,24,4,2012-07-27 20:31:12,2012-07-16 02:22:03
de0cfcd8de67c52b8206a27b7a5a939e70520051...9efe4cce272373b52b96de1309c1fbf0c984305f,3,3,3,6,3,2012-07-30 03:13:40,2012-07-30 03:13:40
9efe4cce272373b52b96de1309c1fbf0c984305f...24f90398dcd47af91a32dfe2a9d9692dcc78a44b,1,1,1,2,1,2012-08-02 15:30:02,2012-08-02 15:30:02
24f90398dcd47af91a32dfe2a9d9692dcc78a44b...d54dc5e869a18b53d62c3a73323f012eeb654ad6,1,1,1,2,1,2012-08-05 18:37:19,2012-08-05 18:37:19
d54dc5e869a18b53d62c3a73323f012eeb654ad6...875033920e8869d284f32119413543fa475227bf,3,3,3,6,3,2012-08-07 11:31:19,2012-08-07 11:31:19
875033920e8869d284f32119413543fa475227bf...daf7aec921bf7f5b8be46bb0bffe2c51984692ff,2,2,2,4,2,2012-08-08 22:40:16,2012-08-08 22:40:16
daf7aec921bf7f5b8be46bb0bffe2c51984692ff...72cc3481b9e9ec791365b8ba6c183945e8093147,2,41,11,52,10,2012-09-12 19:58:51,2012-08-29 06:14:12
72cc3481b9e9ec791365b8ba6c183945e8093147...8ea06cd353ec362256dfcafa835ceba78ecc8186,1,8,1,9,2,2012-10-12 14:22:19,2012-10-12 14:22:19
8ea06cd353ec362256dfcafa835ceba78ecc8186...4d37e1acbad77a3981e9f2954f78da26d093f8f7,1,0,7,7,1,2012-10-13 13:08:17,2012-10-13 13:08:17
4d37e1acbad77a3981e9f2954f78da26d093f8f7...86b6b474a8ae8798d8a4d9edf97234b33f84e11c,1,2,0,2,1,2012-10-15 20:15:39,2012-07-11 14:12:46
86b6b474a8ae8798d8a4d9edf97234b33f84e11c...01477c20c8eee2fa726b26d8c022e80750aab959,1,1,0,1,1,2012-10-15 20:16:25,2012-03-01 20:15:40
01477c20c8eee2fa726b26d8c022e80750aab959...07865170991cb07cab95a57e49f3ed3f44b8a8ba,1,2,1,3,1,2012-10-15 21:17:09,2012-10-15 20:26:33
07865170991cb07cab95a57e49f3ed3f44b8a8ba...5eaf375b0c9e6fef220e71916e83c3c3e265158f,1,6,0,6,1,2012-10-15 21:17:09,2012-08-09 20:11:41
5eaf375b0c9e6fef220e71916e83c3c3e265158f...239d7d6a195f7dff5ad32b6cb29cd64e635c1889,1,4,1,5,1,2012-10-15 21:17:09,2012-10-15 21:01:20
239d7d6a195f7dff5ad32b6cb29cd64e635c1889...3d8d35771fedbfd5e5fac768112e2c143a940536,1,1,0,1,1,2012-10-15 21:18:41,2012-08-06 21:29:18
3d8d35771fedbfd5e5fac768112e2c143a940536...7577f95c80f8f22b7a3c61f0683ee120f6fb1e59,1,2,1,3,1,2012-10-16 06:08:04,2012-10-16 06:08:04
7577f95c80f8f22b7a3c61f0683ee120f6fb1e59...6d021c86d38a1b117fa5f25fd0f6a3e82bd18f35,1,2,0,2,2,2012-10-16 13:37:19,2012-08-07 01:00:02
6d021c86d38a1b117fa5f25fd0f6a3e82bd18f35...365e89e5ec1aeb16d33984bc5d4b8dc23f33c081,1,2,0,2,1,2012-10-25 20:09:40,2012-10-25 20:09:40
365e89e5ec1aeb16d33984bc5d4b8dc23f33c081...744074d2cfc8e37ba53b977fa033612b29650e0d,3,3,3,6,3,2012-10-25 22:46:58,2012-10-25 22:46:58
744074d2cfc8e37ba53b977fa033612b29650e0d...1d3d3ba938b9ac0d627fd8039ad8aee79c6968c4,1,1,1,2,1,2012-10-26 20:32:55,2012-10-26 20:32:55
1d3d3ba938b9ac0d627fd8039ad8aee79c6968c4...a340a57af7cdda865da420704e1d1b2fac0cedc2,3,3,3,6,3,2012-11-16 00:55:43,2012-11-16 00:55:43
a340a57af7cdda865da420704e1d1b2fac0cedc2...bc7400d46a0e619ad166d219b79970b7aa7e1cff,2,2,2,4,2,2012-11-16 17:01:10,2012-11-16 17:01:10
bc7400d46a0e619ad166d219b79970b7aa7e1cff...3c5c12f7d57ba1e44250d3e1734885a5cafaf8e2,1,78,38,116,8,2013-03-26 20:52:39,2013-03-26 20:52:39
3c5c12f7d57ba1e44250d3e1734885a5cafaf8e2...b7b6c384463fbe5b1acce2df48101b72e2b9940b,3,3,3,6,3,2013-03-26 21:04:44,2013-03-26 21:04:44
b7b6c384463fbe5b1acce2df48101b72e2b9940b...bb999bb5032346e4391d80225b1532bc43df9446,1,3,3,6,4,2013-03-27 01:33:20,2013-03-27 01:33:20
bb999bb5032346e4391d80225b1532bc43df9446...446b5ded2382dd9a13706f57df26e5e670cb9788,3,3,3,6,3,2013-03-27 02:23:19,2013-03-27 02:23:19
446b5ded2382dd9a13706f57df26e5e670cb9788...cae3ea8b1d547ee21f836c233e1740f824f97d80,1,1,1,2,1,2013-03-27 15:04:52,2013-03-27 15:04:52
cae3ea8b1d547ee21f836c233e1740f824f97d80...7e34cb36a6ae64d527c0b0da81fa967606c55433,3,3,3,6,3,2013-03-29 22:14:19,2013-03-29 22:14:19
7e34cb36a6ae64d527c0b0da81fa967606c55433...ec60d7de77e4c23e32f80daacd5e45350c3613f7,2,2,2,4,2,2013-04-02 21:14:20,2013-04-02 21:14:20
ec60d7de77e4c23e32f80daacd5e45350c3613f7...e5a7faaecdfa0b153db493ad15d624dc90c986b9,3,69,1,70,3,2013-08-12 14:34:56,2013-08-12 14:01:16
e5a7faaecdfa0b153db493ad15d624dc90c986b9...c28079649e81e3beb96e124e27c22b66d525d480,1,29,1,30,4,2013-08-12 14:35:02,2013-08-12 14:03:53
7399d406b170c2ef7173531c8867f08273f81f58...4da8449ee2d8abf6ae7ba62441fce2013c4bd08a,1,3,0,3,1,2011-09-26 13:07:14,2011-09-26 13:07:14
7399d406b170c2ef7173531c8867f08273f81f58...c0d758f4c95bde181720e1d9ad282db6345d0812,1,1,3,4,2,2011-09-20 21:11:24,2011-09-19 23:31:08
c0d758f4c95bde181720e1d9ad282db6345d0812...0c8d421606e22bc6eed3b9cb149db8688b26ab5f,4,78,4,82,16,2011-09-20 21:11:24,2011-09-20 21:10:29
0c8d421606e22bc6eed3b9cb149db8688b26ab5f...30e2b968998300857bb61c62a31814facd5fa226,4,35,43,78,13,2011-09-20 22:08:06,2011-09-20 22:08:06
30e2b968998300857bb61c62a31814facd5fa226...1329db4856468f2546a03f8947351f636512ef8b,1,9,0,9,1,2011-09-20 22:16:31,2011-09-20 22:16:31
1329db4856468f2546a03f8947351f636512ef8b...55351e6fc80e2640ffd5ae0f397b7a96e4418659,3,172,141,313,36,2011-09-21 00:44:19,2011-09-21 00:44:19
55351e6fc80e2640ffd5ae0f397b7a96e4418659...b9d4ce580ee057fc521ea531bb69a0ee91cbf8cd,8,77,17,94,27,2011-09-21 06:00:36,2011-09-21 05:58:58
b9d4ce580ee057fc521ea531bb69a0ee91cbf8cd...61d496c3dd7940565d6299980a1ce0a3ee913a0e,4,35,29,64,17,2011-09-21 06:40:10,2011-09-21 06:40:10
61d496c3dd7940565d6299980a1ce0a3ee913a0e...a398ef5dcdd33d1576469cd0797ec963bfb35e93,3,108,76,184,23,2011-09-21 19:06:27,2011-09-21 19:05:31
a398ef5dcdd33d1576469cd0797ec963bfb35e93...5282745c1670ac8b7e2aff47174f251d90c159e1,2,11,9,20,5,2011-09-21 19:47:06,2011-09-21 19:47:06
5282745c1670ac8b7e2aff47174f251d90c159e1...ab33a82e252718a7ce6d0dee847be73b47079ff7,3,26,6,32,10,2011-09-21 20:46:29,2011-09-21 20:46:29
ab33a82e252718a7ce6d0dee847be73b47079ff7...e9c2884d3560ff746b80db07cad73209d3a81f7d,2,20,6,26,4,2011-09-21 21:40:50,2011-09-21 21:40:31
e9c2884d3560ff746b80db07cad73209d3a81f7d...343b502f44e8c7888e34e2ed54246163c153b98f,1,1,1,2,1,2011-09-21 23:37:15,2011-09-21 23:36:54
343b502f44e8c7888e34e2ed54246163c153b98f...b88a62a838695d7c57c86dc56fb66c3cd4beabcf,2,46,36,82,18,2011-09-22 01:09:15,2011-09-22 01:08:41
b88a62a838695d7c57c86dc56fb66c3cd4beabcf...9ceb4dff0e21f16bef71223a46a48db819b244a9,1,4,2,6,2,2011-09-22 01:14:55,2011-09-21 19:31:31
9ceb4dff0e21f16bef71223a46a48db819b244a9...357f336ff9622332c47e74b9945f5c9f3643c6da,6,42,5,47,11,2011-09-22 01:14:55,2011-09-21 20:32:22
357f336ff9622332c47e74b9945f5c9f3643c6da...33bda54e9aa42690ebfd312bc164f8b613327e54,2,6,0,6,2,2011-09-22 01:14:55,2011-09-21 21:03:38
33bda54e9aa42690ebfd312bc164f8b613327e54...d40f16a6da9901f179eebb111761d2569ff290fa,1,18,8,26,9,2011-09-22 01:14:55,2011-09-21 21:05:00
81b4dd424400a662c944c001acce7a619100cbc8...d8f4473c253be22f82a5ff75a7e353079539b85a,1,1,1,2,1,2011-09-22 12:27:34,2011-09-22 12:27:34
d8f4473c253be22f82a5ff75a7e353079539b85a...d869bd9bb787707eefd650c6b59ecfdd2686d9d4,2,51,40,91,13,2011-09-22 16:35:44,2011-09-22 16:35:44
30c7b82757b8147b589d6586fb84860e44fc9763...d28c919025766e7a61904fb39b6ebea6d65ba502,1,4,3,7,1,2011-11-17 16:44:08,2011-11-17 16:44:08
296d6e6a52d3583c823cce81b4e1cb89a43b3b36...cf117b7c7d0655282deab662ed68e11119f844c7,2,2,2,4,2,2012-08-13 05:02:41,2012-08-13 05:02:41
cf117b7c7d0655282deab662ed68e11119f844c7...6babfbb64022e68aa9fa2484d9822c56d147cb54,2,2,2,4,2,2012-08-14 04:12:21,2012-08-14 04:12:21
6babfbb64022e68aa9fa2484d9822c56d147cb54...b887909f9281c99c69d733153c3aa6aea6624899,4,46,6,52,13,2012-08-20 20:44:19,2012-08-20 20:43:38
b887909f9281c99c69d733153c3aa6aea6624899...da97c335c4177f0fb1a06b08e0d83db61bd4655a,3,73,5,78,5,2012-08-20 21:01:59,2012-08-17 00:17:24
da97c335c4177f0fb1a06b08e0d83db61bd4655a...1a6eb9d65223ddf094188ed5af124e04020e2a19,1,31,0,31,2,2012-08-20 21:01:59,2012-08-14 15:33:23
1a6eb9d65223ddf094188ed5af124e04020e2a19...61d3e29340aa7b4c4ef82ee216bff932d49966bc,1,3,1,4,1,2012-08-20 21:01:59,2012-08-16 15:53:45
61d3e29340aa7b4c4ef82ee216bff932d49966bc...eae9f0ac98e3cfe43951a217106c2db53c7d9d28,2,370,4,374,4,2012-08-21 04:29:47,2012-08-18 22:07:07
eae9f0ac98e3cfe43951a217106c2db53c7d9d28...3c7061b50bcbd66c864da8771ddb3f77823008f9,4,67,22,89,15,2012-08-21 04:29:53,2012-08-14 23:23:59
3c7061b50bcbd66c864da8771ddb3f77823008f9...a0698e7f385e867469ac8feeb4c8e12e732d630b,1,4,4,8,4,2012-08-21 21:37:45,2012-08-21 21:06:10
a0698e7f385e867469ac8feeb4c8e12e732d630b...7ab12c2e100da04aa7fcfe6946e5eae082777209,6,107,27,134,25,2012-08-21 21:38:19,2012-08-21 02:01:39
7ab12c2e100da04aa7fcfe6946e5eae082777209...cbdd95429bcf28fdf887b8f94e709d418d513c48,1,11,7,18,8,2012-08-21 21:40:21,2012-08-17 14:42:21
cbdd95429bcf28fdf887b8f94e709d418d513c48...056704b124f2ba0525345658d3897f93981b267e,2,25,0,25,4,2012-08-21 21:41:15,2012-08-21 20:54:12
056704b124f2ba0525345658d3897f93981b267e...3f518bf76c1db505449bf8b14b8afd084736006e,1,1,0,1,1,2012-08-21 21:41:32,2012-08-21 20:57:28
3f518bf76c1db505449bf8b14b8afd084736006e...089f96e956634cf922fd3dc99681d7f56318502a,1,9,0,9,3,2012-08-21 22:28:59,2012-08-21 22:28:40
089f96e956634cf922fd3dc99681d7f56318502a...45d66f6b12d8e6faee340c915340256ae1f0a221,1,3,4,7,3,2012-08-21 23:01:40,2012-08-21 22:50:29
45d66f6b12d8e6faee340c915340256ae1f0a221...315481580e1334058f46ec8a6d049271fb7ad0a5,2,2,2,4,2,2012-08-22 15:24:52,2012-08-22 15:24:52
315481580e1334058f46ec8a6d049271fb7ad0a5...380b30c4843fb82e9cc378837e66b83567c16814,4,9,7,16,7,2012-08-22 17:50:33,2012-08-22 17:39:55
380b30c4843fb82e9cc378837e66b83567c16814...c5fa65e7f79115b240ff79b51cbd9fb3e7eeb55d,1,1,1,2,1,2012-08-22 18:41:00,2012-08-22 18:39:14
c5fa65e7f79115b240ff79b51cbd9fb3e7eeb55d...1a9420939dc05021b767187cd52c447a70990a25,2,2,2,4,2,2012-08-23 04:16:04,2012-08-23 04:16:04
1a9420939dc05021b767187cd52c447a70990a25...f5e83eae9cfbec7fb7a071321928f00d1b0c5207,4,9,3,12,4,2012-08-28 05:28:11,2012-08-28 05:28:11
f5e83eae9cfbec7fb7a071321928f00d1b0c5207...8fdddf2e067f403b120ee27789aa510abfbf3d80,2,2,2,4,2,2012-08-28 21:39:48,2012-08-28 21:39:48
8fdddf2e067f403b120ee27789aa510abfbf3d80...a9c7cbec42c94bba604c67d279c9f65ee27efb6a,2,10,8,18,3,2012-09-05 15:32:43,2012-08-30 17:38:14
a9c7cbec42c94bba604c67d279c9f65ee27efb6a...347254ef573926544d79dec246b1c4b7fee7c450,1,4,4,8,1,2012-09-12 03:57:29,2012-09-12 03:54:25
347254ef573926544d79dec246b1c4b7fee7c450...cdd1c01d0f767a5bd6ab06800d8b2dbb9364f384,1,2,2,4,1,2012-09-12 17:41:26,2012-08-22 16:35:51
cdd1c01d0f767a5bd6ab06800d8b2dbb9364f384...6f5e9ad8d3ef5d7053b80748b96a3ca36cdae88e,1,19,2,21,2,2012-09-12 17:42:26,2012-09-05 22:26:06
6f5e9ad8d3ef5d7053b80748b96a3ca36cdae88e...c4873256f35d45260c2a631df8124670882d9682,2,41,11,52,10,2012-09-12 17:48:39,2012-08-29 06:14:12
c4873256f35d45260c2a631df8124670882d9682...c6307f01ee4c49a46b34f083c447f4b82958dd9c,1,36,27,63,5,2012-09-12 17:49:25,2012-09-07 18:41:06
c6307f01ee4c49a46b34f083c447f4b82958dd9c...bebd9195c40c4b61b1858061e4e0709c1f4121ae,1,2,2,4,2,2012-09-12 19:31:05,2012-09-07 17:16:24
bebd9195c40c4b61b1858061e4e0709c1f4121ae...a530383eb222586fd84d3e3d7f5f986dc7ed892e,3,21,1,22,3,2012-09-12 19:31:32,2012-09-04 19:20:45
a530383eb222586fd84d3e3d7f5f986dc7ed892e...44634c4ad56652d4d66e64f9170a6d699bad9253,1,1,1,2,1,2012-09-12 19:31:58,2012-08-27 17:52:55
44634c4ad56652d4d66e64f9170a6d699bad9253...0fb9a7a745affefed607c4a779e540d7f8a6c38c,1,3,1,4,3,2012-09-12 19:32:22,2012-08-23 14:42:21
0fb9a7a745affefed607c4a779e540d7f8a6c38c...35da96298e36bd506ebe6b9b8746eee86415d6a1,1,29,7,36,3,2012-09-12 19:32:42,2012-08-23 02:20:20
35da96298e36bd506ebe6b9b8746eee86415d6a1...a2d6a2bf69d0b924466a1dccd3d3467a2411b3c1,1,1,1,2,1,2012-09-12 19:33:12,2012-09-03 20:06:07
a2d6a2bf69d0b924466a1dccd3d3467a2411b3c1...d56d8026ba24983ec907dc6b804ade59b4738ac2,1,1,1,2,1,2012-09-12 19:34:07,2012-08-20 12:21:59
d56d8026ba24983ec907dc6b804ade59b4738ac2...c668b7782455af963cec2a9631c545d822412a79,5,17,22,39,8,2012-09-12 19:35:35,2012-09-05 16:15:36
c668b7782455af963cec2a9631c545d822412a79...8576fad322e56124b9d29935c0882af2bac6f252,1,1,1,2,2,2012-09-12 19:35:53,2012-09-06 14:37:35
8576fad322e56124b9d29935c0882af2bac6f252...2f80a7b181b124a544549758e182988df932a542,1,17,0,17,4,2012-09-12 19:36:24,2012-08-23 20:45:30
2f80a7b181b124a544549758e182988df932a542...e9e9cc60a49f9bc4ec833d54ed72a9e83918a84a,1,1,0,1,1,2012-09-12 19:36:59,2012-09-05 14:39:47
e9e9cc60a49f9bc4ec833d54ed72a9e83918a84a...5ab736e73e59d17b0867cb05f15c89866bc68657,2,4,2,6,3,2012-09-12 19:37:09,2012-09-06 20:06:18
5ab736e73e59d17b0867cb05f15c89866bc68657...d89e787dec901d79f595a31de7e2e66d0898fc4b,2,10,4,14,6,2012-09-12 19:39:35,2012-09-07 16:35:35
d89e787dec901d79f595a31de7e2e66d0898fc4b...01f04c8f1369eb51558637d8bda1315a475446e4,2,49,1,50,3,2012-09-13 15:33:16,2012-09-12 03:53:13
01f04c8f1369eb51558637d8bda1315a475446e4...f6dede5f105f3824881f0f3e258f0fc261247077,2,12,8,20,4,2012-09-13 16:58:03,2012-09-13 16:09:11
f6dede5f105f3824881f0f3e258f0fc261247077...041303498209f690b27c44c29562ff3e60d64b10,2,47,31,78,9,2012-09-13 17:10:48,2012-08-10 22:56:46
041303498209f690b27c44c29562ff3e60d64b10...853db71002c7e1fdd5ceb1bf16c6db29a9b6a688,1,1,1,2,1,2012-09-18 21:24:58,2012-09-18 21:24:58
853db71002c7e1fdd5ceb1bf16c6db29a9b6a688...414a7dc114f34a341c8b4907a4e24760b449e724,2,36,5,41,5,2012-09-18 22:32:55,2012-09-18 06:08:03
414a7dc114f34a341c8b4907a4e24760b449e724...6be65ade5359a1c9abac96718ccec8e6ed7ae571,1,18,5,23,2,2012-09-18 22:33:22,2012-09-17 18:03:19
6be65ade5359a1c9abac96718ccec8e6ed7ae571...5cc8a693a48f3885df6e77f5ce0f2abf0789d499,2,16,4,20,6,2012-09-18 22:33:58,2012-09-18 20:23:32
5cc8a693a48f3885df6e77f5ce0f2abf0789d499...9e3e96e4901ad21e411d9a781a79d26298392262,1,3,0,3,1,2012-09-18 23:21:14,2012-09-18 23:20:42
9e3e96e4901ad21e411d9a781a79d26298392262...7c3283a3031e72da3c1f48a00e17f37b7d78f9e3,2,5,4,9,3,2012-09-19 00:14:44,2012-09-17 22:27:09
7c3283a3031e72da3c1f48a00e17f37b7d78f9e3...242597ae464698f8fc243ec869654cdc756dabb9,2,34,1,35,3,2012-09-19 00:30:33,2012-09-19 00:26:54
242597ae464698f8fc243ec869654cdc756dabb9...0037700ed5f0d46a80ab8cb86075ae41813e83d6,2,127,2,129,5,2012-09-19 22:40:27,2012-09-19 17:09:58
0037700ed5f0d46a80ab8cb86075ae41813e83d6...ead393a878f95d8d51c2582321e06f016d2c8b6f,1,4,0,4,2,2012-09-19 23:03:38,2012-09-19 23:04:07
ead393a878f95d8d51c2582321e06f016d2c8b6f...c8dadfd8f735e01d4d1c7435ab634c889a431674,2,2,2,4,2,2012-09-19 23:58:07,2012-09-19 23:58:07
c8dadfd8f735e01d4d1c7435ab634c889a431674...10b45bf1f0ed50242f4aa3dbaa7ab150d3d9bfe6,2,2,2,4,2,2012-09-22 19:43:36,2012-09-22 19:43:36
10b45bf1f0ed50242f4aa3dbaa7ab150d3d9bfe6...f87923d19fc3d5b65d4c1743b758dd6bc03b783d,1,5,1,6,2,2012-09-27 21:48:18,2012-09-03 00:39:50
f87923d19fc3d5b65d4c1743b758dd6bc03b783d...de79c6fc5daa96346341a14267ddf339b46e8dd8,1,3,3,6,1,2012-10-01 17:44:51,2012-10-01 17:38:24
de79c6fc5daa96346341a14267ddf339b46e8dd8...6bebf26b4fce1bf5aaceceedae5365d1952b8e88,1,7,6,13,6,2012-10-01 17:45:02,2012-10-01 17:38:59
6bebf26b4fce1bf5aaceceedae5365d1952b8e88...5eb79913ff0ceb6fbf782d8a1ec965ae95880fb4,3,45,5,50,5,2012-10-02 20:48:24,2012-09-26 15:54:55
5eb79913ff0ceb6fbf782d8a1ec965ae95880fb4...c301b78471e055b8426a27910d9ce514defa67d6,6,85,16,101,22,2012-10-02 21:42:26,2012-09-28 20:01:07
c301b78471e055b8426a27910d9ce514defa67d6...2ac26a3c808772c639ee0932527431aee1f4d91e,1,1,1,2,1,2012-10-02 21:42:40,2012-09-28 21:43:13
2ac26a3c808772c639ee0932527431aee1f4d91e...1e852c70e5ad7907ec97142d27278a21324ae544,6,30,15,45,7,2012-10-02 21:45:53,2012-09-28 18:54:44
1e852c70e5ad7907ec97142d27278a21324ae544...275f68924ab8cec65fafe35193be5cbd722b3bef,1,2,1,3,1,2012-10-02 21:45:59,2012-09-28 20:20:59
275f68924ab8cec65fafe35193be5cbd722b3bef...d2d9f179a17f8b76b014b621bfc7a5bf67733633,1,3,2,5,3,2012-10-02 21:46:06,2012-10-01 17:29:58
d2d9f179a17f8b76b014b621bfc7a5bf67733633...d168d1a3ee648c4dd39de70babed7a9945f75259,4,24,13,37,8,2012-10-02 21:46:21,2012-10-02 17:13:15
d168d1a3ee648c4dd39de70babed7a9945f75259...19ecdc680e49471bd88b17024c15795a6a080137,2,11,4,15,2,2012-10-02 22:30:53,2012-10-02 22:29:39
19ecdc680e49471bd88b17024c15795a6a080137...a84fe318f8331ee687ce9232d60adffd5930489c,1,13,5,18,3,2012-10-03 15:23:01,2012-10-02 15:11:44
a84fe318f8331ee687ce9232d60adffd5930489c...e76de3ccd440962bec402d7b47f238e596fccad7,1,1,1,2,1,2012-10-03 15:23:01,2012-10-03 02:06:43
e76de3ccd440962bec402d7b47f238e596fccad7...3e1e25a4d1d6b2b70669787242cbf77d78f99387,2,87,0,87,2,2012-10-03 17:59:27,2012-10-01 14:37:58
3e1e25a4d1d6b2b70669787242cbf77d78f99387...d4619ef38fdd8548a2cc25e0633a9147648819a4,1,30,1,31,4,2012-10-04 14:51:56,2012-09-28 19:31:41
d4619ef38fdd8548a2cc25e0633a9147648819a4...011f6072f5d900c25a364a127c24118c1bc3988f,4,43,20,63,12,2012-10-04 14:52:08,2012-10-01 14:45:29
011f6072f5d900c25a364a127c24118c1bc3988f...d390508cbf59251b96aacd2c6e5e726c6a0c759b,2,11,26,37,7,2012-10-04 14:52:15,2012-10-01 19:35:44
d390508cbf59251b96aacd2c6e5e726c6a0c759b...e0c65e3f6b8c57c3eb873c607a029dcb05b99e5f,3,44,16,60,12,2012-10-04 14:52:24,2012-10-04 14:06:12
e0c65e3f6b8c57c3eb873c607a029dcb05b99e5f...ee081e1df9792e6435568b16d4710a9443ca3657,5,53,30,83,13,2012-10-04 14:53:02,2012-10-03 15:32:40
ee081e1df9792e6435568b16d4710a9443ca3657...8e660532455d1165ff039068336c3dcb1cd5ad5f,2,15,7,22,5,2012-10-04 14:53:10,2012-10-03 15:49:45
8e660532455d1165ff039068336c3dcb1cd5ad5f...edd2fa6fea3f52e1e9ac06f26a7f60d5758adae9,3,43,2,45,7,2012-10-05 13:49:57,2012-10-04 22:04:31
edd2fa6fea3f52e1e9ac06f26a7f60d5758adae9...57e654ee247b13a8a927e9f1f6da597c5ca33c0c,5,632,103,735,85,2012-10-12 18:56:40,2012-10-05 00:49:57
57e654ee247b13a8a927e9f1f6da597c5ca33c0c...60c65832ded36de7306678e09e77760248cd935e,2,59,8,67,8,2012-10-12 18:57:27,2012-10-05 19:38:04
60c65832ded36de7306678e09e77760248cd935e...75bc746a2340ede9c97ed0d75de6d3430a18b376,4,58,10,68,13,2012-10-12 18:58:13,2012-10-11 23:07:14
75bc746a2340ede9c97ed0d75de6d3430a18b376...f7dcb90d9649d6a0ef84729f514e6a82a13199b9,2,31,8,39,7,2012-10-12 18:59:02,2012-10-12 15:57:04
f7dcb90d9649d6a0ef84729f514e6a82a13199b9...293764a638043a01879b7e4fe65c3210186a08a4,1,1,1,2,1,2012-10-12 18:59:54,2012-10-12 17:18:08
293764a638043a01879b7e4fe65c3210186a08a4...c0d27d82dd8212d4af5086bad9e2993a46de56eb,1,1,1,2,1,2012-10-12 22:13:01,2012-10-12 22:12:12
c0d27d82dd8212d4af5086bad9e2993a46de56eb...b19f46ea4b744f9281fb33e7f1491b8080aa879d,7,129,30,159,23,2012-10-15 21:40:34,2012-10-15 21:17:29
b19f46ea4b744f9281fb33e7f1491b8080aa879d...9ff8d3a85f524d727edcb61d309e16656f8e9e7c,2,23,1,24,4,2012-10-17 01:45:04,2012-10-16 20:48:41
9ff8d3a85f524d727edcb61d309e16656f8e9e7c...c26d366ca17b120f3bf3c538a44815d2a7acbf61,1,0,1,1,1,2012-10-17 01:45:35,2012-10-16 21:27:30
c26d366ca17b120f3bf3c538a44815d2a7acbf61...43294fd78b4374530c219771f076aa8f2118ea23,2,30,1,31,4,2012-10-17 01:46:07,2012-10-17 01:40:02
43294fd78b4374530c219771f076aa8f2118ea23...fa0c2577a3f2103910cd76d26ce325b655ac6bbc,3,30,19,49,7,2012-10-17 02:17:23,2012-10-17 02:13:54
fa0c2577a3f2103910cd76d26ce325b655ac6bbc...4689b378b37d5aec8a197a78437b18de1bdfdcf3,1,9,1,10,2,2012-10-17 14:20:00,2012-10-17 05:36:49
4689b378b37d5aec8a197a78437b18de1bdfdcf3...b73c4888f7cedb7b22eb211a08685576c3691eb6,1,12,3,15,5,2012-10-17 14:20:07,2012-10-17 05:39:18
b73c4888f7cedb7b22eb211a08685576c3691eb6...54217e5e20eb5d1604dba4bf8f3368903f23686b,2,10,6,16,7,2012-10-17 19:46:11,2012-10-17 15:22:08
54217e5e20eb5d1604dba4bf8f3368903f23686b...83d73563c47df15373b95e4d4428e323d6005b55,15,25,24,49,23,2012-10-17 20:06:56,2012-10-17 17:08:24
83d73563c47df15373b95e4d4428e323d6005b55...dfb8e2604409e2879ea975c4c49ba6ffde90d795,7,95,33,128,26,2012-10-17 20:07:07,2012-10-17 20:03:53
dfb8e2604409e2879ea975c4c49ba6ffde90d795...b4c6d9278e948c95d1e63b584b9e88d741a803c4,1,1,1,2,1,2012-10-17 21:49:42,2012-10-17 21:49:42
b4c6d9278e948c95d1e63b584b9e88d741a803c4...1bd36a1b83225bcab52f7238866908084b56b328,1,5,0,5,1,2012-10-17 22:52:15,2012-10-17 22:52:15
1bd36a1b83225bcab52f7238866908084b56b328...6f7c02d28f7ab7d88ca02c6279e2f5dabd05c034,7,33,95,128,26,2012-10-18 13:45:11,2012-10-18 13:45:11
6f7c02d28f7ab7d88ca02c6279e2f5dabd05c034...2d0c3f0cae0d6d0a9f32e0a8ac19e389bf8d0f54,1,12,3,15,3,2012-10-18 14:54:14,2012-10-18 14:52:15
2d0c3f0cae0d6d0a9f32e0a8ac19e389bf8d0f54...08c3f9885b4d89958e71b4030e3a1bbffce3bec6,1,3,0,3,1,2012-10-19 13:50:40,2012-10-19 13:43:19
08c3f9885b4d89958e71b4030e3a1bbffce3bec6...58abadd4c00e93e771b1660d9f0b878476539f12,1,11,1,12,4,2012-10-19 13:50:50,2012-10-18 23:08:41
58abadd4c00e93e771b1660d9f0b878476539f12...44746be33b4c75bdece90bfb03b3e55959d59618,1,6,0,6,1,2012-10-19 13:50:59,2012-10-18 20:54:58
44746be33b4c75bdece90bfb03b3e55959d59618...8e3b5a253eeb7e9f8e19ce5a33a2aee7fb1b5dd0,1,46,3,49,4,2012-10-19 13:51:09,2012-10-18 17:04:26
8e3b5a253eeb7e9f8e19ce5a33a2aee7fb1b5dd0...9495696aa169fb34a85eafcb58b64d2ca5e74f25,2,2,2,4,2,2012-10-19 16:58:57,2012-10-19 16:58:57
9495696aa169fb34a85eafcb58b64d2ca5e74f25...5f6b48b5ca453e311577518bd2e7c4bb0a4dbf79,2,2,2,4,2,2012-10-20 02:37:56,2012-10-20 02:37:56
5f6b48b5ca453e311577518bd2e7c4bb0a4dbf79...d6764bf8dfe0685521b8bc7b98fd1fab8cfeb5ae,3,3,3,6,3,2012-10-29 17:17:38,2012-10-29 17:17:38
d6764bf8dfe0685521b8bc7b98fd1fab8cfeb5ae...e6b9b76748d8051ef6616f7fc0a8e0cfbf38d0d1,2,2,2,4,2,2012-10-30 15:43:50,2012-10-30 15:43:50
e6b9b76748d8051ef6616f7fc0a8e0cfbf38d0d1...b6c9d3bfb3c4a0df09e840c6713578f48dc55b3a,1,3,0,3,2,2012-11-06 20:41:15,2012-10-09 19:46:22
b6c9d3bfb3c4a0df09e840c6713578f48dc55b3a...b898687cbea980b2e254ad7c9f159514bd64ad54,1,2,2,4,1,2012-11-06 20:41:15,2012-10-04 14:19:24
b898687cbea980b2e254ad7c9f159514bd64ad54...8bb07be63af3bb27f5f03d767dbf0c7fbda07338,1,2,3,5,1,2012-11-06 20:41:16,2012-10-02 17:03:09
8bb07be63af3bb27f5f03d767dbf0c7fbda07338...c2378fd2d764f76dfaf535a554f6d264ba1c1d92,4,53,11,64,6,2012-11-06 20:41:16,2012-09-23 23:56:01
c2378fd2d764f76dfaf535a554f6d264ba1c1d92...c5bfd792bd6b53ebb753784d3786a7afeb4ccfbb,3,105,35,140,21,2012-11-06 20:41:16,2012-10-09 20:33:45
c5bfd792bd6b53ebb753784d3786a7afeb4ccfbb...67d9b0daa4f444661cf846d07f6a97dfbd03e012,3,26,22,48,6,2012-11-06 20:41:16,2012-09-24 17:58:00
67d9b0daa4f444661cf846d07f6a97dfbd03e012...843a10ca71808a4be340d38912979c7265aa9908,1,18,19,37,7,2012-11-06 20:41:16,2012-09-27 20:56:47
843a10ca71808a4be340d38912979c7265aa9908...5493d59afcc142ec870bac56e9ad654872fdce5d,1,2,2,4,2,2012-11-06 20:41:16,2012-10-01 04:32:18
5493d59afcc142ec870bac56e9ad654872fdce5d...9cf0f3c344a4e155e839d2ac04ccec211e70a2eb,1,8,7,15,6,2012-11-06 20:41:16,2012-10-04 11:58:16
9cf0f3c344a4e155e839d2ac04ccec211e70a2eb...8d44b0127a14fb43a41c23c9c75f0b32c98caaa8,1,40,1,41,1,2012-11-06 20:41:16,2012-10-09 15:32:58
8d44b0127a14fb43a41c23c9c75f0b32c98caaa8...7a5f506e0bef86cc0c68e982904fed4f536e1a57,1,4,7,11,2,2012-11-06 20:41:18,2012-10-14 21:25:02
7a5f506e0bef86cc0c68e982904fed4f536e1a57...4a8a7627d91d1cff7547d4ee11ce9f487898d3d0,1,0,2,2,1,2012-11-06 20:42:37,2012-10-16 15:07:51
4a8a7627d91d1cff7547d4ee11ce9f487898d3d0...f43972dd586475132045bb11a96baac168f5b8cd,2,16,4,20,5,2012-11-06 20:45:20,2012-10-17 09:11:52
f43972dd586475132045bb11a96baac168f5b8cd...f4270abac0d8ca752216e11256f93eb176c6ed8c,5,73,8,81,8,2012-11-06 20:45:44,2012-10-18 21:21:45
f4270abac0d8ca752216e11256f93eb176c6ed8c...fdebd7bae6ca938a80713694ef2dfe360f3dc27f,1,36,18,54,16,2012-11-06 20:46:22,2012-10-18 19:57:19
fdebd7bae6ca938a80713694ef2dfe360f3dc27f...c8dd82004a6759d3485ad1b2a9d49947c52cbf1a,3,18,28,46,8,2012-11-06 20:50:50,2012-10-22 15:24:00
c8dd82004a6759d3485ad1b2a9d49947c52cbf1a...7eabf829d3bfb2798f56c0a863007d9c0facf357,2,117,3,120,3,2012-11-06 20:51:57,2012-10-26 21:22:40
7eabf829d3bfb2798f56c0a863007d9c0facf357...910a15e0698cac4a078c608d6f5c03f44e5f9e18,2,68,2,70,5,2012-11-06 20:55:59,2012-10-29 18:33:34
910a15e0698cac4a078c608d6f5c03f44e5f9e18...e6ebc2a60ebd3aae3ac5b6a34bc489a9affee21b,1,1,1,2,1,2012-11-06 20:58:20,2012-11-05 18:29:09
e6ebc2a60ebd3aae3ac5b6a34bc489a9affee21b...1ce89e9ff2dad6b0dade79bd378d5ad4b765c0e3,1,10,12,22,5,2012-11-06 20:59:56,2012-10-09 09:41:27
1ce89e9ff2dad6b0dade79bd378d5ad4b765c0e3...209ca5fb267b3b0d84bfa9cbac28c8aed3b8924d,1,1,1,2,1,2012-11-06 21:00:23,2012-08-14 14:34:57
209ca5fb267b3b0d84bfa9cbac28c8aed3b8924d...a2af35fefe30de3aa64e7214968969beabce3239,1,2,2,4,2,2012-11-06 21:00:35,2012-09-21 17:55:18
a2af35fefe30de3aa64e7214968969beabce3239...6e3c5b7d4f3b964d2529f4fb4fa110b5f316d45f,2,20,3,23,5,2012-11-06 21:01:06,2012-09-21 20:08:02
6e3c5b7d4f3b964d2529f4fb4fa110b5f316d45f...742094a0024f5e62cd4d1ab01d1f0e4008199a73,1,4,3,7,2,2012-11-06 21:22:22,2012-11-05 19:51:06
742094a0024f5e62cd4d1ab01d1f0e4008199a73...cfac2cb0aa85b9d45deca4d658726999d232eefb,2,27,2,29,5,2012-11-06 21:23:20,2012-11-06 15:54:08
cfac2cb0aa85b9d45deca4d658726999d232eefb...b5ce59fb257b9708922137133f5b200e0ff94186,1,1,1,2,1,2012-11-06 21:24:01,2012-11-06 18:16:01
b5ce59fb257b9708922137133f5b200e0ff94186...e1cb581da6c5c218286b02757fa3ea8969b9eadd,1,7,1,8,1,2012-11-06 22:10:22,2012-11-06 22:10:22
e1cb581da6c5c218286b02757fa3ea8969b9eadd...d7fe5dc2d8f0cf6a95064bfe1ec457e8c4f66a9f,5,113,4,117,11,2012-11-06 22:33:04,2012-11-06 22:33:04
d7fe5dc2d8f0cf6a95064bfe1ec457e8c4f66a9f...ea86be562f0d91a60e1df033a3710d98a78ef801,1,7,7,14,3,2012-11-06 22:43:56,2012-11-06 22:43:56
ea86be562f0d91a60e1df033a3710d98a78ef801...43efcff8b1096d4154aa7af59b8f7a8b77bd1e27,3,10,2,12,3,2012-11-06 23:23:58,2012-11-06 23:23:26
43efcff8b1096d4154aa7af59b8f7a8b77bd1e27...1b0daa024f9caf6fb972f8133a785dfac573d0fb,1,10,2,12,2,2012-11-07 14:33:12,2012-09-25 21:40:40
1b0daa024f9caf6fb972f8133a785dfac573d0fb...2642f0c09b9e8694efd53ce10291a33334d9fc48,3,35,23,58,8,2012-11-07 20:32:05,2012-11-07 18:38:29
2642f0c09b9e8694efd53ce10291a33334d9fc48...f96289dd395b6030429189ed06687c4be0b54c40,2,3,1,4,2,2012-11-07 20:35:35,2012-11-06 22:14:02
f96289dd395b6030429189ed06687c4be0b54c40...105f52b07e90f809a5f6d5ca063c6fbf7638ad17,1,1,1,2,1,2012-11-09 00:10:51,2012-11-09 00:09:16
105f52b07e90f809a5f6d5ca063c6fbf7638ad17...39f9638a400a1189d9f00f89c5ece874b4acaf2a,2,63,1,64,4,2012-11-09 19:21:30,2012-11-09 15:47:00
39f9638a400a1189d9f00f89c5ece874b4acaf2a...3cc3b033b4b8f9e969655128da3c5951a4e9fa33,3,11,5,16,9,2012-11-09 19:53:57,2012-11-08 17:47:28
3cc3b033b4b8f9e969655128da3c5951a4e9fa33...08e7d50eff1e6ac542280c6e31c40b547d99e1ae,1,1,1,2,1,2012-11-09 19:54:04,2012-11-08 21:41:29
08e7d50eff1e6ac542280c6e31c40b547d99e1ae...ff52cf92517a86eebb946b5b3c51df0d9621a01e,1,1,0,1,1,2012-11-09 20:20:28,2012-11-09 20:19:30
ff52cf92517a86eebb946b5b3c51df0d9621a01e...e716273e6e340b69d3ffc16545c297d76bca85fb,1,1,1,2,2,2012-11-11 19:16:18,2012-10-18 21:20:01
e716273e6e340b69d3ffc16545c297d76bca85fb...75d8b0b022a1c1228484af71e1b97adecc67760b,1,917,1309,2226,331,2012-11-13 18:44:47,2012-08-24 22:21:17
75d8b0b022a1c1228484af71e1b97adecc67760b...3d3f7e28b06d42b3f7432d834ac7056e53c41c88,4,294,81,375,189,2012-11-13 18:45:13,2012-11-12 19:07:44
3d3f7e28b06d42b3f7432d834ac7056e53c41c88...ef576759d86050a6098d201cdb193112f1062c94,1,7,5,12,9,2012-11-13 18:45:27,2012-11-13 04:41:59
ef576759d86050a6098d201cdb193112f1062c94...00b4198bd14793de789b10a322145d7bb6885ff7,1,0,2,2,1,2012-11-13 19:28:56,2012-11-13 19:23:55
00b4198bd14793de789b10a322145d7bb6885ff7...ef972b46c92510341f0a25c5f88c8a539b2a8517,2,2,2,4,2,2012-11-14 14:38:44,2012-11-14 14:38:44
ef972b46c92510341f0a25c5f88c8a539b2a8517...c6039b222e5f0d4c518ee997951add2bb4edcb9a,2,2,2,4,2,2012-11-14 21:32:08,2012-11-14 21:32:08
c6039b222e5f0d4c518ee997951add2bb4edcb9a...448ef26e3d74706380b2350030aafc4b22338952,3,223,3,226,4,2012-11-15 17:38:52,2012-11-15 17:38:52
448ef26e3d74706380b2350030aafc4b22338952...9032d392d0caecc23491048710b87c14dd49003f,1,8,8,16,7,2012-11-16 22:34:19,2012-10-26 23:23:15
9032d392d0caecc23491048710b87c14dd49003f...c527cc73e265b647b96b0d84e620c3d75ecd0a1d,1,1,1,2,1,2012-11-16 22:34:49,2012-10-26 23:25:15
c527cc73e265b647b96b0d84e620c3d75ecd0a1d...cb2e7e34d5a2dddeba4eaffece4af7fadcf615a2,1,4,1,5,2,2012-11-16 22:35:21,2012-10-25 02:56:06
cb2e7e34d5a2dddeba4eaffece4af7fadcf615a2...fed35f0c0829626dddeef23c3d9b9e373fe9353f,2,15,7,22,7,2012-11-16 22:36:46,2012-11-05 19:19:11
fed35f0c0829626dddeef23c3d9b9e373fe9353f...5a4b6a0acc92c171e7b8fd7fecd26585e76b60be,2,5,4,9,3,2012-11-17 17:08:08,2012-11-14 20:43:49
5a4b6a0acc92c171e7b8fd7fecd26585e76b60be...f3700f4ec30ee51a7b242166b8f6aa487dd13846,2,2,2,4,2,2012-11-19 04:18:04,2012-11-19 04:18:04
f3700f4ec30ee51a7b242166b8f6aa487dd13846...69655c6c6e4512b89fdac193fa8e8b1db96ab5c5,2,2,2,4,2,2012-11-20 00:35:40,2012-11-20 00:35:40
69655c6c6e4512b89fdac193fa8e8b1db96ab5c5...d1b43b61a5308c4ad0679d34b262c5af9d664267,3,3,3,6,3,2012-11-27 04:08:44,2012-11-27 04:08:44
d1b43b61a5308c4ad0679d34b262c5af9d664267...79a3b1cada2d57fa7b440d6501d6537831e7f3c4,1,1,1,2,1,2012-11-28 05:30:33,2012-11-28 05:30:33
79a3b1cada2d57fa7b440d6501d6537831e7f3c4...f98f20603b966f90efeecfbd45d38949a1f84156,6,676,452,1128,19,2012-11-30 16:16:29,2012-11-29 16:32:23
f98f20603b966f90efeecfbd45d38949a1f84156...c0888b35794e3f9da8eda3b3bd67adef34fc1689,3,18,16,34,17,2012-11-30 18:25:50,2012-11-30 18:25:50
c0888b35794e3f9da8eda3b3bd67adef34fc1689...e342644da333b6efb493bdb6f1c30479f263ee15,2,30,10,40,4,2012-12-03 18:43:36,2012-11-12 20:27:57
e342644da333b6efb493bdb6f1c30479f263ee15...27588421361e5627d9a77667a79c7d0cb4864cce,10,219,67,286,36,2012-12-04 16:47:04,2012-11-30 20:15:45
27588421361e5627d9a77667a79c7d0cb4864cce...d03939e182aec740fb83a65400ee02ce572752ff,6,75,15,90,8,2012-12-14 18:13:03,2012-12-12 05:18:43
d03939e182aec740fb83a65400ee02ce572752ff...8014832a4a4e0925dda1351e0113c7c7b9af94eb,5,133,15,148,18,2012-12-19 16:18:43,2012-12-18 05:00:53
8014832a4a4e0925dda1351e0113c7c7b9af94eb...5baf992b906f440ce99f917d1d53767a303be7f9,1,3,1,4,1,2012-12-20 03:20:10,2012-12-20 03:19:18
5baf992b906f440ce99f917d1d53767a303be7f9...c31da72e8ad5a9a40a03c5286637f58aa658e233,1,22,4,26,3,2012-12-27 20:06:35,2012-12-27 18:53:05
c31da72e8ad5a9a40a03c5286637f58aa658e233...cdc2db7f6b3da66ff7743a06f7852d1343057719,1,1,6,7,2,2012-12-27 20:06:45,2012-12-27 18:58:50
cdc2db7f6b3da66ff7743a06f7852d1343057719...c5f1c1474b182143690867760253b0c99ab1fc5b,3,64,1,65,4,2013-01-07 23:20:42,2013-01-07 19:41:49
c5f1c1474b182143690867760253b0c99ab1fc5b...c28a406b1f3b68a983d40df8503989e39449d8ac,1,8,3,11,2,2013-01-08 06:16:02,2012-11-26 22:51:06
c28a406b1f3b68a983d40df8503989e39449d8ac...82755a0350d77b7492cbe1c234fbefe4ca3099e5,1,2,2,4,2,2013-01-08 06:45:29,2013-01-08 06:45:29
82755a0350d77b7492cbe1c234fbefe4ca3099e5...0878621290380f7300222b90fc7dde03da1122cb,2,86,7,93,8,2013-01-08 06:46:35,2012-09-12 16:27:20
0878621290380f7300222b90fc7dde03da1122cb...9094e68b9b10e32e48949a45bd12515e2bf562c0,1,1,2,3,1,2013-01-08 06:53:42,2012-11-26 18:58:49
9094e68b9b10e32e48949a45bd12515e2bf562c0...4473320aca6097d567cb4f3b2e48ad776dd544b1,1,16,0,16,1,2013-01-08 06:54:05,2012-11-26 19:49:39
4473320aca6097d567cb4f3b2e48ad776dd544b1...8885784cf186b48bda5bd0ee99ff0bfa0a76ff69,2,12,10,22,3,2013-01-08 06:54:22,2012-11-29 18:56:25
8885784cf186b48bda5bd0ee99ff0bfa0a76ff69...b7b2db71ba49e3092119869bcccf90a6d4c45df3,5,107,8,115,7,2013-01-08 07:06:21,2012-11-18 15:50:42
b7b2db71ba49e3092119869bcccf90a6d4c45df3...97df5708b95d28497e16f172e57922b02bca1ee9,4,32,12,44,8,2013-01-08 07:07:17,2012-11-18 21:28:55
97df5708b95d28497e16f172e57922b02bca1ee9...f33a8ce32228554be61c6b65658c5a8e7ab5acf6,1,1,0,1,1,2013-01-08 07:07:29,2012-11-19 16:52:15
f33a8ce32228554be61c6b65658c5a8e7ab5acf6...6f22c3af01fd19aad13c67f58fa98b3e02b62eae,1,1,0,1,1,2013-01-08 07:07:40,2012-11-19 18:07:15
6f22c3af01fd19aad13c67f58fa98b3e02b62eae...832a4c0ccf4fb4135429487477ba93dd9370b5e0,4,34,17,51,8,2013-01-08 07:12:40,2012-11-30 16:37:59
832a4c0ccf4fb4135429487477ba93dd9370b5e0...aecd951b3df16248769a01682e8863656a564e8a,2,21,3,24,4,2013-01-08 08:05:23,2012-11-14 05:17:52
aecd951b3df16248769a01682e8863656a564e8a...2d43e87a51d62e92767b08b9703596dafcfa5f52,1,1,1,2,1,2013-01-08 08:08:56,2012-11-11 06:47:33
2d43e87a51d62e92767b08b9703596dafcfa5f52...e4d0c8913502bf13c00e1448fc74b38cea8cdfff,1,82,11,93,8,2013-01-08 08:09:40,2012-11-08 21:20:05
e4d0c8913502bf13c00e1448fc74b38cea8cdfff...f7afbab2c3fcb54475a6d3c12065f7b36a3f5065,1,22,1,23,3,2013-01-08 08:10:02,2012-11-13 19:56:39
f7afbab2c3fcb54475a6d3c12065f7b36a3f5065...d5a4514a067350e10d17f83a15178a09fa662669,1,9,4,13,3,2013-01-08 08:10:32,2012-12-07 09:29:43
d5a4514a067350e10d17f83a15178a09fa662669...c814cb28686e5336f3cbc3753dc120cbfc43a854,1,1,1,2,1,2013-01-08 08:11:16,2012-11-28 10:22:34
c814cb28686e5336f3cbc3753dc120cbfc43a854...64d9280591661c7bec80a41fc788bf0a6d26416d,1,4,0,4,1,2013-01-08 08:46:32,2013-01-04 18:39:39
64d9280591661c7bec80a41fc788bf0a6d26416d...d857206880ff052f71ebc1593a600d9e327dddde,2,2,2,4,2,2013-01-08 08:52:43,2013-01-08 08:52:43
d857206880ff052f71ebc1593a600d9e327dddde...e330e5269e9a243e167c5933809602e5e0a36e39,1,3,1,4,1,2013-01-08 20:30:28,2013-01-08 20:30:28
e330e5269e9a243e167c5933809602e5e0a36e39...c5c64e3ace3f764f100f7d007d2542ada84bf205,2,2,2,4,2,2013-01-09 03:38:15,2013-01-09 03:37:48
c5c64e3ace3f764f100f7d007d2542ada84bf205...c0ce2108ccadf7b0a48fd8b4a7e4eb2f5caa7157,2,2,2,4,2,2013-01-09 04:09:12,2013-01-09 04:09:12
c0ce2108ccadf7b0a48fd8b4a7e4eb2f5caa7157...38f42b2a42011c23385ba899ab84f78bfa9dc1af,4,213,41,254,10,2013-01-09 19:44:43,2013-01-09 17:12:05
38f42b2a42011c23385ba899ab84f78bfa9dc1af...0a6bac4569c92c7ef92cb4b66f5ec0797b1334af,2,5,4,9,5,2013-01-09 19:47:34,2013-01-09 19:47:34
0a6bac4569c92c7ef92cb4b66f5ec0797b1334af...baaa9118f92d31e6ad400acd0a1e7d9b37ea5d93,4,14,11,25,11,2013-01-09 21:58:25,2013-01-09 21:58:25
baaa9118f92d31e6ad400acd0a1e7d9b37ea5d93...511cbba4d22ac7f2118608927144fe243a76bd16,4,17,34,51,8,2013-01-10 21:26:16,2013-01-10 21:26:16
511cbba4d22ac7f2118608927144fe243a76bd16...5c2f3da947dc5e7c5fec9561d315f51101467a1d,1,1,1,2,1,2013-01-12 05:40:10,2013-01-12 05:40:10
5c2f3da947dc5e7c5fec9561d315f51101467a1d...ededb03f2104f37cdb376e0f17a4d53b87f05cdf,2,73,1,74,4,2013-01-22 21:10:18,2013-01-22 18:53:52
ededb03f2104f37cdb376e0f17a4d53b87f05cdf...109f6fbde0f802413fa80b699a2e2d39cf9b32fc,2,20,11,31,8,2013-01-22 21:10:39,2013-01-15 02:05:02
109f6fbde0f802413fa80b699a2e2d39cf9b32fc...31150cee4cf5aae5fa54ab8d34a8f8452b11b0f1,2,13,6,19,8,2013-01-22 21:10:49,2013-01-15 06:06:58
31150cee4cf5aae5fa54ab8d34a8f8452b11b0f1...ffb92e80ed7b3e68d41d1f1fd7307f4bd2fd9001,1,10,1,11,1,2013-01-22 21:46:12,2012-10-22 16:06:47
ffb92e80ed7b3e68d41d1f1fd7307f4bd2fd9001...ea9c49e06abed02cad55d74d1d35ecc82e5d804e,1,6,0,6,1,2013-01-22 21:46:39,2013-01-21 20:36:38
ea9c49e06abed02cad55d74d1d35ecc82e5d804e...0bab4de51001b8e60eff262ac5c3e860908f25f0,1,1,0,1,1,2013-01-22 22:37:16,2013-01-10 07:29:42
0bab4de51001b8e60eff262ac5c3e860908f25f0...0adb9623539b7cf8bc9bb32bb61b9b83db9c0fda,3,5,7,12,5,2013-01-22 23:31:46,2013-01-22 23:31:46
0adb9623539b7cf8bc9bb32bb61b9b83db9c0fda...0a3b5f08e689b87b41792a1d4e87c493403ede58,2,14,17,31,9,2013-01-23 15:13:24,2013-01-22 19:29:18
0a3b5f08e689b87b41792a1d4e87c493403ede58...e753f6e4823107e4679908500d5934f19dc0d9ab,2,2,2,4,2,2013-01-24 15:22:47,2013-01-24 15:22:47
e753f6e4823107e4679908500d5934f19dc0d9ab...94377aa2b3b7ed7f32c837f46b5c081b0e16cfd8,2,2,2,4,2,2013-01-25 04:17:18,2013-01-25 04:17:18
94377aa2b3b7ed7f32c837f46b5c081b0e16cfd8...f570771a5d8a3846eb7586eaffcf4c2f4a96bf08,3,3,3,6,3,2013-01-31 15:18:33,2013-01-31 15:18:33
f570771a5d8a3846eb7586eaffcf4c2f4a96bf08...80b13a41c1012546234fb44d94c76c449608dca6,2,2,2,4,2,2013-02-01 22:13:27,2013-02-01 22:13:27
80b13a41c1012546234fb44d94c76c449608dca6...139a5759a98d9b18b41499b3c7e4475e5fdb2566,2,9,1,10,4,2013-02-08 23:47:01,2013-02-08 21:10:27
139a5759a98d9b18b41499b3c7e4475e5fdb2566...294c08491709b8fffae0ed1b63b8c34b35f9621a,1,1,1,2,1,2013-02-21 15:15:03,2013-02-21 06:23:48
294c08491709b8fffae0ed1b63b8c34b35f9621a...7ccd633c1c760b0149c6ca8edbd8fd7facb38023,4,44,36,80,13,2013-02-21 22:59:01,2013-02-13 16:26:04
7ccd633c1c760b0149c6ca8edbd8fd7facb38023...eb1217cf2847aa1a9dc9dc47418a3b073f751cc2,1,1,1,2,1,2013-02-22 18:32:52,2013-02-20 14:37:00
eb1217cf2847aa1a9dc9dc47418a3b073f751cc2...37c3df43f01a57c3698db6e371f71371a0ddd6a4,2,10,1,11,4,2013-02-27 17:14:33,2013-01-09 00:00:19
37c3df43f01a57c3698db6e371f71371a0ddd6a4...b4e33ce1ba54c6bfa4ff9ae0bd144d674e11c883,14,124,8,132,21,2013-02-27 18:45:25,2012-11-17 01:44:21
b4e33ce1ba54c6bfa4ff9ae0bd144d674e11c883...57ffb2b9993859213f6bc7cb8e664548377f6445,1,1,1,2,1,2013-02-27 18:45:25,2012-11-20 15:47:02
57ffb2b9993859213f6bc7cb8e664548377f6445...8cadee62dea7b2db8acb07e9eb5e6bb87f18d9c8,4,463,23,486,4,2013-02-27 18:53:04,2013-02-11 18:28:07
8cadee62dea7b2db8acb07e9eb5e6bb87f18d9c8...206bd9372623375aee7bd1c67520d93f96508105,1,2,2,4,2,2013-02-27 19:03:09,2013-02-11 23:06:33
206bd9372623375aee7bd1c67520d93f96508105...cd6d81d6db45da1df6ad5b357d23d7b1e2f514ca,3,8,21,29,10,2013-02-27 19:08:06,2013-02-27 19:08:06
cd6d81d6db45da1df6ad5b357d23d7b1e2f514ca...a332782ad86a83021103fbf3d6f542cb93687975,5,62,8,70,7,2013-03-01 19:17:01,2013-02-28 22:01:56
a332782ad86a83021103fbf3d6f542cb93687975...b83eb6d8aa2d4e8729d4bb22076e19461ad74dc5,1,6,1,7,4,2013-03-01 19:17:01,2013-02-28 22:57:51
b83eb6d8aa2d4e8729d4bb22076e19461ad74dc5...ce3058ed45c4e5d5c3a928081c366a38bec634b2,1,2,1,3,1,2013-03-01 23:43:11,2012-12-04 05:17:26
ce3058ed45c4e5d5c3a928081c366a38bec634b2...de7b456a97ed838c95023829687c7c91e5ddc1ee,1,1,1,2,1,2013-03-01 23:43:39,2013-03-01 23:25:16
de7b456a97ed838c95023829687c7c91e5ddc1ee...77dff908bcbe0f13a2cfc5b48bfda750e4619ce6,1,18,4,22,6,2013-03-06 20:47:10,2013-01-01 05:05:17
77dff908bcbe0f13a2cfc5b48bfda750e4619ce6...a3f7825c1e5f0b1d27cb1d75a080f34d63669d67,3,15,2,17,3,2013-03-06 20:47:23,2012-12-31 05:22:25
a3f7825c1e5f0b1d27cb1d75a080f34d63669d67...0b92639ad548a9262bf7ee19dbf66b7478fe09e8,1,14,1,15,2,2013-03-06 22:26:18,2012-10-11 20:16:04
0b92639ad548a9262bf7ee19dbf66b7478fe09e8...910e3d71fed12bc5731c652b793183c15dbb0977,61,249,239,488,233,2013-03-06 22:32:43,2012-10-24 17:45:27
910e3d71fed12bc5731c652b793183c15dbb0977...61bde93234ed57ce716eabd1c6fbc32b616778b2,1,2,19,21,4,2013-03-06 22:33:20,2012-10-24 17:58:30
61bde93234ed57ce716eabd1c6fbc32b616778b2...69035fca654edfa038e17d1c4543206c48708f6b,1,21,6,27,3,2013-03-06 22:33:41,2012-10-15 23:42:39
69035fca654edfa038e17d1c4543206c48708f6b...b444115cb047a296d250d30765220e0540e23047,6,7,7,14,7,2013-03-06 22:35:50,2012-10-25 21:07:35
b444115cb047a296d250d30765220e0540e23047...083b31476e393258220410f7268261b38c529d97,1,1,1,2,1,2013-03-06 22:36:08,2013-01-18 21:50:39
083b31476e393258220410f7268261b38c529d97...9887fa9cd31bc8fb8500784d1635068cab6abb3e,1,25,6,31,5,2013-03-06 22:36:20,2013-01-18 23:37:08
9887fa9cd31bc8fb8500784d1635068cab6abb3e...f7e854ac9a91cdb2d5c0199148facd8e74e587ba,2,5,4,9,5,2013-03-06 22:37:23,2013-01-18 22:57:53
f7e854ac9a91cdb2d5c0199148facd8e74e587ba...379bee085f2d8bd71c136a5aa136aef2b3da80ed,2,5,5,10,5,2013-03-06 22:46:13,2013-03-06 22:46:13
379bee085f2d8bd71c136a5aa136aef2b3da80ed...39d12aabde1cf72d388de0a2842210018e84c5ae,1,5,2,7,3,2013-03-07 16:45:15,2013-02-08 17:37:06
39d12aabde1cf72d388de0a2842210018e84c5ae...4884f194b011377c05a0b15aecb803efe6af7234,1,3,1,4,1,2013-03-07 17:01:56,2013-02-09 18:04:10
4884f194b011377c05a0b15aecb803efe6af7234...70e051c0480212f80582713da5f0736d12f51de8,1,8,3,11,4,2013-03-07 17:36:23,2013-03-07 17:36:23
70e051c0480212f80582713da5f0736d12f51de8...43f8fdac6e87dc022e2dcb044ad28c1e4903d6e9,1,4,0,4,1,2013-03-11 18:07:42,2013-02-26 21:51:12
43f8fdac6e87dc022e2dcb044ad28c1e4903d6e9...0b6b3dd955cfb6a09f509a5038208669981f409e,2,2,2,4,2,2013-03-11 18:07:42,2013-02-24 12:15:20
0b6b3dd955cfb6a09f509a5038208669981f409e...ffe74836e1b4de86d5a9a5d2335fafbae109bd8e,1,2,1,3,1,2013-03-11 18:07:42,2012-12-31 08:23:02
ffe74836e1b4de86d5a9a5d2335fafbae109bd8e...2d57d099e27b145f040de2f8980e046c0053843a,1,1,1,2,1,2013-03-14 21:12:14,2013-03-14 21:12:14
2d57d099e27b145f040de2f8980e046c0053843a...49cb7cab30855e58ef506c97d1280f2ca7d4dc6e,1,75,10,85,12,2013-03-14 21:15:56,2013-02-28 22:34:30
49cb7cab30855e58ef506c97d1280f2ca7d4dc6e...32fe4cd8fd541e0c14fd28ac17096e9ff76ba726,1,2,2,4,2,2013-03-14 21:16:12,2013-03-01 13:04:19
32fe4cd8fd541e0c14fd28ac17096e9ff76ba726...4873c2bd64b71af9713eb75b222a7e13c6c4e747,1,2,2,4,1,2013-03-15 16:11:57,2013-03-15 16:11:57
4873c2bd64b71af9713eb75b222a7e13c6c4e747...ed9d5f067faadc0bcaeed184f47657741b30f59d,2,6,1,7,2,2013-03-18 15:33:33,2013-03-18 14:28:44
ed9d5f067faadc0bcaeed184f47657741b30f59d...861863ac17feb7ae598f640919a1fc8ba71ce421,1,150,19,169,15,2013-03-20 16:26:48,2013-03-20 16:26:48
861863ac17feb7ae598f640919a1fc8ba71ce421...74323d671a216c8c87fcb295ed743f830d5212ee,4,49,3,52,9,2013-03-20 17:03:36,2013-03-20 16:54:47
74323d671a216c8c87fcb295ed743f830d5212ee...b0f59346069b9b007c1d7d4863b661d0bb06615b,1,3,1,4,2,2013-03-20 21:46:48,2013-01-12 20:20:25
b0f59346069b9b007c1d7d4863b661d0bb06615b...33aa9495f99cc61659961ef7358fb31d8ba1b347,1,12,3,15,2,2013-03-20 21:53:14,2013-02-08 19:03:14
33aa9495f99cc61659961ef7358fb31d8ba1b347...2048a8099765766aa772592ecb0e5a6d54530287,2,10,12,22,8,2013-03-20 21:55:14,2013-02-12 20:32:24
2048a8099765766aa772592ecb0e5a6d54530287...b80968f10ce72f4830ed7c7b1592611dc160f5c1,2,6,6,12,3,2013-03-20 21:58:06,2013-02-01 16:19:43
b80968f10ce72f4830ed7c7b1592611dc160f5c1...679219a64948a9702c639d2a3bdbd20b6be68723,3,68,21,89,19,2013-03-21 00:03:52,2013-01-28 15:55:04
679219a64948a9702c639d2a3bdbd20b6be68723...aa3eab2d92a96d13890fa84b524cd48990ce24c0,2,7,0,7,2,2013-03-21 00:32:31,2013-02-11 22:27:33
aa3eab2d92a96d13890fa84b524cd48990ce24c0...ab40103bbb365075ab5300692ad6412c3c038040,1,72,0,72,1,2013-03-21 00:32:40,2013-02-18 17:55:42
ab40103bbb365075ab5300692ad6412c3c038040...8ea5dd424949d66d0859a45e9b5bc0889fb0ca30,3,43,3,46,3,2013-03-21 00:46:17,2013-01-16 21:47:34
8ea5dd424949d66d0859a45e9b5bc0889fb0ca30...2802b46fde6d3c20f738df0a233ebd0f0f5f8083,1,24,17,41,5,2013-03-21 18:46:04,2013-03-21 18:46:04
2802b46fde6d3c20f738df0a233ebd0f0f5f8083...415ccd3c89eed61d8fa87efaa94045c4c8d5ad75,1,4,2,6,2,2013-03-21 19:12:33,2012-10-15 20:40:29
415ccd3c89eed61d8fa87efaa94045c4c8d5ad75...5d5fe49dfb5f452832b9d44fddbfb2a4e8b42f2a,1,6,0,6,2,2013-03-21 22:04:09,2013-03-21 22:03:39
5d5fe49dfb5f452832b9d44fddbfb2a4e8b42f2a...15291f335c820719d432189fe1dd871193588ca7,1,8,2,10,4,2013-03-22 17:38:15,2013-03-22 17:38:15
15291f335c820719d432189fe1dd871193588ca7...8e252ca206118f3b64ccef4e857e2e84c26a10e0,8,34,18,52,15,2013-03-23 19:03:05,2013-03-23 19:03:05
8e252ca206118f3b64ccef4e857e2e84c26a10e0...568e95e3dad7ee511565056db4f03586cd5ad018,1,1,8,9,2,2013-03-25 15:49:41,2013-01-25 15:33:46
568e95e3dad7ee511565056db4f03586cd5ad018...cb9f8b361e6559ed72fb302be273ea979541b246,2,98,5,103,2,2013-03-25 21:24:34,2013-03-20 14:56:00
cb9f8b361e6559ed72fb302be273ea979541b246...4c93c589bca1099b78e8b0fe48b64e434eb462f1,1,76,51,127,8,2013-03-25 23:18:50,2013-03-25 23:18:50
4c93c589bca1099b78e8b0fe48b64e434eb462f1...e37c8c1e9d64a2d88af633326b557715565de96b,2,2,2,4,2,2013-03-26 13:18:16,2013-03-26 13:18:16
e37c8c1e9d64a2d88af633326b557715565de96b...5558c2821b6a4fdca3dc8aa23a49162c290f1d59,2,2,2,4,2,2013-03-27 13:52:13,2013-03-27 13:52:13
5558c2821b6a4fdca3dc8aa23a49162c290f1d59...f1f70fbe0b515e7d868db0815cec822ae5515966,1,4,5,9,3,2013-03-27 19:17:34,2013-03-26 18:47:30
f1f70fbe0b515e7d868db0815cec822ae5515966...d1421e517c41af36cd756f591b913e3c2b3fed76,1,24,3,27,7,2013-03-28 22:51:19,2013-03-22 17:22:42
d1421e517c41af36cd756f591b913e3c2b3fed76...a2880030d3cec10c850c6850efa7a51b628b8822,2,2,2,4,2,2013-04-01 02:41:49,2013-04-01 02:41:49
a2880030d3cec10c850c6850efa7a51b628b8822...c1bd54f486b76b5427c271be86c6534cdab528cc,2,2,2,4,2,2013-04-02 21:02:43,2013-04-02 21:02:43
c1bd54f486b76b5427c271be86c6534cdab528cc...e8ea40668b1f2dcc0d61760ad3bccd98e0d77b8c,3,52,12,64,7,2013-04-18 15:33:22,2013-04-18 15:33:22
e8ea40668b1f2dcc0d61760ad3bccd98e0d77b8c...ae626614e5ee0de1724fbeaf07c862d6e566d745,1,2,2,4,2,2013-05-10 15:42:52,2013-05-06 18:33:17
ae626614e5ee0de1724fbeaf07c862d6e566d745...90bca9c3ad719d3070fe1c94dc3a716aff63bb3c,1,14,2,16,4,2013-05-19 16:07:08,2013-05-14 17:49:03
90bca9c3ad719d3070fe1c94dc3a716aff63bb3c...aa141a8f086230a25161299f685f9bd3c710936d,1,10,2,12,4,2013-05-19 16:39:44,2012-12-13 17:01:22
aa141a8f086230a25161299f685f9bd3c710936d...5ec76b730a94b6d8d072fab0a348e34debe72ea3,1,3,5,8,3,2013-05-22 21:57:52,2013-05-22 21:08:31
5ec76b730a94b6d8d072fab0a348e34debe72ea3...f159ee9995d9f2fdd8505579f27ba6aaf235d53e,4,10,7,17,5,2013-05-30 22:00:54,2013-05-30 18:39:57
f159ee9995d9f2fdd8505579f27ba6aaf235d53e...d3f702443935daba7caf03366525b54028ee151e,1,1,1,2,2,2013-05-31 17:35:48,2013-05-31 17:35:48
d3f702443935daba7caf03366525b54028ee151e...db3bc3e7e12c56a06a17b1d67bb1987da5b1e9af,1,3,0,3,1,2013-05-31 21:32:57,2013-04-08 16:44:02
db3bc3e7e12c56a06a17b1d67bb1987da5b1e9af...819500d00d46fe0e69ce4cfb4398f04ce79b8471,1,1,0,1,1,2013-05-31 23:28:41,2013-05-02 21:06:48
819500d00d46fe0e69ce4cfb4398f04ce79b8471...b9225432a8d6a5ee11353f78e5df74df9b3c6451,2,13,2,15,3,2013-06-03 18:26:40,2013-04-22 15:35:44
b9225432a8d6a5ee11353f78e5df74df9b3c6451...9d93c7ecb606a8d4260cadf73434b3c2ac1baa01,2,48,2,50,4,2013-06-03 18:31:05,2013-04-29 17:34:43
9d93c7ecb606a8d4260cadf73434b3c2ac1baa01...2f4c521ddb8b342dcd24a3662a8b68e306d86323,1,1,2,3,1,2013-06-03 18:31:22,2013-04-30 19:33:00
2f4c521ddb8b342dcd24a3662a8b68e306d86323...ad2cce872c16a6e1bd540d9570b3f40cb763ee5f,1,5,1,6,2,2013-06-03 22:18:20,2013-04-08 21:21:33
ad2cce872c16a6e1bd540d9570b3f40cb763ee5f...5a3244c1b1424f4fbeb006f501c450074f4127f2,1,3,1,4,1,2013-06-13 21:26:37,2012-12-07 20:22:52
5a3244c1b1424f4fbeb006f501c450074f4127f2...0a4d62f611f4c12a01dca53dc21181091a9bf51e,1,5,6,11,5,2013-06-13 21:28:04,2013-05-23 17:28:15
0a4d62f611f4c12a01dca53dc21181091a9bf51e...6e344f615d87203d0739d0ab0cd45674ca31c5f2,1,1,0,1,1,2013-06-14 14:42:46,2013-06-14 14:42:46
6e344f615d87203d0739d0ab0cd45674ca31c5f2...367b3314efe6c21be461ad7e4041fde2c3904f9c,1,3,1,4,1,2013-06-14 19:00:10,2013-05-10 20:02:12
367b3314efe6c21be461ad7e4041fde2c3904f9c...1378421212e0afbc048e403a24e89cf25c5586a1,1,4,1,5,2,2013-06-14 19:00:15,2013-05-15 15:26:32
1378421212e0afbc048e403a24e89cf25c5586a1...31ba99f6c3385014b56e4f358c5cc9320d6c293d,1,6,1,7,2,2013-06-14 19:00:37,2013-06-14 18:58:46
31ba99f6c3385014b56e4f358c5cc9320d6c293d...447e4270013070e306e2e420a4218a1760c78840,1,1,1,2,1,2013-06-17 13:27:18,2013-06-17 13:26:38
447e4270013070e306e2e420a4218a1760c78840...5b668e129e3d4c2256cc800be6f80e326576bf38,2,2,2,4,2,2013-06-18 18:53:23,2013-06-18 18:53:23
5b668e129e3d4c2256cc800be6f80e326576bf38...f639e8b5638fb0890e11895127044294ad192236,2,2,2,4,2,2013-06-20 19:43:08,2013-06-20 19:43:08
f639e8b5638fb0890e11895127044294ad192236...14d8c4d1eb320ab10c6956f6e4b52263249bc0b4,2,2,2,4,2,2013-06-26 18:24:03,2013-06-26 18:24:03
14d8c4d1eb320ab10c6956f6e4b52263249bc0b4...ad58211471756440cf9c36bc3d9598b50520f9d0,2,2,2,4,2,2013-06-28 02:06:45,2013-06-28 02:06:45
ad58211471756440cf9c36bc3d9598b50520f9d0...5540865628d166f88da833d7470fd3f792c8017d,1,23,3,26,1,2013-07-01 14:42:36,2013-07-01 14:42:36
5540865628d166f88da833d7470fd3f792c8017d...c83318821c4497026731511c391a6f6686d24be3,1,4,4,8,2,2013-07-01 16:18:51,2013-07-01 14:27:17
c83318821c4497026731511c391a6f6686d24be3...4bf8648b4196aff618c68ca2d814a1a13f48c3d2,1,5,0,5,1,2013-07-01 21:22:30,2013-07-01 21:08:15
4bf8648b4196aff618c68ca2d814a1a13f48c3d2...a8e94e832027d44a78b441f9efdc8352ce56834a,2,67,3,70,3,2013-08-12 13:45:54,2013-08-09 19:52:05
a8e94e832027d44a78b441f9efdc8352ce56834a...99c28482a656021be8c6ae5fc4c002cbd6fd46d4,1,32,1,33,7,2013-08-12 13:48:45,2013-08-09 19:52:05
99c28482a656021be8c6ae5fc4c002cbd6fd46d4...a7278ae099789f2a99a240bd02fc0d7519175916,3,3,3,6,3,2013-08-12 21:37:22,2013-08-12 21:37:22
a7278ae099789f2a99a240bd02fc0d7519175916...6a896217f91e45866e211e13ec7903def95cd704,1,4,2,6,2,2013-08-13 19:20:15,2013-08-13 19:17:20
6a896217f91e45866e211e13ec7903def95cd704...10a0a5b2e6c6b2dfe2cbf35e1fa6cb386501474e,2,2,2,4,2,2013-08-13 21:50:00,2013-08-13 21:50:00
10a0a5b2e6c6b2dfe2cbf35e1fa6cb386501474e...300a2288f247f589ace675160dc95b34a655eb08,1,4,2,6,1,2013-08-15 22:50:56,2013-08-15 15:05:00
300a2288f247f589ace675160dc95b34a655eb08...d626379119a6de9f2fb390780cf2fc336dfd540d,2,2,2,4,2,2013-08-18 18:42:54,2013-08-18 18:42:54
d626379119a6de9f2fb390780cf2fc336dfd540d...e62a094fd0c39c3a2d56f990d904da2fa9653b58,2,2,2,4,2,2013-08-20 20:03:23,2013-08-20 20:03:23
e62a094fd0c39c3a2d56f990d904da2fa9653b58...0364ef4bdd4c17a07801457334aee32b9f601828,6,124,8,132,8,2013-08-29 20:02:08,2013-04-22 18:48:02
0364ef4bdd4c17a07801457334aee32b9f601828...be66f1b8fc992251f4785adb4c632d3b4677e005,1,1,2,3,2,2013-08-29 20:02:29,2013-04-30 15:58:46
be66f1b8fc992251f4785adb4c632d3b4677e005...9c9bbd9eeb0978023c599e714d33e004fa94b5c8,1,2,0,2,1,2013-12-09 19:37:37,2013-12-09 15:57:19
9c9bbd9eeb0978023c599e714d33e004fa94b5c8...307fb42c66350981525d64ca8f6a2dbfe6a3d8f4,2,38,33,71,4,2014-01-06 15:29:47,2013-12-21 14:30:26
307fb42c66350981525d64ca8f6a2dbfe6a3d8f4...4f109846481d81bc4b014db00391c61df5f5afa7,2,2,2,4,2,2014-01-07 04:11:09,2014-01-07 04:11:09
4f109846481d81bc4b014db00391c61df5f5afa7...80f87a4de27abfc380e2ecbcacb5b155b5ebad11,2,2,2,4,2,2014-01-09 22:30:09,2014-01-09 22:30:09
80f87a4de27abfc380e2ecbcacb5b155b5ebad11...6c2023ca359ed31407d999edcbe8cd7bd1d433b3,2,2,2,4,2,2014-01-12 21:19:10,2014-01-12 21:19:10
6c2023ca359ed31407d999edcbe8cd7bd1d433b3...0958c93e36120ad0342d863ed6032915d0b61ed3,2,2,2,4,2,2014-01-16 18:46:01,2014-01-16 18:46:01
296d6e6a52d3583c823cce81b4e1cb89a43b3b36...c1bb369cc1fe8b7e543fe217d6db1f4f3b2f0b5d,2,2,2,4,2,2012-08-13 00:47:22,2012-08-13 00:47:22
c1bb369cc1fe8b7e543fe217d6db1f4f3b2f0b5d...0241b042ead3629d19dd507fc8f294c3bf3a5a2d,2,31,0,31,7,2012-08-13 21:22:10,2012-08-13 21:22:10
0241b042ead3629d19dd507fc8f294c3bf3a5a2d...9e1a79dc4a2cc632d45e6af67f574c41aeff54ac,1,1,1,2,1,2012-08-14 14:34:57,2012-08-14 14:34:57
4aaed4ccfb608db56a269e0422f6d48385c28445...f08a742aadb8036944f2843aaac7627e2a49e4fc,1,27,6,33,3,2012-08-06 17:17:35,2012-08-03 20:15:17
4aaed4ccfb608db56a269e0422f6d48385c28445...ebc14a51ca3cfc0be7831eefb446860e22360e97,2,18,18,36,8,2012-08-03 16:31:26,2012-08-03 16:31:26
ebc14a51ca3cfc0be7831eefb446860e22360e97...6eae75619a200baa958b0569016952e5a478cc1e,1,36,15,51,10,2012-08-03 16:36:05,2012-08-02 19:03:29
6eae75619a200baa958b0569016952e5a478cc1e...a1382fdb96bd73e525d6f5499efc31456c07827a,1,9,0,9,2,2012-08-03 16:37:21,2012-08-03 16:35:18
a1382fdb96bd73e525d6f5499efc31456c07827a...e8a3698ef1a2327f38b033c02804c9fb0a97cfea,1,10,4,14,6,2012-08-03 19:42:26,2012-08-03 19:42:26
e8a3698ef1a2327f38b033c02804c9fb0a97cfea...4b7d1be137c0153587220409b2b652255c027d4e,1,5,0,5,5,2012-08-03 20:21:58,2012-08-03 20:21:58
4b7d1be137c0153587220409b2b652255c027d4e...c24b7f9b383367fc2deb2ca01b9b675c6c11eb62,1,3,2,5,1,2012-08-03 20:59:38,2012-08-03 20:35:44
c24b7f9b383367fc2deb2ca01b9b675c6c11eb62...a267fce485de9d52c73ad3c5637c43602d286a0f,1,1,0,1,1,2012-08-03 21:19:39,2012-08-03 21:19:39
a267fce485de9d52c73ad3c5637c43602d286a0f...2069338cce46347116a94004d88861a14ecf3211,2,5,3,8,3,2012-08-03 21:57:57,2012-08-03 20:47:17
2069338cce46347116a94004d88861a14ecf3211...bf724ef21063d3f7f9dec856ef602899b5d0ea14,1,5,4,9,2,2012-08-03 23:20:16,2012-08-03 22:35:21
bf724ef21063d3f7f9dec856ef602899b5d0ea14...c61c32ffb95a1dbac6afd1539ebab12b9472eee0,1,2,3,5,1,2012-08-04 00:39:24,2012-08-04 00:39:24
c61c32ffb95a1dbac6afd1539ebab12b9472eee0...0ff6b7aeb373c82d70cd5a34ce1c2d85f4a725cb,1,4,3,7,1,2012-08-04 20:52:10,2012-08-04 20:52:10
0ff6b7aeb373c82d70cd5a34ce1c2d85f4a725cb...c9eb7c87a391e3acf9c0e73e2619cdf8f87b6ab6,5,19,0,19,17,2012-08-05 18:17:49,2012-08-05 00:17:11
c9eb7c87a391e3acf9c0e73e2619cdf8f87b6ab6...0456a42b27c82c1fe3a6c1a5b2e7139b55925b89,1,37,37,74,1,2012-08-06 14:51:31,2012-08-06 14:51:31
0456a42b27c82c1fe3a6c1a5b2e7139b55925b89...0ec6cb9781205108a35f687b928c78f61e2a46d6,1,25,1,26,3,2012-08-06 15:29:38,2012-08-06 15:29:38
0ec6cb9781205108a35f687b928c78f61e2a46d6...dddeb8a48880d941237388f313779893ae460a8b,69,69,69,138,69,2012-08-06 15:58:20,2012-08-03 17:08:54
dddeb8a48880d941237388f313779893ae460a8b...0d89bf4b199ababfa63b72ef848146769cee81b4,3,161,68,229,11,2012-08-06 16:03:20,2012-08-06 16:03:20
93f341a582b636e02439431a2df47003b4beac74...0ad42973ebe9b3b184e7c51fa753a4e45e2dbb55,2,2,2,4,2,2012-10-04 20:08:31,2012-10-04 20:08:31
0ad42973ebe9b3b184e7c51fa753a4e45e2dbb55...801da724ed205049f24f046e55c0dad935ca32df,1,2,2,4,1,2012-10-04 20:24:38,2012-10-04 14:19:24
801da724ed205049f24f046e55c0dad935ca32df...8ff934fbea3d470c5e499480abc6e962a1690a38,1,1,1,2,1,2012-10-04 20:24:38,2012-10-04 15:59:31
8ff934fbea3d470c5e499480abc6e962a1690a38...07a6fd4726a8e876266319cd8d22d64111cf8688,4,8,12,20,7,2012-10-04 20:24:38,2012-10-04 19:18:29
07a6fd4726a8e876266319cd8d22d64111cf8688...eae26e6044aae32b147fcdb511be034dc4163bc8,1,8,7,15,6,2012-10-04 20:52:48,2012-10-04 11:58:16
eae26e6044aae32b147fcdb511be034dc4163bc8...0d57a0eb93dc750e15e5c459d15aeb8f14296471,4,61,16,77,7,2012-10-04 21:42:05,2012-10-04 21:40:47
0d57a0eb93dc750e15e5c459d15aeb8f14296471...f059e5ff3ca997032d59f63bbc9cae109a73d92f,3,43,2,45,7,2012-10-04 22:04:36,2012-10-04 22:04:31
f059e5ff3ca997032d59f63bbc9cae109a73d92f...60305ad7a4512abc06b902f028fa9fc05ff0f5bd,1,10,25,35,4,2012-10-04 22:20:08,2012-10-04 20:12:18
60305ad7a4512abc06b902f028fa9fc05ff0f5bd...efbca4cd123faaa1c9b12d82612a95e525c1bd98,1,12,1,13,1,2012-10-04 22:56:54,2012-10-04 22:56:46
efbca4cd123faaa1c9b12d82612a95e525c1bd98...966a5473ad1eb7d847da5e2f8c81e0e2e1b3ce9d,1,21,3,24,3,2012-10-04 23:19:04,2012-10-04 23:19:04
966a5473ad1eb7d847da5e2f8c81e0e2e1b3ce9d...55ce76f9360e01216348e65ee5ffe4c748b9040d,5,632,103,735,85,2012-10-05 00:49:57,2012-10-05 00:49:57
9c963f8a637d84375970ef758e12f5732a47b2a1...97bf2c77486ca9a84c58e15c0c194e0db82d94c7,1,2,2,4,1,2012-10-03 22:04:39,2012-10-03 22:04:39
9c963f8a637d84375970ef758e12f5732a47b2a1...c551b8114d7f9ae97ae5d1985be375981365a053,2,4,1,5,2,2012-10-03 20:28:03,2012-10-03 20:28:03
c551b8114d7f9ae97ae5d1985be375981365a053...3b754792b2d5e3e6bc7b675ecd08e4c6ad83ecba,3,44,16,60,12,2012-10-04 14:06:33,2012-10-04 14:06:12
3b754792b2d5e3e6bc7b675ecd08e4c6ad83ecba...13535ff54d3db78de6fc06a137915f25506dd7bc,1,8,2,10,1,2012-10-04 15:33:57,2012-10-04 15:03:29
13535ff54d3db78de6fc06a137915f25506dd7bc...997b1c3718b378e4096fb708e054644690b38c4d,6,758,0,758,8,2012-10-04 16:04:53,2012-09-19 20:32:42
d28c919025766e7a61904fb39b6ebea6d65ba502...b9764b74b882d5994d00fafaf10eb7315c9dafab,1,2,2,4,2,2011-11-17 19:34:44,2011-11-17 19:34:44
b9764b74b882d5994d00fafaf10eb7315c9dafab...a62ab9a7f4ba767ff8dfd1c9ad8acbbc99ef9bb8,2,15,1,16,4,2011-11-17 19:40:09,2011-11-17 15:54:42
a62ab9a7f4ba767ff8dfd1c9ad8acbbc99ef9bb8...0afe00a0d57043c2f31594316a36ecea54601aca,1,27,1,28,2,2011-11-17 19:40:11,2011-11-17 19:07:37
0afe00a0d57043c2f31594316a36ecea54601aca...c4e6e5554d5892e39adcc2b58050675888329766,1,2,1,3,2,2011-11-17 19:40:12,2011-11-17 19:08:53
c4e6e5554d5892e39adcc2b58050675888329766...eab212db97c40828c98dbef03e64f06596bb3b47,10,53,42,95,28,2011-11-17 19:40:14,2011-11-17 19:39:51
eab212db97c40828c98dbef03e64f06596bb3b47...c49a08db09be051d4922350ade3cfd8c98c09a84,2,6,1,7,2,2011-11-18 00:51:05,2011-11-18 00:49:57
d28c919025766e7a61904fb39b6ebea6d65ba502...e79171be37ac7dde76da07b068a44c7955abff23,1,1,1,2,1,2011-11-17 17:28:37,2011-11-17 17:28:37
9e1a79dc4a2cc632d45e6af67f574c41aeff54ac...fcd2ff89bef5afd5b1bb36ae1c104be4399ab5a2,1,1,1,2,1,2012-08-19 13:59:01,2012-08-19 13:59:01
9e1a79dc4a2cc632d45e6af67f574c41aeff54ac...783aaff18cc7880a4bdbf9d0c52a5b56491b5933,1,31,0,31,2,2012-08-14 15:33:23,2012-08-14 15:33:23
783aaff18cc7880a4bdbf9d0c52a5b56491b5933...883ccc4ebcc56238b5dbee403e7856ac5ffe193e,1,3,1,4,1,2012-08-16 15:53:45,2012-08-16 15:53:45
883ccc4ebcc56238b5dbee403e7856ac5ffe193e...a30fbf1c35b266c608e50a48d68d4a7a147015e8,4,34,39,73,21,2012-08-16 20:53:04,2012-08-16 17:56:06
a30fbf1c35b266c608e50a48d68d4a7a147015e8...bd761d51930a8481a14664c98ae1219c858cdd02,4,39,34,73,21,2012-08-17 09:48:08,2012-08-17 09:48:08
bd761d51930a8481a14664c98ae1219c858cdd02...c50c2f57444f524feebf14cecbddd3ed5fe45287,1,11,7,18,8,2012-08-17 14:56:16,2012-08-17 14:42:21
c50c2f57444f524feebf14cecbddd3ed5fe45287...37bf8f163db4d04b5bb7c175f7705e3837b48751,1,6,4,10,1,2012-08-18 20:13:34,2012-08-18 20:13:34
37bf8f163db4d04b5bb7c175f7705e3837b48751...d388ca17b0413f7d8d7431e4673de7e6b6eaf444,1,1,1,2,1,2012-08-20 12:21:59,2012-08-20 12:21:59
d388ca17b0413f7d8d7431e4673de7e6b6eaf444...11420d16263d482419b45464b44d63c1ca7e1ee6,3,73,5,78,5,2012-08-20 18:15:10,2012-08-17 00:17:24
11420d16263d482419b45464b44d63c1ca7e1ee6...cab43568bdd66980bc1aefdbf538cc22c99e6af6,4,46,6,52,13,2012-08-20 20:44:00,2012-08-20 20:43:38
cab43568bdd66980bc1aefdbf538cc22c99e6af6...da6844241dacce4e14240ca67a64ee5c12b35d3c,2,370,4,374,4,2012-08-20 21:33:53,2012-08-18 22:07:07
da6844241dacce4e14240ca67a64ee5c12b35d3c...a781bbc6b3da118c0969c9cc0be9148719c1c67c,4,67,22,89,15,2012-08-20 21:33:53,2012-08-14 23:23:59
a781bbc6b3da118c0969c9cc0be9148719c1c67c...0ff6321172c93d6d4abd14054c0b3e8e0b317054,2,47,31,78,9,2012-08-20 23:46:47,2012-08-10 22:56:46
0ff6321172c93d6d4abd14054c0b3e8e0b317054...774853dbd649b346146ad5bacb7127b67679351f,6,107,27,134,25,2012-08-21 18:56:12,2012-08-21 02:01:39
774853dbd649b346146ad5bacb7127b67679351f...b3b22a00237291f03b1d8d1aa15d52c6799435e9,2,25,0,25,4,2012-08-21 21:06:18,2012-08-21 20:54:12
b3b22a00237291f03b1d8d1aa15d52c6799435e9...084125a26dfba0313a016e3c88b10f0b33c35737,1,1,0,1,1,2012-08-21 21:06:18,2012-08-21 20:57:28
084125a26dfba0313a016e3c88b10f0b33c35737...51609845fceb8d54114594a7df874a87a861281d,1,4,4,8,4,2012-08-21 21:06:18,2012-08-21 21:06:10
51609845fceb8d54114594a7df874a87a861281d...987f61202a6672867f96f87dffc560d19efef0de,1,9,0,9,3,2012-08-21 22:28:40,2012-08-21 22:28:40
987f61202a6672867f96f87dffc560d19efef0de...4cf1628f59deafd1c608aaf0a9930ca68430c8dd,1,3,4,7,3,2012-08-21 22:59:59,2012-08-21 22:50:29
4cf1628f59deafd1c608aaf0a9930ca68430c8dd...b1b0a1a6f9943fe938b367a90e790b32eb32386c,1,2,2,4,1,2012-08-22 16:35:51,2012-08-22 16:35:51
b1b0a1a6f9943fe938b367a90e790b32eb32386c...1bac89b6f3b79507cac2e3272f03789467286e29,1,38,0,38,1,2012-08-22 17:33:38,2012-08-21 23:54:24
1bac89b6f3b79507cac2e3272f03789467286e29...38b899385691c1473dfd3964d026b0bdf8f77685,4,9,7,16,7,2012-08-22 17:49:55,2012-08-22 17:39:55
38b899385691c1473dfd3964d026b0bdf8f77685...dfe1d7cfdf09c45fee223405bb93a70c4bc9dc6f,1,1,1,2,1,2012-08-22 18:39:14,2012-08-22 18:39:14
dfe1d7cfdf09c45fee223405bb93a70c4bc9dc6f...b69e1c687e7a21dde902dea12489d842d040ee68,1,1,3,4,1,2012-08-24 18:16:27,2012-08-02 20:27:38
b69e1c687e7a21dde902dea12489d842d040ee68...258fb29b0d22dd49afb8a294ec0d26088b2ad186,1,2,2,4,2,2012-08-24 18:16:27,2012-08-02 20:35:55
258fb29b0d22dd49afb8a294ec0d26088b2ad186...f98d3f6c2e5659d30be1b18965b6a77b942836d7,2,19,7,26,9,2012-08-24 18:16:27,2012-08-18 22:29:49
f98d3f6c2e5659d30be1b18965b6a77b942836d7...f42bcea13834c40b1f45cc625845c4f8eb00ec4c,1,6,4,10,4,2012-08-24 18:16:28,2012-08-18 22:31:28
f42bcea13834c40b1f45cc625845c4f8eb00ec4c...50e9f135b66aab432f71dd858d985eb205d0fe70,1,2032,78,2110,6,2012-08-24 18:19:22,2012-08-18 22:31:51
50e9f135b66aab432f71dd858d985eb205d0fe70...4db25546e7b599bc53c68f67ded87d1c218f14b0,2,436,1,437,7,2012-08-24 19:15:53,2012-08-20 18:20:53
4db25546e7b599bc53c68f67ded87d1c218f14b0...9e3c6bb745bd2729663dcb3e65a5d8d3b6d66ddc,4,471,0,471,5,2012-08-24 19:15:58,2012-08-20 18:21:27
9e3c6bb745bd2729663dcb3e65a5d8d3b6d66ddc...9b6f04532b2c69f1a2932ce16aac9f49d0af3891,1,1,1,2,1,2012-08-27 17:52:55,2012-08-27 17:52:55
9b6f04532b2c69f1a2932ce16aac9f49d0af3891...a18b9d4cddee21e5df2ea65c4e0d4215e61228fe,1,17,0,17,4,2012-08-27 18:55:53,2012-08-23 20:45:30
a18b9d4cddee21e5df2ea65c4e0d4215e61228fe...f876d2d71a7c238889c222164571a9e7170ec080,1,29,7,36,3,2012-08-27 20:35:01,2012-08-23 02:20:20
0d89bf4b199ababfa63b72ef848146769cee81b4...b2d61cd8a6e332cad3e8f1d5f0f906b42f5fc827,4,298,267,565,200,2012-08-06 18:03:15,2012-08-03 14:39:47
55ce76f9360e01216348e65ee5ffe4c748b9040d...87ff9e6b2388ebfee90225c0fc463de44efacccb,2,8,10,18,2,2012-10-05 14:26:45,2012-10-04 23:43:41
55ce76f9360e01216348e65ee5ffe4c748b9040d...d3f0627604f28d7f6bd35f57101a0274c65e37ec,3,38,4,42,5,2012-10-05 03:04:59,2012-10-05 03:04:59
4f531d6611d46048849a399f2b63c9b3c48a52e2...3b2818eaaf1de46aa9f69f18c3dd87c4144a5cb4,1,1,1,2,1,2012-10-09 13:53:04,2012-10-07 18:27:21
3b2818eaaf1de46aa9f69f18c3dd87c4144a5cb4...4baf84e48b3e413f4fb46af69b7e6a3f29f56cdd,14,318,73,391,35,2012-10-09 15:21:21,2012-10-08 20:54:20
4baf84e48b3e413f4fb46af69b7e6a3f29f56cdd...7418173c31f490ead15b556f95ee539299d87051,8,100,4,104,28,2012-10-09 16:59:01,2012-10-09 16:59:01
7418173c31f490ead15b556f95ee539299d87051...3642e685769b2de9d153816b6054c27f6fe044e2,3,20,2,22,4,2012-10-09 17:01:05,2012-10-09 14:20:08
3642e685769b2de9d153816b6054c27f6fe044e2...04d7dd8ecc3513493682f724e0572c3187bd4f1b,4,53,11,64,6,2012-10-09 17:12:38,2012-09-23 23:56:01
04d7dd8ecc3513493682f724e0572c3187bd4f1b...ed821b6060eacc995740c233ec30899b80a717b0,1,10,12,22,5,2012-10-09 18:12:27,2012-10-09 09:41:27
ed821b6060eacc995740c233ec30899b80a717b0...1535908982245cb565e71da6a92fc4e81ec25922,1,14,6,20,2,2012-10-09 19:33:11,2012-10-09 19:32:26
1535908982245cb565e71da6a92fc4e81ec25922...57b4f108ccf6d558832fe61f0d1704349429b7d3,4,143,2,145,5,2012-10-10 03:07:43,2012-10-09 04:56:24
57b4f108ccf6d558832fe61f0d1704349429b7d3...be1898fa0598cce3296d69cb5b760a47de8908bf,1,1,1,2,1,2012-10-10 03:12:06,2012-10-10 03:12:06
be1898fa0598cce3296d69cb5b760a47de8908bf...acf95c3565a776d98f59149f1205abe1693e0a64,1,3,2,5,3,2012-10-10 03:41:02,2012-10-10 03:41:02
acf95c3565a776d98f59149f1205abe1693e0a64...0b87f2184ccbde557c1d85dbe26a16e8ab1429b2,1,5,16,21,5,2012-10-10 05:06:27,2012-10-10 05:06:27
0b87f2184ccbde557c1d85dbe26a16e8ab1429b2...47042cdbcfbecc50d5a6ed6cd2a174383d008865,1,2,1,3,2,2012-10-10 14:48:14,2012-10-09 23:14:50
47042cdbcfbecc50d5a6ed6cd2a174383d008865...10f316045bb2ea2f02a023ed01b25ab31befa1d9,2,15,4,19,4,2012-10-10 15:34:19,2012-10-10 14:49:39
10f316045bb2ea2f02a023ed01b25ab31befa1d9...d4325f06d5301882c9ee3254d17a54b2301832b4,2,2,2,4,2,2012-10-10 15:34:19,2012-10-10 15:05:16
d4325f06d5301882c9ee3254d17a54b2301832b4...03e7e381365e903c1ac2ab28d74d8d3064e886b2,1,4,4,8,1,2012-10-10 15:34:19,2012-10-10 15:06:39
03e7e381365e903c1ac2ab28d74d8d3064e886b2...f0c77e484c0f574b66966f36c76ac40dc93b5742,2,7,5,12,6,2012-10-10 15:34:19,2012-10-10 15:34:01
f0c77e484c0f574b66966f36c76ac40dc93b5742...f1c121556b9c72127f0902314cd43a63fdf6c905,1,23,21,44,15,2012-10-10 16:51:10,2012-10-04 22:59:22
f1c121556b9c72127f0902314cd43a63fdf6c905...d267f9e5de521b60af1e42b80b3ed0d0571e3d96,1,11,26,37,4,2012-10-10 16:51:10,2012-10-08 17:54:23
d267f9e5de521b60af1e42b80b3ed0d0571e3d96...43b0528e1a098dfcdf3753e8fe61ef41af80fd8c,4,83,0,83,4,2012-10-10 17:13:24,2012-10-10 17:12:59
43b0528e1a098dfcdf3753e8fe61ef41af80fd8c...8c1fdaf093949215d44f6e737948c464f9f598ad,1,3,5,8,5,2012-10-10 17:13:24,2012-10-10 17:13:08
8c1fdaf093949215d44f6e737948c464f9f598ad...a73ff022bf8941d1ca6cf1d71ee6163aa17dcd52,5,10,15,25,5,2012-10-10 17:22:08,2012-10-08 21:47:37
a73ff022bf8941d1ca6cf1d71ee6163aa17dcd52...e1085e542dd4ed1cb7f304e6095c63562f16d65b,6,267,19,286,22,2012-10-10 18:22:24,2012-07-31 23:10:59
e1085e542dd4ed1cb7f304e6095c63562f16d65b...0235bac4b8469e26204e869d52a7fbdc51ae35a4,1,1,1,2,1,2012-10-10 18:22:25,2012-10-08 03:49:14
0235bac4b8469e26204e869d52a7fbdc51ae35a4...25985c2e2c3e4c02c4c24b9b401bb6d67930028f,6,0,25,25,9,2012-10-10 18:22:25,2012-10-09 16:38:18
25985c2e2c3e4c02c4c24b9b401bb6d67930028f...9689f83c44dc2af743a082de1048533ccb0b0c78,1,40,1,41,1,2012-10-10 18:31:15,2012-10-09 15:32:58
9689f83c44dc2af743a082de1048533ccb0b0c78...02cc945dc80ae7aab1741de989fc042dd3047761,1,1,1,2,1,2012-10-10 18:50:42,2012-10-10 18:46:15
02cc945dc80ae7aab1741de989fc042dd3047761...062b91bea8992f83c12278e742c22a701aabbd80,1,1,6,7,1,2012-10-10 19:50:46,2012-10-10 19:50:46
062b91bea8992f83c12278e742c22a701aabbd80...3028cda31d04098d95b70ece6186a883aaa8ff47,1,2,0,2,1,2012-10-10 19:57:46,2012-10-10 19:52:14
3028cda31d04098d95b70ece6186a883aaa8ff47...64f1ccf442fc0168b677a1daea262055e36c157c,1,12,6,18,2,2012-10-10 20:20:29,2012-10-10 15:33:02
64f1ccf442fc0168b677a1daea262055e36c157c...f0a5062ff9651f97ac58ef1f50f91b0a5f653798,10,383,275,658,40,2012-10-10 20:28:49,2012-10-08 18:18:02
f0a5062ff9651f97ac58ef1f50f91b0a5f653798...7922e03d36d059a6602541d83b6a26224e6178dd,26,394,293,687,48,2012-10-10 20:31:14,2012-10-09 17:24:41
7922e03d36d059a6602541d83b6a26224e6178dd...800eea522786a5a80cec62a6eafc382b3bc377bf,4,95,19,114,24,2012-10-10 20:31:15,2012-10-10 20:18:34
800eea522786a5a80cec62a6eafc382b3bc377bf...5d39bdfc11d3b9eb32a8a25a2d655a5f43b7ede7,16,890,3,893,18,2012-10-10 20:34:34,2012-10-09 22:45:30
5d39bdfc11d3b9eb32a8a25a2d655a5f43b7ede7...a50b5956fc17d1f6fdb49c1b2c718bd39ef1aaf8,1,3,2,5,1,2012-10-10 21:59:42,2012-10-10 21:59:42
a50b5956fc17d1f6fdb49c1b2c718bd39ef1aaf8...532a051330efa57bcf2f27ab597f0ab3130715a1,7,164,6,170,13,2012-10-10 22:14:40,2012-10-10 22:10:13
532a051330efa57bcf2f27ab597f0ab3130715a1...58f861ba2f9e9246dfe5c4901ad9d8c275bee600,2,5,0,5,3,2012-10-10 22:23:59,2012-10-10 21:34:10
58f861ba2f9e9246dfe5c4901ad9d8c275bee600...1695343dbf32c975900faba01dbe82c7eab5f2e2,1,1,1,2,1,2012-10-11 00:48:03,2012-10-11 00:48:03
c49a08db09be051d4922350ade3cfd8c98c09a84...05717037fb8cf7b8bf9f7e935d23e64f74a70311,2,9,2,11,3,2011-11-18 18:26:05,2011-11-18 18:26:05
c49a08db09be051d4922350ade3cfd8c98c09a84...8439d2c13751335cacd86b626d44c3d430856fb3,1,427,0,427,1,2011-11-18 15:39:41,2011-11-18 15:39:41
4268a50cde31501e82df741b9ca62ee8841d5fde...518cbf27778821ca9a5617b033fe110febe81f09,6,64,52,116,12,2012-11-27 17:25:48,2012-11-27 16:21:28
518cbf27778821ca9a5617b033fe110febe81f09...935d9dee342c637f117de1417a175e7d62fd06f7,2,157,104,261,28,2012-11-27 19:10:04,2012-11-26 21:13:24
935d9dee342c637f117de1417a175e7d62fd06f7...10ce647e4c9fd1632a11dccc45af634b7f5a86f6,12,29,17,46,15,2012-11-27 19:25:41,2012-11-27 00:05:25
10ce647e4c9fd1632a11dccc45af634b7f5a86f6...498d9102e00e61ca2d41b7db1448969728884b50,4,23,5,28,8,2012-11-27 19:26:34,2012-11-27 19:26:07
498d9102e00e61ca2d41b7db1448969728884b50...8d99bf66e1e432a33b392b95f0946077c11c8eef,2,5,3,8,4,2012-11-27 19:37:23,2012-11-26 23:45:38
8d99bf66e1e432a33b392b95f0946077c11c8eef...3120c1143bf96f6807047048a93bc2f572dc8576,2,56,30,86,4,2012-11-27 21:12:04,2012-11-20 20:20:29
3120c1143bf96f6807047048a93bc2f572dc8576...3c6d965490d91392533c4958d6b4e00c28afea34,14,184,199,383,23,2012-11-27 21:12:04,2012-11-20 20:45:35
3c6d965490d91392533c4958d6b4e00c28afea34...8d75e030e0e3de931e08996a2157491ed77fef9d,3,41,2,43,5,2012-11-27 22:17:08,2012-11-27 22:17:08
8d75e030e0e3de931e08996a2157491ed77fef9d...70c89035a57f2efffd240d93f938b46c001d610e,10,536,219,755,15,2012-11-27 22:17:42,2012-11-27 22:17:42
70c89035a57f2efffd240d93f938b46c001d610e...41a8fc30d20d08a65630ad41630988ba0b52c40d,2,32,10,42,3,2012-11-27 22:33:00,2012-11-27 22:33:00
41a8fc30d20d08a65630ad41630988ba0b52c40d...fa81ee399244f6f844f085870af13386ed09c680,2,32,0,32,2,2012-11-27 23:14:34,2012-11-27 23:14:34
fa81ee399244f6f844f085870af13386ed09c680...c210c079b47273e9219fe1d40e345580b7234b7f,1,1,0,1,1,2012-11-28 02:12:53,2012-11-28 02:12:53
c210c079b47273e9219fe1d40e345580b7234b7f...fbf73ce41acc6335870064d86f9603337834eae6,1,2,1,3,1,2012-11-28 02:59:12,2012-11-28 02:59:12
fbf73ce41acc6335870064d86f9603337834eae6...274e54c549aba74ddc3f746e0c89d8acedc2a8f0,8,64,0,64,20,2012-11-28 09:32:28,2012-11-28 09:31:41
274e54c549aba74ddc3f746e0c89d8acedc2a8f0...46b277b8aaaca0643585db1f68f9f79d5390e813,1,1,0,1,1,2012-11-28 10:51:25,2012-11-28 10:51:25
46b277b8aaaca0643585db1f68f9f79d5390e813...2557e9af57142f8334330c956bdcc8fb1cf481ab,1,1,1,2,1,2012-11-28 12:44:08,2012-11-28 10:22:34
2557e9af57142f8334330c956bdcc8fb1cf481ab...962cbe0180cfcfe6f49c0cc2c1f264fae844c90e,1,13,0,13,1,2012-11-28 15:20:02,2012-11-27 23:33:32
962cbe0180cfcfe6f49c0cc2c1f264fae844c90e...7c9cdae7537781ec6653e117e3adb262c4bb6abe,19,332,157,489,47,2012-11-28 22:20:11,2012-11-27 16:45:53
7c9cdae7537781ec6653e117e3adb262c4bb6abe...2d006f07c0355a68c8724fe8eef9c2ba38c3320a,1,4,1,5,1,2012-11-28 22:39:30,2012-11-27 22:54:56
2d006f07c0355a68c8724fe8eef9c2ba38c3320a...1aa1cd5d0b6e5d02d6aa0871a3fbc735e9e14ee5,2,15,12,27,3,2012-11-28 22:44:06,2012-11-27 16:51:07
1aa1cd5d0b6e5d02d6aa0871a3fbc735e9e14ee5...1ceca5e2c723996de6993ccbdecb3bb526269116,5,82,1,83,21,2012-11-28 23:40:43,2012-11-14 23:55:04
1ceca5e2c723996de6993ccbdecb3bb526269116...2c5becd95d63262f55fc1e789615d7636594c983,15,193,6,199,53,2012-11-28 23:47:17,2012-11-15 00:13:18
2c5becd95d63262f55fc1e789615d7636594c983...71fe3821d72371d7e047525b40ff6ac48fb14cf1,2,147,109,256,55,2012-11-28 23:57:13,2012-11-15 02:45:11
71fe3821d72371d7e047525b40ff6ac48fb14cf1...1c0474f0c088d3c16704331c445f0365fb8ab96c,1,3,3,6,3,2012-11-29 00:05:04,2012-11-28 21:50:48
1c0474f0c088d3c16704331c445f0365fb8ab96c...e4ee5568d96dc08115b88c1d91fbdc07fadd3bf0,1,6,6,12,2,2012-11-29 02:17:11,2012-11-29 02:12:54
e4ee5568d96dc08115b88c1d91fbdc07fadd3bf0...ef5bea9118a10459436945c6831505eb54ea774b,1,4,1,5,3,2012-11-29 05:14:54,2012-11-29 03:24:59
ef5bea9118a10459436945c6831505eb54ea774b...d8a3050eacf526e95ec28dcaf8a1cf3ae62de9d1,3,29,20,49,12,2012-11-29 05:14:54,2012-11-29 05:14:34
d8a3050eacf526e95ec28dcaf8a1cf3ae62de9d1...eb3cf24e3ed24169c45cfa8dcf0e49ead12eeb49,10,1209,12,1221,16,2012-11-29 05:52:04,2012-11-26 20:15:08
eb3cf24e3ed24169c45cfa8dcf0e49ead12eeb49...5352721ef242ae2f2531dbfb10b868444129fe80,1,5,7,12,3,2012-11-29 06:04:38,2012-11-29 06:04:38
5352721ef242ae2f2531dbfb10b868444129fe80...4d99f149a9f827920c495e9936fec5792bd59cab,8,124,16,140,36,2012-11-29 10:03:42,2012-11-29 10:03:42
4d99f149a9f827920c495e9936fec5792bd59cab...8c4d33f505fb0a3374583894a3dccc10a754eb36,1,1,1,2,1,2012-11-29 10:10:19,2012-11-29 10:10:19
8c4d33f505fb0a3374583894a3dccc10a754eb36...9c6912e0a70e2ff95bc2a30c4e07dae56205521b,1,1,1,2,1,2012-11-29 10:17:59,2012-11-29 10:17:59
9c6912e0a70e2ff95bc2a30c4e07dae56205521b...f14a9e79cf5f9b09dec4758d2d2032ddf47373a3,2,11,2,13,3,2012-11-29 15:55:03,2012-11-29 03:45:13
f14a9e79cf5f9b09dec4758d2d2032ddf47373a3...a54fd9e2707aa441a449a5cfe41c230ebc8ff80a,2,86,9,95,6,2012-11-29 18:30:39,2012-11-29 18:30:23
a54fd9e2707aa441a449a5cfe41c230ebc8ff80a...8e7cbf47244f1fa83624ca67c4aada66da783198,2,12,10,22,3,2012-11-29 18:56:29,2012-11-29 18:56:25
8e7cbf47244f1fa83624ca67c4aada66da783198...7c3744cdeff14a8073e27a8127a3d5154326fd63,2,11,1,12,2,2012-11-29 18:57:22,2012-11-29 16:26:12
7c3744cdeff14a8073e27a8127a3d5154326fd63...9947386a0c734cbf775384946a45e362f80ca477,1,3,3,6,2,2012-11-29 19:31:06,2012-11-29 19:31:06
9947386a0c734cbf775384946a45e362f80ca477...fe5517ad974a53852897fa5ad4ba54fdd8a618e6,6,69,122,191,16,2012-11-29 19:48:57,2012-11-29 02:45:42
fe5517ad974a53852897fa5ad4ba54fdd8a618e6...e013f359da0fe8573f2b33f007fc5bdb2529d458,5,113,10,123,7,2012-11-29 20:45:59,2012-11-15 01:56:23
e013f359da0fe8573f2b33f007fc5bdb2529d458...965ad9961052a7dab133ca86e65c0aa210b3a71e,4,98,61,159,4,2012-11-29 21:55:59,2012-11-15 03:17:22
965ad9961052a7dab133ca86e65c0aa210b3a71e...9c153e6ab96ed783f9b185fa34e0e6595baf3478,2,58,4,62,5,2012-11-29 21:58:34,2012-11-28 23:27:05
9c153e6ab96ed783f9b185fa34e0e6595baf3478...871b266fe1f35e06cc6d3bdbadbc64db52591351,4,46,0,46,8,2012-11-29 22:14:21,2012-11-15 03:49:14
871b266fe1f35e06cc6d3bdbadbc64db52591351...b8bdc320d5bf4ad9ad24eacbb310bddc1e3133ad,8,77,42,119,21,2012-11-29 23:16:27,2012-11-26 23:22:02
b8bdc320d5bf4ad9ad24eacbb310bddc1e3133ad...40577e84f4fc3e9b2ec7e6db3448ff5cedaa9c6c,5,16,6,22,13,2012-11-29 23:16:27,2012-11-29 22:05:23
40577e84f4fc3e9b2ec7e6db3448ff5cedaa9c6c...0c26b1d4b3bf6eaa20b9accf4195b5d208f48faf,1,1,0,1,1,2012-11-30 01:03:03,2012-11-30 01:03:03
0c26b1d4b3bf6eaa20b9accf4195b5d208f48faf...e76eda3915e2da398477c81801a6b16bac88dd1b,6,36,0,36,12,2012-11-30 10:13:46,2012-11-30 10:13:46
e76eda3915e2da398477c81801a6b16bac88dd1b...7e0732e4dbdd9bc2b16dfca704b39987f47a1f5d,6,8,8,16,8,2012-11-30 16:33:14,2012-11-30 16:32:24
7e0732e4dbdd9bc2b16dfca704b39987f47a1f5d...fd97dd29da89ceccff74999c749493c920c867af,1,23,10,33,7,2012-11-30 17:59:32,2012-11-30 17:58:03
fd97dd29da89ceccff74999c749493c920c867af...aa0b4e7e82016fb95dd8cc58f1b3c8997df49aff,1,0,11,11,1,2012-11-30 18:00:50,2012-11-30 17:47:28
aa0b4e7e82016fb95dd8cc58f1b3c8997df49aff...95fffadc1c33333c53313f9da2b7a952aeb9f044,6,203,6,209,12,2012-11-30 18:38:31,2012-11-30 18:36:32
95fffadc1c33333c53313f9da2b7a952aeb9f044...0413def714cd2471eb25c30e8f7b62728d26207b,3,31,8,39,11,2012-11-30 18:49:05,2012-11-29 23:35:12
0413def714cd2471eb25c30e8f7b62728d26207b...bcc17bed5e07053f6d5f946c840fc25bc9bafb2b,14,60,116,176,40,2012-11-30 22:19:33,2012-11-30 02:38:53
bcc17bed5e07053f6d5f946c840fc25bc9bafb2b...131696f5b9b81d1657034e100a4d7c82efe02731,1,4,1,5,1,2012-12-01 22:10:59,2012-12-01 22:10:59
131696f5b9b81d1657034e100a4d7c82efe02731...4ec0073f3c847c6129b53ea8d2e27dd7f78d4bdd,3,16,2,18,3,2012-12-01 22:14:34,2012-12-01 22:14:34
4ec0073f3c847c6129b53ea8d2e27dd7f78d4bdd...336d7bfdbfb6f3a1c1fb01ff1f5afc24ab27232c,1,1,0,1,1,2012-12-02 07:51:07,2012-12-02 07:51:07
336d7bfdbfb6f3a1c1fb01ff1f5afc24ab27232c...b8ed302c0c54632cbd40a4fac1a3c8810c94d99e,3,15,12,27,6,2012-12-02 07:51:23,2012-12-02 07:51:23
b8ed302c0c54632cbd40a4fac1a3c8810c94d99e...dd2ff17b5270a35e2b1511177e768e8185310a0c,2,104,0,104,5,2012-12-02 11:53:39,2012-12-02 11:52:41
dd2ff17b5270a35e2b1511177e768e8185310a0c...470d82e7bf89fb9b8bd8f369999a0d5dace122e1,3,91,30,121,19,2012-12-02 15:29:56,2012-12-01 13:45:11
470d82e7bf89fb9b8bd8f369999a0d5dace122e1...f62ce0c86e0a94de1827e96dc459aa9289429021,5,16,9,25,11,2012-12-03 10:00:25,2012-12-03 10:00:25
f62ce0c86e0a94de1827e96dc459aa9289429021...75c3b6423d697be41fd3d295d19cd10245bd653e,3,25,10,35,11,2012-12-03 14:24:14,2012-11-15 22:08:50
75c3b6423d697be41fd3d295d19cd10245bd653e...7751dc3576c8ef06df9b14bf38f410aab4e0c8a5,5,237,2,239,5,2012-12-03 14:24:14,2012-11-28 21:54:09
7751dc3576c8ef06df9b14bf38f410aab4e0c8a5...2cd8f40d181f04ae67662b9c9881721da200b99a,2,116,0,116,3,2012-12-03 14:24:14,2012-11-29 15:44:54
2cd8f40d181f04ae67662b9c9881721da200b99a...c206be850c4560a8657d0d2ac3e713a38603dcbc,7,0,165,165,19,2012-12-03 14:24:14,2012-11-29 15:59:18
c206be850c4560a8657d0d2ac3e713a38603dcbc...23b47c681a960e06145aad961c3dfc2ac449c38b,4,92,178,270,23,2012-12-03 14:24:14,2012-11-29 18:09:42
23b47c681a960e06145aad961c3dfc2ac449c38b...87af7a1cc5300fa6fab2eaa71e2c8d8b181c69d2,3,3,5,8,5,2012-12-03 14:24:14,2012-11-29 18:13:57
87af7a1cc5300fa6fab2eaa71e2c8d8b181c69d2...88650825c651c2a9e358f1b59b1ee7aa2aa4cd8e,6,33,389,422,23,2012-12-03 14:24:14,2012-11-29 19:53:03
88650825c651c2a9e358f1b59b1ee7aa2aa4cd8e...8f531c5b0af1e386ab142dba3349c895ab8d9b76,3,31,1,32,4,2012-12-03 16:18:48,2012-11-29 20:42:24
8f531c5b0af1e386ab142dba3349c895ab8d9b76...871ac217fd6f3a751c9fc92d136bb1e3fa173397,6,98,105,203,40,2012-12-03 16:18:48,2012-11-29 20:45:24
871ac217fd6f3a751c9fc92d136bb1e3fa173397...09bd23a4975e4df8c036f890a8f6f09429a4cb37,1,3,4,7,1,2012-12-03 16:18:48,2012-11-29 21:26:00
09bd23a4975e4df8c036f890a8f6f09429a4cb37...10b5e2e35d08780fd304f0c70b5cbed0f2900f3f,1,3,3,6,3,2012-12-03 16:18:49,2012-11-29 22:29:27
10b5e2e35d08780fd304f0c70b5cbed0f2900f3f...e6355f2f48158091146428c2254c0bd3130966eb,2,2,2,4,2,2012-12-03 16:47:08,2012-12-03 16:47:08
e6355f2f48158091146428c2254c0bd3130966eb...9ea79c8a8ebead419fb2a7dcde88a861fb8e5564,1,1,1,2,1,2012-12-03 20:54:21,2012-12-03 20:54:21
9ea79c8a8ebead419fb2a7dcde88a861fb8e5564...420779efd584347fceaf4cc074d7614bf6581654,1,11,5,16,3,2012-12-03 21:11:59,2012-12-03 21:11:48
420779efd584347fceaf4cc074d7614bf6581654...94fe9334b1d09383d583ab5e56c05a1fb3754753,7,687,0,687,8,2012-12-03 22:01:19,2012-11-26 19:09:25
94fe9334b1d09383d583ab5e56c05a1fb3754753...b8185fc4eac2726d0e850698ac100b9686f8755f,1,4,1,5,2,2012-12-03 22:01:19,2012-11-26 19:09:49
b8185fc4eac2726d0e850698ac100b9686f8755f...d26f22eb2e4280f3dc5713ab99da810208c783da,1,3,0,3,1,2012-12-03 22:01:19,2012-11-26 19:14:51
d26f22eb2e4280f3dc5713ab99da810208c783da...64408b78c89a65a4a727b57d552b64bf5f7eb803,16,614,172,786,98,2012-12-03 22:01:20,2012-11-26 19:14:35
64408b78c89a65a4a727b57d552b64bf5f7eb803...ceddaa1ac65b1c06e62a217f4a78086e0a354f23,3,82,9,91,11,2012-12-03 22:01:20,2012-11-30 21:32:43
ceddaa1ac65b1c06e62a217f4a78086e0a354f23...e857f6608ceafa5dbb4b863ca78193de47694402,3,27,0,27,7,2012-12-03 22:01:20,2012-11-26 19:11:46
e857f6608ceafa5dbb4b863ca78193de47694402...d2df0645428251b2d107b8ebe2f6f37b203ec057,7,84,40,124,37,2012-12-03 22:01:20,2012-12-03 20:50:15
d2df0645428251b2d107b8ebe2f6f37b203ec057...603b9c6795e4cc0db9ff8f344cb9bf1100ff8b1d,1,4,11,15,1,2012-12-03 22:01:21,2012-12-03 21:38:28
603b9c6795e4cc0db9ff8f344cb9bf1100ff8b1d...90edc45f9b5d09f0aa644f0a38d7437323361ec9,5,12,29,41,9,2012-12-03 22:57:29,2012-12-01 02:59:51
90edc45f9b5d09f0aa644f0a38d7437323361ec9...7e30f32bcd7ad29b0497200d289ff58569023b60,2,6,3,9,3,2012-12-03 23:09:40,2012-12-03 23:09:40
7e30f32bcd7ad29b0497200d289ff58569023b60...b889a149319732118caa43842d4e472664e6662f,1,4,7,11,5,2012-12-03 23:27:34,2012-12-01 00:32:28
b889a149319732118caa43842d4e472664e6662f...3adf40dd3755f71f27caf3f18cbcee0af91ef162,6,48,0,48,6,2012-12-03 23:37:13,2012-11-30 22:27:04
3adf40dd3755f71f27caf3f18cbcee0af91ef162...bb5b5c85d7577379bc26a21389e6e0b42a183c4b,5,23,0,23,7,2012-12-03 23:48:40,2012-12-01 03:26:16
bb5b5c85d7577379bc26a21389e6e0b42a183c4b...a556961367ac85c1ce64dbc8f11399db2e873b61,1,3,8,11,2,2012-12-04 00:33:28,2012-12-04 00:32:59
a556961367ac85c1ce64dbc8f11399db2e873b61...ddddf3b6a4bb3ff70fe12dd83e3ab0f43ffdd318,1,2,1,3,1,2012-12-04 05:17:39,2012-12-04 05:17:26
ddddf3b6a4bb3ff70fe12dd83e3ab0f43ffdd318...e4de169d6ac4e34a5e30d6d70db7d32a55555467,7,141,49,190,26,2012-12-04 15:57:49,2012-12-03 19:40:49
e4de169d6ac4e34a5e30d6d70db7d32a55555467...f18b7e4f93bef55ba4be85e1d3211451ed85d895,1,0,5,5,1,2012-12-04 15:57:49,2012-12-04 15:41:17
f18b7e4f93bef55ba4be85e1d3211451ed85d895...3455518ea4f41391c6a38b469dbe736686e13fce,1,1,1,2,1,2012-12-04 16:00:53,2012-12-04 16:00:53
3455518ea4f41391c6a38b469dbe736686e13fce...c65e23885c8a024f5f01baaeac79b92b5b87ba95,1,1,1,2,1,2012-12-04 18:11:24,2012-12-04 18:11:24
c65e23885c8a024f5f01baaeac79b92b5b87ba95...27d7883db067d396cbe35ac93cad109b526630d8,5,271,41,312,28,2012-12-04 18:28:32,2012-12-04 15:13:54
27d7883db067d396cbe35ac93cad109b526630d8...c67d1ff115d0e147c73cee8c0fbcbd0e9c878d32,2,51,36,87,19,2012-12-04 18:28:33,2012-12-04 17:20:44
c67d1ff115d0e147c73cee8c0fbcbd0e9c878d32...62cf5ad3e3b2e2c52f55f9b06e4d094047307923,1,3,3,6,3,2012-12-04 19:59:39,2012-12-04 19:59:39
62cf5ad3e3b2e2c52f55f9b06e4d094047307923...ed810cab19d462ae99c07c40ee976fd680435245,1,8,1,9,3,2012-12-04 21:46:51,2012-12-04 21:46:51
ed810cab19d462ae99c07c40ee976fd680435245...0753b2b2a5ed8e70763d50e6945aea72f0e9f372,4,118,0,118,5,2012-12-04 23:29:00,2012-12-04 20:15:40
0753b2b2a5ed8e70763d50e6945aea72f0e9f372...55bb0f445ee535fd3091b6f0436f4e0ed5c9a19b,2,18,0,18,4,2012-12-04 23:32:30,2012-12-04 18:14:05
55bb0f445ee535fd3091b6f0436f4e0ed5c9a19b...0bdbde18449b907068a96bd02b4268febf78f6b1,11,263,103,366,50,2012-12-05 02:28:25,2012-12-04 19:42:39
0bdbde18449b907068a96bd02b4268febf78f6b1...33d7543c12a21f6496081ca9fa6c3676190aa991,10,227,13,240,28,2012-12-05 14:55:33,2012-12-03 18:18:14
33d7543c12a21f6496081ca9fa6c3676190aa991...f75d3a2e104bd2f99be2f0cb585c26dea6f563d3,19,488,187,675,79,2012-12-05 15:16:07,2012-09-10 19:30:01
f75d3a2e104bd2f99be2f0cb585c26dea6f563d3...3df33025c72c9b1aa7f0cb2a363760e0d924b9a0,2,17,5,22,9,2012-12-05 15:16:16,2012-12-04 19:45:21
3df33025c72c9b1aa7f0cb2a363760e0d924b9a0...6c4280c84d4efcef88945c98c3f5d0bc1eef3b38,1,1,1,2,1,2012-12-05 15:31:47,2012-12-05 15:31:47
6c4280c84d4efcef88945c98c3f5d0bc1eef3b38...c2afb4fa22cd6052f843ca4469e53027a36020cd,2,36,22,58,8,2012-12-05 16:12:04,2012-12-04 20:15:15
c2afb4fa22cd6052f843ca4469e53027a36020cd...3df3cf0feb9d7f2482be11cfd805f9647e1a6f44,4,34,17,51,8,2012-12-05 16:12:04,2012-11-30 16:37:59
3df3cf0feb9d7f2482be11cfd805f9647e1a6f44...bd8d8e4623c1311fd47b9d2edb90c5b895f2d5cf,4,24,0,24,8,2012-12-05 16:48:03,2012-12-05 16:41:29
bd8d8e4623c1311fd47b9d2edb90c5b895f2d5cf...0963cf638eccf52d1aa14d045fc4c80a4433429c,5,398,0,398,5,2012-12-05 17:08:48,2012-12-05 17:08:48
0963cf638eccf52d1aa14d045fc4c80a4433429c...df08bd861053509f84c4c5fcb42ccd7c5fca25bb,3,18,12,30,12,2012-12-05 18:28:37,2012-12-05 17:13:58
df08bd861053509f84c4c5fcb42ccd7c5fca25bb...7c50653c5548c816ad890dc00859e83c65f8aabc,3,107,7,114,11,2012-12-05 18:37:18,2012-12-04 18:33:24
7c50653c5548c816ad890dc00859e83c65f8aabc...09cf6c4236c39da5a575c510e3bb99dcc34b9a4f,2,8,4,12,4,2012-12-05 18:37:18,2012-12-05 16:54:24
09cf6c4236c39da5a575c510e3bb99dcc34b9a4f...210d24b7a5f16360ccee7a9c1956c27d0a771b3e,2,25,31,56,15,2012-12-05 19:18:48,2012-12-05 19:14:51
210d24b7a5f16360ccee7a9c1956c27d0a771b3e...9b470ab7236c382f91bcb0ef8b547741bb08fcfa,2,6,2,8,3,2012-12-05 19:27:35,2012-12-05 19:23:16
9b470ab7236c382f91bcb0ef8b547741bb08fcfa...3e68f5ecca20d1f65b8f1edf19dce51f3b71dc09,1,2,1,3,1,2012-12-05 19:27:35,2012-12-05 19:27:30
3e68f5ecca20d1f65b8f1edf19dce51f3b71dc09...6de192ae71818320c28f58d2ad430a4cf76e24f7,1,1,1,2,1,2012-12-05 20:47:25,2012-12-05 19:19:47
6de192ae71818320c28f58d2ad430a4cf76e24f7...1e7a83f9f97e4ee92c65ec9d9758c479b56b89cf,2,18,3,21,7,2012-12-05 21:14:28,2012-12-05 00:16:12
1e7a83f9f97e4ee92c65ec9d9758c479b56b89cf...c24aa0214b18d875236ff8f31e7bfe54fb537f61,4,198,68,266,10,2012-12-05 22:05:37,2012-12-04 22:40:02
c24aa0214b18d875236ff8f31e7bfe54fb537f61...f0cde92eef642c6ca723399bf3d81ebee0897325,1,2,0,2,1,2012-12-05 22:27:43,2012-12-05 22:27:19
f0cde92eef642c6ca723399bf3d81ebee0897325...7fbd3339d01880709000e533a26fdbd93c51fee9,1,2,2,4,2,2012-12-05 22:29:04,2012-12-05 22:27:37
7fbd3339d01880709000e533a26fdbd93c51fee9...370a013b1dc76f21e77cd3094372bf38dae963f7,2,21,0,21,3,2012-12-05 22:31:45,2012-12-05 00:03:30
370a013b1dc76f21e77cd3094372bf38dae963f7...ef198e0c58f709760c01fb0d44e01de9e67e788c,1,81,6,87,15,2012-12-05 22:35:28,2012-12-04 23:52:23
ef198e0c58f709760c01fb0d44e01de9e67e788c...50f923938ab2058f4d1a34c72b05abb86ae4122c,1,1,2,3,1,2012-12-05 23:07:52,2012-12-05 22:47:29
50f923938ab2058f4d1a34c72b05abb86ae4122c...fe0d238b0ac31f4b2294bda827cc913d59d6de57,7,113,35,148,34,2012-12-05 23:14:04,2012-12-04 23:11:25
fe0d238b0ac31f4b2294bda827cc913d59d6de57...69e9d0414dcf5ad706fccb2022441b25471bad48,13,142,77,219,54,2012-12-05 23:41:05,2012-12-04 01:52:52
69e9d0414dcf5ad706fccb2022441b25471bad48...82d5d620f975469103d4596a1fc9e40ef26cd4fd,1,1,2,3,1,2012-12-06 01:11:38,2012-12-06 01:11:33
82d5d620f975469103d4596a1fc9e40ef26cd4fd...ce53447ced1d3c7ad26274dad8099f2bb199c2b0,2,28,3,31,3,2012-12-06 15:16:13,2012-12-05 20:40:32
ce53447ced1d3c7ad26274dad8099f2bb199c2b0...a781f5a0f6ae1ee24cd83b210c779e400bfaac96,2,0,341,341,2,2012-12-06 15:43:59,2012-12-06 15:43:28
a781f5a0f6ae1ee24cd83b210c779e400bfaac96...9b220b9dfe038f8359d49bffa0854c67e596e024,1,5,6,11,2,2012-12-06 16:17:11,2012-12-06 16:17:11
9b220b9dfe038f8359d49bffa0854c67e596e024...8a01771e20998a90e52aba7b0a52759d36b5f4f1,11,495,190,685,113,2012-12-06 17:40:49,2012-12-05 19:38:09
8a01771e20998a90e52aba7b0a52759d36b5f4f1...ce6b527c4c8cdbbc48effab3694e8d2da0bd9561,1,22,52,74,22,2012-12-06 17:55:24,2012-12-06 17:55:24
ce6b527c4c8cdbbc48effab3694e8d2da0bd9561...e34817a9b1505e5c8cb0d01881124fda0fcc1f1c,1,5,5,10,5,2012-12-06 18:44:19,2012-12-06 18:44:19
e34817a9b1505e5c8cb0d01881124fda0fcc1f1c...b22177be9391b810518c3f0ca58ae4db92329d9b,1,3,0,3,2,2012-12-06 20:10:03,2012-12-06 19:47:29
b22177be9391b810518c3f0ca58ae4db92329d9b...0ed90ac0464147051864d722fc7b7833bbe383b3,2,18,7,25,8,2012-12-06 20:28:18,2012-12-06 20:28:18
0ed90ac0464147051864d722fc7b7833bbe383b3...5e5afe90d148fb93d4c0b05470681d57de5bc3e9,14,332,180,512,89,2012-12-06 22:38:10,2012-12-06 22:38:10
5e5afe90d148fb93d4c0b05470681d57de5bc3e9...81f940e7d8b5429264136f77ee80ed4d3c8948fd,1,6,3,9,1,2012-12-07 06:46:22,2012-12-07 06:46:22
81f940e7d8b5429264136f77ee80ed4d3c8948fd...4b1997c098343fc67f1991dfb2d15b2667a54367,5,6,8,14,7,2012-12-07 08:38:59,2012-12-07 08:38:59
4b1997c098343fc67f1991dfb2d15b2667a54367...f901c05c8b61de6346459db8fc9d9e47a48a7bed,1,9,4,13,3,2012-12-07 09:29:43,2012-12-07 09:29:43
f901c05c8b61de6346459db8fc9d9e47a48a7bed...6ac460add1747bbbd9c9aef1c0216bc365d04292,3,34,3,37,6,2012-12-07 15:05:15,2012-11-30 18:25:04
6ac460add1747bbbd9c9aef1c0216bc365d04292...9fe63411b92a2469d364f4678f04830fdc9e4a38,3,218,111,329,25,2012-12-07 15:05:56,2012-12-06 22:05:08
9fe63411b92a2469d364f4678f04830fdc9e4a38...90440532fca3ce59383ad7e36437191f4819b3fc,5,162,93,255,9,2012-12-07 16:21:01,2012-12-07 13:03:45
90440532fca3ce59383ad7e36437191f4819b3fc...faf643fbbc9cf187c6b76d13ecd395d1eec04161,20,348,47,395,76,2012-12-07 16:38:54,2012-11-27 20:44:13
faf643fbbc9cf187c6b76d13ecd395d1eec04161...ce21fd9e58893d9a2d8b036aed6b5b14ad44f93d,1,2,2,4,1,2012-12-07 16:45:30,2012-12-07 16:45:30
ce21fd9e58893d9a2d8b036aed6b5b14ad44f93d...6da1877e296585e7c435fd6324cafbacf12f7866,2,17,14,31,6,2012-12-07 16:48:02,2012-12-06 01:28:56
6da1877e296585e7c435fd6324cafbacf12f7866...7fee7c0eaa3680efea0ae691f5025c96ade0eae6,5,77,6,83,11,2012-12-07 16:50:13,2012-12-06 00:26:14
7fee7c0eaa3680efea0ae691f5025c96ade0eae6...783caeef0bc4ebaedee47016a4fd7a43a657f350,9,290,102,392,35,2012-12-07 17:49:09,2012-12-07 16:52:31
783caeef0bc4ebaedee47016a4fd7a43a657f350...370c220f4ca2f4ced612b665fbeb4795b8421b84,1,0,1,1,1,2012-12-07 17:49:37,2012-12-07 17:49:37
370c220f4ca2f4ced612b665fbeb4795b8421b84...56bff902c400a9da1bc7557faa5f396ed02bfa54,1,2,1,3,2,2012-12-07 17:55:56,2012-12-07 17:55:56
f876d2d71a7c238889c222164571a9e7170ec080...532bc1ab1a34ec4d52177c1162d8467f956189cf,1,29,29,58,11,2012-09-22 16:53:19,2012-09-22 16:53:19
f876d2d71a7c238889c222164571a9e7170ec080...09e807b669a8e487596e014afbdeb7fd5cd2aab6,1,14,15,29,1,2012-08-30 01:29:30,2012-08-30 01:29:24
09e807b669a8e487596e014afbdeb7fd5cd2aab6...4eb7f6c764c4dde05211fdfa33027d14038338ff,1,3,1,4,3,2012-08-30 13:11:10,2012-08-23 14:42:21
4eb7f6c764c4dde05211fdfa33027d14038338ff...67ddf38a2b3ca17b1b84becf323d38173c97e393,1,1,1,2,1,2012-08-30 13:37:52,2012-08-30 13:37:52
dc89f587c0e4dbfacde71ad2f1e25ac5f8bf9509...8cf562cc844a83849ca6d91f2680761c8f70d739,3,13,7,20,3,2012-08-06 18:49:49,2012-08-03 18:55:20
8cf562cc844a83849ca6d91f2680761c8f70d739...02a1bd5afdd4baf1029b27c32d3a73c0c8023814,1,13,1,14,2,2012-08-06 19:12:27,2012-08-06 16:46:25
02a1bd5afdd4baf1029b27c32d3a73c0c8023814...6cc98c3fcc9ce25bfaa33512f3c8a55095acbd5a,4,31,9,40,9,2012-08-06 19:12:27,2012-08-06 16:54:15
6cc98c3fcc9ce25bfaa33512f3c8a55095acbd5a...d5ce80c885db9b91b25d9a1a8b93e68218a07444,3,61,3,64,20,2012-08-06 19:12:27,2012-08-06 16:56:17
d5ce80c885db9b91b25d9a1a8b93e68218a07444...7eaba0fa4a1dd0dfd4594223efc5525003ce2d6e,2,132,0,132,2,2012-08-06 19:12:27,2012-08-06 16:58:27
7eaba0fa4a1dd0dfd4594223efc5525003ce2d6e...0973b994075fb7374665b210227e328fb815b2f2,2,32,6,38,6,2012-08-06 19:12:27,2012-08-06 16:59:28
0973b994075fb7374665b210227e328fb815b2f2...61b1e6cbad741a72b78f54f6330cb05895b95d7b,1,10,2,12,2,2012-08-06 19:12:27,2012-08-06 17:15:08
61b1e6cbad741a72b78f54f6330cb05895b95d7b...e4887227c71885769f141c5d47161c1604c9e97e,1,10,12,22,1,2012-08-06 20:50:31,2012-08-06 19:16:37
e4887227c71885769f141c5d47161c1604c9e97e...d4e7fba488bc86f7f3c98523589fc09d7c88b65f,1,1,0,1,1,2012-08-06 21:29:22,2012-08-06 21:29:18
d4e7fba488bc86f7f3c98523589fc09d7c88b65f...d3c5e9d22cd50dcca6c39d6953f590d18fd5ef7f,1,2,0,2,2,2012-08-07 01:00:02,2012-08-07 01:00:02
d3c5e9d22cd50dcca6c39d6953f590d18fd5ef7f...71338264726c7e0815e8799197ecf68af2aff939,1,6,1,7,1,2012-08-07 13:27:04,2012-08-07 13:27:04
71338264726c7e0815e8799197ecf68af2aff939...439d47d34addf072a9d50444c2a4fc92d41badc9,3,112,8,120,7,2012-08-07 17:17:12,2012-08-07 17:17:12
439d47d34addf072a9d50444c2a4fc92d41badc9...517dfc979a509adfbabd4e5fa21b3e101ebcb3fa,2,5,0,5,2,2012-08-07 17:34:18,2012-08-07 15:47:56
517dfc979a509adfbabd4e5fa21b3e101ebcb3fa...aec02b62d192a56b647e6f28afbe5bfdec9b2e92,1,2,2,4,1,2012-08-07 17:43:20,2012-08-07 15:36:21
aec02b62d192a56b647e6f28afbe5bfdec9b2e92...32475f5ad8cd7ab629d7d579eb9354891815e8cd,1,16,3,19,3,2012-08-07 18:37:50,2012-08-07 17:22:43
32475f5ad8cd7ab629d7d579eb9354891815e8cd...cc4450dcbdf03b580a4c92cc1f0e5b57e27ebb73,1,6,0,6,2,2012-08-07 18:56:25,2012-08-07 18:56:25
cc4450dcbdf03b580a4c92cc1f0e5b57e27ebb73...b6bfcd495a785b1f9e016a54f748e8167b2702d1,1,1,1,2,1,2012-08-07 20:15:47,2012-08-07 20:15:47
b6bfcd495a785b1f9e016a54f748e8167b2702d1...3eec537d7e9534065a3fce91382da32b2769d204,4,20,16,36,16,2012-08-08 02:40:10,2012-08-07 21:55:34
3eec537d7e9534065a3fce91382da32b2769d204...25e2b7e057b90a5501e78f22105c8658e4479e74,1,3,2,5,1,2012-08-08 13:18:09,2012-08-03 16:38:30
87ff9e6b2388ebfee90225c0fc463de44efacccb...c0bc1fd44cba82ff18bff90d29e5edfc69debb6a,1,17,12,29,1,2012-10-05 16:20:14,2012-10-05 13:43:21
c0bc1fd44cba82ff18bff90d29e5edfc69debb6a...12c9729212df16946bcc152b459bd9253d16bde3,1,7,0,7,2,2012-10-05 16:20:14,2012-10-05 15:54:29
87ff9e6b2388ebfee90225c0fc463de44efacccb...c76bf63c4d2df5879bb79cc1b6f80f4d1000e8a7,1,2,2,4,2,2012-10-05 16:10:22,2012-10-05 16:10:22
d3f0627604f28d7f6bd35f57101a0274c65e37ec...5c18832af5f97b52826098d6f71f29531a50f614,2,51,5,56,4,2012-10-15 03:04:34,2012-10-05 03:39:23
1695343dbf32c975900faba01dbe82c7eab5f2e2...31d8300e6d9251756c52f8c43da19f9dd3f0496c,1,2,1,3,1,2012-10-27 23:02:15,2012-10-27 23:02:15
31d8300e6d9251756c52f8c43da19f9dd3f0496c...a2b519b7cc258b92fc967753057d89406797705d,2,4,1,5,2,2012-11-01 16:33:17,2012-11-01 16:33:17
a2b519b7cc258b92fc967753057d89406797705d...dda91182284a6940a15da79851d29655a1c9dee2,1,1,0,1,1,2012-11-07 02:55:43,2012-11-07 02:55:43
1695343dbf32c975900faba01dbe82c7eab5f2e2...352bd601c0fdaa24edf0357975f20abb0dddfb8c,1,16,0,16,1,2012-10-11 01:14:28,2012-10-11 01:14:28
352bd601c0fdaa24edf0357975f20abb0dddfb8c...a7c4ae5de9e17fc72f33a34d4e92ccd58c099f62,1,1,1,2,1,2012-10-11 02:43:33,2012-10-10 23:59:13
a7c4ae5de9e17fc72f33a34d4e92ccd58c099f62...ace75cb9698da719aacbb60a3ea84ce095acf3a6,9,115,8,123,33,2012-10-11 09:52:38,2012-10-11 09:52:38
ace75cb9698da719aacbb60a3ea84ce095acf3a6...a730aa38bef413dd92d9cb340856d3916ddfff50,2,43,0,43,5,2012-10-11 15:18:11,2012-10-11 15:18:11
a730aa38bef413dd92d9cb340856d3916ddfff50...65d082199d1f6573c530f75790d27d5fc984abfc,3,105,35,140,21,2012-10-11 15:42:41,2012-10-09 20:33:45
65d082199d1f6573c530f75790d27d5fc984abfc...141d37354538ee2eacb8f2c8e9a36871a31ac52d,1,3,0,3,2,2012-10-11 15:52:23,2012-10-09 19:46:22
141d37354538ee2eacb8f2c8e9a36871a31ac52d...5b20f3f12c40541e7baebb639103c38c1d7db4b5,1,22,4,26,6,2012-10-11 16:51:06,2012-10-11 16:51:06
5b20f3f12c40541e7baebb639103c38c1d7db4b5...5527522a466d81bec3cbf8e4dd5b25f880993d09,1,15,2,17,4,2012-10-11 17:07:54,2012-10-11 17:07:54
5527522a466d81bec3cbf8e4dd5b25f880993d09...58f119e899d0f7254353b613838597d23cbdc013,1,10,3,13,1,2012-10-11 17:11:09,2012-10-11 17:11:09
58f119e899d0f7254353b613838597d23cbdc013...9a6aa4f7e181b18fc3ed5868773930904629a3b4,1,6,0,6,2,2012-10-11 19:14:31,2012-10-11 16:04:28
9a6aa4f7e181b18fc3ed5868773930904629a3b4...6453e95ec398eb40623c4a63c7f15b479822f153,3,11,5,16,6,2012-10-11 19:14:31,2012-10-11 19:14:18
6453e95ec398eb40623c4a63c7f15b479822f153...b3b1949de30b5dc1bde3d91aa197a8587d17d193,12,20,31,51,21,2012-10-11 19:37:33,2012-09-05 03:38:01
b3b1949de30b5dc1bde3d91aa197a8587d17d193...31b3279fe365a8d4ad7b1b70b5387a74c77ffebd,1,6,5,11,4,2012-10-11 20:34:58,2012-10-11 19:23:54
31b3279fe365a8d4ad7b1b70b5387a74c77ffebd...46f2d0598cb7c74fc7fd44bd038ecc3599b36f68,4,58,10,68,13,2012-10-11 23:07:14,2012-10-11 23:07:14
46f2d0598cb7c74fc7fd44bd038ecc3599b36f68...cfd233fc99619d38c7be786277bcd9d929b2b7b0,1,1,1,2,1,2012-10-12 07:45:16,2012-10-12 07:45:16
ee660269c2f05087ef7a583964c515c7b45a68d8...e816b2f9486dd31300d3f879b6b552f3d5427f50,1,3,3,6,2,2011-11-19 20:16:05,2011-11-19 20:15:47
e816b2f9486dd31300d3f879b6b552f3d5427f50...f88174e1968a12578c535fb91ef7ce7c1e6b5657,1,3,3,6,2,2011-11-19 22:46:33,2011-11-19 22:46:33
f88174e1968a12578c535fb91ef7ce7c1e6b5657...c67b01be01ee3c7ef84f57834380f287d83ebf61,12,173,4371,4544,28,2011-11-20 03:49:37,2011-11-20 03:49:37
c67b01be01ee3c7ef84f57834380f287d83ebf61...ee9e8115f8a41a3210be5105caa53fe9496ca5e9,2,30,6,36,4,2011-11-20 07:29:13,2011-11-20 07:29:13
ee9e8115f8a41a3210be5105caa53fe9496ca5e9...3039d9b7813bb66f01b71d10bd91347d7e9c8433,2,25,2,27,6,2011-11-20 08:12:55,2011-11-20 08:12:55
3039d9b7813bb66f01b71d10bd91347d7e9c8433...6b7bbe84e4b1607397263ad5415081f23be87fc5,1,51,0,51,1,2011-11-20 08:13:32,2011-11-20 08:13:32
6b7bbe84e4b1607397263ad5415081f23be87fc5...baa9fef42ef04f6cfad0e7608f7c6636e46a0ed3,3,46,3,49,8,2011-11-21 05:27:20,2011-11-21 05:27:20
baa9fef42ef04f6cfad0e7608f7c6636e46a0ed3...d2bf8fe3fac9164913b6260bb2bc66baa43338ee,1,13,9,22,5,2011-11-21 18:12:17,2011-11-21 18:12:17
d2bf8fe3fac9164913b6260bb2bc66baa43338ee...9a5b9cf2fa4262439d98abe26ee32e1f321a446b,1,5,0,5,1,2011-11-21 18:12:27,2011-11-21 18:12:27
9a5b9cf2fa4262439d98abe26ee32e1f321a446b...484b3745a326e7f769b4b80ff5ee328703e2c00d,1,41,0,41,1,2011-11-21 23:05:20,2011-11-21 23:00:56
484b3745a326e7f769b4b80ff5ee328703e2c00d...d4bfbf83d2f153050aba366ff4d73748eb765344,1,2,2,4,1,2011-11-22 01:04:49,2011-11-22 01:04:49
d4bfbf83d2f153050aba366ff4d73748eb765344...277932b8acdcd18a4cb97d85dd6dda908b3dc269,1,1,0,1,1,2011-11-22 09:03:35,2011-11-22 09:03:35
277932b8acdcd18a4cb97d85dd6dda908b3dc269...80865efe4da3c8a605316771f3a6c424f648e606,1,1,1,2,1,2011-11-22 17:35:24,2011-11-22 17:35:24
80865efe4da3c8a605316771f3a6c424f648e606...36406afc647580147555a6243d29416c83faa47b,1,1,0,1,1,2011-11-22 17:35:39,2011-11-22 17:35:39
36406afc647580147555a6243d29416c83faa47b...8507f2580975067bd7013f2553e76e339701bb6e,1,16,14,30,7,2011-11-22 19:02:38,2011-11-22 19:02:38
8507f2580975067bd7013f2553e76e339701bb6e...08eb8c26f281c1e56efe1db0a6b5668b7bdfb31a,1,7,4,11,2,2011-11-22 19:31:35,2011-11-22 19:31:35
08eb8c26f281c1e56efe1db0a6b5668b7bdfb31a...9a1d95efb4265a2fe4e7398277d27295b8dc8181,1,14,2,16,3,2011-11-22 21:49:20,2011-11-22 21:38:46
9a1d95efb4265a2fe4e7398277d27295b8dc8181...220776dff8d5a1de1ceb5e98691122822fe65c76,1,6,2,8,2,2011-11-22 22:45:28,2011-11-22 22:38:43
220776dff8d5a1de1ceb5e98691122822fe65c76...78527f722ea9da5acabea19118ad56006a80d272,1,3,0,3,1,2011-11-23 01:02:51,2011-11-23 00:56:11
78527f722ea9da5acabea19118ad56006a80d272...7156346ff727362dda1890e97c071eea338ed7c5,2,2,1,3,2,2011-11-23 07:35:13,2011-11-23 07:35:13
7156346ff727362dda1890e97c071eea338ed7c5...b7224eeb3eff5dc6440503499322224c7534b0c6,4,17,19,36,7,2011-11-23 16:03:42,2011-11-21 16:24:57
b7224eeb3eff5dc6440503499322224c7534b0c6...7529d38c9165fce38386debc5f8c09bee5037add,1,5,5,10,2,2011-11-23 16:03:45,2011-11-21 16:26:54
7529d38c9165fce38386debc5f8c09bee5037add...bcf554fbeba4739c1f86ced4114ce3b953084faa,1,19,6,25,7,2011-11-23 16:03:47,2011-11-23 16:02:43
bcf554fbeba4739c1f86ced4114ce3b953084faa...9ee0c52df8fd0d17477927eebe990ac27e5a691a,1,3,3,6,3,2011-11-23 16:03:50,2011-11-23 16:03:11
9ee0c52df8fd0d17477927eebe990ac27e5a691a...b6b6bc7de8897043e4412a6f68003d3a1becd6df,5,119,38,157,23,2011-11-23 16:03:52,2011-11-23 16:03:24
b6b6bc7de8897043e4412a6f68003d3a1becd6df...842bbc1527481b424c3504fd2d1dd9d6621e0cbe,4,13,9,22,6,2011-11-23 17:18:06,2011-11-23 17:18:06
842bbc1527481b424c3504fd2d1dd9d6621e0cbe...b7d52074062351a8f3fd146e358f66b30e67e86b,1,1,1,2,1,2011-11-23 17:31:05,2011-11-23 17:31:05
b7d52074062351a8f3fd146e358f66b30e67e86b...3f4978f62d2a228794a2ce473bb2a9ca6f7adb37,1,1,1,2,1,2011-11-23 16:49:40,2011-11-23 16:49:40
3f4978f62d2a228794a2ce473bb2a9ca6f7adb37...ff55522ff0ed882fc8ed7b42c19c1705ef37c243,1,4,7,11,4,2011-11-23 17:51:27,2011-11-23 17:51:27
ff55522ff0ed882fc8ed7b42c19c1705ef37c243...b1684bb3dfdcd4101cc605022258a632f4b38d32,1,41,25,66,14,2011-11-23 20:14:39,2011-11-23 20:14:39
b1684bb3dfdcd4101cc605022258a632f4b38d32...a4604dd86454dcbf880b9e62990d33218c6c61b3,1,1,1,2,1,2011-11-23 23:08:09,2011-11-23 23:08:09
a4604dd86454dcbf880b9e62990d33218c6c61b3...525634baa56f6de7a45a1fe352f06b1309d08728,4,382,356,738,82,2011-11-24 00:01:17,2011-11-23 23:49:09
525634baa56f6de7a45a1fe352f06b1309d08728...b15c813596293bab876a3144fd769ea3f0eac2e4,1,1,1,2,1,2011-11-24 00:09:39,2011-11-24 00:09:39
b15c813596293bab876a3144fd769ea3f0eac2e4...f4b0e1d8172f766e4ef51c0b4ee4dd7ed13515fc,1,2,2,4,2,2011-11-24 03:38:50,2011-11-24 03:38:50
f4b0e1d8172f766e4ef51c0b4ee4dd7ed13515fc...4666f1d2a538cd17c9113f0cabbfde2c3c2df2c9,1,3,8,11,1,2011-11-26 16:38:20,2011-11-26 16:38:20
4666f1d2a538cd17c9113f0cabbfde2c3c2df2c9...03cfbb50629b32c58db1cfef7e9e08e30d0c9fe6,1,13,1,14,2,2011-11-26 18:55:44,2011-11-26 18:55:44
03cfbb50629b32c58db1cfef7e9e08e30d0c9fe6...3e3ed843065b87d8bf9f25d5f15f9f964d83348f,1,40,16,56,3,2011-11-27 02:08:09,2011-11-26 03:15:45
3e3ed843065b87d8bf9f25d5f15f9f964d83348f...ba858ba8d361890a2520ddbbcc377682472ba9e5,20,233,171,404,52,2011-11-27 02:08:11,2011-11-27 02:05:53
ba858ba8d361890a2520ddbbcc377682472ba9e5...bb2351e2b010d5dc5fb16f4d863f1480c7e39394,1,10,0,10,2,2011-11-27 02:54:07,2011-11-27 02:54:07
bb2351e2b010d5dc5fb16f4d863f1480c7e39394...c6251b773c39ebacebd01b3b3fdfd1572e753d58,1,6,1,7,3,2011-11-27 03:06:03,2011-11-27 03:06:03
c6251b773c39ebacebd01b3b3fdfd1572e753d58...d6ee4d6b3e37661d6255e323a5113f22949ae00e,4,338,230,568,13,2011-11-27 07:37:08,2011-11-27 07:36:50
d6ee4d6b3e37661d6255e323a5113f22949ae00e...2cad4df74dd544273fc23d0fb69429766e29a446,1,245,268,513,112,2011-11-27 14:51:40,2011-11-27 14:51:40
2cad4df74dd544273fc23d0fb69429766e29a446...199cab41f31f7ba67e0155f9a833b51a46d4f49b,2,16,3,19,3,2011-11-27 20:17:46,2011-11-27 20:17:46
199cab41f31f7ba67e0155f9a833b51a46d4f49b...64af53ee855fc2a55b4dec611d7f06da8d4c7ade,1,1,1,2,1,2011-11-27 20:18:01,2011-11-27 20:18:01
64af53ee855fc2a55b4dec611d7f06da8d4c7ade...c0cb33335387d57ebcfbfaba57c97d721d3990c5,5,204,92,296,41,2011-11-27 20:19:55,2011-11-27 20:19:55
c0cb33335387d57ebcfbfaba57c97d721d3990c5...9b8a7e844891231f50ba206d3bc8a46083ed263c,1,1,1,2,1,2011-11-27 20:27:08,2011-11-27 20:27:08
9b8a7e844891231f50ba206d3bc8a46083ed263c...291639a9bcbc242f541c30f95b05d905c93a5871,2,2,2,4,2,2011-11-27 19:49:16,2011-11-27 19:49:16
291639a9bcbc242f541c30f95b05d905c93a5871...b8437ea36bfb5920c8fd4f8e2eb3642b755389e2,1,2,3,5,3,2011-11-27 21:26:36,2011-11-27 21:26:36
b8437ea36bfb5920c8fd4f8e2eb3642b755389e2...cabc4a262a0ed737d76c61abcaf4923391610791,1,1,0,1,1,2011-11-27 22:14:46,2011-11-27 22:14:46
cabc4a262a0ed737d76c61abcaf4923391610791...18fb262f9e2c8ccf6da776d1208d706eb333937b,1,2,1,3,1,2011-11-28 05:16:36,2011-11-28 05:16:36
18fb262f9e2c8ccf6da776d1208d706eb333937b...87f77a220c051a35c611d5d2a46b1d215e579552,2,173,173,346,35,2011-11-28 05:54:29,2011-11-28 05:54:22
87f77a220c051a35c611d5d2a46b1d215e579552...de0da34d7242315be58aab9161fa1fdfb7e43e9e,1,56,55,111,6,2011-11-28 15:24:08,2011-11-28 15:24:08
de0da34d7242315be58aab9161fa1fdfb7e43e9e...e5a54592f1ed5947b518ef1ca98ae91f68a2520a,1,2,1,3,2,2011-11-28 17:29:24,2011-11-28 17:29:24
e5a54592f1ed5947b518ef1ca98ae91f68a2520a...cb41d6515b220a4967331eeb873891dd33f590bb,1,5,0,5,1,2011-11-28 19:25:42,2011-11-28 19:18:43
cb41d6515b220a4967331eeb873891dd33f590bb...94602bb066d104cbf1fe8bb18203147774347bfe,1,65,61,126,21,2011-11-28 19:43:21,2011-11-28 19:43:21
94602bb066d104cbf1fe8bb18203147774347bfe...12da4783d45c724f703d33dbd94629b435fcf439,1,12,1,13,1,2011-11-28 20:52:46,2011-11-28 20:40:22
12da4783d45c724f703d33dbd94629b435fcf439...5a4ffdd879a4e991eb0349e35c79fc0a1b98ac95,1,0,1,1,1,2011-11-28 22:03:19,2011-11-28 22:03:19
5a4ffdd879a4e991eb0349e35c79fc0a1b98ac95...8e53d69f092469b7e157005bfd26e394df01db04,1,5,0,5,1,2011-11-28 22:42:17,2011-11-28 22:41:38
8e53d69f092469b7e157005bfd26e394df01db04...ecf21615b55880023fcae1f3cde6059b685899b9,1,14,12,26,6,2011-11-29 02:35:28,2011-11-29 02:35:05
ecf21615b55880023fcae1f3cde6059b685899b9...55cb15d2a7603f78240a47c4ffe77d8585d01001,1,3,3,6,3,2011-11-29 05:53:53,2011-11-29 05:53:53
55cb15d2a7603f78240a47c4ffe77d8585d01001...2e32ca342cca339930ec790e1ee8eb09a5026e6c,1,15,15,30,5,2011-11-29 08:08:12,2011-11-29 08:08:12
2e32ca342cca339930ec790e1ee8eb09a5026e6c...c8f8e6eba687c2240ee87806ee70398c7b0f2393,3,6,3,9,4,2011-11-29 14:29:34,2011-11-29 14:29:02
c8f8e6eba687c2240ee87806ee70398c7b0f2393...a3b0412abebe1d491017c64a42b899a670289133,1,17,12,29,6,2011-11-29 18:36:32,2011-11-28 23:30:18
a3b0412abebe1d491017c64a42b899a670289133...901ff0fa29f3906e44f03672fba907d854ea5e21,1,21,0,21,2,2011-11-29 18:38:56,2011-11-29 18:35:45
901ff0fa29f3906e44f03672fba907d854ea5e21...5b64d7565f574d6bbb2b8f80e8762ad50ae884fd,1,7,5,12,7,2011-11-29 19:52:36,2011-11-29 19:48:16
5b64d7565f574d6bbb2b8f80e8762ad50ae884fd...6d9e1f084ee4150f13ed54d3ba9a261b9d1c9d1a,3,14,6,20,10,2011-11-29 19:55:30,2011-11-29 19:43:56
6d9e1f084ee4150f13ed54d3ba9a261b9d1c9d1a...f853f0d051106dcbcf480f298d9b45500282bb9a,1,5,1,6,1,2011-11-29 20:56:46,2011-11-29 20:56:46
f853f0d051106dcbcf480f298d9b45500282bb9a...b0c5f379ea3b983a18db192f1227c074d0eb2afd,1,99,20,119,10,2011-11-29 21:18:21,2011-11-29 21:17:42
b0c5f379ea3b983a18db192f1227c074d0eb2afd...903de55aa10446ec8bcb19efa4ac9bfe8ab688f9,1,1,0,1,1,2011-11-29 21:23:39,2011-11-29 21:23:39
903de55aa10446ec8bcb19efa4ac9bfe8ab688f9...e9649e05cede70bf83fccf15e2bf209c659a722a,1,9,0,9,1,2011-11-29 22:33:07,2011-11-29 22:33:07
e9649e05cede70bf83fccf15e2bf209c659a722a...7ef279946c996f5cec95a909a37a1ad17093e497,1,1,1,2,1,2011-11-29 22:25:09,2011-11-29 22:25:09
7ef279946c996f5cec95a909a37a1ad17093e497...a1657326bf02c3eabd6d21f2a8815499efc6137e,2,105,2,107,3,2011-11-30 02:41:26,2011-11-30 02:39:52
a1657326bf02c3eabd6d21f2a8815499efc6137e...d4a1ee84a544cb53e75315f6bfb50cad26238971,1,2,1,3,2,2011-11-30 04:12:58,2011-11-30 00:36:40
d4a1ee84a544cb53e75315f6bfb50cad26238971...3ad7b35dcd3051d27955c549f7c377385e19c6f4,1,3,1,4,1,2011-11-30 04:12:59,2011-11-30 04:12:12
56bff902c400a9da1bc7557faa5f396ed02bfa54...ae915f73283a3f96f468fa384fe1e43fe54d7efe,1,1,2,3,2,2012-12-07 18:48:23,2012-12-07 18:48:23
56bff902c400a9da1bc7557faa5f396ed02bfa54...034512991dd4f8beb0bdccef33c18ff05cf4e27e,1,121,89,210,17,2012-12-07 18:04:46,2012-12-04 18:26:23
034512991dd4f8beb0bdccef33c18ff05cf4e27e...da7fd3ad39bbf3f5842e998cc67ab5d711baae1c,6,24,0,24,12,2012-12-07 18:09:17,2012-12-07 17:50:13
67ddf38a2b3ca17b1b84becf323d38173c97e393...4f56c5d9d194bac58d4a981a86bfde39cb6ffa0a,9,1593,2,1595,10,2012-08-30 19:30:12,2012-08-24 15:17:16
4f56c5d9d194bac58d4a981a86bfde39cb6ffa0a...5a06f2ed6e6e4f4e0cf9178e06f78ca07f2f2d80,1,917,1309,2226,331,2012-08-30 19:30:23,2012-08-24 22:21:17
5a06f2ed6e6e4f4e0cf9178e06f78ca07f2f2d80...5a04bcb16bf6f4198852d3d8c2d76dfed7111880,2,41,11,52,10,2012-08-30 21:14:58,2012-08-29 06:14:12
67ddf38a2b3ca17b1b84becf323d38173c97e393...1960f9a546ffa94a5645865eb01d407f402f0098,1,3,3,6,3,2012-08-30 16:14:12,2012-08-30 16:14:12
25e2b7e057b90a5501e78f22105c8658e4479e74...907613b7e589db5141a6e16d31e997da6062931d,1,1,2,3,2,2012-08-08 13:45:57,2012-08-08 13:45:57
ce7dcaea452ad5c17d8901154f7d23b78f10430c...b525bc684b8b1277228249c30a7db9fad5dece76,1,1,1,2,1,2012-10-15 14:14:51,2012-10-15 14:14:51
b525bc684b8b1277228249c30a7db9fad5dece76...d9791cce55a3e011c39ff384ed678c097b831f16,3,7,44,51,8,2012-10-15 14:19:02,2012-10-15 14:19:02
d9791cce55a3e011c39ff384ed678c097b831f16...0e423542312e58347990e3842badcbde3896900b,1,4,7,11,2,2012-10-15 15:09:35,2012-10-14 21:25:02
0e423542312e58347990e3842badcbde3896900b...3342a6ec9cb3a79794587c8d2927257617fbf60d,1,2,0,2,1,2012-10-15 15:26:29,2012-10-15 15:26:29
3342a6ec9cb3a79794587c8d2927257617fbf60d...498c99b00cc2f087fdd3f7321044a96af30bfb8c,1,2,7,9,1,2012-10-15 15:42:40,2012-10-15 14:48:44
498c99b00cc2f087fdd3f7321044a96af30bfb8c...3db903709a0ddb23072cd43d1e3e440be4aa75cc,1,1,1,2,1,2012-10-15 15:42:40,2012-10-15 15:23:18
3db903709a0ddb23072cd43d1e3e440be4aa75cc...732f351f4699758ed30d0a2c7e74969b03004d1a,2,18,16,34,10,2012-10-15 18:33:33,2012-10-15 18:21:48
732f351f4699758ed30d0a2c7e74969b03004d1a...5a28905a8359f336aaa9c6acffe96448ab88e2a1,2,129,36,165,16,2012-10-15 20:22:13,2012-10-15 20:12:18
5a28905a8359f336aaa9c6acffe96448ab88e2a1...6e326668c3d65b4e9af779b3c667c5b2c09bfaf6,7,355,38,393,20,2012-10-15 20:42:17,2012-10-08 21:48:05
6e326668c3d65b4e9af779b3c667c5b2c09bfaf6...e11b8976f1fd776de09559f99e4c339d0da287a7,1,17,9,26,7,2012-10-15 20:42:17,2012-10-11 03:39:02
e11b8976f1fd776de09559f99e4c339d0da287a7...f737a6f12cbbd8559921a91b17157e8152dd2b10,1,37,47,84,18,2012-10-15 20:42:17,2012-10-11 04:06:36
f737a6f12cbbd8559921a91b17157e8152dd2b10...0f3c07bc0cd8f4f3f5abc7d9d3f2babdf9fc3d88,1,11,11,22,6,2012-10-15 20:51:11,2012-10-15 20:51:09
0f3c07bc0cd8f4f3f5abc7d9d3f2babdf9fc3d88...03eb192471e22597936599a01187c2119a9eefbe,7,129,30,159,23,2012-10-15 21:17:29,2012-10-15 21:17:29
03eb192471e22597936599a01187c2119a9eefbe...1c33a98ebf1a0caa5694fcc9a026bf1949c92f65,1,1,1,2,1,2012-10-15 21:51:35,2012-10-15 21:51:35
1c33a98ebf1a0caa5694fcc9a026bf1949c92f65...3a15fac7d854802c99ed287ba2d8f0bd6d09212b,9,3448,16,3464,9,2012-10-15 22:07:06,2012-10-15 05:51:29
3a15fac7d854802c99ed287ba2d8f0bd6d09212b...dcbef4a3e5367c09182e05455e3cca4b70b8a37a,4,133,14,147,5,2012-10-15 22:07:06,2012-10-15 05:53:17
dcbef4a3e5367c09182e05455e3cca4b70b8a37a...a8d20647d7f1a03b56ab422cda4169d9a1c59929,1,9,1,10,3,2012-10-15 22:07:07,2012-10-15 06:04:15
a8d20647d7f1a03b56ab422cda4169d9a1c59929...c4446255277ec3b8d15a89d340cbce37d5fb0019,3,110,71,181,3,2012-10-15 22:07:07,2012-10-15 06:37:46
c4446255277ec3b8d15a89d340cbce37d5fb0019...347c00a5fde35f6e5acef9f58e3c8a056d532d9f,1,2,1,3,2,2012-10-15 22:07:07,2012-10-15 06:39:02
347c00a5fde35f6e5acef9f58e3c8a056d532d9f...b327e6eaeb79852148dbe3c70588f09c746a9e24,1,4,4,8,2,2012-10-15 22:07:07,2012-10-15 06:40:09
b327e6eaeb79852148dbe3c70588f09c746a9e24...ed8c12d161bcbff667a08712f6111a806465f4be,5,66,46,112,21,2012-10-15 22:07:07,2012-10-15 16:26:00
ed8c12d161bcbff667a08712f6111a806465f4be...c56d69562434f15d5d9c42d6ba2314652bd60dcf,1,0,1,1,1,2012-10-15 22:07:07,2012-10-15 18:48:21
c56d69562434f15d5d9c42d6ba2314652bd60dcf...c3ab85bc817ecea7f1591a7c200f79e6d5fab17b,66,840,112,952,77,2012-10-15 22:07:07,2012-10-15 18:50:58
c3ab85bc817ecea7f1591a7c200f79e6d5fab17b...7121e49ecb8a047d1c9fc1015cfd08813ec5e63e,1,11,0,11,2,2012-10-15 22:07:07,2012-10-15 22:06:56
7121e49ecb8a047d1c9fc1015cfd08813ec5e63e...2e287063e6ec4a08b716288cc0ecedbfad4f3d3c,4,16,102,118,11,2012-10-15 22:34:25,2012-10-15 22:31:27
2e287063e6ec4a08b716288cc0ecedbfad4f3d3c...5992d31f7011b31517b62c2b8bd52141b56a77f3,1,26,12,38,5,2012-10-16 08:10:36,2012-10-16 07:26:20
5992d31f7011b31517b62c2b8bd52141b56a77f3...58925e7afbf6f02bf604f80519922d1728ce152d,1,3,2,5,2,2012-10-16 08:29:21,2012-10-16 04:06:26
85b1a93def9416ce3fb00faa077dd871183ef39a...0cb718d3cf435264e2d41f811ac5760d5a27027a,1,9,0,9,1,2012-10-05 19:34:13,2012-10-05 19:33:53
0cb718d3cf435264e2d41f811ac5760d5a27027a...f82aa2825f93d827f6493a3c58a44125506d48b9,1,1,1,2,1,2012-10-05 21:23:22,2012-10-05 21:23:22
f82aa2825f93d827f6493a3c58a44125506d48b9...9f6d290ba2800658e2e74f207fdc992a7c0d3737,1,5,1,6,1,2012-10-05 21:25:51,2012-10-05 21:16:26
9f6d290ba2800658e2e74f207fdc992a7c0d3737...f72009cf0632379eae4f2b173fdbc4b3b47433cf,2,59,8,67,8,2012-10-06 01:03:20,2012-10-05 19:38:04
f72009cf0632379eae4f2b173fdbc4b3b47433cf...92eca294642227dd5124b8e6233c2659c772b3de,1,1,0,1,1,2012-10-07 18:32:36,2012-10-07 18:32:36
92eca294642227dd5124b8e6233c2659c772b3de...c2894c34a83e8df0787e67bfca1e21dfd8e6f801,3,46,31,77,17,2012-10-08 18:26:23,2012-10-07 19:09:42
c2894c34a83e8df0787e67bfca1e21dfd8e6f801...9a401a506af1f516cf591563d5d77c2cc4739977,2,6,6,12,7,2012-10-08 19:45:52,2012-10-04 22:22:41
15a65451256ae84e7b5062ce995c2956e8c6f37b...427442647d4b05c3754123a874a5a5994f296efa,1,2,2,4,2,2012-11-10 00:44:52,2012-11-10 00:44:52
15a65451256ae84e7b5062ce995c2956e8c6f37b...5a7456f2c726953fd7c433d96c76e9b0a1ba6105,10,334,92,426,98,2012-11-07 13:32:39,2012-11-07 13:03:55
5a7456f2c726953fd7c433d96c76e9b0a1ba6105...e5ad47d2aab4d7c731ae7c523708a84fa6b43583,1,15,14,29,2,2012-11-07 14:17:09,2012-11-07 14:17:09
e5ad47d2aab4d7c731ae7c523708a84fa6b43583...29fbd8dffe5dbeb7901c8a5e3c3d514c6d57074e,2,57,13,70,6,2012-11-07 18:29:58,2012-11-01 22:53:40
29fbd8dffe5dbeb7901c8a5e3c3d514c6d57074e...1538f5d076fc15b5736d8535316daed72b26f987,8,73,20,93,16,2012-11-07 18:35:29,2012-11-06 18:37:15
1538f5d076fc15b5736d8535316daed72b26f987...d74f0620002eee755e857739d2e5f48acb4227d6,2,0,4,4,2,2012-11-07 18:39:29,2012-11-07 18:36:45
d74f0620002eee755e857739d2e5f48acb4227d6...9139ae288028d28509c0470e185147cbeca410fa,3,35,31,66,6,2012-11-07 18:39:29,2012-11-07 18:38:29
9139ae288028d28509c0470e185147cbeca410fa...18d95ddbf29899a147750d571676a5b2e1bea493,3,16,8,24,5,2012-11-07 18:42:23,2012-11-07 18:42:18
18d95ddbf29899a147750d571676a5b2e1bea493...57f1be7c72d00eb78c3470f46bfcb9c0e7c0af20,1,1,0,1,1,2012-11-07 19:04:09,2012-11-07 01:48:16
57f1be7c72d00eb78c3470f46bfcb9c0e7c0af20...d1375b287de317a1886e49ecc0b669e084ef457c,1,1,1,2,1,2012-11-07 19:04:09,2012-11-07 01:48:45
d1375b287de317a1886e49ecc0b669e084ef457c...614722b43ff61edfa7d17085d8b0711d32dded31,2,3,1,4,2,2012-11-07 19:17:41,2012-11-06 22:14:02
614722b43ff61edfa7d17085d8b0711d32dded31...2bc73ad708e14564cef45bf74cba07ba354df27e,1,2,0,2,2,2012-11-07 20:32:03,2012-11-05 17:09:32
2bc73ad708e14564cef45bf74cba07ba354df27e...44f86a75fb9f90971008b0b2836893822388079c,1,24,24,48,17,2012-11-07 20:32:03,2012-11-05 17:11:19
44f86a75fb9f90971008b0b2836893822388079c...4ebb9c42ce902440e45e0295198fea7ae33ee600,1,8,0,8,1,2012-11-07 20:40:40,2012-11-07 16:59:18
4ebb9c42ce902440e45e0295198fea7ae33ee600...bfbc29331726fdd2663bdcb6eeae44dce2bed200,1,20,7,27,2,2012-11-07 20:53:49,2012-11-05 20:34:24
bfbc29331726fdd2663bdcb6eeae44dce2bed200...288ef9cb3b6ae41afc97ba74e4cf6d15e7a1c194,15,340,340,680,70,2012-11-07 22:04:39,2012-11-06 22:56:00
288ef9cb3b6ae41afc97ba74e4cf6d15e7a1c194...ea421b12958bfa1001ae1c66eef6a6af639d7140,3,36,10,46,8,2012-11-07 22:04:39,2012-11-06 23:40:38
ea421b12958bfa1001ae1c66eef6a6af639d7140...dbcd8e0120f1dd6ffcff7588b2e54fa97f5de9d1,1,77,0,77,1,2012-11-07 22:43:46,2012-10-25 21:09:20
dbcd8e0120f1dd6ffcff7588b2e54fa97f5de9d1...8f98f933e8997db213994ab6f7de9908ba01ab8d,1,1,1,2,2,2012-11-08 02:17:14,2012-10-18 21:20:01
8f98f933e8997db213994ab6f7de9908ba01ab8d...7f9f3983f678686a15c719a97dc6dee9f645cae0,8,158,74,232,70,2012-11-08 02:54:19,2012-11-08 02:53:02
7f9f3983f678686a15c719a97dc6dee9f645cae0...066f1dc4d417736b2c8cfe7941d690ee428bda05,11,9285,21,9306,17,2012-11-08 03:20:37,2012-11-07 19:13:04
066f1dc4d417736b2c8cfe7941d690ee428bda05...77ced69fd030ae4446f790feb56a0a234cd1367a,2,2,2,4,2,2012-11-08 15:46:29,2012-11-08 15:46:29
77ced69fd030ae4446f790feb56a0a234cd1367a...3f3f3e005ff02df06b6c50494cef6be459e395cb,1,1,1,2,1,2012-11-08 15:46:56,2012-11-08 15:46:56
3f3f3e005ff02df06b6c50494cef6be459e395cb...6491b21065af4666c1a0fcea8fc958568df36f22,4,55,12,67,11,2012-11-08 15:47:24,2012-11-08 15:47:24
cfd233fc99619d38c7be786277bcd9d929b2b7b0...3f55adce04087f0de93c3e39c5450c5c33d3ea41,1,7,5,12,3,2012-10-16 16:30:20,2012-10-16 16:30:20
cfd233fc99619d38c7be786277bcd9d929b2b7b0...9ce8c9ffc3383e131ee04dcbd5e7c07477f2f828,2,31,8,39,7,2012-10-12 15:57:04,2012-10-12 15:57:04
9ce8c9ffc3383e131ee04dcbd5e7c07477f2f828...dbaff09e6fa0be4db855125e8f1863a725ef7801,1,1,1,2,1,2012-10-12 17:18:08,2012-10-12 17:18:08
dbaff09e6fa0be4db855125e8f1863a725ef7801...fd5cef9ff6475b67aadf95d25dec45875a670752,2,10,5,15,6,2012-10-12 17:55:13,2012-10-12 17:54:33
3ad7b35dcd3051d27955c549f7c377385e19c6f4...172fb439abcbca69e2934dafecdf38d2868d38ea,4,7,5,12,5,2011-11-30 17:22:36,2011-11-30 17:21:52
3ad7b35dcd3051d27955c549f7c377385e19c6f4...b21948360c32e81ab02d62a1317f9525a4e4dd28,2,58,29,87,17,2011-11-30 17:04:48,2011-11-30 17:04:48
ffb1bd41d82cb95e3c2d787b346fd6814dda3059...ae321c06047c61c815fa94dc3ab83a13194d4e82,1,1,0,1,1,2012-12-07 18:54:23,2012-12-07 18:40:56
ae321c06047c61c815fa94dc3ab83a13194d4e82...c95c2afe8ead4b05eab7c594dd8f1e2d191924d7,1,7,3,10,3,2012-12-07 19:27:39,2012-12-07 19:27:39
c95c2afe8ead4b05eab7c594dd8f1e2d191924d7...6776b2556a07d72a8300ee5215f3eaabec5ba236,1,1,1,2,1,2012-12-07 21:10:15,2012-12-07 21:10:15
6776b2556a07d72a8300ee5215f3eaabec5ba236...d84d9b8a8db31989c4c1690f6533082ea153abd9,6,268,27,295,26,2012-12-07 21:39:24,2012-12-06 20:16:10
d84d9b8a8db31989c4c1690f6533082ea153abd9...3830c40a2a2122a182875d19f735630cffcabd6b,2,15,8,23,3,2012-12-07 22:30:15,2012-12-06 01:42:15
3830c40a2a2122a182875d19f735630cffcabd6b...d8ce7912c53b13a8a9cad445538a1ee234e25144,5,19,10,29,11,2012-12-07 22:44:11,2012-12-07 19:13:49
d8ce7912c53b13a8a9cad445538a1ee234e25144...3332fb445d6ff6cb9f279f060c91daa945d6ad5f,1,4,4,8,3,2012-12-07 22:47:52,2012-12-07 22:39:37
3332fb445d6ff6cb9f279f060c91daa945d6ad5f...ab04bade62aa3a42773fa5b92f3929068ab1c8eb,1,1,1,2,2,2012-12-07 22:47:52,2012-12-07 22:40:24
ab04bade62aa3a42773fa5b92f3929068ab1c8eb...001d19f0b8a50925aa7192cd565b66168eb9efbc,1,2,2,4,2,2012-12-07 22:47:52,2012-12-07 22:41:39
001d19f0b8a50925aa7192cd565b66168eb9efbc...5172fa4b00a02b7a2102bf54fe1dcd17ca1b0801,5,12,9,21,13,2012-12-07 22:47:52,2012-12-07 22:42:30
5172fa4b00a02b7a2102bf54fe1dcd17ca1b0801...cf417d7fde4fb5d2b71ce8b71e075427ba005b1e,1,2,0,2,2,2012-12-07 22:59:19,2012-12-07 22:59:19
cf417d7fde4fb5d2b71ce8b71e075427ba005b1e...9a6add74dfb76a15c565913d9fe4b4fc71e11934,2,27,18,45,15,2012-12-07 23:10:35,2012-12-07 22:14:55
9a6add74dfb76a15c565913d9fe4b4fc71e11934...c36b02cac2131f7beb73fdb8c7dcb7ec6ce6787c,1,6,3,9,3,2012-12-07 23:32:04,2012-11-28 01:05:47
c36b02cac2131f7beb73fdb8c7dcb7ec6ce6787c...0ae3d6e06642f3ec741837b0f1b749ad605f5fb3,1,1,1,2,1,2012-12-08 11:12:23,2012-12-08 11:12:23
0ae3d6e06642f3ec741837b0f1b749ad605f5fb3...385d0e946a082f768bec4d7bc60872aed9e8f228,2,340,0,340,25,2012-12-08 15:15:03,2012-12-08 15:15:03
385d0e946a082f768bec4d7bc60872aed9e8f228...42d1a78ecfb4fe0fcc087940f2b57e61604ed1ae,4,162,162,324,4,2012-12-08 15:30:13,2012-12-08 15:30:13
42d1a78ecfb4fe0fcc087940f2b57e61604ed1ae...fee6a8bf12bd82ecba7352f430bc3f8ca5698982,1,11,0,11,3,2012-12-08 16:35:10,2012-12-07 21:56:09
fee6a8bf12bd82ecba7352f430bc3f8ca5698982...37147146cb07e6bf0c0e47d4151d893a318ada31,1,1,1,2,1,2012-12-08 16:47:16,2012-12-08 16:47:16
37147146cb07e6bf0c0e47d4151d893a318ada31...1bb0a0ac39e6ce10599f40060d8c2a9dca1a97ea,2,19,15,34,3,2012-12-08 17:13:15,2012-12-07 19:45:52
1bb0a0ac39e6ce10599f40060d8c2a9dca1a97ea...be4c57346e1f5a3402d58762bd1294d3915e9122,1,15,16,31,4,2012-12-08 17:13:15,2012-12-07 20:00:03
be4c57346e1f5a3402d58762bd1294d3915e9122...16bec3dd4cffa6d9c30af70472bd058e3c9e2916,1,3,3,6,1,2012-12-08 17:13:16,2012-12-07 20:06:10
16bec3dd4cffa6d9c30af70472bd058e3c9e2916...c5b21478da310c15fca13f1b69e93e83418796ea,1,3,1,4,1,2012-12-08 17:13:16,2012-12-07 20:22:52
c5b21478da310c15fca13f1b69e93e83418796ea...be0a3384012985ed2f8b0b568b93628bcb0c2ec8,2,3,1,4,2,2012-12-08 19:55:59,2012-12-08 19:50:16
be0a3384012985ed2f8b0b568b93628bcb0c2ec8...fd0caa0cb1e24aaba10d6b4882b97ee50868a0b0,2,61,1,62,4,2012-12-10 02:56:45,2012-11-28 01:27:59
fd0caa0cb1e24aaba10d6b4882b97ee50868a0b0...6c5f4f918ac7edc814ef7432180d2698d5894477,2,10,9,19,6,2012-12-10 18:24:27,2012-12-10 18:24:27
6c5f4f918ac7edc814ef7432180d2698d5894477...ace61a12c09b18f820067f0d451e20fe985dd0fa,4,69,59,128,12,2012-12-10 19:00:58,2012-12-10 18:29:16
ace61a12c09b18f820067f0d451e20fe985dd0fa...e61a8e6d061b5830870ffa0062b97dc9f2db1535,1,1,1,2,1,2012-12-10 19:00:58,2012-12-10 19:00:45
e61a8e6d061b5830870ffa0062b97dc9f2db1535...8bc1aa3f748264648af4d53f263ada813a581434,3,180,17,197,9,2012-12-10 20:12:18,2012-12-10 20:12:18
8bc1aa3f748264648af4d53f263ada813a581434...f52ad32e62cfa750e386c257abddf33eaca7ec8b,5,232,48,280,29,2012-12-10 20:15:21,2012-12-10 20:15:21
f52ad32e62cfa750e386c257abddf33eaca7ec8b...d7d055b768462d8e4b8277ae45fd3ad08f90be91,1,1,0,1,1,2012-12-10 20:16:11,2012-12-10 20:16:11
d7d055b768462d8e4b8277ae45fd3ad08f90be91...d8be68870faae1176018f65ad124f5d6c72c894b,3,7,21,28,8,2012-12-10 20:16:37,2012-12-10 20:16:37
d8be68870faae1176018f65ad124f5d6c72c894b...96d64fa57c8c464d6a724dfdf99453758406447e,2,37,0,37,2,2012-12-10 20:17:14,2012-12-10 20:17:14
96d64fa57c8c464d6a724dfdf99453758406447e...4a5a2afbe2ca352dd518d733274538a27760ac0b,3,8,8,16,8,2012-12-10 20:17:32,2012-12-10 20:17:32
4a5a2afbe2ca352dd518d733274538a27760ac0b...c1e12bcce00c771cbecbda33a22f41249ad0d6f2,6,25,21,46,17,2012-12-10 20:18:28,2012-12-10 20:18:28
c1e12bcce00c771cbecbda33a22f41249ad0d6f2...e7069c1c980a0465ef64dd108a78346a037dd81e,38,151,135,286,94,2012-12-10 20:18:51,2012-12-10 20:18:51
e7069c1c980a0465ef64dd108a78346a037dd81e...cf9eb690613137821f59c0f616e84d4717497219,1,1,2,3,1,2012-12-10 20:19:23,2012-12-10 20:19:23
cf9eb690613137821f59c0f616e84d4717497219...dd2018b62f71ce67ed73f2d13d6a012d56c824fb,1,0,3,3,1,2012-12-10 20:25:54,2012-12-10 16:19:46
dd2018b62f71ce67ed73f2d13d6a012d56c824fb...a41f36c86f722af594e0ad1cfa9610ce03220a01,2,33,1,34,3,2012-12-10 20:25:54,2012-12-10 20:25:33
a41f36c86f722af594e0ad1cfa9610ce03220a01...df1fdd985b7ee3789cda646a3c2f7d42b011f65d,1,2,1,3,2,2012-12-10 20:27:35,2012-12-10 20:27:22
df1fdd985b7ee3789cda646a3c2f7d42b011f65d...855059c482e9a265210f2eb60957d0c0fd0d57c3,6,1,147,148,9,2012-12-10 21:21:31,2012-12-10 21:21:31
855059c482e9a265210f2eb60957d0c0fd0d57c3...b02156f6c11d8f0e865e0a56f72c04c072fca9b9,3,20,31,51,9,2012-12-10 21:53:38,2012-12-10 21:53:38
b02156f6c11d8f0e865e0a56f72c04c072fca9b9...1d322d1e98a9eac3e365d1330108f4d6eae251fe,1,1,1,2,1,2012-12-10 22:03:10,2012-12-10 22:03:10
1d322d1e98a9eac3e365d1330108f4d6eae251fe...705e9b24f884725643ef852633ff72dcd32de97d,1,1,1,2,1,2012-12-10 22:29:43,2012-12-07 16:05:11
705e9b24f884725643ef852633ff72dcd32de97d...8f263678cd71db0d5208ec7783f84f2bdd262be2,2,52,50,102,4,2012-12-10 23:36:54,2012-11-26 19:48:16
8f263678cd71db0d5208ec7783f84f2bdd262be2...323f3924fbb835c8180d95153fb976c4a224157b,8,158,199,357,53,2012-12-10 23:39:00,2012-11-28 00:34:39
323f3924fbb835c8180d95153fb976c4a224157b...e1d1efcf9bd1c417767b3cb5e2393fb3def51b59,6,205,10,215,23,2012-12-10 23:39:00,2012-11-28 20:06:29
e1d1efcf9bd1c417767b3cb5e2393fb3def51b59...46bdfdaf6cd175e20b3225ea227d5803fb8fd1da,4,47,84,131,15,2012-12-10 23:39:00,2012-11-28 20:09:30
46bdfdaf6cd175e20b3225ea227d5803fb8fd1da...fefb4334afe40664438668a289c6daed6813b3c3,10,484,255,739,120,2012-12-10 23:54:04,2012-11-29 19:54:48
fefb4334afe40664438668a289c6daed6813b3c3...459467c7cf47b57d8990eeb41c65b4e203e15b65,16,118,109,227,75,2012-12-10 23:54:04,2012-12-05 23:55:25
459467c7cf47b57d8990eeb41c65b4e203e15b65...cb7bd2463a04d9e5716c55584b19d3d8acb8a6c4,5,49,63,112,17,2012-12-10 23:54:05,2012-12-06 17:20:54
cb7bd2463a04d9e5716c55584b19d3d8acb8a6c4...6b1a5fd8b0814240591b8b3e78c3749f6acec23c,1,5,2,7,1,2012-12-10 23:54:05,2012-12-06 18:23:14
6b1a5fd8b0814240591b8b3e78c3749f6acec23c...7565f22a72262d0874b03c0069477d00da09e8ce,1,2,2,4,2,2012-12-11 00:13:10,2012-12-11 00:13:10
7565f22a72262d0874b03c0069477d00da09e8ce...43c63c1a941e655b532bef1e5a0b31692d4786da,2,25,6,31,7,2012-12-11 01:02:17,2012-12-11 01:02:17
43c63c1a941e655b532bef1e5a0b31692d4786da...568ebb579d9c4f0f1ffa313d4c39570123634294,1,1,1,2,1,2012-12-11 01:51:52,2012-12-11 01:51:31
568ebb579d9c4f0f1ffa313d4c39570123634294...ca9215db209dc3b629dcfaf90f81f8a0ab10f541,1,4,4,8,3,2012-12-11 03:03:03,2012-12-11 03:01:57
ca9215db209dc3b629dcfaf90f81f8a0ab10f541...7fcaffc50ec6ead9cc93c2480ccdb8cb8c7e2bd6,12,72,16,88,38,2012-12-11 09:38:57,2012-12-11 09:38:57
7fcaffc50ec6ead9cc93c2480ccdb8cb8c7e2bd6...f17fbd38f18cc0fda07860a7089b78b74b430f77,7,96,21,117,22,2012-12-11 14:30:40,2012-12-10 18:03:19
f17fbd38f18cc0fda07860a7089b78b74b430f77...c7e34a15541a4cc371e4b818f078f2f5e890ac6e,1,1,0,1,1,2012-12-11 14:48:45,2012-12-11 14:48:45
c7e34a15541a4cc371e4b818f078f2f5e890ac6e...4c3f61e55a81c98da1692d79ee6e27876cc209d2,11,264,57,321,47,2012-12-11 15:10:00,2012-12-11 14:59:53
58925e7afbf6f02bf604f80519922d1728ce152d...7db66f228efe5fa604f94fcb06e850f09920a711,6,59,12,71,17,2012-10-16 10:31:07,2012-10-16 10:08:17
7db66f228efe5fa604f94fcb06e850f09920a711...814807af7fb3c28716b2da9518cdca9608c84f86,3,13,6,19,8,2012-10-16 14:35:38,2012-10-16 01:49:27
814807af7fb3c28716b2da9518cdca9608c84f86...317272e1fee6d932c084df930f46fb2c669c1988,1,1,1,2,1,2012-10-16 14:35:38,2012-10-16 01:59:06
317272e1fee6d932c084df930f46fb2c669c1988...3e32f363eb493974f50fc6b4f5b300504c12f673,5,9,10,19,7,2012-10-16 14:35:38,2012-10-16 01:59:24
3e32f363eb493974f50fc6b4f5b300504c12f673...c35bd13c828582d8f79247a72b76b260f7b1f45b,1,6,3,9,3,2012-10-16 15:05:05,2012-10-15 20:40:29
c35bd13c828582d8f79247a72b76b260f7b1f45b...309cf5f83fa75357a89844e42923a0c907f52edc,3,25,25,50,3,2012-10-16 15:24:48,2012-10-15 22:00:10
309cf5f83fa75357a89844e42923a0c907f52edc...7ba171df2039ef57e7cca38ac42ab4e8ed13b40f,3,20,1,21,4,2012-10-16 15:32:53,2012-10-16 15:18:53
7ba171df2039ef57e7cca38ac42ab4e8ed13b40f...6cbc72e5b0ce5d0a7d15be20b306b810ec712516,1,6,4,10,3,2012-10-16 15:32:53,2012-10-16 15:24:24
6cbc72e5b0ce5d0a7d15be20b306b810ec712516...fac1f128e23e200092a53ea4f64d749145c31656,1,1,1,2,1,2012-10-16 16:01:41,2012-10-16 16:01:41
58925e7afbf6f02bf604f80519922d1728ce152d...db743484f2dd272405aec733c4fff5e8f216b395,1,1,1,2,1,2012-10-16 09:00:01,2012-10-16 09:00:01
6491b21065af4666c1a0fcea8fc958568df36f22...ce84147bb0aae9d37f3c4526ef8db59581887785,2,7,6,13,7,2012-11-09 18:38:59,2012-11-09 18:38:59
6491b21065af4666c1a0fcea8fc958568df36f22...afdcc2f94890ae36f626758ffa7c601d7a56764d,1,11,9,20,2,2012-11-08 16:04:13,2012-11-06 21:35:15
afdcc2f94890ae36f626758ffa7c601d7a56764d...d8d8272d406c8bbe78c5016353cd9bb12ca67507,2,34,1,35,6,2012-11-08 16:04:14,2012-11-06 22:34:22
d8d8272d406c8bbe78c5016353cd9bb12ca67507...3258e15caa09d5f0d3b1a1b476c141282cb3bc3b,1,2,0,2,1,2012-11-08 16:58:44,2012-10-25 22:34:45
3258e15caa09d5f0d3b1a1b476c141282cb3bc3b...e2a1f7522706ee0eb7e83b48b2fa85fda31f54c4,3,69,25,94,7,2012-11-08 16:58:44,2012-10-25 22:41:19
e2a1f7522706ee0eb7e83b48b2fa85fda31f54c4...ffcacd8a882320a4747a696f08d930a7fdc440d8,5,3,12,15,8,2012-11-08 16:58:44,2012-10-25 22:54:41
ffcacd8a882320a4747a696f08d930a7fdc440d8...b1f57396622a186651ae4418fd00448d3adab5d1,2,28,2,30,2,2012-11-08 16:58:44,2012-10-25 22:56:38
b1f57396622a186651ae4418fd00448d3adab5d1...8ca51bc93fc9c5eb87bc4fcbd011018531fc311b,1,2,2,4,1,2012-11-08 16:58:44,2012-10-26 18:43:53
8ca51bc93fc9c5eb87bc4fcbd011018531fc311b...444675bbd5a01a2149a4f112ba966ae85e3deed4,1,3,2,5,1,2012-11-08 16:58:44,2012-10-29 15:58:39
444675bbd5a01a2149a4f112ba966ae85e3deed4...924afa46297540f1b1e787a10d70259413524fc0,7,613,3,616,9,2012-11-08 19:42:05,2012-10-29 17:12:36
924afa46297540f1b1e787a10d70259413524fc0...3dc1e3f1508120806bda0bcb5d2d40484d9dd965,2,8,0,8,2,2012-11-08 19:42:05,2012-11-06 21:23:34
3dc1e3f1508120806bda0bcb5d2d40484d9dd965...784d65ee8f7b6bf58a1aad4690a9b82524ab1e84,3,11,5,16,9,2012-11-08 19:56:40,2012-11-08 17:47:28
784d65ee8f7b6bf58a1aad4690a9b82524ab1e84...299e1d26b612fe05b4a78abc439af37d4194b2f5,1,1,1,2,1,2012-11-08 21:41:29,2012-11-08 21:41:29
299e1d26b612fe05b4a78abc439af37d4194b2f5...9ca918be5fcedc8cd57a7aeeaf9211bf41b3ad36,1,2,2,4,2,2012-11-08 22:19:55,2012-11-08 22:19:07
9ca918be5fcedc8cd57a7aeeaf9211bf41b3ad36...2662102331c0170acaa10840805626f6c26f6415,1,2,2,4,2,2012-11-08 23:35:16,2012-11-08 23:35:16
2662102331c0170acaa10840805626f6c26f6415...f5d6b28def1f23def5cd1ba551f5dc73277407ff,1,1,1,2,1,2012-11-09 00:09:42,2012-11-09 00:09:16
f5d6b28def1f23def5cd1ba551f5dc73277407ff...6a51b6b01e4ebdd723e6ad33f07934d5558f9ad7,31,1294,209,1503,119,2012-11-09 00:32:38,2012-10-25 21:07:23
6a51b6b01e4ebdd723e6ad33f07934d5558f9ad7...5509b014eb5700543f0339240319f2ebac3bbbe9,2,228,236,464,7,2012-11-09 01:19:32,2012-11-09 01:19:32
5509b014eb5700543f0339240319f2ebac3bbbe9...f225b710cf39e462f782e14d4b517596226f161a,1,2,2,4,2,2012-11-09 02:51:33,2012-11-09 02:51:33
f225b710cf39e462f782e14d4b517596226f161a...75aef9e0f2a1c8d825f280b1210a24a4d23aabf7,1,2,2,4,2,2012-11-09 03:15:03,2012-11-09 03:15:03
75aef9e0f2a1c8d825f280b1210a24a4d23aabf7...bdd827db775d7f05de50908e45aca93e0b5c26b6,2,13,2,15,5,2012-11-09 04:51:57,2012-11-09 04:51:57
bdd827db775d7f05de50908e45aca93e0b5c26b6...6fff343f76f0f33d45744d30adf98d7ed1ffcd3d,3,19,16,35,17,2012-11-09 11:02:57,2012-11-08 23:05:51
6fff343f76f0f33d45744d30adf98d7ed1ffcd3d...5bef18aa24f68e817e344d6913850888d27825aa,1,5,2,7,1,2012-11-09 11:27:41,2012-11-08 23:28:05
5bef18aa24f68e817e344d6913850888d27825aa...47aaf8bbe4e26b7b88aa85d2d904c42eb06901bf,1,6,0,6,2,2012-11-09 15:20:35,2012-11-09 15:20:32
47aaf8bbe4e26b7b88aa85d2d904c42eb06901bf...e3471730639f6eba67d9b12d6f78c257cc748048,9,69,66,135,36,2012-11-09 16:23:47,2012-11-09 12:39:12
e3471730639f6eba67d9b12d6f78c257cc748048...608a083d82930ff5d5a0d306ecf60eb7f3a4cadb,4,46,179,225,9,2012-11-09 16:43:42,2012-11-05 15:33:30
6cacecacdb9870cbb3013ce6cc87c6f39b19335b...6f2893e002bd87963145124c96bc35a6fb2c30fc,2,11,9,20,2,2012-10-16 19:00:53,2012-10-16 18:59:11
6f2893e002bd87963145124c96bc35a6fb2c30fc...0c1283f5c9fe3c32d194231934b99f3a7635e19c,2,23,1,24,4,2012-10-16 20:49:16,2012-10-16 20:48:41
0c1283f5c9fe3c32d194231934b99f3a7635e19c...f2ebdd6197a417692a209db2691b540bc2235ced,1,0,1,1,1,2012-10-16 21:27:30,2012-10-16 21:27:30
f2ebdd6197a417692a209db2691b540bc2235ced...0313d5e8e8b74fa76fcef3fba85ca376b33347f1,2,30,1,31,4,2012-10-17 01:40:02,2012-10-17 01:40:02
0313d5e8e8b74fa76fcef3fba85ca376b33347f1...a1d1cc66ad9e9e1bc3d7f1814707e6fc8e5cd3e8,1,5,7,12,3,2012-10-17 02:08:53,2012-10-17 02:08:53
a1d1cc66ad9e9e1bc3d7f1814707e6fc8e5cd3e8...823da97015a5bc950708ff5c565583cc0c6ea25b,3,30,19,49,7,2012-10-17 02:13:54,2012-10-17 02:13:54
823da97015a5bc950708ff5c565583cc0c6ea25b...70f39c63f5e0023a77690c4de71a8720a5b0ea1b,1,9,1,10,2,2012-10-17 05:55:47,2012-10-17 05:36:49
70f39c63f5e0023a77690c4de71a8720a5b0ea1b...69e16e6ff80c653a65488d230fd48924629d6e03,1,12,3,15,5,2012-10-17 05:55:47,2012-10-17 05:39:18
fd5cef9ff6475b67aadf95d25dec45875a670752...003bf7c7e68cab08367f68440d1204855a40bbe7,2,0,24,24,2,2012-10-12 18:09:40,2012-10-12 18:09:25
eee755ecbaac3cc9d1c990db3ff50a944ede79ab...70c0c28f236fcbe7434a2712c90a2b72a8cbaa5b,1,1,1,2,1,2011-11-30 18:33:37,2011-11-30 15:29:28
70c0c28f236fcbe7434a2712c90a2b72a8cbaa5b...040c6ce47546389e255ed3b85ab72a341a92caf9,2,32,8,40,5,2011-11-30 18:33:37,2011-11-30 18:33:16
040c6ce47546389e255ed3b85ab72a341a92caf9...e54996c81083c363057f9840886719c77e75c4d6,5,77,12,89,10,2011-11-30 19:25:34,2011-11-28 21:15:42
e54996c81083c363057f9840886719c77e75c4d6...a68d83f02bac5374590fa667926a89fe48090273,3,49,5,54,12,2011-12-01 06:20:07,2011-12-01 06:20:07
a68d83f02bac5374590fa667926a89fe48090273...7288cf26686633d268c9f99fdabbb3f051c48077,3,158,35,193,11,2011-12-01 06:37:58,2011-12-01 06:18:41
7288cf26686633d268c9f99fdabbb3f051c48077...6619cce4ea948f5890718f1c2b5629156db8c579,3,9,8,17,3,2011-12-01 15:14:20,2011-12-01 15:04:00
6619cce4ea948f5890718f1c2b5629156db8c579...72e08f48437c1e8083901f0bf59c28753a56b011,1,0,0,0,0,2011-12-01 16:27:43,2011-12-01 16:27:43
72e08f48437c1e8083901f0bf59c28753a56b011...fdb9da460c1eac14961bc15cbaafc0222f375104,2,4,2,6,3,2011-12-01 16:52:59,2011-11-30 23:04:32
fdb9da460c1eac14961bc15cbaafc0222f375104...ac2ac5d3a4923b13402307aa1f32115cf30b9648,1,10,1,11,6,2011-12-01 16:53:00,2011-12-01 15:31:36
ac2ac5d3a4923b13402307aa1f32115cf30b9648...406b90f48ab406ce3b337208afd3bbdd456746f7,1,2,1,3,1,2011-12-01 16:53:00,2011-12-01 15:32:16
406b90f48ab406ce3b337208afd3bbdd456746f7...7bfee27706e0f9a27a31dc606b2ddfbb5c690ccc,1,10,0,10,1,2011-12-01 17:42:36,2011-12-01 16:38:33
7bfee27706e0f9a27a31dc606b2ddfbb5c690ccc...68ad44b044f8a92301fb595dade8dd34cef0010e,1,27,0,27,1,2011-12-01 17:42:38,2011-12-01 16:38:50
68ad44b044f8a92301fb595dade8dd34cef0010e...8bf0b0aca2ee9ef29495fc611e1fc2346b6abc9d,1,1,1,2,1,2011-12-01 17:42:40,2011-12-01 17:27:29
8bf0b0aca2ee9ef29495fc611e1fc2346b6abc9d...5c3e52d7a5d954865e2c2b844dfa6b84567d0edd,5,37,26,63,22,2011-12-01 17:45:59,2011-12-01 17:42:23
5c3e52d7a5d954865e2c2b844dfa6b84567d0edd...385289545e6c6172bb1076fe6577a7920d823859,1,2,0,2,2,2011-12-01 17:57:27,2011-12-01 17:57:27
385289545e6c6172bb1076fe6577a7920d823859...4bc686691bbd369dddb043f3df3165630cd8fc25,2,20,10,30,2,2011-12-01 18:21:25,2011-12-01 18:11:05
4c3f61e55a81c98da1692d79ee6e27876cc209d2...9867fdc5bbb0dbd8ba823f2481cc9283b7dc3264,1,3,3,6,3,2012-12-11 16:06:01,2012-12-11 16:06:01
4c3f61e55a81c98da1692d79ee6e27876cc209d2...0215858e3d79efdf013c605ce1a7ca028252104e,2,20,5,25,5,2012-12-11 15:47:16,2012-12-07 22:56:35
0215858e3d79efdf013c605ce1a7ca028252104e...152ebb67c04bd5b47501017afd34bb82c8c87524,2,4,3,7,2,2012-12-11 15:57:54,2012-12-11 15:57:51
152ebb67c04bd5b47501017afd34bb82c8c87524...32d3666a820e9a461996a8c00c28509a764a163c,1,1,1,2,1,2012-12-11 16:03:42,2012-12-11 16:03:06
0eb6ecc66f374be8293302f8fa5693bb733238ad...6cbd16c1076f8a601537f7987564dd5c1cc0cee4,2,117,3,120,3,2012-10-26 21:22:53,2012-10-26 21:22:40
6cbd16c1076f8a601537f7987564dd5c1cc0cee4...a115b75cc7448af9ddaa6d3a727168ab507c3ec1,1,3,2,5,3,2012-10-26 21:51:18,2012-10-26 21:51:18
a115b75cc7448af9ddaa6d3a727168ab507c3ec1...8658d757a226061bee6b3567f9e273b62cc83317,3,34,31,65,9,2012-10-26 22:04:14,2012-10-26 22:03:58
8658d757a226061bee6b3567f9e273b62cc83317...ddc485a490ff55b6f94c5de78ed8e58af049fb6a,3,32,32,64,9,2012-10-26 22:44:35,2012-10-26 22:44:35
ddc485a490ff55b6f94c5de78ed8e58af049fb6a...9fe3b3eb52c266723b4af1083b3351237f611e32,1,8,8,16,7,2012-10-27 03:11:54,2012-10-26 23:23:15
9fe3b3eb52c266723b4af1083b3351237f611e32...4b50937dd119852b6c076902b748286b50306401,1,1,1,2,1,2012-10-27 03:11:54,2012-10-26 23:25:15
4b50937dd119852b6c076902b748286b50306401...85ae4126540da602590801e9a631f07fa41ca397,6,110,3,113,28,2012-10-27 15:39:36,2012-10-27 15:39:36
85ae4126540da602590801e9a631f07fa41ca397...5a1ae683a3ae94a9d716a1d0870e5552d114691f,4,7,11,18,5,2012-10-27 15:54:53,2012-10-27 15:54:53
5a1ae683a3ae94a9d716a1d0870e5552d114691f...9f6f027835114db83c2ff0e3091641d29ded2a08,3,10,14,24,12,2012-10-27 18:21:59,2012-10-25 13:43:29
9f6f027835114db83c2ff0e3091641d29ded2a08...1bd2fc12ef9de5b705dc1d127d02c397441c77e8,1,1,1,2,1,2012-10-29 00:14:48,2012-10-29 00:14:48
1bd2fc12ef9de5b705dc1d127d02c397441c77e8...325b42be26c6dda8965f2d6b9b7b64b381f5bd61,212,105003,3,105006,216,2012-10-29 13:28:18,2012-10-24 21:40:42
325b42be26c6dda8965f2d6b9b7b64b381f5bd61...8c07cabd457b89ecc2db7c990484a9c8d23325b8,1,1,2,3,2,2012-10-29 14:12:01,2012-10-29 14:12:01
8c07cabd457b89ecc2db7c990484a9c8d23325b8...88b04683d0788a53aab83b3b3412542d2ce8ea26,2,4,1,5,2,2012-10-29 15:10:18,2012-10-29 15:10:18
88b04683d0788a53aab83b3b3412542d2ce8ea26...6d151dbaf12ee5d252e095f9609a1385dcb4b78b,2,1,4,5,2,2012-10-29 15:25:01,2012-10-29 15:25:01
6d151dbaf12ee5d252e095f9609a1385dcb4b78b...6c70206f7678f489abe7af63879bd4bdbea835c6,1,3,2,5,2,2012-10-29 16:03:22,2012-10-29 16:03:22
6c70206f7678f489abe7af63879bd4bdbea835c6...e79fc864820e67fb45f3abbe308ce6ab07043c03,4,213,103,316,5,2012-10-29 17:13:25,2012-10-26 22:11:45
e79fc864820e67fb45f3abbe308ce6ab07043c03...d5919cad9a83b4e78701b45f617e953340c920a5,453,382926,0,382926,452,2012-10-29 19:53:25,2012-10-25 20:18:04
d5919cad9a83b4e78701b45f617e953340c920a5...8d5f3b5c711b7f0571fea8636bdc23c0f7e7d728,3,542,2030,2572,3,2012-10-29 19:53:34,2012-10-25 20:38:28
8d5f3b5c711b7f0571fea8636bdc23c0f7e7d728...4251cfcc1123ffd66a2d286e2bae7e25e6d5822a,1,11,310,321,27,2012-10-29 19:53:36,2012-10-25 20:51:02
4251cfcc1123ffd66a2d286e2bae7e25e6d5822a...0de986c712700355c98f0ab20ddb27a713ee8be7,2,168,0,168,2,2012-10-29 19:53:38,2012-10-25 21:01:23
0de986c712700355c98f0ab20ddb27a713ee8be7...8e05f3628784779fb20b6779f7b0fb34b0056fbc,2,95,1,96,4,2012-10-29 19:53:40,2012-10-25 21:06:27
8e05f3628784779fb20b6779f7b0fb34b0056fbc...fe304038351a277d9292fbb64db259d596bb8ed4,1,36,0,36,1,2012-10-29 19:53:42,2012-10-25 21:09:11
fe304038351a277d9292fbb64db259d596bb8ed4...6e9661724b51a8c95eb65c24871f618dfabd79df,4,24,16,40,8,2012-10-29 19:57:42,2012-10-25 21:19:17
6e9661724b51a8c95eb65c24871f618dfabd79df...9541d2b83dd35deb023cf307a0d494951bd0e40b,2,13,3,16,6,2012-10-29 20:25:56,2012-10-17 01:24:37
9541d2b83dd35deb023cf307a0d494951bd0e40b...552ccd85cfc6a5145996a8269eeb8b778d6bcaf8,2,18,2,20,3,2012-10-30 12:55:46,2012-10-29 20:58:18
552ccd85cfc6a5145996a8269eeb8b778d6bcaf8...0f4946ba2d99251e3e3f8d68cfc8e8c99679e475,4,3,2,5,3,2012-10-30 16:20:36,2012-10-29 19:24:44
0f4946ba2d99251e3e3f8d68cfc8e8c99679e475...05b53b3859418d04f2b013ddf16c1fd23031ffca,8,589,11,600,10,2012-10-30 16:40:53,2012-10-11 15:02:38
05b53b3859418d04f2b013ddf16c1fd23031ffca...d4414504e5ab88dd21444bf1572e8ee62ba52134,1,13,1,14,1,2012-10-30 19:52:19,2012-10-30 19:30:16
d4414504e5ab88dd21444bf1572e8ee62ba52134...c3c5cfb53edc1d5eac54e8b6f543da9bf5752566,1,8,0,8,4,2012-10-31 00:09:54,2012-10-31 00:09:54
c3c5cfb53edc1d5eac54e8b6f543da9bf5752566...2386f890810afbcf3de898e92acc21cfc74a08f7,2,10,1,11,5,2012-10-31 16:53:39,2012-10-26 17:25:03
2386f890810afbcf3de898e92acc21cfc74a08f7...44e2a3167adb48e9055639bbd9d94bd9c4d4460b,7,215,5,220,14,2012-10-31 17:18:01,2012-10-17 02:21:17
44e2a3167adb48e9055639bbd9d94bd9c4d4460b...dfbc5b910ba93f7c17463f7b7402b42c8c99321e,4,38,7,45,6,2012-10-31 19:49:17,2012-10-31 18:56:00
dfbc5b910ba93f7c17463f7b7402b42c8c99321e...93de1bff87ff4b922bc51f78b0eb62fdaa8f2920,4,229,165,394,4,2012-10-31 21:28:14,2012-10-29 23:04:03
93de1bff87ff4b922bc51f78b0eb62fdaa8f2920...c445505b7ff191236103558eb7b43e4f1305399b,111,76,69039,69115,155,2012-11-01 14:27:34,2012-10-30 16:08:38
c445505b7ff191236103558eb7b43e4f1305399b...cd2ab499b795a08017b5d4de8ba03c0e3d4b60de,1,19,1,20,1,2012-11-01 15:58:23,2012-11-01 14:55:26
cd2ab499b795a08017b5d4de8ba03c0e3d4b60de...7b2c4c02478426bae2db9a5dc13d616e98177281,1,7,10,17,7,2012-11-01 23:10:57,2012-11-01 23:10:51
7b2c4c02478426bae2db9a5dc13d616e98177281...bd5d48f9c57df96e2a11933057e9a90392a89e40,1,3,0,3,1,2012-11-02 03:01:45,2012-10-26 17:18:13
bd5d48f9c57df96e2a11933057e9a90392a89e40...79c550530065678d1611567cf262a7b325c2db47,3,57,2,59,8,2012-11-02 03:06:51,2012-10-29 17:11:11
79c550530065678d1611567cf262a7b325c2db47...f4793ade8065edc67c512835c4b5c1056ac7e31d,5,512,357,869,154,2012-11-02 14:22:55,2012-10-31 15:25:32
f4793ade8065edc67c512835c4b5c1056ac7e31d...a28ea293ee0e9f0b3efc152dbdeb8d4afb408dcf,1,0,2,2,1,2012-11-02 19:42:59,2012-11-02 02:38:17
a28ea293ee0e9f0b3efc152dbdeb8d4afb408dcf...c03c0a2e8b0ac6d93c2c3e1fe309c18201b63fe2,1,2,0,2,2,2012-11-02 19:42:59,2012-11-02 02:39:09
c03c0a2e8b0ac6d93c2c3e1fe309c18201b63fe2...b4b2c5459db62f45ce74b85ee5f8732d07d0526a,1,22,11,33,9,2012-11-02 19:42:59,2012-11-02 04:22:28
b4b2c5459db62f45ce74b85ee5f8732d07d0526a...f9b92420fbf2107b050d41f3cb304ac285ed3be0,2,14,1,15,3,2012-11-02 19:42:59,2012-11-02 19:42:17
f9b92420fbf2107b050d41f3cb304ac285ed3be0...c59e542ace80e7f4543fd7a815a34103d70920ca,2,19,0,19,3,2012-11-02 20:21:29,2012-11-02 20:21:29
c59e542ace80e7f4543fd7a815a34103d70920ca...b456a5d2ed6da61b43642590cf39e61afe562479,1,2,2,4,2,2012-11-02 21:11:16,2012-11-02 21:11:16
b456a5d2ed6da61b43642590cf39e61afe562479...8003d0c3d0f3923cc14c81049b5b7ccbc7be3bab,1,1,0,1,1,2012-11-03 04:42:52,2012-11-03 04:42:00
8003d0c3d0f3923cc14c81049b5b7ccbc7be3bab...09e8a4aa16f3aef1dfb6d89fd12384141ee0ed24,1,1,1,2,1,2012-11-05 14:04:16,2012-11-05 14:04:16
09e8a4aa16f3aef1dfb6d89fd12384141ee0ed24...81585303805a179893a30665634a15aabaf93670,1,1,0,1,1,2012-11-05 14:41:51,2012-11-05 14:41:04
81585303805a179893a30665634a15aabaf93670...71835a2d7b8dd4c0b4166b5844d33268db2d1811,1,0,1,1,1,2012-11-05 17:02:29,2012-11-05 16:51:26
71835a2d7b8dd4c0b4166b5844d33268db2d1811...bb98b9b6795889c6e3369dd54341aba3503c5863,1,2,2,4,1,2012-11-05 17:56:03,2012-10-11 17:00:46
bb98b9b6795889c6e3369dd54341aba3503c5863...d5390644810ab9a79146b62a02e46f2854cc340b,3,44,2,46,4,2012-11-05 18:03:03,2012-10-11 19:20:54
d5390644810ab9a79146b62a02e46f2854cc340b...d8384a53036b471099b8d293ac21b7bd4809df33,5,73,8,81,8,2012-11-05 18:03:26,2012-10-18 21:21:45
d8384a53036b471099b8d293ac21b7bd4809df33...509199b32dc34f302e1d188a9b35bf7e3a4bd017,2,68,2,70,5,2012-11-05 18:03:26,2012-10-29 18:33:34
6e32720558aaa351546002a96eef7be706d440e0...5b5690339ed066bfc8025dd1fa60d4e3c75f538d,1,7,5,12,9,2012-11-13 04:41:59,2012-11-13 04:41:59
5b5690339ed066bfc8025dd1fa60d4e3c75f538d...1bd9f2405082ec202fe7d574c8b22e5ad18a4c63,1,1,0,1,1,2012-11-13 05:06:06,2012-11-13 05:06:06
1bd9f2405082ec202fe7d574c8b22e5ad18a4c63...88055d1a66ba7daefe681900a79cd9c01896304f,1,1,0,1,1,2012-11-13 05:19:52,2012-11-13 05:19:52
88055d1a66ba7daefe681900a79cd9c01896304f...7956fd07ade66f4ca35cc65472ef2a026b67bdc8,6,512,1,513,8,2012-11-13 07:54:19,2012-11-13 07:53:47
7956fd07ade66f4ca35cc65472ef2a026b67bdc8...1a412fb2d56f71ee361a0833eeec59fc3d2d51a7,1,2,0,2,2,2012-11-13 07:59:15,2012-11-13 07:59:15
1a412fb2d56f71ee361a0833eeec59fc3d2d51a7...dff9dc9d8b1e40bee4352ff9ecda51fb6483c456,1,7,2,9,3,2012-11-13 15:01:10,2012-11-13 15:01:10
dff9dc9d8b1e40bee4352ff9ecda51fb6483c456...a2e429d299dbb5bd58dc3ecca8918b89ac17ae59,4,16,0,16,7,2012-11-13 15:09:41,2012-11-12 15:53:59
a2e429d299dbb5bd58dc3ecca8918b89ac17ae59...f28936b2017cadcaa7cbb926f0afdc8950ee1964,1,1,1,2,1,2012-11-13 17:34:41,2012-11-13 17:34:41
f28936b2017cadcaa7cbb926f0afdc8950ee1964...4dbaf435fe60c39672a9f5e7a934f67a3f1a1bff,8,36,22,58,22,2012-11-13 19:15:52,2012-11-08 18:45:11
4dbaf435fe60c39672a9f5e7a934f67a3f1a1bff...eaa493c99d33cf14e6c9bd391629a624a6368a10,15,677,170,847,44,2012-11-13 19:24:54,2012-11-09 18:24:25
eaa493c99d33cf14e6c9bd391629a624a6368a10...83b8078373340a6b742f99abc441ae82c91a37a3,1,0,1,1,1,2012-11-13 19:26:20,2012-11-13 19:26:20
83b8078373340a6b742f99abc441ae82c91a37a3...32b574388e1296edbe221eff0708fee59563f795,1,0,2,2,1,2012-11-13 19:27:58,2012-11-13 19:23:55
32b574388e1296edbe221eff0708fee59563f795...93fdafcb4c4883d401a0726b67f2141404daa9ee,1,5,5,10,5,2012-11-13 20:20:46,2012-11-13 20:11:20
87ef6eb545fc8706f2b2724596257d3ccaa74e3c...857699a1870d45d8b89534a934612c04df4701f9,1,10,8,18,1,2012-11-09 19:03:01,2012-11-09 13:35:31
857699a1870d45d8b89534a934612c04df4701f9...f71cd730371576d6879d2ac07de16b69439f04b4,1,4,4,8,3,2012-11-09 19:16:58,2012-11-09 15:45:04
f71cd730371576d6879d2ac07de16b69439f04b4...61c4869d25f58e8dae4da9d73f65ed42de84fbe6,2,63,1,64,4,2012-11-09 19:16:58,2012-11-09 15:47:00
61c4869d25f58e8dae4da9d73f65ed42de84fbe6...c9e12a8e01239778acb160bc59b8c38d022077c0,7,23,23,46,18,2012-11-09 19:57:31,2012-11-08 19:43:36
c9e12a8e01239778acb160bc59b8c38d022077c0...92d41c4556669b1faa9df51cd9aad37e16eb57f4,1,1,0,1,1,2012-11-09 20:19:39,2012-11-09 20:19:30
92d41c4556669b1faa9df51cd9aad37e16eb57f4...d6ece0d1c9784d1fd0268cd45f852266b1778cfd,1,2,2,4,2,2012-11-09 20:50:46,2012-11-09 20:50:46
d6ece0d1c9784d1fd0268cd45f852266b1778cfd...02e35bf0fc3c6f8d5fd00a1414219261a4aa3afa,8,7,7,14,7,2012-11-09 21:26:42,2012-11-09 21:26:42
02e35bf0fc3c6f8d5fd00a1414219261a4aa3afa...7e7c9c3fb9d8e78e302a93a789ac50b941d5fdd0,7,70,14,84,19,2012-11-09 21:52:17,2012-11-08 21:08:11
7e7c9c3fb9d8e78e302a93a789ac50b941d5fdd0...e0efa2671623d2b034c4aee673f070dd8ff15c17,9,734,1,735,10,2012-11-09 21:55:50,2012-11-08 20:33:44
e0efa2671623d2b034c4aee673f070dd8ff15c17...20de91c50d0bbb782cbdbc67e7c2634e2fa8ec68,6,84,36,120,30,2012-11-09 23:09:43,2012-11-09 23:09:43
20de91c50d0bbb782cbdbc67e7c2634e2fa8ec68...865564833f8f7a90ff0c5a209d89e7ad579ee5a1,5,86,20,106,35,2012-11-09 23:31:03,2012-11-09 21:44:05
69e16e6ff80c653a65488d230fd48924629d6e03...8f5155b8b22c7aa23940d59d4640073ebffe8dab,2,10,6,16,7,2012-10-17 15:22:08,2012-10-17 15:22:08
8f5155b8b22c7aa23940d59d4640073ebffe8dab...3e4f2ab253a717240c101478c022ac667db74cfd,5,27,4,31,6,2012-10-17 19:02:44,2012-10-16 19:18:19
3e4f2ab253a717240c101478c022ac667db74cfd...34107e2d9785dfbc2665a30a724bf68049f87309,15,25,24,49,23,2012-10-17 20:06:01,2012-10-17 17:08:24
34107e2d9785dfbc2665a30a724bf68049f87309...eb5bf5b804ee4f20ab5c9e5a77674fe051889f76,4,32,3,35,8,2012-10-17 20:06:01,2012-10-17 18:52:06
eb5bf5b804ee4f20ab5c9e5a77674fe051889f76...bb65b80897797e3dc1fe96076fb6c13f6d7260c5,7,95,33,128,26,2012-10-17 20:06:01,2012-10-17 20:03:53
bb65b80897797e3dc1fe96076fb6c13f6d7260c5...b09f06fa07755c96ca8ee0f10f8cffeb2bde4a91,7,33,95,128,26,2012-10-18 13:38:15,2012-10-18 13:38:15
b09f06fa07755c96ca8ee0f10f8cffeb2bde4a91...47629aa786c916f0b988839128c21c535ae9fcfb,1,12,3,15,3,2012-10-18 14:52:15,2012-10-18 14:52:15
47629aa786c916f0b988839128c21c535ae9fcfb...f50518599638f557b77c2f913d74c6c1606fdbf1,1,46,3,49,4,2012-10-18 17:54:58,2012-10-18 17:04:26
f50518599638f557b77c2f913d74c6c1606fdbf1...14ce6482de417c30c3835b5d81c117724ed01d06,1,6,0,6,1,2012-10-18 20:54:58,2012-10-18 20:54:58
14ce6482de417c30c3835b5d81c117724ed01d06...4469161b8833728d62ad9ee00a9ee31799e1cc9a,1,11,1,12,4,2012-10-18 23:08:41,2012-10-18 23:08:41
4469161b8833728d62ad9ee00a9ee31799e1cc9a...b2d72c6390804e049d4094a34f09081f49cb95de,2,840,789,1629,7,2012-10-18 23:15:48,2012-10-18 23:15:12
b2d72c6390804e049d4094a34f09081f49cb95de...1f1a398021e8ab9d17fdeb46cd7e79541550b605,1,3,0,3,1,2012-10-19 13:43:19,2012-10-19 13:43:19
1f1a398021e8ab9d17fdeb46cd7e79541550b605...fd3f282059ab92907f22038914f034fffcf83dbb,1,2,0,2,2,2012-10-19 17:32:35,2012-10-19 17:20:10
fd3f282059ab92907f22038914f034fffcf83dbb...3cbe374586919e5d09cec7ee19301b085401d51c,3,30,5,35,6,2012-10-19 20:25:35,2012-10-19 20:24:41
3cbe374586919e5d09cec7ee19301b085401d51c...86d6c3b316da2fffc1001e665442ba679b51fd26,2,2,2,4,2,2012-10-22 15:17:21,2012-10-22 15:17:21
86d6c3b316da2fffc1001e665442ba679b51fd26...b8700f61942411c01a8ed73a5e5458e475332da7,2,2,2,4,2,2012-10-23 05:10:17,2012-10-23 05:10:17
b8700f61942411c01a8ed73a5e5458e475332da7...ee1220d4c71d9bbc18c1bd9f68893525db0f63be,1,3,2,5,1,2012-10-23 14:26:31,2012-10-16 16:35:49
ee1220d4c71d9bbc18c1bd9f68893525db0f63be...82099aad599f6fd97881d703edd0ea4bfce4444c,6,208,156,364,8,2012-10-23 14:26:31,2012-10-18 17:36:44
82099aad599f6fd97881d703edd0ea4bfce4444c...21cb67432e67313a615c3f3f9599d7cb37d1cda5,1,1,1,2,1,2012-10-23 14:26:31,2012-10-19 15:50:25
21cb67432e67313a615c3f3f9599d7cb37d1cda5...60d3d923812932848a439cf0c3811c8de654a62f,1,2,4,6,2,2012-10-23 14:33:21,2012-10-22 12:21:00
60d3d923812932848a439cf0c3811c8de654a62f...bf452ce511554505ee36648524be968a73735dde,3,54,10,64,6,2012-10-23 14:38:44,2012-10-16 21:54:43
bf452ce511554505ee36648524be968a73735dde...f5c70af4dca92270a00786963bccbf3fc359f5e3,4,169,152,321,59,2012-10-23 14:38:44,2012-10-16 16:24:39
f5c70af4dca92270a00786963bccbf3fc359f5e3...c1f08aad2e2f918adccb952532af47f7aba2efc4,3,31,1,32,5,2012-10-23 14:47:13,2012-10-16 23:31:43
c1f08aad2e2f918adccb952532af47f7aba2efc4...c5b1be7817ebce9502a4a0a9ac87fb9a820509b0,1,1,1,2,1,2012-10-23 14:53:35,2012-10-23 14:53:35
c5b1be7817ebce9502a4a0a9ac87fb9a820509b0...972c32cd09c6dba54b8976f7b78da22146c0078b,1,3,5,8,1,2012-10-23 14:55:00,2012-10-19 22:26:21
972c32cd09c6dba54b8976f7b78da22146c0078b...99bda3b10dc4920abb592bcd0d3630573fc4ad1d,1,2,2,4,2,2012-10-23 15:36:51,2012-10-23 15:36:51
99bda3b10dc4920abb592bcd0d3630573fc4ad1d...4bfc3bc15e23eeca6292cbc018075dcb10e1cd86,1,36,18,54,16,2012-10-23 15:38:28,2012-10-18 19:57:19
4bfc3bc15e23eeca6292cbc018075dcb10e1cd86...2bb94caf04dc5bf7a37368118feaaf17976eb982,11,2589,2135,4724,602,2012-10-23 15:41:33,2012-10-15 18:10:08
2bb94caf04dc5bf7a37368118feaaf17976eb982...9efa8b1db362922274420015390d8c2330aaadd4,2,1,172,173,2,2012-10-23 15:42:43,2012-10-18 20:14:43
9efa8b1db362922274420015390d8c2330aaadd4...a9540d5470bf55d560e5d0108838a6bc37b1ca48,2,4,4,8,4,2012-10-23 16:29:34,2012-10-23 16:29:34
a9540d5470bf55d560e5d0108838a6bc37b1ca48...e683fe15d01ac4f5493affc8534e2864a232e3ac,8,140,4,144,28,2012-10-23 17:57:44,2012-10-23 17:57:44
e683fe15d01ac4f5493affc8534e2864a232e3ac...32a6fdc5f4cb346733a9e2ea31af28f4da73a25b,1,3,1,4,3,2012-10-23 18:00:42,2012-10-23 18:00:25
32a6fdc5f4cb346733a9e2ea31af28f4da73a25b...5352345eda2ffa24a72af1d5bbaccaa32bcb1006,2,16,4,20,5,2012-10-23 18:10:11,2012-10-17 09:11:52
5352345eda2ffa24a72af1d5bbaccaa32bcb1006...85d1e784d2d0f45df6a5f2fc610500614343cad6,1,2,3,5,1,2012-10-23 18:43:12,2012-10-17 17:53:39
85d1e784d2d0f45df6a5f2fc610500614343cad6...03f6428015116124d70a61287c89b191fa3c9ab7,10,360,124,484,50,2012-10-23 18:52:57,2012-10-23 15:20:03
03f6428015116124d70a61287c89b191fa3c9ab7...4586aefb22d86aaddee4115db5a68ffa713042d4,6,36,0,36,13,2012-10-23 19:40:37,2012-10-23 19:40:37
4586aefb22d86aaddee4115db5a68ffa713042d4...af8d9dee9f59e3cb36991e050220c6a77384cf87,1,1,1,2,1,2012-10-23 19:43:33,2012-10-20 19:48:18
af8d9dee9f59e3cb36991e050220c6a77384cf87...d4f7ab9e9813d02380b7debc5c9bc39b26fb234b,1,2,2,4,2,2012-10-23 19:55:01,2012-10-23 19:55:01
69e16e6ff80c653a65488d230fd48924629d6e03...fa5d5970020d82de8d049d8a0dc7ac018ee10296,1,1,1,2,1,2012-10-17 14:28:16,2012-10-17 14:28:16
9250283389cdbb1f0885b628153464e6a59281a0...26f3e41041fce992a554e6a014e2c603bf674b04,1,0,1,1,1,2012-10-12 20:25:40,2012-10-12 20:25:40
26f3e41041fce992a554e6a014e2c603bf674b04...3a91169190b1876f6a5f74bbfb7ef1908e6cc5cd,1,1,1,2,1,2012-10-12 22:12:12,2012-10-12 22:12:12
3a91169190b1876f6a5f74bbfb7ef1908e6cc5cd...b184c111a62d27c49507e4042413fcc88f7f42d2,2,44,0,44,2,2012-10-14 12:42:32,2012-10-14 12:37:43
b184c111a62d27c49507e4042413fcc88f7f42d2...bdd39001aed95b86299d26e914b253c1af8e1f5b,3,76,4,80,12,2012-10-14 12:42:32,2012-10-14 12:41:54
bdd39001aed95b86299d26e914b253c1af8e1f5b...f7196c1b974a9c5ba1f093bc1749d0fe9f39e661,1,2,2,4,2,2012-10-14 12:46:06,2012-10-14 12:46:06
f7196c1b974a9c5ba1f093bc1749d0fe9f39e661...918a14c42a9156086578c28e1a7311c564aac2b3,4,10,5,15,7,2012-10-14 12:49:07,2012-10-14 12:49:07
918a14c42a9156086578c28e1a7311c564aac2b3...39e0e4af9ed4a6e8d2e158c699a89a2281c1b8bb,73,98,98,196,94,2012-10-14 16:48:21,2012-10-14 03:57:18
39e0e4af9ed4a6e8d2e158c699a89a2281c1b8bb...77bf5afd2483098c11b0286d7882d15b9351fbee,3,44,7,51,8,2012-10-14 19:29:57,2012-10-14 19:29:57
77bf5afd2483098c11b0286d7882d15b9351fbee...02e0dc4015276b787dcfc448304d978a06bec51d,1,7,0,7,1,2012-10-15 03:51:00,2012-10-15 03:51:00
02e0dc4015276b787dcfc448304d978a06bec51d...16a8e0484cfbe69c674ed6f3b7609fdc1518b50e,10,271,142,413,34,2012-10-15 06:39:24,2012-10-15 06:25:12
16a8e0484cfbe69c674ed6f3b7609fdc1518b50e...f81fe2452b832d2a8304ecb152bc2a3cb2dd9d97,6,32,0,32,14,2012-10-15 09:47:19,2012-10-15 09:47:19
4bc686691bbd369dddb043f3df3165630cd8fc25...152025d12e77820cc766d473888fd52dc7584838,5,96,32,128,17,2011-12-01 22:50:32,2011-12-01 22:50:32
4bc686691bbd369dddb043f3df3165630cd8fc25...8c5163ca5767c0d6e83f8bbf9d9eb66c2aa8eeca,1,28,3,31,6,2011-12-01 19:19:21,2011-12-01 19:18:02
8c5163ca5767c0d6e83f8bbf9d9eb66c2aa8eeca...66a2b9c2647726cc603868e981681c94d22e4d3a,2,58,44,102,20,2011-12-01 20:15:15,2011-12-01 20:13:59
66a2b9c2647726cc603868e981681c94d22e4d3a...5a9e2ad0b16d6c1ba5302ffcc050f4ff28e0b9e4,1,0,2,2,1,2011-12-01 20:50:58,2011-12-01 20:50:13
5a9e2ad0b16d6c1ba5302ffcc050f4ff28e0b9e4...808a6619da28053dd0a6b8446d80c9d7777b3e54,2,4,0,4,4,2011-12-01 21:33:47,2011-12-01 21:33:35
9bd6c2d422859c387c9c3f30106bc0d52b0f7dad...db19074c291625813fa524c23649927f6524dcd3,1,1,1,2,1,2012-12-11 16:20:28,2012-12-11 16:20:28
db19074c291625813fa524c23649927f6524dcd3...b32467dcd74c741d833a9bb349b0c8a4f3ee8b50,2,26,13,39,6,2012-12-11 16:30:58,2012-12-10 20:46:45
b32467dcd74c741d833a9bb349b0c8a4f3ee8b50...c7c753755acad5fabb83b31c863cffa9c05da673,3,8,3,11,4,2012-12-11 16:30:58,2012-12-11 00:05:01
c7c753755acad5fabb83b31c863cffa9c05da673...23c70544e24b5b2be2797a079196152d8232914c,2,9,19,28,9,2012-12-11 16:37:10,2012-12-11 16:36:58
23c70544e24b5b2be2797a079196152d8232914c...29ce113eac4a3bc9560e6f19160953895b4aff95,10,31,26,57,23,2012-12-11 17:22:06,2012-12-04 21:51:29
29ce113eac4a3bc9560e6f19160953895b4aff95...3852935adfdf1cdfc604fe783da800a474fe7111,1,2,2,4,1,2012-12-11 18:02:30,2012-12-11 18:02:30
3852935adfdf1cdfc604fe783da800a474fe7111...90ae320b451e4b33e0ebe5f3254508ec18c4f9b1,1,1,1,2,1,2012-12-11 18:22:57,2012-12-11 18:20:31
90ae320b451e4b33e0ebe5f3254508ec18c4f9b1...b1ba986ac53f472f1b1c484ea5187a79d4af97fa,2,13,26,39,6,2012-12-11 18:22:57,2012-12-11 18:19:00
b1ba986ac53f472f1b1c484ea5187a79d4af97fa...93cda0b81d954f1c0184bb15691105d90b9cb0c3,13,98,45,143,30,2012-12-11 18:30:47,2012-12-10 21:28:37
93cda0b81d954f1c0184bb15691105d90b9cb0c3...9bc4f3efb3455e0bcd41de908f7ec10532255b2d,4,386,7,393,12,2012-12-11 19:29:08,2012-12-11 19:28:45
9bc4f3efb3455e0bcd41de908f7ec10532255b2d...d53150750557b974d859da3c56dc0ae847e67cc2,3,22,41,63,18,2012-12-11 19:29:08,2012-12-11 19:29:01
d53150750557b974d859da3c56dc0ae847e67cc2...7f15a5ca4f8766e935cc7881fec2edb6b939ccec,1,13,1,14,1,2012-12-11 19:56:11,2012-12-11 18:43:28
7f15a5ca4f8766e935cc7881fec2edb6b939ccec...1dfaa36f44989f41eadc1b7d8e108ca105be3a55,5,92,5,97,7,2012-12-11 20:51:59,2012-12-11 16:16:58
1dfaa36f44989f41eadc1b7d8e108ca105be3a55...21e5ca09c42ec7ae7e1efe10f37e21082a5e9c15,9,61,140,201,26,2012-12-11 20:51:59,2012-12-11 20:51:23
21e5ca09c42ec7ae7e1efe10f37e21082a5e9c15...f728de6c4f40033d35609024c4e29915b6248f63,1,2,0,2,2,2012-12-11 21:04:05,2012-12-11 21:04:05
f728de6c4f40033d35609024c4e29915b6248f63...071f37b61e143e482a0201aa357af13e59125e2f,3,30,46,76,17,2012-12-11 21:19:27,2012-12-11 20:10:52
071f37b61e143e482a0201aa357af13e59125e2f...38cab7a6a9375e391a08098739cf08b59203cae0,1,5,1,6,1,2012-12-11 22:25:22,2012-12-11 22:19:38
38cab7a6a9375e391a08098739cf08b59203cae0...79782656749bd25cb4df50bfbb3df46e22236c24,3,43,27,70,5,2012-12-11 22:29:56,2012-12-11 18:31:47
79782656749bd25cb4df50bfbb3df46e22236c24...7aff4a70be26ba72eb4b4ba855eac25d4a8e72d9,9,159,9,168,26,2012-12-11 22:33:19,2012-12-11 17:42:05
7aff4a70be26ba72eb4b4ba855eac25d4a8e72d9...070bb2cd09198adfacb8ebfb2f2070d2e9c5a03a,12,146,83,229,53,2012-12-11 22:37:32,2012-12-11 19:09:09
070bb2cd09198adfacb8ebfb2f2070d2e9c5a03a...a89f81e461195bf669a06f0f603f0d9836450287,1,2,0,2,1,2012-12-11 22:39:00,2012-12-11 22:26:48
a89f81e461195bf669a06f0f603f0d9836450287...986788c0f9a9ec9b61e83e7ea9c348e731ce3f97,6,5,16,21,7,2012-12-11 23:02:45,2012-12-11 22:59:40
986788c0f9a9ec9b61e83e7ea9c348e731ce3f97...7c596608203b898a1ca1c75da1fbe19afcaee640,6,51,4,55,13,2012-12-12 00:09:37,2012-12-11 00:43:39
7c596608203b898a1ca1c75da1fbe19afcaee640...c99e8acd6edc9d5c60324227c6a1a6e9476a45e0,1,52,11,63,9,2012-12-12 00:13:27,2012-12-11 00:51:31
c99e8acd6edc9d5c60324227c6a1a6e9476a45e0...2d6e8e7951cdcb25b8dc9eb9edab03bcb03fe6cc,7,2,38,40,11,2012-12-12 00:30:02,2012-12-11 23:15:06
2d6e8e7951cdcb25b8dc9eb9edab03bcb03fe6cc...587fde4994df19665404160ff1e399dd5af9d6b0,6,70,15,85,8,2012-12-12 05:19:01,2012-12-12 05:18:43
587fde4994df19665404160ff1e399dd5af9d6b0...eeeabbd815a975d7dadcf5f606f003d84c8414a6,1,2,0,2,2,2012-12-12 12:38:59,2012-12-12 12:38:26
eeeabbd815a975d7dadcf5f606f003d84c8414a6...e16e49f31c98426e5355b80fa176b2b809c32349,1,54,59,113,56,2012-12-12 15:02:01,2012-12-12 09:15:46
e16e49f31c98426e5355b80fa176b2b809c32349...77cf08426e6e30c60efd7198c016386b52503a4a,4,497,16,513,20,2012-12-12 15:01:22,2012-12-12 14:56:18
77cf08426e6e30c60efd7198c016386b52503a4a...f8b63f3630a2188e979fad1a9477ec6be43e27a0,1,1,1,2,1,2012-12-12 15:18:04,2012-12-12 15:18:04
f8b63f3630a2188e979fad1a9477ec6be43e27a0...90f4ef6e11b10732552ebf51d8c89d214b996ca9,1,1,1,2,1,2012-12-12 15:20:48,2012-12-12 15:20:36
90f4ef6e11b10732552ebf51d8c89d214b996ca9...9a8c4039a5204a55429fb2707f44b88741d1f605,1,2,91,93,3,2012-12-12 15:59:11,2012-12-12 15:58:23
9a8c4039a5204a55429fb2707f44b88741d1f605...ac3f20c6dcb8aeaa9ae7182816ab1dc4f15619f5,3,101,5,106,11,2012-12-12 16:46:47,2012-12-12 16:46:47
ac3f20c6dcb8aeaa9ae7182816ab1dc4f15619f5...aa08b13e69e31425a8250278be61f941d3973894,4,18,2,20,4,2012-12-12 18:26:02,2012-12-12 18:22:07
aa08b13e69e31425a8250278be61f941d3973894...b949fb8d05f9a00b834f70a85b194e70a8c28eef,1,10,4,14,2,2012-12-12 18:42:01,2012-12-12 16:24:25
b949fb8d05f9a00b834f70a85b194e70a8c28eef...60c93fff4d0a7fe75e4e8028fd95ea3a825d5b83,1,6,0,6,2,2012-12-12 19:01:43,2012-12-12 18:32:43
60c93fff4d0a7fe75e4e8028fd95ea3a825d5b83...9783afcb785f4fe6d90377b84a895632e83a4388,2,59,3,62,4,2012-12-12 19:52:20,2012-12-12 19:52:20
9783afcb785f4fe6d90377b84a895632e83a4388...5a91f2844d089981bd1589d8bf297d0b669f7436,1,1,1,2,1,2012-12-12 20:42:10,2012-12-12 19:32:34
5a91f2844d089981bd1589d8bf297d0b669f7436...7bf153e956d24bad98169ef751ff71050cce10dd,3,35,3,38,4,2012-12-12 21:21:43,2012-12-12 21:21:43
7bf153e956d24bad98169ef751ff71050cce10dd...f79ab42cdfc2acd2dea2747450ee3c5d000193f1,1,1,1,2,1,2012-12-12 21:30:44,2012-12-12 15:21:47
f79ab42cdfc2acd2dea2747450ee3c5d000193f1...0ee0472878ac373a918f6a0444882f7f6fcf37c8,1,17,21,38,20,2012-12-12 21:30:44,2012-12-12 15:25:31
0ee0472878ac373a918f6a0444882f7f6fcf37c8...b6a54745a833a8597bf6d83e72c116cb13c8ceaf,2,35,32,67,17,2012-12-12 21:30:44,2012-12-12 16:54:06
b6a54745a833a8597bf6d83e72c116cb13c8ceaf...fdb6fac644069f9f1dfa9d860bfb6b0aee7b17da,1,1,1,2,1,2012-12-12 21:30:44,2012-12-12 16:54:18
fdb6fac644069f9f1dfa9d860bfb6b0aee7b17da...ee8fbd5c8fb530eb727ac75c47617c6ef99d5ed1,1,0,3,3,1,2012-12-12 21:30:44,2012-12-12 16:57:19
ee8fbd5c8fb530eb727ac75c47617c6ef99d5ed1...b92fcdf643ae66250f9e83930ae9572d29818b09,4,20,31,51,18,2012-12-12 21:30:44,2012-12-12 20:04:05
b92fcdf643ae66250f9e83930ae9572d29818b09...4002de8b2265cffe10cce8e7a70e756ad0f01c49,1,1,1,2,1,2012-12-12 21:30:45,2012-12-12 20:04:26
4002de8b2265cffe10cce8e7a70e756ad0f01c49...725f626aae2c2701ded3c0f97e7b5aa4c0b65979,4,80,6,86,13,2012-12-12 21:30:45,2012-12-12 21:26:42
725f626aae2c2701ded3c0f97e7b5aa4c0b65979...c3bed85ba616d062224f45625b4b8c466e6f46a4,1,24,24,48,4,2012-12-13 14:32:54,2012-12-13 14:32:54
c3bed85ba616d062224f45625b4b8c466e6f46a4...97c43bce6d80eb7424e085150666b8d4a26faac3,4,315,199,514,18,2012-12-13 16:04:53,2012-12-13 16:04:53
97c43bce6d80eb7424e085150666b8d4a26faac3...d72a2d27f583ef8c00eb8e78e469945fd50a1102,12,40,0,40,20,2012-12-13 17:27:04,2012-12-13 17:27:04
d72a2d27f583ef8c00eb8e78e469945fd50a1102...03471699fc78ae9f4e05ae71f159b6e2621ebfad,17,174,71,245,57,2012-12-13 18:24:42,2012-12-12 21:07:46
03471699fc78ae9f4e05ae71f159b6e2621ebfad...98f016e8cfc74b4a6db9aa9265af2f5a7ab05d75,1,6,8,14,7,2012-12-13 18:37:27,2012-12-13 18:37:27
98f016e8cfc74b4a6db9aa9265af2f5a7ab05d75...2beeb14b6a200094ccf1ebe3be638a8c0d00f843,1,5,5,10,5,2012-12-13 18:48:52,2012-12-13 18:48:38
2beeb14b6a200094ccf1ebe3be638a8c0d00f843...ecf149370b9929e6aaabfc57044183a65fb18d08,1,2,2,4,3,2012-12-13 19:04:41,2012-12-13 18:44:55
ecf149370b9929e6aaabfc57044183a65fb18d08...5271c025f4dcb16801ab56b3ae4a017858687aa7,1,10,2,12,4,2012-12-13 19:28:08,2012-12-13 17:01:22
5271c025f4dcb16801ab56b3ae4a017858687aa7...2812b757dd25de5ca22c3c84135f3c654ffcb928,15,406,110,516,70,2012-12-13 19:36:27,2012-12-13 19:36:27
2812b757dd25de5ca22c3c84135f3c654ffcb928...bfb0922b316f017d6dcc00e170535166e9bbd3ac,1,2,0,2,2,2012-12-13 20:56:23,2012-12-13 20:56:22
bfb0922b316f017d6dcc00e170535166e9bbd3ac...b640bdfb3ede7bd98535e0c344065314105c8100,1,1,1,2,1,2012-12-13 21:42:26,2012-12-13 21:42:26
b640bdfb3ede7bd98535e0c344065314105c8100...26ab30d2bc75af1896f0c3f75541703e351ef839,1,13,3,16,3,2012-12-13 22:00:42,2012-12-13 17:27:00
26ab30d2bc75af1896f0c3f75541703e351ef839...e842f8ca919017ef455b1099a6cd369ae83b895b,1,8,5,13,1,2012-12-13 22:29:27,2012-10-30 20:59:09
e842f8ca919017ef455b1099a6cd369ae83b895b...fa652ca77fa7eac38282a03412c133f7464fb8db,1,1,1,2,1,2012-12-13 22:29:27,2012-10-30 21:52:08
fa652ca77fa7eac38282a03412c133f7464fb8db...c9837ea549a76089bb1122d8ec06a4fc2c634077,4,158,125,283,8,2012-12-14 05:49:50,2012-12-14 05:48:58
c9837ea549a76089bb1122d8ec06a4fc2c634077...c54f0e0d0f56d33d2f3ef2824a16cd951f833fa0,2,8,0,8,4,2012-12-14 12:02:13,2012-12-14 12:02:13
c54f0e0d0f56d33d2f3ef2824a16cd951f833fa0...12df5da1fec4fbc58bc5bb7513f3666d64bfc6c5,11,0,0,0,0,2012-12-14 15:00:54,2012-12-14 15:00:54
12df5da1fec4fbc58bc5bb7513f3666d64bfc6c5...bf8a9e764b91b13616a693bb8fffe91c3470db30,1,1,1,2,1,2012-12-14 16:15:26,2012-12-14 15:21:13
bf8a9e764b91b13616a693bb8fffe91c3470db30...c2226286a28c468b8619cca7cfba18737ccc3f6e,5,286,213,499,50,2012-12-14 17:36:10,2012-12-10 15:51:55
c2226286a28c468b8619cca7cfba18737ccc3f6e...f185d93204c1f189251c5b7c33c1ecf83e3743d7,1,1,0,1,1,2012-12-14 17:49:44,2012-12-13 19:51:38
f185d93204c1f189251c5b7c33c1ecf83e3743d7...48c44465bd3500a62ec122eeda64e410b3cf8f0c,1,1,0,1,1,2012-12-14 17:49:44,2012-12-13 21:06:53
48c44465bd3500a62ec122eeda64e410b3cf8f0c...c8884bd57498000735a5e30af55479d83e8f3634,1,1,0,1,1,2012-12-14 17:49:44,2012-12-14 15:44:09
c8884bd57498000735a5e30af55479d83e8f3634...96ca30b9fba844e543e5a0b223266af4c1683799,1,1,0,1,1,2012-12-14 17:49:44,2012-12-14 17:47:59
96ca30b9fba844e543e5a0b223266af4c1683799...cc29e330d50c79e7df5e0dfdc72b26f9b62b7ad2,1,1,0,1,1,2012-12-14 17:49:44,2012-12-14 17:48:52
cc29e330d50c79e7df5e0dfdc72b26f9b62b7ad2...1c4fb029c1c60459d423f4ad56a1e0841cacdc83,1,1,0,1,1,2012-12-14 17:54:10,2012-12-14 15:48:42
1c4fb029c1c60459d423f4ad56a1e0841cacdc83...12bab3dae57f9ba716f3bdcc059518d50dd80004,6,7,64,71,13,2012-12-14 18:05:54,2012-12-11 00:11:19
12bab3dae57f9ba716f3bdcc059518d50dd80004...0fc78583b6de06235945e776402a452492931caa,3,64,10,74,5,2012-12-14 18:05:54,2012-12-12 00:36:58
0fc78583b6de06235945e776402a452492931caa...8ab8bafd2617674e6656ba063a3782c301a89e13,1,1,0,1,1,2012-12-14 18:16:14,2012-12-13 00:30:31
8ab8bafd2617674e6656ba063a3782c301a89e13...9da0609329171710ac085c66038c6399d4e4423b,10,423,170,593,62,2012-12-14 18:56:36,2012-12-11 22:26:58
9da0609329171710ac085c66038c6399d4e4423b...079c9a78355677f170dc9da2cac05b6057881081,9,39,85,124,38,2012-12-14 18:57:11,2012-12-12 20:30:09
079c9a78355677f170dc9da2cac05b6057881081...ea655580c27ada4ffe4cd62a660c356f25ff44f7,9,29,16,45,16,2012-12-14 18:57:11,2012-12-12 21:10:42
ea655580c27ada4ffe4cd62a660c356f25ff44f7...bef110071c0d2641670ec55f621ea1d23de13aab,4,59,0,59,6,2012-12-14 18:57:11,2012-12-13 00:32:44
bef110071c0d2641670ec55f621ea1d23de13aab...11f68e6353df398d2c87b13d1cb3eccf4e80a7a1,4,65,0,65,4,2012-12-14 19:37:10,2012-12-13 15:59:16
11f68e6353df398d2c87b13d1cb3eccf4e80a7a1...6f7a0dde58625d291c09d76e94fde77ef92a0420,7,51,11,62,13,2012-12-14 19:37:10,2012-12-13 21:03:10
6f7a0dde58625d291c09d76e94fde77ef92a0420...d85c100dd270544f3f43d871cacc313c99f5cbea,8,96,34,130,21,2012-12-14 19:37:10,2012-12-13 21:42:11
d85c100dd270544f3f43d871cacc313c99f5cbea...13f77588a6a9997db841a5583a69ac961f3eb01c,2,98,0,98,2,2012-12-14 19:37:10,2012-12-14 16:24:36
13f77588a6a9997db841a5583a69ac961f3eb01c...7a7ef6547c95301ee95f969599ee09c226c4a8f1,1,3,3,6,3,2012-12-14 19:37:10,2012-12-14 16:25:28
7a7ef6547c95301ee95f969599ee09c226c4a8f1...4e0b278f15d4ab45fe69e7915a8a3bb8a5ebe780,1,1,1,2,1,2012-12-14 19:37:10,2012-12-14 19:36:55
4e0b278f15d4ab45fe69e7915a8a3bb8a5ebe780...dc77bbd3798c8bfe3428a26201b11a2929a3388b,2,4,4,8,4,2012-12-14 19:40:59,2012-12-14 19:40:59
dc77bbd3798c8bfe3428a26201b11a2929a3388b...d67ef67549043e7e293953ba90abc7cde5d0b1a8,1,14,13,27,13,2012-12-14 20:54:01,2012-12-14 20:54:01
d67ef67549043e7e293953ba90abc7cde5d0b1a8...e44707180346d00701da741d1db1b3714f694bed,1,3,0,3,1,2012-12-14 21:01:31,2012-12-14 21:01:31
e44707180346d00701da741d1db1b3714f694bed...03f35f2815726130ff69d63b7d6ba20b2208ebed,1,2,0,2,1,2012-12-14 22:23:35,2012-12-14 22:23:35
03f35f2815726130ff69d63b7d6ba20b2208ebed...177a7aaace930ce1fd186a4a03fc3604377e43eb,4,15,9,24,7,2012-12-14 22:28:30,2012-12-14 19:14:19
177a7aaace930ce1fd186a4a03fc3604377e43eb...1e7a976eff70677c7323e52fd25446822431bcf2,9,52,58,110,21,2012-12-14 22:42:58,2012-12-14 16:30:50
1e7a976eff70677c7323e52fd25446822431bcf2...b21c528acf442300322f2d05a29de9d2a1a43139,1,6,2,8,1,2012-12-14 22:55:05,2012-12-14 22:17:21
b21c528acf442300322f2d05a29de9d2a1a43139...50759820a8a08410ec72b746f387aad26c04d347,1,1,1,2,1,2012-12-14 22:55:06,2012-12-14 22:54:43
50759820a8a08410ec72b746f387aad26c04d347...bd23cb930cd7368d2712177b736581ad9bd7a432,5,213,286,499,51,2012-12-14 23:33:49,2012-12-14 23:33:49
bd23cb930cd7368d2712177b736581ad9bd7a432...f86269bb53dc493d29437aa750fe2a04989bc158,3,40,39,79,11,2012-12-15 00:20:12,2012-12-07 23:27:25
f86269bb53dc493d29437aa750fe2a04989bc158...5786cd475e19250893df3e466005a2a490c91e30,6,135,193,328,69,2012-12-15 00:20:12,2012-12-10 21:40:09
5786cd475e19250893df3e466005a2a490c91e30...264b0e0482ad01e3fba647f767d46314d419d468,1,136,199,335,20,2012-12-15 00:20:12,2012-12-14 23:40:08
264b0e0482ad01e3fba647f767d46314d419d468...1fe69ced14013da9c33bad946abc5911139b6b70,2,36,13,49,10,2012-12-15 00:20:12,2012-12-11 17:52:50
1fe69ced14013da9c33bad946abc5911139b6b70...13a551f7e4e4510c8d18f0aac0fe6259de6c4c00,7,446,0,446,9,2012-12-15 00:20:12,2012-12-11 22:11:37
13a551f7e4e4510c8d18f0aac0fe6259de6c4c00...56729f522901d1258707199f86e049885499ef18,4,21,3,24,5,2012-12-15 00:20:12,2012-12-12 20:30:02
56729f522901d1258707199f86e049885499ef18...d512457fec2a9e2db45b38f7256fadf366883e3c,3,36,41,77,20,2012-12-15 00:20:12,2012-12-14 18:21:51
d512457fec2a9e2db45b38f7256fadf366883e3c...69ceee8d9c8008b974f11937941e7a591124b82c,9,161,160,321,59,2012-12-15 00:20:12,2012-12-14 21:02:41
69ceee8d9c8008b974f11937941e7a591124b82c...8479fc32086bce15e5392e4091df881695792e20,4,91,21,112,18,2012-12-15 00:20:12,2012-12-14 23:10:44
8479fc32086bce15e5392e4091df881695792e20...8a94bf892c8bbbb3a358a6ae890e383cfd4e2d9c,1,3,3,6,1,2012-12-15 01:49:21,2012-12-15 01:49:21
8a94bf892c8bbbb3a358a6ae890e383cfd4e2d9c...2627e7c6fc2d44f89eb343fe32b8304d6c48d543,10,144,16,160,38,2012-12-15 12:55:42,2012-12-15 12:55:42
2627e7c6fc2d44f89eb343fe32b8304d6c48d543...d80594835a3e447951f147c0be7ffa0c19ae8d41,2,36,0,36,2,2012-12-15 12:58:21,2012-12-14 21:32:24
d80594835a3e447951f147c0be7ffa0c19ae8d41...eb8407e4cccaae93a869719c4d9d13e8f84dc92d,12,24,0,24,12,2012-12-15 16:44:03,2012-12-15 16:44:03
eb8407e4cccaae93a869719c4d9d13e8f84dc92d...e21d8122f4613756c018b0140f191bf0c6ab3c34,1,8,1,9,3,2012-12-16 18:43:40,2012-12-16 18:43:40
e21d8122f4613756c018b0140f191bf0c6ab3c34...81a8d87fa7a1a614ca0e0c0c93c260052af541b9,2,43,34,77,16,2012-12-16 21:27:19,2012-12-16 21:27:19
81a8d87fa7a1a614ca0e0c0c93c260052af541b9...c5aa1730a511ecffcb7dab2f7b32b6ee607c933d,3,20,0,20,6,2012-12-16 21:45:02,2012-12-16 17:05:06
c5aa1730a511ecffcb7dab2f7b32b6ee607c933d...2dbcc5f6119adbabe2b972c5113546aa36fab137,1,2,2,4,2,2012-12-16 23:53:00,2012-12-16 23:53:00
2dbcc5f6119adbabe2b972c5113546aa36fab137...41cce287ffad7ea0c04facdd0986631bade7d027,1,8,3,11,4,2012-12-17 16:39:39,2012-12-17 16:39:26
41cce287ffad7ea0c04facdd0986631bade7d027...9a83eb79b5b3587f98b4776d5dcca07d9ba04cd6,5,297,213,510,54,2012-12-17 16:58:57,2012-12-10 15:51:55
9a83eb79b5b3587f98b4776d5dcca07d9ba04cd6...59f0762d269b1c6aef5d4601e2ebda47ee2f947e,1,1,1,2,2,2012-12-17 18:19:02,2012-12-17 18:19:02
59f0762d269b1c6aef5d4601e2ebda47ee2f947e...e08e3c4b635b0517d9d380c5a974787c8e9632ca,3,8,1,9,3,2012-12-17 18:26:28,2012-12-17 16:57:47
e08e3c4b635b0517d9d380c5a974787c8e9632ca...f78e22ed0a2bbc9d5b58b0602dfdadf5f7720836,1,23,18,41,13,2012-12-17 18:57:16,2012-12-17 18:56:15
f78e22ed0a2bbc9d5b58b0602dfdadf5f7720836...1f8532cdd688041813c4ccf8d3143ba5a7ceee4f,11,47,15,62,22,2012-12-17 19:08:59,2012-12-14 23:10:43
1f8532cdd688041813c4ccf8d3143ba5a7ceee4f...57a6ceb4f6ecf8f98dbee4d71fce9b42cc732c22,1,2,2,4,1,2012-12-17 19:32:43,2012-12-12 21:03:34
57a6ceb4f6ecf8f98dbee4d71fce9b42cc732c22...838f6c4aedeb8381d2c7a283497c364db24db559,4,18,10,28,10,2012-12-17 19:32:43,2012-12-12 21:22:10
838f6c4aedeb8381d2c7a283497c364db24db559...913c56c9043ea09a50dab5ec0309385f1d5e3015,1,2,1,3,1,2012-12-17 19:38:24,2012-12-17 16:05:17
913c56c9043ea09a50dab5ec0309385f1d5e3015...c153224a54c1a9ed7a1a04b9bb68b83bca62f5c3,1,2,0,2,1,2012-12-17 19:42:42,2012-12-17 19:42:42
c153224a54c1a9ed7a1a04b9bb68b83bca62f5c3...22865ea27fb097162d5de942ce0fd2baf83bf788,1,4,2,6,2,2012-12-17 20:22:21,2012-12-17 20:22:08
22865ea27fb097162d5de942ce0fd2baf83bf788...385502fd0d6a5aafa5478fb9099c4f26394627cb,3,31,6,37,4,2012-12-17 20:45:01,2012-12-17 20:18:17
385502fd0d6a5aafa5478fb9099c4f26394627cb...50f22ef561c08c56b26e8f4e2bef5636180280f4,5,460,19,479,19,2012-12-17 20:45:38,2012-12-10 19:06:13
50f22ef561c08c56b26e8f4e2bef5636180280f4...c35dc405de400ee45f54746885f5d8f1cf2290fa,1,3,2,5,1,2012-12-17 22:09:33,2012-12-17 21:16:52
c35dc405de400ee45f54746885f5d8f1cf2290fa...45b9844016813ef88849d4ae15575915846f921e,3,1,33,34,6,2012-12-17 22:36:25,2012-12-14 16:51:08
45b9844016813ef88849d4ae15575915846f921e...61eef01258c81d728dda432f2f50a9cacaddb4e0,1,0,4,4,1,2012-12-17 23:00:35,2012-12-15 00:38:27
61eef01258c81d728dda432f2f50a9cacaddb4e0...4d9119b002de7f9ab2238ba01c3cee92201f3dde,4,7,3,10,4,2012-12-17 23:08:59,2012-12-17 22:22:06
4d9119b002de7f9ab2238ba01c3cee92201f3dde...2e4298c6ab219957270c5c2c7ee40c26f07be6ae,1,3,0,3,2,2012-12-17 23:12:45,2012-12-17 23:12:45
2e4298c6ab219957270c5c2c7ee40c26f07be6ae...4dfc7f12d4bdefcf4d5d85a2efd227fdfe730f33,5,133,15,148,18,2012-12-18 05:02:03,2012-12-18 05:00:53
4dfc7f12d4bdefcf4d5d85a2efd227fdfe730f33...1d840a1c19856a6ffa7b0e1d54b4924a770dcad8,1,1,1,2,2,2012-12-18 14:40:56,2012-12-18 14:38:36
1d840a1c19856a6ffa7b0e1d54b4924a770dcad8...a6d3fd5afb19e0cb6c71acb36fc703cb5e79ebb3,1,1,1,2,1,2012-12-18 14:40:56,2012-12-18 14:39:29
a6d3fd5afb19e0cb6c71acb36fc703cb5e79ebb3...6889d1658136c753998b4a408dc8d1a3ec28e3b9,5,341,15,356,23,2012-12-18 14:40:56,2012-12-18 14:40:08
509199b32dc34f302e1d188a9b35bf7e3a4bd017...8a04155fedac3d928f1ddfa34d999c39dd0f27f5,13,3273,0,3273,14,2012-11-05 18:39:10,2012-11-05 18:39:10
509199b32dc34f302e1d188a9b35bf7e3a4bd017...f09b71528ade659dd530ba2d3ea8e31dd0993e5a,7,68,29,97,14,2012-11-05 18:22:06,2012-11-05 17:42:23
93fdafcb4c4883d401a0726b67f2141404daa9ee...feacfec2d6901a5a013aecc4b2d74f304ef4a951,1,3,2,5,1,2012-11-14 22:35:35,2012-11-14 22:35:35
93fdafcb4c4883d401a0726b67f2141404daa9ee...74855308ab2d4c7d40e1da8829796744c5259797,2,31,0,31,6,2012-11-14 00:55:06,2012-11-14 00:55:06
74855308ab2d4c7d40e1da8829796744c5259797...6c82e1be0902616bfbf8c3fd51ae27c99759e986,4,570,0,570,4,2012-11-14 00:55:25,2012-11-14 00:55:25
93fdafcb4c4883d401a0726b67f2141404daa9ee...68a2023506a217e787e0cb50d7de60b36d4fa17f,3,45,4,49,8,2012-11-13 22:35:46,2012-11-13 15:13:25
68a2023506a217e787e0cb50d7de60b36d4fa17f...d7fc7b92c638129d782069de0e5df1cc4db2db9e,1,8,3,11,5,2012-11-13 22:35:46,2012-11-13 15:14:33
d7fc7b92c638129d782069de0e5df1cc4db2db9e...330d394f6f050b664712c6354aec1e2a5e10a710,3,57,23,80,15,2012-11-13 22:35:46,2012-11-13 15:45:01
330d394f6f050b664712c6354aec1e2a5e10a710...78683ad50585eeabb117fffdf90f7e7fe6f8d034,1,17,20,37,8,2012-11-13 22:35:47,2012-11-13 16:13:14
78683ad50585eeabb117fffdf90f7e7fe6f8d034...63f31179f1f6224b1905114280b6041bf82b8679,1,5,13,18,3,2012-11-13 22:35:47,2012-11-13 22:34:38
63f31179f1f6224b1905114280b6041bf82b8679...bd6b634f6c1e56c9bcdc911af01994d2bf23131e,1,13,2,15,4,2012-11-13 22:35:47,2012-11-13 22:35:03
bd6b634f6c1e56c9bcdc911af01994d2bf23131e...a1a34a39d5c555848e27c5ad231b0828cf765655,1,0,1,1,1,2012-11-13 22:35:47,2012-11-13 22:35:21
a1a34a39d5c555848e27c5ad231b0828cf765655...d5fab766d47c09930a2c8c3affa423d71c4303b0,8,5,135,140,12,2012-11-13 22:35:47,2012-11-13 22:35:31
d5fab766d47c09930a2c8c3affa423d71c4303b0...3551c2e37e35f0c482a78c503818eaa87e1c2024,1,1,1,2,1,2012-11-14 00:03:54,2012-11-14 00:03:54
93fdafcb4c4883d401a0726b67f2141404daa9ee...fe38a5e9f8a06e0db57e89b97b9af1bfb789bff0,8,132,30,162,19,2012-11-13 21:34:57,2012-11-13 21:34:57
865564833f8f7a90ff0c5a209d89e7ad579ee5a1...4c78e38659901dfb3e3ca91b7aa7f4864401ee7d,3,1,3,4,4,2012-11-10 20:55:37,2012-11-10 20:55:37
4c78e38659901dfb3e3ca91b7aa7f4864401ee7d...894cc05556fbf69ee515b3685a60e8a5e6d345aa,1,1,1,2,1,2012-11-10 22:23:42,2012-11-10 22:23:42
894cc05556fbf69ee515b3685a60e8a5e6d345aa...6646391f2d5c0077eaad4fc9836a2abe6278f2f8,5,33,27,60,14,2012-11-11 05:37:38,2012-11-11 05:37:38
6646391f2d5c0077eaad4fc9836a2abe6278f2f8...6d089c27a506d0bbb5a761b9099a16d027ffd93c,1,1,1,2,1,2012-11-11 06:47:33,2012-11-11 06:47:33
6d089c27a506d0bbb5a761b9099a16d027ffd93c...96bfc6ffc545e6771f58de1fcdd8b4d300413c85,1,2,2,4,1,2012-11-11 14:51:06,2012-11-11 14:47:31
96bfc6ffc545e6771f58de1fcdd8b4d300413c85...0cb666d9866cd06f5a84f68dbfa4175c0e7e4d8f,1,2,0,2,1,2012-11-11 15:15:46,2012-11-11 15:15:46
0cb666d9866cd06f5a84f68dbfa4175c0e7e4d8f...ee5196d761e301b0dca5af5c864309f0892db2ef,1,2,0,2,1,2012-11-11 16:36:08,2012-11-11 16:36:08
ee5196d761e301b0dca5af5c864309f0892db2ef...e735e4d7314f10ba7ff9a98cc5d03e770a4f7465,2,32,32,64,26,2012-11-11 19:37:54,2012-11-11 19:37:54
e735e4d7314f10ba7ff9a98cc5d03e770a4f7465...889fd753e98dfb91970560c798c3b9c15bdb96f2,5,111,81,192,31,2012-11-11 20:37:33,2012-11-11 00:10:46
889fd753e98dfb91970560c798c3b9c15bdb96f2...319dbf140ff6bf2629ecac844bf3b711850e4b4e,1,9,2,11,3,2012-11-12 02:35:22,2012-11-12 02:35:22
319dbf140ff6bf2629ecac844bf3b711850e4b4e...70361a4125edeeae8427bae122ac361a1c6c2697,28,390,274,664,68,2012-11-12 03:51:25,2012-11-04 21:55:36
70361a4125edeeae8427bae122ac361a1c6c2697...4680f0e8c717f9721b9771cc7e9cfa22822db2f4,1,3,4,7,4,2012-11-12 15:13:24,2012-11-12 14:44:33
4680f0e8c717f9721b9771cc7e9cfa22822db2f4...855ad2f091809beb17909546229723c94f6cbd90,3,15,8,23,5,2012-11-12 15:41:09,2012-11-12 06:38:32
855ad2f091809beb17909546229723c94f6cbd90...6b5c84d267c283babf22155c956764a78d5ad5d2,2,33,0,33,2,2012-11-12 15:41:09,2012-11-12 14:46:32
6b5c84d267c283babf22155c956764a78d5ad5d2...b74de7eadee1fb15527a915aae0b68b823251a66,3,114,0,114,5,2012-11-12 15:41:09,2012-11-12 15:40:07
b74de7eadee1fb15527a915aae0b68b823251a66...d7eb0a09e32b6de3e4acb7e9fa221196da847fe1,1,82,11,93,8,2012-11-12 15:43:24,2012-11-08 21:20:05
d7eb0a09e32b6de3e4acb7e9fa221196da847fe1...3cccc7137f0fc2f583a5484054d1f15efde9e7da,1,16,1,17,2,2012-11-12 15:56:59,2012-11-12 15:56:59
3cccc7137f0fc2f583a5484054d1f15efde9e7da...4ca39159c6c4a18fb1b16063f2ac6b49b58a3167,2,57,7,64,10,2012-11-12 16:09:37,2012-11-08 21:44:59
4ca39159c6c4a18fb1b16063f2ac6b49b58a3167...ab9ff1d3ecc7163fc93188efd997bbacd8fe7406,12,383,106,489,46,2012-11-12 16:09:37,2012-11-12 15:19:43
ab9ff1d3ecc7163fc93188efd997bbacd8fe7406...074431815cdfc44ad757675a159e3e51739d1d95,4,137,1,138,13,2012-11-12 16:09:37,2012-11-08 21:49:11
074431815cdfc44ad757675a159e3e51739d1d95...3abcc53d43145bcda52016c753e10ff139d41e4d,12,106,383,489,46,2012-11-12 16:50:12,2012-11-12 16:50:12
3abcc53d43145bcda52016c753e10ff139d41e4d...ab1bceba74845666aaad957cab256cadf2a0c8de,12,383,106,489,46,2012-11-12 16:51:01,2012-11-12 15:19:43
ab1bceba74845666aaad957cab256cadf2a0c8de...d9df6423f805b5cd1dc7717b62a13aae9ce3778a,2,4,2,6,2,2012-11-12 16:58:14,2012-11-12 16:58:14
d9df6423f805b5cd1dc7717b62a13aae9ce3778a...16201e493f157b9692904b3baa7aed3dd3ab8da2,6,152,0,152,26,2012-11-12 18:13:22,2012-11-12 16:59:26
16201e493f157b9692904b3baa7aed3dd3ab8da2...7f9749e7293d1891497d69744d6dedd1f1e81798,4,9,20,29,9,2012-11-12 21:20:52,2012-11-12 19:08:58
7f9749e7293d1891497d69744d6dedd1f1e81798...cf0f0a4d278ce3f2fd0b5015f3cbd0d48d409f65,1,41,0,41,1,2012-11-12 23:01:40,2012-11-12 23:01:40
cf0f0a4d278ce3f2fd0b5015f3cbd0d48d409f65...4a3336c9e74381ab67ccdb810e8b99f1c520ab33,1,2,1,3,2,2012-11-12 23:55:22,2012-11-12 23:54:56
4a3336c9e74381ab67ccdb810e8b99f1c520ab33...53ffd6d8e442a8d09569845e02e9dee528950481,4,294,81,375,189,2012-11-12 23:58:08,2012-11-12 19:07:44
53ffd6d8e442a8d09569845e02e9dee528950481...0fa6008985fa50194daaf8f0adfca864d9fb38ea,1,2,0,2,1,2012-11-13 00:01:49,2012-11-13 00:01:42
ea4a7326624a4ceab5c6656645ae270725050008...7d6a1be8af07e5c48d32cfe0bdc000bf29a9a212,1,2,2,4,1,2012-10-23 20:05:27,2012-10-23 19:26:21
7d6a1be8af07e5c48d32cfe0bdc000bf29a9a212...0b9a5843bbaeb6adb488f6932c32028345a882fc,1,1,1,2,1,2012-10-23 20:09:03,2012-10-22 09:08:34
0b9a5843bbaeb6adb488f6932c32028345a882fc...ffd8aec961a751aa5adfa79070f26cc21a560ce5,1,50,46,96,14,2012-10-23 20:23:55,2012-10-16 22:25:52
ffd8aec961a751aa5adfa79070f26cc21a560ce5...5589eb5e541eecc80cb94b54139b289c8e6ce06c,2,6,4,10,4,2012-10-23 20:25:46,2012-10-23 15:02:35
5589eb5e541eecc80cb94b54139b289c8e6ce06c...435ad1672d1dc7fef8a4d3b3ba8441081f359ee9,1,1,0,1,1,2012-10-23 20:27:29,2012-10-18 20:20:52
435ad1672d1dc7fef8a4d3b3ba8441081f359ee9...2716c5467a5c171d6af5cfcbda5e63508e48f6ef,5,135,123,258,39,2012-10-23 20:35:42,2012-10-18 20:07:39
2716c5467a5c171d6af5cfcbda5e63508e48f6ef...001e3afa1a06b800d800c4bf70f1e45738a154a5,3,16,25,41,11,2012-10-23 21:01:51,2012-10-22 17:03:17
001e3afa1a06b800d800c4bf70f1e45738a154a5...2b28e842e897189452dccf6bfc9f0855813d4cab,14,373,140,513,52,2012-10-23 21:10:05,2012-10-11 15:01:27
2b28e842e897189452dccf6bfc9f0855813d4cab...2f83d4eb5ccce4d7da554c4034c1b8f32ae7246b,1,10,1,11,1,2012-10-23 21:36:55,2012-10-22 16:06:47
2f83d4eb5ccce4d7da554c4034c1b8f32ae7246b...5b0d005c1e82afb11aed75018e93e0ae04b39c37,1,11,17,28,10,2012-10-23 21:36:55,2012-10-23 14:48:13
5b0d005c1e82afb11aed75018e93e0ae04b39c37...f1b7d4e75523d839784993b0c47111de832ec523,1,8,3,11,2,2012-10-23 21:36:55,2012-10-23 15:30:10
f1b7d4e75523d839784993b0c47111de832ec523...dfa7c20368965bf7dba7b082bf813d66c6499656,5,1128,922,2050,193,2012-10-23 23:36:05,2012-09-16 04:28:43
dfa7c20368965bf7dba7b082bf813d66c6499656...2b049cb181d18870a26b2dbce4927d6de5e7c418,9,104,47,151,10,2012-10-23 23:36:05,2012-10-16 23:08:39
2b049cb181d18870a26b2dbce4927d6de5e7c418...40020f6e56381b1fc6533aa3e85cf01f568ccaea,4,117,15,132,18,2012-10-23 23:36:46,2012-10-10 20:33:07
40020f6e56381b1fc6533aa3e85cf01f568ccaea...c0355ccbf0a3e242fe2db1427989bcd22311ac4c,16,611,179,790,61,2012-10-23 23:36:53,2012-10-11 18:44:38
c0355ccbf0a3e242fe2db1427989bcd22311ac4c...87204cc9de8578fff716ef1b0bb0b707a0b2d04a,3,75,11,86,15,2012-10-23 23:36:58,2012-10-15 03:48:04
87204cc9de8578fff716ef1b0bb0b707a0b2d04a...591d4580587772e2ac3515bcbe3733bb545205b4,1,5,5,10,5,2012-10-24 03:53:57,2012-10-24 03:53:57
591d4580587772e2ac3515bcbe3733bb545205b4...0faefb1381660deb267088a9f5a9fb2437f7223a,6,32,0,32,14,2012-10-24 04:10:49,2012-10-24 03:45:50
0faefb1381660deb267088a9f5a9fb2437f7223a...1d208b0aacbc0e5b5be7f8fc2bf2522d11b5ecc4,2,8,6,14,3,2012-10-24 04:32:17,2012-10-17 18:32:16
1d208b0aacbc0e5b5be7f8fc2bf2522d11b5ecc4...76c04a7d2d9e94f0147a3ee36ef322926ba22f6c,1,1,1,2,1,2012-10-24 04:32:17,2012-10-18 15:39:12
76c04a7d2d9e94f0147a3ee36ef322926ba22f6c...069deac407e23cefc3bc5db2f29d7be8d7c7a359,2,9,7,16,6,2012-10-24 04:32:17,2012-10-20 23:52:08
069deac407e23cefc3bc5db2f29d7be8d7c7a359...17912f419b77f2f6ebb301054556d5a128f0378d,1,17,11,28,11,2012-10-24 04:32:17,2012-10-21 02:03:33
17912f419b77f2f6ebb301054556d5a128f0378d...e4ca2f53b9c0f646691356fc219ce4a0de252221,1,1,1,2,1,2012-10-24 04:32:17,2012-10-21 02:06:46
e4ca2f53b9c0f646691356fc219ce4a0de252221...1515e478bf3391e90d32f50749e3bc9d6b610240,4,8,7,15,7,2012-10-24 04:32:17,2012-10-21 02:07:46
1515e478bf3391e90d32f50749e3bc9d6b610240...1870df0ee0b3ac232ebc9e9b21f2aef819c33ccd,1,1,1,2,1,2012-10-24 04:32:17,2012-10-21 02:35:02
1870df0ee0b3ac232ebc9e9b21f2aef819c33ccd...e9a32c189d62cbc62c524b3b82d8d14944309d32,3,16,26,42,8,2012-10-24 04:32:17,2012-10-22 15:24:00
e9a32c189d62cbc62c524b3b82d8d14944309d32...cbd392884686bd3a4317e52189f3c23acfaace85,1,5,1,6,1,2012-10-24 04:32:17,2012-10-24 04:31:59
cbd392884686bd3a4317e52189f3c23acfaace85...cb8efcd6a2f05d35655ed9f9b947cc4a99ade8db,1,2,2,4,2,2012-10-24 14:17:22,2012-10-24 13:57:57
cb8efcd6a2f05d35655ed9f9b947cc4a99ade8db...df9bc9ca6193fd028045637360ed2dd4aff760e0,1,6,6,12,1,2012-10-24 16:05:11,2012-10-24 01:19:29
df9bc9ca6193fd028045637360ed2dd4aff760e0...349785edc50d2119cc0071d669a373ead32eee95,3,7,7,14,5,2012-10-24 18:26:41,2012-10-24 18:26:41
349785edc50d2119cc0071d669a373ead32eee95...14912cabeabe1d64246f9caec5c7567b515b0a2b,1,90,90,180,6,2012-10-24 18:55:48,2012-10-24 18:55:48
14912cabeabe1d64246f9caec5c7567b515b0a2b...0d61667c3870e9d0c9e04bd7475773ad3227e4e8,1,14,1,15,2,2012-10-24 19:41:34,2012-10-11 20:16:04
0d61667c3870e9d0c9e04bd7475773ad3227e4e8...892aad0c2fd35985f12b052668f1e37195c17740,61,249,239,488,233,2012-10-24 19:41:34,2012-10-24 17:45:27
892aad0c2fd35985f12b052668f1e37195c17740...4db60cf23b58a7a5e177e69c142ab9e1503a3b1b,1,2,19,21,4,2012-10-24 19:41:34,2012-10-24 17:58:30
4db60cf23b58a7a5e177e69c142ab9e1503a3b1b...b5c8d777741147f5b9b7cfa89b5e69374d5c9d2d,1,21,6,27,3,2012-10-24 19:41:34,2012-10-15 23:42:39
b5c8d777741147f5b9b7cfa89b5e69374d5c9d2d...b9853301c32d9fde04fb9357834b7156ca7577df,4,12,7,19,9,2012-10-24 19:57:08,2012-09-20 21:10:03
b9853301c32d9fde04fb9357834b7156ca7577df...5e456ab8075f74ea9623b9e0fa0d5a552e106478,1,10,1,11,1,2012-10-24 19:57:08,2012-10-16 15:04:18
5e456ab8075f74ea9623b9e0fa0d5a552e106478...457d95645a7118fa2d0f6bf5fc097a9039d55d20,1,5,0,5,1,2012-10-24 19:57:08,2012-10-16 15:05:34
457d95645a7118fa2d0f6bf5fc097a9039d55d20...ac8d2de4e03aea342a281104949263eb4a5dc34a,1,0,2,2,1,2012-10-24 19:57:08,2012-10-16 15:07:51
ac8d2de4e03aea342a281104949263eb4a5dc34a...5b3faedafb53cfe7df1464442d67f7aea6d9a9a1,4,791,171,962,76,2012-10-24 19:59:19,2012-10-16 15:18:54
5b3faedafb53cfe7df1464442d67f7aea6d9a9a1...2a4f6c579ef9af2b55bef451db50b102445277f7,1,1,1,2,1,2012-10-24 20:00:34,2012-10-24 20:00:34
2a4f6c579ef9af2b55bef451db50b102445277f7...da000254d751c7741b996e5f03cdae2ea61ec313,1,1,1,2,1,2012-10-25 01:38:30,2012-10-25 01:38:30
da000254d751c7741b996e5f03cdae2ea61ec313...e7d98273e60b55bf3cff45fe5cf7b75ec5d9f4a3,1,13,7,20,4,2012-10-25 14:06:59,2012-10-25 14:06:59
e7d98273e60b55bf3cff45fe5cf7b75ec5d9f4a3...3ae2388259372c4a6f831e53bf0fc502ab38fc9f,1,10,9,19,2,2012-10-25 19:22:06,2012-10-22 21:39:24
3ae2388259372c4a6f831e53bf0fc502ab38fc9f...794ef53c1347e927adbbc15ea1462b3bd6e2c234,1,1,1,2,1,2012-10-25 19:22:06,2012-10-22 21:49:46
794ef53c1347e927adbbc15ea1462b3bd6e2c234...11fde934bf3250217ad11a4a20bd152245ec8fca,1,2,4,6,2,2012-10-25 19:57:20,2012-10-25 19:23:28
11fde934bf3250217ad11a4a20bd152245ec8fca...84cb0fe0660384370fa5d07b7fe4c9d1c76c82ac,6,7,7,14,7,2012-10-25 23:18:39,2012-10-25 21:07:35
84cb0fe0660384370fa5d07b7fe4c9d1c76c82ac...9bd29481d06d953fda6ececf2db447b90778be32,1,5,2,7,2,2012-10-26 14:43:32,2012-10-26 14:43:32
9bd29481d06d953fda6ececf2db447b90778be32...12da928904c1b1229693f0ed768009fc637f8cb2,7,163,29,192,21,2012-10-26 16:10:19,2012-10-22 22:01:21
12da928904c1b1229693f0ed768009fc637f8cb2...5cbd4765a19ddf48b4f0b061c256c559863cf596,1,0,0,0,0,2012-10-26 16:16:07,2012-10-18 09:18:58
5cbd4765a19ddf48b4f0b061c256c559863cf596...47641cc30b77f80172e1d6de77de8edee6579c7c,1,45,29,74,18,2012-10-26 17:15:31,2012-10-16 22:42:25
47641cc30b77f80172e1d6de77de8edee6579c7c...99418fac8dcb69a99faf9cc7a0b322e8ffd70fe5,1,1,0,1,1,2012-10-26 19:06:24,2012-10-26 19:05:21
99418fac8dcb69a99faf9cc7a0b322e8ffd70fe5...2ef1d63cc5a5a8c05aed7204e867ffa99f03827d,2,6,4,10,6,2012-10-26 19:15:59,2012-10-25 23:16:56
2ef1d63cc5a5a8c05aed7204e867ffa99f03827d...c6c6f4514e2a019ac40c985a94757c1c0a42d6c1,1,36,0,36,1,2012-10-26 21:11:50,2012-10-26 21:11:50
c6c6f4514e2a019ac40c985a94757c1c0a42d6c1...b56566bf0ec3cb00221e8e951b24f47783ec2af3,25,966,569,1535,73,2012-10-26 21:12:21,2012-10-26 21:12:21
c5c32571932e52835e9e7b694c90cc44018505f3...1fcc72f2e6d876b24895ae86dcc192a25fee86d7,2,2,2,4,2,2011-12-01 22:04:22,2011-12-01 22:04:22
1fcc72f2e6d876b24895ae86dcc192a25fee86d7...7b098d0647f80702160079e98a3bd830b98c5d11,1,31,41,72,22,2011-12-01 23:08:19,2011-12-01 23:06:28
6889d1658136c753998b4a408dc8d1a3ec28e3b9...85355c52122be895d4ae1bc966ec0d3339cf39d7,1,7,3,10,1,2012-12-18 16:10:02,2012-12-18 16:10:02
85355c52122be895d4ae1bc966ec0d3339cf39d7...92005d77fdd20e3709b00c6b0040c1cbe6c2126f,7,65,72,137,12,2012-12-18 21:05:25,2012-12-18 21:05:25
6889d1658136c753998b4a408dc8d1a3ec28e3b9...6da0f1c47c5468102b655315c3fe78b4f10737e5,12,220,193,413,121,2012-12-18 14:44:00,2012-12-17 21:10:59
6da0f1c47c5468102b655315c3fe78b4f10737e5...acc9aea88a7a56694ba6d7f51d22b61dfc2a9353,4,70,5,75,6,2012-12-18 15:57:08,2012-12-12 23:40:50
acc9aea88a7a56694ba6d7f51d22b61dfc2a9353...6b46f885aba062ffcddbd6f7cfb2a36e23bbce1d,9,45,31,76,19,2012-12-18 16:00:36,2012-12-18 15:54:41
6b46f885aba062ffcddbd6f7cfb2a36e23bbce1d...95aec02bdeb20e4529c140464996b8b47d9dd7e8,1,12,12,24,2,2012-12-18 16:35:36,2012-12-18 16:35:36
95aec02bdeb20e4529c140464996b8b47d9dd7e8...566cf01bd870036b0dfd4b2babaf414b65de444c,18,314,342,656,143,2012-12-18 16:39:20,2012-11-30 02:16:08
566cf01bd870036b0dfd4b2babaf414b65de444c...2827387e48ca5e41c35b0a061517394f35f56622,13,61,70,131,50,2012-12-18 16:39:20,2012-11-30 18:41:14
2827387e48ca5e41c35b0a061517394f35f56622...6cd748eccdcea47c6413a144f921cd8ec9dfcff4,9,56,70,126,41,2012-12-18 16:39:20,2012-11-30 19:47:49
6cd748eccdcea47c6413a144f921cd8ec9dfcff4...9c07a059fedfe534c890a59d13e0fc6536fd8ee8,9,91,109,200,45,2012-12-18 16:39:20,2012-12-01 01:08:14
9c07a059fedfe534c890a59d13e0fc6536fd8ee8...a8b8f95cf7263f0c58c6347fb9f738b490fea5c5,4,304,1,305,5,2012-12-18 16:39:20,2012-12-02 01:52:01
a8b8f95cf7263f0c58c6347fb9f738b490fea5c5...99d046d0d95c748b414e42ffd37e225d4b4cb05c,7,39,63,102,34,2012-12-18 16:39:20,2012-12-01 01:34:37
99d046d0d95c748b414e42ffd37e225d4b4cb05c...bf7614739eb869fafff8f04297b47edb1bfccc0a,4,391,0,391,5,2012-12-18 16:39:21,2012-12-07 02:05:38
bf7614739eb869fafff8f04297b47edb1bfccc0a...5e91da251e332abc79749c8167b3bdc273e95a54,8,38,70,108,31,2012-12-18 16:39:21,2012-12-07 02:19:28
5e91da251e332abc79749c8167b3bdc273e95a54...fa70853dca0990371cf1fde0a9f86088aa6be4c0,4,463,0,463,5,2012-12-18 16:39:21,2012-12-06 01:00:12
fa70853dca0990371cf1fde0a9f86088aa6be4c0...f2446eaa5a23641da12f8a63f34fc3183e055906,3,73,106,179,48,2012-12-18 16:39:21,2012-12-06 01:04:06
f2446eaa5a23641da12f8a63f34fc3183e055906...213d731ccc2b82e53e64fe8091484649370cb9d3,4,351,1,352,5,2012-12-18 16:39:21,2012-12-06 19:52:51
213d731ccc2b82e53e64fe8091484649370cb9d3...b22f069ac1a494baa7d40db52bdcb49e961eb4ad,3,8,24,32,7,2012-12-18 16:39:21,2012-12-06 20:04:40
b22f069ac1a494baa7d40db52bdcb49e961eb4ad...b2e3587f9cad2c681a236da5702280a4295ca153,3,6,30,36,5,2012-12-18 16:39:21,2012-12-05 21:24:35
b2e3587f9cad2c681a236da5702280a4295ca153...bd9ae50abf96abe78226d827916e366ce5cc9e51,4,262,0,262,5,2012-12-18 16:39:21,2012-12-06 01:25:57
bd9ae50abf96abe78226d827916e366ce5cc9e51...b1845ec73b8e5fbb23f67639f3319bb010df9f0f,3,15,31,46,11,2012-12-18 16:39:21,2012-12-06 01:32:04
b1845ec73b8e5fbb23f67639f3319bb010df9f0f...9631cda23dce21242c1032b4a4c35498b880fe58,5,416,2,418,6,2012-12-18 16:39:21,2012-12-05 22:52:52
9631cda23dce21242c1032b4a4c35498b880fe58...7784598c79b6514c1ebd9fab27ecdc878ef7aea4,3,10,46,56,7,2012-12-18 16:39:21,2012-12-05 23:40:17
7784598c79b6514c1ebd9fab27ecdc878ef7aea4...9b52058086a5b005900b52bd850484ae64cfa97b,16,1,97,98,24,2012-12-18 16:39:21,2012-12-14 02:45:48
9b52058086a5b005900b52bd850484ae64cfa97b...0f4e3a0d74c3d24b0139a36b8a8e049bd7617d79,2,0,50,50,9,2012-12-18 16:47:36,2012-12-18 00:39:16
0f4e3a0d74c3d24b0139a36b8a8e049bd7617d79...c9a849e2b10ad300e0fb4cf3198adfab269a461d,19,102,52,154,34,2012-12-18 17:15:44,2012-12-18 16:39:21
c9a849e2b10ad300e0fb4cf3198adfab269a461d...0a2ca6c3676ed70d87209851de0ab1db355bbb92,5,101,10,111,14,2012-12-18 17:17:46,2012-12-12 20:14:02
0a2ca6c3676ed70d87209851de0ab1db355bbb92...d6e139e0ccbd0f081f7fe7e24e727fc4ef280ea3,1,3,2,5,2,2012-12-18 17:51:09,2012-12-18 16:39:39
d6e139e0ccbd0f081f7fe7e24e727fc4ef280ea3...dc9b65b6709862adcb5de90fc9427ef58271b8d1,1,1,1,2,1,2012-12-18 18:05:01,2012-12-18 18:02:39
dc9b65b6709862adcb5de90fc9427ef58271b8d1...0133fa6fe09720333bc0cd49fea6dba4f284edd5,1,11,12,23,2,2012-12-18 18:17:34,2012-12-18 18:17:34
0133fa6fe09720333bc0cd49fea6dba4f284edd5...1057208cf350f9e9da05a3b79f392edfae0c0338,3,56,2,58,6,2012-12-18 18:34:05,2012-11-28 19:36:29
1057208cf350f9e9da05a3b79f392edfae0c0338...966fa94895fb5526367327c66f284dabbc566a8e,6,69,13,82,10,2012-12-18 18:34:05,2012-07-24 21:29:40
966fa94895fb5526367327c66f284dabbc566a8e...b5dda8be7a21e006a6772739f747f8a5beebc8cc,12,77,28,105,30,2012-12-18 18:34:05,2012-06-19 14:06:56
b5dda8be7a21e006a6772739f747f8a5beebc8cc...37c57aa88ddc84c6af69e2e71354193d9e99c4a4,7,169,159,328,48,2012-12-18 18:54:14,2012-12-11 22:20:39
37c57aa88ddc84c6af69e2e71354193d9e99c4a4...61433a3f7692a8acb5bb385b04dcf51b2ccf5fe8,1,1,1,2,1,2012-12-18 19:10:37,2012-12-18 19:10:37
61433a3f7692a8acb5bb385b04dcf51b2ccf5fe8...d718db426cef14ab4ecccff4d2233f95fed81f82,1,128,0,128,1,2012-12-18 19:11:29,2012-12-18 19:11:23
d718db426cef14ab4ecccff4d2233f95fed81f82...9e2543ec729da2a2176dc374ced0f2d29f723ad6,6,52,15,67,17,2012-12-18 20:03:14,2012-12-18 20:03:14
9e2543ec729da2a2176dc374ced0f2d29f723ad6...68f6dcd2c36f3d888feed5a3b63a4e3cdf2b2138,36,224,253,477,120,2012-12-18 20:34:56,2012-12-18 18:26:26
68f6dcd2c36f3d888feed5a3b63a4e3cdf2b2138...82b51d5ce06e893bebef811b305de95339a994a3,1,2,1,3,2,2012-12-18 20:39:22,2012-12-18 20:12:28
82b51d5ce06e893bebef811b305de95339a994a3...9503b50ba6255119cbfc21cac4d568e3254fb24b,1,2,0,2,1,2012-12-18 20:50:03,2012-12-18 20:45:38
9503b50ba6255119cbfc21cac4d568e3254fb24b...62fb9c0c504fc0e5321e05301f5bcff47c4ce714,4,28,26,54,18,2012-12-18 20:59:33,2012-12-18 19:22:08
62fb9c0c504fc0e5321e05301f5bcff47c4ce714...21f25faa6f9288f88553767dc83244ad00dfc1ec,3,20,23,43,8,2012-12-18 20:59:33,2012-12-18 19:33:25
21f25faa6f9288f88553767dc83244ad00dfc1ec...9000267c5bfffeb1bd289667d56043525b31c05a,1,2,3,5,2,2012-12-18 21:05:42,2012-12-18 19:34:46
9000267c5bfffeb1bd289667d56043525b31c05a...a438069d1f72c07bf4c1544a1d22a0f0464efdda,31,0,0,0,0,2012-12-18 21:19:55,2012-12-18 14:33:36
a438069d1f72c07bf4c1544a1d22a0f0464efdda...1d958b4234b7f6bd2d8923cbddaa39b8d0258a1e,3,0,0,0,0,2012-12-18 21:19:55,2012-12-18 14:53:57
1d958b4234b7f6bd2d8923cbddaa39b8d0258a1e...931a52b487290e51f5382274b14cc407f115b1f1,3,0,0,0,0,2012-12-18 21:19:55,2012-12-18 14:55:43
931a52b487290e51f5382274b14cc407f115b1f1...61393540a46511fbc03998935af6b1319763d4b9,4,0,0,0,0,2012-12-18 21:19:55,2012-12-18 14:59:22
61393540a46511fbc03998935af6b1319763d4b9...81b797b2844a0463de9374470aa09b0ddb29b642,1,0,0,0,0,2012-12-18 21:19:55,2012-12-18 15:47:06
81b797b2844a0463de9374470aa09b0ddb29b642...9c1a0b66fd7256d8b99bf0171bdad09fc05f7b40,1,11,11,22,1,2012-12-18 21:53:57,2012-12-18 21:53:57
9c1a0b66fd7256d8b99bf0171bdad09fc05f7b40...67ec3ed7d7550cf5d39458c5a6026568a802557a,2,11,2,13,2,2012-12-18 22:00:24,2012-11-27 23:48:36
67ec3ed7d7550cf5d39458c5a6026568a802557a...0a07acb847cc6e7bc9707a951b2292e701d2d9a4,11,1704,586,2290,132,2012-12-18 22:13:43,2012-09-21 22:51:03
0a07acb847cc6e7bc9707a951b2292e701d2d9a4...3bf6eed7020e0e9dec83f895a4718ca962ce2365,1,1,1,2,1,2012-12-18 22:16:43,2012-12-18 22:16:43
55d24c02108e196f7842ca68bf60e14001154b1c...529567ada46e3313c9385e046209ed0a3d4857e5,5,112,4,116,12,2012-11-05 19:17:40,2012-11-05 18:08:58
529567ada46e3313c9385e046209ed0a3d4857e5...5afa29d92ade566212d3edd9c688ab052ab233df,5,10,10,20,10,2012-11-05 19:17:40,2012-11-05 18:55:04
5afa29d92ade566212d3edd9c688ab052ab233df...68a6aa896cc5e57b30772aaa96cfc115d01b2d42,1,1,1,2,1,2012-11-05 19:25:11,2012-11-05 18:29:09
68a6aa896cc5e57b30772aaa96cfc115d01b2d42...a3bba74665e0b03fd74612dabaaeac284f2a8bb4,5,4,25,29,7,2012-11-05 19:25:11,2012-11-05 19:07:45
a3bba74665e0b03fd74612dabaaeac284f2a8bb4...8afcdc545d5d756900d6ffff43c9e06f90318bff,1,3,3,6,3,2012-11-05 19:35:52,2012-11-05 18:41:54
8afcdc545d5d756900d6ffff43c9e06f90318bff...dcc1f2404856344885a3f5b1ef25c40ea3a105fb,1,1,0,1,1,2012-11-05 19:57:09,2012-11-02 19:41:17
dcc1f2404856344885a3f5b1ef25c40ea3a105fb...b500d17c347044b6d38c135c7edc142e3ac68658,12,837,5,842,15,2012-11-05 20:31:27,2012-11-02 14:31:42
b500d17c347044b6d38c135c7edc142e3ac68658...b6ce540c7c5e6c23835a0b7f05dd5b697fb0ecc7,1,1,1,2,1,2012-11-05 21:16:22,2012-11-05 21:13:28
b6ce540c7c5e6c23835a0b7f05dd5b697fb0ecc7...df0c97f16fa234014565b5ce0c2f6a4388d18d9f,2,12,15,27,5,2012-11-05 21:17:41,2012-11-05 20:51:29
df0c97f16fa234014565b5ce0c2f6a4388d18d9f...f2104328d07610e8512e933d52a7af716e03b5dc,10,331,189,520,50,2012-11-05 22:36:27,2012-11-01 19:35:11
f2104328d07610e8512e933d52a7af716e03b5dc...73b14c23aecb50cc17c0043970c46cb1aba3ff29,6,257,268,525,56,2012-11-05 22:36:27,2012-11-03 20:55:29
73b14c23aecb50cc17c0043970c46cb1aba3ff29...389613bb9727d1594f10ce1abe50a048fa062460,3,107,96,203,12,2012-11-05 22:36:35,2012-11-03 22:37:21
389613bb9727d1594f10ce1abe50a048fa062460...0785b7a0a33c56a5915121ec87949304dd55052c,23,588,502,1090,223,2012-11-06 00:10:16,2012-10-26 21:49:50
0785b7a0a33c56a5915121ec87949304dd55052c...090f250d7f42bb98dd9a52bd6fc3f47fe9d7d241,2,143,18,161,24,2012-11-06 14:03:17,2012-11-06 14:03:17
090f250d7f42bb98dd9a52bd6fc3f47fe9d7d241...48ee27067f024b23066070a7e1d5acd3e91960ee,9,16,16,32,16,2012-11-06 15:53:40,2012-09-27 23:42:56
48ee27067f024b23066070a7e1d5acd3e91960ee...7fe30630080c58565c3471efbfdd1e62694a79ef,1,8,3,11,1,2012-11-06 15:53:52,2012-10-18 23:37:06
7fe30630080c58565c3471efbfdd1e62694a79ef...175f3ee41bb07f9998024fe4191074b102e7e8e1,1,4,3,7,2,2012-11-06 16:30:27,2012-11-05 19:51:06
175f3ee41bb07f9998024fe4191074b102e7e8e1...e541866fa44c13c82df51131b2075739f9d448d9,2,27,2,29,5,2012-11-06 16:30:27,2012-11-06 15:54:08
e541866fa44c13c82df51131b2075739f9d448d9...116af887d49190ebffbe2f4ad73e1275ee8c1d11,3,28,5,33,4,2012-11-06 16:35:11,2012-11-06 16:34:45
116af887d49190ebffbe2f4ad73e1275ee8c1d11...ca95a09c6f938db7c6ba69e8d5cac0eb378ddc79,1,1,1,2,1,2012-11-06 18:16:13,2012-11-06 18:16:01
a8d6bcf5f9758213a5de82d2e54868ebb41d0c91...7cbcb41dc0f759fbf70f80c9d440f0a1fe92efa7,3,20,6,26,6,2012-11-15 17:16:51,2012-11-14 19:58:21
7cbcb41dc0f759fbf70f80c9d440f0a1fe92efa7...522fe6ce670f52714b035117ff4d346657e56d90,1,6,0,6,2,2012-11-15 17:17:38,2012-11-14 23:38:21
522fe6ce670f52714b035117ff4d346657e56d90...3266ccff2ba64391f574bc3f35c11f132642bd8a,2,9,4,13,2,2012-11-15 18:50:25,2012-11-15 16:55:52
3266ccff2ba64391f574bc3f35c11f132642bd8a...28fec164384288a10815c34855dd7e867fbfef4a,4,194,53,247,20,2012-11-15 18:56:02,2012-11-14 20:56:30
28fec164384288a10815c34855dd7e867fbfef4a...f3121bdcd1e330e49092287faa6b70898c973eca,2,20,14,34,9,2012-11-15 18:59:38,2012-11-15 18:58:46
f3121bdcd1e330e49092287faa6b70898c973eca...fa283ee1d6a4900497753e807a678905d029c540,2,9,9,18,8,2012-11-15 18:59:38,2012-11-15 18:59:20
fa283ee1d6a4900497753e807a678905d029c540...9eb6b3a6a83164f20603317fa05e13ecb689e95b,1,7,5,12,2,2012-11-15 20:29:17,2012-11-15 20:29:17
0027639682ee13763b75f15007710f371574131c...80aaf5e73a4223b506c1630d6a7f3959acb3d840,2,21,3,24,4,2012-11-14 05:17:52,2012-11-14 05:17:52
80aaf5e73a4223b506c1630d6a7f3959acb3d840...0078f9cb5084e049f06a58fafa6dc6330cc2c076,1,16,0,16,1,2012-11-14 06:02:04,2012-11-14 04:59:10
0078f9cb5084e049f06a58fafa6dc6330cc2c076...e7c8dbba911455fdd0ed31361a94c1c9b8d0103d,1,29,10,39,7,2012-11-14 06:02:04,2012-11-12 23:21:50
e7c8dbba911455fdd0ed31361a94c1c9b8d0103d...ae33d54a79a0c7bf6dde13d49353351c6a68fc23,12,672,24,696,77,2012-11-14 11:39:28,2012-11-14 11:39:28
ae33d54a79a0c7bf6dde13d49353351c6a68fc23...789b09ef9bb6bb72a53953a364173f2aa5e48003,4,0,16,16,7,2012-11-14 15:24:01,2012-11-14 15:24:01
7b098d0647f80702160079e98a3bd830b98c5d11...fc7c2f746b8d26440b10a9163b5aa2dedef57781,1,2,1,3,2,2011-12-01 23:19:24,2011-12-01 23:19:24
7b098d0647f80702160079e98a3bd830b98c5d11...d0027e0028a9e57fbff5dac04ae7eb9265f5a5b7,1,1,1,2,1,2011-12-01 23:16:58,2011-12-01 23:16:58
868495979724ea17ebb25ecff106ac159680c5a8...4a69edd1a7813cb9fb8ab2223c5ab5fbcc69a23e,1,2,0,2,2,2012-12-19 15:25:18,2012-12-19 15:25:18
4a69edd1a7813cb9fb8ab2223c5ab5fbcc69a23e...379de413a0b210fe912962c2c1a6a15e14f3579d,1,3,0,3,1,2012-12-19 15:25:22,2012-12-19 15:25:22
379de413a0b210fe912962c2c1a6a15e14f3579d...15178dbe4fadacee8cfbe3f7a111c0368b756ed9,1,1,0,1,1,2012-12-19 15:38:06,2012-12-19 15:38:06
15178dbe4fadacee8cfbe3f7a111c0368b756ed9...43a4b0c5ce2b0f4fa460d371f4acc8dab989d038,6,73,14,87,11,2012-12-19 16:17:59,2012-12-19 16:17:59
43a4b0c5ce2b0f4fa460d371f4acc8dab989d038...af85453f8185f91612956aca991ffe07032b7227,1,2,4,6,2,2012-12-19 16:18:26,2012-09-11 15:04:43
af85453f8185f91612956aca991ffe07032b7227...e1f0d07124739ca07b227e17c45b28b4183e71e4,1,2,1,3,1,2012-12-19 16:18:46,2012-09-10 21:26:02
e1f0d07124739ca07b227e17c45b28b4183e71e4...24e46882948452b09943052a411c8f10b1aefb5f,1,0,4,4,2,2012-12-19 16:23:43,2012-09-10 14:53:03
24e46882948452b09943052a411c8f10b1aefb5f...ae77309276e82f16904302880dbdc99c9af48ad0,4,29,0,29,4,2012-12-19 16:34:33,2012-12-18 21:49:36
ae77309276e82f16904302880dbdc99c9af48ad0...7f065fe11da13ea6cd51f4b86efd5369fecfaaba,2,22,27,49,11,2012-12-19 17:26:55,2012-12-19 17:18:36
7f065fe11da13ea6cd51f4b86efd5369fecfaaba...df79de82bba9d41334003c07fd842cc949453a08,1,0,23,23,1,2012-12-19 17:26:55,2012-12-18 19:47:38
df79de82bba9d41334003c07fd842cc949453a08...168d46df5887cfa922c34b990e3ee1dd433c2768,14,21,82,103,20,2012-12-19 17:26:55,2012-12-18 01:12:03
168d46df5887cfa922c34b990e3ee1dd433c2768...8f36226f15ff59b9febabb1030ee9654057ae694,2,3,71,74,6,2012-12-19 17:26:55,2012-12-19 17:25:54
8f36226f15ff59b9febabb1030ee9654057ae694...8434261c0c446935ca81a5443003fc8203f5a57e,7,0,41,41,7,2012-12-19 18:09:19,2012-12-09 13:11:21
8434261c0c446935ca81a5443003fc8203f5a57e...cb0a61089a26e690e266d97f883adcd885325c92,3,6,0,6,5,2012-12-19 18:22:08,2012-12-19 18:20:38
cb0a61089a26e690e266d97f883adcd885325c92...897f17447eb1374ff01ceb7ce2c53fa5dab12fc0,9,1,55,56,12,2012-12-19 18:27:45,2012-12-19 18:09:23
897f17447eb1374ff01ceb7ce2c53fa5dab12fc0...133677e7186540ac36a3a1502dd46d108bca24ee,7,1,31,32,10,2012-12-19 18:27:45,2012-12-19 18:22:38
133677e7186540ac36a3a1502dd46d108bca24ee...d2adeeb4a74dac9f41280d42635fa60d2d58a864,27,302,140,442,109,2012-12-19 19:39:17,2012-12-14 20:05:24
d2adeeb4a74dac9f41280d42635fa60d2d58a864...2a73781c774866d8ba30215f2818896c475a8cbb,4,73,27,100,15,2012-12-19 22:05:31,2012-12-19 22:05:31
2a73781c774866d8ba30215f2818896c475a8cbb...ca6558f3fb779cba5720d1c30ef5c216959fcec8,4,29,19,48,8,2012-12-19 22:11:31,2012-12-17 19:37:37
ca95a09c6f938db7c6ba69e8d5cac0eb378ddc79...890bc3daf16954c78625f43f28ed535bbe0cec96,3,7,7,14,5,2012-11-06 18:44:03,2012-11-06 18:44:03
ca95a09c6f938db7c6ba69e8d5cac0eb378ddc79...661bee981c0b3898d911b76fb9fba1430e608ab2,1,4,4,8,3,2012-11-06 18:31:49,2012-11-06 11:33:55
661bee981c0b3898d911b76fb9fba1430e608ab2...8727da688a8e2ab005dd8d0d5e11504fc354885b,1,2,2,4,1,2012-11-06 18:36:39,2012-11-06 18:36:27
8727da688a8e2ab005dd8d0d5e11504fc354885b...e34b5106ced41b2f3775d1d28c3776b12ef0c595,1,5,1,6,4,2012-11-06 18:38:41,2012-11-06 15:39:23
e34b5106ced41b2f3775d1d28c3776b12ef0c595...e29a1916f78408fde55596f3b769dd7adc623d93,1,2,2,4,2,2012-11-06 18:42:18,2012-11-06 11:39:34
9eb6b3a6a83164f20603317fa05e13ecb689e95b...97e0f2e4d8a865ee72aea03d86bf8c4aec067f71,7,1159,5,1164,10,2012-11-15 22:39:03,2012-11-15 22:10:39
97e0f2e4d8a865ee72aea03d86bf8c4aec067f71...1915fc9984c80c04180724f9f46a05fcf15b6933,6,761,1,762,9,2012-11-15 23:00:10,2012-11-15 22:56:25
789b09ef9bb6bb72a53953a364173f2aa5e48003...91f0ccf38d7bd481235455872a692cff6e949066,2,8,17,25,6,2012-11-14 19:44:06,2012-11-14 19:30:00
c6228e1970fc436602b5ea1f317e3cb7588d516b...c8e45cce25d4de4e877e8179f21d8c93166bc964,4,51,19,70,16,2011-12-02 01:42:13,2011-12-02 01:42:13
c8e45cce25d4de4e877e8179f21d8c93166bc964...3588c09d3572ca1aedfda6e79dc5bf0883eac686,2,12,13,25,5,2011-12-02 13:49:34,2011-11-22 14:39:49
3588c09d3572ca1aedfda6e79dc5bf0883eac686...4c58b9c182d1c8b23591ae9d9d1d5260acfc36a4,3,10,10,20,7,2011-12-02 13:59:48,2011-11-16 22:36:55
4c58b9c182d1c8b23591ae9d9d1d5260acfc36a4...35f1a722c861affafb3862b9784d525306309d61,2,9,11,20,3,2011-12-02 15:30:50,2011-12-02 15:27:17
35f1a722c861affafb3862b9784d525306309d61...460294e5067d4230ef25997f1503c842a9e1c515,1,25,0,25,1,2011-12-02 16:26:00,2011-12-02 16:26:00
460294e5067d4230ef25997f1503c842a9e1c515...0f45cf84dc6af9a03a66d1f3e61c487635f27b0e,1,8,14,22,3,2011-12-02 17:02:56,2011-12-02 17:02:56
0f45cf84dc6af9a03a66d1f3e61c487635f27b0e...1722630e898593af23e77fcbef2cad05c895dec5,3,18,16,34,8,2011-12-02 18:10:36,2011-12-02 18:10:21
1722630e898593af23e77fcbef2cad05c895dec5...80f693ed6e49e81e02a4bb8734b245c93d458ada,1,7,4,11,1,2011-12-02 19:17:24,2011-12-02 19:17:24
80f693ed6e49e81e02a4bb8734b245c93d458ada...9b522f2f41b03275928093fa54504be0bb73645e,1,2,10,12,5,2011-12-02 20:08:37,2011-12-02 20:07:56
9b522f2f41b03275928093fa54504be0bb73645e...5d8132786c6f6dd445c66779e94c4dfde3db6942,1,81,83,164,74,2011-12-02 20:43:19,2011-12-02 20:41:24
5d8132786c6f6dd445c66779e94c4dfde3db6942...c41841daa377747524a6050fa35fabd83c8f37e9,2,5,1,6,3,2011-12-02 21:51:30,2011-12-02 21:50:38
c41841daa377747524a6050fa35fabd83c8f37e9...1836bcd19b7039fe9e5bb8ab77a583e83c6c8bc6,1,56,0,56,1,2011-12-02 22:19:28,2011-12-02 22:19:28
1836bcd19b7039fe9e5bb8ab77a583e83c6c8bc6...a24834713d4e25434a7af6c8810f4d9d1c46f43c,1,1,1,2,1,2011-12-03 03:45:46,2011-12-03 03:45:46
a24834713d4e25434a7af6c8810f4d9d1c46f43c...04dd30ca5d967f7da3c3ed647433a3f4f479e0db,1,9,1,10,1,2011-12-03 03:58:10,2011-12-03 03:58:10
04dd30ca5d967f7da3c3ed647433a3f4f479e0db...c3f882cae9d537a943bed9a2ecdfe9c88209b595,1,7,2,9,1,2011-12-03 05:13:18,2011-12-03 05:12:34
c3f882cae9d537a943bed9a2ecdfe9c88209b595...a094d5ff9169043cce5bba3a9270a8585443bcbd,1,9,2,11,2,2011-12-03 13:36:49,2011-12-03 13:36:30
a094d5ff9169043cce5bba3a9270a8585443bcbd...2930d6f2ede8f4c17850a91fa05879e4d5ddfbb0,9,18,16,34,17,2011-12-03 13:51:32,2011-12-03 13:51:32
2930d6f2ede8f4c17850a91fa05879e4d5ddfbb0...e8ff8e9784b76e0472de25f3c95a4df777d66f7f,4,26,18,44,17,2011-12-03 14:02:00,2011-12-03 14:02:00
ca6558f3fb779cba5720d1c30ef5c216959fcec8...58c18a5eb7bd05e50adac43a39f24f625f41cd43,7,109,6,115,15,2012-12-19 23:09:29,2012-12-19 22:26:00
58c18a5eb7bd05e50adac43a39f24f625f41cd43...77a94d42d38bbfd45c7e14e6e280735a4f835530,9,0,89,89,14,2012-12-20 00:20:21,2012-12-19 20:15:48
77a94d42d38bbfd45c7e14e6e280735a4f835530...a87855d8b537175c2cb47251369f0d6a2149489d,2,12,0,12,3,2012-12-20 03:19:52,2012-12-19 18:24:05
a87855d8b537175c2cb47251369f0d6a2149489d...4be4883faac46fbe45ec65c5ec4e9a93ddaf85e0,2,4,5,9,5,2012-12-20 03:19:52,2012-12-19 19:45:07
4be4883faac46fbe45ec65c5ec4e9a93ddaf85e0...f9817a6cf64bdba8e1e1cef30a798110df746b58,7,39,40,79,13,2012-12-20 03:19:52,2012-12-20 03:15:03
f9817a6cf64bdba8e1e1cef30a798110df746b58...c49f0d43433ea41d16d27916aa119cbbb615e730,1,3,1,4,1,2012-12-20 03:19:52,2012-12-20 03:19:18
c49f0d43433ea41d16d27916aa119cbbb615e730...a266c93faa2bea00141b743a7dcd4635aa2d0b15,3,21,4,25,11,2012-12-20 03:47:25,2012-12-20 03:47:25
a266c93faa2bea00141b743a7dcd4635aa2d0b15...445588bba6d4684730567592eaf22857f6ae72d8,1,11,6,17,6,2012-12-20 03:54:40,2012-12-20 03:54:40
445588bba6d4684730567592eaf22857f6ae72d8...adc44996ffdedbc549d4c99c723bf5f162f62c77,1,1,1,2,1,2012-12-20 06:43:10,2012-12-20 06:43:10
adc44996ffdedbc549d4c99c723bf5f162f62c77...d74ed653b484fa707af411a918bb763a1bdd6464,12,4674,113,4787,135,2012-12-20 10:41:03,2012-12-18 22:23:19
d74ed653b484fa707af411a918bb763a1bdd6464...61659ebd62559c840a1df22ce9910d6a94cab5af,4,18,0,18,12,2012-12-20 16:59:59,2012-12-20 16:59:59
ca6558f3fb779cba5720d1c30ef5c216959fcec8...6c71d937eaa1599d7a233d368d7a9d57c3cf7d4a,3,219,0,219,4,2012-12-19 22:11:31,2012-12-19 18:41:05
6c71d937eaa1599d7a233d368d7a9d57c3cf7d4a...e223993deff1dfd1f054acd01c29759b56a9afb1,6,76,5,81,9,2012-12-19 22:11:31,2012-12-19 19:02:40
8400c07cc9d3dbd3d1d352e75871cd964cd39211...32f2b9b4967af5efef63ca8183ee3be5da5b1ee0,8,5,12,17,8,2012-11-06 19:40:06,2012-11-06 16:29:00
32f2b9b4967af5efef63ca8183ee3be5da5b1ee0...449f8502943557fab1f13e4add93d808e74c68dd,4,293,0,293,5,2012-11-06 19:40:06,2012-11-06 18:03:56
449f8502943557fab1f13e4add93d808e74c68dd...d6b3183ffdce930ca31772bb59bc22be5d9b3f26,11,134,46,180,41,2012-11-06 20:26:34,2012-11-06 01:58:00
d6b3183ffdce930ca31772bb59bc22be5d9b3f26...f573131724d4ef89525849edaf946e681c67aa8d,7,37,89,126,22,2012-11-06 20:26:34,2012-11-06 19:58:34
f573131724d4ef89525849edaf946e681c67aa8d...8e606af7b04e9a1912310a631a6e470fc8bf14f2,2,7,13,20,3,2012-11-06 20:26:34,2012-11-06 20:00:26
8e606af7b04e9a1912310a631a6e470fc8bf14f2...84efa4ffb7cf7b91dacd5a533b7104c7bb48e596,5,13,23,36,13,2012-11-06 20:26:34,2012-11-06 20:25:38
84efa4ffb7cf7b91dacd5a533b7104c7bb48e596...6532e492ca1930b563d8f920e0fa37226e32bd6d,2,16,4,20,9,2012-11-06 21:42:52,2012-11-06 21:42:29
6532e492ca1930b563d8f920e0fa37226e32bd6d...dfd0efcdf9aaed1e0457b492e9926a38857e3ef6,1,7,7,14,3,2012-11-06 21:58:24,2012-11-06 21:58:24
dfd0efcdf9aaed1e0457b492e9926a38857e3ef6...8ee10017eed4813af97a0fc82dcc9b3f3d8e3b0c,1,27,44,71,23,2012-11-06 22:22:35,2012-11-06 22:22:35
8ee10017eed4813af97a0fc82dcc9b3f3d8e3b0c...b0b7a8410d15ff394c321a70932843f51969a8ef,2,19,6,25,6,2012-11-06 22:39:56,2012-11-06 22:39:53
77a4ea50583e94666091621519f26f5c5205f16f...e8cee07ef063b849e89b507dbcb618d48b7cd2fe,1,3,1,4,1,2012-11-16 00:31:27,2012-11-16 00:31:27
77a4ea50583e94666091621519f26f5c5205f16f...a9112c97febba32fc89bf950079400b26b0b035c,1,2,2,4,2,2012-11-16 00:01:10,2012-11-15 23:53:00
cd37fd3ebd5397539d25de6238420519a087f1c3...b787da9413a7e698efb3706246fe6c4e4352c461,2,8,0,8,2,2012-11-14 20:54:47,2012-11-13 22:04:51
e8ff8e9784b76e0472de25f3c95a4df777d66f7f...b86c65abc2ad7b6d58d46d89a6572b1574754408,3,3,45,48,5,2011-12-03 14:58:50,2011-12-03 14:58:50
e8ff8e9784b76e0472de25f3c95a4df777d66f7f...c67031b35dc7f2d535c0b9f7d101867432796493,1,3,1,4,2,2011-12-03 14:45:11,2011-12-03 14:45:11
d920d6bf42a45926da0909854fe72e1d391e1611...f02beea38e12b79fc10afcf2b3d39a003b3c3821,4,1,25,26,5,2012-12-20 17:48:07,2012-12-19 22:49:20
f02beea38e12b79fc10afcf2b3d39a003b3c3821...f018e923858a63c33d8a2be39b44ce2d51bb330f,4,4,6,10,6,2012-12-20 17:48:07,2012-12-19 22:55:21
f018e923858a63c33d8a2be39b44ce2d51bb330f...1416d664cb92f44ca8d2b0da17a1434ef9e6df8a,1,1,0,1,1,2012-12-20 19:32:29,2012-12-20 19:32:29
1416d664cb92f44ca8d2b0da17a1434ef9e6df8a...aa8069ec1a003b98f14396b2b0dc91194e867647,4,26,0,26,8,2012-12-20 20:15:13,2012-12-20 18:49:37
aa8069ec1a003b98f14396b2b0dc91194e867647...fb16940fbade2e661548a43e19f9345daa41d96c,2,1,15,16,2,2012-12-20 20:15:13,2012-12-20 18:51:27
fb16940fbade2e661548a43e19f9345daa41d96c...458796c7cca9f299ee2f23b4dec25162d3235b29,1,2,0,2,1,2012-12-20 20:40:47,2012-12-20 20:08:37
458796c7cca9f299ee2f23b4dec25162d3235b29...09acb35f3d09621ce2df9b099ddcb5db14fa0e1e,15,38,63,101,52,2012-12-20 20:53:31,2012-12-19 21:34:22
09acb35f3d09621ce2df9b099ddcb5db14fa0e1e...3ec68156685a6119163cefd2b4a3c5184444fe53,1,8,0,8,2,2012-12-20 20:59:21,2012-12-20 20:59:05
3ec68156685a6119163cefd2b4a3c5184444fe53...be3108439423c334fb7f5eb835f9c41264390b39,2,3,3,6,2,2012-12-20 21:08:47,2012-12-20 21:08:47
be3108439423c334fb7f5eb835f9c41264390b39...b0b3dbeb3ffc716aeceba0beb889eacef8cdc47e,1,6,1,7,1,2012-12-20 21:10:11,2012-12-20 21:07:06
b0b3dbeb3ffc716aeceba0beb889eacef8cdc47e...429d1a8f670a6f29975f16a1465044f677656bd5,4,26,93,119,11,2012-12-20 21:27:24,2012-12-20 21:25:57
429d1a8f670a6f29975f16a1465044f677656bd5...88cac755218b78e0becde00285420f87b56227ba,2,0,58,58,3,2012-12-20 21:49:22,2012-12-19 21:19:09
88cac755218b78e0becde00285420f87b56227ba...d978f7f0ea41146dc60a7c0a0e7d1de768a296a7,1,4,2,6,2,2012-12-20 21:49:22,2012-12-20 20:46:21
d978f7f0ea41146dc60a7c0a0e7d1de768a296a7...4a148905f94ed24c11a1e15b032b43248a01413b,2,5,5,10,5,2012-12-20 21:49:23,2012-12-20 21:47:35
4a148905f94ed24c11a1e15b032b43248a01413b...fdbf689f653c3dd203c5f57372dc1859d31600bc,1,1,1,2,1,2012-12-21 00:18:12,2012-12-21 00:18:12
fdbf689f653c3dd203c5f57372dc1859d31600bc...4f6a3339782456946d9423cb39ef9a243a76c4e4,1,10,2,12,2,2012-12-21 00:36:23,2012-12-21 00:08:24
4f6a3339782456946d9423cb39ef9a243a76c4e4...81da4ab776af02af57727907e6d696afbda03682,5,7,9,16,7,2012-12-21 00:36:23,2012-12-20 21:54:21
81da4ab776af02af57727907e6d696afbda03682...3c7a4dda12b165e14a8458c7e502b34537d20ab9,2,51,74,125,9,2012-12-21 00:36:23,2012-12-20 22:58:00
3c7a4dda12b165e14a8458c7e502b34537d20ab9...fddb21d387a63e9a38fbeb006ca40978b32de455,3,6,18,24,6,2012-12-21 00:36:23,2012-12-20 19:53:20
fddb21d387a63e9a38fbeb006ca40978b32de455...d7503f310907f8b7c98537617515d7387ade21e4,2,0,31,31,5,2012-12-21 00:36:23,2012-12-20 20:02:39
d7503f310907f8b7c98537617515d7387ade21e4...bbe244c4c8f3250f3215e4c7059db086b6049fbc,5,1,46,47,8,2012-12-21 05:01:55,2012-12-20 19:49:27
bbe244c4c8f3250f3215e4c7059db086b6049fbc...b1e480ea7c451a7558f04d2c055b7ef19c3e3042,4,62,60,122,8,2012-12-21 05:01:55,2012-12-20 20:47:29
b1e480ea7c451a7558f04d2c055b7ef19c3e3042...9291e8f4f875fc66ea53b6c365714cfe02a7c490,1,12,0,12,1,2012-12-21 05:01:55,2012-12-21 02:35:23
9291e8f4f875fc66ea53b6c365714cfe02a7c490...f251438243be73cae48d118983fc9bc001d8d2ca,6,67,59,126,17,2012-12-21 05:01:55,2012-12-21 05:01:20
f251438243be73cae48d118983fc9bc001d8d2ca...de35f62b1a1bfa58eeb1056f150561af8674c605,2,4,3,7,4,2012-12-21 06:15:01,2012-12-21 06:15:01
de35f62b1a1bfa58eeb1056f150561af8674c605...5bf0b0bc360b9be0ecc5b8c7ebec1b5fe8ae4cb3,1,1,0,1,1,2012-12-21 15:37:23,2012-12-21 15:36:48
5bf0b0bc360b9be0ecc5b8c7ebec1b5fe8ae4cb3...e6b9a252c4155b0fdf629dd0f0e1bce99b67edc0,7,58,56,114,49,2012-12-21 15:37:23,2012-12-21 15:36:59
e6b9a252c4155b0fdf629dd0f0e1bce99b67edc0...b3daf37dc9cd3c679f6d108dd7f1322b7428455d,1,1,1,2,1,2012-12-21 16:28:51,2012-12-21 16:28:51
b3daf37dc9cd3c679f6d108dd7f1322b7428455d...dc16c76a437dcb975e8db970296adaf2ed720e7e,2,7,2,9,2,2012-12-21 16:31:00,2012-12-21 15:57:08
dc16c76a437dcb975e8db970296adaf2ed720e7e...f8b0a29bdc1fe31d09d037c637b9e3ad7a62a282,28,133,133,266,133,2012-12-21 16:31:00,2012-12-21 16:12:56
f8b0a29bdc1fe31d09d037c637b9e3ad7a62a282...4372bc82d86d42c0ebaae60586184e9b0ed6cbcc,4,4,4,8,4,2012-12-21 16:58:42,2012-12-21 16:58:42
4372bc82d86d42c0ebaae60586184e9b0ed6cbcc...bb8b3e59cf44c891fff4867250bfd85cc6070bce,2,2,11,13,3,2012-12-21 17:41:28,2012-12-21 16:07:17
bb8b3e59cf44c891fff4867250bfd85cc6070bce...925f701ace23755b36e428f1dce332a522805463,2,8,4,12,7,2012-12-21 17:43:33,2012-12-20 23:07:39
925f701ace23755b36e428f1dce332a522805463...a7d5f6fa9d14ed29d42f531074e5014fc8dd78a0,3,87,0,87,3,2012-12-21 18:00:48,2012-12-21 01:34:48
a7d5f6fa9d14ed29d42f531074e5014fc8dd78a0...ec846a5f38699bacece205d920a863b6944ebf87,3,20,17,37,12,2012-12-21 18:11:48,2012-12-21 00:08:34
ec846a5f38699bacece205d920a863b6944ebf87...cb015fbf94cacf909ce4374ec90be1d2a055fee3,7,316,9,325,12,2012-12-21 18:17:38,2012-12-21 00:10:26
cb015fbf94cacf909ce4374ec90be1d2a055fee3...aee475b5babbe42fecc638091dbc425fddddf813,1,0,8,8,1,2012-12-21 18:28:10,2012-12-19 19:39:54
aee475b5babbe42fecc638091dbc425fddddf813...83e89860d8355b65716c044c1bf047ea2d6b8c16,6,116,4,120,10,2012-12-21 18:45:59,2012-12-21 18:44:00
83e89860d8355b65716c044c1bf047ea2d6b8c16...fbdadd06ff07109cc5231955c3a5bbeb268d80a2,1,4,0,4,4,2012-12-21 18:59:38,2012-12-21 18:59:38
fbdadd06ff07109cc5231955c3a5bbeb268d80a2...b207726d5587d3ec82e940681fa7f5047066b40a,14,43,43,86,41,2012-12-21 19:37:46,2012-12-21 01:46:35
b207726d5587d3ec82e940681fa7f5047066b40a...0b48bffd8417f87201ab44f2c7b00cf5f77001e4,1,3,1,4,2,2012-12-21 19:41:37,2012-12-21 01:16:06
0b48bffd8417f87201ab44f2c7b00cf5f77001e4...63bceed94b36e41b38b0ddfc35f09dd8b7837e3f,9,5,27,32,10,2012-12-21 19:42:08,2012-12-21 02:13:58
63bceed94b36e41b38b0ddfc35f09dd8b7837e3f...e5011b33e5f8750b5bf8435442f3b17bb36e500f,2,15,6,21,2,2012-12-21 20:12:19,2012-12-21 20:12:19
e5011b33e5f8750b5bf8435442f3b17bb36e500f...510dc00e63a9e33735f1d3afe21c4e5c5cd0077b,9,524,506,1030,169,2012-12-21 20:57:06,2012-12-21 20:57:06
510dc00e63a9e33735f1d3afe21c4e5c5cd0077b...0950dfc242a2a04cf9fe1b680cca718d645939ad,52,5029,615,5644,133,2012-12-21 21:05:09,2012-12-19 20:23:57
0967d3fb9e6602974d832116289b8fe92ba76971...27a846ff3112521e0e0a58ea902d962663e67597,1,6,6,12,5,2012-11-16 05:55:10,2012-11-16 05:55:10
27a846ff3112521e0e0a58ea902d962663e67597...d177155d33f7899afb68e3360853b81093a4772e,2,0,8,8,2,2012-11-16 14:34:08,2012-11-16 14:34:08
d177155d33f7899afb68e3360853b81093a4772e...61ddf5889de7a3768be43d165d975918cca304f5,1,2,0,2,2,2012-11-16 14:45:54,2012-11-16 14:45:54
61ddf5889de7a3768be43d165d975918cca304f5...72e82c6c1ed149bdabc8de4207c69856f3f7e86e,3,77,24,101,16,2012-11-16 19:38:39,2012-11-16 19:38:39
72e82c6c1ed149bdabc8de4207c69856f3f7e86e...79f71926822200c13ae9a69a7481b6f594a0db42,1,1,1,2,1,2012-11-16 19:46:20,2012-11-16 19:46:20
79f71926822200c13ae9a69a7481b6f594a0db42...b65f2288159bd5a61726e9f0bf6fe0c2735cfbe4,1,1,0,1,1,2012-11-16 19:49:12,2012-11-16 19:49:12
b65f2288159bd5a61726e9f0bf6fe0c2735cfbe4...a188be8e82106856ac3812ea101da41825983bd3,2,11,0,11,2,2012-11-16 19:50:45,2012-11-16 17:59:21
a188be8e82106856ac3812ea101da41825983bd3...ef604e29ee24e64700ab135d952de71c69de0714,1,1,1,2,1,2012-11-16 19:51:56,2012-11-16 19:51:45
ef604e29ee24e64700ab135d952de71c69de0714...db32bd45983ba3e9caa0c0b4eaad01585f302303,1,1,1,2,2,2012-11-16 20:10:18,2012-11-16 20:10:18
db32bd45983ba3e9caa0c0b4eaad01585f302303...0c63694742fe47aaf4baf9ca632685f67e1cebec,2,18,4,22,5,2012-11-16 20:41:32,2012-11-16 20:40:45
0c63694742fe47aaf4baf9ca632685f67e1cebec...e963c443d90f0909cba0ef5aa31fa0ce4d745d4a,2,2,2,4,2,2012-11-16 21:12:31,2012-11-16 21:11:31
e963c443d90f0909cba0ef5aa31fa0ce4d745d4a...879fb0899b1d0f3530ee0f01364f5d808d8ef706,1,1,0,1,1,2012-11-16 21:17:48,2012-11-16 16:48:42
879fb0899b1d0f3530ee0f01364f5d808d8ef706...b99e6577c58f774937f5f445bad498903a1601bd,2,2,2,4,2,2012-11-16 21:35:32,2012-11-16 21:34:38
b99e6577c58f774937f5f445bad498903a1601bd...792e4ec3782ff1019067efeaa0432c951180b058,1,8,3,11,2,2012-11-16 21:38:28,2012-11-16 21:38:28
792e4ec3782ff1019067efeaa0432c951180b058...6b5cf42aeebe056b8905ad82b79d0612e7d8d7c3,1,8,6,14,2,2012-11-16 21:42:55,2012-11-16 21:05:50
6b5cf42aeebe056b8905ad82b79d0612e7d8d7c3...0265277c79d818d09ed54ea815717c7b4d041778,2,33,3,36,4,2012-11-16 21:42:55,2012-11-16 21:11:27
0265277c79d818d09ed54ea815717c7b4d041778...294bce818add5c4bc59f7a7e8f5680bcdecff6e3,1,3,0,3,1,2012-11-16 21:42:56,2012-11-16 21:13:47
294bce818add5c4bc59f7a7e8f5680bcdecff6e3...9d268547290aed31dcccd4cc9fe4dfaf7effc3e7,1,1,1,2,1,2012-11-16 21:42:56,2012-11-16 21:42:31
9d268547290aed31dcccd4cc9fe4dfaf7effc3e7...35ca4d0f94dd5a6cbc091d18060b842ac2dff2ce,1,4,1,5,2,2012-11-16 22:24:24,2012-10-25 02:56:06
35ca4d0f94dd5a6cbc091d18060b842ac2dff2ce...7eb3fc28fbd9cb0464cbf6dba5ffb497ba2088e9,2,14,7,21,7,2012-11-16 22:24:24,2012-11-05 19:19:11
7eb3fc28fbd9cb0464cbf6dba5ffb497ba2088e9...ffd194f68edf4a61bff35fac591452b715cff849,43,2636,2267,4903,908,2012-11-16 22:32:59,2012-10-26 23:35:31
ffd194f68edf4a61bff35fac591452b715cff849...5cc16bd140a83a8fea4a63bd8ae1ca77916baafc,2,0,11,11,2,2012-11-16 22:40:08,2012-11-16 22:35:04
5cc16bd140a83a8fea4a63bd8ae1ca77916baafc...ba47b25460ab32d0403773e4a9316aa8bb9d7912,1,1,6,7,1,2012-11-16 22:40:08,2012-11-16 22:39:58
ba47b25460ab32d0403773e4a9316aa8bb9d7912...5bbf1c926dc40db801572871e0a9d8f167f2e859,1,4,0,4,1,2012-11-16 22:54:23,2012-11-16 22:54:23
5bbf1c926dc40db801572871e0a9d8f167f2e859...fd1018b15d6bc7c295b110a019200bbb9c58a5ba,1,6,6,12,6,2012-11-16 22:57:51,2012-11-16 22:55:12
fd1018b15d6bc7c295b110a019200bbb9c58a5ba...79a4bf86803bc08355bd9699ccae5a54172b07fc,2,5,5,10,3,2012-11-16 23:55:00,2012-11-14 20:43:49
79a4bf86803bc08355bd9699ccae5a54172b07fc...f8f684a8a3e727ed5baad22433333963e2817346,1,4,0,4,1,2012-11-17 00:32:35,2012-11-17 00:32:27
f8f684a8a3e727ed5baad22433333963e2817346...e79049861baa58b2e8292eb3c70d6a7859b84336,1,1,1,2,1,2012-11-17 02:04:54,2012-11-17 02:04:54
e79049861baa58b2e8292eb3c70d6a7859b84336...83dbdf1a38b2620701ad85b307ecbb799caa38ba,18,1011,23,1034,61,2012-11-17 02:44:32,2012-11-05 17:05:39
83dbdf1a38b2620701ad85b307ecbb799caa38ba...054155bb07d721a611f3c241f9b5f07667a72494,2,2,2,4,2,2012-11-17 07:01:34,2012-11-17 07:01:26
054155bb07d721a611f3c241f9b5f07667a72494...9b0661f6323a4f48c20d3d341e378a246593375e,1,1,1,2,1,2012-11-17 07:19:09,2012-11-17 07:19:09
9b0661f6323a4f48c20d3d341e378a246593375e...c7d2b5823ff8ff068cb5a387d06bef2e25e5d489,1,2,0,2,1,2012-11-17 12:15:58,2012-11-17 12:15:58
c7d2b5823ff8ff068cb5a387d06bef2e25e5d489...72d500da9c0fda483605119ec7a59c19eca91751,10,36,0,36,12,2012-11-17 13:52:55,2012-11-17 11:57:29
72d500da9c0fda483605119ec7a59c19eca91751...38d64e3ffb528a597fb13d8aa459cd21f0967490,5,26,28,54,17,2012-11-17 13:55:38,2012-11-17 11:55:48
38d64e3ffb528a597fb13d8aa459cd21f0967490...2e2f0c570348d3eb6a2c1607d0e734858ab48bfc,1,13,16,29,7,2012-11-17 21:22:07,2012-11-17 21:22:07
2e2f0c570348d3eb6a2c1607d0e734858ab48bfc...77348a04f6ebfa4aec82cde0b8f519fd27f5fe0c,1,2,2,4,2,2012-11-18 00:14:31,2012-11-18 00:14:31
77348a04f6ebfa4aec82cde0b8f519fd27f5fe0c...075b8e8859c199785aeefb9d72608c9cb5c44289,1,1,1,2,1,2012-11-18 10:08:17,2012-11-18 10:08:17
075b8e8859c199785aeefb9d72608c9cb5c44289...7074841fad6e29c190d22ca2c1df63ab0b8e3e4c,4,50,3,53,8,2012-11-18 11:48:43,2012-11-18 11:48:43
7074841fad6e29c190d22ca2c1df63ab0b8e3e4c...5cc85a542ed918ededa875d861d7ba23d482cbf1,2,17,17,34,9,2012-11-18 11:54:31,2012-11-18 11:54:31
5cc85a542ed918ededa875d861d7ba23d482cbf1...7c8dec9a7bff471724c9cf9941650462a11bd983,4,24,4,28,9,2012-11-18 15:09:56,2012-11-18 14:17:51
7c8dec9a7bff471724c9cf9941650462a11bd983...39ccb23eaf656640fe3def564c47ebbcaa003b11,4,4,24,28,9,2012-11-18 17:38:16,2012-11-18 17:38:16
39ccb23eaf656640fe3def564c47ebbcaa003b11...34619f9cccb7159f8906f8cc9e48bf289084ef03,1,1,1,2,1,2012-11-18 19:38:04,2012-11-16 14:25:34
34619f9cccb7159f8906f8cc9e48bf289084ef03...975bfa3635741b94ab25244add48131d5142e257,2,12,6,18,8,2012-11-18 19:38:04,2012-11-16 14:55:25
975bfa3635741b94ab25244add48131d5142e257...97ed3b5231d93b1c869ba7dbc95fe7a5644ea6ac,4,61,128,189,54,2012-11-18 19:38:04,2012-11-14 19:31:33
97ed3b5231d93b1c869ba7dbc95fe7a5644ea6ac...db962c62b288609e0523cd2f31b887d8e5b540dd,3,98,95,193,51,2012-11-18 19:38:04,2012-11-15 00:09:06
db962c62b288609e0523cd2f31b887d8e5b540dd...70d6f10b78d949d1ec0c81ff8f99caf7880d4a52,7,300,299,599,228,2012-11-18 19:38:04,2012-11-15 00:20:45
70d6f10b78d949d1ec0c81ff8f99caf7880d4a52...9250b12205cfd656edb950279963e7f908012d69,4,20,6,26,6,2012-11-18 19:38:04,2012-11-15 21:09:54
9250b12205cfd656edb950279963e7f908012d69...cbddbb79fa8b92fdc2e294d5d1eae661b0de5421,2,17,1,18,6,2012-11-18 19:38:04,2012-11-15 21:19:43
cbddbb79fa8b92fdc2e294d5d1eae661b0de5421...027a2dce72b30e8cc59fb94509035e5778ebc322,2,8,6,14,5,2012-11-18 19:38:04,2012-11-15 21:23:57
027a2dce72b30e8cc59fb94509035e5778ebc322...f24d0d6de4f2afcfa58e61347e88f11772b07a6b,3,2,8,10,4,2012-11-18 19:38:05,2012-11-15 21:27:49
f24d0d6de4f2afcfa58e61347e88f11772b07a6b...23ceb44037e9aa53cc0edf72d4782d2ec1fac86c,2,6,12,18,4,2012-11-18 19:38:05,2012-11-15 22:56:00
23ceb44037e9aa53cc0edf72d4782d2ec1fac86c...e665d4219029af7cd140a9fd9852e0e8049952b5,11,32,22,54,30,2012-11-18 19:38:05,2012-11-16 14:26:35
e665d4219029af7cd140a9fd9852e0e8049952b5...a86115efaeacb654ff3dbc3489dd9961f8f99dd4,3,6,5,11,5,2012-11-18 19:38:05,2012-11-16 14:58:30
a86115efaeacb654ff3dbc3489dd9961f8f99dd4...d87cdadffef5c2c7b0662805a63bc32aa53e9ecd,1,1,1,2,1,2012-11-18 20:37:20,2012-11-18 20:37:02
d87cdadffef5c2c7b0662805a63bc32aa53e9ecd...525b9cf46eded368a4b07e59de2b88551a6908bb,2,3,3,6,2,2012-11-18 21:11:26,2012-11-18 21:11:11
525b9cf46eded368a4b07e59de2b88551a6908bb...8006d768e57f6fc50f3bf0cd8cdb57a6a6fc1341,2,9,10,19,9,2012-11-18 22:25:39,2012-11-18 22:25:09
8006d768e57f6fc50f3bf0cd8cdb57a6a6fc1341...86890c467e0d8a832aa85afe69d4da13857936cc,1,1,1,2,1,2012-11-18 23:11:51,2012-11-18 23:11:51
86890c467e0d8a832aa85afe69d4da13857936cc...2232ee5fa337735a3e3c6f1fdbd29fae228724cb,1,2,1,3,1,2012-11-18 23:36:50,2012-11-18 23:15:19
2232ee5fa337735a3e3c6f1fdbd29fae228724cb...63e189c67fd9e8f54fe18f59f4a8e6eb5cee29f5,1,1,1,2,1,2012-11-19 03:58:05,2012-11-19 03:45:03
63e189c67fd9e8f54fe18f59f4a8e6eb5cee29f5...dc6e2fec66b80181e2950ca8aec69637e0492c73,2,12,1,13,2,2012-11-19 15:47:21,2012-11-19 15:47:21
dc6e2fec66b80181e2950ca8aec69637e0492c73...62bdaee9b4a8046c1c80c7f464b8a3c1729c73f0,2,7,6,13,4,2012-11-19 15:56:14,2012-11-19 15:55:53
62bdaee9b4a8046c1c80c7f464b8a3c1729c73f0...73d153e44e75197115944b60ab4fca6f7bb6f2d0,1,4,0,4,1,2012-11-19 16:10:42,2012-11-19 12:27:30
73d153e44e75197115944b60ab4fca6f7bb6f2d0...9a516f7440bf40148ee3068a51a04ba3e28d8dea,1,2,2,4,2,2012-11-19 16:52:29,2012-11-18 04:18:57
9a516f7440bf40148ee3068a51a04ba3e28d8dea...33782f2420ae347a92e22b53755e1f7eb46eb81d,1,1,0,1,1,2012-11-19 16:52:30,2012-11-18 04:21:18
33782f2420ae347a92e22b53755e1f7eb46eb81d...52fc1856e8ce24d89210832073ceb2d8bf0e971f,5,108,8,116,7,2012-11-19 16:52:30,2012-11-18 15:50:42
52fc1856e8ce24d89210832073ceb2d8bf0e971f...54e26dda91ce550b62087ee2e7bea341f48a701b,4,32,12,44,8,2012-11-19 16:52:30,2012-11-18 21:28:55
54e26dda91ce550b62087ee2e7bea341f48a701b...8f4944f423b0008c0e46ca6af6da5f791bdb7cce,1,1,0,1,1,2012-11-19 16:52:30,2012-11-19 16:52:15
8f4944f423b0008c0e46ca6af6da5f791bdb7cce...8d1d6d0064c84c47b1c19dbd4fb5f9463cc2dca4,2,9,0,9,3,2012-11-19 17:14:23,2012-11-16 01:51:45
8d1d6d0064c84c47b1c19dbd4fb5f9463cc2dca4...3f76bfbb36ae65588bdf5f9ba3851536e01cb603,2,15,0,15,2,2012-11-19 17:15:23,2012-11-16 00:40:23
3f76bfbb36ae65588bdf5f9ba3851536e01cb603...12dbc4828e4db032b1bd600b7037590cb51efd1d,1,1,0,1,1,2012-11-19 18:07:15,2012-11-19 18:07:15
12dbc4828e4db032b1bd600b7037590cb51efd1d...9da5bec61ffb3509b53a8ef8fb85a017bba007bc,1,3,3,6,2,2012-11-19 18:40:01,2012-11-19 18:39:52
9da5bec61ffb3509b53a8ef8fb85a017bba007bc...73356d57d8c01db50a2cb6ff244d10956ce2723b,3,203,3,206,5,2012-11-19 18:53:58,2012-11-14 23:20:24
73356d57d8c01db50a2cb6ff244d10956ce2723b...d4c087bcafbd94ae038dc9cd2523bac3f98ebafd,1,3,5,8,1,2012-11-19 19:08:33,2012-11-19 19:08:33
d4c087bcafbd94ae038dc9cd2523bac3f98ebafd...74da78e550430d742a29439bf7d126ea0ff3e739,1,1,1,2,1,2012-11-19 19:10:03,2012-11-19 19:10:03
74da78e550430d742a29439bf7d126ea0ff3e739...ddd8f52f5aa548c021841c89ef35485ba5876726,2,4,4,8,4,2012-11-19 19:10:42,2012-11-15 22:24:59
ddd8f52f5aa548c021841c89ef35485ba5876726...77bf7870d02267ff3dde6ac87c2e7d9ddac92ddd,6,127,75,202,53,2012-11-19 19:39:42,2012-11-13 19:58:20
77bf7870d02267ff3dde6ac87c2e7d9ddac92ddd...ed988d295801a6798d051d3d873edf49abf8fa9f,1,1,3,4,4,2012-11-19 20:15:00,2012-11-19 20:14:54
ed988d295801a6798d051d3d873edf49abf8fa9f...59a247fbd4d94afa1073d9c310a372e4e3ff457f,1,4,0,4,2,2012-11-19 20:55:55,2012-11-19 20:41:43
59a247fbd4d94afa1073d9c310a372e4e3ff457f...b6019134ebec0ce7550956fc455a1525bfddc0cd,1,2,2,4,1,2012-11-19 20:56:32,2012-11-19 20:56:32
b6019134ebec0ce7550956fc455a1525bfddc0cd...a7b27560f56a08a2ca01ea330a28849044385cef,9,59,51,110,32,2012-11-19 21:49:09,2012-11-19 19:56:54
a7b27560f56a08a2ca01ea330a28849044385cef...2c9726896d8eaaad93a8ca17b2307ab03bbe8def,1,1,2,3,1,2012-11-19 22:18:18,2012-11-19 22:18:18
2c9726896d8eaaad93a8ca17b2307ab03bbe8def...ba4b096473f4e6eb79bd9b362d121fa9952beb55,1,2,7,9,2,2012-11-19 22:26:16,2012-11-19 19:15:51
ba4b096473f4e6eb79bd9b362d121fa9952beb55...6bdaca981be459757d6d93b5cc34724ff89359c6,8,222,101,323,46,2012-11-19 23:16:24,2012-11-05 20:16:56
6bdaca981be459757d6d93b5cc34724ff89359c6...2ded9d6bbafbf276dc1a902f852daa068543a54f,1,2,2,4,2,2012-11-19 23:45:30,2012-11-19 02:30:43
2ded9d6bbafbf276dc1a902f852daa068543a54f...3cc16161de9e097c34f8992bd7376203af86182e,10,928,48,976,34,2012-11-19 23:54:32,2012-11-19 23:49:17
3cc16161de9e097c34f8992bd7376203af86182e...c2aff79d6383739994dd110aed6596c34d2e07b7,1,27,0,27,2,2012-11-19 23:59:48,2012-11-19 23:55:51
c2aff79d6383739994dd110aed6596c34d2e07b7...d6fb51e8b1b224c90a025723bab6e605385ae338,14,132,12,144,22,2012-11-20 00:18:09,2012-11-17 01:44:21
d6fb51e8b1b224c90a025723bab6e605385ae338...3db6cf6bcccf838044d6c7f6460fd4e90ba9ad1d,3,198,8,206,7,2012-11-20 00:38:35,2012-11-20 00:37:26
3db6cf6bcccf838044d6c7f6460fd4e90ba9ad1d...ec38a5b7f242987fdabd27c6acc257b79936ffd7,5,30,25,55,13,2012-11-20 00:50:54,2012-11-19 20:29:23
ec38a5b7f242987fdabd27c6acc257b79936ffd7...e12ae88b13032796fda557e8c1fa070f6935b322,12,167,35,202,47,2012-11-20 01:52:19,2012-11-20 01:52:19
e12ae88b13032796fda557e8c1fa070f6935b322...a273613e5b95ab666f770d07f77df1b5d2abd888,1,22,1,23,3,2012-11-20 02:02:22,2012-11-13 19:56:39
a273613e5b95ab666f770d07f77df1b5d2abd888...062652649915997e34ffd2e36bf6bf47edcf917f,3,50,3,53,5,2012-11-20 02:44:51,2012-11-13 18:23:40
062652649915997e34ffd2e36bf6bf47edcf917f...428bb865bfd24848ffba0fb9b9514264e5b3816e,28,2455,162,2617,82,2012-11-20 02:44:51,2012-11-04 21:55:36
428bb865bfd24848ffba0fb9b9514264e5b3816e...38a48227486caecfe45e4754418e22f804cdbf84,7,323,2,325,13,2012-11-20 02:58:02,2012-11-20 02:57:50
38a48227486caecfe45e4754418e22f804cdbf84...b8b020232b893c55056fdacffd51a13dc3546725,1,1,0,1,1,2012-11-20 03:04:16,2012-11-20 03:03:59
b8b020232b893c55056fdacffd51a13dc3546725...c9d95847ffdb2f42387066fd00edb2588c4fadef,5,20,4,24,7,2012-11-20 03:11:46,2012-11-19 23:41:19
c9d95847ffdb2f42387066fd00edb2588c4fadef...273d8c921532b67ba9291c470732d2d56ee116ee,1,4,2,6,2,2012-11-20 03:41:48,2012-11-20 03:41:48
273d8c921532b67ba9291c470732d2d56ee116ee...0a25fc37d3ad50cefea7e19f9866f63f5d2ea2e7,1,1,1,2,1,2012-11-20 04:14:41,2012-11-20 04:14:31
0a25fc37d3ad50cefea7e19f9866f63f5d2ea2e7...61f3b37996bcdfff022a301a233c0ae3458eeb8f,2,2,0,2,2,2012-11-20 04:45:09,2012-11-20 04:45:09
61f3b37996bcdfff022a301a233c0ae3458eeb8f...f08ff7bfc7fd4eb3f2e7d73625520221773c9f72,3,51,13,64,14,2012-11-20 04:58:13,2012-11-20 04:57:38
f08ff7bfc7fd4eb3f2e7d73625520221773c9f72...bc4327e0eab9aebf7ee57c857a59440ca5f26fbb,8,80,0,80,28,2012-11-20 10:19:30,2012-11-20 10:19:30
bc4327e0eab9aebf7ee57c857a59440ca5f26fbb...08cfe5f5054eff0830c12289c38e7c49460ce86d,1,0,1,1,1,2012-11-20 10:39:59,2012-11-20 10:36:10
08cfe5f5054eff0830c12289c38e7c49460ce86d...675132c08da314433157016c3a0ee1187b55b65a,14,12,132,144,22,2012-11-20 14:43:01,2012-11-20 14:43:01
675132c08da314433157016c3a0ee1187b55b65a...7aac243b122f4ac073f81a1f98182d40bc322ffc,1,1,0,1,1,2012-11-20 16:07:04,2012-11-20 16:04:20
7aac243b122f4ac073f81a1f98182d40bc322ffc...37e3c78fd0fd25be18fbfe650a70d0a7d90fcd60,4,15,28,43,5,2012-11-20 17:04:36,2012-11-20 15:19:24
37e3c78fd0fd25be18fbfe650a70d0a7d90fcd60...2f433ece1bb9408f949527e0d95ad6db0d5ef7c5,2,167,91,258,6,2012-11-20 18:17:03,2012-11-20 18:17:03
2f433ece1bb9408f949527e0d95ad6db0d5ef7c5...85abee65027409182c318d22aa79fd224e6b311c,14,132,12,144,22,2012-11-20 18:20:42,2012-11-17 01:44:21
85abee65027409182c318d22aa79fd224e6b311c...dac93da27163d2c1e0978a44ec814caaa80c5428,1,1,1,2,1,2012-11-20 18:20:42,2012-11-20 15:47:02
dac93da27163d2c1e0978a44ec814caaa80c5428...b73765f0fe003ca92508552283dbbd8a6e7ff87b,1,55,47,102,9,2012-11-20 19:46:03,2012-11-20 19:46:03
b73765f0fe003ca92508552283dbbd8a6e7ff87b...c8ac128c2317aac68d794246a596f982430c44d8,1,1,1,2,1,2012-11-20 19:52:53,2012-11-20 19:52:45
c8ac128c2317aac68d794246a596f982430c44d8...326095ca898a7b81ae65255841db31f626db0951,1,3,1,4,2,2012-11-20 20:07:46,2012-11-20 20:07:46
326095ca898a7b81ae65255841db31f626db0951...d20100997e519ad744cfbef48cc1b5010d98f94e,3,33,2,35,3,2012-11-20 20:52:14,2012-11-20 20:49:38
d20100997e519ad744cfbef48cc1b5010d98f94e...518ac5389697045ca7262b19726a4905814a8d18,2,6,7,13,2,2012-11-20 21:47:43,2012-11-20 21:47:43
518ac5389697045ca7262b19726a4905814a8d18...cb14cf83102cca848e572ffd8b95c6fa35594175,1,77,5,82,3,2012-11-20 23:59:29,2012-11-20 19:56:24
cb14cf83102cca848e572ffd8b95c6fa35594175...dce8b0b14316588cd186906e4418edd2e18f1649,1,5,1,6,2,2012-11-21 13:21:37,2012-11-21 11:39:55
dce8b0b14316588cd186906e4418edd2e18f1649...08b96ce551d867c8de54a25ea2692744e14f3caf,2,15,1,16,2,2012-11-21 16:28:36,2012-11-21 16:17:49
08b96ce551d867c8de54a25ea2692744e14f3caf...d562f53acd71f594fcbf381f581a57e2b2425042,2,1,15,16,2,2012-11-21 16:45:05,2012-11-21 16:45:05
d562f53acd71f594fcbf381f581a57e2b2425042...5ef99388a9c6687e00bdfe399e7d44e77a8d1a08,1,2,1,3,1,2012-11-21 16:55:25,2012-11-21 16:54:06
5ef99388a9c6687e00bdfe399e7d44e77a8d1a08...52022a72aa802118357f2aa78d482d8b93a0d9aa,1,11,1,12,2,2012-11-21 17:06:09,2012-11-21 17:03:30
52022a72aa802118357f2aa78d482d8b93a0d9aa...ca6b31d9d2da68bb14ea896d3db8de72fb0bed5d,3,25,18,43,7,2012-11-21 18:49:46,2012-11-20 21:07:28
ca6b31d9d2da68bb14ea896d3db8de72fb0bed5d...bfec1e9b891fd2160eb7b38fc6585d58f4aaaa5a,1,1,0,1,1,2012-11-21 21:02:40,2012-11-21 21:02:40
bfec1e9b891fd2160eb7b38fc6585d58f4aaaa5a...3b563464a4cd52a32daef83ce600ffb0974d3b98,2,117,87,204,8,2012-11-21 22:10:28,2012-11-21 19:53:01
3b563464a4cd52a32daef83ce600ffb0974d3b98...219eaa7361faa9a516d2201c9d766ea8285a83e0,2,7,7,14,7,2012-11-21 22:17:32,2012-11-21 22:17:32
219eaa7361faa9a516d2201c9d766ea8285a83e0...319c7f0ced3935dd9d28ed89895112e6504612cd,3,39,21,60,7,2012-11-22 00:10:16,2012-11-21 19:38:44
319c7f0ced3935dd9d28ed89895112e6504612cd...fa64548884d610ebee36c52e75425117dcb4f512,1,16,1,17,4,2012-11-22 01:04:26,2012-11-22 01:04:26
fa64548884d610ebee36c52e75425117dcb4f512...7582d50b18dedef00b605f8a44cd11d267be540c,2,11,2,13,2,2012-11-22 01:26:27,2012-10-21 17:05:36
7582d50b18dedef00b605f8a44cd11d267be540c...ae9f99dbc9eb0683147078d290d3f1b8171fe864,2,2,11,13,2,2012-11-22 04:33:39,2012-11-22 04:33:16
ae9f99dbc9eb0683147078d290d3f1b8171fe864...0240ea99eb415ea5b380084bb3d45e3a53c475e0,1,13,1,14,5,2012-11-22 18:03:51,2012-11-22 18:03:51
0240ea99eb415ea5b380084bb3d45e3a53c475e0...32151400c2b4cf93b025723903794f1e2ec26d3c,1,24,9,33,8,2012-11-22 23:59:56,2012-11-22 23:59:56
32151400c2b4cf93b025723903794f1e2ec26d3c...e4cc1ddb3d248cd95a3996f48feb57807a50a7a5,2,2,2,4,2,2012-11-25 04:32:00,2012-11-25 04:32:00
e4cc1ddb3d248cd95a3996f48feb57807a50a7a5...a710a4a341f79af877e12a714317a4c3c5caa017,4,53,6,59,7,2012-11-26 01:53:02,2012-11-20 15:29:52
a710a4a341f79af877e12a714317a4c3c5caa017...55ca3569e8f9c7ace67f20f67cf5ece631e47df8,3,8,3,11,4,2012-11-26 01:53:02,2012-11-20 19:26:09
55ca3569e8f9c7ace67f20f67cf5ece631e47df8...ae62040c61ab08903d3045cb1013473d7fb65ee3,1,1,1,2,1,2012-11-26 01:54:16,2012-11-26 01:54:16
ae62040c61ab08903d3045cb1013473d7fb65ee3...8ae059694e049913eaf5f291a6ba1218ea12ca63,1,1,1,2,1,2012-11-26 02:09:46,2012-11-26 02:09:46
8ae059694e049913eaf5f291a6ba1218ea12ca63...84b4f2f2325c1e7d2f8d12fff1c3909bf5f06ce0,1,3,3,6,2,2012-11-26 17:59:55,2012-11-26 17:59:55
84b4f2f2325c1e7d2f8d12fff1c3909bf5f06ce0...22de9cb08d762acac32d7ac6ad476ae8a2a06eef,2,7,2,9,2,2012-11-26 18:14:09,2012-11-26 18:10:17
22de9cb08d762acac32d7ac6ad476ae8a2a06eef...7897df78d1d5abb55939ac8aef614a7792b2603a,1,2,2,4,2,2012-11-26 18:20:06,2012-11-26 14:18:59
7897df78d1d5abb55939ac8aef614a7792b2603a...057dbf82309c6f16ebec0f04dfdab32dd2624a15,1,4,3,7,2,2012-11-26 18:20:06,2012-11-26 15:53:32
057dbf82309c6f16ebec0f04dfdab32dd2624a15...703051921448696681b9db910667ead0f2761367,1,6,0,6,1,2012-11-26 18:38:56,2012-11-26 18:38:56
703051921448696681b9db910667ead0f2761367...8bc764952237b9da1832cd877e215049a11a6029,1,10,12,22,2,2012-11-26 18:53:34,2012-11-23 22:35:41
8bc764952237b9da1832cd877e215049a11a6029...43aca5859689ec16c6504e2b9afd5d68155a5a3e,1,15,14,29,9,2012-11-26 19:01:00,2012-11-26 18:50:55
43aca5859689ec16c6504e2b9afd5d68155a5a3e...5765b96d9c11f7ec84609e5554e2ba3b3821dced,1,1,2,3,1,2012-11-26 19:08:24,2012-11-26 18:58:49
5765b96d9c11f7ec84609e5554e2ba3b3821dced...4212bb0c155d97121f55c345440b650cdc9163d4,1,1,0,1,1,2012-11-26 19:38:13,2012-11-20 23:00:56
4212bb0c155d97121f55c345440b650cdc9163d4...00e5a9aada74de383d6d4f530c30af82e164e1d7,1,19,0,19,1,2012-11-26 19:38:13,2012-11-20 23:32:10
00e5a9aada74de383d6d4f530c30af82e164e1d7...edb9482cb410e5b78830ad4e340e15479cb00526,2,4,5,9,3,2012-11-26 19:38:13,2012-11-20 21:58:06
edb9482cb410e5b78830ad4e340e15479cb00526...71318659ed305b8590cf146dad95540e8c37b212,1,25,4,29,5,2012-11-26 21:09:01,2012-11-26 19:02:42
71318659ed305b8590cf146dad95540e8c37b212...736bcf0b8b51e9baea921952f7cfc0a387d6c404,1,4,0,4,1,2012-11-26 21:09:01,2012-11-26 21:07:02
736bcf0b8b51e9baea921952f7cfc0a387d6c404...25c8a4947a4b06b4a0eb21b6f995902529281b56,1,16,0,16,1,2012-11-26 22:17:46,2012-11-26 19:49:39
25c8a4947a4b06b4a0eb21b6f995902529281b56...eb04f7328d8cbfc4731e5ff6a466a138d9b5fc42,5,126,56,182,24,2012-11-26 22:54:16,2012-11-14 00:18:17
eb04f7328d8cbfc4731e5ff6a466a138d9b5fc42...a4526bad1cf9984e11529aca3e6cb7ad58102f94,5,207,4,211,37,2012-11-26 23:10:23,2012-11-09 00:46:35
a4526bad1cf9984e11529aca3e6cb7ad58102f94...0b43c20ee9bd35aa2e76a8e63781a27244ca43b7,1,0,3,3,2,2012-11-26 23:28:34,2012-11-26 23:28:34
0b43c20ee9bd35aa2e76a8e63781a27244ca43b7...678e917b0e18ad10a38213d68bb8e5f9fbb5e5a0,1,8,3,11,2,2012-11-26 23:56:53,2012-11-26 22:51:06
678e917b0e18ad10a38213d68bb8e5f9fbb5e5a0...4ab0df571e0ed0cfbdfe30a85c898cadeab250e4,1,2,1,3,1,2012-11-27 00:14:12,2012-11-26 23:52:02
4ab0df571e0ed0cfbdfe30a85c898cadeab250e4...c594cc09d1bf68243b1e380828db5b1f49b4cc82,1,128,5,133,22,2012-11-27 00:35:14,2012-11-12 23:06:48
c594cc09d1bf68243b1e380828db5b1f49b4cc82...a950145bcd1cbdaccce9432d4c8b219fe9655ea0,3,167,1,168,29,2012-11-27 00:51:55,2012-11-13 17:25:05
a950145bcd1cbdaccce9432d4c8b219fe9655ea0...cce08d2ad71b42a877beedf6dbcbe0acdf067358,1,46,4,50,7,2012-11-27 00:53:19,2012-11-13 21:31:40
cce08d2ad71b42a877beedf6dbcbe0acdf067358...5864a3ca451034227246478621ff886bddb66652,1,65,3,68,13,2012-11-27 01:04:04,2012-11-15 00:00:24
5864a3ca451034227246478621ff886bddb66652...dfeb366b82a6eda05d54b4a5a4566d8f018d4461,2,30,10,40,4,2012-11-27 14:58:07,2012-11-12 20:27:57
b787da9413a7e698efb3706246fe6c4e4352c461...2e5ac90c8b205e09b6ac6985c882da0a125b72b7,1,2,2,4,2,2012-11-14 21:18:27,2012-11-14 21:18:27
f6e15ab6ec5ed7b58c8b4ba82a76c88bcc5d7b53...ed5353bb0aa0cea761614a03fe6b543d8d9102c9,11,25,36,61,25,2011-12-03 18:32:26,2011-12-03 18:32:11
ed5353bb0aa0cea761614a03fe6b543d8d9102c9...37b6574596b5d034806e40ae6a7c823e4340dae6,1,4,2,6,2,2011-12-03 20:33:57,2011-12-03 20:33:57
37b6574596b5d034806e40ae6a7c823e4340dae6...40777bef74019614f21d3d9cf010ddac72cd090c,1,3,3,6,3,2011-12-03 20:34:20,2011-12-03 20:34:20
40777bef74019614f21d3d9cf010ddac72cd090c...cc92ca3000df16c78b7cefd5833c54eb550753a7,5,110,22,132,12,2011-12-03 20:34:53,2011-12-03 20:34:53
cc92ca3000df16c78b7cefd5833c54eb550753a7...3068617cfbe4178f90c0820e281e7ab0d09795c3,1,106,104,210,2,2011-12-03 20:41:34,2011-12-03 20:41:34
3068617cfbe4178f90c0820e281e7ab0d09795c3...7f42b317e848477bc1582ed029f5d92f7543cb34,1,2,2,4,2,2011-12-03 20:01:06,2011-12-03 20:01:06
7f42b317e848477bc1582ed029f5d92f7543cb34...ad88622f6fd799b11c2a422fc45ca208ea354149,1,3,0,3,2,2011-12-04 05:42:47,2011-12-04 05:42:00
ad88622f6fd799b11c2a422fc45ca208ea354149...f001f0ad672fbd96d70dece247e382537ff8165d,1,1,1,2,1,2011-12-04 05:42:47,2011-12-04 05:42:37
f001f0ad672fbd96d70dece247e382537ff8165d...16e8ae73ca7f0cdb02ed4f80daf4f8a8c66732cc,1,1,1,2,1,2011-12-04 18:36:51,2011-10-26 00:53:38
16e8ae73ca7f0cdb02ed4f80daf4f8a8c66732cc...e5c440ac103fd6f8836402cbcf7caf4fb09002a7,2,9,7,16,6,2011-12-04 18:36:51,2011-10-26 00:55:41
e5c440ac103fd6f8836402cbcf7caf4fb09002a7...8cc9e997a1bb1a89240ac13057bb543e496ba9e4,1,0,7,7,1,2011-12-04 18:36:52,2011-10-26 00:56:35
8cc9e997a1bb1a89240ac13057bb543e496ba9e4...e86d2a2ce76204048fb71cbfe79169620d99917b,3,16,16,32,15,2011-12-04 18:36:52,2011-12-02 06:32:19
e86d2a2ce76204048fb71cbfe79169620d99917b...1299e0cc56fe18d983091eec296ffc24cc1060ad,2,43,1,44,3,2011-12-04 18:36:52,2011-12-02 06:35:27
1299e0cc56fe18d983091eec296ffc24cc1060ad...d1eab2cbc44ca0afbbc10dfcde2ca8322e76a33b,1,2,2,4,1,2011-12-04 18:36:52,2011-12-02 06:38:41
d1eab2cbc44ca0afbbc10dfcde2ca8322e76a33b...12c246fc60f8c34512e66321cc1d0b01811bd306,1,1,1,2,1,2011-12-04 18:36:52,2011-12-03 23:23:02
12c246fc60f8c34512e66321cc1d0b01811bd306...7ff9fec9363cc4b6bbb9b96cfb15ae9c094ace0a,1,7,0,7,1,2011-12-04 18:36:53,2011-12-03 23:23:30
7ff9fec9363cc4b6bbb9b96cfb15ae9c094ace0a...bd50d4591b1e6255ef7a4c397b9158f9ec9029c9,3,14,11,25,8,2011-12-04 18:36:53,2011-12-04 03:40:15
bd50d4591b1e6255ef7a4c397b9158f9ec9029c9...d8bb81b35289fd64c7db538cabc271d28b139e04,1,2,4,6,4,2011-12-04 18:36:53,2011-12-04 04:05:41
d8bb81b35289fd64c7db538cabc271d28b139e04...4eb045885013d144b4ea31314a46382052297370,1,2,2,4,1,2011-12-04 18:36:53,2011-12-04 04:38:51
4eb045885013d144b4ea31314a46382052297370...8bfc4a135e5d0a30e20a70455f6bc6e17f7b75c7,3,19,25,44,20,2011-12-04 18:36:53,2011-12-04 05:59:53
8bfc4a135e5d0a30e20a70455f6bc6e17f7b75c7...aa4987764abc3d11ce92b5c8fed4693dee4bce8d,1,0,1,1,1,2011-12-05 15:43:26,2011-12-05 15:43:26
aa4987764abc3d11ce92b5c8fed4693dee4bce8d...3472b0bc7970daf419dc1430e80bea9973c00a57,2,2,5,7,3,2011-12-05 15:27:38,2011-12-05 15:27:38
0950dfc242a2a04cf9fe1b680cca718d645939ad...5eff9e598d77ceae993de8628ed1f637a523b75b,7,20,22,42,16,2012-12-21 21:32:22,2012-12-21 18:59:14
5eff9e598d77ceae993de8628ed1f637a523b75b...bb852c8a29cda31869d54f610cf4daf143387792,2,13,1,14,6,2012-12-21 21:32:22,2012-12-21 19:07:28
bb852c8a29cda31869d54f610cf4daf143387792...db028e3543cf5ffedd0e8256069924a5b970b81c,4,45,11,56,9,2012-12-21 21:32:22,2012-12-21 20:29:36
db028e3543cf5ffedd0e8256069924a5b970b81c...ccff45c737696652c9c2bd8bafa5f8fc9a4a5dfc,4,42,29,71,16,2012-12-21 21:32:22,2012-12-21 20:51:54
ccff45c737696652c9c2bd8bafa5f8fc9a4a5dfc...90a936ea5d70015991de7d2b17c1516854e10d06,1,3,3,6,1,2012-12-21 21:32:22,2012-12-21 21:32:03
90a936ea5d70015991de7d2b17c1516854e10d06...adffd84f5ae56f12c11937121f228acff39eae31,2,2,7,9,2,2012-12-21 21:51:05,2012-12-21 21:48:28
adffd84f5ae56f12c11937121f228acff39eae31...3f9239803de4fe219c913ad0720502f9ccfe494b,10,315,57,372,33,2012-12-21 22:09:31,2012-12-17 23:27:19
0950dfc242a2a04cf9fe1b680cca718d645939ad...5f7f17708b5b2de1c6b6625376abb78a957e10c7,10,315,57,372,33,2012-12-21 21:14:12,2012-12-17 23:27:19
5f7f17708b5b2de1c6b6625376abb78a957e10c7...acd3c9d43be478b209f5e0b732e0f4d5ff72cea7,5,112,23,135,14,2012-12-21 21:55:58,2012-12-21 20:55:14
d122f4772b716f1819ca6b44def68eaade91d0de...6446345ba4836ba1cd70b6c30296f96df260ba5e,6,62,3,65,13,2012-11-14 22:14:41,2012-11-08 22:06:10
3472b0bc7970daf419dc1430e80bea9973c00a57...a19c36eae6549a177928e76db52f84fbddc95c2f,1,25,5,30,9,2011-12-05 20:31:31,2011-12-05 20:31:31
3472b0bc7970daf419dc1430e80bea9973c00a57...00485a8cb5105913e88d31c07dbfad9d9007b48e,2,4,2,6,2,2011-12-05 20:00:18,2011-12-05 19:58:37
00485a8cb5105913e88d31c07dbfad9d9007b48e...81b965f96635feb44bde1185182c6673dbb6c64d,2,3,3,6,3,2011-12-05 20:23:35,2011-12-01 21:49:06
81b965f96635feb44bde1185182c6673dbb6c64d...6865f14009fc894152b3e58201f1d2292c6cb7db,1,34,0,34,7,2011-12-05 20:25:36,2011-12-05 19:55:51
6865f14009fc894152b3e58201f1d2292c6cb7db...8a67b153d7940e3e62437d41e470ad4621b54820,3,30,12,42,5,2011-12-05 20:25:36,2011-12-05 20:10:54
0b9369b62fe8eb38d5b5e8fdff6fc5179a92eeb5...506b27828af7ad2ca81b3474eee471c1088574b9,1,5,0,5,1,2012-12-21 22:38:41,2012-12-21 22:38:41
506b27828af7ad2ca81b3474eee471c1088574b9...247e04dff5bd40871b04ac0ecedbf898f46fd40d,2,7,2,9,2,2012-12-21 22:39:22,2012-12-21 22:39:22
247e04dff5bd40871b04ac0ecedbf898f46fd40d...6f02ce4f3e8ec16f3d6ae636d8f25a9368f4257d,1,1,1,2,1,2012-12-21 22:42:35,2012-12-21 22:42:35
6f02ce4f3e8ec16f3d6ae636d8f25a9368f4257d...377ef5136dff3fc340df312f0c422f96d8256802,2,68,5,73,5,2012-12-21 22:50:50,2012-12-21 20:56:12
377ef5136dff3fc340df312f0c422f96d8256802...c98c4f07be6838fb98280756526d5eabf56f8aea,4,0,36,36,4,2012-12-21 22:53:05,2012-12-21 01:28:41
c98c4f07be6838fb98280756526d5eabf56f8aea...e67651f117934fa920fc3ab1b2203baf9765afa1,39,711,648,1359,218,2012-12-21 22:53:05,2012-12-21 01:29:10
e67651f117934fa920fc3ab1b2203baf9765afa1...a0b0cfa89c7b46dd0db9ff2f8a1d31cf76f9cd0f,15,210,140,350,22,2012-12-21 22:53:06,2012-12-21 02:09:53
a0b0cfa89c7b46dd0db9ff2f8a1d31cf76f9cd0f...f9f37613fc04e97373ae421dd9990970b79223e7,14,39,39,78,22,2012-12-21 22:53:06,2012-12-21 02:29:40
f9f37613fc04e97373ae421dd9990970b79223e7...90c981c91e97e9286153269eec71e162f94f3d2d,1,1,2,3,2,2012-12-21 23:29:44,2012-12-21 23:27:28
90c981c91e97e9286153269eec71e162f94f3d2d...82e311d805824ec52244fb1f0cd27da4a68a161d,1,8,0,8,1,2012-12-22 00:19:37,2012-12-22 00:19:37
82e311d805824ec52244fb1f0cd27da4a68a161d...7bbe9e7341dcbd777825ed8786a717ed08ff3420,1,8,7,15,4,2012-12-22 00:43:49,2012-12-22 00:43:12
7bbe9e7341dcbd777825ed8786a717ed08ff3420...41928dcbf0364d81386286e125a86a2b5d0d69e8,2,4,2,6,2,2012-12-22 01:06:14,2012-12-22 01:06:14
41928dcbf0364d81386286e125a86a2b5d0d69e8...23b5cd33dbb11262523811f6ceadb32a240c1ad2,1,3,2,5,2,2012-12-22 01:39:52,2012-12-22 01:39:52
23b5cd33dbb11262523811f6ceadb32a240c1ad2...1b181aa17c9a8e88d59dee3f603eb9e280328055,2,4,4,8,4,2012-12-22 04:50:13,2012-12-22 04:50:13
1b181aa17c9a8e88d59dee3f603eb9e280328055...161fdc6f34b52dbf00df6b971a63da502cf1ab4f,1,2,2,4,2,2012-12-22 05:38:05,2012-12-22 05:38:05
161fdc6f34b52dbf00df6b971a63da502cf1ab4f...daff786610357651d2ff1747becd1327bdfdebc3,1,1,1,2,1,2012-12-22 06:16:31,2012-12-22 06:16:31
daff786610357651d2ff1747becd1327bdfdebc3...51e000daea784fcbca0573814792619acf4d18ae,4,32,11,43,11,2012-12-22 07:19:46,2012-12-22 07:19:46
51e000daea784fcbca0573814792619acf4d18ae...50e1fe795f9c5ba121a04cd56458dc949f3503a2,1,3,2,5,1,2012-12-22 12:31:28,2012-12-22 12:31:28
50e1fe795f9c5ba121a04cd56458dc949f3503a2...efbcdf7e972ae1e7d6691ec57869c8035a07b1d2,2,10,4,14,3,2012-12-22 15:42:02,2012-12-22 15:42:02
efbcdf7e972ae1e7d6691ec57869c8035a07b1d2...f05814c2f7892f8b699dbdbc22741a53103ab1d1,1,1,1,2,1,2012-12-22 17:20:52,2012-12-22 17:20:52
f05814c2f7892f8b699dbdbc22741a53103ab1d1...16e80a25596a28bc36690652742d7327c5c2f66f,10,231,96,327,67,2012-12-22 17:22:56,2012-12-22 12:28:36
16e80a25596a28bc36690652742d7327c5c2f66f...d251b6d4784928e747497b6210eb586307269106,1,1,1,2,1,2012-12-22 17:29:58,2012-12-22 17:29:58
d251b6d4784928e747497b6210eb586307269106...7d37704a9875b7a10d1db60f0f61cb6f6ca5f59e,1,1,1,2,1,2012-12-22 21:47:19,2012-12-22 21:47:19
7d37704a9875b7a10d1db60f0f61cb6f6ca5f59e...6a6684ca9153564cc4d06bd001ea500afdcc6f4f,1,1,0,1,1,2012-12-22 22:38:57,2012-12-22 22:38:57
6a6684ca9153564cc4d06bd001ea500afdcc6f4f...ad9b37e8ad1acc366e2a04e40bb4713abbae69aa,1,2,2,4,2,2012-12-22 22:45:50,2012-12-22 22:45:25
ad9b37e8ad1acc366e2a04e40bb4713abbae69aa...2ffcf53cad52ba80d3dff70ed3c79af0b6aafb9e,1,1,1,2,1,2012-12-22 23:02:30,2012-12-22 23:02:30
2ffcf53cad52ba80d3dff70ed3c79af0b6aafb9e...d02a03c48edc7f7a7eb7523b97ba3800dbe87856,1,7,0,7,1,2012-12-22 23:05:22,2012-12-22 23:04:13
d02a03c48edc7f7a7eb7523b97ba3800dbe87856...947e48ee9afa8adfc6e4f2c242d1b2136d6a7019,5,73,3,76,7,2012-12-22 23:05:49,2012-12-21 07:17:09
947e48ee9afa8adfc6e4f2c242d1b2136d6a7019...14a2ac2ff9330c77a348502896accd2d12db982f,1,4,1,5,2,2012-12-23 07:37:03,2012-12-23 07:37:03
14a2ac2ff9330c77a348502896accd2d12db982f...6f9f587e6f7a61fc49f38f8257185a3cd1ed2ef3,1,2,2,4,1,2012-12-23 08:33:40,2012-12-23 08:33:28
6f9f587e6f7a61fc49f38f8257185a3cd1ed2ef3...168d8b6dfa7b4c723c3d401fdecb6b2a5c8f003e,1,1,1,2,1,2012-12-23 12:07:34,2012-12-23 12:07:34
168d8b6dfa7b4c723c3d401fdecb6b2a5c8f003e...a7169fdbfb82f228afba1aad96080e40687571e1,1,9,1,10,2,2012-12-24 00:19:30,2012-12-23 22:40:47
a7169fdbfb82f228afba1aad96080e40687571e1...a615d7dd1e3201e03d8fc8ed2f6a31d73e192cc1,2,16,19,35,6,2012-12-24 01:01:47,2012-12-22 16:32:36
a615d7dd1e3201e03d8fc8ed2f6a31d73e192cc1...13bde295415c1e5ea9afd6b7faed3f2a425e33fa,19,1,697,698,30,2012-12-24 01:31:30,2012-12-23 19:52:47
13bde295415c1e5ea9afd6b7faed3f2a425e33fa...5785051ec2c379d99c461225ba9d6c328b31b5e3,18,3,18,21,18,2012-12-24 01:31:30,2012-12-23 21:13:00
5785051ec2c379d99c461225ba9d6c328b31b5e3...77e823e1ad71c652cd9d5022306896838311ad17,11,106,214,320,30,2012-12-24 01:31:30,2012-12-23 22:37:00
77e823e1ad71c652cd9d5022306896838311ad17...19c0d71a949273a719e477c920fce95d71602609,1,1,0,1,1,2012-12-24 01:34:07,2012-12-23 23:14:31
19c0d71a949273a719e477c920fce95d71602609...ae5ced20b3fd0bfbcaae16d288ffd3c928677a6f,2,1,7,8,3,2012-12-24 01:44:25,2012-12-24 00:03:22
ae5ced20b3fd0bfbcaae16d288ffd3c928677a6f...4b6a074becdcaf59442ce828bdc701a504aea2e0,1,0,1,1,1,2012-12-24 02:06:45,2012-12-24 02:06:45
4b6a074becdcaf59442ce828bdc701a504aea2e0...f722a43a3ac6973d9f350afc9730c1c3181facf2,1,0,2,2,1,2012-12-24 02:44:13,2012-12-24 02:44:13
f722a43a3ac6973d9f350afc9730c1c3181facf2...80ffdeeed3a2ca2b0e4c3178260e0ad6a368c765,2,10,2,12,3,2012-12-24 03:33:56,2012-12-23 23:15:28
80ffdeeed3a2ca2b0e4c3178260e0ad6a368c765...76646ce218cde8f9a79496d84b1f319a46f42317,2,17,1,18,4,2012-12-24 03:37:11,2012-12-24 02:37:28
76646ce218cde8f9a79496d84b1f319a46f42317...14cf20504b6d37117dc365f24a9f0e7db22dd995,1,2,6,8,4,2012-12-24 04:04:15,2012-12-24 00:34:04
14cf20504b6d37117dc365f24a9f0e7db22dd995...538134e8bb0400e790beb6761f7306c5dd65b411,2,9,6,15,8,2012-12-24 04:04:16,2012-12-24 00:45:50
538134e8bb0400e790beb6761f7306c5dd65b411...8bc01d2eb642514983eeb87ff3c696b8ac6c3b46,2,77,8,85,8,2012-12-24 04:50:51,2012-12-23 23:24:37
8bc01d2eb642514983eeb87ff3c696b8ac6c3b46...4252beda7ebbadc24c61dabed66a0609e6ac3dae,1,9,3,12,2,2012-12-24 08:37:37,2012-12-24 08:37:37
4252beda7ebbadc24c61dabed66a0609e6ac3dae...a321943143ef35ae26893b98847207c2045703e6,1,46,22,68,12,2012-12-24 11:32:40,2012-12-24 01:18:16
a321943143ef35ae26893b98847207c2045703e6...5c83c4816968294b6a930374332154b9549f67e3,2,25,1,26,2,2012-12-24 14:22:49,2012-12-24 14:22:49
5c83c4816968294b6a930374332154b9549f67e3...2bdf5cb1ea4b2a7709ffcc2b03b8394eea961118,1,1,1,2,1,2012-12-24 14:28:01,2012-12-24 14:09:49
2bdf5cb1ea4b2a7709ffcc2b03b8394eea961118...7b3ac96879653d879a5f24b9768cec7e279603aa,1,35,35,70,14,2012-12-24 14:28:01,2012-12-24 14:12:55
7b3ac96879653d879a5f24b9768cec7e279603aa...ac674ac1530d7a7c58f567894135e31783deb65a,4,17,13,30,8,2012-12-24 15:47:02,2012-12-24 15:47:02
ac674ac1530d7a7c58f567894135e31783deb65a...27e342b284e0b43190a09d1f9b39ad489c04c8cc,2,19,11,30,6,2012-12-24 15:51:23,2012-12-24 15:51:06
27e342b284e0b43190a09d1f9b39ad489c04c8cc...8214e8666e5d291b767075c250ec2b7dd06c265a,3,288,7,295,5,2012-12-24 17:59:09,2012-11-07 03:03:03
8214e8666e5d291b767075c250ec2b7dd06c265a...2bf4f80e8895207146cfb68f1cc3c19e6c2be5c7,1,4,4,8,4,2012-12-24 18:18:44,2012-12-24 18:18:19
2bf4f80e8895207146cfb68f1cc3c19e6c2be5c7...24b17d7c2b429d3a39ee2a41a2e3f5fae11b78d7,1,7,4,11,1,2012-12-24 18:18:44,2012-12-24 18:18:30
24b17d7c2b429d3a39ee2a41a2e3f5fae11b78d7...26deb3c91225f45353fa9dd8b3dd8383535fff08,12,285,194,479,105,2012-12-24 18:50:36,2012-12-24 17:58:30
26deb3c91225f45353fa9dd8b3dd8383535fff08...009df3c38250011ae22cc65f81656e28d26f9c37,1,6,2,8,1,2012-12-24 20:24:15,2012-12-24 20:24:15
009df3c38250011ae22cc65f81656e28d26f9c37...a3a5fd617cc9bc7df0083c60094ec6d804ddba3a,6,208,19,227,17,2012-12-24 22:30:16,2012-12-24 22:30:16
a3a5fd617cc9bc7df0083c60094ec6d804ddba3a...5f453739cc2d4f17341395115a2d27cda5894f38,1,4,1,5,2,2012-12-25 01:11:05,2012-12-25 01:11:05
5f453739cc2d4f17341395115a2d27cda5894f38...bca5026bbecea061eb599d8345db5223b5a790c1,2,6,2,8,4,2012-12-25 03:29:00,2012-12-25 03:29:00
bca5026bbecea061eb599d8345db5223b5a790c1...13a61cb9c7ddce77b7f9aab812443802da8ee955,1,0,4,4,2,2012-12-25 03:41:01,2012-12-25 03:40:14
13a61cb9c7ddce77b7f9aab812443802da8ee955...d2df300721805ace411b5d1a87cb4bf6d8a51ff3,85,28945,2,28947,87,2012-12-25 17:25:45,2012-12-25 17:07:05
d2df300721805ace411b5d1a87cb4bf6d8a51ff3...f201972ecc87f099777e1c61f269998f4399caf4,64,8070,0,8070,64,2012-12-25 17:25:45,2012-12-25 17:08:28
f201972ecc87f099777e1c61f269998f4399caf4...d6cf0d675c7067e1a26ae5ee4ddd6dc16ea2feb2,1,9,0,9,1,2012-12-25 17:40:37,2012-12-25 17:40:37
d6cf0d675c7067e1a26ae5ee4ddd6dc16ea2feb2...2ae88e148381a437f6a8bdbaab09e5200cad4b68,1,1,1,2,1,2012-12-25 17:42:47,2012-12-25 17:42:47
2ae88e148381a437f6a8bdbaab09e5200cad4b68...3854df8471a90e6a684d8bb60c195232f3a65e99,9,3094,30,3124,88,2012-12-26 00:18:05,2012-12-26 00:18:05
3854df8471a90e6a684d8bb60c195232f3a65e99...80507d135a22723e95f5b1be9938c3bf5309d273,1,1,1,2,1,2012-12-26 01:00:42,2012-12-26 01:00:42
80507d135a22723e95f5b1be9938c3bf5309d273...000ea9d49c4de0c68002809ad1b0b9558c1a5771,3,4,0,4,3,2012-12-26 14:26:29,2012-12-26 14:26:29
000ea9d49c4de0c68002809ad1b0b9558c1a5771...513470c4d1a2cef523f6423fdf57a550fa69cbc7,6,114,6,120,12,2012-12-26 17:03:09,2012-12-24 01:20:35
513470c4d1a2cef523f6423fdf57a550fa69cbc7...27f0a166ec56f5cfc56536f1b4160d98ee726f2d,1,0,1,1,1,2012-12-26 17:07:19,2012-12-26 16:51:40
27f0a166ec56f5cfc56536f1b4160d98ee726f2d...eebab54fc2463ceb686a47f756eab6cf37e60a17,1,1,0,1,1,2012-12-26 18:24:24,2012-12-26 18:24:24
eebab54fc2463ceb686a47f756eab6cf37e60a17...6ba39d0b64d1d4563e56892885851338b9a475ce,2,4,0,4,2,2012-12-26 18:31:43,2012-12-26 18:31:43
6ba39d0b64d1d4563e56892885851338b9a475ce...b02a79e172c50ca42aefba49b57cebf87ec508a4,1,6,4,10,1,2012-12-26 18:35:03,2012-12-26 18:35:00
b02a79e172c50ca42aefba49b57cebf87ec508a4...9b32a7bcf4fd8993b60c5f92b0422e727e3b6ade,3,24,40,64,17,2012-12-26 19:17:01,2012-12-21 19:21:47
9b32a7bcf4fd8993b60c5f92b0422e727e3b6ade...b5c154a792a28f4164e54057e1eb3044002e4551,2,14,10,24,8,2012-12-26 19:17:01,2012-12-21 21:23:14
b5c154a792a28f4164e54057e1eb3044002e4551...2d20562cceb1ff6ac01d7ce04fa4346c984b9a94,4,147,16,163,19,2012-12-26 19:17:01,2012-12-21 23:15:28
2d20562cceb1ff6ac01d7ce04fa4346c984b9a94...020047aefeb662e42f4f72f0782ce6734a01d2b0,6,31,1,32,6,2012-12-26 20:08:16,2012-12-26 20:08:08
020047aefeb662e42f4f72f0782ce6734a01d2b0...70a6456c39e919b119472b4f466fb2128458a985,1,0,1,1,1,2012-12-26 21:13:09,2012-12-26 21:13:09
70a6456c39e919b119472b4f466fb2128458a985...242af4e3999d1f326128c55e9686dc9c522bb00b,1,1,1,2,1,2012-12-26 21:13:31,2012-12-26 21:07:14
242af4e3999d1f326128c55e9686dc9c522bb00b...2f21426abe2d75487c91fb361154261969d303cd,16,887,32,919,53,2012-12-26 21:56:49,2012-12-26 21:56:49
2f21426abe2d75487c91fb361154261969d303cd...6d9965560701c890081f5c982bc280100f5aae63,3,21,14,35,11,2012-12-26 22:10:57,2012-12-26 20:20:04
6d9965560701c890081f5c982bc280100f5aae63...1e48eeab982d385e75ad9a25b5eecd2c93cc1659,3,17,24,41,18,2012-12-26 22:10:57,2012-12-26 20:57:05
1e48eeab982d385e75ad9a25b5eecd2c93cc1659...793311b68a095cb86c82be523090b5b338b96458,1,0,1,1,1,2012-12-26 22:24:40,2012-12-26 22:24:40
793311b68a095cb86c82be523090b5b338b96458...d06c2ff635acc548e73381d669d9f66f7e225ea8,2,68,9,77,3,2012-12-26 23:36:08,2012-12-26 23:36:02
d06c2ff635acc548e73381d669d9f66f7e225ea8...b012f057c65f112f83d7bf49a0fcd885188fa41b,1,9,2,11,1,2012-12-27 00:01:01,2012-12-27 00:01:01
b012f057c65f112f83d7bf49a0fcd885188fa41b...283fc0d291c196232cebc8b964178037aa71f943,3,9,1,10,4,2012-12-27 00:53:41,2012-12-27 00:53:37
283fc0d291c196232cebc8b964178037aa71f943...325ec6e4d66dfdc075b47a804314eec8f7ea3eb2,1,5,4,9,5,2012-12-27 00:59:22,2012-12-27 00:59:22
325ec6e4d66dfdc075b47a804314eec8f7ea3eb2...c5e5e6b9c0d9609234afd1390984d08f6055801b,2,12,8,20,11,2012-12-27 02:15:32,2012-12-27 01:42:47
c5e5e6b9c0d9609234afd1390984d08f6055801b...7962e49b40c2bf344187df4c6fdd857c2255d759,1,1,1,2,1,2012-12-27 02:23:22,2012-12-27 02:23:22
7962e49b40c2bf344187df4c6fdd857c2255d759...e561ddfb5a5fba96741138e4f4125be126ba25bd,4,1066,30,1096,28,2012-12-27 04:15:30,2012-12-27 01:56:42
e561ddfb5a5fba96741138e4f4125be126ba25bd...9a9a2a35cf794189fc2ebd8fa772ed37e1eed329,2,8,8,16,8,2012-12-27 04:58:05,2012-12-27 04:58:05
9a9a2a35cf794189fc2ebd8fa772ed37e1eed329...7b27beab091addc90e058d7342d0db360f271c62,2,4,2,6,2,2012-12-27 05:47:19,2012-12-27 05:47:19
7b27beab091addc90e058d7342d0db360f271c62...109e2bc05ce1b96f35139f46875dfe6411530cad,2,8,0,8,2,2012-12-27 06:35:20,2012-12-27 06:34:42
109e2bc05ce1b96f35139f46875dfe6411530cad...db368e2aa0e520e835416c3dde8668da7dd1366f,1,3,0,3,1,2012-12-27 07:25:25,2012-12-27 07:25:06
db368e2aa0e520e835416c3dde8668da7dd1366f...a02754295ab258f2d10f1c1d668c3f24c633afb1,6,182,1,183,7,2012-12-27 08:51:48,2012-12-27 08:50:15
a02754295ab258f2d10f1c1d668c3f24c633afb1...871d874036a841253cd7c8d6b1d31f506d8099eb,6,43,172,215,24,2012-12-27 09:19:52,2012-12-27 09:19:41
871d874036a841253cd7c8d6b1d31f506d8099eb...68ab8587507637e337035632eb0827ea73dac58f,3,12,14,26,5,2012-12-27 09:52:26,2012-12-27 09:52:26
68ab8587507637e337035632eb0827ea73dac58f...0963605989b76bb98fcca08fd73774f818efb5cb,2,3,2,5,3,2012-12-27 15:14:41,2012-12-27 15:10:06
0963605989b76bb98fcca08fd73774f818efb5cb...e972491122daadd7e7cfff888de46611d008d11b,1,2,1,3,1,2012-12-27 16:21:46,2012-12-27 16:21:46
e972491122daadd7e7cfff888de46611d008d11b...db802e6e4e58b4a1ffd62d8916b7128b66d95747,1,0,0,0,0,2012-12-27 16:23:13,2012-12-27 16:23:13
db802e6e4e58b4a1ffd62d8916b7128b66d95747...ccf86a0fdbe7f9c9a45e8fad0410a7eef777fea2,1,1,1,2,1,2012-12-27 16:44:18,2012-12-27 16:44:18
ccf86a0fdbe7f9c9a45e8fad0410a7eef777fea2...1fd36965705e7bbcaec5e855d0b8c072e41ff20b,2,6,2,8,3,2012-12-27 17:38:45,2012-12-27 17:38:45
1fd36965705e7bbcaec5e855d0b8c072e41ff20b...19bba17e74b5cbbd199080b26dbcf903ee6db3e7,2,2,6,8,3,2012-12-27 18:01:04,2012-12-27 18:01:04
19bba17e74b5cbbd199080b26dbcf903ee6db3e7...2b6c0b2de87857f007adee67bb06c81b414c41fc,2,9,68,77,3,2012-12-27 18:01:34,2012-12-27 18:01:34
2b6c0b2de87857f007adee67bb06c81b414c41fc...0d3539f1ea4489c1e97891ab7d72c7b6d4684521,1,1,1,2,1,2012-12-27 18:02:16,2012-12-27 18:02:16
0d3539f1ea4489c1e97891ab7d72c7b6d4684521...b351a198d52f0cae28e549098925de3121ebd493,1,22,4,26,3,2012-12-27 18:53:05,2012-12-27 18:53:05
b351a198d52f0cae28e549098925de3121ebd493...e9208a08eeb6757902bb79ba0d485046e222d7bf,1,1,6,7,2,2012-12-27 18:58:50,2012-12-27 18:58:50
e9208a08eeb6757902bb79ba0d485046e222d7bf...5b24436ec22e8925d921a5f070e5c46132915f6c,10,145,62,207,45,2012-12-27 19:59:19,2012-12-27 19:59:19
5b24436ec22e8925d921a5f070e5c46132915f6c...f498a5c235e4da255d9cfea336b66b9c30403706,6,145,4,149,8,2012-12-27 20:20:18,2012-12-22 21:34:06
f498a5c235e4da255d9cfea336b66b9c30403706...91865e62b25c3969e38684ac1e15f2799cdf018e,1,3,0,3,1,2012-12-27 22:30:35,2012-12-27 22:27:58
91865e62b25c3969e38684ac1e15f2799cdf018e...5a16894d45d9236acb348e0d9d805320c08c294e,2,76,3,79,4,2012-12-28 06:41:39,2012-12-28 06:41:39
5a16894d45d9236acb348e0d9d805320c08c294e...748634387395ca84dbe5dfff4f91bd9da4946f3b,1,0,3,3,2,2012-12-28 08:56:03,2012-12-28 08:56:03
748634387395ca84dbe5dfff4f91bd9da4946f3b...fb08f1c01d9bc3808ec22b49eac66638f38dca66,8,150,49,199,37,2012-12-28 13:16:08,2012-12-27 20:54:59
fb08f1c01d9bc3808ec22b49eac66638f38dca66...95262b4c34bdd9c71cff1f17d3e390b81f8f326d,2,31,11,42,9,2012-12-28 14:41:10,2012-12-28 04:05:31
95262b4c34bdd9c71cff1f17d3e390b81f8f326d...903865b5d1fbdf4b3f9302fa92a9c1cc8488764a,1,0,1,1,1,2012-12-28 14:41:10,2012-12-28 14:40:43
903865b5d1fbdf4b3f9302fa92a9c1cc8488764a...04a27ca4b43c3cc3c71bebab6d917a1ef0f260a4,2,16,0,16,2,2012-12-28 14:44:17,2012-12-28 14:44:17
04a27ca4b43c3cc3c71bebab6d917a1ef0f260a4...11ef57e23acfbf079d4b74055413ba9631e63dc0,1,4,2,6,2,2012-12-28 14:47:02,2012-12-28 14:47:02
11ef57e23acfbf079d4b74055413ba9631e63dc0...56944b0240ae4bce795e728f5decd21f2b09be88,1,5,3,8,1,2012-12-28 16:29:34,2012-12-28 16:24:47
56944b0240ae4bce795e728f5decd21f2b09be88...9e4c23bb48d70dbf158ea79f3cc1500c35fa555d,1,8,2,10,2,2012-12-28 20:05:28,2012-12-28 20:05:28
9e4c23bb48d70dbf158ea79f3cc1500c35fa555d...e733331c7edb8871ba2dc58f20fbd2f40bf3adda,1,5,2,7,4,2012-12-28 20:05:56,2012-12-28 20:05:56
e733331c7edb8871ba2dc58f20fbd2f40bf3adda...9661888594bc3606a469a01a9e30fe76b3e895f3,1,16,1,17,1,2012-12-28 20:52:29,2012-12-28 20:49:23
9661888594bc3606a469a01a9e30fe76b3e895f3...7dd78bb5b8b6ed0b64f5e45510585fb3602930d9,2,42,42,84,3,2012-12-28 21:09:51,2012-12-27 23:28:43
7dd78bb5b8b6ed0b64f5e45510585fb3602930d9...941c5bd713c16ef82f2be71fcb3b6af19f414512,1,1,1,2,1,2012-12-29 04:42:33,2012-12-29 04:42:33
941c5bd713c16ef82f2be71fcb3b6af19f414512...5d0c96677b000cb175943f002137a31e874d4b41,4,37,18,55,14,2012-12-31 04:25:41,2012-12-31 04:25:41
5d0c96677b000cb175943f002137a31e874d4b41...d1f7eee6a26eb4d0eaf1ad42cc7feb597031e075,1,0,1,1,1,2012-12-31 05:03:30,2012-12-31 05:03:30
d1f7eee6a26eb4d0eaf1ad42cc7feb597031e075...bd05bb2077200a95b752aa1a418267c83ab774f6,2,19,1,20,10,2012-12-31 05:22:11,2012-12-31 05:22:11
bd05bb2077200a95b752aa1a418267c83ab774f6...4a9c84693a439aa4c481f82ae32de80062c0bb8a,3,15,2,17,3,2012-12-31 05:22:25,2012-12-31 05:22:25
4a9c84693a439aa4c481f82ae32de80062c0bb8a...33600ec3892bb411363bf1aa802d245b58633ea9,1,2,1,3,1,2012-12-31 08:23:02,2012-12-31 08:23:02
33600ec3892bb411363bf1aa802d245b58633ea9...bc8a25a7f02c7846e60c09063202aa7f275fc0e5,2,2,1,3,2,2012-12-31 15:58:26,2012-12-31 15:58:26
bc8a25a7f02c7846e60c09063202aa7f275fc0e5...62cb06b7979fc06f13d18127d0da568d9bcd485c,1,4,0,4,1,2012-12-31 21:00:41,2012-12-31 21:00:41
62cb06b7979fc06f13d18127d0da568d9bcd485c...5e4b69b88e39180a527871e44efc4911a44a4d6e,1,2,1,3,2,2013-01-01 05:03:31,2013-01-01 05:03:31
5e4b69b88e39180a527871e44efc4911a44a4d6e...eaf67b09cf3ed66294f334c655539e2224bd807a,1,45,25,70,12,2013-01-01 05:04:06,2013-01-01 05:04:06
eaf67b09cf3ed66294f334c655539e2224bd807a...5860ed9463e9275cda4e50008be6d83ec849b560,1,18,4,22,6,2013-01-01 05:05:17,2013-01-01 05:05:17
5860ed9463e9275cda4e50008be6d83ec849b560...23a02cffe69cccd4fb9911dec350c0f5c5b8dd10,1,8,2,10,2,2013-01-01 21:42:43,2013-01-01 21:42:43
23a02cffe69cccd4fb9911dec350c0f5c5b8dd10...fc54b8f7df91b004032dda651e8debe694aa8157,2,24,0,24,7,2013-01-02 02:47:25,2013-01-02 02:47:25
fc54b8f7df91b004032dda651e8debe694aa8157...43cc1547aaf72146f937d3ae72325807539a4199,2,19,4,23,10,2013-01-02 15:07:38,2012-12-21 22:59:19
43cc1547aaf72146f937d3ae72325807539a4199...e04a7396ea753ea6dbff89028c11ed689868d707,16,39,931,970,59,2013-01-02 15:44:58,2013-01-02 15:41:44
e04a7396ea753ea6dbff89028c11ed689868d707...c1da06e5c42172e6fa867bf8a132d2531471ff9d,2,4,19,23,10,2013-01-02 17:59:04,2013-01-02 17:59:04
c1da06e5c42172e6fa867bf8a132d2531471ff9d...8c9373d63d68efa0966c76bb41e36922972b5fcd,2,20,4,24,11,2013-01-02 18:09:01,2013-01-02 17:59:36
8c9373d63d68efa0966c76bb41e36922972b5fcd...ed4025a96991b95bb61ac7f6aa109bbe8be3c545,1,7,1,8,2,2013-01-02 22:11:11,2013-01-02 22:06:49
ed4025a96991b95bb61ac7f6aa109bbe8be3c545...3e309515a71cbece88fa22120ff264ee34d18407,1,9,2,11,3,2013-01-02 23:09:31,2013-01-02 21:42:30
3e309515a71cbece88fa22120ff264ee34d18407...8cd5176a2a5b2373cae5823c9a2b7b6af1c597a4,2,97,14,111,8,2013-01-02 23:18:28,2013-01-02 20:56:17
8cd5176a2a5b2373cae5823c9a2b7b6af1c597a4...8023819729014b7d84d1efc3c08a2ec9c0658de1,2,22,4,26,6,2013-01-02 23:44:38,2013-01-02 23:23:11
8023819729014b7d84d1efc3c08a2ec9c0658de1...f9fa29ad81ca5c8588918c2ded1c75ad672d2adc,1,5,2,7,2,2013-01-03 00:04:55,2013-01-02 23:59:23
f9fa29ad81ca5c8588918c2ded1c75ad672d2adc...0c99deae0ce63b0ae000175cbc4d446aa094d2de,1,4,8,12,3,2013-01-03 00:08:16,2013-01-03 00:01:30
0c99deae0ce63b0ae000175cbc4d446aa094d2de...ae5a98ca54b4c9287cf7634d8086a44930f7c0b5,9,1551,1782,3333,731,2013-01-03 00:42:09,2013-01-03 00:42:09
ae5a98ca54b4c9287cf7634d8086a44930f7c0b5...bfa4ef93adf108db2fc6f99d3a55317f3f790b65,5,43,16,59,13,2013-01-03 00:49:33,2012-12-21 23:35:42
bfa4ef93adf108db2fc6f99d3a55317f3f790b65...234fabfd27e8732b1fe42e2f885f64371de5a774,1,27,2,29,4,2013-01-03 15:41:17,2013-01-03 01:59:46
234fabfd27e8732b1fe42e2f885f64371de5a774...b3687e73545f6d0d04f1992119308e7ab80d44e1,4,432,299,731,182,2013-01-03 17:19:31,2013-01-03 17:19:13
b3687e73545f6d0d04f1992119308e7ab80d44e1...56090cce56cc8e700b8dedc809e50523d3272cea,1,9,9,18,7,2013-01-03 21:23:09,2013-01-03 21:23:09
56090cce56cc8e700b8dedc809e50523d3272cea...ebe82a67f125af7b91ee00d82862328ce001ec4e,2,6,7,13,5,2013-01-03 22:09:46,2013-01-03 22:09:40
ebe82a67f125af7b91ee00d82862328ce001ec4e...334e1affbe57567362c1f13cd08a2f1cb6d716fc,1,5,2,7,1,2013-01-03 22:45:15,2013-01-03 22:45:15
334e1affbe57567362c1f13cd08a2f1cb6d716fc...2add89edce7122e2cb72aa928dfc476c95024fe5,1,5,4,9,2,2013-01-03 22:52:05,2013-01-03 22:52:05
2add89edce7122e2cb72aa928dfc476c95024fe5...7cbbcbbb04fe3f4c4822a10f9fab2a5975cfc75c,1,12,2,14,2,2013-01-03 23:30:53,2013-01-03 23:22:39
7cbbcbbb04fe3f4c4822a10f9fab2a5975cfc75c...a428db77dfdebf04c4a7dcd4cc7073ec2160a463,1,2,2,4,2,2013-01-03 23:58:42,2013-01-03 23:49:12
a428db77dfdebf04c4a7dcd4cc7073ec2160a463...1c5d333d1bfd11475e32c3c8979cfa693a3f9b14,4,77,6,83,7,2013-01-04 00:15:10,2013-01-03 20:28:43
1c5d333d1bfd11475e32c3c8979cfa693a3f9b14...c64be9ced818ee33c02b469f96903a610ef6007b,1,4,0,4,1,2013-01-04 19:13:08,2013-01-04 18:39:39
c64be9ced818ee33c02b469f96903a610ef6007b...a77eee6cb39573656d329a90b14aa9bd75a4b6a8,1,3,0,3,1,2013-01-04 23:39:34,2013-01-04 23:38:46
a77eee6cb39573656d329a90b14aa9bd75a4b6a8...ea17746c8bada229b5b5dff7e2a5e7dce3c4ab59,1,7,5,12,2,2013-01-04 23:41:52,2013-01-04 23:36:57
ea17746c8bada229b5b5dff7e2a5e7dce3c4ab59...0eba42b858f33c2e016a9b0c496e22043ddecace,1,19,3,22,7,2013-01-05 00:04:05,2013-01-04 23:16:56
0eba42b858f33c2e016a9b0c496e22043ddecace...f3c92a4b2afc59ba737a99172eb9bf798530a034,2,47,10,57,10,2013-01-05 00:21:06,2013-01-05 00:20:56
f3c92a4b2afc59ba737a99172eb9bf798530a034...28fcd53854a3aeec10cb7fad65ee782034dae15d,2,3,2,5,3,2013-01-05 00:42:32,2013-01-05 00:34:03
28fcd53854a3aeec10cb7fad65ee782034dae15d...09679f6b9bfbddd3f9dd092433a16c29765f2fc8,6,14,1,15,6,2013-01-06 21:08:47,2013-01-06 21:08:47
09679f6b9bfbddd3f9dd092433a16c29765f2fc8...b5e82274602b5f4af862d93b0f75fd3fd3c8ee9f,1,3,0,3,1,2013-01-06 22:37:00,2013-01-06 22:37:00
b5e82274602b5f4af862d93b0f75fd3fd3c8ee9f...e08992e04ae2867a1e52d00e62526c2695e8c14f,1,1,1,2,1,2013-01-07 01:58:09,2013-01-07 01:58:09
e08992e04ae2867a1e52d00e62526c2695e8c14f...be56edc259bb5c0e3bb862c69a6303705ef453f4,1,5,0,5,1,2013-01-07 02:45:53,2013-01-07 02:45:53
be56edc259bb5c0e3bb862c69a6303705ef453f4...10b3fbf534cbf677e0324da7705ee6d019345b4c,1,2,0,2,2,2013-01-07 15:58:53,2013-01-07 15:58:53
10b3fbf534cbf677e0324da7705ee6d019345b4c...7c8a88ac38879d63908f0d17d35f0252a8c06ba6,3,16,10,26,8,2013-01-07 16:43:58,2013-01-04 20:08:46
7c8a88ac38879d63908f0d17d35f0252a8c06ba6...dabfef364f9af1352255c64fa9266c3d23bad122,1,12,0,12,1,2013-01-07 17:03:14,2012-12-17 21:56:49
dabfef364f9af1352255c64fa9266c3d23bad122...8d4aeec0eb811f02d7863fecb2b9502802005fbb,2,0,4,4,2,2013-01-07 17:48:31,2013-01-07 17:48:31
8d4aeec0eb811f02d7863fecb2b9502802005fbb...fb217cf590840459b8d2193f53f2a795a14960ec,2,29,0,29,3,2013-01-07 18:19:59,2013-01-07 17:04:13
fb217cf590840459b8d2193f53f2a795a14960ec...8204ea427d2e4944624d2f49bebac1418b9550c0,7,190,44,234,33,2013-01-07 22:03:18,2013-01-07 21:00:40
8204ea427d2e4944624d2f49bebac1418b9550c0...0aea5af06d60eb75f3073127ff82ab66284df68c,3,64,1,65,4,2013-01-07 23:20:05,2013-01-07 19:41:49
0aea5af06d60eb75f3073127ff82ab66284df68c...ec077b8848107fc3d42bc4ec9265ebb66d9e17d1,1,13,4,17,4,2013-01-07 23:49:02,2013-01-07 23:38:47
ec077b8848107fc3d42bc4ec9265ebb66d9e17d1...0547ed8a19c701822bc562cfcecea0688573eccc,1,8,1,9,3,2013-01-08 05:27:56,2013-01-08 05:27:56
0547ed8a19c701822bc562cfcecea0688573eccc...fb05f51383f89b6422e420508f2101aad6b18961,2,7,4,11,5,2013-01-08 06:26:13,2013-01-08 06:26:13
fb05f51383f89b6422e420508f2101aad6b18961...1c8278985f7376dd07f25427e65351d7fe460672,6,4,20,24,12,2013-01-08 09:26:17,2013-01-07 09:28:24
1c8278985f7376dd07f25427e65351d7fe460672...2e39303482c92e075012ca44ad76f9db1f00da0e,1,15,1,16,1,2013-01-08 16:57:55,2013-01-08 16:33:45
2e39303482c92e075012ca44ad76f9db1f00da0e...e703648398e5e6df847483422bb56b5523b62595,1,1,0,1,1,2013-01-08 19:49:45,2013-01-08 19:49:45
e703648398e5e6df847483422bb56b5523b62595...95a3407fa9a673ac21e966e6f5e751ab35b63311,1,8,1,9,1,2013-01-08 20:57:22,2013-01-08 20:56:49
95a3407fa9a673ac21e966e6f5e751ab35b63311...e03279bb3d581b87b01486fa496267b57bf6b304,1,1,1,2,1,2013-01-08 21:31:10,2013-01-08 21:31:10
e03279bb3d581b87b01486fa496267b57bf6b304...97eca5fe66c68f290e9c29535fce1e058988660d,4,213,41,254,10,2013-01-09 17:12:05,2013-01-09 17:12:05
97eca5fe66c68f290e9c29535fce1e058988660d...e83157eda5598393e2b2783e036daf259af21421,1,1,1,2,1,2013-01-09 17:37:49,2013-01-09 17:37:49
e83157eda5598393e2b2783e036daf259af21421...0f1d143bf508de6e5735e1d984f5edb772f8ae4c,3,38,4,42,14,2013-01-09 17:42:09,2013-01-09 17:42:09
0f1d143bf508de6e5735e1d984f5edb772f8ae4c...27637ed300e7e9af9b6998e73fce13f96b195a30,2,138,0,138,2,2013-01-09 17:54:36,2013-01-09 17:54:36
27637ed300e7e9af9b6998e73fce13f96b195a30...5f6172c3c31313ff99553c28db17ed1b9c269d9a,7,75,34,109,16,2013-01-09 19:27:20,2013-01-09 04:57:09
5f6172c3c31313ff99553c28db17ed1b9c269d9a...82d7498b6a362847c0367a17fb5ebe07d9c9cb5a,8,68,0,68,16,2013-01-09 19:48:36,2013-01-09 19:48:36
82d7498b6a362847c0367a17fb5ebe07d9c9cb5a...5ffba5f721f6f17b41b9bd8782b3c79567fd27d3,3,58,1,59,3,2013-01-09 21:19:47,2013-01-09 16:52:00
5ffba5f721f6f17b41b9bd8782b3c79567fd27d3...cd8efe3eb044511e736cc9b4f6caa21ccde571ab,1,11,1,12,4,2013-01-09 21:35:31,2013-01-09 19:59:37
cd8efe3eb044511e736cc9b4f6caa21ccde571ab...3aff9a906f6f7b9681187813c71a17332fb6ede3,1,6,3,9,4,2013-01-09 21:57:50,2013-01-09 21:57:50
3aff9a906f6f7b9681187813c71a17332fb6ede3...641faecc1dfe888c1061b18d707665f027f221c4,2,13,3,16,4,2013-01-09 22:08:24,2013-01-09 22:08:24
641faecc1dfe888c1061b18d707665f027f221c4...b2ab9737664420fbaeaf16c39f06bd53dfc13a4f,2,43,20,63,12,2013-01-09 22:32:12,2013-01-09 16:57:29
b2ab9737664420fbaeaf16c39f06bd53dfc13a4f...0c05bdf0be1afa381548372a9e8ea6e2726fc018,2,39,11,50,3,2013-01-09 22:42:18,2013-01-09 04:09:28
0c05bdf0be1afa381548372a9e8ea6e2726fc018...19ab4ba71c5793878d6588d6c9d6eb6fee26c6d9,1,13,0,13,1,2013-01-09 22:48:52,2013-01-09 22:48:33
19ab4ba71c5793878d6588d6c9d6eb6fee26c6d9...17cc56d647f8edb44ea2d130850bfb037cbd672f,1,0,13,13,1,2013-01-09 23:02:52,2013-01-09 23:02:52
17cc56d647f8edb44ea2d130850bfb037cbd672f...df44332cdbff34954e32e55ed9c0960248c88773,1,1,0,1,1,2013-01-10 07:29:42,2013-01-10 07:29:42
df44332cdbff34954e32e55ed9c0960248c88773...f405c58e098a67158b004f48e121e45146a89afa,2,2,2,4,2,2013-01-10 16:37:30,2013-01-10 16:37:30
f405c58e098a67158b004f48e121e45146a89afa...d0e873e7acf41b1315e73d67b59531f6339c4119,1,1,1,2,1,2013-01-11 04:55:13,2013-01-11 04:55:13
d0e873e7acf41b1315e73d67b59531f6339c4119...4ba4aae6776c5832fcf613884eaca31382cde7a4,3,23,17,40,7,2013-01-11 15:33:36,2013-01-09 20:53:03
4ba4aae6776c5832fcf613884eaca31382cde7a4...2e7a1a24160a09c9de2df4caad0fc9c2a278b998,3,26,5,31,9,2013-01-11 15:33:36,2013-01-10 22:53:16
2e7a1a24160a09c9de2df4caad0fc9c2a278b998...4968e36adf286829d80dc857f515d77ace6a801a,1,9,27,36,7,2013-01-11 15:33:36,2013-01-11 15:33:20
4968e36adf286829d80dc857f515d77ace6a801a...ee22c23a0d1cb96e4ba6aab86a20323f1b9762ec,1,0,75,75,1,2013-01-11 19:43:28,2013-01-11 19:43:28
ee22c23a0d1cb96e4ba6aab86a20323f1b9762ec...03ae388bb6e855a7988fe227dfc84797fbe0129c,2,3,1,4,2,2013-01-11 20:11:58,2012-11-27 19:14:32
03ae388bb6e855a7988fe227dfc84797fbe0129c...0a6d331be5ed7733de344bc41ede34f4a2ae4dd9,1,1,2,3,2,2013-01-11 20:16:09,2013-01-11 20:15:55
0a6d331be5ed7733de344bc41ede34f4a2ae4dd9...03b80fb81feb076a618b275825f1c662bba9237d,2,18,7,25,4,2013-01-11 22:07:04,2013-01-10 08:05:44
03b80fb81feb076a618b275825f1c662bba9237d...5053efc1043a095a013c40af1cc382a60895d4b5,7,439,8,447,17,2013-01-11 23:15:44,2013-01-11 22:40:10
5053efc1043a095a013c40af1cc382a60895d4b5...7171263319c21da0e1b2b56b56490971a8584722,1,1,1,2,1,2013-01-12 12:09:47,2013-01-12 12:09:47
7171263319c21da0e1b2b56b56490971a8584722...0cc5b98a25462d7403c9976aaaa04660d8b390c2,1,5,5,10,1,2013-01-13 17:05:49,2013-01-13 16:53:09
0cc5b98a25462d7403c9976aaaa04660d8b390c2...36253b27bf227cf3919d4813dd0199caef3b17fb,2,36,7,43,6,2013-01-13 17:05:49,2013-01-13 17:04:37
36253b27bf227cf3919d4813dd0199caef3b17fb...e3ab2ed4f9612a0b6b9e8cf0505e4b979b511472,12,677,13,690,37,2013-01-14 11:02:16,2013-01-14 11:02:16
e3ab2ed4f9612a0b6b9e8cf0505e4b979b511472...8af04aac6b443b448b4bad7f97e6ae28aebce95a,2,21,0,21,2,2013-01-14 15:54:30,2013-01-14 15:54:30
8af04aac6b443b448b4bad7f97e6ae28aebce95a...0909a37d8a61700bb499d21d3597f38451ac9bff,1,8,4,12,4,2013-01-14 16:07:20,2013-01-14 16:07:20
0909a37d8a61700bb499d21d3597f38451ac9bff...da0ddc4023a9dbfa1a615ea7b5ac28ef903c850b,1,2,2,4,1,2013-01-14 16:14:33,2013-01-14 16:12:21
da0ddc4023a9dbfa1a615ea7b5ac28ef903c850b...f86c2934777dc12244b60829c8da9bff1097a877,1,2,2,4,2,2013-01-14 16:16:52,2013-01-14 16:16:52
f86c2934777dc12244b60829c8da9bff1097a877...d389aca222298dc75e83a2e25c0339fc09493ffc,25,832,663,1495,142,2013-01-14 17:59:49,2013-01-11 18:54:10
d389aca222298dc75e83a2e25c0339fc09493ffc...16bc4ef44f7cd121e811d92afcee1f34556100aa,2,51,1,52,3,2013-01-14 18:13:43,2013-01-12 15:54:52
16bc4ef44f7cd121e811d92afcee1f34556100aa...29a4db1a89ebb658669c88dd01abe742298f96fa,1,2,1,3,1,2013-01-14 18:50:33,2013-01-14 18:34:03
29a4db1a89ebb658669c88dd01abe742298f96fa...13801770f1633e976854fc0c2a1c75a3a8352c33,1,4,3,7,2,2013-01-14 18:54:07,2013-01-14 18:16:22
13801770f1633e976854fc0c2a1c75a3a8352c33...81d4655c8cb701c8a0be7e144d64361960257362,1,7,2,9,4,2013-01-14 18:58:04,2013-01-14 18:57:50
81d4655c8cb701c8a0be7e144d64361960257362...a1119f9a193ef812c17012fb41a77698f9933266,4,190,264,454,136,2013-01-14 19:11:03,2013-01-14 19:11:03
a1119f9a193ef812c17012fb41a77698f9933266...4c803ee9e211b81ba0aea185c2f320aa02e27646,1,1,2,3,1,2013-01-14 21:47:59,2013-01-14 20:48:51
4c803ee9e211b81ba0aea185c2f320aa02e27646...4d0654de1470ca88fb319bc99d57f96136791768,1,1,1,2,1,2013-01-14 22:21:58,2013-01-14 22:21:58
4d0654de1470ca88fb319bc99d57f96136791768...6a031d8e8d5680f2c034e3d40d8b70c7c1edc05f,5,149,3,152,10,2013-01-14 23:34:29,2013-01-14 23:34:14
6a031d8e8d5680f2c034e3d40d8b70c7c1edc05f...4fdc9ae0d39c56c879fb6c1b7ca474f0e8d2f135,12,256,0,256,36,2013-01-15 00:19:40,2013-01-15 00:19:40
4fdc9ae0d39c56c879fb6c1b7ca474f0e8d2f135...4831624324fdc883e0f4c4ba842ca87c3e2fbbcb,1,0,2,2,1,2013-01-15 00:24:18,2013-01-15 00:24:18
4831624324fdc883e0f4c4ba842ca87c3e2fbbcb...a4b1b4568d0283a6c526f922690f0eb2d6de00f2,1,1,1,2,1,2013-01-15 00:26:31,2013-01-15 00:26:26
a4b1b4568d0283a6c526f922690f0eb2d6de00f2...f5cc553ffa9a8c61b96f6ac0cdb5c7ec08dfd8ce,2,20,11,31,8,2013-01-15 02:05:22,2013-01-15 02:05:02
f5cc553ffa9a8c61b96f6ac0cdb5c7ec08dfd8ce...69e3bd18b5f82a727cf3dcd5e472cbe07d40162c,2,13,6,19,8,2013-01-15 06:06:58,2013-01-15 06:06:58
69e3bd18b5f82a727cf3dcd5e472cbe07d40162c...7bf4628360e553fb2de252b753b24336a7e75bab,1,1,1,2,1,2013-01-15 11:32:43,2013-01-15 11:32:43
7bf4628360e553fb2de252b753b24336a7e75bab...71214c25bcd507e56bf8c5ce432c5478419f7328,4,80,10,90,7,2013-01-15 16:13:33,2013-01-14 21:07:55
71214c25bcd507e56bf8c5ce432c5478419f7328...4a5dc19bc2612d24288792be09d7f0c920652bb0,1,13,8,21,2,2013-01-15 17:12:44,2013-01-14 23:14:54
4a5dc19bc2612d24288792be09d7f0c920652bb0...ed4789001bc45371cd56d644baa54f0abaef0eb4,1,9,7,16,6,2013-01-15 18:40:13,2013-01-15 02:13:58
ed4789001bc45371cd56d644baa54f0abaef0eb4...537beb02ecff7588dd1fd40957686f454110eae7,14,261,143,404,60,2013-01-15 18:40:51,2013-01-03 19:14:02
537beb02ecff7588dd1fd40957686f454110eae7...3783307988cb6d56b7791013afb4052710c24224,1,8,0,8,1,2013-01-15 19:40:48,2013-01-15 16:20:28
3783307988cb6d56b7791013afb4052710c24224...88241273e9f16df063135f437c5937fcadaae0c2,2,19,0,19,3,2013-01-15 19:58:44,2013-01-15 19:05:13
88241273e9f16df063135f437c5937fcadaae0c2...d6ccc8c58426c271f0f0a1f69b0bb1c602c60917,13,99,105,204,36,2013-01-15 20:03:42,2013-01-15 16:56:39
d6ccc8c58426c271f0f0a1f69b0bb1c602c60917...abff0d88ea22003e2508468ee67e018fa7a7f041,1,5,5,10,5,2013-01-15 20:27:02,2013-01-15 20:26:44
abff0d88ea22003e2508468ee67e018fa7a7f041...312427b7b1e90778c65d8be67d83f8a48c7f85fa,1,15,13,28,1,2013-01-15 20:31:20,2013-01-15 19:43:03
312427b7b1e90778c65d8be67d83f8a48c7f85fa...b6879559f6a87c585915553ca9edb931d0df8e83,3,9,8,17,5,2013-01-15 20:48:13,2013-01-15 20:48:06
b6879559f6a87c585915553ca9edb931d0df8e83...c177552c3c9323cef3a897a9a30d4cb5a8d2e900,1,63,0,63,1,2013-01-15 20:52:52,2013-01-09 22:30:17
c177552c3c9323cef3a897a9a30d4cb5a8d2e900...3f829e954e8bb3693f5675b7761d10d7f43bc972,1,1,1,2,1,2013-01-15 20:54:51,2013-01-15 20:54:51
3f829e954e8bb3693f5675b7761d10d7f43bc972...db62658b202c3570a5f7e091cb5bb1ee0437adc8,2,4,2,6,2,2013-01-15 20:59:57,2013-01-15 19:21:52
db62658b202c3570a5f7e091cb5bb1ee0437adc8...f380d40a3da93c22e9eb95d5308855f377a4123f,3,165,2,167,11,2013-01-15 20:59:57,2013-01-15 20:59:43
f380d40a3da93c22e9eb95d5308855f377a4123f...ecaa87e0f70009d635353e7197a32e3af46450ae,4,12,4,16,7,2013-01-15 21:24:35,2013-01-15 21:24:35
ecaa87e0f70009d635353e7197a32e3af46450ae...a34cee844d3f61c6bd9e9db053cbd8aade9fb251,1,7,2,9,2,2013-01-15 21:27:12,2013-01-15 21:12:27
a34cee844d3f61c6bd9e9db053cbd8aade9fb251...73a18c8d42f7af21342f596fccf527d6d635f045,1,5,1,6,2,2013-01-15 21:42:06,2013-01-15 20:17:28
73a18c8d42f7af21342f596fccf527d6d635f045...d00cccf525affb7e810f718e745fe0340347c4ae,2,36,3,39,3,2013-01-15 21:47:24,2013-01-15 21:04:51
d00cccf525affb7e810f718e745fe0340347c4ae...9867870de5443de8a3a989fd4beab8d0f5874d70,1,3,3,6,1,2013-01-15 21:49:51,2013-01-15 21:49:51
eb8c1e94e30a71183fe0fea9848f61511039744f...d4be225391ba2639fac317ff4eda4245cea88f5e,2,3,1,4,2,2011-12-05 20:55:51,2011-12-05 20:55:51
d4be225391ba2639fac317ff4eda4245cea88f5e...a80c2d10d001e589cc293d76ecb464286d3064cb,1,0,6,6,3,2011-12-05 21:41:10,2011-12-05 21:31:33
a80c2d10d001e589cc293d76ecb464286d3064cb...d9c699c39246d99454dc16fbb4f24ccae04acce8,3,14,9,23,7,2011-12-05 22:17:41,2011-12-05 21:41:53
d9c699c39246d99454dc16fbb4f24ccae04acce8...e39d2c1c8ae42f6d0f5762f257f2ed16ff9a83e8,1,2,2,4,1,2011-12-05 22:36:01,2011-12-05 22:35:10
e39d2c1c8ae42f6d0f5762f257f2ed16ff9a83e8...1f7d07e3805736e113eb85d0af13c928154aea21,1,1,1,2,1,2011-12-05 22:44:27,2011-12-05 22:44:10
1f7d07e3805736e113eb85d0af13c928154aea21...2f166e0b30ed774a5612369ab238e89eb1e55851,2,496,448,944,147,2011-12-05 22:51:46,2011-12-05 22:51:46
2f166e0b30ed774a5612369ab238e89eb1e55851...d47b0d51084265fd516ac8dad11e6d49fae078c4,2,19,1,20,3,2011-12-06 05:00:46,2011-12-06 05:00:46
d47b0d51084265fd516ac8dad11e6d49fae078c4...5ec59400d7b23146a6633ce9cc02a955a29689e6,1,2,2,4,2,2011-12-06 14:52:19,2011-12-06 14:52:19
5ec59400d7b23146a6633ce9cc02a955a29689e6...ee990ea176690c0b625c03946cb5ccbcf162161a,1,1,1,2,1,2011-12-06 16:06:55,2011-12-06 16:05:48
ee990ea176690c0b625c03946cb5ccbcf162161a...b3a25600cd7b561574e83c4ed596309ad36f826b,1,3,1,4,1,2011-12-06 16:17:16,2011-12-05 23:11:14
b3a25600cd7b561574e83c4ed596309ad36f826b...064f39607e90b8c9289fa1250c5a3bbd58e84cda,1,33,42,75,29,2011-12-06 17:17:30,2011-12-06 17:17:30
064f39607e90b8c9289fa1250c5a3bbd58e84cda...a70fbc392c3cc261d9e8c73bfa5cab6a321bf89e,2,7,1,8,3,2011-12-06 17:51:07,2011-12-06 17:46:33
a70fbc392c3cc261d9e8c73bfa5cab6a321bf89e...7d90cd2d203bd590f34003662a3b2dcbef73d5c5,1,5,0,5,1,2011-12-06 18:06:28,2011-12-05 22:00:02
7d90cd2d203bd590f34003662a3b2dcbef73d5c5...125f72059c92ba0e21726303273863ea4eb915ec,1,2,0,2,1,2011-12-06 19:01:46,2011-12-06 19:01:46
125f72059c92ba0e21726303273863ea4eb915ec...45ddfbca7e199911b208499f6e0a28db4a829bca,1,17,0,17,1,2011-12-06 19:04:15,2011-12-06 19:00:51
45ddfbca7e199911b208499f6e0a28db4a829bca...86e56e223cc609aef6d7b6d4fa595b456b8736d8,2,5,1,6,3,2011-12-06 19:04:15,2011-12-06 19:01:26
86e56e223cc609aef6d7b6d4fa595b456b8736d8...5a593f2f88ef795c32c96f36794327b8098b8b6b,1,81,0,81,1,2011-12-06 19:04:15,2011-12-06 19:01:54
5a593f2f88ef795c32c96f36794327b8098b8b6b...fa62a374a8818ec2c8981176c60c9cd0a01eb8c1,1,13,3,16,4,2011-12-06 19:10:38,2011-12-06 19:10:38
fa62a374a8818ec2c8981176c60c9cd0a01eb8c1...da633ea46d736930a3505f0ceddc677e38a5927c,1,0,4,4,1,2011-12-06 19:28:13,2011-12-06 19:27:37
9867870de5443de8a3a989fd4beab8d0f5874d70...4298850689b3e66a36fa377a1d331362b03c381d,7,809,0,809,7,2013-01-15 22:11:38,2013-01-15 16:19:35
4298850689b3e66a36fa377a1d331362b03c381d...89a34aad73c2c183ecb154c21fdb260eb18ef3bc,1,108,0,108,1,2013-01-15 22:11:38,2013-01-15 17:35:20
89a34aad73c2c183ecb154c21fdb260eb18ef3bc...286dd8f74dfe63564907873aa7db45ec61e5445a,7,90,82,172,70,2013-01-15 22:11:38,2013-01-15 18:57:43
402d5c7cde95110610098a3daeba13503b494789...503672094dcc6370bc015638cc36c0a306cf2996,3,75,76,151,12,2013-01-15 22:34:15,2013-01-14 04:16:36
503672094dcc6370bc015638cc36c0a306cf2996...09139c400d9fe5a6a0d19764395f22b4333e761f,1,2,2,4,2,2013-01-15 22:53:57,2013-01-15 22:53:57
09139c400d9fe5a6a0d19764395f22b4333e761f...45772b7c149307803a3b0052b2468e2b254e19be,1,16,0,16,6,2013-01-16 12:39:20,2013-01-16 12:39:20
45772b7c149307803a3b0052b2468e2b254e19be...fd1bc4895b51dc65185ac5fa633bb0435860b936,12,234,27,261,26,2013-01-16 15:36:40,2013-01-16 15:36:40
fd1bc4895b51dc65185ac5fa633bb0435860b936...c4630d115dfc1dfbe6f3da356dc9fceaf3ed7632,1,0,0,0,0,2013-01-16 18:49:44,2013-01-16 18:49:44
c4630d115dfc1dfbe6f3da356dc9fceaf3ed7632...7c598aec35ddf89aea69a06ee5142e4eee217b9b,6,33,33,66,24,2013-01-16 19:19:56,2013-01-16 19:19:56
7c598aec35ddf89aea69a06ee5142e4eee217b9b...47c18b8545d6e97319a10d8683e021401f50e6c8,1,2,2,4,2,2013-01-16 20:06:17,2013-01-16 20:06:17
47c18b8545d6e97319a10d8683e021401f50e6c8...bbf3b7dffa0c27db45eb4398c4e88eb63435fe51,1,4,4,8,4,2013-01-16 22:01:01,2013-01-16 22:01:01
bbf3b7dffa0c27db45eb4398c4e88eb63435fe51...d30f8de98c08a1fdc599dc717758dc0edf719083,3,44,3,47,4,2013-01-16 22:54:06,2013-01-16 21:47:34
d30f8de98c08a1fdc599dc717758dc0edf719083...9a675e0ff77f1a1f7e0bbf056c2c64a17c08f71d,1,12,5,17,1,2013-01-16 23:49:20,2013-01-16 23:49:20
9a675e0ff77f1a1f7e0bbf056c2c64a17c08f71d...f15796bb641f06a5cc60cbc85447363169c1c23b,1,2,3,5,1,2013-01-17 15:00:42,2013-01-17 15:00:42
f15796bb641f06a5cc60cbc85447363169c1c23b...f1cc877a50d0aa8521f752391a7cd313f60651e4,5,10,26,36,7,2013-01-17 15:16:31,2013-01-16 17:48:38
f1cc877a50d0aa8521f752391a7cd313f60651e4...22f75bee738547c854dc3a03a10fc961b2e86ef1,6,34,30,64,18,2013-01-17 15:18:02,2013-01-16 16:14:40
22f75bee738547c854dc3a03a10fc961b2e86ef1...45350ddb64725a665b2bc2bebc66d7c058020ada,7,85,31,116,25,2013-01-17 15:18:02,2013-01-16 19:58:15
45350ddb64725a665b2bc2bebc66d7c058020ada...1e2283a07f07d417f7bcb600b7a8fbd0720f25bd,2,413,33,446,18,2013-01-17 15:25:02,2013-01-10 20:02:37
1e2283a07f07d417f7bcb600b7a8fbd0720f25bd...e923e7695bc6492d383e1125f12b73ff7c5125c2,1,4,3,7,3,2013-01-17 15:25:21,2013-01-10 20:11:30
e923e7695bc6492d383e1125f12b73ff7c5125c2...96679353b14dcdd171f510cecb06d9c94af8fe71,3,52,12,64,6,2013-01-17 15:32:32,2013-01-09 19:18:46
96679353b14dcdd171f510cecb06d9c94af8fe71...39d2b276b6b5ed4c4671973641d3c89fb0afba3e,4,111,62,173,63,2013-01-17 15:56:56,2012-12-19 17:26:41
39d2b276b6b5ed4c4671973641d3c89fb0afba3e...e0fa2f1eea17be8faeaad2a550c82e833a3eadeb,4,103,28,131,16,2013-01-17 15:56:56,2013-01-04 19:46:14
e0fa2f1eea17be8faeaad2a550c82e833a3eadeb...20e12facef46d7d3edd98c5240559eaab57e37c7,3,175,55,230,32,2013-01-17 15:56:56,2013-01-17 12:13:21
20e12facef46d7d3edd98c5240559eaab57e37c7...2a12fd677b029f8cff7c12f2baf2b4acffb82def,2,136,48,184,32,2013-01-17 15:56:56,2013-01-17 11:50:31
2a12fd677b029f8cff7c12f2baf2b4acffb82def...f8d9f5d434e1898e4d14c6215e948abcf4164aeb,3,201,57,258,31,2013-01-17 15:56:56,2013-01-17 11:50:30
f8d9f5d434e1898e4d14c6215e948abcf4164aeb...a0aaf99845554ff826cc0caaba6e6b9842475c19,2,231,80,311,43,2013-01-17 15:56:56,2013-01-17 11:50:30
a0aaf99845554ff826cc0caaba6e6b9842475c19...810aa6cb78a29b584e44d01ba417399ccc1e481a,3,307,81,388,46,2013-01-17 15:56:56,2013-01-17 11:50:30
810aa6cb78a29b584e44d01ba417399ccc1e481a...04296d4f271aacfaaa8fc7c822e07dba76ae4a50,2,216,74,290,43,2013-01-17 15:56:56,2013-01-17 11:50:29
04296d4f271aacfaaa8fc7c822e07dba76ae4a50...588a5937884a07c72af6e40a98cd592eedebc74e,2,78,33,111,24,2013-01-17 15:56:57,2013-01-17 11:50:29
588a5937884a07c72af6e40a98cd592eedebc74e...4d4f0c4fb1708ca5ab95d6efc334e185459c2621,3,248,142,390,49,2013-01-17 15:56:57,2013-01-17 11:50:28
4d4f0c4fb1708ca5ab95d6efc334e185459c2621...72c63c5853fb5e130c3311192ebaf9046a5db4cb,4,290,94,384,54,2013-01-17 15:56:57,2013-01-17 11:50:28
72c63c5853fb5e130c3311192ebaf9046a5db4cb...19be6832a2e64bede6c6120c8933e4a97caf9312,3,194,81,275,64,2013-01-17 15:56:57,2013-01-17 11:50:28
19be6832a2e64bede6c6120c8933e4a97caf9312...058b24ef9aae96edfc9d70f7d9cedf284f3d8bb5,2,218,69,287,45,2013-01-17 15:56:57,2013-01-17 11:50:27
058b24ef9aae96edfc9d70f7d9cedf284f3d8bb5...5205372fbe4eddc3296c2c155ea0699b661a10e8,1,8,8,16,8,2013-01-17 17:04:05,2013-01-17 17:04:05
5205372fbe4eddc3296c2c155ea0699b661a10e8...1f2593e504014d1ed523a44851e3b7a8c7110845,4,28,5,33,5,2013-01-17 17:23:19,2013-01-15 18:04:13
1f2593e504014d1ed523a44851e3b7a8c7110845...1007c8a94a46420a8c437a6520b0450e6e361a91,1,1,1,2,1,2013-01-17 17:50:03,2013-01-17 17:49:48
1007c8a94a46420a8c437a6520b0450e6e361a91...770a3903d6b03c724d1a8465bc02073392981ea2,1,5,0,5,1,2013-01-17 18:18:14,2013-01-16 22:24:49
770a3903d6b03c724d1a8465bc02073392981ea2...7d3f945ee748347a3ca3c219a9df1435d74ae3e9,1,10,4,14,4,2013-01-17 18:43:18,2013-01-15 19:50:29
7d3f945ee748347a3ca3c219a9df1435d74ae3e9...4c228117925e19ff8c127447d3ce42454709c025,4,64,60,124,21,2013-01-17 18:44:42,2013-01-16 19:13:13
4c228117925e19ff8c127447d3ce42454709c025...0ad5610b28aaeebab3f3713c517f468fbb6eee17,1,10,4,14,1,2013-01-17 19:40:47,2013-01-16 18:59:15
0ad5610b28aaeebab3f3713c517f468fbb6eee17...08210bf287d9b8d9742250295a6b49773de621da,2,15,8,23,8,2013-01-17 19:40:47,2013-01-16 19:52:14
08210bf287d9b8d9742250295a6b49773de621da...e39b2d1781b23be7d218b5acde55843ac4cda80b,4,27,4,31,4,2013-01-17 19:48:36,2013-01-17 19:48:21
e39b2d1781b23be7d218b5acde55843ac4cda80b...f744b0e7c560dc8ce984dfc3b8589132af7f3868,1,4,4,8,4,2013-01-17 20:14:40,2013-01-17 20:14:40
f744b0e7c560dc8ce984dfc3b8589132af7f3868...9c49afe9eb138ac806a30cd211095fc52a993fa5,1,15,1,16,3,2013-01-17 20:22:33,2013-01-16 20:12:47
9c49afe9eb138ac806a30cd211095fc52a993fa5...e0ae3e12c01498ba716b72fd4302b7f7adfc9d13,1,3,0,3,1,2013-01-17 20:22:33,2013-01-16 22:14:02
e0ae3e12c01498ba716b72fd4302b7f7adfc9d13...3a44cf876b94ec892e4a0cfb3885e25f24978bd8,2,11,32,43,13,2013-01-17 21:34:21,2013-01-17 18:22:24
3a44cf876b94ec892e4a0cfb3885e25f24978bd8...4a8f5612ac7dc209249ab7a01a744201f98634c1,4,28,31,59,11,2013-01-17 22:01:24,2013-01-15 19:08:18
4a8f5612ac7dc209249ab7a01a744201f98634c1...3085f8fadd84f02e4bee9cfa6fb42ea6a17ab6ba,1,2,1,3,1,2013-01-17 22:01:25,2013-01-15 23:34:07
3085f8fadd84f02e4bee9cfa6fb42ea6a17ab6ba...af5d8350b5d58630c75356a00ad918e99b3fd6c2,1,82,0,82,1,2013-01-17 22:01:25,2013-01-16 00:19:32
af5d8350b5d58630c75356a00ad918e99b3fd6c2...f9940fb9ba9a1a562a2624f87ad6e821516ea5ca,2,5,2,7,4,2013-01-17 22:01:25,2013-01-16 23:53:03
f9940fb9ba9a1a562a2624f87ad6e821516ea5ca...604d23e892905a08fb54f69c64c14651376c025d,1,3,0,3,1,2013-01-17 22:09:25,2013-01-17 21:38:56
604d23e892905a08fb54f69c64c14651376c025d...972c8078cd9002f684aa32dff532b4da9992380e,6,112,112,224,99,2013-01-17 22:15:14,2013-01-17 22:15:14
972c8078cd9002f684aa32dff532b4da9992380e...6ac6cc7204c7b3c44aa35ba399823f15b8d80cbd,3,6,6,12,5,2013-01-17 23:05:42,2013-01-17 21:29:36
6ac6cc7204c7b3c44aa35ba399823f15b8d80cbd...664bdf3f3fd2c2388cea389c51632baa04a0ef9e,3,0,134,134,2,2013-01-17 23:21:36,2013-01-17 23:01:07
664bdf3f3fd2c2388cea389c51632baa04a0ef9e...e51b22e4ea37cf6a767561e27f8e316e5d5afd11,5,195,119,314,45,2013-01-18 15:40:24,2013-01-16 18:35:15
e51b22e4ea37cf6a767561e27f8e316e5d5afd11...123a10609e275a46b55e8f8a12c7b9d37217f4b4,1,2,2,4,2,2013-01-18 15:49:36,2013-01-18 15:49:19
123a10609e275a46b55e8f8a12c7b9d37217f4b4...e376978abdf9407bb3348901d767a55bb1fca8ad,1,1,1,2,1,2013-01-18 16:16:11,2013-01-18 16:16:11
e376978abdf9407bb3348901d767a55bb1fca8ad...c9f85f4c81763a8cd0c48a26e15e2e21e8416f0d,3,62,44,106,10,2013-01-18 16:38:26,2013-01-18 16:26:30
c9f85f4c81763a8cd0c48a26e15e2e21e8416f0d...1a1f72cc2a298289a0303c0eb316f363c75be057,9,62,45,107,18,2013-01-18 19:29:34,2013-01-18 19:23:52
1a1f72cc2a298289a0303c0eb316f363c75be057...5d2e7788b667099419564efa74c2bb2c052d582d,1,5,3,8,2,2013-01-18 21:01:53,2013-01-18 21:01:53
5d2e7788b667099419564efa74c2bb2c052d582d...1a4363cb481ab62f5199eb6f2adf2ffbc04b542d,1,1,1,2,1,2013-01-18 21:28:28,2013-01-18 21:28:28
1a4363cb481ab62f5199eb6f2adf2ffbc04b542d...ec7ecfb7308aa22ab0ed880024bfb43a130f9a70,6,10,9,19,9,2013-01-18 21:44:35,2013-01-18 21:39:46
ec7ecfb7308aa22ab0ed880024bfb43a130f9a70...2860b2f11ce7692daa56bb16902f316874955ac2,2,58,0,58,2,2013-01-18 22:04:37,2013-01-18 20:52:52
2860b2f11ce7692daa56bb16902f316874955ac2...98d2e5d364e01581a4ba1b2e7df25f79ebd836b2,1,4,4,8,2,2013-01-18 22:12:39,2013-01-18 22:11:17
98d2e5d364e01581a4ba1b2e7df25f79ebd836b2...41c1110326ae00fc7fb279b3bfeabadc3a82bc5a,24,1011,1018,2029,53,2013-01-18 22:15:43,2013-01-18 22:15:28
41c1110326ae00fc7fb279b3bfeabadc3a82bc5a...3d697bb6f776c9c435dc6138b373e4d7672f06ff,2,20,1,21,3,2013-01-18 22:39:55,2013-01-18 22:38:49
3d697bb6f776c9c435dc6138b373e4d7672f06ff...fc568e0067d08c682a39918e10ad465ff8c2d0ca,1,4,3,7,4,2013-01-18 22:44:34,2013-01-18 22:36:10
fc568e0067d08c682a39918e10ad465ff8c2d0ca...6151edafad14a36f0f49ca5e592f5b81dac58949,1,5,4,9,1,2013-01-18 22:44:35,2013-01-18 22:36:24
6151edafad14a36f0f49ca5e592f5b81dac58949...0f14e723eacd93bd0fdbafca417285b85837e3bb,1,36,25,61,10,2013-01-18 23:01:23,2013-01-18 23:00:37
0f14e723eacd93bd0fdbafca417285b85837e3bb...e375265c72bbff840008b165f39f3d683de20ab9,1,1,1,2,1,2013-01-18 23:12:15,2013-01-18 23:09:24
e375265c72bbff840008b165f39f3d683de20ab9...3dfc22e239d7455608a2ad2bc1197eac78550a23,2,11,1,12,8,2013-01-18 23:31:26,2013-01-18 22:46:27
3dfc22e239d7455608a2ad2bc1197eac78550a23...e9e9228c0fce2fdbcc27ffb6aac3a4afa978a85c,1,2,1,3,2,2013-01-19 03:12:10,2013-01-19 03:10:29
e9e9228c0fce2fdbcc27ffb6aac3a4afa978a85c...d10e66f541958c076dbd4cc5be3a806dba23d31a,1,2,3,5,1,2013-01-19 03:32:25,2013-01-19 03:32:25
d10e66f541958c076dbd4cc5be3a806dba23d31a...1f0bac590a2b79f81e3cab2e5d42851aa063c780,1,1,1,2,1,2013-01-19 16:42:33,2013-01-18 03:42:26
1f0bac590a2b79f81e3cab2e5d42851aa063c780...867f1eabadafaa17dc7f40b993ccafbcabad4cfb,1,2,2,4,1,2013-01-19 16:42:33,2013-01-18 20:38:17
867f1eabadafaa17dc7f40b993ccafbcabad4cfb...cc7e01b276ec64813bf35f8eca1cb587cab9f4f4,1,1,1,2,1,2013-01-19 16:42:33,2013-01-18 21:50:39
cc7e01b276ec64813bf35f8eca1cb587cab9f4f4...6497950cd222f39313d47bceee26d7d8f83f7acc,1,25,6,31,5,2013-01-19 16:43:59,2013-01-18 23:37:08
6497950cd222f39313d47bceee26d7d8f83f7acc...e2ff104513136aec4874a644cec6800d65ab9fe3,2,5,4,9,5,2013-01-19 16:43:59,2013-01-18 22:57:53
e2ff104513136aec4874a644cec6800d65ab9fe3...ac08508bd4727043521f8b57da19571525675072,1,96,0,96,1,2013-01-19 18:50:27,2013-01-13 10:52:44
ac08508bd4727043521f8b57da19571525675072...329657490c07c5b873acc501c80a7b22efe4eef0,1,3,1,4,2,2013-01-19 18:57:01,2013-01-12 20:20:25
329657490c07c5b873acc501c80a7b22efe4eef0...8f6abe9857e4e37970677b4e695ce70a24aee8d9,1,1,1,2,1,2013-01-19 19:48:01,2013-01-19 19:48:01
8f6abe9857e4e37970677b4e695ce70a24aee8d9...d5a046fa54961733ba8cc13641229914fe8c1cbd,1,1,1,2,1,2013-01-19 19:54:32,2013-01-19 19:54:32
d5a046fa54961733ba8cc13641229914fe8c1cbd...1773b0be95dc9bade30fdd3cd5b7121239b5d138,1,2,2,4,2,2013-01-20 01:47:28,2013-01-20 01:47:28
1773b0be95dc9bade30fdd3cd5b7121239b5d138...eab8cd5fcb0acbae2fb554858fd71b9f10c4c4d3,1,2,2,4,2,2013-01-21 16:21:04,2013-01-21 16:21:04
eab8cd5fcb0acbae2fb554858fd71b9f10c4c4d3...7ea3aa490775b2076433123f79ab7235d07328e5,1,1,1,2,1,2013-01-21 16:39:14,2013-01-21 16:39:09
7ea3aa490775b2076433123f79ab7235d07328e5...9860bd69efb49e095b9e1ef2e7104e9dbd227dc6,1,175,0,175,1,2013-01-21 16:55:25,2013-01-21 16:55:25
9860bd69efb49e095b9e1ef2e7104e9dbd227dc6...604fb39eaa6e2dec1fd6b25d1fb2201fda672b4e,1,1,1,2,1,2013-01-21 17:50:18,2013-01-21 17:31:28
604fb39eaa6e2dec1fd6b25d1fb2201fda672b4e...daee35f0fa0052c1d620b296797641fa64652772,1,0,400,400,1,2013-01-21 19:15:13,2013-01-21 19:15:13
daee35f0fa0052c1d620b296797641fa64652772...4ba51f091c1a70689a0ccf2e552126743ea99c60,1,1,1,2,1,2013-01-21 20:04:49,2013-01-21 20:04:09
4ba51f091c1a70689a0ccf2e552126743ea99c60...9aff17649253a666b14d9fed0a932fce883495be,1,6,0,6,1,2013-01-21 20:47:13,2013-01-21 20:36:38
9aff17649253a666b14d9fed0a932fce883495be...e2b4643fa3c0f61737ae208e8153a775f3ef68fd,3,3,3,6,3,2013-01-21 20:49:37,2013-01-21 20:49:37
e2b4643fa3c0f61737ae208e8153a775f3ef68fd...75a7b863566f51c0e8da20be9c8214c5982abb9d,1,2,2,4,2,2013-01-21 21:45:35,2013-01-21 21:45:35
75a7b863566f51c0e8da20be9c8214c5982abb9d...2d845b7fa9dbb5c292053a4b921075776681e48f,1,1,1,2,1,2013-01-22 05:25:29,2013-01-22 05:25:29
2d845b7fa9dbb5c292053a4b921075776681e48f...fdcce4518baa1d475df5c1de4f244246fae248bd,1,2,0,2,1,2013-01-22 06:07:03,2013-01-22 06:07:03
fdcce4518baa1d475df5c1de4f244246fae248bd...0064c4c197b01dbd029ce9d0ce8016762deefe73,3,7952,0,7952,3,2013-01-22 06:32:32,2013-01-21 18:23:26
0064c4c197b01dbd029ce9d0ce8016762deefe73...8188ef72163de85f5a230e10e64a84c3fa606494,3,6724,0,6724,3,2013-01-22 08:39:18,2013-01-22 08:39:18
8188ef72163de85f5a230e10e64a84c3fa606494...e351361ed10632a26ef8498e66014f746615b18d,1,6,5,11,5,2013-01-22 16:43:52,2013-01-22 16:43:52
e351361ed10632a26ef8498e66014f746615b18d...6b0e6231983d6bfbb7a9fcabb1dc719ef6de7a5f,2,63,0,63,4,2013-01-22 16:51:45,2013-01-22 15:37:55
6b0e6231983d6bfbb7a9fcabb1dc719ef6de7a5f...40ff66292da547bffc518c2720c72e89ca1edfca,1,1,1,2,1,2013-01-22 17:53:42,2013-01-22 17:53:42
40ff66292da547bffc518c2720c72e89ca1edfca...43ffb31e4c051fe1f50130289099d3983964e00e,4,113,105,218,17,2013-01-22 17:58:19,2013-01-18 18:29:56
43ffb31e4c051fe1f50130289099d3983964e00e...2abfcc79152f38c0c1557298b6ae240bb477967f,12,225,43,268,33,2013-01-22 18:03:01,2013-01-18 23:29:50
2abfcc79152f38c0c1557298b6ae240bb477967f...ef98f5a893921c0c1ceb5e7a7341492d269ff4f0,7,14,6,20,7,2013-01-22 18:11:41,2013-01-22 18:11:41
ef98f5a893921c0c1ceb5e7a7341492d269ff4f0...a7429ac24de67afaf5dc0b71b3a83e529678799f,1,22,1,23,2,2013-01-22 18:27:17,2013-01-22 18:27:17
a7429ac24de67afaf5dc0b71b3a83e529678799f...aa8e450455f538d3fd631b0b19f4cfba2ddde4ae,11,56,56,112,56,2013-01-22 18:47:40,2013-01-22 17:23:50
aa8e450455f538d3fd631b0b19f4cfba2ddde4ae...f9b9bb1f42814b7aa487d1c589cbee3bbde9ed3b,15,80,80,160,80,2013-01-22 18:47:40,2013-01-22 17:26:31
f9b9bb1f42814b7aa487d1c589cbee3bbde9ed3b...24b35b78bc6f7b7e964edfa2ae96813a39aac4f7,22,22,22,44,22,2013-01-22 18:47:40,2013-01-22 17:33:03
24b35b78bc6f7b7e964edfa2ae96813a39aac4f7...439ce8c8911e33ec47fd1bec9bb6289baf3edfc0,17,110,141,251,135,2013-01-22 18:47:40,2013-01-22 18:36:24
439ce8c8911e33ec47fd1bec9bb6289baf3edfc0...748b5f462a92fb5ee64c20df5789d393b568ff56,1,9,0,9,2,2013-01-22 18:52:07,2013-01-22 18:51:50
748b5f462a92fb5ee64c20df5789d393b568ff56...c3cbef09e99892c1d559f3275183f040501f6ddd,2,73,1,74,4,2013-01-22 18:53:58,2013-01-22 18:53:52
c3cbef09e99892c1d559f3275183f040501f6ddd...f631e83b119bd0ade11cc452486dae5eacc5650f,4,8,3,11,6,2013-01-22 19:01:31,2013-01-22 18:20:29
f631e83b119bd0ade11cc452486dae5eacc5650f...3f9d606e7573d28bd8edc6e417075f1ecd774b90,1,1,0,1,1,2013-01-22 19:01:31,2013-01-22 18:32:29
3f9d606e7573d28bd8edc6e417075f1ecd774b90...322b1a69625b14af4dac4f120cc70cd4d86f00f8,1,8,8,16,4,2013-01-22 19:01:31,2013-01-22 18:57:48
322b1a69625b14af4dac4f120cc70cd4d86f00f8...ffb455ab773816ba576099886192d3f379d4b1ae,1,193,22,215,16,2013-01-22 19:07:05,2013-01-22 19:02:27
ffb455ab773816ba576099886192d3f379d4b1ae...be68b1d0ec3eab8d35992153565f43e90fc0d6cd,2,17,11,28,4,2013-01-22 19:20:19,2013-01-22 18:44:50
be68b1d0ec3eab8d35992153565f43e90fc0d6cd...2ee2f9dbbb88e92aa913c364fb5091f72762c57f,1,9,3,12,1,2013-01-22 19:55:34,2013-01-22 19:47:25
2ee2f9dbbb88e92aa913c364fb5091f72762c57f...fd23f2391d138ff034d907460e13aeb757eb6bdf,1,2,1,3,1,2013-01-22 20:05:55,2013-01-22 20:02:47
fd23f2391d138ff034d907460e13aeb757eb6bdf...8b23788e366470fff665947bb7acb93653e6a967,3,63,21,84,8,2013-01-22 20:32:34,2013-01-22 20:32:34
8b23788e366470fff665947bb7acb93653e6a967...6cf57903b037b8ffcca7e821b2604d480944df5b,1,1,1,2,1,2013-01-22 21:31:14,2013-01-22 21:19:26
6cf57903b037b8ffcca7e821b2604d480944df5b...4c8fe4f520c872cb6bc5cefd3b0ab10cd9fc1b43,3,30,60,90,24,2013-01-22 22:57:25,2013-01-22 22:57:25
4c8fe4f520c872cb6bc5cefd3b0ab10cd9fc1b43...e0d99898b252672958db3a9996bf861e56da2019,1,5,1,6,5,2013-01-23 16:15:12,2013-01-22 23:52:52
e0d99898b252672958db3a9996bf861e56da2019...39144a5b4efaff4af91f8b283548fa1ee81ddf83,1,5,1,6,1,2013-01-23 17:05:49,2013-01-23 16:51:34
39144a5b4efaff4af91f8b283548fa1ee81ddf83...776557c5b219147d01693f1433d5fdcbb0fa0c9b,1,3,6,9,3,2013-01-23 18:28:40,2013-01-23 18:28:40
776557c5b219147d01693f1433d5fdcbb0fa0c9b...bb7769500018cb80a26b06529a12744c03b7a992,1,3,2,5,2,2013-01-23 18:56:10,2013-01-23 18:27:14
bb7769500018cb80a26b06529a12744c03b7a992...10604d07659e07377c891e4cc401bfab06412ab4,1,3,0,3,1,2013-01-23 18:57:54,2013-01-23 18:57:42
10604d07659e07377c891e4cc401bfab06412ab4...e5ffe6de99970a6ac14264793dd99a16c8c742d2,1,6,1,7,1,2013-01-23 20:54:25,2013-01-23 20:54:25
e5ffe6de99970a6ac14264793dd99a16c8c742d2...02c3ae2696a53dd32bbfb16853fcfd0f39d6b6b1,1,1,1,2,1,2013-01-23 22:57:36,2013-01-23 22:56:40
02c3ae2696a53dd32bbfb16853fcfd0f39d6b6b1...ad47817b9397d8cfe97b9a51f1ad2e806c079d77,3,16,0,16,5,2013-01-24 15:46:14,2013-01-24 15:45:22
ad47817b9397d8cfe97b9a51f1ad2e806c079d77...a7019403d3c6cb2f4f8b261c7789d52ccc154da4,1,1,4,5,2,2013-01-24 15:58:10,2013-01-24 15:36:59
a7019403d3c6cb2f4f8b261c7789d52ccc154da4...2216a1e75b1cb540a6974d72cd52bbaac8e46adf,1,3,2,5,3,2013-01-24 15:58:10,2013-01-24 15:42:55
2216a1e75b1cb540a6974d72cd52bbaac8e46adf...962f53dc4e3245fa3979cdc24cf1d8d339e0bc0d,2,33,2,35,2,2013-01-24 16:34:10,2013-01-24 15:27:06
962f53dc4e3245fa3979cdc24cf1d8d339e0bc0d...358794215a51f3dc8b646ad22eaad6f5e4444c5d,1,5,3,8,3,2013-01-24 16:34:10,2013-01-24 15:48:42
358794215a51f3dc8b646ad22eaad6f5e4444c5d...e599e186e2482dc2a1caf86f40e80ebb7b3de5f6,1,13,9,22,4,2013-01-24 17:33:36,2013-01-24 17:32:54
e599e186e2482dc2a1caf86f40e80ebb7b3de5f6...6cf5e6d6318f0f9f932f02337e33b8a7e0b5c76b,2,3,3,6,3,2013-01-24 18:21:48,2013-01-24 17:47:40
6cf5e6d6318f0f9f932f02337e33b8a7e0b5c76b...334c13c492b98cf82e1605cba5ca774bb52014f8,4,54,10,64,12,2013-01-24 18:25:42,2013-01-24 16:37:32
334c13c492b98cf82e1605cba5ca774bb52014f8...4622d34b15e3e941d9164d099dc320bfdb5cdb62,2,6,10,16,3,2013-01-24 18:25:42,2013-01-24 18:24:56
4622d34b15e3e941d9164d099dc320bfdb5cdb62...4621e405d98606b869421a4bdc7a8aed63b6616e,1,3,2,5,2,2013-01-24 20:20:12,2013-01-24 20:20:04
4621e405d98606b869421a4bdc7a8aed63b6616e...6ca745df7983defe7261e7b59828e66cd8bb9a27,1,1,1,2,1,2013-01-24 22:51:25,2013-01-24 22:03:26
6ca745df7983defe7261e7b59828e66cd8bb9a27...62d05a0803d7d3246f0be3f9d2549c9db22de771,1,1,1,2,1,2013-01-25 00:00:23,2013-01-25 00:00:23
62d05a0803d7d3246f0be3f9d2549c9db22de771...992433084dbed40d6509beeb28cf938a81e5c176,1,2,16,18,5,2013-01-25 15:33:19,2013-01-25 15:33:19
992433084dbed40d6509beeb28cf938a81e5c176...2c1ca7a77b395623216ef35964383813830a2ddd,1,1,8,9,2,2013-01-25 15:33:46,2013-01-25 15:33:46
2c1ca7a77b395623216ef35964383813830a2ddd...a0a114ba8baf09ed45d9ea8f1307fc604d12c1e7,3,11,7,18,4,2013-01-25 15:52:03,2013-01-23 20:51:26
a0a114ba8baf09ed45d9ea8f1307fc604d12c1e7...7f88e248007a5aa720ad1b712a235b867e63caa4,3,33,25,58,10,2013-01-25 16:11:33,2013-01-25 12:47:32
7f88e248007a5aa720ad1b712a235b867e63caa4...51bc29ad9a22e51f68d888d634979fcb58ddbd31,1,0,74,74,1,2013-01-25 16:52:59,2013-01-25 16:50:40
51bc29ad9a22e51f68d888d634979fcb58ddbd31...7a8fdfc75c26efc9aa4b3849587ef0995ffd9a36,1,1,2,3,1,2013-01-25 16:52:59,2013-01-25 16:52:45
7a8fdfc75c26efc9aa4b3849587ef0995ffd9a36...84d39b0802890a1853ceb40b908a5053ad5d48ba,7,87,34,121,21,2013-01-25 20:30:58,2013-01-22 20:25:16
84d39b0802890a1853ceb40b908a5053ad5d48ba...d6bdd363f7fad2afc6516bc0443c1c52ae4248ee,6,151,45,196,43,2013-01-25 20:30:58,2013-01-24 19:23:25
d6bdd363f7fad2afc6516bc0443c1c52ae4248ee...90dd7f6486ef65ed04fe2cfd178e4ebd12da3a35,2,8,1,9,4,2013-01-25 20:30:58,2013-01-24 19:42:15
90dd7f6486ef65ed04fe2cfd178e4ebd12da3a35...18468f01130609f7ae4fbc36273378e52df7fa11,6,50,73,123,24,2013-01-25 20:30:58,2013-01-25 20:30:30
18468f01130609f7ae4fbc36273378e52df7fa11...41de9044a87c167de4ec2ba5e67f8f735d9f98c9,4,221,263,484,117,2013-01-25 21:41:49,2013-01-25 21:41:49
41de9044a87c167de4ec2ba5e67f8f735d9f98c9...7a01a9526a86f372063fa7a8ee89eec919592a51,1,1,1,2,1,2013-01-25 21:55:17,2013-01-25 21:54:21
7a01a9526a86f372063fa7a8ee89eec919592a51...7d538d4eae30fd945fc6d4e7cef27ca0da08cf60,1,4,0,4,1,2013-01-26 15:25:34,2013-01-26 15:25:34
7d538d4eae30fd945fc6d4e7cef27ca0da08cf60...ceb21ee5acbbe396a8509bc1abcb6e76e7fe974d,1,2,1,3,1,2013-01-26 22:57:55,2013-01-26 22:57:55
ceb21ee5acbbe396a8509bc1abcb6e76e7fe974d...9b3a4ce065c1aea42473d8b6489f642488ac2b4e,4,34,11,45,15,2013-01-28 15:21:42,2013-01-22 21:42:02
9b3a4ce065c1aea42473d8b6489f642488ac2b4e...b7763e7355337502e6ed2ddd9e536646b0323aa3,1,2,1,3,2,2013-01-28 15:21:42,2013-01-28 14:20:52
b7763e7355337502e6ed2ddd9e536646b0323aa3...07861f5341d4a8e95cc23037b6f245ca8b9110b5,3,68,21,89,19,2013-01-28 15:55:23,2013-01-28 15:55:04
07861f5341d4a8e95cc23037b6f245ca8b9110b5...975bdc846056f91ba997674da648e05a643d61a9,1,1,1,2,1,2013-01-28 16:42:08,2013-01-28 16:42:08
975bdc846056f91ba997674da648e05a643d61a9...e4cae266e46566f38659211be16b4948e8ffcec4,4,11,34,45,15,2013-01-28 17:12:17,2013-01-28 17:11:59
e4cae266e46566f38659211be16b4948e8ffcec4...d901ee1c28cb3c13fdfe7124b44e33f23aa82357,1,4,1,5,1,2013-01-28 21:13:36,2013-01-28 21:09:50
d901ee1c28cb3c13fdfe7124b44e33f23aa82357...84e94743ead1cf066273e3ba0d395252e209e334,1,1,1,2,1,2013-01-28 21:29:25,2013-01-28 21:29:10
84e94743ead1cf066273e3ba0d395252e209e334...dd5dab588622d9f1b874438f12d0172e2bc1218b,1,6,3,9,2,2013-01-28 22:11:27,2013-01-28 22:10:35
dd5dab588622d9f1b874438f12d0172e2bc1218b...1792e07714da4afd0085b34147cb59ec9de82665,1,21,6,27,14,2013-01-28 22:13:23,2013-01-28 22:13:10
1792e07714da4afd0085b34147cb59ec9de82665...305df5edd9dc4aa891e3529b2f3d113ee4bf637d,1,6,2,8,1,2013-01-28 22:16:31,2013-01-28 22:14:25
305df5edd9dc4aa891e3529b2f3d113ee4bf637d...94e77ee131716d06d48f9df7aa2939491ada9ff6,1,53,2,55,3,2013-01-29 12:10:39,2013-01-29 12:10:39
0f79c34fc9b652f3f3c7a9ec494dc316688e4e8d...3ff1634cf2c24c996f426872c5fafd83dc399e51,1,2,53,55,3,2013-01-29 16:50:16,2013-01-29 16:50:16
3ff1634cf2c24c996f426872c5fafd83dc399e51...2b94e0e553d7b76b2c1a50c6e9bd6d0b4764e78c,2,27,1,28,3,2013-01-29 17:55:04,2013-01-29 17:55:04
2b94e0e553d7b76b2c1a50c6e9bd6d0b4764e78c...e9fe81f1d7eef251a9ebee4514031657372cf939,1,5,2,7,1,2013-01-29 18:10:18,2013-01-29 18:09:40
e9fe81f1d7eef251a9ebee4514031657372cf939...84df92e10e2458cd4ff3751c620535aa9f9a92b6,12,223,62,285,49,2013-01-29 19:36:24,2013-01-29 19:36:24
84df92e10e2458cd4ff3751c620535aa9f9a92b6...21b5281a60f04d99bb2ee912f61e5ae0469c2b70,1,0,3,3,1,2013-01-29 19:42:14,2013-01-29 19:42:14
21b5281a60f04d99bb2ee912f61e5ae0469c2b70...e63efd1a41b62ece64d4fce7576fbc8f888b786a,1,1,1,2,1,2013-01-29 21:01:07,2013-01-29 21:01:07
e63efd1a41b62ece64d4fce7576fbc8f888b786a...cbbb6288961bb749deaf6af662bd6e45a715fd32,1,1,0,1,1,2013-01-29 21:57:15,2013-01-29 21:57:15
cbbb6288961bb749deaf6af662bd6e45a715fd32...ba257276295142403329d885a1702e30756a76f7,1,2,1,3,1,2013-01-30 21:24:08,2013-01-30 21:24:08
ba257276295142403329d885a1702e30756a76f7...f8095df93efac80bc8d6ec994abff2d0e0419732,1,14,1,15,3,2013-01-31 00:00:48,2013-01-30 16:35:28
f8095df93efac80bc8d6ec994abff2d0e0419732...759d091f5b5f5c1ce5a336e06f6cfaa2a3a0ea57,1,150,150,300,1,2013-01-31 15:13:38,2013-01-31 15:13:38
759d091f5b5f5c1ce5a336e06f6cfaa2a3a0ea57...09967e98e5d6280305d85553cdb2dd12e2e1e149,3,3,3,6,3,2013-01-31 15:17:31,2013-01-31 15:15:22
09967e98e5d6280305d85553cdb2dd12e2e1e149...52c14416a62ebc02102855a35a049d05986ff915,1,3,7,10,2,2013-01-31 22:40:42,2013-01-31 22:40:42
52c14416a62ebc02102855a35a049d05986ff915...6db61ff2d0ec9da70e03ef68f2d17a562cd766cf,1,1,1,2,1,2013-02-01 00:22:40,2013-02-01 00:22:40
52c14416a62ebc02102855a35a049d05986ff915...cbdc5cc45a34c7deac277d8d546666f95ca9860c,2,2,2,4,2,2013-01-31 23:43:02,2013-01-31 23:42:40
cbdc5cc45a34c7deac277d8d546666f95ca9860c...19b9024e103826808f51aca83baa76b4719dfa1f,2,6,6,12,3,2013-02-01 16:19:43,2013-02-01 16:19:43
19b9024e103826808f51aca83baa76b4719dfa1f...e6280bb744590d7d3b0beca8c66e780d13adf53e,1,1,1,2,1,2013-02-01 18:17:38,2013-01-30 20:51:42
e6280bb744590d7d3b0beca8c66e780d13adf53e...433508a6e94211b3ab8cc198972956ece021d8f5,1,3,3,6,3,2013-02-01 18:18:11,2013-01-31 19:23:29
433508a6e94211b3ab8cc198972956ece021d8f5...9b063257b2b061e2a4f013649d16e28e62712d78,4,38,15,53,17,2013-02-01 19:05:10,2013-02-01 19:04:51
9b063257b2b061e2a4f013649d16e28e62712d78...cd134b933098e6c777b49bd68365c644d8f63a16,3,19,5,24,6,2013-02-01 19:11:04,2013-01-24 16:07:18
cd134b933098e6c777b49bd68365c644d8f63a16...51bcc22142234ca1d86d6675b8fe4a83b140a025,1,14,17,31,2,2013-02-01 19:17:34,2013-01-31 21:19:28
51bcc22142234ca1d86d6675b8fe4a83b140a025...8ab462ba516003db27c4e4574688deef0f8e8dbe,11,26,41,67,22,2013-02-01 20:06:10,2013-01-22 23:19:22
8ab462ba516003db27c4e4574688deef0f8e8dbe...6981863f1174a3c8d0b25a441ad82085cb11f32c,2,8,10,18,5,2013-02-01 20:13:19,2013-01-28 15:29:44
6981863f1174a3c8d0b25a441ad82085cb11f32c...0a590e42086869bb05b2bff36fb104f0f91ba98a,3,155,9,164,8,2013-02-01 20:16:47,2013-01-25 23:35:51
0a590e42086869bb05b2bff36fb104f0f91ba98a...323e305139fc978ce5175521985c8aa18bf241c1,1,176,130,306,18,2013-02-01 20:39:06,2013-01-30 15:13:24
323e305139fc978ce5175521985c8aa18bf241c1...39aad53ef21e4b44c82b9a81c5d50b8dde47ce1b,1,2,12,14,2,2013-02-01 22:16:27,2013-02-01 19:27:53
ff4c692899d8e91fd3dd28e890f61c43c6787531...31ccc2972f011574181e72d0119873b5f81ebe6e,1,0,16,16,16,2013-02-01 22:38:29,2013-01-25 15:04:56
31ccc2972f011574181e72d0119873b5f81ebe6e...e4230c5af776c7094c8a1b697b275da84fe00010,1,12,2,14,2,2013-02-02 15:33:23,2013-02-02 15:33:23
e4230c5af776c7094c8a1b697b275da84fe00010...ea4fcac13bde124ff6ce9d986438235a9fe796a9,1,2,2,4,1,2013-02-03 01:00:27,2013-02-03 01:00:27
ea4fcac13bde124ff6ce9d986438235a9fe796a9...cf8c09559ddc07c6d70d75f128d867f4b4786d80,1,29,12,41,5,2013-02-04 01:14:22,2013-02-04 01:14:22
cf8c09559ddc07c6d70d75f128d867f4b4786d80...98d30384e9036c29372ff806626ac1df606f9c5c,1,8,1,9,1,2013-02-07 11:50:19,2013-02-03 01:32:06
98d30384e9036c29372ff806626ac1df606f9c5c...2e3e2e9957eac59b670d5adbad1483d4615e1845,1,14,8,22,9,2013-02-07 14:16:30,2013-02-07 14:16:30
2e3e2e9957eac59b670d5adbad1483d4615e1845...6dec70a4f6d8b968fe69af32ce0efc2198c13eed,9,135,26,161,33,2013-02-07 14:40:19,2013-01-28 19:35:26
6dec70a4f6d8b968fe69af32ce0efc2198c13eed...63e792f9db6ff9b0ea798910301c30aa590b1678,3,26,4,30,6,2013-02-07 16:54:15,2013-01-29 18:43:24
63e792f9db6ff9b0ea798910301c30aa590b1678...c81afde28a94d7b4588c04b88797c9a67a4640ef,2,19,17,36,7,2013-02-07 16:54:15,2013-01-29 20:36:17
c81afde28a94d7b4588c04b88797c9a67a4640ef...e8df9a34795c2ababebba15a7d25fc44a1a7eabc,1,1,0,1,1,2013-02-07 18:53:11,2013-01-24 23:31:11
e8df9a34795c2ababebba15a7d25fc44a1a7eabc...13dc58eee6fc66b903dd8a65d6dc9537beaf8067,1,1,0,1,1,2013-02-07 18:53:11,2013-01-29 23:05:27
13dc58eee6fc66b903dd8a65d6dc9537beaf8067...5850b2b5aacfe391a0ec34cac0e60d224aa442b2,1,13,2,15,1,2013-02-07 18:56:19,2013-01-30 00:17:16
5850b2b5aacfe391a0ec34cac0e60d224aa442b2...6d58823d47c1cb1ddbd29e774819b1bd81661cc5,1,71,0,71,1,2013-02-07 19:14:57,2013-01-28 22:32:33
6d58823d47c1cb1ddbd29e774819b1bd81661cc5...4f5d0af7ed9ffd1f1d75a46ac3201643451b0bfb,7,114,67,181,33,2013-02-07 19:14:57,2013-01-30 20:40:55
4f5d0af7ed9ffd1f1d75a46ac3201643451b0bfb...cd3b792af9effb43cc9d6982d7ca49339778a10a,5,159,135,294,46,2013-02-07 19:26:38,2013-01-30 23:25:22
cd3b792af9effb43cc9d6982d7ca49339778a10a...f556f67442af30bec0a9f6c10f63f17cfcb53882,1,11,2,13,3,2013-02-07 19:40:37,2013-01-29 23:34:25
f556f67442af30bec0a9f6c10f63f17cfcb53882...710c44d47e1fe414d40d0c1e6e7823034bcbcd54,1,116,16,132,15,2013-02-07 20:08:59,2013-01-30 18:10:53
710c44d47e1fe414d40d0c1e6e7823034bcbcd54...d728797dfa138ae09486c76f90b16c789fad6388,1,166,166,332,37,2013-02-07 20:08:59,2013-01-31 08:28:38
d728797dfa138ae09486c76f90b16c789fad6388...508775a628ca22a2a98acf1d5c0802885e81b9bf,1,0,1,1,1,2013-02-07 20:09:41,2013-02-01 23:28:15
508775a628ca22a2a98acf1d5c0802885e81b9bf...c2ff9da39bcc046e1964c86eb9ce436b9f6efc9c,5,49,46,95,8,2013-02-07 20:48:20,2013-02-07 19:54:52
c2ff9da39bcc046e1964c86eb9ce436b9f6efc9c...2862a34f292335574a96d0a13390aec1011590f4,1,18,0,18,3,2013-02-07 21:37:30,2013-02-01 18:39:51
2862a34f292335574a96d0a13390aec1011590f4...1ea40396c4f6ce9679c336d6c948b11b059cbec2,4,17,10,27,10,2013-02-07 21:37:59,2013-02-07 21:37:59
1ea40396c4f6ce9679c336d6c948b11b059cbec2...52858af695150e71ca17f06e10c07419d54af42b,4,87,32,119,18,2013-02-07 22:02:05,2013-02-07 21:53:24
52858af695150e71ca17f06e10c07419d54af42b...4fe58f1bab72a4d9190bf78b570727cdbff93556,1,4,1,5,3,2013-02-07 23:56:07,2013-02-07 23:20:51
4fe58f1bab72a4d9190bf78b570727cdbff93556...db1067156440d88b4c3dc9c187da55da47471d89,1,12,3,15,3,2013-02-07 23:56:07,2013-02-07 23:49:54
db1067156440d88b4c3dc9c187da55da47471d89...14b14fe13bea33fc3bc92c949fc1567f3f69ade9,8,252,5,257,15,2013-02-08 15:13:48,2013-02-07 20:28:52
14b14fe13bea33fc3bc92c949fc1567f3f69ade9...45e9ad3f408fdf385abd7d560335391b9173188f,1,1,0,1,1,2013-02-08 17:38:52,2013-02-08 15:08:04
45e9ad3f408fdf385abd7d560335391b9173188f...536d1a6d520dbb6d022af9c2c27ea0efa9da48ac,1,5,2,7,3,2013-02-08 17:38:53,2013-02-08 17:37:06
536d1a6d520dbb6d022af9c2c27ea0efa9da48ac...5ecb17b3c84ac55a0e46ae854b8e4cf85b24932d,1,5,1,6,1,2013-02-08 17:38:53,2013-02-08 17:37:55
5ecb17b3c84ac55a0e46ae854b8e4cf85b24932d...084f2697b60982c2b5f6f8a0cb111c71bd1c7a64,1,7,4,11,3,2013-02-08 18:08:37,2013-02-08 17:30:48
084f2697b60982c2b5f6f8a0cb111c71bd1c7a64...cdd7654f2ee3f9cda255e116b0615cfeae93d86b,1,4,2,6,1,2013-02-08 19:01:56,2013-02-08 18:16:35
cdd7654f2ee3f9cda255e116b0615cfeae93d86b...cd93f5f2327addd5506d81e4ba71d652be9ae9d2,2,9,1,10,4,2013-02-08 21:10:46,2013-02-08 21:10:27
cd93f5f2327addd5506d81e4ba71d652be9ae9d2...288df8991ba54a02e034b7a45068acf1972071c9,1,1,0,1,1,2013-02-08 21:58:10,2013-02-08 20:22:22
288df8991ba54a02e034b7a45068acf1972071c9...12b4c4a7c2540f0102637fd53bdceff77e9debdf,1,1,1,2,2,2013-02-08 22:06:24,2013-02-08 21:07:23
12b4c4a7c2540f0102637fd53bdceff77e9debdf...d305bf71dd0c49909c7c59eb3d8c282f9d966128,4,557,46,603,29,2013-02-08 22:09:16,2013-01-29 16:08:11
d305bf71dd0c49909c7c59eb3d8c282f9d966128...0502e74fe90915fe7fa5a3ffb3c2610aa54f486e,1,0,7,7,1,2013-02-09 02:48:34,2013-02-09 02:48:34
0502e74fe90915fe7fa5a3ffb3c2610aa54f486e...5e59e09213eb13e796d7c8052ee944e186618025,1,3,1,4,1,2013-02-09 18:04:10,2013-02-09 18:04:10
5e59e09213eb13e796d7c8052ee944e186618025...2e8ea804a7879babfbb542d8dad07005c4f1ff44,1,9,2,11,1,2013-02-09 20:45:54,2013-02-09 20:37:32
2e8ea804a7879babfbb542d8dad07005c4f1ff44...186f91d83d158adb06e024e7d3a1f4f5673ef5c9,5,208,3,211,10,2013-02-10 16:38:39,2013-01-30 23:10:50
186f91d83d158adb06e024e7d3a1f4f5673ef5c9...ae5f92aec64a2e65091cb53c4edfd77a12abacbf,4,463,23,486,4,2013-02-11 18:28:07,2013-02-11 18:28:07
186f91d83d158adb06e024e7d3a1f4f5673ef5c9...0e0b5016ab80630666277790adbd8042b2c5bb68,2,13,21,34,5,2013-02-11 16:05:08,2013-02-11 16:05:08
0e0b5016ab80630666277790adbd8042b2c5bb68...8813bd382ebe00bf907ae5a0d236dbb8323ac1bf,2,5,5,10,5,2013-02-11 16:18:28,2013-02-09 03:40:00
8813bd382ebe00bf907ae5a0d236dbb8323ac1bf...39d99f00e987d2164412800ea8dbc0894c899cd5,4,5,20,25,9,2013-02-11 17:26:47,2013-02-11 15:41:52
39d99f00e987d2164412800ea8dbc0894c899cd5...71440fea8bf12d12705830817fa1c1a7275ec041,2,9,3,12,5,2013-02-11 17:26:47,2013-02-11 17:12:21
918799b280d9920bc916f2e28e6dea37a3c86bfc...974900c5f2b582dedb74d8b00fa6e3fb0812071d,1,9,1,10,1,2013-02-11 20:04:27,2013-02-11 20:04:27
974900c5f2b582dedb74d8b00fa6e3fb0812071d...4257f887cca2171cde6353a9aada243a7a02852e,1,12,3,15,2,2013-02-11 20:58:30,2013-02-08 19:03:14
4257f887cca2171cde6353a9aada243a7a02852e...7cb5ac461ee22e7b1977e56a8718a2ea3593754d,1,2,2,4,2,2013-02-11 21:15:54,2013-02-11 21:00:10
7cb5ac461ee22e7b1977e56a8718a2ea3593754d...69c85af1e899c52f7b00cacd4c2a11052a6ead91,1,15,0,15,2,2013-02-11 21:59:48,2013-02-07 21:19:06
69c85af1e899c52f7b00cacd4c2a11052a6ead91...8a7974b8048b4617503df4fce4e14489e1c06bc6,1,7,5,12,4,2013-02-11 21:59:48,2013-02-09 23:00:38
8a7974b8048b4617503df4fce4e14489e1c06bc6...79cdf8036d69042a8bb23e6ce7cd028780434d8a,1,5,2,7,2,2013-02-11 21:59:48,2013-02-10 06:11:53
79cdf8036d69042a8bb23e6ce7cd028780434d8a...fa7276e692befefeedd2a63885e5d722a92dcbc9,1,6,2,8,2,2013-02-11 21:59:48,2013-02-10 06:13:05
fa7276e692befefeedd2a63885e5d722a92dcbc9...55653fa1a3a256f96d2098ffcad97eedab49fd56,2,21,4,25,3,2013-02-11 22:51:30,2013-02-11 22:42:00
55653fa1a3a256f96d2098ffcad97eedab49fd56...331ca28913a345af97ddd1bca5bcfe423f40789e,1,2,2,4,2,2013-02-11 23:06:33,2013-02-11 23:06:33
331ca28913a345af97ddd1bca5bcfe423f40789e...04e0c2e0599bb1564c001d685c7efac5b0dbe983,1,0,4,4,1,2013-02-12 15:01:36,2013-02-12 14:47:14
04e0c2e0599bb1564c001d685c7efac5b0dbe983...f101751415d9cf815f2205ee290eb6e803d10462,4,6,8,14,4,2013-02-12 16:03:54,2013-02-11 23:19:26
f101751415d9cf815f2205ee290eb6e803d10462...042548ce2512e7d1d0b48914880e0cdcf9b09e0d,3,10,5,15,7,2013-02-12 17:09:47,2013-02-12 15:24:49
042548ce2512e7d1d0b48914880e0cdcf9b09e0d...77ed8b1f3536574e9a72ab0361d1b0c414d5b899,1,6,0,6,1,2013-02-12 19:02:48,2013-02-12 19:02:38
77ed8b1f3536574e9a72ab0361d1b0c414d5b899...00c53fbf50e539ca8a70f6b879cff9c1391fa603,1,8,4,12,1,2013-02-12 19:05:18,2013-02-12 18:43:01
00c53fbf50e539ca8a70f6b879cff9c1391fa603...1b2b144a8829296cfb1a8f78864eebfe752d9cb3,25,504,340,844,88,2013-02-12 20:30:24,2013-01-31 22:59:23
1b2b144a8829296cfb1a8f78864eebfe752d9cb3...65ed5f4d576e380ae9e59ca7ae9d6b06b9d9766c,4,59,28,87,11,2013-02-12 20:33:12,2013-02-12 18:09:19
65ed5f4d576e380ae9e59ca7ae9d6b06b9d9766c...75b0536f0032627241fbad47baba64322834e523,11,56,67,123,48,2013-02-12 20:33:12,2013-02-12 19:13:35
75b0536f0032627241fbad47baba64322834e523...fe6e8f69d0d0453622b3ea6e99c113580f79ca5b,1,7,4,11,1,2013-02-12 20:33:12,2013-02-12 19:16:08
fe6e8f69d0d0453622b3ea6e99c113580f79ca5b...15a994b5fd9396dc236fda48a95a2bb7c2fb3b99,2,37,37,74,8,2013-02-12 20:33:12,2013-02-12 19:17:39
15a994b5fd9396dc236fda48a95a2bb7c2fb3b99...74e487e24e4120c55436977e0b5972ac38efbab7,2,10,12,22,8,2013-02-12 20:33:12,2013-02-12 20:32:24
74e487e24e4120c55436977e0b5972ac38efbab7...bf3f5025418bab735c28671221b77abe0a5eaee5,1,1,1,2,1,2013-02-12 20:51:19,2013-02-12 20:51:19
bf3f5025418bab735c28671221b77abe0a5eaee5...d4bbcbd420773c6bd2bf2121e0029f277ceb20e8,2,3,3,6,2,2013-02-12 20:51:43,2013-02-12 20:51:43
d4bbcbd420773c6bd2bf2121e0029f277ceb20e8...8b3a9982a49b384dc68031d1388661c845ddbf45,2,14,10,24,4,2013-02-12 20:54:02,2013-02-08 16:56:09
8b3a9982a49b384dc68031d1388661c845ddbf45...c1dca21e709b7fdbffedba1c7e279ab32aa14dcb,1,3,0,3,2,2013-02-12 20:58:43,2013-02-12 20:58:38
c1dca21e709b7fdbffedba1c7e279ab32aa14dcb...9e13c284c7ab6cdb4a80ad40248825fbf73178e3,2,3,3,6,3,2013-02-12 21:06:11,2013-02-08 17:04:35
9e13c284c7ab6cdb4a80ad40248825fbf73178e3...314f7d6ab6dd5969bd36778429375f7f4874bb3b,3,12,1,13,3,2013-02-12 21:10:32,2013-02-12 21:08:02
314f7d6ab6dd5969bd36778429375f7f4874bb3b...a671f10c5e8b2a412eea30ed2f903b66df38ca16,1,1,1,2,1,2013-02-12 21:11:15,2013-02-12 21:11:15
a671f10c5e8b2a412eea30ed2f903b66df38ca16...e554b65675189d75e6001acfb16c8473e1fb9772,4,78,14,92,4,2013-02-12 21:51:02,2013-01-02 16:47:52
e554b65675189d75e6001acfb16c8473e1fb9772...53f0dccda36bf56bdf55ee2c8c5843f0f78f50a1,2,32,3,35,2,2013-02-12 21:58:10,2013-02-07 19:18:17
53f0dccda36bf56bdf55ee2c8c5843f0f78f50a1...9de38f4ef785faaa17ac455e422abc0b4889a5ea,1,5,6,11,2,2013-02-12 21:58:10,2013-02-07 20:26:44
9de38f4ef785faaa17ac455e422abc0b4889a5ea...8084ca65c98d3733c62faedec3f81fd99b2fa547,9,42,37,79,30,2013-02-12 21:58:10,2013-02-12 17:42:35
8084ca65c98d3733c62faedec3f81fd99b2fa547...a7cd0f1d940a74ccec58ec6269d900c59641286b,2,46,27,73,11,2013-02-12 21:58:11,2013-02-12 19:27:07
a7cd0f1d940a74ccec58ec6269d900c59641286b...652651a3c9bf5e79152840a82b6baf8df78c53c4,1,1,1,2,1,2013-02-12 23:08:26,2013-02-12 23:05:35
652651a3c9bf5e79152840a82b6baf8df78c53c4...6e243bcfb4f17fad02f5d8069eec63fe59564242,1,15,0,15,1,2013-02-12 23:39:51,2013-02-12 23:25:40
6e243bcfb4f17fad02f5d8069eec63fe59564242...c0b7158e31d10155a1285f989beae7bb03a5768e,4,168,39,207,26,2013-02-13 00:00:20,2013-02-12 23:59:50
c0b7158e31d10155a1285f989beae7bb03a5768e...38db721f46d739a1356ea27b3ee5ad50669b8b15,1,1,0,1,1,2013-02-13 01:30:03,2013-02-13 01:30:03
38db721f46d739a1356ea27b3ee5ad50669b8b15...9ade835328c4bac80f1f7f7ea34e2ed2ad0a73f2,2,2,2,4,2,2013-02-13 01:36:29,2013-02-13 01:36:29
9ade835328c4bac80f1f7f7ea34e2ed2ad0a73f2...5aee6a37d6164bcf8e7a9cc76d79f2e401ead690,16,64,0,64,32,2013-02-13 01:38:16,2013-02-13 01:38:16
5aee6a37d6164bcf8e7a9cc76d79f2e401ead690...4fd7f7facda415834854c203a38d66df234f648a,2,24,11,35,7,2013-02-13 02:39:22,2013-02-13 02:38:04
4fd7f7facda415834854c203a38d66df234f648a...3a8bf9f32314d1625fe57086a010d783eba97316,2,40,18,58,11,2013-02-13 05:01:08,2013-02-13 04:59:06
3a8bf9f32314d1625fe57086a010d783eba97316...00ac54a1d2bf8c30cef7c7d69e396da46c15c383,2,30,7,37,5,2013-02-13 15:34:54,2013-02-13 15:01:34
00ac54a1d2bf8c30cef7c7d69e396da46c15c383...d6d840d3100a7f6292038cc9d6889eeebf6fb7d7,1,40,24,64,22,2013-02-13 15:59:51,2013-01-24 04:37:40
d6d840d3100a7f6292038cc9d6889eeebf6fb7d7...a6d20c6ececb6fcf667fc85e3cc6dc929651e93d,1,76,0,76,3,2013-02-13 15:59:52,2013-01-24 15:19:11
a6d20c6ececb6fcf667fc85e3cc6dc929651e93d...9ffe6effcf69aaf10272df23f4a0c2d69209d09c,3,296,2,298,4,2013-02-13 15:59:52,2013-01-25 18:38:16
9ffe6effcf69aaf10272df23f4a0c2d69209d09c...2ff5550f2a4e3cf19225cb17fdc1c88a4849b61a,2,91,9,100,8,2013-02-13 15:59:52,2013-02-07 16:58:39
2ff5550f2a4e3cf19225cb17fdc1c88a4849b61a...849d5233b6e3900452a46aabbc09c0b77c1b30c2,1,5,0,5,1,2013-02-13 17:23:19,2013-02-13 14:15:45
849d5233b6e3900452a46aabbc09c0b77c1b30c2...81bc3877fba8e1a5ecf60202477838602b0eceb4,1,40,16,56,4,2013-02-13 17:36:41,2013-02-13 15:23:56
81bc3877fba8e1a5ecf60202477838602b0eceb4...73251a410b512f01f9508a4a648e6af1598ba67c,1,2,2,4,2,2013-02-13 17:36:41,2013-02-13 15:29:53
73251a410b512f01f9508a4a648e6af1598ba67c...6fdf41f93da55f26e714870ddce577c1ad54dd2a,1,117,65,182,17,2013-02-13 17:36:41,2013-02-13 16:47:03
6fdf41f93da55f26e714870ddce577c1ad54dd2a...0e3f43a12e5fcdab1f0942278088608ad9f36046,4,45,36,81,14,2013-02-13 19:56:36,2013-02-13 16:26:04
0e3f43a12e5fcdab1f0942278088608ad9f36046...535ab1a962ccec27209a0e6829f1d2c898bd652e,1,4,1,5,3,2013-02-13 20:47:55,2013-02-13 20:47:55
66bc2d1afbff04c304c8072175044fa8d2bdf371...ae2256441b1c96768b270ee6a866d9669d4b15ec,8,416,58,474,51,2013-02-13 23:16:16,2013-02-07 18:34:44
ae2256441b1c96768b270ee6a866d9669d4b15ec...771e198a491c35c09475d43bed16cdf14118c64d,3,153,141,294,38,2013-02-13 23:52:51,2013-02-13 23:52:51
771e198a491c35c09475d43bed16cdf14118c64d...e02bc698e6926e3bd074f2dab5f902d60a3e44a9,1,15,3,18,3,2013-02-14 14:40:30,2013-02-12 16:02:57
e02bc698e6926e3bd074f2dab5f902d60a3e44a9...93b0ecaf65b24109717981cc32be3fe153d33e2e,3,4,16,20,8,2013-02-14 15:12:55,2013-02-12 17:16:35
93b0ecaf65b24109717981cc32be3fe153d33e2e...f62bc8177b52420e7dc4d0086b6902ccd188f725,3,29,24,53,5,2013-02-14 15:12:55,2013-02-12 23:56:35
f62bc8177b52420e7dc4d0086b6902ccd188f725...ea4b79b64fc4b7fd80aa5b4ec171ac8a37190801,2,7,0,7,2,2013-02-14 15:29:18,2013-02-11 22:27:33
ea4b79b64fc4b7fd80aa5b4ec171ac8a37190801...3face9156090a46c14f281a1f684fa07a6110363,1,89,0,89,1,2013-02-14 17:17:35,2013-01-30 22:56:36
3face9156090a46c14f281a1f684fa07a6110363...d013b483c917ff4a48c002c0c0a133a1f62f55cf,9,394,0,394,9,2013-02-14 18:59:56,2013-02-14 00:25:30
d013b483c917ff4a48c002c0c0a133a1f62f55cf...d710a22595c2a7ce9f393f87ea6a85b3e95a056d,3,23,7,30,12,2013-02-14 19:41:26,2013-02-14 18:50:45
d710a22595c2a7ce9f393f87ea6a85b3e95a056d...cec27ae57687c176f1b67f8189345c5bb3d4120c,1,2,2,4,1,2013-02-14 20:17:35,2013-02-14 20:17:35
cec27ae57687c176f1b67f8189345c5bb3d4120c...ca8305a028f9601f8d6b73aa7be998b014dc9f1c,1,9,3,12,2,2013-02-14 20:33:18,2013-02-14 17:14:09
ca8305a028f9601f8d6b73aa7be998b014dc9f1c...c0d6c3d2058138fbc297626c6712d24f4501d4e0,2,297,0,297,2,2013-02-14 21:43:14,2013-02-11 17:41:46
c0d6c3d2058138fbc297626c6712d24f4501d4e0...b1a992c49c1481b097aaa42a9bf732c99d8fde88,4,105,12,117,14,2013-02-14 21:48:40,2013-02-13 22:51:41
b1a992c49c1481b097aaa42a9bf732c99d8fde88...2d71e6ab2d42c3c1cc31d42e579dec8041f6cca4,1,5,9,14,3,2013-02-15 06:31:52,2013-02-15 06:26:56
2d71e6ab2d42c3c1cc31d42e579dec8041f6cca4...b73eb512ad5429bce3e796e53eaeb56a70e0140a,1,1,0,1,1,2013-02-14 22:53:11,2013-02-14 22:52:46
b73eb512ad5429bce3e796e53eaeb56a70e0140a...96b3a6112d5fadc9a26a30ea8de0db32744bf931,1,1,1,2,1,2013-02-15 13:15:40,2013-02-15 13:15:40
96b3a6112d5fadc9a26a30ea8de0db32744bf931...7af32893c811268fec798d25ded7132e276992ba,1,1,1,2,1,2013-02-15 13:32:48,2013-02-15 13:32:48
7af32893c811268fec798d25ded7132e276992ba...a09abdaa6c93c50d3b58ee97597baff96e02475b,1,40,0,40,1,2013-02-15 14:56:04,2013-02-14 17:04:29
a09abdaa6c93c50d3b58ee97597baff96e02475b...31a2028d80848e1770bf91ced08bae9ca7139d58,9,86,23,109,24,2013-02-15 16:33:38,2013-02-13 19:28:31
31a2028d80848e1770bf91ced08bae9ca7139d58...cd299d2c5b00fe869ac0279e7258d352b1bb827e,12,343,160,503,33,2013-02-15 17:41:22,2013-01-28 18:58:11
cd299d2c5b00fe869ac0279e7258d352b1bb827e...da274cac081409d0edb82901b9c1ad9633f9b1aa,1,2,2,4,2,2013-02-15 17:41:32,2013-02-13 14:56:57
da274cac081409d0edb82901b9c1ad9633f9b1aa...fccd00cad578064cbab4ef0c55d3527ed7ef1436,1,1,0,1,1,2013-02-15 18:35:38,2013-02-15 18:35:32
fccd00cad578064cbab4ef0c55d3527ed7ef1436...e04cab4ddac153023271141190818c7a1256437c,1,16,6,22,4,2013-02-15 18:57:45,2013-02-15 18:57:45
e04cab4ddac153023271141190818c7a1256437c...2d1920b36274a7781891866e413373c52b721b5b,8,32,0,32,16,2013-02-15 19:21:53,2013-02-15 19:21:53
2d1920b36274a7781891866e413373c52b721b5b...c1196d976819b5261ba3b8ebcd4f6fafd251f943,1,1,1,2,1,2013-02-15 19:57:36,2013-02-15 19:57:36
c1196d976819b5261ba3b8ebcd4f6fafd251f943...6d972f8236741e93111e14a9eb96dd1244f8d98f,1,14,14,28,4,2013-02-15 20:55:10,2013-02-15 19:39:58
6d972f8236741e93111e14a9eb96dd1244f8d98f...3d6337ea8958e3a6d97279189f460c9f9decaf9c,8,11,11,22,10,2013-02-15 22:19:42,2013-02-15 20:57:35
3d6337ea8958e3a6d97279189f460c9f9decaf9c...e5756af5f18150608d514176a5fd73b3041d82b5,1,3,2,5,2,2013-02-15 22:41:23,2013-02-15 22:40:12
e5756af5f18150608d514176a5fd73b3041d82b5...caab2a0821cf3e2ad17b6a6ec44979d5881797f0,1,7,1,8,2,2013-02-15 23:06:42,2013-02-15 23:06:28
caab2a0821cf3e2ad17b6a6ec44979d5881797f0...94e43adf33a620633af809d8eefc38a0501a64da,1,1,1,2,1,2013-02-15 23:31:38,2013-02-15 23:31:08
94e43adf33a620633af809d8eefc38a0501a64da...4b4b4e32d9ee8d3ad1141342706c3c2602b3f938,1,8,8,16,7,2013-02-16 00:43:29,2013-02-16 00:43:29
4b4b4e32d9ee8d3ad1141342706c3c2602b3f938...711cd9fc6e2cb95dfc0803ec8487c17d0a530b04,2,26,10,36,5,2013-02-16 01:52:11,2013-02-15 23:34:47
711cd9fc6e2cb95dfc0803ec8487c17d0a530b04...c750a79482d100b19b7415dec9c7cdaed71adf28,1,5,0,5,1,2013-02-16 02:26:42,2013-02-16 02:26:34
c750a79482d100b19b7415dec9c7cdaed71adf28...692090f1efd4a5a869abcddadefac1cdc5de69d0,3,10,7,17,9,2013-02-16 12:43:04,2013-02-14 22:09:12
692090f1efd4a5a869abcddadefac1cdc5de69d0...1bd8b84c64214356f482fa3164d88e664f585243,1,23,10,33,13,2013-02-16 16:10:24,2013-02-16 02:28:31
1bd8b84c64214356f482fa3164d88e664f585243...73805ae6a4bf4b953d79ffbca70bb427b114491b,1,72,0,72,1,2013-02-18 17:55:42,2013-02-18 17:55:42
73805ae6a4bf4b953d79ffbca70bb427b114491b...e23de6dba57bb39fb80f5619a541ed6c0510546f,1,13,13,26,9,2013-02-19 16:16:55,2013-02-19 15:58:30
e23de6dba57bb39fb80f5619a541ed6c0510546f...dd950a095b760d3eef53c2273b4c20f9c90b8b04,1,4,7,11,2,2013-02-19 20:23:05,2013-02-15 16:36:33
dd950a095b760d3eef53c2273b4c20f9c90b8b04...1d9112158860663ca0336dea85dadda88b865bc2,1,10,9,19,5,2013-02-19 20:35:01,2013-02-19 18:39:04
1d9112158860663ca0336dea85dadda88b865bc2...1b4f6081c0884098dd82ae175f4b16ca37e7f9f4,2,2,2,4,2,2013-02-19 22:33:09,2013-02-19 22:33:09
1b4f6081c0884098dd82ae175f4b16ca37e7f9f4...8365d3949be3e877fb73ebb25a8c1440b8bb3b40,16,758,67,825,40,2013-02-20 13:55:48,2013-02-20 13:55:48
8365d3949be3e877fb73ebb25a8c1440b8bb3b40...6896813d49a8bdea68b42c0aa04fbcf0418d1768,1,1,1,2,1,2013-02-20 14:37:00,2013-02-20 14:37:00
6896813d49a8bdea68b42c0aa04fbcf0418d1768...3f920f0e2bcd88a8b3f76239d9d2da5c1a061702,3,65,6,71,8,2013-02-20 15:11:16,2013-02-19 23:35:49
3f920f0e2bcd88a8b3f76239d9d2da5c1a061702...781645b9bfad03c42238a2449aefa6da0074bd87,1,10,4,14,3,2013-02-20 15:13:56,2013-02-19 22:35:12
781645b9bfad03c42238a2449aefa6da0074bd87...f11d2b67e2f185a0934d76cca21361b0679e5301,9,134,41,175,28,2013-02-20 17:15:57,2013-02-20 17:15:46
f11d2b67e2f185a0934d76cca21361b0679e5301...39a806e7390ac9effd99bf7d1633fa7f4829021a,3,29,0,29,5,2013-02-20 17:50:57,2013-02-20 16:41:00
39a806e7390ac9effd99bf7d1633fa7f4829021a...7817175b3cc03b9da8ac1b38690ec321f16a6f68,1,7,7,14,5,2013-02-20 17:56:39,2013-02-20 17:56:24
7817175b3cc03b9da8ac1b38690ec321f16a6f68...20536f81cb31522acc7c633fb87ab1582c947b8a,32,23488,23273,46761,1257,2013-02-20 18:23:53,2013-02-20 17:50:27
20536f81cb31522acc7c633fb87ab1582c947b8a...097e3578da6365b20d41d74bfe13d414c151eda7,3,99,13,112,6,2013-02-20 18:26:01,2013-02-20 15:22:35
097e3578da6365b20d41d74bfe13d414c151eda7...8d9bb7a5147e58e9d5a704b5dbbd04d2b19507e0,1,5,0,5,1,2013-02-20 19:26:24,2013-02-20 00:12:15
8d9bb7a5147e58e9d5a704b5dbbd04d2b19507e0...5ed08e9a1299a0d5cee74666ccec660d224bd5ce,1,1,0,1,1,2013-02-20 19:40:28,2013-02-20 19:40:28
5ed08e9a1299a0d5cee74666ccec660d224bd5ce...c8828dea771690082f949a367ac920aa7e463262,1,2,3,5,2,2013-02-20 20:12:10,2013-02-20 20:12:00
c8828dea771690082f949a367ac920aa7e463262...01c2aa306374e440dc24f47c529ea075618aa20c,1,2,2,4,1,2013-02-20 20:26:52,2013-02-20 20:22:35
01c2aa306374e440dc24f47c529ea075618aa20c...14ed13866d9b88f8cdf5d3456882197f7530798e,1,1,1,2,1,2013-02-20 20:35:58,2013-02-20 20:35:50
14ed13866d9b88f8cdf5d3456882197f7530798e...1dce1ffee15f9d07958b3300cb020252a9402e3e,1,0,13,13,1,2013-02-20 20:51:02,2013-02-20 20:51:02
1dce1ffee15f9d07958b3300cb020252a9402e3e...3131bfba5e3d4fefcc8c9cf38bce54393606849e,1,3,0,3,1,2013-02-20 21:31:08,2013-02-20 19:40:00
3131bfba5e3d4fefcc8c9cf38bce54393606849e...6ddad8c0d34bdd0e1c08a85cf35b1fd0f0f235e2,5,30,0,30,7,2013-02-20 21:36:28,2013-02-20 15:34:19
6ddad8c0d34bdd0e1c08a85cf35b1fd0f0f235e2...1e1ee889c2bc36b315b1e92a50db0c996e90d5b9,5,0,30,30,7,2013-02-20 22:26:55,2013-02-20 22:26:55
1e1ee889c2bc36b315b1e92a50db0c996e90d5b9...277d9a4b12b7e74a5ba5ec11e56d9f21cb3a9172,1,1,1,2,1,2013-02-21 00:16:25,2013-02-21 00:16:19
277d9a4b12b7e74a5ba5ec11e56d9f21cb3a9172...897627666be933bbfe2c396cd5ca4d08d03b70ee,4,144,31,175,22,2013-02-21 00:13:30,2013-02-20 23:06:39
897627666be933bbfe2c396cd5ca4d08d03b70ee...46436d5fd83099aec712ba513a3a8677924939ed,1,45,0,45,2,2013-02-21 00:29:20,2013-02-21 00:28:39
46436d5fd83099aec712ba513a3a8677924939ed...6ac1c2384a823be2f897fce28aec642d97e059a6,1,12,0,12,1,2013-02-21 00:35:52,2013-02-21 00:34:46
6ac1c2384a823be2f897fce28aec642d97e059a6...a6482ac68a564dc04e3fe623d91731502ef6b48b,1,1,1,2,1,2013-02-21 00:35:41,2013-02-21 00:34:29
a6482ac68a564dc04e3fe623d91731502ef6b48b...d856f64418940934a2e0c110c6da05b3ba0f4549,2,25,6,31,4,2013-02-21 13:35:22,2013-02-21 00:47:13
d856f64418940934a2e0c110c6da05b3ba0f4549...cc76deb72e656ab86dc1c2fd826d9a89631f54a0,2,11,3,14,2,2013-02-21 13:41:24,2013-02-21 13:40:55
cc76deb72e656ab86dc1c2fd826d9a89631f54a0...eb61bc9a8c04f11b76c280a7e7fe76d9aa1547a5,5,31,0,31,7,2013-02-21 14:50:50,2013-02-20 22:42:56
eb61bc9a8c04f11b76c280a7e7fe76d9aa1547a5...5d03739eb1214ea0c032869ed58a2bdfd6456d8f,1,1,1,2,1,2013-02-21 14:51:01,2013-02-21 06:23:48
5d03739eb1214ea0c032869ed58a2bdfd6456d8f...a54647db96c32c1c8c92e44f9c35b1eb2ba6ce89,2,28,3,31,8,2013-02-21 16:01:35,2013-02-21 16:01:35
a54647db96c32c1c8c92e44f9c35b1eb2ba6ce89...bf97961c885fc02feecb3bc45bd1f52e23b3d1b8,2,200,7,207,7,2013-02-15 14:48:30,2013-02-15 14:46:25
bf97961c885fc02feecb3bc45bd1f52e23b3d1b8...a8b4d76306f231df8a1c85625a8d9ee20ae1d2cf,1,3,0,3,2,2013-02-21 16:53:48,2013-02-21 16:53:37
a8b4d76306f231df8a1c85625a8d9ee20ae1d2cf...a65d725b90f7a10e18420f4e25ecd6359d0c4e95,1,6,5,11,1,2013-02-21 18:31:49,2013-02-21 17:40:21
a65d725b90f7a10e18420f4e25ecd6359d0c4e95...3aba6f8dc555eafeb9abfdb9fecf2067469fbf1c,1,6,6,12,2,2013-02-21 20:09:06,2013-02-21 20:09:06
3aba6f8dc555eafeb9abfdb9fecf2067469fbf1c...420e61e130be8ae5f4d2d283e4f84711121dd8c0,1,3,1,4,1,2013-02-22 00:40:37,2013-02-22 00:27:23
420e61e130be8ae5f4d2d283e4f84711121dd8c0...2145ebc9c7bfacd78f0ad3a17cf4312ef74d96d0,1,1,0,1,1,2013-02-22 16:38:59,2013-02-22 16:38:54
2145ebc9c7bfacd78f0ad3a17cf4312ef74d96d0...98ab68d7d8c077f497857563da62f331e0dc570f,1,1,1,2,1,2013-02-22 17:55:36,2013-02-22 17:55:36
98ab68d7d8c077f497857563da62f331e0dc570f...03f150d60037e1206a6ed3b001c33118c7e17dbc,1,1,0,1,1,2013-02-22 18:14:05,2013-02-22 18:14:05
03f150d60037e1206a6ed3b001c33118c7e17dbc...0c1895dae4a9cd6550f8ce0a8c40fe4d988361d5,2,9,2,11,6,2013-02-22 18:35:39,2013-02-22 16:33:36
0c1895dae4a9cd6550f8ce0a8c40fe4d988361d5...4cdf08b86b2f9141f0dc9e5a878a9a853364efd3,1,1,0,1,1,2013-02-22 19:12:15,2013-02-22 19:09:48
4cdf08b86b2f9141f0dc9e5a878a9a853364efd3...b4be8b421a39444f7ffb45f232db40dbd945823b,1,15,2,17,1,2013-02-22 20:48:24,2013-02-22 20:48:24
b4be8b421a39444f7ffb45f232db40dbd945823b...81fde62a567e0fcd729adfd39efed06c59135c45,2,2,1,3,2,2013-02-22 21:45:22,2013-02-22 21:45:13
81fde62a567e0fcd729adfd39efed06c59135c45...29ccd88fccfeb88cad4217be482a335ac81a8fb7,1,4,6,10,2,2013-02-22 21:55:27,2013-02-22 21:37:22
29ccd88fccfeb88cad4217be482a335ac81a8fb7...4edaaee961ab91e5b2e1b78b8b2c9363b56b1d77,1,2,1,3,1,2013-02-24 04:13:16,2013-02-24 04:11:54
4edaaee961ab91e5b2e1b78b8b2c9363b56b1d77...c2db241639fc9c26c8dfb773d29a8d2eac6e32cc,2,2,2,4,2,2013-02-24 12:15:20,2013-02-24 12:15:20
c2db241639fc9c26c8dfb773d29a8d2eac6e32cc...1ea058cf251bda7624f2afac0b38eebd969c5105,2,2,2,4,2,2013-02-24 21:44:05,2013-02-24 21:44:05
1ea058cf251bda7624f2afac0b38eebd969c5105...2882398182a9055938b78057ca49333162e266c5,2,2,2,4,2,2013-02-25 16:41:27,2013-02-25 16:41:27
2882398182a9055938b78057ca49333162e266c5...b06ea7b670826856cbc28ba99ae766c7ca397084,1,1,1,2,1,2013-02-25 19:27:15,2013-02-25 19:27:15
b06ea7b670826856cbc28ba99ae766c7ca397084...b30db2399313a1043f419f9581a5688aa68f5e32,1,3,2,5,3,2013-02-25 21:44:30,2013-02-25 20:12:57
b30db2399313a1043f419f9581a5688aa68f5e32...49e64f404b3f6fa1c618060944733feb79f467fe,1,4,3,7,2,2013-02-25 23:37:19,2013-02-08 23:20:43
49e64f404b3f6fa1c618060944733feb79f467fe...efac678a395772d05fdb0b742275f6e0844d2bc1,1,2,1,3,1,2013-02-26 15:21:34,2013-02-26 15:21:34
efac678a395772d05fdb0b742275f6e0844d2bc1...4a39a5bcbb2c298432819e66febab717e2c67b1a,1,1,1,2,1,2013-02-26 15:54:39,2013-02-22 10:07:30
4a39a5bcbb2c298432819e66febab717e2c67b1a...5bbdfa31eba4680f8aee37300db852706b9289cb,1,4,4,8,3,2013-02-26 16:06:58,2013-02-26 09:14:21
5bbdfa31eba4680f8aee37300db852706b9289cb...7e3abac147af2eecc3b199c905be47b5120b4ee9,2,88,10,98,8,2013-02-26 16:49:04,2013-02-21 00:50:22
7e3abac147af2eecc3b199c905be47b5120b4ee9...d3aef09798f59763f268a3e9ad35d0ddca1b7018,1,4,2,6,2,2013-02-26 16:49:04,2013-02-25 16:01:43
d3aef09798f59763f268a3e9ad35d0ddca1b7018...915e4b4996188ebbb20b16979b803633d16ff223,10,1811,0,1811,10,2013-02-26 18:21:18,2013-02-15 22:02:06
915e4b4996188ebbb20b16979b803633d16ff223...0e3b3ca8480ddddf5d0105d11a94bd4698335312,11,1630,2067,3697,229,2013-02-26 18:21:18,2013-02-15 23:41:47
0e3b3ca8480ddddf5d0105d11a94bd4698335312...12b78705d4cf20c884cd87500078bfc47d87607a,1,141,403,544,19,2013-02-26 18:21:18,2013-02-19 16:58:57
12b78705d4cf20c884cd87500078bfc47d87607a...3815d85c8eb82fb49ea165f9fe9b2f79cb477207,1,90,4,94,41,2013-02-26 18:21:18,2013-02-20 16:53:10
3815d85c8eb82fb49ea165f9fe9b2f79cb477207...dde1e74f8320f5d9b90193efa41615c2b59bf808,1,0,2,2,2,2013-02-26 18:21:18,2013-02-22 16:58:46
dde1e74f8320f5d9b90193efa41615c2b59bf808...b85896c286f5858b0ab9bfe38b0a77a452900847,1,31,0,31,23,2013-02-26 18:21:18,2013-02-22 18:42:21
b85896c286f5858b0ab9bfe38b0a77a452900847...89d8c3c0358dcf670c60efafdd3e31cd8d8b98dc,10,0,1811,1811,10,2013-02-26 18:21:19,2013-02-23 00:15:31
89d8c3c0358dcf670c60efafdd3e31cd8d8b98dc...ac2b60765a3af8da44d10153db3731301e558281,1,2,6,8,5,2013-02-26 18:21:19,2013-02-25 21:51:48
ac2b60765a3af8da44d10153db3731301e558281...e773814068ce154ce5577c4428575b55a3626524,1,204,949,1153,28,2013-02-26 18:21:19,2013-02-25 22:36:59
e773814068ce154ce5577c4428575b55a3626524...56a415f2adc9601dfc9b06e532acaa74a3c2d59c,1,1,3,4,2,2013-02-26 18:21:19,2013-02-26 17:59:36
56a415f2adc9601dfc9b06e532acaa74a3c2d59c...7e7866cc263c2af803ba2479b212c245f73d57bc,1,3,1,4,1,2013-02-26 18:44:31,2013-02-24 11:32:04
7e7866cc263c2af803ba2479b212c245f73d57bc...17665ae38630a340d1c73537dde9f333750d18df,1,4,0,4,1,2013-02-26 21:52:12,2013-02-26 21:51:12
17665ae38630a340d1c73537dde9f333750d18df...f396ed2f582b17e0aeac263ca55242b699e7fc27,1,3,1,4,1,2013-02-26 21:53:53,2013-02-26 21:24:10
f396ed2f582b17e0aeac263ca55242b699e7fc27...a61095252979abc4793bfe1c72e2e4bb9790c49f,1,6,1,7,2,2013-02-27 00:30:25,2013-02-27 00:30:20
a61095252979abc4793bfe1c72e2e4bb9790c49f...a5e5bcf541657ae8e6ac587a224504085688f4a1,1,4,0,4,1,2013-02-27 14:40:25,2013-02-27 14:40:25
a5e5bcf541657ae8e6ac587a224504085688f4a1...6a2ab90b67fb496d34a77a4315c3ebd730ed7a8b,1,0,5,5,1,2013-02-27 14:50:04,2013-02-27 14:50:04
6a2ab90b67fb496d34a77a4315c3ebd730ed7a8b...9a7c92638a28c21bd1e883c85ecee2f41a67ca4b,1,5,0,5,1,2013-02-27 14:51:22,2013-02-27 14:51:22
9a7c92638a28c21bd1e883c85ecee2f41a67ca4b...73f277b1630c32339a90674428a7956c4f8b8bbf,2,20,5,25,5,2013-02-27 16:40:55,2013-02-27 03:27:12
73f277b1630c32339a90674428a7956c4f8b8bbf...82c8b3262103a89f0d29c51989f5063718b2ae5c,1,0,0,0,0,2013-02-27 16:48:55,2013-02-27 05:58:36
82c8b3262103a89f0d29c51989f5063718b2ae5c...85f084463750f3cddb0792f45b3af2b19d4749b6,1,9,5,14,4,2013-02-27 18:53:11,2013-02-27 17:25:47
85f084463750f3cddb0792f45b3af2b19d4749b6...46f3b3f0342f59406f69b2ed540ca6e4d6500854,1,3,9,12,3,2013-02-27 18:59:55,2013-02-26 17:31:10
46f3b3f0342f59406f69b2ed540ca6e4d6500854...23f9b0fd0cfb65b5c4bd700d9e876c6938c3e9b4,1,1,0,1,1,2013-02-27 19:11:59,2013-02-27 18:50:20
23f9b0fd0cfb65b5c4bd700d9e876c6938c3e9b4...5637ebbc1c778d55dc105a3dc8c6d016523d095e,3,57,68,125,28,2013-02-27 20:16:32,2013-02-27 20:16:32
5637ebbc1c778d55dc105a3dc8c6d016523d095e...5eb8129fe56f7ef5454577416ac8b4fc12e2ae46,7,15,11,26,13,2013-02-27 21:03:29,2013-02-27 21:03:29
5eb8129fe56f7ef5454577416ac8b4fc12e2ae46...e57f5d32d93cd23971cadfcdb93a4b9f07a0ef5a,5,47,0,47,7,2013-02-27 22:13:24,2013-02-26 21:23:39
e57f5d32d93cd23971cadfcdb93a4b9f07a0ef5a...2dc724253a8befc714d45a63ea86385d48abc35c,3,113,30,143,15,2013-02-27 22:13:24,2013-02-26 21:25:07
2dc724253a8befc714d45a63ea86385d48abc35c...eb04c21a8be312d2a100fab53456fa25b52d75d2,5,0,47,47,7,2013-02-27 22:50:05,2013-02-27 22:50:05
eb04c21a8be312d2a100fab53456fa25b52d75d2...cde17b7efa1f41b4bac1fc84fe72566d8740c8cc,5,59,2,61,10,2013-02-28 04:22:52,2013-02-26 21:23:39
cde17b7efa1f41b4bac1fc84fe72566d8740c8cc...8cc24988016ec8d3f2cc2c4046d3f97757e7761e,1,7,0,7,1,2013-02-28 14:15:16,2013-02-28 14:15:16
8cc24988016ec8d3f2cc2c4046d3f97757e7761e...cb1bdcd2688b65fce865d3db5c23c47d3b69c6be,1,16,0,16,5,2013-02-28 15:31:09,2013-02-28 15:31:09
cb1bdcd2688b65fce865d3db5c23c47d3b69c6be...7471ba53b04f21157c4d6066e6e2769d856a3d3c,1,15,1,16,1,2013-02-28 18:54:35,2013-02-28 18:53:57
7471ba53b04f21157c4d6066e6e2769d856a3d3c...9d638fd65a8010d3d357b2cd0bb11e099a222ae8,2,17,1,18,2,2013-02-28 21:00:28,2013-02-27 16:23:14
9d638fd65a8010d3d357b2cd0bb11e099a222ae8...b91edafaec04c2b131a5bca03f05da55fa28c90a,2,15,47,62,11,2013-02-28 21:44:11,2013-02-27 18:14:40
b91edafaec04c2b131a5bca03f05da55fa28c90a...dd142e8324f977197107c9bbec62f4af3670aebd,2,20,5,25,5,2013-02-28 21:44:11,2013-02-27 18:26:16
dd142e8324f977197107c9bbec62f4af3670aebd...0c8ac1a52dcf0a93e6e1ab4d701215b2beb6cff6,3,24,2,26,5,2013-02-28 21:44:11,2013-02-28 21:43:45
0c8ac1a52dcf0a93e6e1ab4d701215b2beb6cff6...e63cc1987e8e69e53158a02f393b5a8c8993f492,1,72,9,81,12,2013-02-28 22:34:35,2013-02-28 22:34:30
e63cc1987e8e69e53158a02f393b5a8c8993f492...6ea3fb90c6a90cad47501c4581c7206545f5e3f3,9,31,16,47,17,2013-02-28 23:19:47,2013-02-28 23:19:47
6ea3fb90c6a90cad47501c4581c7206545f5e3f3...c909370ff97ccf17d340ab3c337269f8c181af92,2,24,9,33,12,2013-03-01 00:39:39,2013-02-28 18:13:47
c909370ff97ccf17d340ab3c337269f8c181af92...6ec8713ca64641bc292d8b61af4fa2c075a45948,8,32,0,32,32,2013-03-01 10:12:15,2013-03-01 10:12:15
6ec8713ca64641bc292d8b61af4fa2c075a45948...d65b141de63340c84563be8c1d2ee13b06363e78,3,5,5,10,4,2013-03-01 11:30:10,2013-03-01 11:29:59
d65b141de63340c84563be8c1d2ee13b06363e78...f84a8a92cd95dc925d7285564bbce56efb73ba3b,1,2,2,4,2,2013-03-01 13:04:19,2013-03-01 13:04:19
f84a8a92cd95dc925d7285564bbce56efb73ba3b...1f7902206e31305e336c155166a6c12ae0f72ab3,1,10,5,15,5,2013-03-01 15:06:25,2013-03-01 15:06:18
1f7902206e31305e336c155166a6c12ae0f72ab3...7e5a331e53569c1c4a239cf3a972bef3eef67afa,1,4,4,8,2,2013-03-01 16:18:00,2013-03-01 16:18:00
7e5a331e53569c1c4a239cf3a972bef3eef67afa...e3eb91bedca694eda23c911ab860d803bf042bc0,2,48,0,48,3,2013-03-01 16:55:07,2013-02-28 00:49:28
e3eb91bedca694eda23c911ab860d803bf042bc0...e3cd35bf6902a4eeb2b90eff643d9fcd852023d1,1,2,2,4,2,2013-03-01 16:59:30,2013-03-01 16:59:30
e3cd35bf6902a4eeb2b90eff643d9fcd852023d1...f5a99e393fca6ca8167b0e37b4a7d05e7d43ce1d,1,9,4,13,4,2013-03-01 18:31:39,2013-03-01 18:31:39
f5a99e393fca6ca8167b0e37b4a7d05e7d43ce1d...58203415c1971faba57ab2488b9b14d3374e9103,4,56,3,59,5,2013-03-01 18:45:43,2013-03-01 18:45:38
58203415c1971faba57ab2488b9b14d3374e9103...77d55de67cf5700a4472d60ed2df4d7b5157de95,3,95,53,148,18,2013-03-01 18:47:27,2013-03-01 18:40:05
77d55de67cf5700a4472d60ed2df4d7b5157de95...e528ff70fcc75984331612d20b0496dbb4fcf365,5,62,8,70,7,2013-03-01 19:06:30,2013-02-28 22:01:56
e528ff70fcc75984331612d20b0496dbb4fcf365...b19a031dd8558d96307d021cab84a2fe4bd7ee3a,1,6,1,7,4,2013-03-01 19:06:30,2013-02-28 22:57:51
b19a031dd8558d96307d021cab84a2fe4bd7ee3a...f7dfdd32aa7e04388fdba10f828b3552c2f8d78e,1,3,2,5,1,2013-03-01 20:00:43,2013-03-01 18:07:35
f7dfdd32aa7e04388fdba10f828b3552c2f8d78e...117f00f4d7bef6385cca2761c3b4cc56ead34144,16,25,25,50,19,2013-03-01 20:52:02,2013-02-25 22:15:33
117f00f4d7bef6385cca2761c3b4cc56ead34144...23fc55ca33aa4e00b300824165466e4febe67f6d,22,28,31,59,24,2013-03-01 20:52:09,2013-02-26 00:54:19
23fc55ca33aa4e00b300824165466e4febe67f6d...28c49b3882ccca72971270fcebc438c593aa6ede,10,76,12,88,18,2013-03-01 21:45:17,2013-03-01 19:01:34
28c49b3882ccca72971270fcebc438c593aa6ede...18cc49471b44049f97bc047c3a3200c2011c4e54,2,8,8,16,2,2013-03-01 22:26:19,2013-03-01 22:26:11
18cc49471b44049f97bc047c3a3200c2011c4e54...6084f5cb58657f2576e5a63794fcf302b1777a8c,1,1,1,2,1,2013-03-01 23:25:16,2013-03-01 23:25:16
6084f5cb58657f2576e5a63794fcf302b1777a8c...11188a46354c7a46761fdcb3e2cdb4bc589f03e8,1,1,0,1,1,2013-03-02 13:37:59,2013-03-02 13:37:59
11188a46354c7a46761fdcb3e2cdb4bc589f03e8...c8fea053358994f98cd8e4112ae90e90ce207d9a,1,11,10,21,4,2013-03-02 13:51:46,2013-03-02 13:51:46
c8fea053358994f98cd8e4112ae90e90ce207d9a...20359e07cdf15a41f65572f1fccb881d17f33563,1,1,0,1,1,2013-03-04 16:23:55,2013-03-04 16:23:55
20359e07cdf15a41f65572f1fccb881d17f33563...04e96203721d49eb03777f63a3b085057656e313,1,4,7,11,3,2013-03-04 16:44:24,2013-03-04 16:44:24
04e96203721d49eb03777f63a3b085057656e313...cafb1081b84aa443aa0b5c2c12d4d14eaa628a82,1,3,0,3,1,2013-03-04 17:43:17,2013-03-04 16:35:53
cafb1081b84aa443aa0b5c2c12d4d14eaa628a82...cd913b22be1a7b9737b4c368926dc86cd920669b,1,1,0,1,1,2013-03-04 17:43:17,2013-03-04 17:43:12
cd913b22be1a7b9737b4c368926dc86cd920669b...696dec1262372b0ac45bad9c84de4700eb0d2e71,7,144,10,154,16,2013-03-04 18:39:59,2013-03-03 16:38:44
696dec1262372b0ac45bad9c84de4700eb0d2e71...4cfc0636c0768a5590c0e961e88f4976c63fe490,1,1,1,2,1,2013-03-04 18:59:04,2013-03-04 18:59:04
4cfc0636c0768a5590c0e961e88f4976c63fe490...acfb8d8abda2587c6015b354684614a5a1adbbd1,1,3,1,4,2,2013-03-04 19:20:06,2013-03-04 16:38:24
acfb8d8abda2587c6015b354684614a5a1adbbd1...00c93cd20c7aed10c5f26d42272182d79b4a8972,2,50,15,65,11,2013-03-04 19:20:06,2013-03-04 19:19:24
00c93cd20c7aed10c5f26d42272182d79b4a8972...3f2de68c7ee94db972ee4a631208c3c8b0ee6f8f,1,17,2,19,4,2013-03-04 20:28:42,2013-03-04 20:28:42
3f2de68c7ee94db972ee4a631208c3c8b0ee6f8f...cc1fd583aa2280f993efa1741b0a0197dd580269,4,8,0,8,4,2013-03-04 21:43:24,2013-03-04 21:43:23
cc1fd583aa2280f993efa1741b0a0197dd580269...9d9ea7b87d170711ddc17ac9abc2ead80d9cda60,1,19,0,19,3,2013-03-05 05:51:07,2013-03-05 05:51:07
9d9ea7b87d170711ddc17ac9abc2ead80d9cda60...f69af0110f837371b45f2939a5e5c991357d9b2d,1,69,63,132,33,2013-03-05 15:39:10,2013-03-05 15:39:10
f69af0110f837371b45f2939a5e5c991357d9b2d...b3162303cea18e7dea467067246312376ccaee04,1,1,0,1,1,2013-03-05 16:18:32,2013-03-05 15:35:07
b3162303cea18e7dea467067246312376ccaee04...f4cf69ce489dd7ea90214dda4d799e3f7a294c35,1,1,1,2,1,2013-03-05 17:11:34,2013-03-05 17:11:26
f4cf69ce489dd7ea90214dda4d799e3f7a294c35...8b37c220e98451d67d89f2a8e6b3c08bec442221,1,10,10,20,2,2013-03-05 17:17:04,2013-03-05 17:17:04
8b37c220e98451d67d89f2a8e6b3c08bec442221...18de1d56412bfb89a6b3f95b18eeb770184fda15,1,5,5,10,2,2013-03-05 17:21:18,2013-03-05 17:21:18
18de1d56412bfb89a6b3f95b18eeb770184fda15...081a0a87a20d51ded630c967ce31b4a607d5035d,1,120,107,227,34,2013-03-05 17:26:36,2013-03-05 17:26:36
081a0a87a20d51ded630c967ce31b4a607d5035d...0893701ad4a183589e08d3e00428b6f1d5a37124,1,8,3,11,3,2013-03-05 21:04:54,2013-03-05 21:04:54
0893701ad4a183589e08d3e00428b6f1d5a37124...629ed9f2a0bd63fe6640d6497aeee840bd474214,2,18,2,20,2,2013-03-05 21:30:23,2013-03-01 19:14:00
629ed9f2a0bd63fe6640d6497aeee840bd474214...e78e92cbdd0f91c58b5a72ef774ebe04b7b479b3,1,1,1,2,1,2013-03-05 21:30:25,2013-03-01 19:34:02
e78e92cbdd0f91c58b5a72ef774ebe04b7b479b3...9c7f2055e3977c988ea7b6fa3c8762cdaafe0509,8,156,25,181,27,2013-03-05 21:30:25,2013-03-01 22:41:38
9c7f2055e3977c988ea7b6fa3c8762cdaafe0509...1aa18930b39ad01a310794d7207c61da10f2c0ab,2,2,2,4,2,2013-03-06 16:42:07,2013-03-06 16:42:07
1aa18930b39ad01a310794d7207c61da10f2c0ab...3ce5079c1caa7dfe34a6b457a30b3a55b906ac80,2,2,2,4,2,2013-03-07 15:00:58,2013-03-07 15:00:58
3ce5079c1caa7dfe34a6b457a30b3a55b906ac80...08da87aa68a489dab7f24e059916b1ba2aa33452,9,0,68,68,34,2013-03-07 16:43:15,2013-03-07 16:36:22
08da87aa68a489dab7f24e059916b1ba2aa33452...3018a05958ccfba1cd08b476fdcd103835e3fde8,2,4,4,8,4,2013-03-08 23:14:49,2013-03-08 23:13:45
3018a05958ccfba1cd08b476fdcd103835e3fde8...1b84109f9c0fb976d67de4a837391fbbfbb6659a,1,3,0,3,1,2013-03-12 14:35:46,2013-03-12 14:29:09
1b84109f9c0fb976d67de4a837391fbbfbb6659a...edb5f4efef0b5592f6e9449db86eca50223439ea,2,13,1,14,3,2013-03-12 14:35:53,2013-03-12 14:30:21
edb5f4efef0b5592f6e9449db86eca50223439ea...bb2313f4204203b8289546151d475f5d3b247511,1,1,1,2,1,2013-03-12 14:48:04,2013-03-12 14:47:08
bb2313f4204203b8289546151d475f5d3b247511...d92e62945420c0c3a4df1aeb3b8df800e3d8181d,2,19,0,19,2,2013-03-12 15:12:39,2013-03-12 14:39:27
d92e62945420c0c3a4df1aeb3b8df800e3d8181d...36e04f7bb6775ad55109177b75be18da56d594a2,1,2,1,3,1,2013-03-12 17:52:51,2013-03-12 17:51:38
36e04f7bb6775ad55109177b75be18da56d594a2...3bcf74b73f80e965ccb0acb4f2203ad3e4551b41,1,8,5,13,4,2013-03-12 20:43:28,2013-03-12 20:43:28
3bcf74b73f80e965ccb0acb4f2203ad3e4551b41...8d3cd285f3b39e993d7c96424b766892398eacea,2,2,2,4,2,2013-03-13 04:30:52,2013-03-13 04:30:52
8d3cd285f3b39e993d7c96424b766892398eacea...5345b970c3a484d3aa5e25621fbb7369fbe686ea,2,2,2,4,2,2013-03-13 18:44:12,2013-03-13 18:44:12
5345b970c3a484d3aa5e25621fbb7369fbe686ea...b894cc7211a5520196a735301a26a0df33123819,14,5385,527,5912,172,2013-03-15 00:04:40,2013-03-14 23:00:30
b894cc7211a5520196a735301a26a0df33123819...f89c7424fc8777ef43c0f3557515f1a0f1f9d91e,1,3,0,3,1,2013-03-15 00:04:40,2013-03-14 23:09:00
f89c7424fc8777ef43c0f3557515f1a0f1f9d91e...a8fd67b31adb0bfd99967543b10c7dda4e8d614c,1,3,3,6,1,2013-03-15 00:04:40,2013-03-14 23:10:58
a8fd67b31adb0bfd99967543b10c7dda4e8d614c...eace82e9395abe0c92091adc255c05b1430e7a2f,3,0,0,0,0,2013-03-15 00:04:40,2013-03-15 00:03:28
eace82e9395abe0c92091adc255c05b1430e7a2f...ce2d666c04b4a80af58e8bbb3388b0680e8cfeb6,3,14,2,16,3,2013-03-15 18:59:55,2013-03-15 18:59:55
08da87aa68a489dab7f24e059916b1ba2aa33452...e6b1b481cab13e8602553fd70f9d4da9c7d0e852,2,2,2,4,2,2013-03-08 14:32:02,2013-03-08 14:32:02
e6b1b481cab13e8602553fd70f9d4da9c7d0e852...14d1e3414f252dfb1ebb0ac6d51a463413ba6f93,1,4,6,10,1,2013-03-08 15:33:18,2012-12-21 20:54:20
14d1e3414f252dfb1ebb0ac6d51a463413ba6f93...c069af07b6c9b2462a83cf7f26147e1f0cb12c1e,1,3,3,6,3,2013-03-08 15:33:18,2013-01-09 01:43:51
c069af07b6c9b2462a83cf7f26147e1f0cb12c1e...05eddb24d1a1c4c2ebada12a7beab97a82d7f7d6,23,4328,2804,7132,109,2013-03-08 15:44:00,2012-12-05 00:19:44
05eddb24d1a1c4c2ebada12a7beab97a82d7f7d6...5b3f4cfd7a5b1a1589920d5dfad06b63c884b51e,1,2,0,2,1,2013-03-08 16:18:25,2013-02-28 20:44:45
5b3f4cfd7a5b1a1589920d5dfad06b63c884b51e...e8f63bc48606952e6352a095db479b178c3672e6,1,1,1,2,1,2013-03-08 16:18:25,2013-02-28 20:45:30
e8f63bc48606952e6352a095db479b178c3672e6...13ddc4ee6eb6717808ce3726bd3b59eb55e48b58,7,56,50,106,22,2013-03-08 16:24:43,2013-03-07 19:42:30
13ddc4ee6eb6717808ce3726bd3b59eb55e48b58...3e934ea471f8f82575fcb49f3011b678d06f11aa,1,1,1,2,1,2013-03-08 16:24:43,2013-03-07 21:30:31
3e934ea471f8f82575fcb49f3011b678d06f11aa...bafd5c286f824ddcacc4376af1db35e5e8f11ea1,1,1,0,1,1,2013-03-08 16:24:43,2013-02-28 20:53:17
bafd5c286f824ddcacc4376af1db35e5e8f11ea1...a25c25b030cd2f35db1e0e0e9e32ca9efbc8a5f1,1,1,1,2,1,2013-03-08 16:24:44,2013-02-28 20:54:42
a25c25b030cd2f35db1e0e0e9e32ca9efbc8a5f1...5f34f4471c8982ecc1aa8b1b7c4606f8f079fe4c,1,6,0,6,1,2013-03-08 16:24:44,2013-02-28 21:01:02
5f34f4471c8982ecc1aa8b1b7c4606f8f079fe4c...9e271caab68b239713c08221693e767055284824,1,1,1,2,1,2013-03-08 16:27:07,2013-02-28 21:02:03
9e271caab68b239713c08221693e767055284824...ee31325070b204fe07fe80ad78c9ff06de5fc40e,1,2,1,3,1,2013-03-08 16:27:07,2013-02-28 21:02:55
ee31325070b204fe07fe80ad78c9ff06de5fc40e...51c0ec740e7dc3eb112ae39e7d248e98e1571622,1,19,0,19,1,2013-03-08 18:18:40,2013-02-27 23:27:29
51c0ec740e7dc3eb112ae39e7d248e98e1571622...c156062309f03e4f5392b877af2df06b288b827f,2,32,19,51,10,2013-03-08 18:18:40,2013-02-27 23:31:04
c156062309f03e4f5392b877af2df06b288b827f...9791f3f0e8229acb54d763ae0b5788eb41a34d0d,1,36,0,36,9,2013-03-08 18:52:48,2013-03-08 16:05:41
9791f3f0e8229acb54d763ae0b5788eb41a34d0d...734da7a76163ba177fa5cd8a4cb96a1acdfea828,2,4,4,8,4,2013-03-08 23:16:31,2013-03-08 23:13:45
734da7a76163ba177fa5cd8a4cb96a1acdfea828...d2fbc4ca6fb25d0089712e5e740ee8578c477f6e,16,568,256,824,48,2013-03-09 09:43:59,2013-03-09 00:20:08
d2fbc4ca6fb25d0089712e5e740ee8578c477f6e...c494fd60d822915fbd9559785ef0e3f4ef2abac7,1,4,1,5,1,2013-03-09 19:32:32,2013-03-09 19:18:49
c494fd60d822915fbd9559785ef0e3f4ef2abac7...7b167dd97a463f28acbb3ed700341dcdee88ad90,1,7,0,7,4,2013-03-09 20:53:38,2013-03-09 20:53:38
7b167dd97a463f28acbb3ed700341dcdee88ad90...0982b4085efb7cdd6115ae9c66c13a358390a4aa,17,1308,0,1308,13,2013-03-11 04:29:37,2013-03-11 04:28:33
0982b4085efb7cdd6115ae9c66c13a358390a4aa...3a2a35044db2205cf7f31ceb45436e2dab9f9a6e,1,0,1,1,1,2013-03-11 10:49:43,2013-01-15 21:41:32
ce2d666c04b4a80af58e8bbb3388b0680e8cfeb6...2308e25ae49bc53f4790851918f2da586eaad6a0,1,2,1,3,2,2013-03-22 19:53:17,2013-03-22 19:51:08
2308e25ae49bc53f4790851918f2da586eaad6a0...1560959e9ce11a693be8b4d0d160d633eee75110,4,9,3,12,4,2013-03-22 19:55:25,2013-03-22 19:55:25
ce2d666c04b4a80af58e8bbb3388b0680e8cfeb6...bafb7708c6f34cde5dbe6d954594984056ab5d76,1,3,3,6,1,2013-03-17 23:32:26,2013-03-17 23:32:26
bafb7708c6f34cde5dbe6d954594984056ab5d76...b74d1bb85d6b33d9d5fdbf8bc598419d83a0d918,2,2,2,4,2,2013-03-18 14:29:02,2013-03-18 14:29:02
b74d1bb85d6b33d9d5fdbf8bc598419d83a0d918...1dc86f438b4e21d30f1592636af433d5faf5647b,1,153,16,169,16,2013-03-19 20:40:52,2013-03-14 18:05:02
1dc86f438b4e21d30f1592636af433d5faf5647b...1b8a70243686a7d4bf078bbd0e438f3faa95790b,3,40,3,43,8,2013-03-19 20:40:59,2013-03-14 19:03:03
1b8a70243686a7d4bf078bbd0e438f3faa95790b...656008683a8674542453c932e5f7f9e1583e6015,2,11,1,12,2,2013-03-21 22:01:42,2013-03-21 15:46:45
656008683a8674542453c932e5f7f9e1583e6015...4ffa04351152b7ca2ef4ec502f05392d22eddbe2,3,17,13,30,5,2013-03-21 22:02:02,2013-03-21 20:27:37
4ffa04351152b7ca2ef4ec502f05392d22eddbe2...83012756771a658c34a2b9e3581301d17fd8bb69,1,2,1,3,2,2013-03-22 19:56:28,2013-03-22 19:51:08
83012756771a658c34a2b9e3581301d17fd8bb69...a16001b741db3f333535af45ab2b3c3ac9b0a757,2,2,2,4,2,2013-03-22 19:56:32,2013-03-22 19:56:32
a16001b741db3f333535af45ab2b3c3ac9b0a757...ab32409b04abee6f503313895428c0889000928b,2,98,5,103,2,2013-03-25 21:38:07,2013-03-20 14:56:00
ab32409b04abee6f503313895428c0889000928b...d54170cb2bcabd23bd7f2583dcbe1f48dd16fa60,1,16,4,20,2,2013-03-25 22:00:39,2013-03-25 19:12:36
d54170cb2bcabd23bd7f2583dcbe1f48dd16fa60...182955c65bcd2db6f63e9b9dd0909422772b9e52,3,65,34,99,17,2013-03-27 21:18:39,2013-02-25 19:44:08
182955c65bcd2db6f63e9b9dd0909422772b9e52...7ec1528ae3b136da4ff37b07a0dea57f2795d387,2,18,0,18,3,2013-03-28 22:36:12,2013-03-12 18:39:15
7ec1528ae3b136da4ff37b07a0dea57f2795d387...f9289144fce80aee078213c4553015bf49954d91,1,5,1,6,1,2013-03-28 22:39:34,2013-03-25 20:54:36
f9289144fce80aee078213c4553015bf49954d91...033f58e7d51c6d3740a22e92c311420ff776e312,4,37,9,46,13,2013-03-28 22:41:26,2013-03-25 15:01:40
033f58e7d51c6d3740a22e92c311420ff776e312...27b3840145a51d401457da35d54c69dc31d03c43,1,24,3,27,7,2013-03-28 22:42:05,2013-03-22 17:22:42
27b3840145a51d401457da35d54c69dc31d03c43...fde9ff094deccc27ef0701b8e46d8b3f35db3775,1,15,4,19,5,2013-03-28 23:08:19,2013-03-20 19:49:38
fde9ff094deccc27ef0701b8e46d8b3f35db3775...719d6d82077c24777b9bcf0048b65680bb8955e5,2,9,6,15,4,2013-03-28 23:09:39,2013-03-16 06:27:42
719d6d82077c24777b9bcf0048b65680bb8955e5...6f677a81500cd16e3419b02ce54095bb408905ef,1,5,2,7,2,2013-03-28 23:10:31,2013-03-28 16:41:48
6f677a81500cd16e3419b02ce54095bb408905ef...4f26c3137e67ba98b4160c40d95c053b5905a9fe,1,1,1,2,1,2013-03-28 23:11:06,2013-03-25 14:22:49
4f26c3137e67ba98b4160c40d95c053b5905a9fe...7f45f0fe14b9ffd64b6e75a9fe87d49c66a17b83,1,6,0,6,6,2013-03-28 23:11:38,2013-03-27 14:46:09
7f45f0fe14b9ffd64b6e75a9fe87d49c66a17b83...9412afa6f3a61f173f8a43ed9af5d45164dda818,3,15,0,15,4,2013-03-28 23:35:01,2013-03-18 17:54:36
9412afa6f3a61f173f8a43ed9af5d45164dda818...bca711f26fc6a76220fb420f5fe83cad7384f423,3,15,1,16,4,2013-03-29 14:33:56,2013-03-26 20:54:49
bca711f26fc6a76220fb420f5fe83cad7384f423...6d7ac05ea28a7c0f28eefa03de4305ec48b9ebe2,1,62,0,62,1,2013-03-29 14:34:21,2013-03-27 20:24:51
6d7ac05ea28a7c0f28eefa03de4305ec48b9ebe2...2e87ed15f0875087136404e78fecdbbb4a75e584,1,28,27,55,15,2013-03-29 15:37:48,2013-01-28 17:58:24
2e87ed15f0875087136404e78fecdbbb4a75e584...ffe9de8df384792315c40c65209c1932778b52a8,1,156,55,211,13,2013-03-29 15:37:59,2013-02-15 20:42:08
ffe9de8df384792315c40c65209c1932778b52a8...9ba71622c9cf2af20c72469601aaf0eebd5f6e4c,3,81,60,141,19,2013-03-29 15:38:07,2013-03-28 14:41:57
9ba71622c9cf2af20c72469601aaf0eebd5f6e4c...85fc27444fa888d30cba56b31b6dfec8072a9116,1,8,11,19,5,2013-03-29 18:49:17,2013-03-29 18:14:36
85fc27444fa888d30cba56b31b6dfec8072a9116...198c577fe4dc2d35a829fac99a97f9e9b03e4ffd,2,56,1,57,3,2013-03-29 21:32:42,2013-03-29 21:14:38
198c577fe4dc2d35a829fac99a97f9e9b03e4ffd...3bf409d4e597a0afd48361245e53e38b2e2b6e21,1,0,1,1,1,2013-03-29 22:48:39,2013-03-29 22:40:30
3bf409d4e597a0afd48361245e53e38b2e2b6e21...337b300277bbd104bb0012eecc09cc22bf091d8b,1,0,2,2,2,2013-03-29 23:06:15,2013-03-29 22:39:06
337b300277bbd104bb0012eecc09cc22bf091d8b...e4890bf85c97c5b4d8d1797a77ad0e3cb5bf95f3,1,18,7,25,3,2013-03-29 23:06:30,2013-03-29 22:44:08
e4890bf85c97c5b4d8d1797a77ad0e3cb5bf95f3...f00104e92fc12bf6fc85edbdb30c0d3b6250a954,2,33,7,40,5,2013-03-30 00:23:18,2013-03-30 00:21:39
f00104e92fc12bf6fc85edbdb30c0d3b6250a954...9e05b382ca858f496f0da65ebbbd42216fb95927,1,2,0,2,2,2013-03-30 14:41:53,2013-03-30 14:41:53
9e05b382ca858f496f0da65ebbbd42216fb95927...f1017ee04454faace5997a3604527d3fd6bccda9,2,6,6,12,6,2013-04-01 21:43:56,2013-04-01 19:21:53
f1017ee04454faace5997a3604527d3fd6bccda9...0502e6aadada1ce1bf5187a44c367714e8c142b2,4,385,252,637,18,2013-04-01 23:17:36,2013-03-29 20:00:59
0502e6aadada1ce1bf5187a44c367714e8c142b2...4a472d8df3a07679edfe36339490a50830408843,5,123,21,144,17,2013-04-02 14:25:07,2013-03-31 20:08:37
4a472d8df3a07679edfe36339490a50830408843...3bc93285244eaafe0f5f1d019a8eb74609134239,2,57,3,60,6,2013-04-02 14:25:32,2013-04-01 18:11:19
3bc93285244eaafe0f5f1d019a8eb74609134239...64ccdfa2f6cfdc6a050e305375192ac20e8942a2,1,1,1,2,1,2013-04-02 15:31:49,2013-04-01 20:56:31
64ccdfa2f6cfdc6a050e305375192ac20e8942a2...822840b180533efc07fc5eea660e929edc6f6c9f,1,0,6,6,1,2013-04-02 17:19:03,2013-04-02 17:18:22
822840b180533efc07fc5eea660e929edc6f6c9f...81212176da8a2b0e3791f0644b562eb66c000219,1,6,2,8,2,2013-04-02 17:20:05,2013-04-02 16:06:20
81212176da8a2b0e3791f0644b562eb66c000219...04707f7b39c2a5a4f25df05ceb9cb07cdd7fe092,1,1,1,2,1,2013-04-03 19:15:38,2013-04-03 19:12:43
04707f7b39c2a5a4f25df05ceb9cb07cdd7fe092...9a846d86881cc2a0b3a0ceca14a0248fc3c11e2b,2,8,1,9,2,2013-04-04 01:52:53,2013-04-03 17:59:18
9a846d86881cc2a0b3a0ceca14a0248fc3c11e2b...ee21ceb8d40329db2da65216b634c8f6f05628ab,1,8,8,16,6,2013-04-04 01:55:46,2013-04-03 20:50:46
ee21ceb8d40329db2da65216b634c8f6f05628ab...aefcffa1248b4830699ff84b367246ba1317d748,2,10,181,191,4,2013-04-06 02:21:47,2013-04-03 22:39:05
aefcffa1248b4830699ff84b367246ba1317d748...219986d5caade286de1f40e7ea84ba4f0374d07f,1,8,2,10,1,2013-04-06 02:23:39,2013-04-03 23:23:31
219986d5caade286de1f40e7ea84ba4f0374d07f...1a6239025624c7660b65970d3258f1a242ab4512,2,60,38,98,29,2013-04-06 02:23:47,2013-04-05 20:19:25
1a6239025624c7660b65970d3258f1a242ab4512...a3dae84adeeff7b062c0a969d5122d17b838bd4b,1,10,4,14,6,2013-04-08 23:38:14,2013-04-08 23:32:36
a3dae84adeeff7b062c0a969d5122d17b838bd4b...cde1ad8f45e65afdbe3a90d1d470ede37ead327a,1,1,1,2,1,2013-04-09 13:45:41,2013-04-09 13:44:17
cde1ad8f45e65afdbe3a90d1d470ede37ead327a...9f073b6cae48457c6adb81cf399694da7b6d85e7,1,4,4,8,2,2013-04-09 16:51:20,2013-04-09 16:28:03
9f073b6cae48457c6adb81cf399694da7b6d85e7...6edf4a7f081a4d2dc7c515a29908b79af5e94771,1,10,1,11,2,2013-04-09 16:51:21,2013-04-09 16:49:06
6edf4a7f081a4d2dc7c515a29908b79af5e94771...ab76660a759117bf60d5b54d0b0d257d105fb55b,2,9,6,15,6,2013-04-09 20:02:19,2013-04-09 19:59:22
ab76660a759117bf60d5b54d0b0d257d105fb55b...c6ec08e0217e76678a4f5e22e5aad5e3ba0ac88f,1,1,1,2,1,2013-04-10 19:30:58,2013-04-10 18:20:54
c6ec08e0217e76678a4f5e22e5aad5e3ba0ac88f...72acf70c11962f45cd7093f7df61ade3559d71a1,2,2,2,4,2,2013-04-10 19:37:09,2013-04-10 19:37:09
72acf70c11962f45cd7093f7df61ade3559d71a1...0ec9eca507b9b71e0e69c39207184feaaafb6280,2,2,2,4,2,2013-04-11 13:14:52,2013-04-11 13:14:52
0ec9eca507b9b71e0e69c39207184feaaafb6280...3e52c1a73c08eba7abdcb2c93e08205111976f07,2,2,2,4,2,2013-04-16 19:21:23,2013-04-16 19:21:23
3e52c1a73c08eba7abdcb2c93e08205111976f07...ccaf58fccf8da22af4ddf5d8b37fc0c811ab1e5e,2,2,2,4,2,2013-04-18 14:18:34,2013-04-18 14:18:34
ccaf58fccf8da22af4ddf5d8b37fc0c811ab1e5e...63970873031d29f7eafbe1bd3d441578e7f675d3,1,9,0,9,1,2013-04-18 14:19:59,2013-04-10 19:13:31
63970873031d29f7eafbe1bd3d441578e7f675d3...9d5de58e4fb9129ed630e99e732899411249ac6a,5,64,25,89,20,2013-04-18 14:24:54,2013-04-16 15:37:19
9d5de58e4fb9129ed630e99e732899411249ac6a...757fe510df0ee15901000195520f6c1d67c66052,1,4,2,6,6,2013-04-18 14:55:33,2013-04-17 15:02:23
757fe510df0ee15901000195520f6c1d67c66052...37f20624204b2eaeec6d15aab6bb32e6879fa029,2,13,8,21,5,2013-04-18 15:13:43,2013-04-03 04:33:24
37f20624204b2eaeec6d15aab6bb32e6879fa029...be1e22fea51d58429fd6db167d1fe49090f75424,1,1,1,2,1,2013-04-18 15:13:55,2013-04-03 12:48:39
be1e22fea51d58429fd6db167d1fe49090f75424...036337a5c0757e7a06ea3fc3f98efd467b27b43e,1,1,1,2,1,2013-04-18 15:29:07,2013-04-03 04:32:15
036337a5c0757e7a06ea3fc3f98efd467b27b43e...e01102d1dfdfe64293bd7db38d798da87c48c01a,4,53,36,89,6,2013-04-18 15:46:48,2013-04-01 20:48:11
e01102d1dfdfe64293bd7db38d798da87c48c01a...0239789a5b1ef3057673288cb024e8ec286dbde3,1,3,0,3,1,2013-04-18 16:11:38,2013-04-08 16:44:02
0239789a5b1ef3057673288cb024e8ec286dbde3...52c1e65d6fd86c84a116650ab072899a65585b7f,1,0,40,40,1,2013-04-18 17:55:26,2013-04-18 17:55:26
52c1e65d6fd86c84a116650ab072899a65585b7f...0b48ec01cb707a485cf46e01be05b6c0aa04cd5a,1,1,1,2,1,2013-04-18 21:45:30,2013-04-18 21:42:19
0b48ec01cb707a485cf46e01be05b6c0aa04cd5a...022affc651140b5ad28ff5a48b5e4564e1d97317,2,21,2,23,4,2013-04-18 23:02:42,2013-04-18 12:42:40
022affc651140b5ad28ff5a48b5e4564e1d97317...716d31016dc572a87ffc7748d6d4f5348e1a28d6,1,10,4,14,10,2013-04-18 23:02:58,2013-04-18 18:41:28
716d31016dc572a87ffc7748d6d4f5348e1a28d6...7d75e95bc00dfd396e62b361b44741d106abef36,2,2,2,4,2,2013-04-18 23:15:44,2013-04-18 21:42:16
7d75e95bc00dfd396e62b361b44741d106abef36...139e40b500f89f7dcd96749c52c16dba130a250e,2,2,2,4,2,2013-04-19 14:09:25,2013-04-19 14:09:25
139e40b500f89f7dcd96749c52c16dba130a250e...fe1743177a5ea03e91e0052fb5e2cb2945f6d95f,2,2,2,4,2,2013-04-22 14:48:39,2013-04-22 14:48:39
fe1743177a5ea03e91e0052fb5e2cb2945f6d95f...ddb73290a43fdc09c0e58dc38cdb879e37381ea0,2,2,2,4,2,2013-04-23 12:55:09,2013-04-23 12:55:09
ddb73290a43fdc09c0e58dc38cdb879e37381ea0...dc3b3a8fd707e2a3ff4243f4c6a648b8fa12667c,2,2,10,12,2,2013-04-30 14:53:26,2013-03-18 17:14:06
dc3b3a8fd707e2a3ff4243f4c6a648b8fa12667c...2c1c529f66491e0eb7fb62ac242d1131393b3380,6,31,16,47,14,2013-04-30 15:12:23,2013-04-05 19:28:24
2c1c529f66491e0eb7fb62ac242d1131393b3380...0610711458cd64ad667ac49aceab9140b1932b09,1,100,0,100,1,2013-04-30 15:12:36,2013-04-05 19:25:04
0610711458cd64ad667ac49aceab9140b1932b09...e33f50c94983be97d8dee41f69cc04c65dada6e3,1,1,1,2,1,2013-04-30 15:12:52,2013-04-11 09:08:25
e33f50c94983be97d8dee41f69cc04c65dada6e3...db4d82a844946a0ed1d6fe4dc1ed775ce37190f6,1,1,0,1,1,2013-04-30 15:13:00,2013-04-11 09:10:38
db4d82a844946a0ed1d6fe4dc1ed775ce37190f6...c557a1a66f1e5747769ee3eccbc0fb58e53884d4,1,18,0,18,2,2013-04-30 15:13:13,2013-04-22 17:10:00
c557a1a66f1e5747769ee3eccbc0fb58e53884d4...0ca298d847d1b38b39147d702dcc162da4872d76,1,0,1,1,1,2013-04-30 15:13:23,2013-04-26 14:29:10
0ca298d847d1b38b39147d702dcc162da4872d76...6987dd1dd3f4990cb05212c9c77fd924eca4e8ba,6,124,8,132,8,2013-04-30 15:32:54,2013-04-22 18:48:02
6987dd1dd3f4990cb05212c9c77fd924eca4e8ba...c6a32dc49c05a78ea322ef13ebb90443bbdb44f1,1,1,2,3,2,2013-05-01 14:44:56,2013-04-30 15:58:46
c6a32dc49c05a78ea322ef13ebb90443bbdb44f1...08e4b8cebaa96c023830e5460925f549c13804af,16,630,358,988,47,2013-05-01 17:05:23,2013-03-28 19:22:26
08e4b8cebaa96c023830e5460925f549c13804af...16a08039c41107970e226e6a15e3eb683f4dae20,2,64,13,77,5,2013-05-01 19:33:08,2013-05-01 19:33:08
16a08039c41107970e226e6a15e3eb683f4dae20...98acad100e99e1756e01364e3254887ec2b667ce,1,1,1,2,1,2013-05-02 12:23:57,2013-05-02 12:22:57
98acad100e99e1756e01364e3254887ec2b667ce...84d9196c884edc26f49524c180aa05a6688852b2,1,2,2,4,2,2013-05-06 18:35:48,2013-05-06 18:33:17
84d9196c884edc26f49524c180aa05a6688852b2...779cdd6a8b6cfc70d462a9697672592d553dcdaa,2,14,2,16,3,2013-05-08 19:40:05,2013-04-22 15:35:44
779cdd6a8b6cfc70d462a9697672592d553dcdaa...e3f23c51123fa15613b83cac8baa705b1d2d7742,2,48,2,50,4,2013-05-08 19:40:06,2013-04-29 17:34:43
e3f23c51123fa15613b83cac8baa705b1d2d7742...5e43429c986d88cf160d758891967f2fb4caec2b,1,1,2,3,1,2013-05-08 19:40:06,2013-04-30 19:33:00
5e43429c986d88cf160d758891967f2fb4caec2b...f4ddf51ef4c4712cb3d4e6b5b0a70dc1a12d7ae9,1,1,1,2,2,2013-05-10 17:58:57,2013-05-10 17:00:48
f4ddf51ef4c4712cb3d4e6b5b0a70dc1a12d7ae9...63f4bc287d175ab3414025402c47b00c2f238ac9,1,1,1,2,1,2013-05-13 04:50:55,2013-03-11 12:35:26
63f4bc287d175ab3414025402c47b00c2f238ac9...db625382d09b5eabf928ee0abb3de0851da38e9e,1,23,3,26,1,2013-05-13 04:51:31,2013-03-18 14:13:45
db625382d09b5eabf928ee0abb3de0851da38e9e...d05cbf2871e65052298f2a2291b076322f62a951,2,2,2,4,2,2013-05-13 04:56:09,2013-04-28 16:47:26
d05cbf2871e65052298f2a2291b076322f62a951...47c04a148e801116985394a4afb22c4b492ed0ee,1,1,1,2,1,2013-05-13 04:56:58,2013-05-02 20:41:30
47c04a148e801116985394a4afb22c4b492ed0ee...b5c4e7ac53d57767ce5e88c18d1b76d89fb67808,2,20,3,23,5,2013-05-13 05:19:28,2013-04-25 17:10:00
b5c4e7ac53d57767ce5e88c18d1b76d89fb67808...928e0a6aca7d1f364ac22df3cae5432b56293c1f,2,65,3,68,3,2013-05-13 05:20:24,2013-04-25 19:43:15
928e0a6aca7d1f364ac22df3cae5432b56293c1f...834f226a115f71c7f57d202efc2bf99dcc86509f,1,1,0,1,1,2013-05-13 05:21:38,2013-04-22 17:10:56
834f226a115f71c7f57d202efc2bf99dcc86509f...d6093148fceef8bf50556a2681dc6d2ff77ccb5f,2,28,5,33,6,2013-05-13 05:29:19,2013-05-03 19:44:54
d6093148fceef8bf50556a2681dc6d2ff77ccb5f...bd9e9d04bc0f0d35b19e97421bb7f28fc349443a,5,101,2,103,8,2013-05-13 05:30:30,2013-04-26 15:55:36
bd9e9d04bc0f0d35b19e97421bb7f28fc349443a...4dc1cd907aa84733c3d5f68eb8c4a52beef229a3,1,2,3,5,3,2013-05-13 05:30:42,2013-05-01 13:25:03
4dc1cd907aa84733c3d5f68eb8c4a52beef229a3...e9483034118e5ffd7665889642c3c32e51022ecd,1,3,3,6,3,2013-05-13 05:30:52,2013-05-01 14:37:40
e9483034118e5ffd7665889642c3c32e51022ecd...c9cc631ac964aafd5c951ae61e2eb09920be1d81,1,1,1,2,1,2013-05-13 11:30:17,2013-05-02 18:34:02
c9cc631ac964aafd5c951ae61e2eb09920be1d81...36541662e167d5c8b5be7a6f8cc91b3a2230b251,2,10,8,18,5,2013-05-14 18:56:36,2013-05-14 18:55:58
36541662e167d5c8b5be7a6f8cc91b3a2230b251...8db5640d6c869440fd3ad0377f15c17a1f8ac04e,5,126,2,128,5,2013-05-15 15:16:32,2013-05-15 15:06:32
8db5640d6c869440fd3ad0377f15c17a1f8ac04e...582288be1c56f76a731b891c451808959d0659c2,1,1,1,2,1,2013-05-17 14:13:58,2013-05-14 14:54:54
582288be1c56f76a731b891c451808959d0659c2...c8db9c81f2311ec49ffe50a3cf97d9e50de86a84,1,14,2,16,2,2013-05-17 14:13:58,2013-05-13 15:12:02
c8db9c81f2311ec49ffe50a3cf97d9e50de86a84...cb25ea3bb5d9a20378da9d72077573715b57c1c6,3,36,2,38,5,2013-05-17 14:13:58,2013-05-13 21:25:41
cb25ea3bb5d9a20378da9d72077573715b57c1c6...664284634b36bc7c89a30ec60a5e81063b6013f8,1,1,1,2,1,2013-05-17 14:13:58,2013-05-15 18:34:13
664284634b36bc7c89a30ec60a5e81063b6013f8...cf139b7cb6a3f619fc4577f4f0cd1b773d6e5ec2,1,2,2,4,2,2013-05-17 14:13:58,2013-05-15 20:40:45
cf139b7cb6a3f619fc4577f4f0cd1b773d6e5ec2...c741fd006ce28c59ee7dd4f32c79672a62cc6a82,1,5,1,6,2,2013-05-17 23:24:08,2013-04-08 21:21:33
c741fd006ce28c59ee7dd4f32c79672a62cc6a82...67fc55fbf944341c4662850d2d165e16114f47ea,1,12,14,26,4,2013-05-17 23:24:25,2013-04-25 22:10:16
67fc55fbf944341c4662850d2d165e16114f47ea...7d43e2ded4c1b2e62349263d1e6a800f5f0eee75,1,12,1,13,4,2013-05-17 23:24:32,2013-04-25 22:03:59
7d43e2ded4c1b2e62349263d1e6a800f5f0eee75...0762a6a2fb8fa3d130a089697da863b095f910fd,1,14,2,16,4,2013-05-19 16:04:18,2013-05-14 17:49:03
0762a6a2fb8fa3d130a089697da863b095f910fd...756d0a11816a8796981848b604bf47da4743cf02,1,12,2,14,4,2013-05-19 16:10:09,2013-05-14 17:02:13
756d0a11816a8796981848b604bf47da4743cf02...33e52874dfcfd2257f49bb1b4007664723d7d309,1,13,6,19,3,2013-05-19 16:10:23,2013-05-09 13:57:37
33e52874dfcfd2257f49bb1b4007664723d7d309...4da577ffc1e8cfc19042770a6b9ff7b88aa1ffa2,1,1,1,2,1,2013-05-19 16:10:34,2013-05-14 23:12:52
4da577ffc1e8cfc19042770a6b9ff7b88aa1ffa2...d1d2e9c89fe5f10ba8b56e46bd38b7634bb7afa1,2,21,4,25,4,2013-05-20 14:53:32,2013-04-29 19:22:03
d1d2e9c89fe5f10ba8b56e46bd38b7634bb7afa1...6f73c167a1388b89702bcbf3e9dada449679f614,1,0,1,1,1,2013-05-22 20:39:01,2013-05-22 13:26:43
6f73c167a1388b89702bcbf3e9dada449679f614...80096f6d290ea0e9f065a9fbab6914269ef8d171,1,4,0,4,2,2013-05-22 20:39:10,2013-05-22 18:19:06
80096f6d290ea0e9f065a9fbab6914269ef8d171...c781250a897fe37bd806593c45c3b8dbe424358d,1,2,2,4,1,2013-05-22 20:39:20,2013-05-17 13:30:51
c781250a897fe37bd806593c45c3b8dbe424358d...20528eed9458f5ea5decd8aa7c0a4760a910c66d,1,3,0,3,1,2013-05-22 20:43:46,2013-05-17 14:39:10
20528eed9458f5ea5decd8aa7c0a4760a910c66d...69f84b299776ec2f8b0ae29b95e82f6baf20fa3b,1,5,1,6,1,2013-05-22 20:44:09,2013-05-17 14:30:22
69f84b299776ec2f8b0ae29b95e82f6baf20fa3b...a82ff7c74478a65a5908abc0db08c2d254b4f386,1,1,1,2,1,2013-05-22 20:44:45,2013-05-17 14:14:16
a82ff7c74478a65a5908abc0db08c2d254b4f386...c88286c3695eeadb237a7d82c86d738fe2261843,2,9,9,18,6,2013-05-22 20:49:02,2013-05-10 15:57:27
c88286c3695eeadb237a7d82c86d738fe2261843...e73f081b184431b97f81e98d6eca097a2195f6e8,4,71,104,175,4,2013-05-22 20:50:40,2013-04-05 15:30:08
e73f081b184431b97f81e98d6eca097a2195f6e8...c34d5a987b25ec72b989077769435404ad7d3608,2,11,3,14,3,2013-05-22 21:17:32,2013-05-13 16:30:49
c34d5a987b25ec72b989077769435404ad7d3608...d01732d65dea9295ffe08bbbe748136dcd4178bf,1,3,5,8,3,2013-05-22 21:20:45,2013-05-22 21:08:31
d01732d65dea9295ffe08bbbe748136dcd4178bf...587a48dafc24429fbc4e0c5540edc217fa91f287,1,3,1,4,1,2013-05-23 18:45:33,2013-05-10 20:02:12
587a48dafc24429fbc4e0c5540edc217fa91f287...4d38d2427bdab4b0ca9d5c9fa644d15a34b36b9b,1,4,1,5,2,2013-05-23 18:45:36,2013-05-15 15:26:32
4d38d2427bdab4b0ca9d5c9fa644d15a34b36b9b...338bce1a36af8cb220afb4c20363505ac7fa058d,1,1,1,2,1,2013-05-23 18:57:42,2013-05-10 20:09:18
338bce1a36af8cb220afb4c20363505ac7fa058d...f25c410a9c4a88de36c82797e82e306be2274d40,2,2,2,4,2,2013-05-24 02:43:48,2013-05-24 02:43:48
f25c410a9c4a88de36c82797e82e306be2274d40...e43cbcd9797f4f018fa95bb491439980015dcaae,2,2,2,4,2,2013-05-28 14:57:46,2013-05-28 14:57:46
e43cbcd9797f4f018fa95bb491439980015dcaae...4ec1fb96702c9d4c57b1e06dd34eb73a16e407d2,2,2,2,4,2,2013-06-02 20:58:06,2013-06-02 20:58:06
4ec1fb96702c9d4c57b1e06dd34eb73a16e407d2...5c7363fd0826e08f4cff764230857d150fcd5275,2,2,2,4,2,2013-06-03 22:50:52,2013-06-03 22:50:52
5c7363fd0826e08f4cff764230857d150fcd5275...d88d25240b06a71dd6221750d97c3e5dfa941e62,4,10,7,17,5,2013-06-03 23:18:45,2013-05-30 18:39:57
d88d25240b06a71dd6221750d97c3e5dfa941e62...3ec04acb1a7183b30533678e745a920389ec8d91,1,6,1,7,1,2013-06-04 16:32:53,2013-06-03 23:32:04
3ec04acb1a7183b30533678e745a920389ec8d91...5316bea80670d924ec2d0cc3906d026882b24951,9,284,70,354,33,2013-06-04 20:16:08,2013-06-04 20:13:50
5316bea80670d924ec2d0cc3906d026882b24951...28c04eb6fef5652d12cfbd0dd0bfe5cb0b18e26a,1,1,1,2,1,2013-06-05 13:14:26,2013-06-05 13:14:26
28c04eb6fef5652d12cfbd0dd0bfe5cb0b18e26a...72bc7469940b686ba5ff09f40ee4c368784e828e,1,6,0,6,1,2013-06-05 17:41:19,2013-06-05 17:41:19
72bc7469940b686ba5ff09f40ee4c368784e828e...78ff2db9b03fdf705677707cda7bdbabad3f65bc,1,0,6,6,1,2013-06-05 18:15:33,2013-06-05 18:15:33
78ff2db9b03fdf705677707cda7bdbabad3f65bc...01fa5e94422bdd29810e1aa5e5db54b6ce68fc24,1,1,3,4,1,2013-06-06 14:21:27,2013-06-05 18:48:48
01fa5e94422bdd29810e1aa5e5db54b6ce68fc24...bc08f8a73aeedb1511c699290029e22e9bad1324,1,5,4,9,4,2013-06-06 14:21:27,2013-06-05 18:51:07
bc08f8a73aeedb1511c699290029e22e9bad1324...6975c883e8c431985037ded4a6d78c92f0a7c802,1,1,2,3,2,2013-06-06 14:21:27,2013-06-05 18:57:34
6975c883e8c431985037ded4a6d78c92f0a7c802...288d347dbfcd99f49f75b8d2313aa49429b9119c,3,5,5,10,4,2013-06-07 22:48:18,2013-06-06 14:55:38
288d347dbfcd99f49f75b8d2313aa49429b9119c...9c4382ecb90f1044e3ba0e38991cf5c45281b7ea,1,6,4,10,1,2013-06-07 22:48:18,2013-06-06 16:43:53
9c4382ecb90f1044e3ba0e38991cf5c45281b7ea...264aa37448eaef7f3bf46f0ba6ef5508d272b24c,1,5,6,11,5,2013-06-13 21:31:18,2013-05-23 17:28:15
264aa37448eaef7f3bf46f0ba6ef5508d272b24c...61a75bebf0c05604e6bc6482833fba1ca68f9384,1,6,1,7,2,2013-06-14 19:01:34,2013-06-14 18:58:46
61a75bebf0c05604e6bc6482833fba1ca68f9384...5d5116a94ea779c7c4e694bcd74bc5775e98958a,1,15,0,15,1,2013-06-14 22:46:22,2013-06-13 15:07:34
5d5116a94ea779c7c4e694bcd74bc5775e98958a...daf69857a3b82d7ba6f9362ee01cd8982e5f5e23,1,13,15,28,2,2013-06-18 13:51:00,2013-06-17 18:14:59
daf69857a3b82d7ba6f9362ee01cd8982e5f5e23...efe5ff8332c3c89e4d3bc9f3e180356aacd2d6f7,1,5,2,7,3,2013-06-18 13:51:06,2013-06-17 20:36:22
efe5ff8332c3c89e4d3bc9f3e180356aacd2d6f7...aa2d926ae5a1cd8bc80bc843529bb1a1d7262b24,3,29,0,29,3,2013-06-18 16:23:44,2013-02-28 19:26:42
aa2d926ae5a1cd8bc80bc843529bb1a1d7262b24...10409c353696df0d07151cfc13d7c2baebafe8a6,2,12,0,12,2,2013-06-18 16:40:47,2013-03-12 23:31:42
10409c353696df0d07151cfc13d7c2baebafe8a6...b811b312962130f772cb62a4bd593f09a0ea41b9,2,0,6,6,2,2013-06-18 16:40:47,2013-04-11 23:00:00
b811b312962130f772cb62a4bd593f09a0ea41b9...277b05b6e148292e742aa9896efae7b15b4b4925,1,18,22,40,14,2013-06-18 16:40:47,2013-04-10 17:35:46
277b05b6e148292e742aa9896efae7b15b4b4925...9d9e10d86ae139493b8492434fb98ffb5ace1f1f,2,83,57,140,47,2013-06-18 16:40:47,2013-04-10 22:32:29
9d9e10d86ae139493b8492434fb98ffb5ace1f1f...dfd3df0648f48017b7b90e3f15f422642b51474f,5,96,42,138,38,2013-06-18 16:40:47,2013-04-11 22:20:33
dfd3df0648f48017b7b90e3f15f422642b51474f...3c4ac58bfdb94f811a624062693a368ae55b013e,4,15,8,23,7,2013-06-18 16:40:47,2013-04-30 16:37:06
3c4ac58bfdb94f811a624062693a368ae55b013e...41ce3764cf4fec472f7d0e7655bda7ecd6f7c662,1,3,3,6,3,2013-06-18 16:40:48,2013-05-07 11:23:40
41ce3764cf4fec472f7d0e7655bda7ecd6f7c662...f6801d07821fa460d487f43d6e2ca195d81760ee,2,13,0,13,3,2013-06-18 16:40:48,2013-05-22 21:15:58
f6801d07821fa460d487f43d6e2ca195d81760ee...d3f27364cb97bac645f5c1c2c7d7dae247bfe974,1,1,1,2,1,2013-06-18 16:40:48,2013-04-22 12:20:35
d3f27364cb97bac645f5c1c2c7d7dae247bfe974...7c1b35e0b2cc69c93074c6d1d76879b3ed525f56,7,979,619,1598,195,2013-06-18 16:40:48,2013-06-05 22:23:46
7c1b35e0b2cc69c93074c6d1d76879b3ed525f56...6e1d805e582c62a2755d9f90b9176c3dbe48ef40,1,1,0,1,1,2013-06-19 22:58:41,2013-05-29 13:38:39
6e1d805e582c62a2755d9f90b9176c3dbe48ef40...ff8827be356c9f443dd1cac252f29634a89cd60b,2,7,2,9,3,2013-06-19 22:59:47,2013-05-30 16:21:13
ff8827be356c9f443dd1cac252f29634a89cd60b...310645dc7ba40a0ff3a48a7d3660d01e3e6d5da7,1,10,10,20,5,2013-06-19 23:01:16,2013-06-05 18:29:52
310645dc7ba40a0ff3a48a7d3660d01e3e6d5da7...f91d6f0a74e4410b93d6b30e2352fe589f71a5d7,1,1,0,1,1,2013-06-19 23:01:24,2013-06-06 02:31:45
f91d6f0a74e4410b93d6b30e2352fe589f71a5d7...3b0ac30a7b16bddde3788f35d4e16d1777fdd8a3,4,39,7,46,6,2013-06-19 23:03:13,2013-05-21 21:07:53
3b0ac30a7b16bddde3788f35d4e16d1777fdd8a3...df2274d2a2cac0fe41de61b0a7943ff7977975f7,2,213,200,413,2,2013-06-19 23:04:24,2013-06-07 18:31:00
df2274d2a2cac0fe41de61b0a7943ff7977975f7...6ab83d2992c3432f03951ca96a8d5f078a954664,1,212,212,424,1,2013-06-19 23:04:33,2013-06-07 19:03:28
6ab83d2992c3432f03951ca96a8d5f078a954664...9f975ab30ef2f579ea2bbb2bebeadd7abf1d69d2,1,45,0,45,1,2013-06-19 23:04:43,2013-06-10 10:05:19
9f975ab30ef2f579ea2bbb2bebeadd7abf1d69d2...af0b49cbb0ca6888d6f133081b7d41464bf4135f,4,30,8,38,7,2013-06-19 23:05:27,2013-06-05 14:01:30
af0b49cbb0ca6888d6f133081b7d41464bf4135f...42980b6c626bcf130cc72bc441285fd8bb0f17f3,3,110,44,154,15,2013-06-19 23:41:13,2013-06-12 15:52:56
42980b6c626bcf130cc72bc441285fd8bb0f17f3...b82d99d5b8b2de63f9bfa5928793285526a81986,2,122,39,161,10,2013-06-20 00:20:34,2013-06-03 18:08:58
b82d99d5b8b2de63f9bfa5928793285526a81986...9cd0092e07574b6cff5925ddfa6e68c56a8acd02,1,20,15,35,9,2013-06-20 00:30:02,2013-03-04 23:05:47
9cd0092e07574b6cff5925ddfa6e68c56a8acd02...3bc78e15f15a49df9c6506a41d87f3ee71865a3d,2,34,12,46,10,2013-06-20 00:30:14,2013-06-05 17:55:40
3bc78e15f15a49df9c6506a41d87f3ee71865a3d...5304928a8a5696d35ca0b3a01b68b41ec4fc4f18,1,1,1,2,1,2013-06-20 20:14:25,2013-06-17 13:26:38
5304928a8a5696d35ca0b3a01b68b41ec4fc4f18...073bfa9db6461c27c4d19135ef256c5627b4cdbc,1,1,0,1,1,2013-06-20 20:15:34,2013-06-20 20:03:56
073bfa9db6461c27c4d19135ef256c5627b4cdbc...d2b8eab1cc6f05d6d75df2a7fbd5c81917b588d7,1,5,0,5,1,2013-06-20 22:35:49,2013-06-13 17:31:54
d2b8eab1cc6f05d6d75df2a7fbd5c81917b588d7...23344f8b7506df694f66999693ee3c00dfd6afae,1,13,8,21,3,2013-06-21 14:50:49,2013-06-20 21:10:20
23344f8b7506df694f66999693ee3c00dfd6afae...6ad56b63d33987ed153ba757e9f8169ef670f58e,1,101,0,101,1,2013-06-21 14:50:49,2013-06-20 21:42:05
6ad56b63d33987ed153ba757e9f8169ef670f58e...13b33da1e49973dcb71fa5680f7f4bd8612f1010,2,2,2,4,2,2013-06-21 15:24:43,2013-06-21 15:24:43
13b33da1e49973dcb71fa5680f7f4bd8612f1010...a6462d21ea9487d061eba788333003711793411f,2,2,2,4,2,2013-06-23 14:24:08,2013-06-23 14:24:08
a6462d21ea9487d061eba788333003711793411f...a2ddc68ba7c9cee17bfe69ed840383ec3506602b,2,2,2,4,2,2013-07-02 19:27:08,2013-07-02 19:27:08
a2ddc68ba7c9cee17bfe69ed840383ec3506602b...b814d9f2e022ff0482692b79ed07c07c3e9b1e13,2,2,2,4,2,2013-07-03 17:10:56,2013-07-03 17:10:56
b814d9f2e022ff0482692b79ed07c07c3e9b1e13...bb7c9d3b76cb0006e37667864329bd4a19d4277c,1,20,5,25,5,2013-07-03 19:40:04,2013-06-28 15:30:39
bb7c9d3b76cb0006e37667864329bd4a19d4277c...65c74804583291dff35cc53eb3083b9da037e1d2,1,7,1,8,3,2013-07-05 19:01:08,2013-07-02 21:50:53
65c74804583291dff35cc53eb3083b9da037e1d2...73dac6d52ea5b61c750a8d87121e4e0d7a410d4f,1,1,1,2,1,2013-07-05 19:01:26,2013-07-03 20:29:29
73dac6d52ea5b61c750a8d87121e4e0d7a410d4f...af16dc9ef411146bfa97e1d4bfa6a9c955b6127a,1,3,3,6,1,2013-07-11 19:54:04,2013-07-11 19:26:09
af16dc9ef411146bfa97e1d4bfa6a9c955b6127a...cef462bf0f1bd3d10dacba32d8c9f3a78d008ed1,1,1,0,1,1,2013-07-12 17:29:17,2013-07-11 15:24:24
cef462bf0f1bd3d10dacba32d8c9f3a78d008ed1...d0413be9bb9c809c5e72a0093bcbd2428b9d503a,1,4,4,8,2,2013-07-12 17:31:29,2013-07-01 14:27:17
d0413be9bb9c809c5e72a0093bcbd2428b9d503a...35f6d48c1f3117f2191407dcfb1121da280c59c1,1,5,0,5,1,2013-07-12 17:32:09,2013-07-01 21:08:15
35f6d48c1f3117f2191407dcfb1121da280c59c1...d9a15614c71fbf4ee8ad457330b793b16f2336bc,1,8,7,15,11,2013-07-12 17:34:51,2013-06-28 13:17:42
d9a15614c71fbf4ee8ad457330b793b16f2336bc...22df6cbb2b128955189ad493cd7b67e41633dc3b,1,1,1,2,1,2013-07-12 17:46:24,2013-07-03 21:02:05
22df6cbb2b128955189ad493cd7b67e41633dc3b...cec25e5e779eee081bf2598c19ba1e754a6726c3,1,4,3,7,3,2013-07-15 19:18:52,2013-07-09 11:56:19
cec25e5e779eee081bf2598c19ba1e754a6726c3...df1725c542b2370d90c2d6a3ab336cba1e0f77d8,1,2,1,3,1,2013-07-16 16:36:35,2013-07-16 16:36:35
df1725c542b2370d90c2d6a3ab336cba1e0f77d8...c0116b875ea61f6ead4169119dc52d5ada742869,2,24,0,24,7,2013-07-17 15:10:20,2013-07-17 15:10:20
c0116b875ea61f6ead4169119dc52d5ada742869...5a9cac28f8debfc5cc8ff616e3d3f6c186d8e057,1,4,0,4,1,2013-07-17 16:42:06,2013-04-15 13:21:17
5a9cac28f8debfc5cc8ff616e3d3f6c186d8e057...e1320f91ee711c64f6b00482b23e21fa496f4b5b,4,141,12,153,7,2013-07-17 18:32:55,2013-06-17 23:25:26
e1320f91ee711c64f6b00482b23e21fa496f4b5b...09feca0ac1756cf079e525bbbfa128ff8db60426,1,7,4,11,2,2013-07-17 19:25:41,2013-06-03 16:31:07
09feca0ac1756cf079e525bbbfa128ff8db60426...b1d2d93414998318b12308ffabb55e14369e7558,16,64,0,64,32,2013-07-18 09:45:33,2013-07-18 09:45:33
b1d2d93414998318b12308ffabb55e14369e7558...dec675167778bf7cd7bbcb14fd7713e9738ce174,2,24,0,24,7,2013-07-18 09:55:29,2013-07-18 09:55:29
dec675167778bf7cd7bbcb14fd7713e9738ce174...16fc6424eb4b556e148529dc26fb763dc4eca5b1,1,130,24,154,15,2013-07-18 16:10:25,2013-06-07 19:37:22
16fc6424eb4b556e148529dc26fb763dc4eca5b1...4d4790146b76d8e65caa9fc9c34dc4263e0539a9,9,121,13,134,20,2013-07-18 17:33:07,2013-06-19 23:29:15
4d4790146b76d8e65caa9fc9c34dc4263e0539a9...66f4a37277cc2f309851e525e3392a20295cf737,8,194,64,258,25,2013-07-18 18:29:19,2013-06-20 15:53:23
66f4a37277cc2f309851e525e3392a20295cf737...71082c54a4bb5007445f1a0c19e14aca3567b284,1,42,0,42,3,2013-07-18 18:45:33,2013-06-21 17:34:53
71082c54a4bb5007445f1a0c19e14aca3567b284...990cb4be620ee4bfbc406b36ba3d5793b0563ee7,1,81,1,82,8,2013-07-18 18:54:44,2013-06-21 17:42:41
990cb4be620ee4bfbc406b36ba3d5793b0563ee7...3686654879edaea1c2ddb06f34624d2f76841f87,1,7,0,7,1,2013-07-18 20:07:38,2013-06-28 21:32:29
3686654879edaea1c2ddb06f34624d2f76841f87...636361bf46f2be6f1b883fab59c26170a49b4ac0,2,11,4,15,4,2013-07-18 20:27:35,2013-06-02 22:07:36
636361bf46f2be6f1b883fab59c26170a49b4ac0...cfe110242f4eeee9987fba0a782d8dada0c0290b,1,0,3,3,1,2013-07-18 20:28:55,2013-06-03 08:41:43
cfe110242f4eeee9987fba0a782d8dada0c0290b...2dcd03ab378a92a356225e87c697e891a4393bd3,16,128,0,128,40,2013-07-18 22:05:54,2013-07-18 22:05:54
2dcd03ab378a92a356225e87c697e891a4393bd3...0d74c378de2be46cd572417071e3685965234a5e,1,6,1,7,1,2013-07-19 15:52:30,2013-07-19 14:51:02
0d74c378de2be46cd572417071e3685965234a5e...7ea27bae26b61e16439a36431e71d030842acd2c,1,6,0,6,1,2013-07-22 18:28:01,2013-07-22 18:28:01
7ea27bae26b61e16439a36431e71d030842acd2c...07fd444dd6d3be33223b0324a78570b75c8d3d31,2,73,49,122,6,2013-07-29 14:39:45,2013-07-25 18:22:29
07fd444dd6d3be33223b0324a78570b75c8d3d31...0356d2623bee3b768ddd89e0d083d6c4314a69fe,2,28,2,30,2,2013-07-29 16:06:41,2013-06-10 18:07:21
0356d2623bee3b768ddd89e0d083d6c4314a69fe...551c30f0061d38f3296ea095d4f7a8c160b6b10e,1,5,2,7,1,2013-07-29 16:21:53,2013-05-09 17:29:21
551c30f0061d38f3296ea095d4f7a8c160b6b10e...ec902210eb2a7e9c5e4818f8c39328da493a5df4,2,2,2,4,2,2013-07-29 16:32:23,2013-05-30 09:36:59
ec902210eb2a7e9c5e4818f8c39328da493a5df4...ad46ea3318bd584ac27cca7b90fe6f68948c2530,1,0,6,6,2,2013-07-29 17:31:11,2013-07-27 12:24:37
ad46ea3318bd584ac27cca7b90fe6f68948c2530...031daa05328127af84a0625ab9165a531678fe5d,3,148,17,165,7,2013-07-29 17:48:33,2013-03-10 17:34:11
031daa05328127af84a0625ab9165a531678fe5d...47d1066c0bc4feef089193995b23d5899eb2eee1,1,139,0,139,1,2013-07-29 17:50:02,2013-03-13 13:50:02
47d1066c0bc4feef089193995b23d5899eb2eee1...896ad48104be797f76dd8e65d18ff21a7be34d38,1,1,1,2,1,2013-07-29 18:33:09,2013-05-23 09:23:37
896ad48104be797f76dd8e65d18ff21a7be34d38...a57449ba7630559b5a9f4f090253057d0677b8b1,1,4,1,5,1,2013-07-31 20:47:04,2013-07-31 20:47:04
a57449ba7630559b5a9f4f090253057d0677b8b1...6e87ce7c6fa79e738db42f676e3a92a780da0d6d,1,2,1,3,1,2013-07-31 20:57:04,2013-07-31 16:47:20
6e87ce7c6fa79e738db42f676e3a92a780da0d6d...343e5c12c9cdbac66a2225fd4d49f884971df378,1,1,1,2,1,2013-08-01 23:00:40,2013-05-01 19:32:13
343e5c12c9cdbac66a2225fd4d49f884971df378...e0ae2fd180827aeafe69644f66478459d026b30a,1,0,37,37,1,2013-08-02 00:31:28,2013-06-24 19:03:46
e0ae2fd180827aeafe69644f66478459d026b30a...92fef8d6efdff480aa889b6e0a486d72e18ecaa7,5,105,9,114,7,2013-08-02 00:36:34,2013-06-26 19:13:56
92fef8d6efdff480aa889b6e0a486d72e18ecaa7...9a09884807bd4a3ce1a12188a281a2885df235ef,1,3,1,4,3,2013-08-02 00:38:29,2013-07-12 19:13:31
9a09884807bd4a3ce1a12188a281a2885df235ef...30300a9c025f718ac8ee4c5799e35e67410977a3,1,3,0,3,3,2013-08-02 00:38:39,2013-07-12 22:05:26
30300a9c025f718ac8ee4c5799e35e67410977a3...0156435f4a49b665120ffaeed772fd871094ec93,2,16,0,16,2,2013-08-02 00:39:14,2013-07-24 20:03:07
0156435f4a49b665120ffaeed772fd871094ec93...50dace31f840b8c0261420db9ce53480f36ef83d,1,1,1,2,1,2013-08-02 00:39:26,2013-07-24 20:22:05
50dace31f840b8c0261420db9ce53480f36ef83d...6d738db1f45ec0f7447e2a14e0216af2410074c8,2,22,7,29,8,2013-08-02 00:39:49,2013-07-29 18:38:18
6d738db1f45ec0f7447e2a14e0216af2410074c8...12ecb7dbc765df9544d21bb3823a5fbde0efe0e6,1,12,6,18,3,2013-08-02 00:41:58,2013-07-29 19:51:02
12ecb7dbc765df9544d21bb3823a5fbde0efe0e6...b699950eb4a0b1f82c00b1a074b6d094df60b397,1,1,0,1,1,2013-08-02 00:42:45,2013-07-30 19:03:55
b699950eb4a0b1f82c00b1a074b6d094df60b397...d502de0e89f72e6a912d68dfa34b14354d3210d1,1,1,1,2,1,2013-08-02 01:00:47,2013-08-02 01:00:47
d502de0e89f72e6a912d68dfa34b14354d3210d1...9a7944042ca58ed776a501cd02910bc384ce4a6c,6,147,10,157,12,2013-08-02 01:04:02,2013-07-20 17:59:57
9a7944042ca58ed776a501cd02910bc384ce4a6c...e1656eda9f044dab3207703994d13c5de91e9c71,2,12,5,17,4,2013-08-02 03:43:32,2013-05-22 15:23:37
e1656eda9f044dab3207703994d13c5de91e9c71...2c332a62c92cc668d407164a1374932885dc0dd3,2,13,23,36,12,2013-08-02 03:43:44,2013-06-11 17:51:01
2c332a62c92cc668d407164a1374932885dc0dd3...fa40f42573419fe61abc63195f18d051bc886dbf,1,12,2,14,1,2013-08-02 03:53:56,2013-04-04 20:31:06
fa40f42573419fe61abc63195f18d051bc886dbf...d0f73fae4db80f586c06f390f4c1ac1ecc4d952d,4,16,0,16,8,2013-08-02 11:14:25,2013-08-02 11:14:25
d0f73fae4db80f586c06f390f4c1ac1ecc4d952d...1de7cd5518e2743a5e9e1db7727dccc488be43da,1,6,2,8,5,2013-08-02 14:03:22,2013-08-02 12:00:12
1de7cd5518e2743a5e9e1db7727dccc488be43da...2c0ae78a0e91f90aae488d68af4f9637eb1369dc,3,136,20,156,31,2013-08-02 15:07:32,2013-06-24 18:05:31
2c0ae78a0e91f90aae488d68af4f9637eb1369dc...4439f7ac67ce428de77a51c23d7c99f3fac2b2c6,1,1,1,2,1,2013-08-02 15:07:32,2013-06-25 14:44:14
4439f7ac67ce428de77a51c23d7c99f3fac2b2c6...bae49ad621c67176cc329faba96f246597af98ea,1,4,0,4,1,2013-08-02 15:07:32,2013-03-07 22:38:49
bae49ad621c67176cc329faba96f246597af98ea...80f1630fc9a1603de5835690e49ac5fa0f4509e4,1,34,35,69,8,2013-08-02 15:07:32,2013-06-13 17:39:25
80f1630fc9a1603de5835690e49ac5fa0f4509e4...49109a06220f2497488e6b6f67cd740c44a856dc,1,2,1,3,1,2013-08-02 15:10:51,2013-05-16 22:09:28
49109a06220f2497488e6b6f67cd740c44a856dc...b89e706faca937c07cc578c37c962532fc7b751b,1,61,52,113,16,2013-08-02 15:30:07,2013-06-18 14:29:18
b89e706faca937c07cc578c37c962532fc7b751b...dd0be59518730f3142dccf67daa6f2340590a3ae,1,5,1,6,2,2013-08-02 17:40:31,2013-07-08 20:44:26
dd0be59518730f3142dccf67daa6f2340590a3ae...268d3f6656021733914d5f743ab4bb6eb5db61bd,1,1,1,2,1,2013-08-02 17:47:58,2013-07-09 13:29:31
268d3f6656021733914d5f743ab4bb6eb5db61bd...392b933598668768bf12b1e41ad444aa3548d970,1,1,0,1,1,2013-08-04 21:48:55,2013-08-04 11:54:44
392b933598668768bf12b1e41ad444aa3548d970...3fc69c4aaaedd9c1a90179a4bad9ab7416157c52,1,3,3,6,3,2013-08-05 19:40:09,2013-07-08 20:43:02
3fc69c4aaaedd9c1a90179a4bad9ab7416157c52...75d9c31c5c2c3a0c937a9b3adb7708c301388021,1,0,57,57,1,2013-08-07 19:30:52,2013-08-07 18:04:48
75d9c31c5c2c3a0c937a9b3adb7708c301388021...72009e81f2c622abdc26e39ada424cd5fa666ac9,1,2,0,2,2,2013-08-07 19:30:52,2013-08-07 19:12:04
72009e81f2c622abdc26e39ada424cd5fa666ac9...52d6125af81c913bbbf5b5d610e1b7fa381d6a87,2,2,2,4,2,2013-08-08 16:29:44,2013-08-08 16:19:12
52d6125af81c913bbbf5b5d610e1b7fa381d6a87...b8c0af00dd5e50bbf5c74a8a72dd745a448273f0,1,1,1,2,1,2013-08-08 17:14:38,2013-08-08 17:14:38
b8c0af00dd5e50bbf5c74a8a72dd745a448273f0...7cf37eb6d49bf8d4d19b5e608f47dbfbe50abf72,2,2,2,4,2,2013-08-09 19:26:23,2013-08-09 19:26:23
7cf37eb6d49bf8d4d19b5e608f47dbfbe50abf72...484fc234656308135234cfca7c184f8f8520c497,2,67,3,70,3,2013-08-09 20:32:44,2013-08-09 19:52:05
484fc234656308135234cfca7c184f8f8520c497...4d957329dc47c05a0edfd6b85f8170508aa3321f,1,30,3,33,7,2013-08-09 21:09:17,2013-08-09 19:52:05
4d957329dc47c05a0edfd6b85f8170508aa3321f...5dfa2980fcb1783c8dd005a431644d1e3d676d76,2,2,2,4,2,2013-08-11 01:48:19,2013-08-11 01:48:19
5dfa2980fcb1783c8dd005a431644d1e3d676d76...b756166c991b6be7e99510c979c5cf56e79ccbae,2,2,2,4,2,2013-08-12 21:48:07,2013-08-12 21:48:07
b756166c991b6be7e99510c979c5cf56e79ccbae...b9925db5eac369d77a3a5f5d98a145eaaacd9673,3,3,3,6,3,2013-08-18 18:24:57,2013-08-18 18:24:57
b9925db5eac369d77a3a5f5d98a145eaaacd9673...f7505b61c5c103ef0ee11977110725324b6d5084,2,2,2,4,2,2013-08-20 20:03:58,2013-08-20 20:03:58
f7505b61c5c103ef0ee11977110725324b6d5084...cc9361ee7e40cb087d779eef7e10b2225c7ff8f7,2,28,2,30,3,2013-08-23 20:37:02,2013-08-19 15:51:46
cc9361ee7e40cb087d779eef7e10b2225c7ff8f7...26f638873eadfc3dd8e17bb37eb68a1c613146c3,2,47,0,47,5,2013-08-23 20:37:29,2013-08-19 17:01:25
26f638873eadfc3dd8e17bb37eb68a1c613146c3...5f724c01611a8c12da6b803b2edff97788a756c1,10,238,91,329,39,2013-08-27 16:01:45,2013-08-22 19:11:53
5f724c01611a8c12da6b803b2edff97788a756c1...69a76cca7ea6336eed04c1c5d563a0d381176774,1,5,3,8,2,2013-09-10 22:17:10,2013-09-10 21:25:43
69a76cca7ea6336eed04c1c5d563a0d381176774...9976d1d8e9627010f0741612cbfee1ac6c1562f6,1,2,8,10,1,2013-09-26 17:19:40,2013-09-26 16:58:12
9976d1d8e9627010f0741612cbfee1ac6c1562f6...80adf5e6901e016ff2df21f85b3efa93b701b3b9,1,4,3,7,1,2013-10-02 18:58:07,2013-06-26 22:44:08
80adf5e6901e016ff2df21f85b3efa93b701b3b9...3803f6424a32433401b55126bbe7cad76c56d723,1,2,10,12,3,2013-10-02 18:58:23,2013-07-08 18:22:12
3803f6424a32433401b55126bbe7cad76c56d723...eb13f30cec8e9fcecddc0e91e7db85ba033e1415,2,15,5,20,6,2013-10-02 19:14:26,2013-07-30 15:15:31
eb13f30cec8e9fcecddc0e91e7db85ba033e1415...2711fa56d83006ddf91978f8e749074769cc121a,1,17,3,20,1,2013-10-02 19:15:59,2013-07-30 15:16:44
2711fa56d83006ddf91978f8e749074769cc121a...95342c1fb48e145b7f8a7e46c4fcc79d8bf0f1a0,1,4,3,7,4,2013-10-02 20:05:09,2013-05-31 20:11:22
95342c1fb48e145b7f8a7e46c4fcc79d8bf0f1a0...4a34704bfa393b7a52b64a447a9c735bafe52782,1,1,1,2,1,2013-10-02 20:05:27,2013-07-31 21:32:43
4a34704bfa393b7a52b64a447a9c735bafe52782...8d082558e94bf937de09a1d6be62cc85441c1c5b,4,69,1,70,7,2013-10-02 20:06:55,2013-07-09 15:59:16
8d082558e94bf937de09a1d6be62cc85441c1c5b...7621e8ac60b7b99abb7bb705a133edb36c93e782,2,21,20,41,12,2013-10-02 20:36:52,2013-08-08 14:10:57
7621e8ac60b7b99abb7bb705a133edb36c93e782...6c0b71b3845dddb48a30c9ad63627cf0af8c2356,2,12,1,13,2,2013-10-02 20:37:49,2013-06-24 21:50:03
6c0b71b3845dddb48a30c9ad63627cf0af8c2356...bd4653ca22ddeebd4bcdf074eb234a40843f8f3d,1,1,1,2,1,2013-10-02 20:40:18,2013-08-27 19:54:10
bd4653ca22ddeebd4bcdf074eb234a40843f8f3d...bd96977507f3b45f2fafb3f8b8c3299948e5899c,1,12,4,16,4,2013-10-02 21:44:01,2013-09-05 19:29:42
bd96977507f3b45f2fafb3f8b8c3299948e5899c...33865cba588b666b32b75c42f309b26d21652762,1,9,2,11,1,2013-10-02 23:45:14,2013-10-02 23:45:14
33865cba588b666b32b75c42f309b26d21652762...9c032a641b278715e71129efe100db2b570ceeb0,1,13,8,21,8,2013-10-02 23:47:14,2013-09-05 21:38:19
9c032a641b278715e71129efe100db2b570ceeb0...22252fdaa6ec8744bb191c3d09d84e5e6e3f4058,2,42,1,43,2,2013-10-03 18:44:06,2013-10-02 22:59:37
22252fdaa6ec8744bb191c3d09d84e5e6e3f4058...aab2a11c76e18925eb8956d13fdefc57ca4d4159,1,1,4,5,2,2013-10-03 18:44:06,2013-08-30 19:53:10
aab2a11c76e18925eb8956d13fdefc57ca4d4159...92f7c00614dbc90627cb3a356498df9e7e09b88c,1,2,0,2,1,2013-10-03 18:44:06,2013-10-03 18:42:15
92f7c00614dbc90627cb3a356498df9e7e09b88c...577fe667c612de137251b34f96535e3afc9ad4bb,6,308,116,424,7,2013-10-04 11:52:01,2013-10-04 11:52:01
577fe667c612de137251b34f96535e3afc9ad4bb...c53182403aae0eae655c34b848a61de92fd92566,1,3,1,4,1,2013-10-04 15:58:54,2013-10-03 20:03:17
c53182403aae0eae655c34b848a61de92fd92566...874b42c4a70ab9eea507afbff0dda6d4faa9ebf0,1,1,0,1,1,2013-10-06 22:36:10,2013-10-05 02:00:59
874b42c4a70ab9eea507afbff0dda6d4faa9ebf0...79b6a2e25674d0d98f16d3f6ceb86c58dc1157d8,1,992,0,992,1,2013-10-07 21:39:07,2013-10-07 21:39:07
79b6a2e25674d0d98f16d3f6ceb86c58dc1157d8...caa1f8ec2651b18105bbb4704255d563481a4009,1,12,3,15,4,2013-10-07 21:44:52,2013-07-11 21:46:45
caa1f8ec2651b18105bbb4704255d563481a4009...078285ab6ed605ef4714bae48d7423c35ff96148,2,2,2,4,2,2013-10-08 17:53:24,2013-10-08 17:53:24
078285ab6ed605ef4714bae48d7423c35ff96148...93048bad2117f49ec92fcbc6d6f9b65a179c8d99,2,2,2,4,2,2013-10-09 18:32:57,2013-10-09 18:32:57
93048bad2117f49ec92fcbc6d6f9b65a179c8d99...0161738abf06c1f067b56a465b706efd6f4bf2aa,3,3,3,6,3,2013-10-17 18:37:56,2013-10-17 18:37:56
0161738abf06c1f067b56a465b706efd6f4bf2aa...8997835c05bbd40d4c966484c5a79cadeb328c37,2,2,2,4,2,2013-10-21 01:44:27,2013-10-21 01:44:27
8997835c05bbd40d4c966484c5a79cadeb328c37...99679e88796a86b57ee3567fa4c2e7ec9c6832b0,1,50,45,95,25,2013-10-23 02:50:19,2013-10-23 02:50:19
99679e88796a86b57ee3567fa4c2e7ec9c6832b0...6c2e2de0c32a55b21843e6d3bc1b1a75ac93c27d,1,2,2,4,2,2013-10-23 02:50:33,2013-10-23 02:50:33
6c2e2de0c32a55b21843e6d3bc1b1a75ac93c27d...94a9026ed0729997d8af6a79f56da4862ca1db6e,1,4,0,4,1,2013-10-30 20:54:23,2013-10-30 17:21:37
94a9026ed0729997d8af6a79f56da4862ca1db6e...ed7af1195c8364068118be90eb39996f8440fa47,2,43,1,44,3,2013-10-30 21:14:22,2013-10-30 21:14:22
ed7af1195c8364068118be90eb39996f8440fa47...c87c7360031246f548c9a3d5e8c298a24eee0935,2,2,2,4,2,2013-10-30 22:05:42,2013-10-30 22:05:42
c87c7360031246f548c9a3d5e8c298a24eee0935...a350fc38922fbda2cec8d5dd842237b904eafc14,3,3,3,6,3,2013-10-31 14:15:50,2013-10-31 14:15:50
a350fc38922fbda2cec8d5dd842237b904eafc14...d193e03b72068fa6f11527eed8ea53fdc42198da,2,2,2,4,2,2013-11-01 19:02:33,2013-11-01 19:02:33
d193e03b72068fa6f11527eed8ea53fdc42198da...5779b6e198c0dd22a99e12837faea4b5e8b2664f,1,4,5,9,3,2013-11-06 19:22:37,2013-11-06 19:22:37
5779b6e198c0dd22a99e12837faea4b5e8b2664f...38b3b8f7395d6717efd570a62dc1c2c085d1b049,1,10,1,11,2,2013-11-20 18:37:44,2013-11-18 21:36:30
38b3b8f7395d6717efd570a62dc1c2c085d1b049...45662915c2f4e7e19b8333dc93d0d2526d8a34c5,11,798,48,846,33,2013-12-02 02:29:10,2013-11-22 21:51:20
45662915c2f4e7e19b8333dc93d0d2526d8a34c5...77dc6ecf84ef6020ae195e142780369b05533cdf,1,2,1,3,1,2013-12-02 15:15:00,2013-10-16 15:34:16
77dc6ecf84ef6020ae195e142780369b05533cdf...3d8faaadab8ed44e30e410565868cac44d35b1c3,3,344,2,346,4,2013-12-04 19:10:00,2013-12-04 17:49:48
3d8faaadab8ed44e30e410565868cac44d35b1c3...b113ec11a03ff3037d459928df1d492fad59d8eb,1,2,3,5,2,2013-12-04 19:11:47,2013-12-04 19:11:47
b113ec11a03ff3037d459928df1d492fad59d8eb...9a1b20453b318801c344850879023427c812c047,4,371,204,575,67,2013-12-06 21:59:18,2013-12-06 16:57:14
9a1b20453b318801c344850879023427c812c047...e7f4f01001866bddd5a2d20f9f80e50c037f4fe6,2,67,3,70,4,2013-12-08 18:36:48,2013-12-05 18:51:02
e7f4f01001866bddd5a2d20f9f80e50c037f4fe6...77a74780a02b25a250888077e2b700409e3c50a9,1,2,0,2,1,2013-12-09 16:30:29,2013-12-09 15:57:19
77a74780a02b25a250888077e2b700409e3c50a9...0e883bd5f3c8556847fb831b5c45b5d128c6de7a,1,8,3,11,1,2013-12-17 17:19:25,2013-12-17 16:30:59
0e883bd5f3c8556847fb831b5c45b5d128c6de7a...8bc5cef78b701ee3165b3f97f86f7b97ca49e2b4,1,10,0,10,1,2013-12-20 01:26:20,2013-12-02 21:14:57
8bc5cef78b701ee3165b3f97f86f7b97ca49e2b4...294234af4ec017aed633fe3292d1d3669cbb26a7,2,37,7,44,6,2013-12-20 01:35:55,2013-10-15 17:52:56
294234af4ec017aed633fe3292d1d3669cbb26a7...37f8eaa898b521863547f46560c6ff4e9029656e,1,0,1,1,1,2013-12-20 01:36:50,2013-10-01 18:11:41
37f8eaa898b521863547f46560c6ff4e9029656e...9ceadd4ece53d98762967b27bb897d09d912c1c8,1,3,1,4,1,2013-12-20 01:37:12,2013-09-19 17:14:05
9ceadd4ece53d98762967b27bb897d09d912c1c8...815bb1efe0f5c3f8ae6c5f0eccf6cf96e4936ab8,1,18,23,41,11,2013-12-20 02:16:42,2013-12-20 02:16:42
815bb1efe0f5c3f8ae6c5f0eccf6cf96e4936ab8...dc1e3b1a0c16b08aa887ec60a3031ec05ad8431f,1,2,2,4,1,2013-12-20 02:21:05,2013-12-20 02:21:05
dc1e3b1a0c16b08aa887ec60a3031ec05ad8431f...e5dd557257e21ab8f2f19d2f7c557357f982c7f0,2,7,7,14,7,2013-12-20 14:41:41,2013-12-18 20:09:18
e5dd557257e21ab8f2f19d2f7c557357f982c7f0...bd3553dff93786447130c242c274678f969cd513,2,38,33,71,4,2013-12-21 14:30:26,2013-12-21 14:30:26
bd3553dff93786447130c242c274678f969cd513...a8481e8f75464e5e570d415a00a98b6607d4cf54,1,2,2,4,2,2013-12-21 23:28:41,2013-12-21 23:28:41
a8481e8f75464e5e570d415a00a98b6607d4cf54...859858cc6159b973ee7ea547bb9a149e18ea5c48,2,48,3,51,6,2013-12-22 00:29:46,2013-12-21 22:59:41
859858cc6159b973ee7ea547bb9a149e18ea5c48...0559d8970d41215d00049e3289100d2c566b931c,1,2,2,4,2,2013-12-22 22:12:36,2013-12-22 22:07:39
0559d8970d41215d00049e3289100d2c566b931c...c05e2c52dc6537f618b10aa3767b7a58fe0bc6c4,2,2,2,4,2,2013-12-23 00:21:28,2013-12-23 00:21:28
c05e2c52dc6537f618b10aa3767b7a58fe0bc6c4...3e3734c569b7f45c25411572173e648adf7bf420,2,2,2,4,2,2013-12-23 18:09:41,2013-12-23 18:09:41
3e3734c569b7f45c25411572173e648adf7bf420...52fe0d21959e32a5bdbecdc62057db386e4e029c,2,2,2,4,2,2014-01-08 23:31:24,2014-01-08 23:31:24
52fe0d21959e32a5bdbecdc62057db386e4e029c...74698f5f561d1758fd1ace80b80a4cb3a0699fc1,2,2,2,4,2,2014-01-10 21:24:11,2014-01-10 21:24:11
74698f5f561d1758fd1ace80b80a4cb3a0699fc1...7fa028e8fa7b961d69769172565791b1dd5caec4,1,1,0,1,1,2014-02-03 18:07:41,2014-02-03 18:07:41
7fa028e8fa7b961d69769172565791b1dd5caec4...419bc91c2cdf2e10f3e7a1754ac92a1e6c69d964,1,2,1,3,1,2014-02-04 13:33:05,2014-02-04 13:32:55
419bc91c2cdf2e10f3e7a1754ac92a1e6c69d964...b0971060b10d57588759b56fcaff380c7909f219,1,0,1,1,1,2014-02-04 17:29:54,2014-02-04 17:29:54
b0971060b10d57588759b56fcaff380c7909f219...2f3bd6fc8f3b50bf4802f4477c55660355cff9fe,2,17,12,29,2,2014-02-12 22:28:05,2014-02-12 22:28:05
2f3bd6fc8f3b50bf4802f4477c55660355cff9fe...a003add92d538a4de60d64fa382376177149a0e7,2,12,17,29,2,2014-02-13 14:10:48,2014-02-13 14:10:48
a003add92d538a4de60d64fa382376177149a0e7...7736ee885b28295a60ba39f9f6d7d59beb35b34f,2,127,0,127,3,2014-02-15 19:50:12,2014-02-14 23:09:19
7736ee885b28295a60ba39f9f6d7d59beb35b34f...ae451ca13f2803b315a136a0efebcc123129f069,2,24,9,33,4,2014-03-07 18:20:40,2014-03-06 20:33:46
ae451ca13f2803b315a136a0efebcc123129f069...801d87f5c8d66d5f5a462c5e0daae67e6b848976,1,18,3,21,2,2014-03-09 15:27:35,2014-03-08 20:58:43
801d87f5c8d66d5f5a462c5e0daae67e6b848976...c7436cd7fc8d2e7d891bcba6cd2d897b98b0fbcf,3,33,2,35,7,2014-03-09 15:27:35,2014-01-28 18:14:48
c7436cd7fc8d2e7d891bcba6cd2d897b98b0fbcf...989ed9711ec10194476e65813183d9fae290af88,1,31,23,54,7,2014-03-09 15:27:35,2014-03-08 21:17:48
989ed9711ec10194476e65813183d9fae290af88...fcabc21a3e9336869af2598aaa7ad86012d467cb,1,1,1,2,1,2014-03-09 15:27:35,2014-01-24 17:17:55
fcabc21a3e9336869af2598aaa7ad86012d467cb...73695a99c1c1f19fc795f7a636787364e1f7b30d,3,24,2,26,4,2014-03-09 15:27:35,2013-08-29 21:41:24
73695a99c1c1f19fc795f7a636787364e1f7b30d...a29de43de7fee23456fe44fcd4e00606427d2997,1,1,5,6,1,2014-03-09 15:27:35,2014-01-15 15:24:43
a29de43de7fee23456fe44fcd4e00606427d2997...4c16a61826d96639b0542de0dbbdd9c5eb3fec24,1,2,0,2,2,2014-03-09 15:27:35,2013-11-26 20:53:40
4c16a61826d96639b0542de0dbbdd9c5eb3fec24...2c62563720d16b49abe24cbb799b70e5b00ed169,1,1,1,2,1,2014-03-09 15:27:35,2014-01-07 16:19:46
2c62563720d16b49abe24cbb799b70e5b00ed169...a7d9059a07c1be3043dae0dcfbabfa0e5a908f9e,2,4,0,4,2,2014-03-09 15:27:35,2013-12-31 22:41:09
a7d9059a07c1be3043dae0dcfbabfa0e5a908f9e...ac5d61ca615f5028c32204f69bfd8aca7dbb152b,1,4,9,13,5,2014-03-09 15:27:35,2013-12-16 21:08:29
ac5d61ca615f5028c32204f69bfd8aca7dbb152b...df5a9d90ebe21f23bd710377b32d5e1f523879b4,1,0,1,1,1,2014-03-09 15:27:35,2013-12-19 21:24:50
df5a9d90ebe21f23bd710377b32d5e1f523879b4...67c47db36f9195679382062d52db0151251c6074,1,6,6,12,1,2014-03-09 23:25:03,2014-03-09 23:25:03
67c47db36f9195679382062d52db0151251c6074...435f6118c5c3f2515970c65aab53f59bb54f2982,2,63,7,70,3,2014-03-09 23:28:26,2014-01-07 16:22:05
435f6118c5c3f2515970c65aab53f59bb54f2982...14e868877c82d3b01544187516245631faaf458e,1,1,0,1,1,2014-03-09 23:28:26,2014-02-28 14:35:54
14e868877c82d3b01544187516245631faaf458e...b9fa2dac50c915eda3d8547e99e52ce3e6764bf6,1,4,0,4,2,2014-03-10 18:06:23,2014-03-10 18:06:23
b9fa2dac50c915eda3d8547e99e52ce3e6764bf6...1ceeb84bd0b170bb367e8f78be53d2f075007cb5,2,15,1,16,2,2014-03-11 19:27:50,2014-03-10 15:52:00
1ceeb84bd0b170bb367e8f78be53d2f075007cb5...8dd9cf06d7df65baf16eac7725e837c8303eef07,3,32,18,50,6,2014-03-14 13:32:48,2014-03-13 19:56:45
8dd9cf06d7df65baf16eac7725e837c8303eef07...55a6a0d284e0921a877020592857b3abf6c6cb73,3,32,0,32,6,2014-03-14 13:32:48,2014-03-13 21:19:40
55a6a0d284e0921a877020592857b3abf6c6cb73...fce1d8d0932775d6106e1ca9b17ae7bde15a2c74,1,15,6,21,9,2014-03-14 13:32:48,2014-03-14 13:32:18
fce1d8d0932775d6106e1ca9b17ae7bde15a2c74...317cb98a19baa2e9731c735ee223a746b60bb334,1,1,1,2,1,2014-03-14 14:53:33,2014-03-14 14:53:33
317cb98a19baa2e9731c735ee223a746b60bb334...d4ef06166f8249d9b4f97c621b4a0336f8f1c828,1,20,41,61,17,2014-03-15 19:21:28,2014-02-03 19:49:03
d4ef06166f8249d9b4f97c621b4a0336f8f1c828...c7fc38edc356944df1cafe5a5c68fa8112e03136,1,2,1,3,2,2014-03-17 21:30:06,2014-03-17 20:29:02
c7fc38edc356944df1cafe5a5c68fa8112e03136...1ac617e145b0c3f2238b67e833883a7ad6442fa5,2,4,3,7,4,2014-03-17 21:33:26,2014-03-17 20:40:26
1ac617e145b0c3f2238b67e833883a7ad6442fa5...c991426e46e416dfad3e433995a1bd2725e9b09c,1,13,2,15,4,2014-03-17 22:56:57,2014-03-17 15:53:07
c991426e46e416dfad3e433995a1bd2725e9b09c...be2d871df615e8322c5cb377426721e171830ed4,1,2,13,15,4,2014-03-18 00:15:56,2014-03-18 00:15:56
be2d871df615e8322c5cb377426721e171830ed4...b8ca63ffd23f136aff20aec29f540191d16e05cf,1,1,1,2,1,2014-03-18 12:56:00,2014-03-18 12:53:11
b8ca63ffd23f136aff20aec29f540191d16e05cf...4469ab13e286aee83c2ff84dc92af7b424a9c2df,1,2,2,4,1,2014-03-19 14:01:29,2014-03-19 13:58:57
4469ab13e286aee83c2ff84dc92af7b424a9c2df...967120643015068ca8f60cde4bfbc2984da7bef1,1,1,1,2,1,2014-03-19 19:31:11,2014-03-19 19:28:17
967120643015068ca8f60cde4bfbc2984da7bef1...d949d2f1c378a8230a2c24da4f1c431cca78a80c,2,36,11,47,4,2014-03-20 18:48:42,2014-03-13 15:26:10
d949d2f1c378a8230a2c24da4f1c431cca78a80c...b2c3b08b75892f25ca662d787b061070473d9ba5,1,0,16,16,1,2014-03-20 16:24:05,2013-07-12 19:14:30
b2c3b08b75892f25ca662d787b061070473d9ba5...67aadff82dc47bcfcba06aebc3b5a61eebf97658,1,21,14,35,12,2014-03-21 10:17:18,2014-02-03 16:48:16
67aadff82dc47bcfcba06aebc3b5a61eebf97658...7e8aaa3a488c8b23f05147464a107db66f76eab2,1,1,1,2,1,2014-03-24 20:58:59,2014-03-24 17:56:00
7e8aaa3a488c8b23f05147464a107db66f76eab2...0080fdc3fea4be834b14eb65d8a334b1d83a00ab,1,1,1,2,1,2014-03-24 23:04:25,2014-03-24 19:38:04
0080fdc3fea4be834b14eb65d8a334b1d83a00ab...6c3b95564423914c33c3aba7a951a1ba5d4953aa,2,2,2,4,2,2014-03-25 22:07:08,2014-03-25 22:07:08
6c3b95564423914c33c3aba7a951a1ba5d4953aa...e8d714a7471249cc66d695a352f1012aa7871ff3,2,2,2,4,2,2014-03-26 22:09:33,2014-03-26 22:09:33
e8d714a7471249cc66d695a352f1012aa7871ff3...0e1908763a942f33ff90ce30f0b7a5e90a8d947d,2,20,9,29,6,2014-03-27 17:51:35,2014-03-27 15:42:33
0e1908763a942f33ff90ce30f0b7a5e90a8d947d...e3d78955d181e475345ebd60053a4738a4c5268a,2,2,2,4,2,2014-04-02 12:23:31,2014-04-02 12:23:31
e3d78955d181e475345ebd60053a4738a4c5268a...d218cd5a78936e46f945e7976bc26d25630a7792,2,2,2,4,2,2014-04-04 19:38:34,2014-04-04 19:38:34
d218cd5a78936e46f945e7976bc26d25630a7792...899d16e9c6ff8388db6c9c42bbaa97f330fa5bfc,1,5,1,6,2,2014-05-08 19:43:08,2014-04-29 21:34:05
899d16e9c6ff8388db6c9c42bbaa97f330fa5bfc...4ad6d96e91f4a1d5a22ae64547a9129daf807285,1,3,0,3,1,2014-07-16 21:25:32,2014-07-16 21:25:32
4ad6d96e91f4a1d5a22ae64547a9129daf807285...1fbb52159eb9748627ffd2ae16785ad807d3ebb1,1,4,4,8,2,2014-07-22 20:30:21,2014-06-13 22:18:20
1fbb52159eb9748627ffd2ae16785ad807d3ebb1...3e570fc232d1e678324b80e803dabba2e41da9a0,5,224,5,229,14,2014-08-07 21:39:57,2014-08-07 21:39:57
3e570fc232d1e678324b80e803dabba2e41da9a0...aaa8a1d71e00bde3f9783dfaf0070c214e8ad1a1,1,2,2,4,1,2014-08-07 22:14:25,2013-04-05 03:30:09
aaa8a1d71e00bde3f9783dfaf0070c214e8ad1a1...98eb2f1dd5e9577db16f2f109b0d8b5b9d56552c,2,48,11,59,4,2014-08-11 16:47:18,2014-08-11 16:43:57
98eb2f1dd5e9577db16f2f109b0d8b5b9d56552c...89d34fd3eb9b21dab1243363e14f5f5ef6a430ff,1,1,0,1,1,2014-08-12 15:45:57,2014-08-12 15:43:50
89d34fd3eb9b21dab1243363e14f5f5ef6a430ff...91e1ec144205e140272b2ed9560accf634c4e93b,1,15,2,17,3,2014-08-12 17:23:31,2014-08-12 12:44:03
91e1ec144205e140272b2ed9560accf634c4e93b...bd14042812b9bab796a83672f95b2d0e2e6b4252,1,10,9,19,7,2014-08-13 23:23:55,2014-08-13 23:23:51
bd14042812b9bab796a83672f95b2d0e2e6b4252...9105b69e1ded5b7d0d384d574103b0ee6bbb6122,11,401,150,551,48,2014-08-14 20:28:12,2014-08-11 22:48:46
9105b69e1ded5b7d0d384d574103b0ee6bbb6122...cefb0ef38f050b73b2bf8211add55f3749753e0a,1,0,11,11,1,2014-08-14 21:33:12,2014-08-14 21:33:12
cefb0ef38f050b73b2bf8211add55f3749753e0a...5b84ff5201607e19f4276675f9930c571c906914,4,5,5,10,5,2014-08-15 15:45:22,2014-08-15 15:45:22
5b84ff5201607e19f4276675f9930c571c906914...953cd5f652f1f73313ba6160a0f489184e1fffaf,4,4,4,8,4,2014-08-18 20:00:20,2014-08-18 20:00:20
953cd5f652f1f73313ba6160a0f489184e1fffaf...50c95dfc9d9ab165cd5ab08707bfa0d6b191decd,1,5,1,6,1,2014-08-20 17:56:58,2014-04-17 20:05:55
50c95dfc9d9ab165cd5ab08707bfa0d6b191decd...7305c859899654cb134e61c3bc47e918c56e395e,1,1,5,6,1,2014-08-21 21:55:17,2014-08-21 21:55:17
7305c859899654cb134e61c3bc47e918c56e395e...fa13d1ee8da0f112f588570b4070f73d7af2f7fd,4,4,4,8,4,2014-08-21 21:56:32,2014-08-21 21:56:32
fa13d1ee8da0f112f588570b4070f73d7af2f7fd...5806dba8e1c2d2daf364ddc9f04d53fceaeb6022,4,4,4,8,4,2014-08-22 15:05:43,2014-08-22 15:05:43
5806dba8e1c2d2daf364ddc9f04d53fceaeb6022...c344f31ae584773c043abe3c718b4f7a151e4e28,1,24,24,48,12,2014-08-22 17:50:22,2014-08-19 19:03:55
c344f31ae584773c043abe3c718b4f7a151e4e28...d5a8cfd7bddcc0c4bc63bc637dc744bcbf0bfb8a,2,3,3,6,2,2014-09-08 18:09:24,2014-08-27 19:00:43
d5a8cfd7bddcc0c4bc63bc637dc744bcbf0bfb8a...59dc05c0b60be7097723020dd59c370f06041c1d,1,1,6,7,1,2014-09-08 18:09:41,2014-08-29 17:18:36
59dc05c0b60be7097723020dd59c370f06041c1d...66bfc5b6fbb64e03cfb80c1c830ac88b1d3ec5ba,1,19,0,19,3,2014-09-25 22:16:07,2014-09-25 22:16:07
66bfc5b6fbb64e03cfb80c1c830ac88b1d3ec5ba...e4a5649bb5bed607e0e907ce6f2d08e607dcde12,2,28,4,32,5,2014-09-29 15:07:12,2014-09-29 15:07:12
e4a5649bb5bed607e0e907ce6f2d08e607dcde12...e96f29859aa6bf9baa5e599f9b6d2f611fe031bd,7,139,138,277,16,2014-10-06 16:06:53,2014-09-16 22:29:29
e96f29859aa6bf9baa5e599f9b6d2f611fe031bd...c62f9b697a0053155363621e2866dd121b5f66f2,1,5,1,6,1,2014-10-06 22:28:47,2014-04-17 20:05:55
c62f9b697a0053155363621e2866dd121b5f66f2...a2f5d8bd3c2a8886b2fdea42d78dd62168adbe05,4,4,4,8,4,2014-10-07 16:05:41,2014-10-07 16:05:41
a2f5d8bd3c2a8886b2fdea42d78dd62168adbe05...ce8b30585954857905b84377a55620ff0b5a9049,4,4,4,8,4,2014-10-08 13:26:38,2014-10-08 13:26:38
ce8b30585954857905b84377a55620ff0b5a9049...09917767b116f4ff1c0eadda1e8bc5db30828500,4,4,4,8,4,2014-10-14 20:40:29,2014-10-14 20:40:29
09917767b116f4ff1c0eadda1e8bc5db30828500...6c0fccd4601b65c7c808608a60cbfb182f0b7215,4,4,4,8,4,2014-10-16 17:43:04,2014-10-16 17:43:04
6c0fccd4601b65c7c808608a60cbfb182f0b7215...8b9242837510e6410ddcf4f19969da4c7b01b2f7,1,3,1,4,1,2014-10-28 02:45:56,2014-10-28 02:45:56
8b9242837510e6410ddcf4f19969da4c7b01b2f7...656f78711632a5dc37221422c99e3c4619bcc58f,1,1,1,2,1,2014-10-28 03:49:33,2014-10-28 03:49:33
656f78711632a5dc37221422c99e3c4619bcc58f...3a7e85ea1f672f702660e5472566234b1d19038e,2,19,0,19,2,2015-02-17 18:39:51,2015-02-12 03:12:37
3a7e85ea1f672f702660e5472566234b1d19038e...04c33a8e1f97542f92c34432a2871fa7e359a342,1,3,0,3,2,2015-02-17 18:42:19,2015-02-13 16:49:49
04c33a8e1f97542f92c34432a2871fa7e359a342...821ee5672b55cf8720e0901c8efd7837226f4945,4,4,4,8,4,2015-02-18 21:43:18,2015-02-18 21:43:18
821ee5672b55cf8720e0901c8efd7837226f4945...4f77548efb7a60a0ad6454c7292d339cc7f597c6,4,4,4,8,4,2015-02-19 23:09:20,2015-02-19 23:09:20
4f77548efb7a60a0ad6454c7292d339cc7f597c6...de9d77996aab9315400b9f203d0c4826211fc32e,4,4,4,8,4,2015-02-24 20:26:56,2015-02-24 20:26:56
de9d77996aab9315400b9f203d0c4826211fc32e...dd44995239296a2d5f8ec4c3aa7cd46a2df77318,4,4,4,8,4,2015-02-25 20:56:17,2015-02-25 20:56:17
dd44995239296a2d5f8ec4c3aa7cd46a2df77318...32dbdb01ca606df9b639a9569d0be9c226b95cd6,141,124610,0,124610,141,2015-03-05 21:15:27,2015-02-19 16:43:25
32dbdb01ca606df9b639a9569d0be9c226b95cd6...e8a768d0f47d92d56308ea45c4e5dd98f89b4c07,1,5,2,7,1,2015-03-05 21:15:28,2015-02-19 23:14:52
e8a768d0f47d92d56308ea45c4e5dd98f89b4c07...88f8524ed4d346e68162bcc88d720e3c1600012d,5,825,1,826,6,2015-03-05 21:15:28,2015-02-20 15:56:24
88f8524ed4d346e68162bcc88d720e3c1600012d...7805c5042c81d2b8aec94a6c8b90fd912e4017fa,1,7,7,14,7,2015-03-05 21:15:28,2015-03-05 05:27:27
7805c5042c81d2b8aec94a6c8b90fd912e4017fa...22251f7783f3fcef07f6745da19d3e1a4f792391,2,4,4,8,4,2015-03-05 21:15:28,2015-03-05 15:33:01
3a2a35044db2205cf7f31ceb45436e2dab9f9a6e...e22bdb0b330d5d236c2fa8fb89a98b8f908ccf61,9,1268,1248,2516,19,2013-03-11 15:15:02,2013-02-24 22:30:41
e22bdb0b330d5d236c2fa8fb89a98b8f908ccf61...c068d465b7f1948a0af3290d1898853d0dec0725,8,322,266,588,9,2013-03-11 15:15:02,2013-02-26 12:58:26
c068d465b7f1948a0af3290d1898853d0dec0725...a900b38a67c5604ab57613a434310017e9412776,3,138,109,247,3,2013-03-11 15:15:02,2013-02-26 13:11:23
a900b38a67c5604ab57613a434310017e9412776...753dc84327d166c2973d268d5c6f05fef64195bb,4,78,80,158,5,2013-03-11 15:15:02,2013-02-26 13:21:17
753dc84327d166c2973d268d5c6f05fef64195bb...c77acec063b7319a2e2bb4d304cb3d5abb563c29,6,128,72,200,6,2013-03-11 15:15:02,2013-02-27 01:01:12
c77acec063b7319a2e2bb4d304cb3d5abb563c29...cac2effa776649208b8428f6c8c9692d45148fd2,3,78,27,105,2,2013-03-11 15:15:02,2013-02-27 12:24:29
cac2effa776649208b8428f6c8c9692d45148fd2...a8c05c5fd10f1aa9a57b7edbe0589d4a0b17f5b0,14,30,77,107,25,2013-03-11 15:15:02,2013-02-27 12:25:51
a8c05c5fd10f1aa9a57b7edbe0589d4a0b17f5b0...509d8b0f040c7d1400ea45ec4ad79061e2a2a09e,10,225,192,417,14,2013-03-11 15:15:03,2013-02-27 13:04:16
509d8b0f040c7d1400ea45ec4ad79061e2a2a09e...bad416255d0b952c5b59195c1acc6fecd566f5c9,14,246,177,423,17,2013-03-11 15:15:03,2013-03-07 23:02:57
bad416255d0b952c5b59195c1acc6fecd566f5c9...90a3bb93ef918a876592239409d311f41954a348,6,78,25,103,6,2013-03-11 15:15:03,2013-03-08 13:20:13
90a3bb93ef918a876592239409d311f41954a348...2544cc8a30c14218344402b5cc9d0ffa05c99888,28,178,217,395,42,2013-03-11 15:15:03,2013-03-08 14:05:10
2544cc8a30c14218344402b5cc9d0ffa05c99888...5701b8515443a52806aa1f7fd0b174d417b0e1a3,1,1,0,1,1,2013-03-11 15:32:39,2013-03-11 15:32:39
5701b8515443a52806aa1f7fd0b174d417b0e1a3...4fd64f6e32ccdb5c75f2478753012b1ff2f566a9,12,336,84,420,64,2013-03-11 17:08:39,2013-03-11 17:08:39
4fd64f6e32ccdb5c75f2478753012b1ff2f566a9...d36db8ac30a56d39f4af58e573ee417450798c96,1,1,1,2,1,2013-03-11 17:18:08,2013-03-11 12:35:26
d36db8ac30a56d39f4af58e573ee417450798c96...3e77e29635c719fecec008c15542fee68d50a4ce,2,95,0,95,3,2013-03-11 17:40:23,2013-03-04 15:08:41
3e77e29635c719fecec008c15542fee68d50a4ce...3f40b3aabc51462b66855863401dbdbbaf5fb7aa,2,41,43,84,2,2013-03-11 17:40:23,2013-03-04 15:10:19
3f40b3aabc51462b66855863401dbdbbaf5fb7aa...d1049f2f1940b89fc01f9eb0e1fa2fe85ce08080,1,12,13,25,4,2013-03-11 17:40:23,2013-03-04 15:08:59
d1049f2f1940b89fc01f9eb0e1fa2fe85ce08080...c45d541d39086c0d1e4d60ca2b476c25a06841c3,3,29,0,29,3,2013-03-11 17:40:49,2013-02-28 19:26:42
c45d541d39086c0d1e4d60ca2b476c25a06841c3...2b930683ec32565874e0d7fccdf618f97a4096e6,2,9,8,17,8,2013-03-11 18:15:09,2013-03-11 18:14:36
2b930683ec32565874e0d7fccdf618f97a4096e6...9f5ab59f81a1c61b78fda2037302999bbd7dda0c,1,20,15,35,9,2013-03-11 18:20:01,2013-03-04 23:05:47
9f5ab59f81a1c61b78fda2037302999bbd7dda0c...c40533e151407c0cc48cc0d514ec6fa2d600d374,3,148,17,165,7,2013-03-11 18:41:44,2013-03-10 17:34:11
3a2a35044db2205cf7f31ceb45436e2dab9f9a6e...b80590079e2984a797679bc62f29802314be7c38,1,2,0,2,1,2013-03-11 15:13:52,2013-03-11 14:24:55
3a2a35044db2205cf7f31ceb45436e2dab9f9a6e...23b5998222ec073e0581dcdbe09cacc2d53cac7d,1,1,1,2,1,2013-03-11 14:52:00,2013-03-11 14:52:00
127f3a575c7c65cfa9a56bbf90d3726a764f4875...9e820f0b16d4d2334eddab5c00e76798951da400,1,28,27,55,15,2013-03-11 21:00:52,2013-01-28 17:58:24
9e820f0b16d4d2334eddab5c00e76798951da400...211191443212b35e71a41ea4a5c669f4de3c5a2e,1,156,55,211,13,2013-03-11 21:00:52,2013-02-15 20:42:08
211191443212b35e71a41ea4a5c669f4de3c5a2e...b62d9b141418529f094dbd7cbd5b258179224e93,1,188,0,188,1,2013-03-11 21:00:52,2013-03-01 01:13:23
b62d9b141418529f094dbd7cbd5b258179224e93...e1531fe32b91149cb43bd36caa146843794768e1,1,11,0,11,1,2013-03-11 21:00:52,2013-02-28 18:56:06
e1531fe32b91149cb43bd36caa146843794768e1...68f7f56506b166f3c0dd70aa1754284af97bb017,1,66,0,66,1,2013-03-11 21:00:52,2013-03-04 21:13:55
68f7f56506b166f3c0dd70aa1754284af97bb017...f74df614474b545732e285836c4caa2be92507c2,1,6,5,11,5,2013-03-11 22:45:44,2013-03-11 22:08:05
f74df614474b545732e285836c4caa2be92507c2...78da859fa541a4c580aa958cf1a67ba61db82dcf,1,3,3,6,1,2013-03-11 23:21:55,2013-03-11 23:21:55
78da859fa541a4c580aa958cf1a67ba61db82dcf...ceccc68851a118f67a48acd832b1300350951137,1,0,1,1,1,2013-03-12 14:33:28,2013-03-12 14:33:17
ceccc68851a118f67a48acd832b1300350951137...34f01531077d1843c1277303a5ce94dcb8bdba63,1,3,0,3,1,2013-03-12 14:36:21,2013-03-12 14:29:09
34f01531077d1843c1277303a5ce94dcb8bdba63...d4193ba12b50954ede6bab1594696769893dfb13,2,13,1,14,3,2013-03-12 14:36:22,2013-03-12 14:30:21
d4193ba12b50954ede6bab1594696769893dfb13...7e37b626030be45057f1d3abbeac890d3249f3b0,2,19,0,19,2,2013-03-12 14:39:36,2013-03-12 14:39:27
7e37b626030be45057f1d3abbeac890d3249f3b0...2bc9d4ee47db6b39a7509e080b5b457563272db5,1,1,1,2,1,2013-03-12 14:47:33,2013-03-12 14:47:08
2bc9d4ee47db6b39a7509e080b5b457563272db5...9565164d45d62d3d8aad59527ad8fbcbc1feb25d,2,0,0,0,0,2013-03-12 15:23:17,2013-03-12 15:23:17
9565164d45d62d3d8aad59527ad8fbcbc1feb25d...962ccb59819aecc6fe9ebf8a2ea3df37ba3ac0c7,1,2,2,4,2,2013-03-12 16:30:48,2013-02-23 19:05:10
962ccb59819aecc6fe9ebf8a2ea3df37ba3ac0c7...18d57191b1133d17239a78f41b9e3899526b5456,16,2,41,43,33,2013-03-12 16:33:30,2013-02-26 20:38:31
18d57191b1133d17239a78f41b9e3899526b5456...fea451a3eb1d00b680d7b4808ea5a3a7b9574190,1,2,1,3,1,2013-03-12 17:51:38,2013-03-12 17:51:38
fea451a3eb1d00b680d7b4808ea5a3a7b9574190...8f1376eb01cbcf6435ed2b69f30ae662a64757a2,3,57,7,64,12,2013-03-12 18:05:29,2013-03-12 14:32:33
8f1376eb01cbcf6435ed2b69f30ae662a64757a2...56e754ab2121fb0a8055425875281dc0b2c67bdf,2,205,0,205,2,2013-03-12 18:07:06,2013-01-09 17:35:50
56e754ab2121fb0a8055425875281dc0b2c67bdf...29bc5063bd232aa1664511d4486936d1f13e60b6,2,37,1,38,3,2013-03-12 19:07:54,2013-03-12 17:19:31
29bc5063bd232aa1664511d4486936d1f13e60b6...424b9067da68ff2a2451675d2e6e76111c8d7149,1,2,2,4,2,2013-03-12 20:27:07,2013-01-08 00:10:50
424b9067da68ff2a2451675d2e6e76111c8d7149...b42818dc36df9e6357fbb42266e48e1e760d8358,1,8,5,13,4,2013-03-12 20:48:28,2013-03-12 20:43:28
b42818dc36df9e6357fbb42266e48e1e760d8358...2e7a26d69bfbb18e7a829267814a2bb3e2f15fed,1,4,7,11,1,2013-03-12 21:02:16,2013-03-01 20:56:08
2e7a26d69bfbb18e7a829267814a2bb3e2f15fed...0f1e69e5d850192f61021d6404792efb892ba11a,1,35,10,45,11,2013-03-13 01:37:31,2013-03-12 23:05:07
0f1e69e5d850192f61021d6404792efb892ba11a...c8f2add36716a6579b8ca9ed7bf25714aba7a3c5,3,28,3,31,5,2013-03-13 01:37:45,2013-03-12 23:31:42
c8f2add36716a6579b8ca9ed7bf25714aba7a3c5...6309c19d489c97f54570436b89469432c60953ab,1,139,0,139,1,2013-03-13 13:50:02,2013-03-13 13:50:02
6309c19d489c97f54570436b89469432c60953ab...f5352a787b042ba663dd5cc9976088f719f5651f,3,53,19,72,12,2013-03-13 14:21:56,2013-03-13 14:21:56
f5352a787b042ba663dd5cc9976088f719f5651f...ea0e9f0ae192b23c6855afa18a8868c4dfb3d64c,2,39,2,41,3,2013-03-13 14:52:08,2013-03-12 19:26:21
ea0e9f0ae192b23c6855afa18a8868c4dfb3d64c...1039ebd0cb0fec11a60260a2257bd2e74604fbf6,1,25,20,45,7,2013-03-13 18:18:31,2013-03-13 18:04:57
1039ebd0cb0fec11a60260a2257bd2e74604fbf6...fd5c1b3925f09937855e8a19130853281acecabb,1,2,2,4,2,2013-03-13 18:54:58,2013-03-13 16:52:49
fd5c1b3925f09937855e8a19130853281acecabb...c5e0cd08b4f1c90bd80920bc5ab298d7a22eceee,2,18,0,18,3,2013-03-13 20:08:49,2013-03-12 18:39:15
c5e0cd08b4f1c90bd80920bc5ab298d7a22eceee...7e33eb759679ca0693caaec8c1b12cd394a7285b,7,29,30,59,23,2013-03-13 20:08:49,2013-03-13 20:02:27
7e33eb759679ca0693caaec8c1b12cd394a7285b...5ce51596e587523136473c7bf7bbc10d23f135e3,1,1,1,2,1,2013-03-13 22:02:33,2013-03-13 22:02:33
5ce51596e587523136473c7bf7bbc10d23f135e3...1ae603134a992931ef85511e23d8aafffe6deda3,37,508,854,1362,341,2013-03-13 22:06:55,2013-03-12 19:13:36
1ae603134a992931ef85511e23d8aafffe6deda3...093672f84e259b29d4a3f6d6f6aa6574f16ee783,3,8,8,16,6,2013-03-13 22:06:55,2013-03-12 20:49:51
093672f84e259b29d4a3f6d6f6aa6574f16ee783...275535c2f8d17f51edb1dfb3503c69686e7f2776,15,44,26,70,26,2013-03-13 22:49:32,2013-03-13 21:30:01
275535c2f8d17f51edb1dfb3503c69686e7f2776...c8008c1bfc7ae2866813147ad689b2508b2aeb3e,16,0,32,32,16,2013-03-14 09:27:43,2013-03-14 09:27:43
c8008c1bfc7ae2866813147ad689b2508b2aeb3e...bc47e8418dc702a242dcc3b180ecfec69ac6556b,30,123,102,225,65,2013-03-14 12:33:16,2013-03-13 11:58:07
bc47e8418dc702a242dcc3b180ecfec69ac6556b...ae4652122c38bb6a2b7081f60c71b6b645092c9c,10,54,52,106,18,2013-03-14 12:33:16,2013-03-13 12:10:58
ae4652122c38bb6a2b7081f60c71b6b645092c9c...218d40c3085b69149420d87aec5c862d6b418834,1,0,1,1,1,2013-03-14 12:33:16,2013-03-13 18:42:06
218d40c3085b69149420d87aec5c862d6b418834...0a448e6e4e573121eec1a71fc89e8fc47b19d832,12,64,56,120,50,2013-03-14 14:04:10,2013-03-14 14:04:10
0a448e6e4e573121eec1a71fc89e8fc47b19d832...2b2b5aa8f61c48719331ce3c2c3568d250964b46,1,13,0,13,2,2013-03-14 14:08:59,2013-03-13 19:13:04
2b2b5aa8f61c48719331ce3c2c3568d250964b46...047778363178a9040f92ca14df8ae0114903d5cd,1,5,8,13,6,2013-03-14 14:36:58,2013-03-14 13:54:19
047778363178a9040f92ca14df8ae0114903d5cd...cb7e10a27b58b860880d9fd38c3d1bd2000bbe83,1,2,2,4,2,2013-03-14 14:56:02,2013-03-14 14:56:02
cb7e10a27b58b860880d9fd38c3d1bd2000bbe83...e82e93e4fee859dc020e7c5391db5a37e62a9c7a,1,1,1,2,1,2013-03-14 17:03:39,2013-03-14 17:03:39
e82e93e4fee859dc020e7c5391db5a37e62a9c7a...7b9e52dad3b7a067230836b13e89690c48ad91e4,1,30,8,38,3,2013-03-14 18:30:13,2013-03-14 16:58:08
7b9e52dad3b7a067230836b13e89690c48ad91e4...74f23e0b2149b376ee41d5e9c1d4b29dc3a94085,2,9,2,11,2,2013-03-14 18:38:45,2013-03-14 17:27:27
74f23e0b2149b376ee41d5e9c1d4b29dc3a94085...360e8336f7546297545c4363e0ac96c0754c02b1,3,65,34,99,17,2013-03-14 18:44:50,2013-02-25 19:44:08
360e8336f7546297545c4363e0ac96c0754c02b1...b4704b474f055d71ed2f92d2d241293736792f42,14,5385,527,5912,172,2013-03-14 23:54:50,2013-03-14 23:00:30
b4704b474f055d71ed2f92d2d241293736792f42...206cf27c5847ca2e44eba20d69904d92ae71c8db,1,3,0,3,1,2013-03-14 23:54:53,2013-03-14 23:09:00
206cf27c5847ca2e44eba20d69904d92ae71c8db...9d5a7c8631e4fc9e7b4d7c9eee684d4f8029db20,1,3,3,6,1,2013-03-14 23:54:56,2013-03-14 23:10:58
9d5a7c8631e4fc9e7b4d7c9eee684d4f8029db20...a9e3f501a75c36a462e8a360f418fbd35779af3d,3,0,0,0,0,2013-03-15 00:06:31,2013-03-15 00:06:31
a9e3f501a75c36a462e8a360f418fbd35779af3d...bb9594f5ab9400d0c72b400a9f7f4e598526cece,1,46,31,77,10,2013-03-15 06:45:44,2013-03-14 20:58:56
bb9594f5ab9400d0c72b400a9f7f4e598526cece...dfb307e5716ad789cc2146048853d3a45077056b,1,21,2,23,4,2013-03-15 12:59:08,2013-03-15 06:55:57
dfb307e5716ad789cc2146048853d3a45077056b...160886e6bb6eb1916e88c6b17cb4fc039634fa9f,11,165,117,282,20,2013-03-16 01:41:06,2013-03-12 06:57:06
160886e6bb6eb1916e88c6b17cb4fc039634fa9f...939b33d5befde0272be54158bfecd3c9e361ff51,8,70,34,104,15,2013-03-16 01:41:06,2013-03-12 09:04:02
939b33d5befde0272be54158bfecd3c9e361ff51...5a3b833af00c10a90dfae88b0342d61cfcdab7ef,9,734,648,1382,23,2013-03-16 01:41:06,2013-03-12 10:18:27
5a3b833af00c10a90dfae88b0342d61cfcdab7ef...95e8af042d9ecc867b9b7e7967bfa249e774143f,15,392,249,641,167,2013-03-16 01:41:06,2013-03-12 10:33:54
95e8af042d9ecc867b9b7e7967bfa249e774143f...fbdf70f4536b32c31e5f1b10e8fea3eca4163549,20,347,257,604,89,2013-03-16 01:41:06,2013-03-12 11:38:39
fbdf70f4536b32c31e5f1b10e8fea3eca4163549...b3e4a86d28b0bec87358e9460183dbb1fab2d159,1,362,0,362,3,2013-03-16 01:41:06,2013-03-15 10:13:48
b3e4a86d28b0bec87358e9460183dbb1fab2d159...e60c28a09c691a7c4d9447dab9347d15d85e5e39,1,4,2,6,2,2013-03-16 01:41:06,2013-03-15 10:17:01
e60c28a09c691a7c4d9447dab9347d15d85e5e39...4c75c66c34bae94e61e805403ceca4e132856064,2,562,15,577,11,2013-03-16 01:41:06,2013-03-15 15:19:59
4c75c66c34bae94e61e805403ceca4e132856064...8ed4f87153afe99609898c6af7e1b58327e6335f,1,46,0,46,1,2013-03-15 17:47:35,2013-03-15 16:10:09
8ed4f87153afe99609898c6af7e1b58327e6335f...2bab9b2747e97d6835310816b09b3b259735061a,2,7,7,14,4,2013-03-15 18:16:57,2013-03-13 21:12:52
2bab9b2747e97d6835310816b09b3b259735061a...e1793c96db6a82535198254aed94d6c1a7efc25a,1,1,1,2,1,2013-03-16 03:05:15,2013-03-16 03:05:08
e1793c96db6a82535198254aed94d6c1a7efc25a...dc2727b22ca6be947ab60169dbcafd92d612007e,1,4,3,7,1,2013-03-15 19:31:59,2013-03-15 19:31:59
dc2727b22ca6be947ab60169dbcafd92d612007e...ea168df93a2681edf003304123888a94f7f3da38,8,144,32,176,32,2013-03-15 20:13:24,2013-03-15 20:10:02
ea168df93a2681edf003304123888a94f7f3da38...d4898c284b0b5b71e2ac96a7de685c5dce170fe6,1,1020,0,1020,1,2013-03-16 00:04:26,2013-03-16 00:04:26
d4898c284b0b5b71e2ac96a7de685c5dce170fe6...e23f796526a5158f9e5b5ba0fc9bf3371beb909e,2,51,7,58,3,2013-03-16 00:24:48,2013-02-28 20:59:39
e23f796526a5158f9e5b5ba0fc9bf3371beb909e...a60108e953f2b20a6803466f2b622ae9f4b77ede,1,3,2,5,1,2013-03-16 00:24:48,2013-03-13 22:49:18
a60108e953f2b20a6803466f2b622ae9f4b77ede...7a71d1e0552132ccaea01f8eba84be2885c775ef,1,0,1,1,1,2013-03-16 00:24:48,2013-03-13 22:50:20
7a71d1e0552132ccaea01f8eba84be2885c775ef...b2ec0a0f73928294a891f95f9db058e7a63704c2,1,3,3,6,3,2013-03-16 00:24:48,2013-03-13 23:11:00
b2ec0a0f73928294a891f95f9db058e7a63704c2...ad24a15a6a4f500f908e297885176944049cb809,1,9,9,18,8,2013-03-16 00:24:48,2013-03-11 17:55:42
ad24a15a6a4f500f908e297885176944049cb809...97e9f84c29b688917a963e9b3133c871bc97d095,1,18,7,25,8,2013-03-16 00:24:49,2013-03-12 00:10:47
97e9f84c29b688917a963e9b3133c871bc97d095...054ac98b9adc35cf945c5831f3b8fb764ff600ff,2,132,36,168,16,2013-03-16 00:24:49,2013-03-01 20:45:15
054ac98b9adc35cf945c5831f3b8fb764ff600ff...e08eb0176c955058111d2019125ef726b2d89ee9,1,20,0,20,2,2013-03-16 00:24:49,2013-03-01 20:47:24
e08eb0176c955058111d2019125ef726b2d89ee9...1426de920e1066149c79408ec232b04945c465b0,1,11,0,11,2,2013-03-16 00:24:49,2013-03-01 20:50:58
1426de920e1066149c79408ec232b04945c465b0...e01d425eef0d274840e8c1b0637ef7dd685fce4d,2,14,1,15,3,2013-03-16 00:24:49,2013-03-04 23:28:53
e01d425eef0d274840e8c1b0637ef7dd685fce4d...a7e6e1fa8b89c930ae0a451ef1f1a52360760db3,1,6,3,9,2,2013-03-16 00:24:49,2013-03-13 21:00:06
a7e6e1fa8b89c930ae0a451ef1f1a52360760db3...ac0492a0a6e904d13942d0bd19be5b3b69f59abb,2,9,6,15,4,2013-03-16 06:27:42,2013-03-16 06:27:42
ac0492a0a6e904d13942d0bd19be5b3b69f59abb...2effa8a2aa831eb5a7b0f07e1e0a9628ff3f9340,16,586,1,587,70,2013-03-16 11:16:16,2013-03-16 11:16:16
2effa8a2aa831eb5a7b0f07e1e0a9628ff3f9340...00421d40cbcb9af6447a4a6fb9a5f946490ec7df,1,5,2,7,2,2013-03-16 16:45:54,2013-03-16 16:45:18
00421d40cbcb9af6447a4a6fb9a5f946490ec7df...122657d540114a0d31e07da6fec50f7a1b35936a,13,336,126,462,88,2013-03-16 19:32:38,2013-03-16 16:51:04
122657d540114a0d31e07da6fec50f7a1b35936a...8914b61d04fd71063139ae6bb7beb663dd7a1270,1,7,0,7,2,2013-03-16 20:01:54,2013-03-16 19:56:37
8914b61d04fd71063139ae6bb7beb663dd7a1270...c6c2ea55fe9b37660623807d1225c7ec3b1b949e,1,3,3,6,1,2013-03-17 23:41:01,2013-03-17 23:41:01
c6c2ea55fe9b37660623807d1225c7ec3b1b949e...ec3aba682ce0e2f8312526895c7fda9719c7caa5,1,56,14,70,4,2013-03-18 13:58:34,2013-03-17 11:22:29
ec3aba682ce0e2f8312526895c7fda9719c7caa5...7cf042ff3e0c97a7fe701cd85f5cdd4c1519179b,1,23,3,26,1,2013-03-18 14:13:45,2013-03-18 14:13:45
7cf042ff3e0c97a7fe701cd85f5cdd4c1519179b...34d0cb83c50a621ad8073fcb19bc96f5a6b8e858,2,22,13,35,8,2013-03-18 14:27:51,2013-03-18 14:27:51
34d0cb83c50a621ad8073fcb19bc96f5a6b8e858...2d2a2ce570c402dcdc445fde3842818b1ea6c89c,2,2,10,12,2,2013-03-18 17:14:06,2013-03-18 17:14:06
2d2a2ce570c402dcdc445fde3842818b1ea6c89c...c481eb4987035fe894fa0c9c8d82d3a24c2421ac,1,1,3,4,2,2013-03-18 17:51:40,2013-03-16 20:47:01
c481eb4987035fe894fa0c9c8d82d3a24c2421ac...a6046309af1b8e7751976e68f46152574e4f078a,1,0,46,46,1,2013-03-18 18:18:16,2013-03-18 18:18:16
a6046309af1b8e7751976e68f46152574e4f078a...0cd87df068260b0db4bfb5c7317a552ce0042378,1,13,6,19,7,2013-03-18 18:27:43,2013-03-14 19:01:06
0cd87df068260b0db4bfb5c7317a552ce0042378...baa95b10f3d649944acfa052dcd4878691b00c4c,1,15,5,20,2,2013-03-18 18:27:43,2013-03-14 20:25:48
baa95b10f3d649944acfa052dcd4878691b00c4c...7a34ad789202cd8b4e7fb941c57c5347ba2d4ea6,1,8,10,18,6,2013-03-18 18:34:07,2012-07-25 18:20:11
7a34ad789202cd8b4e7fb941c57c5347ba2d4ea6...42676483093ae14b1f9f4a25190f0e00edcd020c,3,52,13,65,14,2013-03-18 22:02:51,2013-03-15 21:15:27
42676483093ae14b1f9f4a25190f0e00edcd020c...a13499fed6ad8f530fe2b2c9d4006268b38447a3,3,15,0,15,4,2013-03-18 22:27:23,2013-03-18 17:54:36
a13499fed6ad8f530fe2b2c9d4006268b38447a3...d2d811ebb5f50307e41601c26cb300a7e884b98f,1,153,16,169,16,2013-03-18 22:37:35,2013-03-14 18:05:02
d2d811ebb5f50307e41601c26cb300a7e884b98f...706459a8af0b278609d70e7122595243df6aeee8,3,40,3,43,8,2013-03-19 16:21:04,2013-03-14 19:03:03
706459a8af0b278609d70e7122595243df6aeee8...5312dbd53b72e856e7237df8fb6094120a875b27,1,1,1,2,1,2013-03-19 17:51:13,2013-03-19 17:51:07
5312dbd53b72e856e7237df8fb6094120a875b27...451a73db438b08c6889df334f2cfee44cb22d59a,2,0,0,0,0,2013-03-19 18:59:41,2013-03-19 18:59:41
451a73db438b08c6889df334f2cfee44cb22d59a...0a7b61a2941ee3a9180ca2dda8740944ca8a8d05,2,98,5,103,2,2013-03-20 14:56:11,2013-03-20 14:56:00
0a7b61a2941ee3a9180ca2dda8740944ca8a8d05...de6386bc631db39c1460fd476b9c2d699af457a6,2,4,4,8,3,2013-03-20 21:13:13,2013-03-20 17:38:56
de6386bc631db39c1460fd476b9c2d699af457a6...59a863f82956e070331b7262070d3ef7de4324c5,1,15,4,19,5,2013-03-20 22:12:26,2013-03-20 19:49:38
59a863f82956e070331b7262070d3ef7de4324c5...ec757744090ebeac463fdf2ba6ea5e4c9e27851f,2,73,2,75,3,2013-03-21 00:21:20,2013-03-13 22:24:07
ec757744090ebeac463fdf2ba6ea5e4c9e27851f...7280fb4d33786ab8cdb0fda4719cb2b0f06f1a75,2,11,1,12,2,2013-03-21 16:03:16,2013-03-21 15:46:45
7280fb4d33786ab8cdb0fda4719cb2b0f06f1a75...07282ec02deb1063ae27035a008737151c108ceb,1,4,0,4,1,2013-03-21 19:35:03,2013-03-07 22:38:49
07282ec02deb1063ae27035a008737151c108ceb...0ead11b1bc9855e136b77d9e9303856efed6f132,3,17,13,30,5,2013-03-21 20:27:37,2013-03-21 20:27:37
0ead11b1bc9855e136b77d9e9303856efed6f132...1192d3046bd42dc2b43ff43952624564d9227b04,27,370,254,624,54,2013-03-22 01:32:37,2013-03-22 00:40:25
1192d3046bd42dc2b43ff43952624564d9227b04...b485d031010909e04de0f78f8caf1002170c29ac,1,1,0,1,1,2013-03-22 01:55:15,2013-03-22 01:55:15
b485d031010909e04de0f78f8caf1002170c29ac...babd5ce7c4a061ac62675bec3611a3d67e32f661,8,32,0,32,16,2013-03-22 13:15:26,2013-03-22 13:15:26
babd5ce7c4a061ac62675bec3611a3d67e32f661...70e098ac3ed67c597db05cb14b5e8b7aefdd2b47,1,1,1,2,1,2013-03-22 15:39:49,2013-03-20 21:19:36
70e098ac3ed67c597db05cb14b5e8b7aefdd2b47...a67ea3ac0c570cc738d43494079e2bc284aa5071,1,24,3,27,7,2013-03-22 17:22:42,2013-03-22 17:22:42
a67ea3ac0c570cc738d43494079e2bc284aa5071...ae6ef38de2c5761b8e5d0e9012fa35e5dfa90b5b,1,2,1,3,2,2013-03-22 19:51:08,2013-03-22 19:51:08
ae6ef38de2c5761b8e5d0e9012fa35e5dfa90b5b...6f7d5ca12971663a02a158e7ff97925e431e9ee3,1,54,0,54,5,2013-03-23 15:19:59,2013-03-20 21:51:55
6f7d5ca12971663a02a158e7ff97925e431e9ee3...6286ed8d316f494d948ec02a2bc4163cc9285934,1,95,55,150,16,2013-03-23 15:19:59,2013-03-16 19:16:16
6286ed8d316f494d948ec02a2bc4163cc9285934...037ccf6382b4e71de27104c670291b330d8d1e45,1,8,0,8,2,2013-03-23 15:19:59,2013-03-14 18:23:30
037ccf6382b4e71de27104c670291b330d8d1e45...1b2a4e07f24df4f2bed7ecf6857d312d2235dfb0,1,26,6,32,3,2013-03-23 15:19:59,2013-03-04 22:06:17
1b2a4e07f24df4f2bed7ecf6857d312d2235dfb0...224a7bb7f6669eb80c393d536a894d8841f003c3,1,7,1,8,2,2013-03-23 19:43:06,2013-03-23 19:30:36
224a7bb7f6669eb80c393d536a894d8841f003c3...5bc11809e0fe058b83defe1106a90e452caddf93,1,1,1,2,1,2013-03-25 14:22:49,2013-03-25 14:22:49
5bc11809e0fe058b83defe1106a90e452caddf93...2e0b6c68eb6bc7caabe4494ff79263d17a5202a0,1,5,1,6,1,2013-03-25 20:54:36,2013-03-25 20:54:36
2e0b6c68eb6bc7caabe4494ff79263d17a5202a0...3521eaab4c6d1a6e9a80fb55ee493e5c5806a43b,1,16,4,20,2,2013-03-25 21:58:22,2013-03-25 19:12:36
3521eaab4c6d1a6e9a80fb55ee493e5c5806a43b...37e19cbffbd2f7c20e862f7afbc622d2a60c2a96,5,59,50,109,13,2013-03-25 22:45:20,2013-03-19 20:38:35
37e19cbffbd2f7c20e862f7afbc622d2a60c2a96...a14608d57d574081c8fafb198ec6c755883bb7a0,1,6,1,7,3,2013-03-25 22:45:20,2013-03-25 18:04:20
a14608d57d574081c8fafb198ec6c755883bb7a0...1a8b7b4241cc17524a482e7caa7fbbba90cbabbc,1,1,1,2,1,2013-03-26 14:51:30,2013-03-26 14:51:30
1a8b7b4241cc17524a482e7caa7fbbba90cbabbc...75d38d081ea7a38a4c254ba01a0d61a279746b21,1,86,0,86,1,2013-03-26 19:51:03,2013-03-26 19:51:03
75d38d081ea7a38a4c254ba01a0d61a279746b21...ce9218e76a54f913bd1896db25824e33117ff14b,1,7,3,10,4,2013-03-26 20:03:41,2013-03-26 19:57:43
ce9218e76a54f913bd1896db25824e33117ff14b...7b84af64e01ae93f0315dcd3c492f44e044adb24,1,44,0,44,1,2013-03-27 03:36:11,2013-03-24 17:20:49
7b84af64e01ae93f0315dcd3c492f44e044adb24...2ef273f283c7d45b9dfa55f5adf14f2b63069dc7,4,37,9,46,13,2013-03-27 13:37:49,2013-03-25 15:01:40
2ef273f283c7d45b9dfa55f5adf14f2b63069dc7...45bedc3c887794a25dc74325fecaa654ea160506,6,139,30,169,10,2013-03-27 18:42:17,2013-03-26 19:32:03
45bedc3c887794a25dc74325fecaa654ea160506...ca31c2c178b1105b75939179757e05e277e958b7,3,15,1,16,4,2013-03-27 20:11:23,2013-03-26 20:54:49
ca31c2c178b1105b75939179757e05e277e958b7...ff6348dd229e9c15f46cba3f5419a1ef3d8a1cad,1,62,0,62,1,2013-03-27 20:24:51,2013-03-27 20:24:51
ff6348dd229e9c15f46cba3f5419a1ef3d8a1cad...168396205ffe36c65eb3a5893750e817a367f1fd,2,2,2,4,4,2013-03-28 03:13:56,2013-03-25 19:51:02
168396205ffe36c65eb3a5893750e817a367f1fd...0aa0d6b3794f5cd963ef5508b672fd03db6aa5c5,1,3,0,3,1,2013-03-28 14:57:19,2013-03-28 13:31:14
0aa0d6b3794f5cd963ef5508b672fd03db6aa5c5...e72ca6c0f8998225a11c2514db10e7346f516e6c,1,5,2,7,2,2013-03-28 18:45:04,2013-03-28 16:41:48
e72ca6c0f8998225a11c2514db10e7346f516e6c...2dc4f569adf4b66a2b9f4500de521c9cdf7ba73b,1,6,0,6,6,2013-03-28 18:47:51,2013-03-27 14:46:09
2dc4f569adf4b66a2b9f4500de521c9cdf7ba73b...0b6737c2ddd58df25eb41c477c9dc639014b0ebe,3,81,60,141,19,2013-03-29 13:34:44,2013-03-28 14:41:57
0b6737c2ddd58df25eb41c477c9dc639014b0ebe...d24a34fccf2399cc89dc0b159739754b8a62ba27,1,44,44,88,2,2013-03-29 14:41:17,2013-03-27 18:51:21
d24a34fccf2399cc89dc0b159739754b8a62ba27...cc155a6fb38cb8509047e772187f23bd44bb7cb4,2,143,37,180,30,2013-03-29 14:41:17,2013-03-28 16:07:28
cc155a6fb38cb8509047e772187f23bd44bb7cb4...0938eb923f522452e2c2918c6e89911355913bec,1,5,5,10,5,2013-03-29 17:37:03,2013-03-13 02:29:34
0938eb923f522452e2c2918c6e89911355913bec...d8d85cb268995cd6561156ab595c44d3fab9565b,1,16,10,26,2,2013-03-29 17:37:03,2013-03-13 02:34:46
d8d85cb268995cd6561156ab595c44d3fab9565b...26867fd66d6174beca2155ae2fb2c63d7a658ed7,1,8,11,19,5,2013-03-29 18:39:39,2013-03-29 18:14:36
26867fd66d6174beca2155ae2fb2c63d7a658ed7...f8699f77f90ff9b24d23729644ee7cd7ed0e9600,2,6,0,6,2,2013-03-29 19:56:43,2013-03-29 18:18:17
f8699f77f90ff9b24d23729644ee7cd7ed0e9600...939e91aed13ecb55d2e9a43f5ea92bf4bf64a1c1,2,56,1,57,3,2013-03-29 21:14:42,2013-03-29 21:14:38
939e91aed13ecb55d2e9a43f5ea92bf4bf64a1c1...e6b57b52cef4e56e93210438d89f7361af83b880,1,0,2,2,2,2013-03-29 22:39:06,2013-03-29 22:39:06
e6b57b52cef4e56e93210438d89f7361af83b880...afb0f9b2434d53642df88376a30ee519c125d99d,1,0,1,1,1,2013-03-29 22:40:30,2013-03-29 22:40:30
afb0f9b2434d53642df88376a30ee519c125d99d...6fc598a53ac23f9809f21142211749e9f1214acb,1,18,7,25,3,2013-03-29 22:44:28,2013-03-29 22:44:08
6fc598a53ac23f9809f21142211749e9f1214acb...428309bef753f26ea11e17744710c6bfacfab72b,2,33,7,40,5,2013-03-30 00:21:39,2013-03-30 00:21:39
428309bef753f26ea11e17744710c6bfacfab72b...7d24b812ead07623a838306b9beebd8cd0d5df63,1,2,0,2,2,2013-03-30 14:40:27,2013-03-30 14:40:27
7d24b812ead07623a838306b9beebd8cd0d5df63...d6da825b127dd5ea535da4812c722441d6e71f01,3,23,32,55,18,2013-04-01 18:21:30,2013-04-01 17:08:42
d6da825b127dd5ea535da4812c722441d6e71f01...b466593c214b031740c31e064b9124e17ce48467,4,385,252,637,18,2013-04-01 18:47:47,2013-03-29 20:00:59
b466593c214b031740c31e064b9124e17ce48467...d2febea6d4a66998682467aa0e4adc0d55365166,2,6,6,12,6,2013-04-01 19:21:53,2013-04-01 19:21:53
d2febea6d4a66998682467aa0e4adc0d55365166...356f8a74eb794432e8f01afc0557b78219636cb8,5,123,19,142,17,2013-04-01 21:21:08,2013-03-31 20:08:37
356f8a74eb794432e8f01afc0557b78219636cb8...7c79805aa5ed14c573a07da705c888a22bf8853a,2,57,3,60,6,2013-04-01 23:05:24,2013-04-01 18:11:19
7c79805aa5ed14c573a07da705c888a22bf8853a...2d0f6cc207ac4574ead4bb4728bfef1e22229b67,3,29,181,210,26,2013-04-02 14:41:45,2013-03-15 18:46:45
2d0f6cc207ac4574ead4bb4728bfef1e22229b67...e50383635fe7ff08ff420d2659ee9faca74b641f,1,4,4,8,4,2013-04-02 15:04:52,2013-04-02 15:04:52
e50383635fe7ff08ff420d2659ee9faca74b641f...3ab70d9ed498fc2e879058a8d398f0078388f203,3,447,0,447,3,2013-04-02 15:10:54,2013-03-27 17:45:09
3ab70d9ed498fc2e879058a8d398f0078388f203...bc994d83b810cf39084379c398abcc8c304837bc,15,1343,304,1647,56,2013-04-02 15:16:13,2013-03-29 14:18:37
bc994d83b810cf39084379c398abcc8c304837bc...3fa848aaea3b5f108877f5f4ea97b77e6df4b899,1,1,1,2,1,2013-04-02 15:30:54,2013-04-01 20:56:31
3fa848aaea3b5f108877f5f4ea97b77e6df4b899...5b1d3d9f9b4bfd72d4a169a760ecb520c4f144e4,1,0,6,6,1,2013-04-02 17:18:32,2013-04-02 17:18:22
5b1d3d9f9b4bfd72d4a169a760ecb520c4f144e4...0cffc277798ab1b9647855194c9f2774f456aab1,2,2,2,4,2,2013-04-02 20:01:27,2013-04-02 20:01:27
0cffc277798ab1b9647855194c9f2774f456aab1...4510b95addbb34730609f700e04d40ba3d4320ca,1,0,1,1,1,2013-04-02 20:39:00,2013-04-02 20:13:59
4510b95addbb34730609f700e04d40ba3d4320ca...acf53fe9a229398bd6a600e8dad43a451a8cc44b,8,172,0,172,20,2013-04-02 20:58:25,2013-04-02 20:56:03
acf53fe9a229398bd6a600e8dad43a451a8cc44b...348108640dba300439e8121f7509147e8d1313b3,4,53,36,89,6,2013-04-02 21:42:19,2013-04-01 20:48:11
348108640dba300439e8121f7509147e8d1313b3...658cf5e72f1a901a37bef2af8ce0943a2d242c86,1,1,1,2,1,2013-04-03 04:32:15,2013-04-03 04:32:15
658cf5e72f1a901a37bef2af8ce0943a2d242c86...145f0b74af82e2b9b2d3c78052fd3a7df9f7c0b3,2,13,8,21,5,2013-04-03 04:33:24,2013-04-03 04:33:24
145f0b74af82e2b9b2d3c78052fd3a7df9f7c0b3...b98575fa80b8fac5ad3bb52172dff9ce6070aa1c,1,1,1,2,1,2013-04-03 12:48:39,2013-04-03 12:48:39
b98575fa80b8fac5ad3bb52172dff9ce6070aa1c...78c31beb18a47f431da12004c8f820136b0dc857,2,10,1,11,3,2013-04-03 14:29:01,2013-04-01 16:03:14
78c31beb18a47f431da12004c8f820136b0dc857...a003b72dbfc9c993daeb91ed72d22d8e55e4da16,2,17,0,17,3,2013-04-03 18:47:27,2013-04-03 14:11:52
a003b72dbfc9c993daeb91ed72d22d8e55e4da16...3dde5c13b5a3dca40f8e3c47696bf33ca7fbf7ab,6,425,140,565,23,2013-04-03 18:47:27,2013-04-03 15:03:08
3dde5c13b5a3dca40f8e3c47696bf33ca7fbf7ab...c45071d421239819e23cc0ff2a0f7ba10f618e77,1,1,1,2,1,2013-04-03 19:12:49,2013-04-03 19:12:43
c45071d421239819e23cc0ff2a0f7ba10f618e77...8911cdf312fba509ab20f31b56fc614d13e0d1ee,2,8,1,9,2,2013-04-03 19:53:34,2013-04-03 17:59:18
8911cdf312fba509ab20f31b56fc614d13e0d1ee...ed3b8e1af9b629c99b433c818c0e9314bce405ee,1,8,8,16,6,2013-04-03 21:24:19,2013-04-03 20:50:46
ed3b8e1af9b629c99b433c818c0e9314bce405ee...c33e687b922c9e3b75ffd7b058a081cc2bcca4b3,4,8,8,16,8,2013-04-04 10:10:42,2013-04-04 10:10:42
c33e687b922c9e3b75ffd7b058a081cc2bcca4b3...359d02fd8ad0a2a8d98b3bee6fd136c227885fc7,2,18,11,29,4,2013-04-04 15:33:44,2013-04-03 21:01:28
359d02fd8ad0a2a8d98b3bee6fd136c227885fc7...85d5487e2e40b7351566b914f8df4d454beb5835,1,21,4,25,5,2013-04-05 16:24:43,2013-04-05 16:24:31
85d5487e2e40b7351566b914f8df4d454beb5835...7d96d614c9b91a668a65992115c12b3ede51faea,6,31,16,47,14,2013-04-05 19:28:24,2013-04-05 19:28:24
7d96d614c9b91a668a65992115c12b3ede51faea...5b2ea1ce0b17268cdd4e90f0039ba5df3b07581e,2,10,179,189,4,2013-04-05 21:39:35,2013-04-03 22:39:05
5b2ea1ce0b17268cdd4e90f0039ba5df3b07581e...86203fb1187e5673fcf27463b0967892d4cec111,1,8,2,10,1,2013-04-05 21:39:35,2013-04-03 23:23:31
86203fb1187e5673fcf27463b0967892d4cec111...be6a5bbdca5b7b0566d043b6d7cea289743812d1,2,60,38,98,29,2013-04-05 21:39:35,2013-04-05 20:19:25
be6a5bbdca5b7b0566d043b6d7cea289743812d1...0d6aff98bf28808560a4ee57709be77d0584c638,4,155,6,161,13,2013-04-08 15:11:34,2013-01-23 01:20:12
0d6aff98bf28808560a4ee57709be77d0584c638...d5fad724e291ca8af3b47e4622cc97a3a85b62a0,1,3,0,3,1,2013-04-08 16:44:07,2013-04-08 16:44:02
d5fad724e291ca8af3b47e4622cc97a3a85b62a0...eaae81e7711ba0620ec56ac4600ae76e4ab819db,1,1,1,2,1,2013-04-08 16:51:04,2013-04-08 16:50:58
eaae81e7711ba0620ec56ac4600ae76e4ab819db...817a5e3f07a399e27c7098f1bcc451437dc4e0d5,1,1,1,2,1,2013-04-08 18:12:53,2013-04-08 18:12:46
817a5e3f07a399e27c7098f1bcc451437dc4e0d5...6a0cdd1825fc033c65bd12dcb556fb9a865ff31f,1,55,0,55,1,2013-04-08 18:51:11,2013-04-05 18:42:28
6a0cdd1825fc033c65bd12dcb556fb9a865ff31f...da0559f544928c3b56fc3f02cabb912e8c45343f,3,21,0,21,3,2013-04-08 18:51:11,2013-04-05 20:32:42
da0559f544928c3b56fc3f02cabb912e8c45343f...f6b0d41bc6f230822e611ce8b3cfaffc02e44a69,5,57,0,57,5,2013-04-08 18:51:11,2013-04-05 20:59:30
f6b0d41bc6f230822e611ce8b3cfaffc02e44a69...ac39ed282dc9610a115d09cbf88cd1bdf0fa3ba6,2,24,10,34,11,2013-04-08 19:03:39,2013-04-03 22:43:32
ac39ed282dc9610a115d09cbf88cd1bdf0fa3ba6...50c89129eaa8c77ce24bb1e2f2965996f3757143,22,1194,299,1493,91,2013-04-08 19:30:35,2013-04-02 18:28:21
50c89129eaa8c77ce24bb1e2f2965996f3757143...6d8d4172c7388495b518ae6b8d4f836532f770d8,19,964,43,1007,70,2013-04-08 20:26:37,2013-04-02 17:28:11
6d8d4172c7388495b518ae6b8d4f836532f770d8...c3e875be4102581a744d8c04ebc274f1a6188510,1,1,1,2,1,2013-04-08 20:42:26,2013-04-08 20:42:09
c3e875be4102581a744d8c04ebc274f1a6188510...7da7625b971d08d6c3705499f412ff0852b36b5a,1,1,0,1,1,2013-04-08 20:57:55,2013-04-08 20:57:55
7da7625b971d08d6c3705499f412ff0852b36b5a...930893b39d0aaf8db227642d78b54eaa6b697320,1,5,1,6,2,2013-04-08 21:46:13,2013-04-08 21:21:33
930893b39d0aaf8db227642d78b54eaa6b697320...b5aa82c6783029da7fd21480d0271731c0c770f3,1,10,4,14,6,2013-04-08 23:32:36,2013-04-08 23:32:36
b5aa82c6783029da7fd21480d0271731c0c770f3...ad60f1bdacbcc1fe212a78f310ea73a2f07ec62a,1,21,1,22,5,2013-04-09 00:58:23,2013-03-24 18:16:01
ad60f1bdacbcc1fe212a78f310ea73a2f07ec62a...53d7bcd4ed2996a4115211075643090173e7cf7a,9,120,64,184,18,2013-04-09 00:58:23,2013-04-02 21:15:13
53d7bcd4ed2996a4115211075643090173e7cf7a...2444132a2de70f488588326456de4e615d3af3d3,12,160,12,172,40,2013-04-09 09:53:45,2013-04-09 09:53:45
2444132a2de70f488588326456de4e615d3af3d3...10b42b5a9c9b4fe01eb0832ca8faf384eb742f48,1,1,1,2,1,2013-04-09 13:44:30,2013-04-09 13:44:17
10b42b5a9c9b4fe01eb0832ca8faf384eb742f48...d34383a1c346d039a002579408dc2bde3b9f111f,2,61,34,95,6,2013-04-09 13:48:13,2013-04-09 13:47:58
d34383a1c346d039a002579408dc2bde3b9f111f...8f18c1f029f040760bafa222fa2976d3102e579f,4,71,104,175,4,2013-04-09 13:54:04,2013-04-05 15:30:08
8f18c1f029f040760bafa222fa2976d3102e579f...5263d2a1a0f4c04bca93e08344afff6c7f910e7a,1,541,0,541,1,2013-04-09 14:50:22,2013-04-02 20:43:47
5263d2a1a0f4c04bca93e08344afff6c7f910e7a...b8a78720e2d1bdbd2b6afe2f710131b19011de7e,1,4,4,8,2,2013-04-09 16:28:03,2013-04-09 16:28:03
b8a78720e2d1bdbd2b6afe2f710131b19011de7e...694ad4140ad4433cf05f321b4ea348e54d00c46a,1,10,1,11,2,2013-04-09 16:49:06,2013-04-09 16:49:06
694ad4140ad4433cf05f321b4ea348e54d00c46a...0077dc8ecb111075177c66abc8a5b7809a8547a0,2,9,6,15,6,2013-04-09 19:59:22,2013-04-09 19:59:22
0077dc8ecb111075177c66abc8a5b7809a8547a0...21d5514eeac55ee128120085e83dcce3873c29f0,7,48,43,91,15,2013-04-10 14:49:07,2013-04-10 14:47:20
21d5514eeac55ee128120085e83dcce3873c29f0...37c08671b653c16fc2e1e568a18b380d09a93733,6,504,0,504,6,2013-04-10 16:19:20,2013-04-09 21:56:53
37c08671b653c16fc2e1e568a18b380d09a93733...4f1a1a3a825701f01ba62207858646a7df40843b,20,1463,30,1493,35,2013-04-10 16:41:42,2013-04-09 02:45:05
4f1a1a3a825701f01ba62207858646a7df40843b...6365b534fe25b81101d7a26f798e23e649e8ddbb,1,1,1,2,1,2013-04-10 19:12:54,2013-04-10 18:20:54
6365b534fe25b81101d7a26f798e23e649e8ddbb...74409f3cb7a2122610842955ed1c6ed7dd1779e6,1,9,0,9,1,2013-04-10 19:17:55,2013-04-10 19:13:31
74409f3cb7a2122610842955ed1c6ed7dd1779e6...623665025536722bf2d3cb303fbb4abdc6271a8e,1,1,1,2,1,2013-04-10 19:24:04,2013-04-10 19:16:21
623665025536722bf2d3cb303fbb4abdc6271a8e...56432a5305e0ef445b7d1d6cb0752a45c703eff6,8,178,84,262,34,2013-04-10 19:27:26,2013-04-10 19:27:26
56432a5305e0ef445b7d1d6cb0752a45c703eff6...0519832fd3916d78bb283903586f53afd477f54c,1,100,0,100,1,2013-04-10 19:40:49,2013-04-05 19:25:04
0519832fd3916d78bb283903586f53afd477f54c...1038d524de8d36ca17d73c39a1880fa13066e47c,1,1,1,2,1,2013-04-11 09:08:25,2013-04-11 09:08:25
1038d524de8d36ca17d73c39a1880fa13066e47c...31ee545e444d89b85566685f45ab27bf48766a06,1,1,0,1,1,2013-04-11 09:10:38,2013-04-11 09:10:38
31ee545e444d89b85566685f45ab27bf48766a06...359b0b8c25e76b18bf6a366d9d6d9115f5a26fcc,1,9,1,10,1,2013-04-11 17:30:50,2013-04-11 17:30:50
359b0b8c25e76b18bf6a366d9d6d9115f5a26fcc...b7245d22bd7699400196e1d077bfdc3996b37bd9,1,119,0,119,1,2013-04-11 21:09:55,2013-02-26 01:53:14
b7245d22bd7699400196e1d077bfdc3996b37bd9...7444ce1790062e17087342d22ab64690c0023b3c,2,1,5,6,2,2013-04-12 18:52:10,2013-04-12 18:52:10
7444ce1790062e17087342d22ab64690c0023b3c...90e75dd68fc39178feeb535739f5e214b07a9d2f,1,11,9,20,7,2013-04-12 20:11:00,2013-04-12 17:11:34
90e75dd68fc39178feeb535739f5e214b07a9d2f...7797f459758a98bce90593e583f90c858a287a1c,2,14,26,40,8,2013-04-12 20:11:00,2013-04-12 20:08:20
7797f459758a98bce90593e583f90c858a287a1c...ef3d06fb6c5402d56a90ad60fd61c761021b92a7,20,685,245,930,60,2013-04-12 20:40:38,2013-04-11 20:22:55
ef3d06fb6c5402d56a90ad60fd61c761021b92a7...8e54313f211263922ee1df20c71ee2a0390fc3ca,1,1,2,3,2,2013-04-14 11:44:10,2013-04-14 11:44:10
8e54313f211263922ee1df20c71ee2a0390fc3ca...06aa0fb74f552074e718c5c4b891f82ab6f1facb,1,1,1,2,1,2013-04-14 11:47:23,2013-04-14 11:47:23
06aa0fb74f552074e718c5c4b891f82ab6f1facb...0d46f9b7fcc8eabcf7ada9e4eb8766247e0c4f7b,1,6,4,10,4,2013-04-14 11:50:28,2013-04-14 11:50:28
0d46f9b7fcc8eabcf7ada9e4eb8766247e0c4f7b...91079254e23d3c3ee0d500b48a01e26d6928b080,8,84,0,84,25,2013-04-14 11:54:15,2013-04-14 11:54:15
91079254e23d3c3ee0d500b48a01e26d6928b080...b5303b8d34243e0aabaf22bcbe01b0fc0ef6ce3f,2,11,9,20,10,2013-04-15 15:45:21,2013-04-15 15:45:21
b5303b8d34243e0aabaf22bcbe01b0fc0ef6ce3f...0abe2d757e1a992a5ea47f939e9a4cc05f45ff82,1,788,0,788,33,2013-04-16 00:50:12,2013-04-03 22:03:58
0abe2d757e1a992a5ea47f939e9a4cc05f45ff82...8f543cb195e7cd9c4586644b3e0de971cc4d01d4,1,16,16,32,2,2013-04-16 09:45:47,2013-04-16 09:45:47
8f543cb195e7cd9c4586644b3e0de971cc4d01d4...ae8f60287af2138896faea6de17b1da8b4e7054a,16,40,36,76,24,2013-04-16 15:36:29,2013-04-16 14:17:41
ae8f60287af2138896faea6de17b1da8b4e7054a...1de69d1de81d98c2ecbb5e6cedd31109de15da88,5,65,25,90,20,2013-04-17 12:35:18,2013-04-16 15:37:19
1de69d1de81d98c2ecbb5e6cedd31109de15da88...04451da971f8de4201e2c8d58b678d1a033106f8,1,4,2,6,6,2013-04-17 15:02:23,2013-04-17 15:02:23
04451da971f8de4201e2c8d58b678d1a033106f8...df34c1f568b6759c9f4e3ececf978ebf916d02d4,12,24,16,40,20,2013-04-17 20:59:34,2013-04-17 20:59:34
df34c1f568b6759c9f4e3ececf978ebf916d02d4...2e3f2b38accbaf7ba47d39c04dc77caf9d9ed611,5,156,14,170,11,2013-04-17 23:16:55,2013-03-29 14:26:07
2e3f2b38accbaf7ba47d39c04dc77caf9d9ed611...61158f0c43993c321176fc0ecf47eb90c6c35dfe,9,2005,0,2005,10,2013-04-17 23:16:55,2013-04-01 17:52:58
61158f0c43993c321176fc0ecf47eb90c6c35dfe...957dda895f9bc4d481b1e40add92db9a33b46233,3,36,36,72,6,2013-04-18 09:17:42,2013-04-18 09:17:42
957dda895f9bc4d481b1e40add92db9a33b46233...7a24fedbb3cdd55b2d204143a0cc605e391aa884,12,398,0,398,24,2013-04-18 10:06:24,2013-04-18 10:06:24
7a24fedbb3cdd55b2d204143a0cc605e391aa884...8cfa93578c541b046903dd9b40e7eb9f46156fb9,28,2472,260,2732,76,2013-04-18 13:38:42,2013-04-17 01:09:09
8cfa93578c541b046903dd9b40e7eb9f46156fb9...0bd9f00eb58f6ad1ac67ca04c9ff99f977c4501d,1,1,1,2,1,2013-04-18 15:26:27,2013-04-18 15:26:27
0bd9f00eb58f6ad1ac67ca04c9ff99f977c4501d...0963b26bb78c85016781140c0b647877a6456ecc,8,80,0,80,16,2013-04-18 15:59:50,2013-04-18 15:59:50
0963b26bb78c85016781140c0b647877a6456ecc...f1bc52b19bbd126d5d3c53c230173bae493741a9,1,4,0,4,1,2013-04-18 16:03:29,2013-04-15 13:21:17
f1bc52b19bbd126d5d3c53c230173bae493741a9...d10d06711be066d30a8c54bc34f0de712a4bf261,2,21,2,23,4,2013-04-18 17:11:32,2013-04-18 12:42:40
d10d06711be066d30a8c54bc34f0de712a4bf261...756819679e8c1d664f1618aeaa8b12b980e769b6,1,17,6,23,5,2013-04-18 18:31:41,2013-04-18 18:31:41
756819679e8c1d664f1618aeaa8b12b980e769b6...452650285a1b121dfee104e9435e593f8dce8ba2,1,18,0,18,2,2013-04-18 18:54:14,2013-04-18 18:54:14
756819679e8c1d664f1618aeaa8b12b980e769b6...8720e07600694c4390faab186ad5da8bdbe49a3a,4,47,33,80,24,2013-04-18 18:44:37,2013-04-18 15:46:45
8ed3bd52bc4f7e1ac411815ffcec779f7b747772...9fdb6af78cb43d26582a9702d95a6ef5829cdef1,1,3,3,6,3,2013-04-18 19:19:52,2013-04-18 19:19:52
8ed3bd52bc4f7e1ac411815ffcec779f7b747772...e8129b807c8ac31b34c9c0cb9b5f4d76052453f3,6,97,32,129,41,2013-04-18 19:04:37,2013-04-11 21:05:08
e8129b807c8ac31b34c9c0cb9b5f4d76052453f3...a6769906c38dd79e7c98d28dc59e29350a531b61,5,51,18,69,20,2013-04-18 19:06:37,2013-04-15 21:40:27
132ee71cfe074a5cf88a8a0103290e6849279a5d...14839ca976cff7566f9aa578044f44413b7abdc0,66,344,297,641,105,2013-04-18 19:47:12,2013-04-17 13:11:35
14839ca976cff7566f9aa578044f44413b7abdc0...52eb3dd20eb26368df2dac68085e9bcaad183e9f,1,1,1,2,1,2013-04-18 21:42:19,2013-04-18 21:42:19
52eb3dd20eb26368df2dac68085e9bcaad183e9f...57c7fa55d700497b0e95f16878499d8ffc330916,6,24,11,35,8,2013-04-18 22:15:07,2013-04-18 22:15:07
57c7fa55d700497b0e95f16878499d8ffc330916...f63d4e568bfc00f27d573520f16e66e215890355,1,10,4,14,10,2013-04-18 22:56:38,2013-04-18 18:41:28
f63d4e568bfc00f27d573520f16e66e215890355...89ca7f9d6f134e09241837edeb9b456d80f2abc9,1,36,0,36,1,2013-04-19 15:06:52,2013-04-11 21:43:37
89ca7f9d6f134e09241837edeb9b456d80f2abc9...f75c238b3363048f91ed22d9db0cb83383b1ebd4,23,463,728,1191,147,2013-04-19 16:02:28,2013-04-18 21:10:12
f75c238b3363048f91ed22d9db0cb83383b1ebd4...9b37a3aa83655aa92c1d466e65500100e4d799cd,1,9,0,9,1,2013-04-19 18:54:02,2013-04-19 18:05:11
9b37a3aa83655aa92c1d466e65500100e4d799cd...f95e411f58f2a4dcaf9433c75d0c2dca4754e1a1,2,61,2,63,5,2013-04-19 21:43:23,2013-04-19 21:18:58
f95e411f58f2a4dcaf9433c75d0c2dca4754e1a1...75619a9c480dc808bff048a83b13409de1f586cc,3,22,1,23,4,2013-04-19 21:43:23,2013-04-19 21:23:18
75619a9c480dc808bff048a83b13409de1f586cc...e31fef3ad78fd7214a9e79420703a49d8bff488a,2,24,1,25,2,2013-04-19 21:43:24,2013-04-19 21:37:30
e31fef3ad78fd7214a9e79420703a49d8bff488a...ed92817b737fcb13019583d7e0770436369021f7,1,1,1,2,1,2013-04-20 12:08:47,2013-04-20 12:08:47
ed92817b737fcb13019583d7e0770436369021f7...89448f1a64d95c796cbf88c46f27b50efd08ed17,16,170,22,192,54,2013-04-20 12:10:47,2013-04-20 12:10:47
89448f1a64d95c796cbf88c46f27b50efd08ed17...534611839a35a5fcc11fa7f946ff17d8a9cb12ee,2,2,2,4,2,2013-04-28 16:47:26,2013-04-28 16:47:26
89448f1a64d95c796cbf88c46f27b50efd08ed17...41e3d093a280680d113aa2c92fa0aebf00b9212a,1,1,1,2,1,2013-04-22 12:20:35,2013-04-22 12:20:35
41e3d093a280680d113aa2c92fa0aebf00b9212a...3cd3c2ff68a39980f6e4a6a50e727bdf1ded2078,1,1,1,2,1,2013-04-22 13:32:18,2013-04-12 14:22:32
3cd3c2ff68a39980f6e4a6a50e727bdf1ded2078...1e05c5b74abc9996036a02aa04fb573825e7f692,2,14,2,16,3,2013-04-22 15:35:44,2013-04-22 15:35:44
1e05c5b74abc9996036a02aa04fb573825e7f692...506e7c0adffc8708fb15bab929fa83d016e96eec,1,6,3,9,3,2013-04-22 16:07:37,2013-04-22 16:07:22
506e7c0adffc8708fb15bab929fa83d016e96eec...2d8e9831979076e5f6a47895aedad80c8da10d4c,12,571,351,922,46,2013-04-22 17:02:47,2013-03-28 19:22:26
2d8e9831979076e5f6a47895aedad80c8da10d4c...8324f6c8872f83404d811a69df91bf4df9ad2a62,1,1,1,2,1,2013-04-22 17:05:06,2013-04-22 17:05:06
8324f6c8872f83404d811a69df91bf4df9ad2a62...16aba22e19a11749db4cf0e3f8075a9b4dbc4295,6,115,99,214,11,2013-04-22 17:09:38,2013-04-16 18:30:51
16aba22e19a11749db4cf0e3f8075a9b4dbc4295...86734df5eb25a9151ada55de2ddbb1a97b526791,1,1,0,1,1,2013-04-22 18:06:46,2013-04-22 17:10:56
86734df5eb25a9151ada55de2ddbb1a97b526791...ead9f3b6baaab0845348acc3760ba094d74dd884,1,18,0,18,2,2013-04-22 18:22:01,2013-04-22 17:10:00
ead9f3b6baaab0845348acc3760ba094d74dd884...fd8726bbf6ba0c7843465358022b848ba6b552a9,1,16,2,18,2,2013-04-23 00:05:03,2013-04-17 17:00:22
fd8726bbf6ba0c7843465358022b848ba6b552a9...30b7ed6470b3c97b04e32b53137ece4314ee8ce8,6,124,8,132,8,2013-04-23 12:39:33,2013-04-22 18:48:02
30b7ed6470b3c97b04e32b53137ece4314ee8ce8...f4ef62572f1bb2b378d940f50cf22c1be2e7c5b3,1,4,3,7,2,2013-04-23 15:53:56,2013-04-23 15:53:56
f4ef62572f1bb2b378d940f50cf22c1be2e7c5b3...9ce6634e0ffc6757b4f511a11fd46b863d9dc136,18,204,3293,3497,39,2013-04-23 16:13:27,2013-04-22 17:55:24
9ce6634e0ffc6757b4f511a11fd46b863d9dc136...eb04c3299fb9be3afbf01e281ff5d3c3d38ba024,27,393,312,705,118,2013-04-23 16:13:27,2013-04-22 19:39:24
eb04c3299fb9be3afbf01e281ff5d3c3d38ba024...62a22563d4bd9b21c1e168246c8899b5da4e28bc,1,76,0,76,1,2013-04-23 16:27:43,2013-04-23 16:25:56
62a22563d4bd9b21c1e168246c8899b5da4e28bc...2aff8e4b59393067557204da5333bfc16677ecb3,22,5830,0,5830,22,2013-04-23 16:27:44,2013-04-23 16:26:52
2aff8e4b59393067557204da5333bfc16677ecb3...4dac4a8f9f6ba79c9cf4e65e013914fde0fff83d,2,2,0,2,2,2013-04-23 19:07:22,2013-04-23 19:07:22
4dac4a8f9f6ba79c9cf4e65e013914fde0fff83d...95b42ea5dfd7e8939c8eff9e7bf4a6442b7b14d3,3,2,9,11,6,2013-04-23 19:37:57,2013-04-23 19:37:52
95b42ea5dfd7e8939c8eff9e7bf4a6442b7b14d3...d5b73a85510f8620d14ce2b40b61bbef9cf3911f,3,18,13,31,10,2013-04-23 22:18:17,2013-04-23 22:17:57
d5b73a85510f8620d14ce2b40b61bbef9cf3911f...2edb8a4a4256a7d86ef2e2f5136c17c92e786c37,1,1,1,2,1,2013-04-24 04:07:28,2013-04-24 04:07:28
2edb8a4a4256a7d86ef2e2f5136c17c92e786c37...92bebb9de4c0842d7aaa257596538b3675a060f8,1,50,0,50,1,2013-04-24 13:18:16,2013-04-24 13:18:04
92bebb9de4c0842d7aaa257596538b3675a060f8...2d30f0b562c1925a52670e767c2c0222189fb8f0,1,4,1,5,1,2013-04-24 14:33:55,2013-04-24 12:39:01
2d30f0b562c1925a52670e767c2c0222189fb8f0...7216abf5b7faa3f80251dd8d5b1349a2b4064656,8,204,5,209,19,2013-04-24 17:04:42,2013-04-24 17:04:42
7216abf5b7faa3f80251dd8d5b1349a2b4064656...84d1b3a112889278d68f707b439d97a3fb08b10c,1,4,0,4,1,2013-04-24 17:30:39,2013-04-24 17:30:39
84d1b3a112889278d68f707b439d97a3fb08b10c...ad8a1d4678122bada9d4479b114cf68d39c27724,16,830,264,1094,100,2013-04-24 18:22:32,2013-04-24 18:22:32
ad8a1d4678122bada9d4479b114cf68d39c27724...8cc2ab561ec1a6d011c44c7b8dbdf3338440145c,1,6,4,10,3,2013-04-24 20:38:01,2013-04-24 19:52:17
8cc2ab561ec1a6d011c44c7b8dbdf3338440145c...c4012da4e1458efdf6710aea54839dba18067332,2,0,6,6,2,2013-04-24 20:50:12,2013-04-11 23:00:00
c4012da4e1458efdf6710aea54839dba18067332...55a88023b6389af96927b5eb7fc48c8bbf00b8d9,1,18,22,40,14,2013-04-24 20:50:12,2013-04-10 17:35:46
55a88023b6389af96927b5eb7fc48c8bbf00b8d9...79f7a94c8f3d79b0a0a26646ec215e1096b663da,2,83,57,140,47,2013-04-24 20:55:39,2013-04-10 22:32:29
79f7a94c8f3d79b0a0a26646ec215e1096b663da...6cea3cbbca67f682d16b93a50f9a90a4b7f2b405,2,10,1,11,2,2013-04-24 20:55:39,2013-04-10 22:40:56
6cea3cbbca67f682d16b93a50f9a90a4b7f2b405...dccfd557ce411b890b708cbc259a14e023263a8e,5,96,42,138,38,2013-04-24 20:59:03,2013-04-11 22:20:33
dccfd557ce411b890b708cbc259a14e023263a8e...98bff7f2bb292ae7723412fed3acd2ce9931a780,3,54,15,69,10,2013-04-25 14:31:05,2013-04-25 14:31:05
98bff7f2bb292ae7723412fed3acd2ce9931a780...2433c3af1fcd93e73e67f708e7da2410965c8e64,24,250,226,476,92,2013-04-25 19:29:25,2013-04-24 00:31:52
2433c3af1fcd93e73e67f708e7da2410965c8e64...a94c9391ab226fb7e19b2f41a41986b603fcc534,2,65,3,68,3,2013-04-25 19:43:25,2013-04-25 19:43:15
a94c9391ab226fb7e19b2f41a41986b603fcc534...5ae15577b9b341ec782459c975e2f6e8cdf8caf7,1,1,1,2,1,2013-04-25 17:13:16,2013-04-25 17:13:16
5ae15577b9b341ec782459c975e2f6e8cdf8caf7...4996dd6882e46ad4adb743bb98df8cb596165685,1,1,0,1,1,2013-04-25 22:24:58,2013-04-25 22:24:58
4996dd6882e46ad4adb743bb98df8cb596165685...c6a64785eceb702606a18e3910a47fed40e3fe33,12,72,0,72,26,2013-04-26 13:59:24,2013-04-26 13:59:24
c6a64785eceb702606a18e3910a47fed40e3fe33...bc532c817a433d33a9d25d9e48cc1567f303097c,1,4,4,8,4,2013-04-26 15:08:25,2013-04-25 00:04:27
bc532c817a433d33a9d25d9e48cc1567f303097c...128b0cb3b421ec91e93402a5b275b4b97a158eaf,1,19,3,22,3,2013-04-26 15:08:34,2013-04-25 15:33:22
128b0cb3b421ec91e93402a5b275b4b97a158eaf...4a27c920158de92bff2fb4b55bd8c210e0995b39,1,4,17,21,5,2013-04-26 15:45:36,2013-04-02 22:09:37
4a27c920158de92bff2fb4b55bd8c210e0995b39...78177599d1ea6e4e89337e527f50bd84f367ad3c,1,0,1,1,1,2013-04-26 19:12:27,2013-04-26 14:29:10
78177599d1ea6e4e89337e527f50bd84f367ad3c...f432d2ce05e5608f926f2d21cb345f84cb2445b0,2,20,1,21,4,2013-04-26 19:58:35,2013-04-26 16:50:27
f432d2ce05e5608f926f2d21cb345f84cb2445b0...12dd5bcedc0a36bb82a8093ed1bc8f036160173f,1,25,20,45,3,2013-04-27 00:39:55,2013-04-17 20:42:27
12dd5bcedc0a36bb82a8093ed1bc8f036160173f...2d38469a02bbe1d171d7ba789aefd94245af303c,1,95,39,134,11,2013-04-27 00:39:55,2013-04-19 15:48:10
2d38469a02bbe1d171d7ba789aefd94245af303c...8376a849147d9a56cd46b71a4fd133e368e70d65,1,21,43,64,10,2013-04-27 00:39:55,2013-04-19 15:52:13
8376a849147d9a56cd46b71a4fd133e368e70d65...fbc18f3f1141373e75042769bc6249ee31c1f317,1,92,52,144,25,2013-04-27 00:42:13,2013-04-19 16:12:05
fbc18f3f1141373e75042769bc6249ee31c1f317...64a28e32e5e0584e12ddecc2b7a967b7b4d109ca,1,62,0,62,1,2013-04-27 00:42:18,2013-04-19 16:21:41
e39e32a60166acb3a9d72b357e00ae292645d01b...bdcc3c3fd1e477df099f818673bab848fcfcba6f,2,11,0,11,3,2013-04-29 03:14:17,2013-04-29 03:14:17
bdcc3c3fd1e477df099f818673bab848fcfcba6f...7f0c71f871e5faa548cb47aee932495694f68244,2,20,3,23,5,2013-04-29 15:14:11,2013-04-25 17:10:00
7f0c71f871e5faa548cb47aee932495694f68244...f58d431f45a0db9812e67641f429c692c3207201,1,0,0,0,0,2013-04-29 18:02:33,2013-04-29 18:02:33
f58d431f45a0db9812e67641f429c692c3207201...b13db37280d9cfca51e1e5e59bf5956295ac61b6,19,118,105,223,28,2013-04-29 18:51:37,2013-04-29 18:02:47
b13db37280d9cfca51e1e5e59bf5956295ac61b6...8d36f78e1b088f2a8741a58826969a70b8e296ba,2,0,151,151,2,2013-04-29 18:51:37,2013-04-29 18:21:43
8d36f78e1b088f2a8741a58826969a70b8e296ba...bc99c890539b16a7f2d783d40d74bc64e756295d,1,2,0,2,1,2013-04-29 18:53:43,2013-04-29 18:52:03
bc99c890539b16a7f2d783d40d74bc64e756295d...b4ee2f8e1691d54391362513598d02fcf1f7aa82,2,2,6,8,2,2013-04-29 19:18:25,2013-04-29 19:17:59
b4ee2f8e1691d54391362513598d02fcf1f7aa82...ddd82aecad2179230b487285d6e081424550b7d8,4,91,3,94,8,2013-04-29 19:18:49,2013-04-29 19:18:49
ddd82aecad2179230b487285d6e081424550b7d8...c2519352ea7c2eefa7e747ce8d3ada1005683f39,1,21,14,35,15,2013-04-29 19:24:14,2013-04-29 19:24:14
c2519352ea7c2eefa7e747ce8d3ada1005683f39...f967fcf9df2127c90c3023a62c63070273a204f2,1,16,9,25,7,2013-04-29 21:32:57,2013-04-29 21:32:57
f967fcf9df2127c90c3023a62c63070273a204f2...1bba08742e836118267f4162a36cbbc222b445fd,1,7,2,9,3,2013-04-29 21:40:19,2013-04-29 21:40:19
1bba08742e836118267f4162a36cbbc222b445fd...dab9c1a25454c06a5dd94eb093a0d2a64bf9d9d3,21,996,996,1992,791,2013-04-29 21:46:24,2013-04-29 21:46:24
dab9c1a25454c06a5dd94eb093a0d2a64bf9d9d3...60a1d258892f09572a0b6bb7507381f2086b1887,1,1,1,2,1,2013-04-30 03:38:01,2013-04-30 03:38:01
60a1d258892f09572a0b6bb7507381f2086b1887...62ce2b986cc35eecf43a2e35d3361bbf30329a2e,2,48,2,50,4,2013-04-30 12:26:20,2013-04-29 17:34:43
62ce2b986cc35eecf43a2e35d3361bbf30329a2e...469b45cb1de52a6293c8b0d55b3ad27261b0d96f,1,17,15,32,6,2013-04-30 13:42:41,2013-04-30 13:42:41
469b45cb1de52a6293c8b0d55b3ad27261b0d96f...5de75658007c491c8f3c53d2e52fd4f21adff02f,12,502,0,502,30,2013-04-30 13:52:38,2013-04-30 13:52:38
5de75658007c491c8f3c53d2e52fd4f21adff02f...deee10f83dcb62bd6dd2808850fe59618449756e,1,12,2,14,1,2013-04-30 15:41:47,2013-04-04 20:31:06
deee10f83dcb62bd6dd2808850fe59618449756e...41198192d48e3324b6ff804bf042446debc863da,1,1,1,2,1,2013-04-30 15:46:06,2013-04-30 15:45:53
41198192d48e3324b6ff804bf042446debc863da...8746fa436394d630efec6ee1f4788c932dabb698,1,1,2,3,2,2013-04-30 15:58:46,2013-04-30 15:58:46
8746fa436394d630efec6ee1f4788c932dabb698...9dfa3ef7fdcf7c8a156f0717814c3cac3bf58948,1,12,14,26,4,2013-04-30 17:49:39,2013-04-25 22:10:16
9dfa3ef7fdcf7c8a156f0717814c3cac3bf58948...318326dfa3c57c369d8d2987bda7cc68e5e5b28a,1,12,1,13,4,2013-04-30 17:49:39,2013-04-25 22:03:59
318326dfa3c57c369d8d2987bda7cc68e5e5b28a...fc65245aa15da959d628d79b579a8c18c3f8740c,1,1,2,3,1,2013-04-30 19:33:16,2013-04-30 19:33:00
fc65245aa15da959d628d79b579a8c18c3f8740c...bc7aee5b23c1b467638d8e1cb2171a2d0d2af994,5,101,2,103,8,2013-04-30 19:58:08,2013-04-26 15:55:36
bc7aee5b23c1b467638d8e1cb2171a2d0d2af994...1567ed66bcda61e4113ddc131e2f6f381d05ed0f,4,15,8,23,7,2013-04-30 20:41:13,2013-04-30 16:37:06
1567ed66bcda61e4113ddc131e2f6f381d05ed0f...aa2f7bbbce08723d93d9e5eeb9b1f2c343d2155a,1,2,3,5,3,2013-05-01 13:25:03,2013-05-01 13:25:03
aa2f7bbbce08723d93d9e5eeb9b1f2c343d2155a...aadb0e411e3b5f49a825c7200662f9735070abb5,1,2,1,3,1,2013-05-01 14:10:19,2013-05-01 14:10:13
aadb0e411e3b5f49a825c7200662f9735070abb5...1cbde06d282f8b380f2cc33cddc345686c9398ca,1,3,3,6,3,2013-05-01 14:38:16,2013-05-01 14:37:40
1cbde06d282f8b380f2cc33cddc345686c9398ca...5d675c8855d6d7c7ed0faea97b143ea4243a5cc5,2,65,14,79,6,2013-05-01 19:07:20,2013-05-01 19:07:20
5d675c8855d6d7c7ed0faea97b143ea4243a5cc5...340ccbb1cced25e5e9e9b33ede652b728134d50b,1,27,23,50,12,2013-05-01 19:39:43,2013-05-01 17:54:20
340ccbb1cced25e5e9e9b33ede652b728134d50b...8495b3f9a90bd4cdba72e4a91d679923c0f2532f,1,1,1,2,1,2013-05-01 19:52:53,2013-05-01 19:32:13
8495b3f9a90bd4cdba72e4a91d679923c0f2532f...ac40858f0544316cefce19201b65a6521b8960e3,2,27,11,38,5,2013-05-01 20:19:18,2013-04-29 15:46:10
ac40858f0544316cefce19201b65a6521b8960e3...8d420461fee37608b064841327a032bb90ec610c,2,12,4,16,2,2013-05-01 20:19:18,2013-04-23 01:51:44
8d420461fee37608b064841327a032bb90ec610c...99e6e03543459cf6c4fea61dc6d3c9b4b2ba5ed3,3,0,8,8,3,2013-05-01 23:03:52,2013-05-01 22:09:56
99e6e03543459cf6c4fea61dc6d3c9b4b2ba5ed3...c6c0d83535b3bce3c43c26a0aeef7cdb2e82561e,1,1,1,2,1,2013-05-02 12:23:05,2013-05-02 12:22:57
c6c0d83535b3bce3c43c26a0aeef7cdb2e82561e...623683b0f717769626381f4d3fb6f62170ffd137,1,1,1,2,1,2013-05-02 18:34:02,2013-05-02 18:34:02
623683b0f717769626381f4d3fb6f62170ffd137...fc76b559266c4e2aee0707e6d640c08d20ff9e55,2,21,4,25,4,2013-05-02 19:39:37,2013-04-29 19:22:03
fc76b559266c4e2aee0707e6d640c08d20ff9e55...41a2d01e419cabd2011ce4ce7262eb8b7181d9e7,43,354,2220,2574,202,2013-05-02 19:57:13,2013-04-29 16:17:05
41a2d01e419cabd2011ce4ce7262eb8b7181d9e7...c81781d4064998e1cd5d98f6e89c9359f2b7e323,34,390,422,812,107,2013-05-02 19:58:09,2013-05-01 14:01:08
c81781d4064998e1cd5d98f6e89c9359f2b7e323...1930908cf3dc4ee2ca5db7b94625338af0cc6d13,1,1,1,2,1,2013-05-02 20:41:30,2013-05-02 20:41:30
1930908cf3dc4ee2ca5db7b94625338af0cc6d13...07e478d1a8d9fced5aa7fc5e1e079569368dce2c,1,7,1,8,2,2013-05-02 22:56:40,2013-05-01 23:15:54
07e478d1a8d9fced5aa7fc5e1e079569368dce2c...cde4c355c2ae85ed6b06cef3a1d1b6e121c20206,13,288,223,511,70,2013-05-02 22:56:40,2013-05-01 23:22:23
cde4c355c2ae85ed6b06cef3a1d1b6e121c20206...e801393010fa3c432451ef5173b3347fa6c3bf1b,1,15,0,15,2,2013-05-02 22:59:12,2013-04-26 17:22:04
e801393010fa3c432451ef5173b3347fa6c3bf1b...5c559ec6797fc3e4508acaea8ca3b28f4e37bd3c,1,1,1,2,1,2013-05-02 22:59:12,2013-04-30 01:09:19
5c559ec6797fc3e4508acaea8ca3b28f4e37bd3c...2daa35d735fad02c9e902842f63f6b83724fbd98,1,7,0,7,2,2013-05-02 22:59:12,2013-04-30 15:22:54
2daa35d735fad02c9e902842f63f6b83724fbd98...6aa444a46d2e5457c0fe185d323a6d328cfcde28,16,66,366,432,132,2013-05-03 08:17:29,2013-05-03 08:17:29
6aa444a46d2e5457c0fe185d323a6d328cfcde28...a9adef030bde00e872ee46e0ae5caec60a97a50e,3,18,6,24,7,2013-05-03 15:11:51,2013-05-02 21:47:26
a9adef030bde00e872ee46e0ae5caec60a97a50e...e9f02a3676d816bf1b0190fcb83f8a6b6576e4c2,1,4,4,8,4,2013-05-03 15:30:13,2013-05-03 14:27:07
e9f02a3676d816bf1b0190fcb83f8a6b6576e4c2...8f34ccaa990b80cef9935fcdda844add6f881fac,2,28,5,33,6,2013-05-03 20:19:02,2013-05-03 19:44:54
8f34ccaa990b80cef9935fcdda844add6f881fac...d00de7fe0c6a0c4277193b5919d67c1c8a01d03f,1,5,0,5,1,2013-05-03 20:19:02,2013-04-19 22:17:57
d00de7fe0c6a0c4277193b5919d67c1c8a01d03f...910e8b536d22652db899247fe785be69e8b87880,7,364,39,403,55,2013-05-03 21:31:45,2013-04-11 01:38:24
910e8b536d22652db899247fe785be69e8b87880...b035c96d7b62af53aceb6484795a5369f9945db6,4,247,2,249,5,2013-05-03 21:31:46,2013-04-16 14:40:35
b035c96d7b62af53aceb6484795a5369f9945db6...d7ee127e58019c7c1e11f2685d0e905145244729,1,0,15,15,3,2013-05-03 21:48:22,2013-05-03 21:48:22
d7ee127e58019c7c1e11f2685d0e905145244729...fc5824e28527db3386aa6c3282641d1982512cd0,1,1,1,2,1,2013-05-04 02:31:55,2013-05-04 02:31:55
fc5824e28527db3386aa6c3282641d1982512cd0...3ae448651d896bcf939d01dff2892329fab63302,8,152,0,152,28,2013-05-04 11:15:31,2013-05-04 11:15:31
3ae448651d896bcf939d01dff2892329fab63302...c18c7b22d8709dc63498eb38af0d6eda2d337de6,2,40,0,40,5,2013-05-06 14:37:32,2013-05-06 14:37:32
c18c7b22d8709dc63498eb38af0d6eda2d337de6...10c5bd34f4973aae49e6f89fcb939f9b9e9318a7,2,15,0,15,2,2013-05-06 14:48:15,2013-05-06 14:46:42
10c5bd34f4973aae49e6f89fcb939f9b9e9318a7...a6dab30a41f5a4a7cb2ed64e534eb2bd6b2a8d97,1,37,24,61,15,2013-05-06 14:48:15,2013-05-06 14:40:27
a6dab30a41f5a4a7cb2ed64e534eb2bd6b2a8d97...d6a2d8027f1cbc684d960b8f522e3ffb4043d6d2,4,912,0,912,6,2013-05-06 14:48:15,2013-05-06 14:42:54
d6a2d8027f1cbc684d960b8f522e3ffb4043d6d2...ed3efe444510137cc45e11188e23680656e22ead,27,1649,294,1943,252,2013-05-06 15:22:54,2013-05-06 15:22:54
ed3efe444510137cc45e11188e23680656e22ead...40faa8d4027af5ccee00705eb2ac6b92bb44f182,1,2,2,4,2,2013-05-06 18:34:29,2013-05-06 18:33:17
40faa8d4027af5ccee00705eb2ac6b92bb44f182...19f0bbbd98ed9e8fdcbde1a855445aa678e50abb,1,0,0,0,0,2013-05-06 19:27:43,2013-05-06 19:27:43
19f0bbbd98ed9e8fdcbde1a855445aa678e50abb...f2bf885d383cab8d4c035abb3a6b5c7ce759c563,4,35,9,44,12,2013-05-06 20:40:04,2013-04-30 16:04:06
f2bf885d383cab8d4c035abb3a6b5c7ce759c563...015efa9f9ff01cb429d16a150370a1c2a7019a6e,3,3,3,6,3,2013-05-06 22:37:51,2013-05-06 22:37:35
015efa9f9ff01cb429d16a150370a1c2a7019a6e...f05861f99a1b675b47927b9e6aa9576b9cc3bb45,3,37,0,37,3,2013-05-07 00:00:53,2013-05-06 21:21:27
f05861f99a1b675b47927b9e6aa9576b9cc3bb45...34703211e2b2a9680404d1637f96a112cbe36539,3,33,0,33,3,2013-05-07 00:00:53,2013-05-06 21:19:03
34703211e2b2a9680404d1637f96a112cbe36539...07a0439411607c5b2095b3379cbbdfb08ee3b318,3,16,16,32,15,2013-05-07 00:00:54,2013-05-06 16:19:47
07a0439411607c5b2095b3379cbbdfb08ee3b318...a26354ff10fc029f9f2832ec844d2a57706d2307,1,48,11,59,5,2013-05-07 00:00:54,2013-05-06 15:27:21
a26354ff10fc029f9f2832ec844d2a57706d2307...cee7ec3cbfbc26b7a765f43d74d51e2a5b7630fa,1,8,8,16,8,2013-05-07 10:12:38,2013-05-07 10:12:38
cee7ec3cbfbc26b7a765f43d74d51e2a5b7630fa...520c0e117c639c65fce53c6df4de3159b62f3874,12,352,16,368,48,2013-05-07 10:15:34,2013-05-07 10:15:34
520c0e117c639c65fce53c6df4de3159b62f3874...e3512ba585065163d7e7a87e6431461a0976d11a,4,722,0,722,5,2013-05-07 13:24:31,2013-05-07 13:24:31
e3512ba585065163d7e7a87e6431461a0976d11a...da0962ca3d509a2d93b2140ac1508fa2fbdf04d5,1,1,14,15,3,2013-05-07 13:26:58,2013-05-07 13:26:58
da0962ca3d509a2d93b2140ac1508fa2fbdf04d5...a32e09e46f2bbb5237cb49b22deb59f03d64d832,8,84,0,84,16,2013-05-07 16:25:02,2013-05-07 16:25:02
a32e09e46f2bbb5237cb49b22deb59f03d64d832...5c2de15471b7485a37290828dbdee97f068424e8,1,3,3,6,3,2013-05-07 16:28:32,2013-05-07 11:23:40
5c2de15471b7485a37290828dbdee97f068424e8...6932776c728f65860c88813626efe94513fbf83b,2,15,0,15,2,2013-05-07 16:37:37,2013-05-07 16:31:14
6932776c728f65860c88813626efe94513fbf83b...3049ab5ae2b3e672f17a001be0f7cdf7e599a9fb,4,750,0,750,5,2013-05-07 21:18:30,2013-05-06 21:22:08
3049ab5ae2b3e672f17a001be0f7cdf7e599a9fb...a0c85678a66bac82ee4d7766f2f80f48408128c3,8,1518,1426,2944,26,2013-05-08 03:13:19,2013-05-07 13:56:29
a0c85678a66bac82ee4d7766f2f80f48408128c3...35e454e42e683ba663293c1305817cb17e6cab16,3,59,49,108,5,2013-05-08 03:13:19,2013-05-07 19:06:41
35e454e42e683ba663293c1305817cb17e6cab16...24972756065eb5c281c6e89fe963daef2f5015a8,4,78,1,79,6,2013-05-08 03:13:19,2013-05-07 19:54:10
24972756065eb5c281c6e89fe963daef2f5015a8...38a311afb70d4abf940b3c23c479d2c46ee59eac,7,31,155,186,33,2013-05-08 03:13:20,2013-05-07 20:33:09
38a311afb70d4abf940b3c23c479d2c46ee59eac...7490373462b0d3dd475b99252d7d0a14f3c69c4b,4,81,52,133,7,2013-05-08 03:13:20,2013-05-07 21:57:02
7490373462b0d3dd475b99252d7d0a14f3c69c4b...9f43fb9a79e91928d20b2c1053bd42c0754db589,3,173,0,173,5,2013-05-08 03:34:50,2013-05-06 21:18:25
9f43fb9a79e91928d20b2c1053bd42c0754db589...8540c7ffb60c49534779c423e066e1e47d6962c4,3,93,59,152,6,2013-05-08 03:34:50,2013-05-07 15:15:47
8540c7ffb60c49534779c423e066e1e47d6962c4...c13d75db43b76a51e96dc61c70fecb75bdaccf70,2,14,4,18,8,2013-05-08 03:34:50,2013-05-07 19:54:37
c13d75db43b76a51e96dc61c70fecb75bdaccf70...dcafb509e762b6a89905aa29505e5fabc94836fe,16,179,0,179,34,2013-05-08 12:10:31,2013-05-08 12:10:31
dcafb509e762b6a89905aa29505e5fabc94836fe...54dcb6d9f55d3f97ccdcaf656231f580f08c564d,1,18,18,36,8,2013-05-08 12:17:05,2013-05-08 12:16:34
54dcb6d9f55d3f97ccdcaf656231f580f08c564d...8717760ee798be768e456d266616fba9da33f3a8,1,3,3,6,2,2013-05-08 14:50:13,2013-05-08 14:50:13
8717760ee798be768e456d266616fba9da33f3a8...25f2dfea762ebbaca65bd30d86429699b8a5da85,1,7,6,13,3,2013-05-08 17:20:22,2013-05-08 16:59:51
25f2dfea762ebbaca65bd30d86429699b8a5da85...95e8fd9ac9811a64e62dfc6b560bc871e6c244d7,2,31,33,64,6,2013-05-08 17:55:38,2013-05-08 17:54:12
95e8fd9ac9811a64e62dfc6b560bc871e6c244d7...fbadbba833f283a846d3f9ac03f765ef9d0b9b97,1,5,1,6,1,2013-05-08 18:45:33,2013-05-08 17:05:10
fbadbba833f283a846d3f9ac03f765ef9d0b9b97...a2c6dd27a07f6e4acfe80156c36eb6448ac205a4,4,87,78,165,27,2013-05-08 18:50:52,2013-05-08 15:01:57
a2c6dd27a07f6e4acfe80156c36eb6448ac205a4...c6f9272a9e2b77f8f1ea9298a2df9504e30e4c5a,2,21,23,44,9,2013-05-08 19:11:00,2013-05-08 19:11:00
c6f9272a9e2b77f8f1ea9298a2df9504e30e4c5a...0ecc01dfd716d73e47e1af7290496a60db1373c0,1,4,4,8,4,2013-05-08 19:58:26,2013-05-08 17:38:43
0ecc01dfd716d73e47e1af7290496a60db1373c0...9e06e7a9a31a1be892e2b891da86ff02e875c6b2,1,1,7,8,2,2013-05-08 21:21:45,2013-05-08 15:28:09
9e06e7a9a31a1be892e2b891da86ff02e875c6b2...1a4afe2906e385f0f4772a7f36ecb7fe5170cb1f,1,1,1,2,1,2013-05-08 21:24:45,2013-05-08 14:40:03
1a4afe2906e385f0f4772a7f36ecb7fe5170cb1f...5e4e9ad9c5672789c984f17fd3f235d78fa7f5a3,1,0,2,2,1,2013-05-08 22:24:09,2013-05-08 22:06:50
5e4e9ad9c5672789c984f17fd3f235d78fa7f5a3...fc47942cd0894c38bab27f7dc95f6257ee070589,4,746,0,746,5,2013-05-09 02:43:17,2013-05-07 14:18:55
fc47942cd0894c38bab27f7dc95f6257ee070589...aabd44b8d65f7da5cff8362fbb1c1d6ecf869cbf,1,10,2,12,3,2013-05-09 02:43:17,2013-05-08 21:48:39
aabd44b8d65f7da5cff8362fbb1c1d6ecf869cbf...17760c3589ca368c00ed3f16aec0c9d6e1c2c6ea,1,10,11,21,6,2013-05-09 02:43:17,2013-05-08 21:49:45
17760c3589ca368c00ed3f16aec0c9d6e1c2c6ea...1df1d5e6e8503c2092fc6ff648f4547b2444a745,8,84,0,84,16,2013-05-09 07:15:34,2013-05-09 07:15:34
1df1d5e6e8503c2092fc6ff648f4547b2444a745...0078fb7d2bc7cb352df42524399276fa51b7b110,1,0,1,1,1,2013-05-09 14:04:30,2013-05-08 16:13:12
0078fb7d2bc7cb352df42524399276fa51b7b110...f41cc12bf4672528f513fb81f1fab4b4b379ae83,3,52,0,52,4,2013-05-09 14:16:55,2013-05-08 14:22:47
f41cc12bf4672528f513fb81f1fab4b4b379ae83...3893e7ff97d576652756456fafba2936092e15ce,22,702,484,1186,243,2013-05-09 14:16:55,2013-05-08 14:26:44
3893e7ff97d576652756456fafba2936092e15ce...82052a817a3690e0ef5419c46c82845c5334998a,4,13,4,17,8,2013-05-09 14:16:55,2013-05-08 14:52:01
82052a817a3690e0ef5419c46c82845c5334998a...1cd527fc703a8a568990f84585973c3e9e292075,9,65,57,122,53,2013-05-09 14:16:55,2013-05-08 15:30:10
1cd527fc703a8a568990f84585973c3e9e292075...b326df258988f9f7d91dcbe77440ab3c365bc3da,2,6,6,12,6,2013-05-09 14:16:55,2013-05-08 15:33:28
b326df258988f9f7d91dcbe77440ab3c365bc3da...5638031288f5dc8069dee5bebb02a7698d39ee75,3,20,6,26,5,2013-05-09 14:16:55,2013-05-08 15:56:39
5638031288f5dc8069dee5bebb02a7698d39ee75...6472047433c187351ab83ca98586ecd0fb6cb480,1,4,2,6,1,2013-05-09 14:16:55,2013-05-08 15:57:18
6472047433c187351ab83ca98586ecd0fb6cb480...f965a97f3077be56bc0423d851dc1e3aeee4c0b5,5,10,21,31,7,2013-05-09 14:16:55,2013-05-08 15:57:42
f965a97f3077be56bc0423d851dc1e3aeee4c0b5...0ee3411cf465a49dcac6b0146557cb5c9e2ea430,6,12,18,30,13,2013-05-09 14:16:55,2013-05-08 16:06:17
0ee3411cf465a49dcac6b0146557cb5c9e2ea430...7008c37d48aa8893a4b79abd2ecca9699d8ee7d0,4,84,33,117,16,2013-05-09 15:06:38,2013-05-09 15:03:52
7008c37d48aa8893a4b79abd2ecca9699d8ee7d0...099a809c44237f1e57fae6395c34f58aa369e592,12,48,0,48,24,2013-05-09 17:02:54,2013-05-09 17:02:54
099a809c44237f1e57fae6395c34f58aa369e592...d40ecc33a18354ecc0f76e1b0e23468fa6ecd677,2,10,10,20,2,2013-05-09 17:08:10,2013-05-09 17:07:21
d40ecc33a18354ecc0f76e1b0e23468fa6ecd677...5edcd2c959475f6eab14d90e16d6386610bc5563,1,2,2,4,2,2013-05-09 17:12:22,2013-05-09 17:12:22
5edcd2c959475f6eab14d90e16d6386610bc5563...a937738e08477f2b3e8b27a796bc556e71b47ae4,1,5,2,7,1,2013-05-09 17:29:22,2013-05-09 17:29:21
a937738e08477f2b3e8b27a796bc556e71b47ae4...c37f75c550b80eb060cb6f69bc9c3997532e6104,1,5,5,10,1,2013-05-09 18:49:21,2013-05-09 18:49:21
c37f75c550b80eb060cb6f69bc9c3997532e6104...61b8f72884dc6fee89b91a30021f41e50cb9de0e,13,420,16,436,30,2013-05-09 21:28:33,2013-03-28 20:26:16
61b8f72884dc6fee89b91a30021f41e50cb9de0e...6f50df12631a01a1e742eee747b4e5a487af4816,1,9,1,10,3,2013-05-09 21:28:34,2013-05-09 17:04:41
6f50df12631a01a1e742eee747b4e5a487af4816...e54e86b4d3c36f6762ff63c03d824b1eaec0c2df,1,4,1,5,1,2013-05-09 21:28:34,2013-05-09 19:09:58
e54e86b4d3c36f6762ff63c03d824b1eaec0c2df...10a960aebd1e9eba978578377139fabb4b7dbeef,1,1,1,2,1,2013-05-10 14:16:20,2013-05-10 14:16:20
10a960aebd1e9eba978578377139fabb4b7dbeef...f10527979b27da40fe23a4f2a5a75243b588d808,1,2,2,4,2,2013-05-10 15:25:13,2013-05-10 15:25:13
f10527979b27da40fe23a4f2a5a75243b588d808...c4f5c81aa05abe1cddc0ed5b7a3912a7ebbc048f,2,9,9,18,6,2013-05-10 15:57:36,2013-05-10 15:57:27
c4f5c81aa05abe1cddc0ed5b7a3912a7ebbc048f...2d74c9110eb7a6cc173bb1edb02ec4f91eca56b7,1,1,2,3,1,2013-05-10 16:53:13,2013-05-10 16:53:13
2d74c9110eb7a6cc173bb1edb02ec4f91eca56b7...9a1b92102088670581bc0e8e522465b2a3d359e0,1,1,1,2,2,2013-05-10 17:00:48,2013-05-10 17:00:48
9a1b92102088670581bc0e8e522465b2a3d359e0...465b5587980f77ddd0685fbb5ba9cf95d109c324,1,0,1,1,1,2013-05-10 17:11:25,2013-05-10 17:11:25
465b5587980f77ddd0685fbb5ba9cf95d109c324...bfede8d086719ace81c92bfc1560b170c81637b0,1,8,1,9,1,2013-05-10 20:11:08,2013-05-10 20:11:01
bfede8d086719ace81c92bfc1560b170c81637b0...b855bbd70638aa284ed4c80c8166b11989de2af8,1,3,1,4,1,2013-05-10 20:11:51,2013-05-10 20:02:12
b855bbd70638aa284ed4c80c8166b11989de2af8...c7469639d98b26ac8376bac7662d717b5b0129b0,1,1,1,2,1,2013-05-10 20:11:51,2013-05-10 20:09:18
c7469639d98b26ac8376bac7662d717b5b0129b0...91b011415532da47cb67fdd221480a25d6e0ae45,3,40,5,45,3,2013-05-10 20:49:01,2013-05-06 22:25:04
91b011415532da47cb67fdd221480a25d6e0ae45...3ace688b3b2830450c522d5be94d453fd0382e5d,12,494,0,494,66,2013-05-11 12:24:53,2013-05-11 12:24:53
3ace688b3b2830450c522d5be94d453fd0382e5d...726169ccf9bfe49560e940617ad15e9434d331ed,4,48,7,55,11,2013-05-13 05:29:46,2013-05-13 05:29:46
726169ccf9bfe49560e940617ad15e9434d331ed...7e6dd638c57798a87d93f29d699c72f51268a4e7,1,14,2,16,2,2013-05-13 15:12:02,2013-05-13 15:12:02
7e6dd638c57798a87d93f29d699c72f51268a4e7...9c046fbf99aada223f2d4d26e331cff0eddc0b98,1,5,5,10,5,2013-05-13 17:58:44,2013-05-13 17:58:39
9c046fbf99aada223f2d4d26e331cff0eddc0b98...f2c59cd1fabc8c5e6a5311c16943b6d4ca4325c0,1,7,1,8,1,2013-05-13 19:45:31,2013-05-13 19:45:31
9c046fbf99aada223f2d4d26e331cff0eddc0b98...a13b441926ada81d805172aa94243164858c012f,2,11,3,14,3,2013-05-13 18:26:16,2013-05-13 16:30:49
a13b441926ada81d805172aa94243164858c012f...24fd0ec8b02ee86f9d11bf4a6cbf04aae42ccf65,2,28,2,30,4,2013-05-13 19:18:10,2013-05-13 19:04:30
24fd0ec8b02ee86f9d11bf4a6cbf04aae42ccf65...08a2fa3f08f72f02958c5a7128121f7e75ce602e,2,2,28,30,4,2013-05-13 19:48:34,2013-05-13 19:48:34
08a2fa3f08f72f02958c5a7128121f7e75ce602e...ae40ceb967a9b0f1d936ebe2e3594ee6b99ce24f,2,19,11,30,8,2013-05-13 21:02:27,2013-05-09 18:55:47
ae40ceb967a9b0f1d936ebe2e3594ee6b99ce24f...44d7bce7f7bc775bd8b6c513942fc9eb88baeb59,8,702,8,710,15,2013-05-13 21:02:42,2013-04-23 20:35:16
44d7bce7f7bc775bd8b6c513942fc9eb88baeb59...656f118b9e968161c7eabe3a3bc0d31b59568065,2,68,4,72,12,2013-05-13 21:02:42,2013-05-03 21:21:27
656f118b9e968161c7eabe3a3bc0d31b59568065...acc084a6dc24a4de55c0727cb536aad299338228,2,3,6,9,5,2013-05-13 21:02:42,2013-05-03 22:51:46
acc084a6dc24a4de55c0727cb536aad299338228...439df8fff2e5b3140bf7d32393ce4a18cf5fd876,4,136,105,241,29,2013-05-13 21:02:42,2013-05-07 16:44:53
439df8fff2e5b3140bf7d32393ce4a18cf5fd876...52f8a9555f4dd71a7787d4a7a1412a9e5e8415a2,2,200,13,213,14,2013-05-13 21:02:42,2013-05-07 18:29:12
52f8a9555f4dd71a7787d4a7a1412a9e5e8415a2...94bee44f5a29e75d3023e4e912e33787d9d55f14,1,36,2,38,6,2013-05-13 21:02:42,2013-05-07 19:56:32
94bee44f5a29e75d3023e4e912e33787d9d55f14...8f6c8eebf6d50b1289df4d0d5a45ddfb22686867,2,265,258,523,68,2013-05-13 21:02:42,2013-05-07 20:20:45
8f6c8eebf6d50b1289df4d0d5a45ddfb22686867...2292e85c93ad9492e0fc7c832cd2c1940fca1f84,1,20,3,23,6,2013-05-13 21:02:42,2013-05-07 21:05:48
2292e85c93ad9492e0fc7c832cd2c1940fca1f84...0ac841b08d432215df396080fd2079c084dcb8d0,2,22,9,31,3,2013-05-13 21:02:42,2013-05-08 18:50:07
0ac841b08d432215df396080fd2079c084dcb8d0...f96061127a185a7cbb0d1e384960855687ecd8a1,2,507,17,524,12,2013-05-13 21:02:42,2013-05-09 21:07:54
f96061127a185a7cbb0d1e384960855687ecd8a1...1114629755f2ef3ea4c98e2109ee261e14e78699,2,26,7,33,6,2013-05-13 21:02:42,2013-05-10 22:57:50
1114629755f2ef3ea4c98e2109ee261e14e78699...a2f1bd875b81802e05575076262fe84c551470ab,1,0,43,43,1,2013-05-13 21:02:42,2013-05-13 17:14:08
a2f1bd875b81802e05575076262fe84c551470ab...a2266610781e1c8abea3a2f6269c5d93d9226d6d,1,3,3,6,2,2013-05-13 22:33:41,2013-05-13 22:06:43
a2266610781e1c8abea3a2f6269c5d93d9226d6d...a7c21d7416d0c80e35e34baeed6040710de1ebd4,1,3,3,6,3,2013-05-13 22:54:28,2013-05-13 22:52:43
a7c21d7416d0c80e35e34baeed6040710de1ebd4...62fec3e663bf160aafc7663bb5b35a28da314fc2,2,157,128,285,17,2013-05-13 23:06:08,2013-05-13 23:04:53
62fec3e663bf160aafc7663bb5b35a28da314fc2...896e1bf419b6795f4cafd78d80d7be28bb99acf1,2,18,6,24,9,2013-05-14 01:52:00,2013-05-13 20:28:41
896e1bf419b6795f4cafd78d80d7be28bb99acf1...930e6ca8fde1e003661ee4370b88ff3b9748a63f,1,5,0,5,2,2013-05-14 01:52:00,2013-05-13 20:29:19
930e6ca8fde1e003661ee4370b88ff3b9748a63f...9c28453d56d3ab69f8cefe85bdc4216de8164906,2,10,1,11,6,2013-05-14 05:22:41,2013-05-14 05:22:41
9c28453d56d3ab69f8cefe85bdc4216de8164906...c934f621261042f3d235a81d16119840991a2ddf,2,64,12,76,21,2013-05-14 05:23:57,2013-05-14 05:23:57
c934f621261042f3d235a81d16119840991a2ddf...73a97bec17f42d2b423e8dd287b8f0f489d18d47,2,12,7,19,6,2013-05-14 05:42:20,2013-05-14 05:42:20
73a97bec17f42d2b423e8dd287b8f0f489d18d47...3ec663b7bbaaeb08886ee1a9da0a853b1925c90e,1,1,1,2,1,2013-05-14 14:54:54,2013-05-14 14:54:54
3ec663b7bbaaeb08886ee1a9da0a853b1925c90e...763c40a81f19c6cd29dfe9c45251abf69e361223,1,1,1,2,1,2013-05-14 17:42:36,2013-05-14 17:22:43
763c40a81f19c6cd29dfe9c45251abf69e361223...3210cf876673fa9ed3a9e56b1f94cc192fa245b5,1,12,4,16,5,2013-05-14 17:46:36,2013-05-14 17:28:59
3210cf876673fa9ed3a9e56b1f94cc192fa245b5...f9f16ce9b2d8e10e641692c6ccdba17f00d2ed19,1,14,2,16,4,2013-05-14 18:05:08,2013-05-14 17:49:03
f9f16ce9b2d8e10e641692c6ccdba17f00d2ed19...c7be8dda6b96a243d264ede977da6e64fdf16c6a,1,8,0,8,4,2013-05-14 18:06:23,2013-05-13 21:40:47
c7be8dda6b96a243d264ede977da6e64fdf16c6a...993fad41bdb155af9606c53accea9f56fa4ec129,1,12,2,14,4,2013-05-14 18:27:14,2013-05-14 17:02:13
993fad41bdb155af9606c53accea9f56fa4ec129...e9048f5943d187bfcbb4138505f09a55c46a0bc4,1,13,6,19,3,2013-05-14 18:37:49,2013-05-09 13:57:37
e9048f5943d187bfcbb4138505f09a55c46a0bc4...72f93e69ede4fb36fb11d2cb79560e98ff37f4a2,1,1,1,2,1,2013-05-14 22:10:32,2013-05-14 21:57:46
72f93e69ede4fb36fb11d2cb79560e98ff37f4a2...f1f5a9538290d0a9e1831da34b70016a2774b40b,1,1,1,2,1,2013-05-14 23:12:52,2013-05-14 23:12:52
f1f5a9538290d0a9e1831da34b70016a2774b40b...f965235efa02833d8055013525ff0433567e0d95,5,110,3,113,7,2013-05-15 13:50:27,2013-05-15 13:50:08
f965235efa02833d8055013525ff0433567e0d95...3972b5c71c32a7db5bf93455d6b83cbff9bef6cd,1,3,0,3,1,2013-05-15 15:13:41,2013-05-15 15:13:41
3972b5c71c32a7db5bf93455d6b83cbff9bef6cd...b4c5ac3579fff46b19b927bf4a51b11cb262fc3a,1,4,1,5,2,2013-05-15 15:26:43,2013-05-15 15:26:32
b4c5ac3579fff46b19b927bf4a51b11cb262fc3a...7030cc8148131c8ac4910dd316929019f1909468,3,36,2,38,5,2013-05-15 18:26:44,2013-05-13 21:25:41
7030cc8148131c8ac4910dd316929019f1909468...e810419be9102315c4b2f0720b2c640ef58827fc,1,1,1,2,1,2013-05-15 18:34:13,2013-05-15 18:34:13
e810419be9102315c4b2f0720b2c640ef58827fc...ce9e5626a8c7c10c4292a20cbaa9ab61888b1064,1,2,2,4,2,2013-05-15 20:40:45,2013-05-15 20:40:45
ce9e5626a8c7c10c4292a20cbaa9ab61888b1064...9df07aa58f54646c0792734d72f0702b41b16ceb,1,11,0,11,1,2013-05-15 21:13:21,2013-05-15 19:50:57
9df07aa58f54646c0792734d72f0702b41b16ceb...f1795a09131e5888572d82da42adc55cef086fbe,1,2,1,3,1,2013-05-16 22:12:09,2013-05-16 22:09:28
f1795a09131e5888572d82da42adc55cef086fbe...03d622614f5539e298b7872f9db8552957b720fa,2,11,0,11,2,2013-05-16 22:16:30,2013-05-16 17:15:29
03d622614f5539e298b7872f9db8552957b720fa...8a59bbfdd1b947ef42de4a1e598c6cc06c459b19,3,38,36,74,14,2013-05-16 22:16:30,2013-05-16 17:17:46
8a59bbfdd1b947ef42de4a1e598c6cc06c459b19...6fa7a15256d8058b982bf259cad34c051c1f245a,4,8,186,194,5,2013-05-16 22:16:30,2013-05-16 19:29:32
6fa7a15256d8058b982bf259cad34c051c1f245a...c2d7507dab8045b6ad1817ecb650f74fe2652af3,2,24,4,28,6,2013-05-16 22:16:30,2013-05-16 19:31:11
c2d7507dab8045b6ad1817ecb650f74fe2652af3...013cc2b1bdfec1a6dfa7251734bb263c9fcbd7d1,2,36,12,48,9,2013-05-16 22:16:30,2013-05-16 19:31:41
013cc2b1bdfec1a6dfa7251734bb263c9fcbd7d1...fe027497e73ea04b82077b9650876c40ea85b6ce,1,6,0,6,1,2013-05-16 22:19:00,2013-05-16 20:00:07
fe027497e73ea04b82077b9650876c40ea85b6ce...3595a3902afc0ca14db1f92ad3f78a23c0d63092,1,2,2,4,1,2013-05-17 13:30:51,2013-05-17 13:30:51
3595a3902afc0ca14db1f92ad3f78a23c0d63092...d5bb16f175a21e45b6a97a3840372df30750396b,1,1,1,2,1,2013-05-17 14:14:16,2013-05-17 14:14:16
d5bb16f175a21e45b6a97a3840372df30750396b...7147f38909978e83f290a31a0b5833b097bab5db,1,5,1,6,1,2013-05-17 14:30:22,2013-05-17 14:30:22
7147f38909978e83f290a31a0b5833b097bab5db...66385352abe589f784b967669d2766929cd1f7fe,1,3,0,3,1,2013-05-17 14:39:10,2013-05-17 14:39:10
66385352abe589f784b967669d2766929cd1f7fe...7e516efc7845f62bd89344d7b2daf17632169660,5,22,56,78,22,2013-05-17 16:25:23,2013-05-17 13:42:29
7e516efc7845f62bd89344d7b2daf17632169660...3bd0695d6d53f2f6d33139086fe45fa6d645de19,1,4,3,7,2,2013-05-17 16:25:23,2013-05-17 16:12:08
3bd0695d6d53f2f6d33139086fe45fa6d645de19...321e6eb0ed18154ea1b7ddbbfbd943189a007d4c,6,27,105,132,15,2013-05-17 16:25:23,2013-05-17 16:15:49
321e6eb0ed18154ea1b7ddbbfbd943189a007d4c...1990f56f85fd5a43bc35fffce028f5ef0d8ebd25,1,13,6,19,4,2013-05-17 16:25:23,2013-05-17 16:17:04
1990f56f85fd5a43bc35fffce028f5ef0d8ebd25...093b50f848078861fba60194d382d4a63bbb590e,1,0,2,2,1,2013-05-17 16:25:23,2013-05-17 16:18:27
093b50f848078861fba60194d382d4a63bbb590e...4e25efbff5ccfe66950600d1004682f5c7fa4c01,1,11,1,12,3,2013-05-17 16:25:23,2013-05-17 16:19:32
4e25efbff5ccfe66950600d1004682f5c7fa4c01...3760b413f72b7ac827d46b35ca0b629fc36063a9,1,10,2,12,1,2013-05-17 16:25:23,2013-05-17 16:19:47
3760b413f72b7ac827d46b35ca0b629fc36063a9...b22d5e5fea99ae7c6a45e930085ec5bbdf707d3c,1,41,13,54,10,2013-05-17 16:25:23,2013-05-17 16:21:35
b22d5e5fea99ae7c6a45e930085ec5bbdf707d3c...f3dc88b8fe956bd9bd26a5329a7b2de694947f52,1,11,0,11,2,2013-05-17 16:25:23,2013-05-17 16:22:08
f3dc88b8fe956bd9bd26a5329a7b2de694947f52...2a8d3e43d57ef46170c14e65de16f9c2c0850d1f,1,2,0,2,1,2013-05-17 16:25:23,2013-05-17 16:22:53
2a8d3e43d57ef46170c14e65de16f9c2c0850d1f...2399a6a4f042f4d247acbdef6139349ff4a9d466,1,2,2,4,2,2013-05-17 16:25:23,2013-05-17 16:23:47
2399a6a4f042f4d247acbdef6139349ff4a9d466...d076a2f8c4c3298da444d942184d8fa06cc0c54f,2,68,22,90,11,2013-05-17 16:25:23,2013-05-17 16:24:12
d076a2f8c4c3298da444d942184d8fa06cc0c54f...d8b717d3dc9bfb8e5e0a6ffac537ccb6243e4aba,1,6,2,8,1,2013-05-18 03:04:14,2013-05-18 03:04:14
d8b717d3dc9bfb8e5e0a6ffac537ccb6243e4aba...380210b574bd967a6c06a8d336a4e8e56c908539,1,20,5,25,6,2013-05-19 14:06:57,2013-05-19 14:06:57
380210b574bd967a6c06a8d336a4e8e56c908539...b15928f4a371b9804cfb419dc64c46677c6c5900,1,1,0,1,1,2013-05-19 15:13:18,2013-05-19 15:13:18
b15928f4a371b9804cfb419dc64c46677c6c5900...f6fb00300c6994fbe79adfbd1b8a0a6cbe44710b,1,9,1,10,3,2013-05-19 15:14:00,2013-05-19 15:14:00
f6fb00300c6994fbe79adfbd1b8a0a6cbe44710b...65c12e6fe156a6e64515a5a6b6ede6bccfb81ca7,1,2,1,3,2,2013-05-19 15:14:41,2013-05-19 15:14:41
65c12e6fe156a6e64515a5a6b6ede6bccfb81ca7...705872c7e387f65a15d4c24163627f65b50be21d,9,64,47,111,14,2013-05-19 23:44:29,2013-05-19 23:44:29
705872c7e387f65a15d4c24163627f65b50be21d...551cb75376b86b059b846f12ad40f0c6bb638c2f,1,21,0,21,1,2013-05-20 01:18:32,2013-05-20 01:18:32
551cb75376b86b059b846f12ad40f0c6bb638c2f...a6323b8f428e8c7dfcd1efe6645b189c3894f03f,1,14,1,15,2,2013-05-20 03:20:24,2013-05-20 03:20:24
a6323b8f428e8c7dfcd1efe6645b189c3894f03f...a90e55ca07a68a3e35aa3e1050ffc774e08697d5,2,2,1,3,2,2013-05-20 04:28:32,2013-05-20 04:28:32
a90e55ca07a68a3e35aa3e1050ffc774e08697d5...638732434565608a1172b472c9703f0e1acf5bdf,3,14,16,30,12,2013-05-20 18:24:00,2013-05-20 18:24:00
638732434565608a1172b472c9703f0e1acf5bdf...8a6823ca8ff9ad7075d4c74e6a21c4360dfc391b,3,20,16,36,3,2013-05-20 18:24:14,2013-05-20 18:24:14
8a6823ca8ff9ad7075d4c74e6a21c4360dfc391b...33130b6e8cebdc007d6a25dc90a4b688e2f57022,2,6,2,8,3,2013-05-20 19:09:26,2013-05-20 19:09:06
33130b6e8cebdc007d6a25dc90a4b688e2f57022...b1702dd5eb1b048cbbdd7e53a5ac1d4cffa24c42,2,2,2,4,2,2013-05-21 13:58:28,2013-05-21 13:58:28
feaec049c81d0b3375d43b88bd48de2df47ecfcb...4e4e740a79e2cc0a0d490dad8d2d3512ee5f81be,1,1,7,8,1,2013-05-21 18:37:55,2013-05-21 18:37:55
4e4e740a79e2cc0a0d490dad8d2d3512ee5f81be...59c64b943afa52b4d837949b1094be1d895bf062,2,2,2,4,2,2013-05-22 17:30:16,2013-05-22 17:30:16
59c64b943afa52b4d837949b1094be1d895bf062...0467aeb4416f82ff18927f3f887cd181073e1db6,11,1381,0,1381,16,2013-05-22 18:08:54,2013-05-07 23:51:11
0467aeb4416f82ff18927f3f887cd181073e1db6...7e47d066ae2a6635815c4f4f26b5ef546c15d6a5,1,10,10,20,6,2013-05-22 18:11:49,2013-05-10 18:17:56
7e47d066ae2a6635815c4f4f26b5ef546c15d6a5...bb8d0b4b30dd45e4f46592e98ea770497a3f4bba,1,4,0,4,2,2013-05-22 18:19:30,2013-05-22 18:19:06
bb8d0b4b30dd45e4f46592e98ea770497a3f4bba...1a21ab350155db13fac0938114dc0b9c8ef81fb9,4,69,24,93,7,2013-05-22 18:24:34,2013-05-16 18:48:27
1a21ab350155db13fac0938114dc0b9c8ef81fb9...f91b4e3e551fda7cbbe43679a5e62742f71f28de,1,0,1,1,1,2013-05-22 18:24:34,2013-05-22 13:26:43
f91b4e3e551fda7cbbe43679a5e62742f71f28de...b22026c9025967522dfaa0c7a1207835df641f49,6,1747,0,1747,7,2013-05-22 18:44:33,2013-05-07 16:57:13
b22026c9025967522dfaa0c7a1207835df641f49...b666da1bcd7e18ecc7067053cd0296dcfa2938c2,2,2,2,4,2,2013-05-22 19:44:48,2013-05-22 19:44:48
b666da1bcd7e18ecc7067053cd0296dcfa2938c2...0f3b3455aad38fb566ca0acbe6e2f83c54315f8f,1,1,5,6,5,2013-05-22 20:31:54,2013-05-09 15:02:17
0f3b3455aad38fb566ca0acbe6e2f83c54315f8f...0b83e1503a77c769bfc3ffbd322ab1bcb847bc88,1,1,1,2,1,2013-05-22 20:31:54,2013-05-13 18:35:30
0b83e1503a77c769bfc3ffbd322ab1bcb847bc88...6e2d2139e7242b0e1b182a258dfba1e7b6924d8b,1,10,2,12,3,2013-05-22 20:31:54,2013-05-16 22:19:27
6e2d2139e7242b0e1b182a258dfba1e7b6924d8b...c4fdee5db93ed24c5dc07c8b44765a4bde214ae8,2,69,0,69,3,2013-05-22 20:31:54,2013-05-09 17:57:03
c4fdee5db93ed24c5dc07c8b44765a4bde214ae8...a283ea34da6f6b64c4c6ddf21e5f6fbe1a4ef4f9,5,805,0,805,6,2013-05-22 20:31:54,2013-05-15 20:49:47
a283ea34da6f6b64c4c6ddf21e5f6fbe1a4ef4f9...98e9bc926749a7096b19c2e1fea636cd96380597,4,734,0,734,6,2013-05-22 20:31:54,2013-05-15 20:56:01
98e9bc926749a7096b19c2e1fea636cd96380597...6a7413d9c28534b0f5e507787ed522c95914df9d,3,35,2,37,4,2013-05-22 20:31:54,2013-05-21 14:14:27
6a7413d9c28534b0f5e507787ed522c95914df9d...cd3548f66b33f019e5c42dbf02d96d4ccf839789,1,2,2,4,1,2013-05-22 20:47:08,2013-05-22 20:46:50
cd3548f66b33f019e5c42dbf02d96d4ccf839789...cf9c3ea82f89136d98fe58fc9a68d0f62f501e20,9,70,341,411,12,2013-05-22 20:51:00,2013-05-22 02:56:51
cf9c3ea82f89136d98fe58fc9a68d0f62f501e20...9fa69b17b9a967ec877211159e7af1aa6b0cf94c,1,1,2,3,2,2013-05-22 20:52:59,2013-05-22 20:52:59
9fa69b17b9a967ec877211159e7af1aa6b0cf94c...47fc9f6809a29713ac7d80a4b318e690906075df,1,3,5,8,3,2013-05-22 21:08:37,2013-05-22 21:08:31
47fc9f6809a29713ac7d80a4b318e690906075df...52e081c9bc5268dddcc3bf7e1df87266d7ea2ec3,13,395,229,624,35,2013-05-22 21:11:28,2013-05-08 21:59:43
52e081c9bc5268dddcc3bf7e1df87266d7ea2ec3...9e29cae9a0293d8aaa31dda4b74e19cbc0ec112a,1,7,0,7,1,2013-05-22 21:11:29,2013-05-13 17:21:34
9e29cae9a0293d8aaa31dda4b74e19cbc0ec112a...9d11c79f61a09496b50ee7e1eee34221b61ea842,13,36,35,71,14,2013-05-22 21:11:29,2013-05-14 14:44:59
9d11c79f61a09496b50ee7e1eee34221b61ea842...83900ac233c2a94e0f3e6a1628cf822f9bb88425,2,13,0,13,3,2013-05-22 21:15:58,2013-05-22 21:15:58
83900ac233c2a94e0f3e6a1628cf822f9bb88425...eb719438afc316e9bf56bf716a129def27f5e768,49,1229,1128,2357,170,2013-05-22 23:14:01,2013-05-14 21:33:25
eb719438afc316e9bf56bf716a129def27f5e768...e4eea0dce2bc4406fa7e7cf55c88db22c1f4d12f,20,10,17,27,20,2013-05-22 23:14:01,2013-05-15 18:48:20
e4eea0dce2bc4406fa7e7cf55c88db22c1f4d12f...070707c4e7cf37384647c0d5728dbdb1815b94d0,16,75,73,148,55,2013-05-22 23:20:55,2013-05-21 22:34:19
070707c4e7cf37384647c0d5728dbdb1815b94d0...86d7443917a1497c9c3294e4b995872e7b85cd7e,1,111,0,111,2,2013-05-22 23:52:25,2013-04-23 23:32:20
86d7443917a1497c9c3294e4b995872e7b85cd7e...214697c86ed2b1cad2a485f7ff810199bd69d674,4,112,82,194,23,2013-05-22 23:52:25,2013-04-24 01:17:54
214697c86ed2b1cad2a485f7ff810199bd69d674...b7c80ec25658288217947e3d4aaf1e27826bb578,2,53,34,87,16,2013-05-22 23:52:25,2013-05-17 15:18:55
b7c80ec25658288217947e3d4aaf1e27826bb578...c3c8ec43d247635a2c6c418ce7f540b2c34390ea,2,13,18,31,6,2013-05-23 14:44:44,2013-05-23 14:44:44
c3c8ec43d247635a2c6c418ce7f540b2c34390ea...23a185462b83a4f0f7ea5f3ada89ff819313c992,4,24,69,93,7,2013-05-23 16:01:49,2013-05-23 16:01:49
23a185462b83a4f0f7ea5f3ada89ff819313c992...c95bf3ff714f9dad17288e3cb8dcfab7d7ebe6fc,6,326,35,361,8,2013-05-23 16:09:58,2013-05-16 22:04:07
c95bf3ff714f9dad17288e3cb8dcfab7d7ebe6fc...6938769d485509434aacf5241b9a4cc14ebdf025,3,64,0,64,3,2013-05-23 16:43:28,2013-05-09 17:00:04
6938769d485509434aacf5241b9a4cc14ebdf025...2c26026c1b2554bc15a9745598d71a10a52b4d21,1,8,3,11,4,2013-05-23 17:08:23,2013-05-17 19:27:33
2c26026c1b2554bc15a9745598d71a10a52b4d21...5269c62430e6aa071b94f22812777d0d205de06b,1,2,2,4,1,2013-05-23 17:12:29,2013-05-23 16:19:46
5269c62430e6aa071b94f22812777d0d205de06b...9b894e349663e4bf10625b0f35844cb63311a10c,4,39,7,46,6,2013-05-23 17:33:47,2013-05-21 21:07:53
9b894e349663e4bf10625b0f35844cb63311a10c...40ee85cfda7ec8047702f9c921278af8e6d9e722,16,2346,376,2722,232,2013-05-23 18:29:15,2013-05-23 18:29:15
40ee85cfda7ec8047702f9c921278af8e6d9e722...42e79743e335e676f560b103da3ce73b5537a468,2,2,2,4,2,2013-05-23 18:38:34,2013-05-23 18:35:16
42e79743e335e676f560b103da3ce73b5537a468...454b52fc53c44b7b5be09ce51c140b501ef98a74,1,66,0,66,1,2013-05-23 19:18:08,2013-05-17 17:15:08
454b52fc53c44b7b5be09ce51c140b501ef98a74...79c14ac356818963e3e12611dad032719de27e0f,32,203,207,410,168,2013-05-23 20:39:14,2013-05-23 18:43:58
79c14ac356818963e3e12611dad032719de27e0f...25dd08970a4cf19364fc2ac7bb8f8d03193bffb5,1,5,6,11,5,2013-05-23 21:00:47,2013-05-23 17:28:15
25dd08970a4cf19364fc2ac7bb8f8d03193bffb5...e3cc63fd27db5f50304d238dfca7ff431ec5d954,2,23,0,23,3,2013-05-24 13:34:43,2013-05-20 14:37:26
e3cc63fd27db5f50304d238dfca7ff431ec5d954...8d62e8af5a55abad7ef7849beaa2f6b5bfa3e8f7,1,44,22,66,25,2013-05-24 15:32:55,2013-05-23 21:15:41
8d62e8af5a55abad7ef7849beaa2f6b5bfa3e8f7...72a3bc4bdf55951e7b482db189b975598bb6866d,4,507,0,507,5,2013-05-24 15:44:38,2013-05-24 15:14:53
72a3bc4bdf55951e7b482db189b975598bb6866d...c5f43cbb26ae515e50043735e3fcea54218584c9,4,573,0,573,5,2013-05-24 15:44:38,2013-05-24 15:44:22
c5f43cbb26ae515e50043735e3fcea54218584c9...d421154b236fb21df4f559ed0f92cbb596d4199f,1,2,2,4,2,2013-05-24 17:40:01,2013-05-24 17:35:47
d421154b236fb21df4f559ed0f92cbb596d4199f...1637fb59af782793af74e561246109adec51f7ab,2,2,24,26,5,2013-05-24 17:44:34,2013-05-24 17:44:30
1637fb59af782793af74e561246109adec51f7ab...d3406f67f03e3e68ae623fd2604d18e028900874,1,4,2,6,1,2013-05-24 20:01:57,2013-05-24 20:01:57
d3406f67f03e3e68ae623fd2604d18e028900874...710b296117ca6f1b8caf1ce24937100f09553506,12,196,28,224,48,2013-05-26 14:19:45,2013-05-26 11:55:11
710b296117ca6f1b8caf1ce24937100f09553506...6d18458b1891ed2c29ab1c498d88cdc8498e7c20,1,1,1,2,1,2013-05-28 16:43:34,2013-05-28 16:41:30
6d18458b1891ed2c29ab1c498d88cdc8498e7c20...60f86587e5f528fc0f5685ce7f9fb25fa415ca2a,3,28,3,31,5,2013-05-28 20:00:39,2013-05-23 21:11:54
60f86587e5f528fc0f5685ce7f9fb25fa415ca2a...e3eee799bb681ec9598fbb093338a0bc29fafc12,1,1,0,1,1,2013-05-29 13:38:46,2013-05-29 13:38:39
e3eee799bb681ec9598fbb093338a0bc29fafc12...3d297a3c3e6cec95003e1c5e2b2ac1c08be6e3c8,1,13,10,23,1,2013-05-29 17:09:02,2013-05-29 15:49:53
3d297a3c3e6cec95003e1c5e2b2ac1c08be6e3c8...9c9b90620c39b2fb461ade6c82716763413bf490,1,10,3,13,3,2013-05-29 18:34:11,2013-05-29 18:33:41
9c9b90620c39b2fb461ade6c82716763413bf490...088557a3cf2b1ed0b6656e0fd9812ca5501e723b,1,1,1,2,1,2013-05-29 18:42:30,2013-05-29 18:42:30
088557a3cf2b1ed0b6656e0fd9812ca5501e723b...135f0fb362efd4be85b422cf386cc26c2cd5d2d5,7,78,7,85,11,2013-05-29 18:47:17,2013-04-09 23:58:21
135f0fb362efd4be85b422cf386cc26c2cd5d2d5...34ee0f47bee10c3e2bddbd8c1c733de5b6b780bc,1,1,0,1,1,2013-05-29 19:10:39,2013-05-02 21:06:48
34ee0f47bee10c3e2bddbd8c1c733de5b6b780bc...913fb476f8691b52c93b3f67e66b598fa02d927b,1,0,1,1,1,2013-05-29 20:35:31,2013-05-29 20:35:31
913fb476f8691b52c93b3f67e66b598fa02d927b...4e53ef60ef44a74114f7d5acc0b15f2ff9d477cf,4,20,14,34,11,2013-05-29 21:07:36,2013-05-27 17:25:29
4e53ef60ef44a74114f7d5acc0b15f2ff9d477cf...15145c5b6a1db46e5246bcb2d63ae6ec3d28b3a5,16,32,0,32,16,2013-05-30 08:47:52,2013-05-30 08:47:52
15145c5b6a1db46e5246bcb2d63ae6ec3d28b3a5...3ad9a467b346a617f318f08479f4d194f50c6bdc,1,23,5,28,8,2013-05-30 08:56:25,2013-05-30 08:56:25
3ad9a467b346a617f318f08479f4d194f50c6bdc...3b1257a5224d1e9df71ee1b4631ca32f2cf438f2,2,2,2,4,2,2013-05-30 09:36:59,2013-05-30 09:36:59
3b1257a5224d1e9df71ee1b4631ca32f2cf438f2...a6d055026c3a13b423e099e9d080256ac040f706,2,5,18,23,8,2013-05-30 15:49:11,2013-05-23 04:04:19
a6d055026c3a13b423e099e9d080256ac040f706...29623818ca553d7231a8eb7274ffb16f233670e8,16,824,304,1128,79,2013-05-30 15:57:22,2013-05-30 15:57:22
29623818ca553d7231a8eb7274ffb16f233670e8...57a80ea1d0ae34124a5c408466834eda31e4578f,2,7,2,9,3,2013-05-30 16:25:11,2013-05-30 16:21:13
57a80ea1d0ae34124a5c408466834eda31e4578f...29112149f51cd3eaa0149ba9d4e16cc935d03b40,12,347,10,357,17,2013-05-30 18:54:35,2013-05-23 20:54:21
29112149f51cd3eaa0149ba9d4e16cc935d03b40...d321ec5375acd7aa0b7abc1c375200c8d955ffb4,4,10,7,17,5,2013-05-30 20:35:24,2013-05-30 18:39:57
d321ec5375acd7aa0b7abc1c375200c8d955ffb4...bb426ee877b62c914931ce49ef12a333f8fabe3e,15,1172,30,1202,30,2013-05-31 01:26:36,2013-05-28 23:02:37
bb426ee877b62c914931ce49ef12a333f8fabe3e...a1725351eabf7ded026c50a474f6e4504fe0f17c,1,1,1,2,1,2013-05-31 01:47:33,2013-05-31 01:47:33
a1725351eabf7ded026c50a474f6e4504fe0f17c...ca6e91b774b575cbba2f7cc50d1f9a107e94efda,12,1086,49,1135,81,2013-05-31 11:39:45,2013-05-31 11:39:45
ca6e91b774b575cbba2f7cc50d1f9a107e94efda...445cb8b8fd98aa30af2b0516d2780b27542681dc,1,31,7,38,14,2013-05-31 13:00:53,2013-05-31 13:00:48
445cb8b8fd98aa30af2b0516d2780b27542681dc...1e872f9b62ca1f83e7878be0395554fa9cb776fc,1,63,0,63,1,2013-05-31 14:29:41,2013-05-31 14:29:36
1e872f9b62ca1f83e7878be0395554fa9cb776fc...f844ed02b1df1b54ea96b6e902cb7ab0663612d8,1,3,2,5,1,2013-05-31 14:40:14,2013-05-31 14:32:19
f844ed02b1df1b54ea96b6e902cb7ab0663612d8...29f747605154a4855ce76d21cd5ecbc2fa3890a0,9,152,29,181,16,2013-05-31 15:08:13,2013-05-29 03:45:08
29f747605154a4855ce76d21cd5ecbc2fa3890a0...49549b8e8650346540063b9c5b61b020d2021e24,4,136,20,156,54,2013-05-31 15:08:13,2013-05-29 20:15:16
49549b8e8650346540063b9c5b61b020d2021e24...2dfcfdf52ff8074f85f3a3a91a6f48ac2545dc5d,1,4,3,7,2,2013-05-31 15:08:13,2013-05-29 20:35:31
2dfcfdf52ff8074f85f3a3a91a6f48ac2545dc5d...e52de4130cf076cfb18178e9ce5e117b3553d9ed,1,28,12,40,2,2013-05-31 15:08:13,2013-05-30 21:45:56
e52de4130cf076cfb18178e9ce5e117b3553d9ed...8bad41e8f65744266c503ca4ccb38e16aefa15e5,1,3,3,6,3,2013-05-31 15:26:58,2013-05-31 14:54:19
8bad41e8f65744266c503ca4ccb38e16aefa15e5...9a8ffdd8fbc035db418c285b36b3a32b87f3fb63,1,10,3,13,4,2013-05-31 17:04:09,2013-05-31 15:31:44
9a8ffdd8fbc035db418c285b36b3a32b87f3fb63...9cd31fde02b3e701f5c354cbbc5a473957e155a5,2,35,5,40,4,2013-05-31 17:04:09,2013-05-29 17:07:13
9cd31fde02b3e701f5c354cbbc5a473957e155a5...88b66393ce61f1bf7bbc33064349501f39d02266,6,199,11,210,14,2013-05-31 17:20:21,2013-05-30 17:42:19
88b66393ce61f1bf7bbc33064349501f39d02266...6fe21d54ac7046265322f98d322f1bdece3f22d8,1,26,26,52,14,2013-05-31 17:56:47,2013-05-31 17:52:17
6fe21d54ac7046265322f98d322f1bdece3f22d8...4d664821926be0666af5861ba87be007633ff68e,1,8,7,15,2,2013-05-31 18:34:20,2013-05-31 18:33:59
4d664821926be0666af5861ba87be007633ff68e...d3cecc87f1e07ad5f8a4569acfde42147a15a406,1,1,1,2,1,2013-05-31 18:46:15,2013-05-31 18:46:15
d3cecc87f1e07ad5f8a4569acfde42147a15a406...97e3e31be450f754b92006726153a251087e31ca,1,1,1,2,1,2013-05-31 20:27:16,2013-05-31 20:17:33
97e3e31be450f754b92006726153a251087e31ca...0723117bdc1fa9725fc2cea7852ebe516398a5fe,7,105,0,105,18,2013-05-31 20:48:53,2013-05-29 21:44:50
0723117bdc1fa9725fc2cea7852ebe516398a5fe...0f97e5ee12313038cc9f0d62184cd98fa80fa790,1,2,2,4,2,2013-05-31 20:57:31,2013-05-31 20:57:31
0f97e5ee12313038cc9f0d62184cd98fa80fa790...ed8e8bde125c38db215e1fe5dfbdc2ad560ced4e,26,130,130,260,99,2013-05-31 21:17:06,2013-05-30 21:00:12
ed8e8bde125c38db215e1fe5dfbdc2ad560ced4e...661a68e0bd5d9679afa6a1fc9f371bb17a15129e,18,157,55,212,43,2013-05-31 21:32:48,2013-05-31 18:45:59
661a68e0bd5d9679afa6a1fc9f371bb17a15129e...f87c096e7d78c30f1e7c660fe4ad718d9b821217,18,55,157,212,43,2013-06-01 07:40:00,2013-06-01 07:40:00
f87c096e7d78c30f1e7c660fe4ad718d9b821217...65811339dc36ac869e363c6366e8f013431f7de4,12,397,345,742,105,2013-06-01 15:42:20,2013-06-01 15:42:20
65811339dc36ac869e363c6366e8f013431f7de4...0c3ca38ca7065f064608ac2a6e4c7822a0c822fb,3,209,49,258,64,2013-06-01 16:40:17,2013-05-29 18:05:22
0c3ca38ca7065f064608ac2a6e4c7822a0c822fb...7652fb20c47fb3847a53bb2231ea23ee8e485623,1,5,1,6,2,2013-06-03 03:36:57,2013-06-01 19:58:03
7652fb20c47fb3847a53bb2231ea23ee8e485623...4893af05ebc6960b7058b9d23ce1270bb1cda74e,2,11,4,15,4,2013-06-03 08:32:41,2013-06-02 22:07:36
4893af05ebc6960b7058b9d23ce1270bb1cda74e...054f48f94a98ca9ea43eb861c29b52b87a7aa32e,1,0,3,3,1,2013-06-03 08:41:43,2013-06-03 08:41:43
054f48f94a98ca9ea43eb861c29b52b87a7aa32e...59a12930f6be0d422b0a3be342181646b3010bca,1,2,2,4,2,2013-06-03 09:53:10,2013-06-03 09:53:10
59a12930f6be0d422b0a3be342181646b3010bca...c4b60b8ff775f494873535343cf50794f995cb5f,24,25,26,51,30,2013-06-03 18:23:51,2013-06-03 18:23:51
c4b60b8ff775f494873535343cf50794f995cb5f...5dd87637236aeed5d05222835231ea7ee8dd1b4c,3,51,20,71,20,2013-06-03 19:26:37,2013-06-03 19:26:16
5dd87637236aeed5d05222835231ea7ee8dd1b4c...e2bc8d7824b1304dd8c4bc8d30e615432e60c08a,18,157,55,212,43,2013-06-03 21:11:32,2013-05-31 18:45:59
e2bc8d7824b1304dd8c4bc8d30e615432e60c08a...8165d3e4c906e8d2ee8442d4b2a12941ecd66786,4,24,1,25,8,2013-06-03 21:11:32,2013-06-03 20:01:33
8165d3e4c906e8d2ee8442d4b2a12941ecd66786...b3762aae9b2ee9dc2c9429d99432df65c94b7498,1,5,0,5,2,2013-06-03 22:31:13,2013-06-03 22:31:13
b3762aae9b2ee9dc2c9429d99432df65c94b7498...06c6c3b6fb835e1bcc62e5f725aca6d815cfb42e,4,222,2,224,5,2013-06-03 22:53:52,2013-05-23 20:36:33
06c6c3b6fb835e1bcc62e5f725aca6d815cfb42e...9b148b0419d79f7173d0e972e8427fea67f77616,22,107,105,212,82,2013-06-03 22:53:52,2013-05-23 17:43:28
9b148b0419d79f7173d0e972e8427fea67f77616...da8c0fa929eeb03dbe3fb0533874de31da0bc8c8,8,214,70,284,32,2013-06-04 00:21:13,2013-05-22 01:07:48
da8c0fa929eeb03dbe3fb0533874de31da0bc8c8...ec4e8f3ea794c6769d90083fc3c32fc25e66ded2,1,3,1,4,1,2013-06-04 00:57:46,2013-04-13 02:50:07
ec4e8f3ea794c6769d90083fc3c32fc25e66ded2...2e7d108efe4a00b012d8489eae6e9565584a0529,6,43,9,52,14,2013-06-04 00:57:46,2013-06-03 18:33:18
2e7d108efe4a00b012d8489eae6e9565584a0529...1d42a534e0eb1e9ac868c0234495c0333d57d7c1,2,5,5,10,5,2013-06-04 00:57:46,2013-06-03 18:00:12
1d42a534e0eb1e9ac868c0234495c0333d57d7c1...9a7f88f0843a6d4d6c148b0ecee2cefb385584fb,5,37,2,39,10,2013-06-04 14:50:19,2013-06-03 22:59:02
9a7f88f0843a6d4d6c148b0ecee2cefb385584fb...7c151707ca81af0ade246bb181f1b424ae6b9a4f,1,2,2,4,1,2013-06-04 17:07:24,2013-05-06 22:01:56
7c151707ca81af0ade246bb181f1b424ae6b9a4f...680f0bf57260bf020cfaeb35598861c6b89524cb,1,68,0,68,1,2013-06-04 17:55:43,2013-06-04 17:53:36
680f0bf57260bf020cfaeb35598861c6b89524cb...0a8bf519fd6c3e50718f2b27fdd9e006cabee221,1,2,1,3,1,2013-06-04 17:55:43,2013-06-04 17:54:12
0a8bf519fd6c3e50718f2b27fdd9e006cabee221...48f8431210aba4de7d108852bc1d87267237d358,1,6,4,10,3,2013-06-04 17:55:43,2013-06-04 17:55:15
48f8431210aba4de7d108852bc1d87267237d358...9f980baa3c9ff301695a977956b56335e6774f95,1,1,3,4,1,2013-06-04 19:52:45,2013-06-04 19:52:45
9f980baa3c9ff301695a977956b56335e6774f95...4cb7655e3da3466265ace5d6cf44c55b931f3d15,14,153,162,315,84,2013-06-04 20:44:06,2013-06-04 17:46:05
4cb7655e3da3466265ace5d6cf44c55b931f3d15...75095e78e03d16d08f29770c9c80ec8f34792bc0,3,12,11,23,5,2013-06-04 20:59:34,2013-06-03 19:49:16
75095e78e03d16d08f29770c9c80ec8f34792bc0...ae3652641c23b56be0d428366700732029d7554a,1,13,0,13,1,2013-06-04 20:59:34,2013-06-04 16:21:54
ae3652641c23b56be0d428366700732029d7554a...c6be4e71ef1f22950a7055da6f401152a06c3fc5,14,15,124,139,18,2013-06-04 21:05:19,2013-06-03 22:03:44
c6be4e71ef1f22950a7055da6f401152a06c3fc5...2ccf39cab1d62c4b2a68513e9f906074d156a531,11,1129,469,1598,36,2013-06-04 21:05:20,2013-06-04 19:59:45
2ccf39cab1d62c4b2a68513e9f906074d156a531...f5e81a3f0155c73bee1732c935b20f774bcab2cc,3,8,551,559,13,2013-06-04 21:05:20,2013-06-04 20:10:16
f5e81a3f0155c73bee1732c935b20f774bcab2cc...34691ade8ee1e78939842225ab3691ba5ce62521,3,551,8,559,13,2013-06-04 21:10:49,2013-06-04 21:10:49
34691ade8ee1e78939842225ab3691ba5ce62521...f44d4c9151c49ba81d232ceb9eb521f6f2cf33bc,11,469,1129,1598,36,2013-06-04 21:11:01,2013-06-04 21:11:01
f44d4c9151c49ba81d232ceb9eb521f6f2cf33bc...174c187f6c26144d4f5894776456e5097f04866e,12,1131,1014,2145,43,2013-06-04 21:11:43,2013-06-04 19:59:45
174c187f6c26144d4f5894776456e5097f04866e...33e8bf580ac5a573f007a0f85f66406751700c03,2,4,4,8,3,2013-06-04 21:19:35,2013-06-04 21:05:27
33e8bf580ac5a573f007a0f85f66406751700c03...34f701faec271c454612a8b992efbae7f9070a96,4,28,27,55,23,2013-06-04 21:57:09,2013-05-31 18:12:54
34f701faec271c454612a8b992efbae7f9070a96...ecc9f99bf487191c628c8c36fb9606304a790d31,5,56,56,112,43,2013-06-04 21:57:09,2013-06-04 21:19:03
ecc9f99bf487191c628c8c36fb9606304a790d31...9cb96a3e348f41261693fc386bfc2f4a65c32982,16,546,66,612,72,2013-06-05 06:14:14,2013-06-05 06:14:14
9cb96a3e348f41261693fc386bfc2f4a65c32982...54e11a3cfa5de27351da1c9c55d539b3b17a0b00,1,1,1,2,1,2013-06-05 06:25:49,2013-05-23 09:23:37
54e11a3cfa5de27351da1c9c55d539b3b17a0b00...c4378a6f860a68117b2c879944b3fe39ab6b3e75,1,7,4,11,2,2013-06-05 07:00:25,2013-06-03 16:31:07
c4378a6f860a68117b2c879944b3fe39ab6b3e75...e0c8f9047f55ccfc1012c47689871d519f7f6dc0,5,32,32,64,32,2013-06-05 15:49:39,2013-06-05 15:48:11
e0c8f9047f55ccfc1012c47689871d519f7f6dc0...7d37be060bd7db332ebeade1e1c0cf53d8b00cb3,18,56,52,108,53,2013-06-05 15:52:05,2013-06-05 14:53:16
7d37be060bd7db332ebeade1e1c0cf53d8b00cb3...e132330bcd5a61ec6365655ffed6b0499a3f29b2,1,5,2,7,1,2013-06-05 17:19:50,2013-05-13 02:21:45
e132330bcd5a61ec6365655ffed6b0499a3f29b2...75a947ebee7e1d8d30f5e45d3bc05b9c1028901d,2,34,12,46,10,2013-06-05 17:55:49,2013-06-05 17:55:40
75a947ebee7e1d8d30f5e45d3bc05b9c1028901d...7f3e4ac0d188da665320603ee7eddcc274ed14ef,1,261,261,522,2,2013-06-05 18:00:22,2013-06-05 18:00:22
7f3e4ac0d188da665320603ee7eddcc274ed14ef...cee9135e0f478bc60cbe599a6822c11fcbdb9dd0,1,10,10,20,5,2013-06-05 18:30:26,2013-06-05 18:29:52
cee9135e0f478bc60cbe599a6822c11fcbdb9dd0...88641efac7eece815ee2f220dba56f1c9613541e,18,52,56,108,53,2013-06-05 19:06:22,2013-06-05 19:06:22
88641efac7eece815ee2f220dba56f1c9613541e...cfc88a35ce57ef8552233cc10a74af0e59f29200,1,1,3,4,1,2013-06-05 19:43:14,2013-06-05 18:48:48
cfc88a35ce57ef8552233cc10a74af0e59f29200...8752f3576634716b3ff81b8d0d99b5b6abc61165,1,5,4,9,4,2013-06-05 19:45:01,2013-06-05 18:51:07
8752f3576634716b3ff81b8d0d99b5b6abc61165...3ba5acdb56f4268f56debd18db0fd6cf962572b4,1,1,2,3,2,2013-06-05 19:45:07,2013-06-05 18:57:34
3ba5acdb56f4268f56debd18db0fd6cf962572b4...e93d63c4468b5dd65c4f3673544f25ac21bc7b52,1,1,0,1,1,2013-06-06 02:31:45,2013-06-06 02:31:45
e93d63c4468b5dd65c4f3673544f25ac21bc7b52...2c35c4c4aa5f98a8bae5cdacea9dc71bdc27eaed,1,5,0,5,1,2013-06-06 14:17:34,2013-06-06 14:17:34
2c35c4c4aa5f98a8bae5cdacea9dc71bdc27eaed...732d51ad8de1940c467de2b64e8acafb02d228a0,1,646,1,647,5,2013-06-06 15:16:56,2013-03-02 07:26:49
732d51ad8de1940c467de2b64e8acafb02d228a0...ce97dc76c6a3f399f2f67613a55a7c238384ede9,3,5,5,10,4,2013-06-06 17:39:50,2013-06-06 14:55:38
ce97dc76c6a3f399f2f67613a55a7c238384ede9...8e424563048f15a8a7f2fe6de1ad40131a75580b,1,6,4,10,1,2013-06-06 17:39:50,2013-06-06 16:43:53
8e424563048f15a8a7f2fe6de1ad40131a75580b...80cc5892d74c9377d4a2c08087affe5b9852d120,2,19,6,25,5,2013-06-06 18:13:56,2013-06-06 18:13:56
80cc5892d74c9377d4a2c08087affe5b9852d120...db76ce6eefbdb4f6887e3136a707b3010c360cc7,1,3,2,5,1,2013-06-06 19:05:29,2013-06-06 19:05:15
db76ce6eefbdb4f6887e3136a707b3010c360cc7...220b1031ddb979159e21aaac13807f694fb00842,2,30,21,51,19,2013-06-06 19:35:59,2013-06-06 19:35:59
220b1031ddb979159e21aaac13807f694fb00842...b80a599adcf590fa7a02135085a09148e83adff5,1,9,4,13,5,2013-06-06 19:49:49,2013-06-06 18:12:34
b80a599adcf590fa7a02135085a09148e83adff5...d1b334e0701e2f7f599079d57968a599f7f98173,1,2,2,4,2,2013-06-07 14:06:53,2013-06-07 14:06:53
d1b334e0701e2f7f599079d57968a599f7f98173...f88a9247b085b1dae76745ceddb53a9e53541f1c,1,2,2,4,2,2013-06-07 14:57:58,2013-06-07 14:57:58
f88a9247b085b1dae76745ceddb53a9e53541f1c...80261daed7582d538cddd855c38b69b8adf2f3db,5,302,25,327,18,2013-06-07 15:33:19,2013-05-24 19:58:59
80261daed7582d538cddd855c38b69b8adf2f3db...1bad6b0bd957b0bbe98459770c10bf1af0670a99,2,213,200,413,2,2013-06-07 18:31:00,2013-06-07 18:31:00
1bad6b0bd957b0bbe98459770c10bf1af0670a99...c2748a2bf862e026c4a919aac62a568b52abb9a2,1,212,212,424,1,2013-06-07 19:03:28,2013-06-07 19:03:28
c2748a2bf862e026c4a919aac62a568b52abb9a2...e55d971e468141401db1e8b9e570eed7af3c5947,1,130,24,154,15,2013-06-07 20:34:22,2013-06-07 19:37:22
e55d971e468141401db1e8b9e570eed7af3c5947...eb5b8b0226d1d0d1d9b1dfba58b8af810d0e0146,1,5,1,6,1,2013-06-08 16:35:23,2013-06-07 20:38:49
eb5b8b0226d1d0d1d9b1dfba58b8af810d0e0146...8d832958dd3387336bfedc9ed400b72f1012a61d,1,45,0,45,1,2013-06-10 10:05:19,2013-06-10 10:05:19
8d832958dd3387336bfedc9ed400b72f1012a61d...1e65ddf0bf4fe11d2ab71cf04be808e9a10f342d,4,30,8,38,7,2013-06-10 13:08:41,2013-06-05 14:01:30
1e65ddf0bf4fe11d2ab71cf04be808e9a10f342d...5e02976117c3ea90318326670cba51975b957ca9,2,122,39,161,10,2013-06-10 15:27:02,2013-06-03 18:08:58
5e02976117c3ea90318326670cba51975b957ca9...713734e41357a96592ace944ad71f5982211f31b,1,35,0,35,1,2013-06-10 16:14:06,2013-06-08 19:53:06
713734e41357a96592ace944ad71f5982211f31b...8ff5aecd2c0c606feefa39f0f8bd5e84c2c57bba,1,6,2,8,4,2013-06-10 18:02:56,2013-06-06 14:42:32
8ff5aecd2c0c606feefa39f0f8bd5e84c2c57bba...64a1136d69b700d9e7e40e7fd8c43f9a8108ac76,1,4,5,9,5,2013-06-10 18:23:06,2013-06-10 17:16:06
64a1136d69b700d9e7e40e7fd8c43f9a8108ac76...283623c7a30326a7baf93fc08ac74162f8d3a50f,1,8,4,12,2,2013-06-10 22:45:11,2013-06-10 05:37:27
283623c7a30326a7baf93fc08ac74162f8d3a50f...ebf3a76940041bcfe8fbf84fd8b3f22b57ef3ecd,1,2,2,4,2,2013-06-11 15:46:10,2013-06-11 15:45:57
ebf3a76940041bcfe8fbf84fd8b3f22b57ef3ecd...89aed8f923497f019fdfc49459b642a2873621a6,1,2,2,4,2,2013-06-11 15:59:05,2013-06-11 15:56:58
89aed8f923497f019fdfc49459b642a2873621a6...7d49df9335bb9294cf657b97a0f3850d9abd7db6,1,0,1,1,1,2013-06-11 16:33:06,2013-05-20 12:18:42
7d49df9335bb9294cf657b97a0f3850d9abd7db6...ec882b844512f7bdc8172fedce5ddad73557cc3e,2,28,2,30,2,2013-06-11 19:30:58,2013-06-10 18:07:21
ec882b844512f7bdc8172fedce5ddad73557cc3e...42255e2d5a9fa8eff2426d78be3e292f45a39cbc,1,2,2,4,2,2013-06-11 21:47:02,2012-08-03 18:48:28
42255e2d5a9fa8eff2426d78be3e292f45a39cbc...71a46cf6b9465204eed8707933d50a858e8d4d6b,11,262,0,262,16,2013-06-11 22:16:57,2013-06-11 18:35:14
71a46cf6b9465204eed8707933d50a858e8d4d6b...917beec5445a869da5f0315a7501d8acf1ce8d2f,12,24,0,24,12,2013-06-12 11:21:47,2013-06-12 11:21:47
917beec5445a869da5f0315a7501d8acf1ce8d2f...e3097872b5837e31179702f1009a976656f8af76,2,12,5,17,4,2013-06-12 15:37:41,2013-05-22 15:23:37
e3097872b5837e31179702f1009a976656f8af76...6c3225162bcb5aea62fc476b647e14742f2bd65b,2,13,23,36,12,2013-06-12 15:37:41,2013-06-11 17:51:01
6c3225162bcb5aea62fc476b647e14742f2bd65b...1e03edb5a6432018af994e1f41e359ae903493a9,3,39,11,50,9,2013-06-12 16:22:14,2013-06-11 14:28:44
1e03edb5a6432018af994e1f41e359ae903493a9...eb6b5b794b167bb9ac9d7d6fffa48579c86f25b5,1,2,0,2,1,2013-06-12 20:11:25,2013-06-11 17:03:02
eb6b5b794b167bb9ac9d7d6fffa48579c86f25b5...b9fed4eb9373c22a498b582febbd18e551d55d5d,2,7,7,14,3,2013-06-12 21:23:19,2013-06-12 21:23:19
b9fed4eb9373c22a498b582febbd18e551d55d5d...e23ee681ca40f271ddbbd840f155a9b13102f148,19,218,34,252,50,2013-06-13 09:44:54,2013-06-13 09:40:19
e23ee681ca40f271ddbbd840f155a9b13102f148...fc739c0a815547e405df3978bbeedf09a8dbf2d1,1,2,0,2,2,2013-06-13 11:10:43,2013-06-13 11:10:43
fc739c0a815547e405df3978bbeedf09a8dbf2d1...92d59bdabb46de6821c12affd21d180316148fdf,1,2,1,3,1,2013-06-13 15:11:57,2013-06-13 14:53:06
92d59bdabb46de6821c12affd21d180316148fdf...77c838a35f2a1475b859ed869d9e018dc233e4c6,1,3,1,4,1,2013-06-13 15:44:23,2013-06-13 15:44:23
77c838a35f2a1475b859ed869d9e018dc233e4c6...01e4e857be20365b72867458b1a7f48fd8b1c689,3,110,44,154,15,2013-06-13 16:07:32,2013-06-12 15:52:56
01e4e857be20365b72867458b1a7f48fd8b1c689...34906754037982bd2559c0e9820444c865cb9574,1,33,34,67,9,2013-06-13 17:40:51,2013-06-13 17:39:25
34906754037982bd2559c0e9820444c865cb9574...71544f212f797826cb46d2702bb802942e3de4b9,1,5,0,5,1,2013-06-13 19:36:16,2013-06-13 17:31:54
71544f212f797826cb46d2702bb802942e3de4b9...58f82cf66d180a595c9e6801667c569c6d0eed98,1,15,0,15,1,2013-06-13 21:02:51,2013-06-13 15:07:34
58f82cf66d180a595c9e6801667c569c6d0eed98...f9667a3f90c57086bc9d03f4350b76e2a02cd6b3,1,6,1,7,2,2013-06-14 18:58:46,2013-06-14 18:58:46
f9667a3f90c57086bc9d03f4350b76e2a02cd6b3...fcc103ba403fd35d96675f217c0e56d73eb14469,36,750,583,1333,354,2013-06-14 19:40:43,2013-06-14 19:40:10
fcc103ba403fd35d96675f217c0e56d73eb14469...85a5413d651d00849d63b96386584e36d5d845e3,12,199,10,209,19,2013-06-14 20:08:33,2013-06-11 19:17:05
85a5413d651d00849d63b96386584e36d5d845e3...cf5d9a25d126ec4d9af8ceb788c1b29f3abc52e1,1,5,5,10,1,2013-06-14 20:10:13,2013-06-14 20:09:51
cf5d9a25d126ec4d9af8ceb788c1b29f3abc52e1...9a8f1bffa1906c854ecaf2b3b40c8232843b24f3,1,6,13,19,3,2013-06-14 20:34:49,2013-06-14 20:34:49
9a8f1bffa1906c854ecaf2b3b40c8232843b24f3...a73206f7a11f8641b2a7737ad4ecb14202d944c8,1,3,2,5,4,2013-06-14 21:47:42,2013-06-14 19:27:58
a73206f7a11f8641b2a7737ad4ecb14202d944c8...ab4e36fef8b3c6324139d212fd4644ede6aba212,1,1,1,2,1,2013-06-17 13:26:58,2013-06-17 13:26:38
ab4e36fef8b3c6324139d212fd4644ede6aba212...859e80ecccf3cdcdde541c27ee43da690742eff9,1,4,0,4,1,2013-06-17 15:18:31,2013-06-14 16:05:06
859e80ecccf3cdcdde541c27ee43da690742eff9...a2056afecf016c4798cd16f594c719ce6e893196,2,225,8,233,5,2013-06-17 15:49:56,2013-06-17 14:06:50
a2056afecf016c4798cd16f594c719ce6e893196...1459353f995228932bf5077aa4da52d8d68a6871,16,114,1139,1253,55,2013-06-17 16:23:32,2013-06-05 19:04:12
1459353f995228932bf5077aa4da52d8d68a6871...432d1c9546340633dd5f0ef07259708a75f4a87e,19,1293,1257,2550,243,2013-06-17 16:23:32,2013-06-06 14:59:36
432d1c9546340633dd5f0ef07259708a75f4a87e...88b7299f433e6b7bcae6df68a021fee91dc21dd3,7,496,464,960,130,2013-06-17 16:23:32,2013-06-07 20:11:49
88b7299f433e6b7bcae6df68a021fee91dc21dd3...c676251944be837ebe285e12ff701e1594c2f70b,5,24,37,61,13,2013-06-17 16:35:35,2013-06-11 16:06:10
c676251944be837ebe285e12ff701e1594c2f70b...fda4a2342614e4ca1fb26c868a5adef0e050eb5e,7,752,623,1375,200,2013-06-17 22:35:10,2013-06-05 22:23:46
fda4a2342614e4ca1fb26c868a5adef0e050eb5e...75b4cddd29af46fb3902fd5a064bb7093fe68bea,4,138,11,149,7,2013-06-17 23:25:26,2013-06-17 23:25:26
75b4cddd29af46fb3902fd5a064bb7093fe68bea...6e15f4f8f462aab68e59d042413a9a93e5851b0f,1,13,15,28,2,2013-06-17 23:37:31,2013-06-17 18:14:59
6e15f4f8f462aab68e59d042413a9a93e5851b0f...af07d274c2dc0806966b2ffc991eb120ca232da1,1,5,2,7,3,2013-06-17 23:38:22,2013-06-17 20:36:22
af07d274c2dc0806966b2ffc991eb120ca232da1...f2e40f7814d0f664d1baa202d623a0e3d678245b,16,462,96,558,83,2013-06-18 10:48:16,2013-06-18 10:48:16
f2e40f7814d0f664d1baa202d623a0e3d678245b...7471abc180fbd5f7b2ac31c51a71563052ea03ce,21,144,135,279,100,2013-06-18 13:58:59,2013-06-18 13:58:59
7471abc180fbd5f7b2ac31c51a71563052ea03ce...acbae789795b2f628712ada73b2d89684b97da9d,1,75,67,142,15,2013-06-18 14:31:13,2013-06-18 14:29:18
acbae789795b2f628712ada73b2d89684b97da9d...5e331a573cfd9a860f5afb1e2bb14cad8394f464,2,154,117,271,17,2013-06-18 14:59:12,2013-06-17 19:08:37
5e331a573cfd9a860f5afb1e2bb14cad8394f464...800da131d4b2877ec924f6a45dadc8574645211c,8,770,3,773,12,2013-06-18 15:04:13,2013-06-12 18:45:43
800da131d4b2877ec924f6a45dadc8574645211c...c020b94a9e3154cf0b18ea8e504992f2ab3ae885,9,159,179,338,147,2013-06-18 16:51:15,2013-05-15 20:25:10
c020b94a9e3154cf0b18ea8e504992f2ab3ae885...d9c570d95817d3a17c08f5cfab98112f55220a64,11,170,352,522,95,2013-06-18 16:51:15,2013-05-16 19:17:54
d9c570d95817d3a17c08f5cfab98112f55220a64...f71dfdc67408a2fc0d695f865ad3abbb116ed443,2,87,39,126,14,2013-06-18 16:51:15,2013-05-21 23:17:54
f71dfdc67408a2fc0d695f865ad3abbb116ed443...be4e909ad1ae382a073f456710052a65c2b5fd39,5,17,5,22,7,2013-06-18 16:51:15,2013-05-29 22:31:51
be4e909ad1ae382a073f456710052a65c2b5fd39...4c30d0500b1da673840f0ea12a9277f3803a230f,11,109,210,319,78,2013-06-18 16:51:15,2013-05-30 20:22:49
4c30d0500b1da673840f0ea12a9277f3803a230f...063e03c4e8055fd5e22251250715d34342cf88be,9,577,259,836,187,2013-06-18 16:51:16,2013-05-21 16:33:24
063e03c4e8055fd5e22251250715d34342cf88be...a6f35523cd2dcc6c49d8f1c745bd98c8842cc1d6,2,10,10,20,7,2013-06-18 16:51:16,2013-06-04 20:14:34
a6f35523cd2dcc6c49d8f1c745bd98c8842cc1d6...367ed447e0bdf0a67887f5d00113bd293e309bd1,3,178,2,180,8,2013-06-18 16:51:16,2013-06-05 17:27:06
367ed447e0bdf0a67887f5d00113bd293e309bd1...bfc57a632cf01135d271e460fbb07f4bbfceae9a,1,3,0,3,1,2013-06-18 18:15:08,2013-06-18 17:59:03
bfc57a632cf01135d271e460fbb07f4bbfceae9a...cb50688cbb996615c03a09cb101888455eff42f7,1,3,2,5,1,2013-06-18 18:22:22,2013-06-18 18:22:22
cb50688cbb996615c03a09cb101888455eff42f7...d9913645465ed6de81a41fa1e3aca19f49794663,1,1,1,2,1,2013-06-18 19:06:17,2013-06-18 18:59:34
d9913645465ed6de81a41fa1e3aca19f49794663...2f5ebe592b5faa10f7a7881f9c6fc3f83f59be62,12,84,24,108,28,2013-06-19 08:22:42,2013-06-19 08:22:42
2f5ebe592b5faa10f7a7881f9c6fc3f83f59be62...ab65ed04e2a4ad3aeebc9222e24340396c345082,1,2,1,3,1,2013-06-19 12:55:34,2013-06-19 12:55:34
ab65ed04e2a4ad3aeebc9222e24340396c345082...260befcae73d6f9a17d958417e75a9b7bc4a89a1,1,17,5,22,2,2013-06-19 15:52:23,2013-06-19 13:16:39
260befcae73d6f9a17d958417e75a9b7bc4a89a1...40708e54a41f833933d748383d563cf7c9092744,1,21,3,24,6,2013-06-19 17:14:28,2012-11-29 18:40:29
40708e54a41f833933d748383d563cf7c9092744...8706a021d8edcd747623bb2b2605995e2c57b76d,1,6,6,12,6,2013-06-19 17:14:28,2013-06-18 18:49:33
8706a021d8edcd747623bb2b2605995e2c57b76d...69d7632211e20d05f564e67e0cb9fd98929e5d5a,9,121,13,134,20,2013-06-19 23:29:15,2013-06-19 23:29:15
69d7632211e20d05f564e67e0cb9fd98929e5d5a...714a9c6febdac4d062811cbe09477d662e890fb6,16,64,0,64,32,2013-06-19 23:57:16,2013-06-19 23:57:16
714a9c6febdac4d062811cbe09477d662e890fb6...38d638004c0125a52e4dc86b586efec3e2efee4c,1,4,4,8,3,2013-06-20 14:42:27,2013-06-20 14:42:27
38d638004c0125a52e4dc86b586efec3e2efee4c...54f25e6292eb565d4eadec1d5d75d286c787c053,8,194,64,258,25,2013-06-20 15:53:23,2013-06-20 15:53:23
54f25e6292eb565d4eadec1d5d75d286c787c053...709c667c5fa4dffd8a62d97ac24a1db5abcba7b3,1,0,2,2,1,2013-06-20 15:57:05,2013-06-20 15:56:55
709c667c5fa4dffd8a62d97ac24a1db5abcba7b3...b7c325752afbf532f5a2b5b056995d15ddda36c3,4,216,109,325,38,2013-06-20 16:01:23,2013-06-14 21:03:01
b7c325752afbf532f5a2b5b056995d15ddda36c3...de9b1bba1d69e80bf403ef01c82741c8300e0427,1,1,0,1,1,2013-06-20 16:08:44,2013-06-19 22:03:29
de9b1bba1d69e80bf403ef01c82741c8300e0427...cf351d0ee969f6b1709ad4d4e307e17242be2434,1,13,11,24,5,2013-06-20 16:10:19,2013-06-19 22:27:37
cf351d0ee969f6b1709ad4d4e307e17242be2434...aae69729c55172dcf70081e6e5ce8650e9ac0dc2,1,1,3,4,1,2013-06-20 16:11:47,2013-06-19 22:28:10
aae69729c55172dcf70081e6e5ce8650e9ac0dc2...e2254896d875d2fa7866938cbf4f33d0a3910c53,1,101,101,202,19,2013-06-20 16:15:22,2013-06-20 16:15:22
e2254896d875d2fa7866938cbf4f33d0a3910c53...a34ce4ddd3f56daf9bd88b81454632d44788d585,16,64,0,64,32,2013-06-20 18:26:55,2013-06-20 18:26:55
a34ce4ddd3f56daf9bd88b81454632d44788d585...a01f9fda4c522130922c1601119acb9df9ce853f,1,22,2,24,6,2013-06-20 18:57:23,2013-06-20 17:55:08
a01f9fda4c522130922c1601119acb9df9ce853f...0d9540aaea8a06d9c4c9c465488261ba91ec9c84,1,1,1,2,1,2013-06-20 18:58:24,2013-06-20 17:19:56
0d9540aaea8a06d9c4c9c465488261ba91ec9c84...65cc69f5badfc74e02969af42f192d95a9171e87,1,1,11,12,4,2013-06-20 19:09:50,2013-06-20 19:07:39
65cc69f5badfc74e02969af42f192d95a9171e87...35ed8f8722088d4215dcea5c32dde2e52c42c099,3,7,7,14,4,2013-06-20 19:24:52,2013-06-20 18:54:50
35ed8f8722088d4215dcea5c32dde2e52c42c099...512672d0df049aa992b2f00c1f2968767a6cd2c8,1,3,3,6,1,2013-06-20 19:25:26,2013-06-20 17:41:30
512672d0df049aa992b2f00c1f2968767a6cd2c8...021b9bb6946bc7f07f88c176a081e53b2db36e49,1,1,0,1,1,2013-06-20 20:03:56,2013-06-20 20:03:56
021b9bb6946bc7f07f88c176a081e53b2db36e49...c5ad04549e40b1069029026081d9324e9e06156c,1,13,7,20,3,2013-06-20 22:25:37,2013-06-20 22:12:48
c5ad04549e40b1069029026081d9324e9e06156c...fc9491ee7be6a7dc8a92a8422468284359073545,1,101,0,101,1,2013-06-21 16:47:14,2013-06-20 21:42:05
fc9491ee7be6a7dc8a92a8422468284359073545...a5eb3244eb0846bba96ff56289460f38fe26fffb,1,42,0,42,3,2013-06-21 17:34:53,2013-06-21 17:34:53
a5eb3244eb0846bba96ff56289460f38fe26fffb...c42fd35a0a0bd5f9511fdcbea4bdc2ec590fddd3,1,4,0,4,1,2013-06-21 19:32:20,2013-06-21 18:59:38
c42fd35a0a0bd5f9511fdcbea4bdc2ec590fddd3...93e431a1ddca2623743df3a1333fee31e53b7ff6,4,17,7,24,8,2013-06-21 19:38:17,2013-06-03 23:56:40
93e431a1ddca2623743df3a1333fee31e53b7ff6...1c159fbd32e681f6d8c954d398d6b9d944261ab3,1,0,4,4,2,2013-06-22 23:10:13,2013-06-22 23:10:13
1c159fbd32e681f6d8c954d398d6b9d944261ab3...874b277be6275e05fa5e3a272c6218238bcb154a,1,3,4,7,2,2013-06-22 23:14:32,2013-06-22 23:14:32
874b277be6275e05fa5e3a272c6218238bcb154a...cf97062ee8e3d7fac96e195293f2c120c64de1b2,7,14,3,17,10,2013-06-23 04:26:50,2013-06-23 04:26:16
cf97062ee8e3d7fac96e195293f2c120c64de1b2...8717795894c20ecd0fd4eb92f23c4ce0f295683d,1,2,2,4,1,2013-06-24 18:06:40,2013-06-24 18:06:40
8717795894c20ecd0fd4eb92f23c4ce0f295683d...1515efcb5e385299fe97859d0d672f33ad40eed2,1,0,36,36,1,2013-06-24 19:03:46,2013-06-24 19:03:46
1515efcb5e385299fe97859d0d672f33ad40eed2...57a4875807ac0ff15f1a656afe3301e127a510fa,1,12,0,12,1,2013-06-24 21:10:21,2013-06-14 19:43:40
57a4875807ac0ff15f1a656afe3301e127a510fa...eb7ba8adc1ea407ebd88a8b829a6adbaf109e681,276,7,163713,163720,302,2013-06-24 21:26:06,2013-06-24 16:58:41
eb7ba8adc1ea407ebd88a8b829a6adbaf109e681...82674f15106984028627c9ecba18f84b55cd6dea,4,137,7,144,7,2013-06-24 23:42:26,2013-05-23 02:38:52
82674f15106984028627c9ecba18f84b55cd6dea...1c53e2b9e90c17287664312f8fcac861d63165e4,1,0,2,2,1,2013-06-24 23:54:43,2013-06-24 23:54:43
1c53e2b9e90c17287664312f8fcac861d63165e4...4232b77a2ce5aa078db6f4cf3afedf8a07efb825,1,81,1,82,8,2013-06-25 01:01:49,2013-06-21 17:42:41
4232b77a2ce5aa078db6f4cf3afedf8a07efb825...d7c695037e8563fce0751fe7b1231c263f0f70ff,4,11,6,17,8,2013-06-25 03:58:15,2013-06-25 02:38:48
d7c695037e8563fce0751fe7b1231c263f0f70ff...f16a607f0e16e88a6b55d5e667139ec4e0ec7113,1,2,0,2,1,2013-06-25 03:58:15,2013-06-25 03:35:33
f16a607f0e16e88a6b55d5e667139ec4e0ec7113...eae5f9737a7cecf07ef9cd93e237570e9d598a31,5,0,1543,1543,5,2013-06-25 03:58:15,2013-06-25 03:35:41
eae5f9737a7cecf07ef9cd93e237570e9d598a31...b63e86f76b1d79c52eb080c6c2de59882a1b7691,1,3,2,5,4,2013-06-25 09:41:41,2013-06-25 09:33:18
b63e86f76b1d79c52eb080c6c2de59882a1b7691...76803bccc0206503b1641fe4222c90bcb82331d0,6,0,46,46,14,2013-06-25 10:30:05,2013-06-25 10:30:05
76803bccc0206503b1641fe4222c90bcb82331d0...6d27da0887b286c421751afc5e5cf573101c1eb8,5,137,7,144,14,2013-06-25 13:56:37,2013-06-24 21:35:57
6d27da0887b286c421751afc5e5cf573101c1eb8...d813c5b15e390e9e181a761059bc350028bb8472,3,136,20,156,31,2013-06-25 14:31:14,2013-06-24 18:05:31
d813c5b15e390e9e181a761059bc350028bb8472...d0cffa96c1761a79b52ff36b5441e845ed6bd3f0,1,1,1,2,1,2013-06-25 14:44:14,2013-06-25 14:44:14
d0cffa96c1761a79b52ff36b5441e845ed6bd3f0...b290b65c9e679a42999fe1b0ef7d466b669bd6c9,14,23,150,173,20,2013-06-25 14:46:30,2013-06-24 20:06:18
b290b65c9e679a42999fe1b0ef7d466b669bd6c9...ba239918c950c254056bf589a943a5e88fd4144c,21,1634,686,2320,186,2013-06-25 17:46:36,2013-03-29 19:25:55
ba239918c950c254056bf589a943a5e88fd4144c...ace643f0afb1e4637587abf3faa05edd6f2fc123,1,6,0,6,1,2013-06-25 18:12:02,2013-06-25 15:53:36
ace643f0afb1e4637587abf3faa05edd6f2fc123...fc8538ac9231a104d5858b25d24d6ca688c385ea,1,6,2,8,2,2013-06-25 21:13:33,2013-06-25 21:13:33
fc8538ac9231a104d5858b25d24d6ca688c385ea...c2e3f288b5e61806b00ea6ec93a055363b9faeec,1,1,2,3,2,2013-06-25 21:20:49,2013-06-25 21:03:47
c2e3f288b5e61806b00ea6ec93a055363b9faeec...c63814f9a762c52b884271fded969cc2303ed13c,1,1,1,2,1,2013-06-26 14:06:35,2013-06-26 14:06:35
c63814f9a762c52b884271fded969cc2303ed13c...3d6e8936938e5aef274ea97ee385f062a9b1bcdf,2,2,2,4,2,2013-06-26 14:55:18,2013-06-25 19:13:25
3d6e8936938e5aef274ea97ee385f062a9b1bcdf...becf20f90e77996c3652fd9cb4f19d0147c17840,2,31,10,41,3,2013-06-26 16:54:12,2013-06-26 16:54:12
becf20f90e77996c3652fd9cb4f19d0147c17840...c82f38b68a3c14aa9cabe06b3e527a334ebcd101,1,11,8,19,6,2013-06-26 17:32:31,2013-06-26 17:31:05
c82f38b68a3c14aa9cabe06b3e527a334ebcd101...23f8257fa37ff164e16094db044a113779f84b2b,3,32,17,49,11,2013-06-26 17:37:36,2013-04-05 08:01:46
23f8257fa37ff164e16094db044a113779f84b2b...e14606de365ef11a49ba5c0cf63f5418eee8ad55,1,2,2,4,1,2013-06-26 17:56:13,2013-06-26 17:54:39
e14606de365ef11a49ba5c0cf63f5418eee8ad55...bd0713e9a67f67b19944841275007f6fc6ee1c69,1,5,2,7,4,2013-06-26 18:15:42,2013-06-26 18:15:42
bd0713e9a67f67b19944841275007f6fc6ee1c69...692f1859a032a92e54f08b1a2a130fa99590b1d0,32,406,240,646,101,2013-06-27 02:36:37,2013-06-25 23:42:11
692f1859a032a92e54f08b1a2a130fa99590b1d0...eed9f7d6bfe906f906df39765550a103c3764fd6,1,15,0,15,1,2013-06-27 10:22:52,2013-06-25 13:54:34
eed9f7d6bfe906f906df39765550a103c3764fd6...3bfd47b218a0dc7614c46f6fe4499cf6efa68fb2,2,2,2,4,2,2013-06-27 11:15:43,2013-06-27 11:15:43
3bfd47b218a0dc7614c46f6fe4499cf6efa68fb2...9ae211bbd106570522e99d905b07a06a121186e2,1,21,0,21,3,2013-06-27 13:38:48,2013-06-27 13:38:48
9ae211bbd106570522e99d905b07a06a121186e2...d0ea86827f0cf222023ea6fcbe4a5c5314c84d89,1,5,4,9,4,2013-06-27 15:56:28,2013-06-27 15:51:15
d0ea86827f0cf222023ea6fcbe4a5c5314c84d89...838bb8f9475464c698593536e0183c0326337301,5,105,9,114,7,2013-06-27 18:51:58,2013-06-26 19:13:56
838bb8f9475464c698593536e0183c0326337301...bf4f0841d9ea557cde3a775e2c418f845dcdcbcd,7,13,1,14,8,2013-06-27 19:52:38,2013-06-27 17:04:49
bf4f0841d9ea557cde3a775e2c418f845dcdcbcd...86e76e34e88c3db7c48039b3e7c1b2a8e5d12771,2,4,2,6,3,2013-06-28 02:57:35,2013-06-28 02:57:29
86e76e34e88c3db7c48039b3e7c1b2a8e5d12771...a3f89bd33d2321f0cd518ea71c63683383fa3ac6,1,8,7,15,11,2013-06-28 13:18:59,2013-06-28 13:17:42
a3f89bd33d2321f0cd518ea71c63683383fa3ac6...f3ebed0f3ab8e1cf0df752fb9e44875ed1e3849d,1,3,1,4,1,2013-06-28 14:40:48,2013-06-28 14:40:41
f3ebed0f3ab8e1cf0df752fb9e44875ed1e3849d...1a16d0505886c1fe50f43014d82b3e1c9dd8b7ca,1,2,2,4,1,2013-06-28 17:04:41,2013-06-28 17:04:41
1a16d0505886c1fe50f43014d82b3e1c9dd8b7ca...0a4b206a2938fec91d4431ce6d5ebfc602972a4e,1,1,1,2,1,2013-06-28 19:48:20,2013-06-28 19:32:42
0a4b206a2938fec91d4431ce6d5ebfc602972a4e...b975f73660d0fbe7306e77a58f3a8b85aa6a6419,1,20,5,25,5,2013-06-28 20:45:59,2013-06-28 15:30:39
b975f73660d0fbe7306e77a58f3a8b85aa6a6419...bd9ff869615e2611589f4e8795dea3fe9655ad27,1,7,0,7,1,2013-06-28 21:32:29,2013-06-28 21:32:29
bd9ff869615e2611589f4e8795dea3fe9655ad27...d50e1b93f4f9571175f7daa5d13ba6d9aabc44c9,1,2,2,4,1,2013-06-28 22:38:06,2013-06-28 21:57:03
d50e1b93f4f9571175f7daa5d13ba6d9aabc44c9...babd275f88181c3f2cd29585816aab24bc4b421c,2,15,0,15,2,2013-06-28 22:43:03,2013-06-28 22:00:12
babd275f88181c3f2cd29585816aab24bc4b421c...83ecb9775b7997dd5115c53f6ea30d2e368a4244,21,1823,50,1873,48,2013-06-30 02:32:38,2013-06-30 01:58:07
83ecb9775b7997dd5115c53f6ea30d2e368a4244...85ca38c33e4aaebad539e78a05aed329b09c1208,1,1,1,2,1,2013-06-30 03:03:43,2013-06-30 03:03:43
85ca38c33e4aaebad539e78a05aed329b09c1208...59878c039978b28f0399ad20e349ae7ab9ddb1b8,1,4,4,8,2,2013-07-01 14:27:17,2013-07-01 14:27:17
59878c039978b28f0399ad20e349ae7ab9ddb1b8...a7079c5c7c901bae94306d764ee816d63bb9bf63,1,1,1,2,1,2013-07-01 16:08:38,2013-06-28 22:13:46
a7079c5c7c901bae94306d764ee816d63bb9bf63...2267744af0e972bceccb4ff4e9ed19a1ed639d2e,3,14,6,20,9,2013-07-01 16:10:17,2013-07-01 16:07:17
2267744af0e972bceccb4ff4e9ed19a1ed639d2e...edcded80dff8ef25eebf95cebf2099ab7da29cc0,2,3,8,11,4,2013-07-01 18:21:18,2013-06-28 19:38:00
edcded80dff8ef25eebf95cebf2099ab7da29cc0...1ef1d5118231f200d3a03007ba1dfd1fdb62dfea,4,29,10,39,8,2013-07-01 18:21:18,2013-06-28 19:55:04
1ef1d5118231f200d3a03007ba1dfd1fdb62dfea...64f066468c5d708d17321a44a1ded85002b4fe30,2,0,15,15,2,2013-07-01 18:53:15,2013-07-01 15:24:57
64f066468c5d708d17321a44a1ded85002b4fe30...50962f5188cc1d0cdc0e06c3d0aef0f1f84ebc53,3,3,0,3,3,2013-07-01 18:53:15,2013-07-01 15:27:40
50962f5188cc1d0cdc0e06c3d0aef0f1f84ebc53...f45a24632fa44c6c52ced657be68344efc7633e3,15,1575,1,1576,23,2013-07-01 20:53:24,2013-06-26 17:45:51
f45a24632fa44c6c52ced657be68344efc7633e3...ed4a672f9ffe6cec4a7ecdedbfe1e824aa2f5676,1,1,0,1,1,2013-07-01 21:13:42,2013-07-01 21:13:42
ed4a672f9ffe6cec4a7ecdedbfe1e824aa2f5676...01f1dc100623352300be761829b0e19be587de30,2,10,0,10,2,2013-07-01 21:12:36,2013-07-01 21:08:15
01f1dc100623352300be761829b0e19be587de30...c7a7210f90370b3314ac176aa3af4b77015e43b8,1,7,5,12,3,2013-07-01 21:35:05,2013-07-01 20:46:02
c7a7210f90370b3314ac176aa3af4b77015e43b8...4c076dc4786f838ce3c63e7706e597540ec029e8,2,9,5,14,3,2013-07-01 21:38:12,2013-05-06 15:17:23
4c076dc4786f838ce3c63e7706e597540ec029e8...48e0b758fab492458f608b9565853213f0fc043a,3,12,4,16,6,2013-07-01 21:38:12,2013-05-06 15:34:22
48e0b758fab492458f608b9565853213f0fc043a...d15b27260f62349d9d9aac0b53d60eaf284492c3,7,46,12,58,20,2013-07-01 21:38:12,2013-05-07 05:45:05
d15b27260f62349d9d9aac0b53d60eaf284492c3...90f1d8947a26b330accfaf69dc25ee1d892891d1,9,446,20,466,41,2013-07-01 21:41:53,2013-06-27 21:10:39
90f1d8947a26b330accfaf69dc25ee1d892891d1...2051cfd7b9e2ba09347fcd92a57db7b151b5abbb,1,1,1,2,1,2013-07-01 23:41:40,2013-07-01 23:41:40
2051cfd7b9e2ba09347fcd92a57db7b151b5abbb...718012dbfc5393d0f74ba5d8c947d85dd1676ece,1,1139,0,1139,1,2013-07-02 00:39:38,2013-07-01 13:05:59
718012dbfc5393d0f74ba5d8c947d85dd1676ece...91235163ae72ffa3955c80c92485a0ab80cce02d,4,5,5,10,5,2013-07-02 12:56:58,2013-07-02 12:56:58
91235163ae72ffa3955c80c92485a0ab80cce02d...a9226d98c4eb17a3dd1f34805335424d90aaf85a,2,5,10,15,2,2013-07-02 16:17:13,2013-07-02 14:51:03
a9226d98c4eb17a3dd1f34805335424d90aaf85a...a6766a1b1d9cdbcdad70ed1115e129bb0bb17366,21,69,76,145,37,2013-07-02 16:22:24,2013-06-25 15:33:00
a6766a1b1d9cdbcdad70ed1115e129bb0bb17366...2eceeb6202c17313fbcfe0cc101ec645b28bb350,1,13,10,23,5,2013-07-02 17:35:15,2013-07-02 17:35:15
2eceeb6202c17313fbcfe0cc101ec645b28bb350...ea7be9d5db2a3dde7c71ba21836dbb63180f438f,1,1,0,1,1,2013-07-02 18:11:06,2013-07-02 17:09:28
ea7be9d5db2a3dde7c71ba21836dbb63180f438f...5741e9a35cfdbf7aa475f4a611f9b57c0c98134d,15,108,32,140,18,2013-07-02 20:12:59,2013-07-02 19:53:47
5741e9a35cfdbf7aa475f4a611f9b57c0c98134d...2b400fabe2fbf0b7c62faeea329aacc15af71ed6,5,175,12,187,22,2013-07-03 10:32:25,2013-07-03 10:27:26
2b400fabe2fbf0b7c62faeea329aacc15af71ed6...b2b5e6663136a965ec0baaf377f88837e8a5b016,4,131,0,131,5,2013-07-03 13:18:13,2013-06-05 02:16:11
b2b5e6663136a965ec0baaf377f88837e8a5b016...665e6ec217b197577663fd739d66ae7a4e8aa359,7,499,1,500,7,2013-07-03 14:11:38,2013-07-01 18:33:38
665e6ec217b197577663fd739d66ae7a4e8aa359...cb9a63eacaf4e205c0361e362c8b7375b109ac4e,1,7,5,12,1,2013-07-03 14:27:58,2013-06-28 20:45:26
cb9a63eacaf4e205c0361e362c8b7375b109ac4e...f397dbcf4378d70a5cdc9b871f583a00d833b9ec,1,7,1,8,3,2013-07-03 14:31:13,2013-07-02 21:50:53
f397dbcf4378d70a5cdc9b871f583a00d833b9ec...7dff601fa5405c2c210015b7f90a80e8fe2551e6,1,15,0,15,1,2013-07-03 15:36:57,2013-07-03 15:36:57
7dff601fa5405c2c210015b7f90a80e8fe2551e6...3457954bb082d98dfd769d27771d4e30f3f785a5,2,25,0,25,2,2013-07-03 16:31:19,2013-07-03 16:30:56
3457954bb082d98dfd769d27771d4e30f3f785a5...00fb45cd97d2314548dc07c2c8e1cc1737fd273f,13,77,68,145,31,2013-07-03 17:29:37,2013-07-03 16:09:09
00fb45cd97d2314548dc07c2c8e1cc1737fd273f...cd3101ca2f8e539a4ad425fa8e6da55a935dd2b1,13,68,77,145,31,2013-07-03 18:27:17,2013-07-03 18:23:25
cd3101ca2f8e539a4ad425fa8e6da55a935dd2b1...de8ae2e2d4fa654b1ef2fbf840eeb05b24730e07,1,6,6,12,6,2013-07-03 19:12:50,2013-07-03 18:34:45
de8ae2e2d4fa654b1ef2fbf840eeb05b24730e07...95efa9a5dd492f8abc85e412aaec9163c7a93ad2,11,62,53,115,29,2013-07-03 19:40:53,2013-07-03 19:00:29
95efa9a5dd492f8abc85e412aaec9163c7a93ad2...c11ea25c522ce5ac3573b4a9638dfa069ed30d92,1,1,1,2,1,2013-07-03 20:31:14,2013-07-03 20:29:29
c11ea25c522ce5ac3573b4a9638dfa069ed30d92...fdad3c7653a494649c58ee4074a3f170a6eaca1f,1,1,1,2,1,2013-07-03 21:03:13,2013-07-03 21:02:05
fdad3c7653a494649c58ee4074a3f170a6eaca1f...5f949c19a26099320f1040e875b3841d4a362b26,1,19,1,20,1,2013-07-03 22:43:22,2013-07-03 22:39:56
5f949c19a26099320f1040e875b3841d4a362b26...1961a5d66cee7d9bc102cc2ff6f189c4c4306895,9,582,87,669,42,2013-07-05 14:35:20,2013-07-05 14:35:20
1961a5d66cee7d9bc102cc2ff6f189c4c4306895...3ac4551322eb2307e4957b4a1014f03768b17a82,14,1461,8,1469,24,2013-07-05 20:42:23,2013-07-03 00:01:25
3ac4551322eb2307e4957b4a1014f03768b17a82...54cd71ed4fcfb1b86271d76cef4d514d6f38fa7d,1,1,1,2,1,2013-07-05 21:09:51,2013-07-05 21:09:51
54cd71ed4fcfb1b86271d76cef4d514d6f38fa7d...074054ecb223db85a0245ac28fdd94788789af88,1,3,3,6,3,2013-07-05 21:14:51,2013-07-05 21:14:51
074054ecb223db85a0245ac28fdd94788789af88...bdf9a87b13e3ed0816746b462b9feef1742cbdb9,3,994,4,998,7,2013-07-06 01:49:55,2013-07-05 20:32:53
bdf9a87b13e3ed0816746b462b9feef1742cbdb9...949b656a5a5a05fee1c51b67c1c98234acbd2473,1,3,1,4,2,2013-07-07 15:47:31,2013-07-07 15:47:31
949b656a5a5a05fee1c51b67c1c98234acbd2473...2b9d003ef853584a85516be4d18fd01fa9a37056,1,7,1,8,2,2013-07-08 03:04:28,2013-07-05 16:11:35
2b9d003ef853584a85516be4d18fd01fa9a37056...82f148923f7b7d52d88b99a9153f6df8adb7ef64,22,267,214,481,37,2013-07-08 03:04:28,2013-07-05 20:16:41
82f148923f7b7d52d88b99a9153f6df8adb7ef64...fee51c2cf08a0d100f999a4a82e683aca84a49c3,9,28,24,52,13,2013-07-08 03:04:28,2013-07-05 20:36:12
fee51c2cf08a0d100f999a4a82e683aca84a49c3...57b46d6f1840c696e93d7fe0ef11153c5d2e1403,2,32,32,64,23,2013-07-08 03:04:28,2013-07-05 21:16:29
57b46d6f1840c696e93d7fe0ef11153c5d2e1403...140820325d9bfe574b86041ec938bdfef25b9f9d,1,6,8,14,3,2013-07-08 03:04:28,2013-07-06 02:02:20
140820325d9bfe574b86041ec938bdfef25b9f9d...5a6334c7fcb2d33ea2c58530fafeebd34c8c0cf4,6,4,11,15,7,2013-07-08 03:04:28,2013-07-06 02:42:21
5a6334c7fcb2d33ea2c58530fafeebd34c8c0cf4...7c21379b070154a381e3df340a1f830a074969b8,3,24,9,33,7,2013-07-08 09:09:07,2013-07-08 09:08:28
7c21379b070154a381e3df340a1f830a074969b8...7eef25c3aa99144f039132d869628391a82b9339,1,1,1,2,1,2013-07-08 13:51:35,2013-07-08 13:50:09
7eef25c3aa99144f039132d869628391a82b9339...a493a1a94fc159c175d144fab7a77e20bdf9e467,6,985,94,1079,61,2013-07-08 13:51:36,2013-07-07 19:16:25
a493a1a94fc159c175d144fab7a77e20bdf9e467...78878a0f998da4a3f9c3d5ce854da21b63bf1278,1,1,1,2,1,2013-07-08 14:32:29,2013-07-08 14:32:29
78878a0f998da4a3f9c3d5ce854da21b63bf1278...0564d3e830c7c3a2c0a2e4e7a24b4db7f878c368,5,203,45,248,7,2013-07-08 14:37:30,2013-07-08 14:37:30
0564d3e830c7c3a2c0a2e4e7a24b4db7f878c368...8cf1cd27240ef6e7127b7f86eca22da298b213ee,1,4,3,7,1,2013-07-08 18:24:23,2013-06-26 22:44:08
8cf1cd27240ef6e7127b7f86eca22da298b213ee...82f2196f64e9883e4e35ac9f07a4e1ecd195b682,1,2,10,12,3,2013-07-08 18:24:23,2013-07-08 18:22:12
82f2196f64e9883e4e35ac9f07a4e1ecd195b682...291f7c324d7361a84951bab734e3959f83ef2ba3,1,81,21,102,13,2013-07-08 18:58:26,2013-06-11 18:35:59
291f7c324d7361a84951bab734e3959f83ef2ba3...aeea19e327254a740b78ba5484946e93f0eac743,9,1273,0,1273,11,2013-07-08 19:51:05,2013-07-08 19:51:05
aeea19e327254a740b78ba5484946e93f0eac743...939978956b67fa059e8d61b5d1daf58e5b642de8,1,3,3,6,3,2013-07-08 20:43:02,2013-07-08 20:43:02
939978956b67fa059e8d61b5d1daf58e5b642de8...3e47b95f0de530d579f51fc0d4b588b45f8eda73,1,5,1,6,2,2013-07-08 20:44:26,2013-07-08 20:44:26
3e47b95f0de530d579f51fc0d4b588b45f8eda73...9a5e0a4f1659a1c8f30ffdfd2311babb318c62b7,1,17,0,17,1,2013-07-08 21:22:18,2013-07-08 17:42:37
9a5e0a4f1659a1c8f30ffdfd2311babb318c62b7...37697bdb58f91be434416c3b73b66ced4cb0efa0,1,3,1,4,2,2013-07-08 21:37:10,2012-10-03 03:45:09
37697bdb58f91be434416c3b73b66ced4cb0efa0...b57980929a4a35b1cb2d03f780f0c8fb8b1bc3b5,11,33,30,63,18,2013-07-08 22:11:04,2013-07-08 14:17:23
b57980929a4a35b1cb2d03f780f0c8fb8b1bc3b5...37501173c32474a43dd407a5ac4be74de0ed40a5,37,36,36,72,36,2013-07-08 22:11:04,2013-07-08 14:21:21
37501173c32474a43dd407a5ac4be74de0ed40a5...08840d93facf8f5440c4184063b7a972327fde44,3,64,3,67,6,2013-07-08 22:11:04,2013-07-08 14:47:20
08840d93facf8f5440c4184063b7a972327fde44...b46eec4b5770036d8e4e5ab91c0bd983972b1683,2,7,3,10,4,2013-07-08 22:11:04,2013-07-08 15:22:35
b46eec4b5770036d8e4e5ab91c0bd983972b1683...596f6524cdd61ea544fab9f50069825f336e1176,1,1,1,2,1,2013-07-08 22:14:30,2013-07-08 22:14:30
596f6524cdd61ea544fab9f50069825f336e1176...af45cb2615d13f1a29627ce2937633361413c797,1,26,26,52,23,2013-07-08 23:01:09,2013-02-15 14:10:23
af45cb2615d13f1a29627ce2937633361413c797...2dff1cb34284427ecec2028e61000ad7d4cd6947,8,104,95,199,20,2013-07-09 04:16:05,2013-07-09 04:15:42
2dff1cb34284427ecec2028e61000ad7d4cd6947...6bc6dc7360b9b346f3910cd16fb08d97d32c70b3,1,4,3,7,3,2013-07-09 11:56:23,2013-07-09 11:56:19
6bc6dc7360b9b346f3910cd16fb08d97d32c70b3...1b6bb038ccbf0d1b18bc97220e0190b2c251e78c,1,1,1,2,1,2013-07-09 13:29:31,2013-07-09 13:29:31
1b6bb038ccbf0d1b18bc97220e0190b2c251e78c...d3eb1d9463bf4bb1c799ac9a4dd110346e17c3fe,4,208,34,242,30,2013-07-09 13:57:06,2013-07-07 17:53:53
d3eb1d9463bf4bb1c799ac9a4dd110346e17c3fe...dfc904e4c74a5f1c17b817c9efc86d9ac1de6b6f,9,96,25,121,25,2013-07-09 14:12:17,2013-07-07 18:56:24
dfc904e4c74a5f1c17b817c9efc86d9ac1de6b6f...f1f85413baff9d0db1f715fa6051817d4d0d0277,1,4,1,5,1,2013-07-09 14:28:05,2013-07-09 14:28:05
f1f85413baff9d0db1f715fa6051817d4d0d0277...4fcb787834f6286cd42f07b798bc39efe2eec727,1,1,1,2,1,2013-07-09 14:37:56,2013-07-09 14:37:56
4fcb787834f6286cd42f07b798bc39efe2eec727...ec44394db451217894da2a203b8015ce06cc85dc,1,5,0,5,1,2013-07-09 14:51:16,2013-07-05 15:20:41
ec44394db451217894da2a203b8015ce06cc85dc...588155ed1cfcec217d0c978552d9ee44a0f06683,1,10,0,10,3,2013-07-09 15:03:29,2013-07-09 13:36:34
588155ed1cfcec217d0c978552d9ee44a0f06683...1a7ba538315e49f07122c20b0a4f085172f24dbb,1,17,6,23,4,2013-07-09 15:50:08,2013-07-09 15:43:53
1a7ba538315e49f07122c20b0a4f085172f24dbb...fedd312c424fc5f82f7be1dad13f3dd74403c4a4,1,12,6,18,3,2013-07-09 17:46:59,2013-07-09 17:46:59
fedd312c424fc5f82f7be1dad13f3dd74403c4a4...b8f0ec598013009c56dee527e76429ffa7b8c394,22,1498,23,1521,39,2013-07-09 18:10:54,2013-07-08 18:44:32
b8f0ec598013009c56dee527e76429ffa7b8c394...d067cc3531d62db6791d095c0471ee1aa245d471,4,36,14,50,10,2013-07-09 18:22:04,2013-07-02 21:47:19
d067cc3531d62db6791d095c0471ee1aa245d471...02435802ba79742942d9ab1cb6932344a2a0b821,4,101,69,170,31,2013-07-09 18:22:04,2013-07-02 22:02:03
02435802ba79742942d9ab1cb6932344a2a0b821...0e4a3a0c8439de066a09c3d17f1c23be85b49273,1,3,3,6,2,2013-07-09 18:46:07,2013-07-09 04:53:45
0e4a3a0c8439de066a09c3d17f1c23be85b49273...b918a9c83e0164ef610d3a0c45d4daa7f52ef20c,2,4,2,6,3,2013-07-09 19:30:49,2013-07-09 19:22:48
b918a9c83e0164ef610d3a0c45d4daa7f52ef20c...7711aed31df7d761fe272249fca32559c1fd120f,1,21,4,25,6,2013-07-09 20:11:48,2013-07-08 21:44:05
7711aed31df7d761fe272249fca32559c1fd120f...4bab9b0ee8dbffa00c4c86ea20195524a90f81f4,10,344,252,596,24,2013-07-09 20:43:33,2013-07-09 19:10:33
4bab9b0ee8dbffa00c4c86ea20195524a90f81f4...ea22c3173541606519ddcb6da578b837a092b1c1,130,2847,1306,4153,360,2013-07-09 20:43:33,2013-07-01 18:35:03
ea22c3173541606519ddcb6da578b837a092b1c1...740239e90b7f16463ed45f363cc13efb1383fa11,1,9,2,11,3,2013-07-09 21:28:19,2013-07-08 21:41:52
740239e90b7f16463ed45f363cc13efb1383fa11...1158aa623df2d64736240c1e85dabd173e120001,2,4,7,11,4,2013-07-09 21:49:14,2013-07-08 22:41:18
1158aa623df2d64736240c1e85dabd173e120001...c2c246e900c8b66805fa2c5aba872d92c28ced82,1,2,2,4,1,2013-07-09 22:07:11,2013-07-09 22:06:56
c2c246e900c8b66805fa2c5aba872d92c28ced82...8a0d36615ae385734fa5bb5e980fccaa372cc695,1,8,6,14,1,2013-07-09 22:11:30,2013-07-09 21:14:08
8a0d36615ae385734fa5bb5e980fccaa372cc695...2d0674bad139cf408403a61fcc6b246a3f8fdc32,1,2,8,10,2,2013-07-10 00:02:50,2013-07-08 18:37:32
2d0674bad139cf408403a61fcc6b246a3f8fdc32...11989a1f968d632eb78c8d6347b71ca39ef9ff80,1,2,1,3,2,2013-07-10 00:02:50,2013-07-09 17:35:22
11989a1f968d632eb78c8d6347b71ca39ef9ff80...b2d128b328405df243e4835615822f895049d8f2,2,61,9,70,6,2013-07-10 00:02:50,2013-07-08 22:19:22
b2d128b328405df243e4835615822f895049d8f2...5623bbd54da40c28f876a516760836b29ab2441f,1,35,20,55,35,2013-07-10 00:02:51,2013-07-09 21:21:50
5623bbd54da40c28f876a516760836b29ab2441f...2dd8b16ebbafd564fcd2967ec390da222dedc3c5,3,21,8,29,4,2013-07-10 00:02:51,2013-07-09 22:56:30
2dd8b16ebbafd564fcd2967ec390da222dedc3c5...be456c97dae7bdb93382174ce55e4fea5f949092,1,8,8,16,4,2013-07-10 00:02:51,2013-07-09 23:56:07
be456c97dae7bdb93382174ce55e4fea5f949092...86774c4091d3286b4ee2281402c67fba440e23c8,6,10,8,18,9,2013-07-10 00:04:01,2013-07-09 23:48:13
86774c4091d3286b4ee2281402c67fba440e23c8...c14eb6f50cc3887160af7b2bfb2340354034967d,2,181,44,225,21,2013-07-10 02:27:04,2013-07-08 22:02:54
c14eb6f50cc3887160af7b2bfb2340354034967d...331ca8a14dbc62cf065f3c8c6ed6ccd9a0eb9647,1,19,78,97,68,2013-07-10 02:27:04,2013-07-09 23:35:30
331ca8a14dbc62cf065f3c8c6ed6ccd9a0eb9647...81c207c0c5160d02dc8fe752ec662f943c0ee10d,1,24,8,32,6,2013-07-10 14:04:12,2013-07-10 10:50:36
81c207c0c5160d02dc8fe752ec662f943c0ee10d...9c222f4ffb1eac72d54b8c1237c8816b115af43b,1,14,1,15,5,2013-07-10 14:58:26,2013-07-10 03:38:18
9c222f4ffb1eac72d54b8c1237c8816b115af43b...6685c058c7bf4444f14fcae61f56b7783b5edebe,18,334,141,475,92,2013-07-10 15:04:01,2013-06-20 15:44:41
6685c058c7bf4444f14fcae61f56b7783b5edebe...f126215c5e23637a55c6fda08f5b5d6f1dcbce88,1,2,2,4,1,2013-07-10 16:02:05,2013-07-09 12:51:49
f126215c5e23637a55c6fda08f5b5d6f1dcbce88...2412e834cf3505f69a57b5443dc3484b171c0b68,13,171,189,360,130,2013-07-10 16:11:26,2013-07-10 16:11:26
2412e834cf3505f69a57b5443dc3484b171c0b68...61c4b0358b61b4cf4630999f45ca34d0cafd4a66,1,40,1,41,4,2013-07-10 16:26:15,2013-07-10 14:27:46
61c4b0358b61b4cf4630999f45ca34d0cafd4a66...03c4a237478c5637e36184a5cf1931435408fdf6,1,12,4,16,9,2013-07-10 17:04:47,2013-07-10 16:32:25
03c4a237478c5637e36184a5cf1931435408fdf6...290750178aee02a006f730205068fc8cffcb7031,5,148,68,216,48,2013-07-10 17:13:31,2013-07-09 18:10:16
290750178aee02a006f730205068fc8cffcb7031...d430713c403fa6b065337cf7e480ed70940631ab,9,96,68,164,20,2013-07-10 17:26:13,2013-07-03 18:56:21
d430713c403fa6b065337cf7e480ed70940631ab...4f7713325020275578cce51dcd6ba7a1a19cfb22,1,1,1,2,1,2013-07-10 18:02:27,2013-07-10 18:02:27
4f7713325020275578cce51dcd6ba7a1a19cfb22...089d5992f9000d618a59f79fa5dc1a3e818c2ad0,4,217,149,366,7,2013-07-10 18:49:00,2013-07-10 18:49:00
089d5992f9000d618a59f79fa5dc1a3e818c2ad0...01b912eb0897f490159f27be3142bd82d8806206,11,1159,246,1405,124,2013-07-10 19:02:16,2013-07-10 17:13:29
01b912eb0897f490159f27be3142bd82d8806206...c293028c1516b170e0fc5218f9e25c89f290daa5,3,108,6,114,6,2013-07-10 19:02:16,2013-07-10 17:32:10
c293028c1516b170e0fc5218f9e25c89f290daa5...1556be30b24b7a00038182e233a52e6c20385c26,1,0,2,2,1,2013-07-10 19:24:49,2013-07-10 19:24:49
1556be30b24b7a00038182e233a52e6c20385c26...53dab689a519b4daf6a5c4772123b74616c0283b,8,514,15,529,23,2013-07-10 19:37:48,2013-07-01 20:51:30
53dab689a519b4daf6a5c4772123b74616c0283b...2d09800f72846436b5d560a5d21e240d944c316e,1,116,0,116,1,2013-07-10 19:52:08,2013-07-10 19:52:08
2d09800f72846436b5d560a5d21e240d944c316e...2e2a6fdffdba369a0594962267e5bc7bb47a3f3a,9,68,96,164,20,2013-07-10 20:43:31,2013-07-10 20:28:51
2e2a6fdffdba369a0594962267e5bc7bb47a3f3a...0e573d73f6bf7deea31e3f2c6076fe21a07effe0,9,123,126,249,41,2013-07-10 21:17:58,2013-07-01 22:15:42
0e573d73f6bf7deea31e3f2c6076fe21a07effe0...1571ab85d3ecfd5b21670c00d6d29b6700adb84a,4,185,22,207,10,2013-07-10 21:17:59,2013-07-02 19:43:48
1571ab85d3ecfd5b21670c00d6d29b6700adb84a...7d978b9ef92ca75a3b690601e7826a53f796c86a,12,439,534,973,199,2013-07-10 21:17:59,2013-07-03 17:43:31
7d978b9ef92ca75a3b690601e7826a53f796c86a...fc3c814a0ac7cec753aa5ad18ec1c07ea84ecaf1,3,238,31,269,34,2013-07-10 21:17:59,2013-07-08 16:35:42
fc3c814a0ac7cec753aa5ad18ec1c07ea84ecaf1...5c3e1d60f26b8b6502904e9ca4c9b8626c18bd1b,15,9,255,264,37,2013-07-10 21:17:59,2013-07-08 18:29:13
5c3e1d60f26b8b6502904e9ca4c9b8626c18bd1b...866c02716a21da7e0568569c5f7f96bbbab8cce7,2,13,0,13,4,2013-07-10 21:17:59,2013-07-10 16:45:22
866c02716a21da7e0568569c5f7f96bbbab8cce7...b6d259180642b0bb3296928ad4d6740e63ac30bf,1,5,3,8,4,2013-07-10 21:17:59,2013-07-10 17:05:08
b6d259180642b0bb3296928ad4d6740e63ac30bf...9d28e59d9cdf7ceb70e4b8a5a75b0b9bcb5c9354,1,8,2,10,3,2013-07-10 21:17:59,2013-07-10 18:30:00
9d28e59d9cdf7ceb70e4b8a5a75b0b9bcb5c9354...8512fdda5f4a5d69fa9084339eec13da9de10e7a,8,81,8,89,12,2013-07-10 21:17:59,2013-07-10 19:37:03
8512fdda5f4a5d69fa9084339eec13da9de10e7a...429a6df08c21b02032ba926963fb34d370be5011,4,134,121,255,41,2013-07-10 21:27:36,2013-06-25 16:15:26
429a6df08c21b02032ba926963fb34d370be5011...0f43cfcbe063c1f4615ce362e751155218224bec,5,46,13,59,10,2013-07-10 21:29:10,2013-07-08 20:37:34
0f43cfcbe063c1f4615ce362e751155218224bec...a51f2688fa05672d999c997170847a3ee29a223b,16,403,16,419,36,2013-07-10 21:43:58,2013-07-09 03:19:53
a51f2688fa05672d999c997170847a3ee29a223b...7b28670611588fa3fd8ee89f70abc7a979c76fce,2,32,28,60,12,2013-07-10 23:05:43,2013-07-10 23:05:43
7b28670611588fa3fd8ee89f70abc7a979c76fce...331e3dc9c056a025c5bb5dca81ad4738d48dedc6,1,1,0,1,1,2013-07-11 15:24:24,2013-07-11 15:24:24
331e3dc9c056a025c5bb5dca81ad4738d48dedc6...0d5e34388ccfb8ebac716ff6eb4877cdb287f24c,1,7,1,8,3,2013-07-11 16:23:17,2013-07-11 16:01:48
0d5e34388ccfb8ebac716ff6eb4877cdb287f24c...1d73fc675b2f437c05e48e136e7871bde128a26a,1,1,1,2,1,2013-07-11 18:15:30,2013-07-09 21:14:23
1d73fc675b2f437c05e48e136e7871bde128a26a...3e7274c55c42539c36fc2e251512add7ca49bd60,1,11,9,20,1,2013-07-11 19:43:19,2013-07-11 19:43:19
3e7274c55c42539c36fc2e251512add7ca49bd60...b1830ddbacbf2ade577514bde7ee16cbef2cb949,1,3,3,6,1,2013-07-11 19:50:08,2013-07-11 19:26:09
b1830ddbacbf2ade577514bde7ee16cbef2cb949...e1cc815cb6156fc6c3bc4925a5ecf3784d7cf9a9,2,0,2,2,2,2013-07-11 20:36:06,2013-07-11 20:25:22
e1cc815cb6156fc6c3bc4925a5ecf3784d7cf9a9...7076bcc8d4774c354025b2c568b93cd8805aa093,1,3,3,6,2,2013-07-11 20:38:57,2013-07-11 20:23:42
7076bcc8d4774c354025b2c568b93cd8805aa093...db49b72d3a6abedd3d1304d27334140d608116eb,1,6,1,7,4,2013-07-11 21:17:00,2013-07-11 20:31:52
db49b72d3a6abedd3d1304d27334140d608116eb...06107f8ea8fb7fdf1515420a6b1e2c70b087c955,1,12,3,15,4,2013-07-11 22:52:38,2013-07-11 21:46:45
06107f8ea8fb7fdf1515420a6b1e2c70b087c955...30a130776b43c283fc8c38c48a9478e935a69bc2,4,15,13,28,13,2013-07-11 23:15:08,2013-07-11 22:48:32
30a130776b43c283fc8c38c48a9478e935a69bc2...42b8033f86de1e51283118bf00c0f13493536109,1,7,0,7,2,2013-07-12 13:48:37,2013-07-11 22:05:23
42b8033f86de1e51283118bf00c0f13493536109...7bafcc73b71bfd364786f6faf4401d345d714eba,1,2,0,2,2,2013-07-12 16:46:39,2013-07-12 15:47:26
7bafcc73b71bfd364786f6faf4401d345d714eba...edbd2e1d70b2303d378aae91315974312c260ef9,1,1,1,2,1,2013-07-12 19:03:30,2013-07-12 19:03:30
edbd2e1d70b2303d378aae91315974312c260ef9...ac386485a9b9f141a518f2aca1a2b66b8f976104,8,2247,77,2324,155,2013-07-12 19:05:51,2013-07-12 01:05:20
ac386485a9b9f141a518f2aca1a2b66b8f976104...6486b4035c5ac52679eb3e1a034c925ccdd20deb,21,50,1828,1878,48,2013-07-12 19:14:09,2013-07-12 18:24:08
6486b4035c5ac52679eb3e1a034c925ccdd20deb...723a68c9afbe134c9dffe9312640ec22e941527e,1,3,1,4,3,2013-07-12 19:14:09,2013-07-12 19:13:31
723a68c9afbe134c9dffe9312640ec22e941527e...85cc36126c772ed5e406bebf68fa24a49e7109c4,1,0,16,16,1,2013-07-12 19:38:40,2013-07-12 19:14:30
85cc36126c772ed5e406bebf68fa24a49e7109c4...0bd1b72a38bcbc598be5338b207c76a44c10810b,1,3,0,3,3,2013-07-12 22:05:29,2013-07-12 22:05:26
0bd1b72a38bcbc598be5338b207c76a44c10810b...15333b2a308fd26c28448810780b06407328a795,2,7,0,7,4,2013-07-12 22:06:14,2013-07-12 21:50:42
15333b2a308fd26c28448810780b06407328a795...6e3ccc5649d16fd9940bc8fd1b490556d5767bf8,11,189,92,281,47,2013-07-12 22:08:19,2013-07-12 22:05:35
6e3ccc5649d16fd9940bc8fd1b490556d5767bf8...458cfbf633d94357212d03587e6544d296df58d5,1,2,0,2,1,2013-07-12 22:33:28,2013-07-12 22:33:28
458cfbf633d94357212d03587e6544d296df58d5...f204f7fdc3ab8a25f37e6700b9801a468417a7f2,4,0,16,16,8,2013-07-13 19:27:39,2013-07-13 19:27:39
f204f7fdc3ab8a25f37e6700b9801a468417a7f2...e375392233c712e1c9d628f209796883fa3463c2,2,18,11,29,6,2013-07-15 12:23:17,2013-07-11 22:07:23
e375392233c712e1c9d628f209796883fa3463c2...c0cd2bc13effe27c31c9bd2ae2ef334f2044aa79,1,57,53,110,2,2013-07-15 12:23:17,2013-07-12 16:42:09
c0cd2bc13effe27c31c9bd2ae2ef334f2044aa79...4d95966d3ec97c148d887fd97265b55cb01309e1,3,22,5,27,7,2013-07-15 12:53:39,2013-07-15 12:53:34
4d95966d3ec97c148d887fd97265b55cb01309e1...746dee394d9529b42b785d4c72c1187bc33c936f,2,35,1,36,3,2013-07-15 13:12:42,2013-07-12 16:13:08
746dee394d9529b42b785d4c72c1187bc33c936f...5fb3b3d28710ab5b02af3ab574a495feea0c9d43,9,67,18,85,9,2013-07-15 13:59:36,2013-07-15 13:59:36
5fb3b3d28710ab5b02af3ab574a495feea0c9d43...49a2a3e03eba6503e2a5e09709d4816fee7c8b19,1,1,0,1,1,2013-07-15 14:00:20,2013-07-15 14:00:15
49a2a3e03eba6503e2a5e09709d4816fee7c8b19...8c0ff93cc3f7088794f1d28322fe29702998165d,1,4,1,5,3,2013-07-15 15:41:47,2013-07-15 15:41:47
8c0ff93cc3f7088794f1d28322fe29702998165d...08439d7693f2c005dd2013eb482526706fb49b7f,1,3,2,5,3,2013-07-15 18:59:42,2013-07-15 18:58:55
08439d7693f2c005dd2013eb482526706fb49b7f...704dc4fdf5248077c53271f249260478d6c56cd3,1,39,23,62,7,2013-07-15 19:16:35,2013-07-15 17:52:20
704dc4fdf5248077c53271f249260478d6c56cd3...2cf30807f82d325ef706211667cd80e008e8ca68,1,9,0,9,2,2013-07-16 14:36:20,2013-07-16 14:36:20
2cf30807f82d325ef706211667cd80e008e8ca68...41affec0b4b0afe1a2cd2abf52c08c922bd2abb8,1,1,0,1,1,2013-07-16 16:30:05,2013-07-16 16:30:05
41affec0b4b0afe1a2cd2abf52c08c922bd2abb8...dd226d98a53286a5af892f0b81a5252dd62f7444,2,2,2,4,2,2013-07-16 16:33:33,2013-07-16 16:31:28
dd226d98a53286a5af892f0b81a5252dd62f7444...354a844c45a2d3734cdce0f22525bb8fe5de37a1,2,2,2,4,2,2013-07-17 18:01:13,2013-07-17 18:01:13
354a844c45a2d3734cdce0f22525bb8fe5de37a1...f62d600cb0a2680b72a35023e812140da50056ca,10,99,69,168,21,2013-07-17 18:35:14,2013-07-11 15:33:07
f62d600cb0a2680b72a35023e812140da50056ca...457e50ba8c19cc6df8d865a870268a5a5462de8b,5,76,1,77,7,2013-07-17 18:37:37,2013-07-09 20:57:51
457e50ba8c19cc6df8d865a870268a5a5462de8b...5e63001cd9bb86f57af2343536a0a0cd32f35dc2,10,1285,1,1286,13,2013-07-17 18:51:32,2013-07-10 18:55:24
5e63001cd9bb86f57af2343536a0a0cd32f35dc2...7ef3fcb0b938c96fddfec5e87f1b63d55d508368,3,6,12,18,4,2013-07-17 18:56:36,2013-07-16 20:57:54
7ef3fcb0b938c96fddfec5e87f1b63d55d508368...b85f738cebd1846ca995b25e21406532e5400497,5,25,10,35,12,2013-07-17 19:12:37,2013-07-09 21:49:53
b85f738cebd1846ca995b25e21406532e5400497...fec9c2a9fa948f9a3e3e1f3ef0ddd753532b3b24,3,48,35,83,32,2013-07-17 19:30:59,2013-07-10 18:53:45
fec9c2a9fa948f9a3e3e1f3ef0ddd753532b3b24...18681a8276159d24418f5b8c4d64621de837839c,1,5,1,6,3,2013-07-17 19:49:14,2013-07-16 21:56:47
18681a8276159d24418f5b8c4d64621de837839c...0b1e95f481a82892f2df30c9ae0cdd1b485c9057,1,4,4,8,4,2013-07-17 20:35:00,2013-07-16 20:57:06
0b1e95f481a82892f2df30c9ae0cdd1b485c9057...67957614060f635bb0b6dfc3340d8ff64a680156,1,9,20,29,11,2013-07-17 21:13:45,2013-07-17 21:04:27
67957614060f635bb0b6dfc3340d8ff64a680156...752f704bc0fb5c771b74a033364eaa045eda2040,10,272,8,280,19,2013-07-17 21:36:28,2013-07-07 21:56:41
752f704bc0fb5c771b74a033364eaa045eda2040...0eb227c15841da86dbf9d21e7e593c7659040963,5,213,27,240,25,2013-07-17 21:47:36,2013-07-17 18:43:10
0eb227c15841da86dbf9d21e7e593c7659040963...beb5a898a6646b12a48977829c39fe084911ee34,1,3,3,6,2,2013-07-17 23:23:48,2013-07-17 23:23:48
beb5a898a6646b12a48977829c39fe084911ee34...22dd649cbcc7828a78ba677ad7705db7a1bcbe7b,6,106,0,106,19,2013-07-18 08:38:57,2013-07-18 08:38:57
22dd649cbcc7828a78ba677ad7705db7a1bcbe7b...a2960637041c11bc1d8b925e5a99975b7fe9485e,1,3,2,5,1,2013-07-18 10:30:01,2013-07-17 13:10:48
a2960637041c11bc1d8b925e5a99975b7fe9485e...c95d4bc5744dc6aaa9abf202ebee0bee2ffa5463,53,1330,985,2315,183,2013-07-18 13:35:32,2013-07-18 13:35:32
c95d4bc5744dc6aaa9abf202ebee0bee2ffa5463...5100671e7de35c8dab44f1943babcea45095fcfa,1,4,2,6,3,2013-07-18 14:27:50,2013-07-18 14:27:50
5100671e7de35c8dab44f1943babcea45095fcfa...2f03ad166b9aabe5d7501e03eda7738f2822280f,1,1,1,2,1,2013-07-18 14:42:40,2013-07-18 14:37:41
2f03ad166b9aabe5d7501e03eda7738f2822280f...6e5b61610af007af85045ebb4b3dd2c183a9d048,1,1,0,1,1,2013-07-18 15:50:02,2013-07-18 15:50:02
6e5b61610af007af85045ebb4b3dd2c183a9d048...a64cbc9c0f2c98ea48a0efdaa431075e1912fe51,10,9,9,18,10,2013-07-18 17:16:42,2013-07-18 00:50:21
a64cbc9c0f2c98ea48a0efdaa431075e1912fe51...46a7a951f43dd20aa20937bbeed0584c9dd19485,1,25,2,27,3,2013-07-18 17:16:43,2013-07-18 00:50:55
46a7a951f43dd20aa20937bbeed0584c9dd19485...f83212339810f4cecbc944fede69c9455bd4531c,2,22,1,23,3,2013-07-18 17:22:10,2013-07-17 17:43:21
f83212339810f4cecbc944fede69c9455bd4531c...3f4169d7144fe1300129f5b0ccda1b75b8f76cef,3,62,76,138,25,2013-07-18 18:18:56,2013-07-15 20:31:42
3f4169d7144fe1300129f5b0ccda1b75b8f76cef...6f43961ec9d4afffac6e532ccb45bd3ceafbb709,1,15,8,23,6,2013-07-18 18:40:58,2013-07-18 15:13:54
6f43961ec9d4afffac6e532ccb45bd3ceafbb709...83d3c89666975eeed651049f56fbf5d035d85d22,1,0,2,2,1,2013-07-18 18:43:33,2013-07-18 18:40:26
83d3c89666975eeed651049f56fbf5d035d85d22...8d9a893e84a125f3a7d35898e25c6babfd792dfa,8,112,40,152,43,2013-07-19 10:14:42,2013-07-19 10:14:42
8d9a893e84a125f3a7d35898e25c6babfd792dfa...cc54cdf3aa4a42308d135a393bf736aeb58d89d1,10,1468,1,1469,15,2013-07-19 13:25:48,2013-07-16 14:14:57
cc54cdf3aa4a42308d135a393bf736aeb58d89d1...366e3e92f6335720fb9a9e588a3e093cda3415f5,1,5,1,6,2,2013-07-19 13:43:32,2013-07-16 20:57:29
366e3e92f6335720fb9a9e588a3e093cda3415f5...1ddba8d97313a167e54a1f65c320d4bbddf2340b,6,74,0,74,19,2013-07-19 13:59:09,2013-07-19 13:59:09
1ddba8d97313a167e54a1f65c320d4bbddf2340b...f29364047e9328b689d52dc45222452bbee4b84e,7,100,101,201,40,2013-07-19 14:56:53,2013-07-03 22:31:20
f29364047e9328b689d52dc45222452bbee4b84e...129d2ddff0d3d0b8cb041473525af41c63cd1470,4,35,2,37,9,2013-07-19 14:58:23,2013-07-10 20:00:56
129d2ddff0d3d0b8cb041473525af41c63cd1470...bcf8d9f3366c8362a45afa03831851f4964c2c23,1,1,1,2,1,2013-07-19 15:35:32,2013-07-19 15:35:01
bcf8d9f3366c8362a45afa03831851f4964c2c23...d2b2f42b5012c64468ab7ab24b137f4828b2405d,2,10,2,12,3,2013-07-19 15:35:33,2013-07-16 21:38:09
d2b2f42b5012c64468ab7ab24b137f4828b2405d...228ad77a39a471b323095691dbbe1a9fd7150f38,1,6,1,7,1,2013-07-19 15:48:41,2013-07-19 14:51:02
228ad77a39a471b323095691dbbe1a9fd7150f38...23170882979115ad884818ea765047382d8ecf65,38,833,365,1198,230,2013-07-19 16:03:57,2013-07-16 23:53:43
23170882979115ad884818ea765047382d8ecf65...fe0cfee0effbf9fbb8200ecfac332d8b52c165c2,4,86,19,105,27,2013-07-19 16:12:11,2013-07-10 18:49:22
fe0cfee0effbf9fbb8200ecfac332d8b52c165c2...c04a24af25d1dac21eab524bd3ee146bddc303d3,4,38,26,64,14,2013-07-19 16:12:27,2013-07-10 20:39:10
c04a24af25d1dac21eab524bd3ee146bddc303d3...1cb08f64a9e9087712b57197911d182a0220a9b9,1,25,30,55,9,2013-07-19 16:12:32,2013-07-15 21:31:28
1cb08f64a9e9087712b57197911d182a0220a9b9...248744606c4eb89ba4741a0b5e3725b284a756a9,2,93,1,94,4,2013-07-19 16:57:22,2013-07-15 18:22:27
248744606c4eb89ba4741a0b5e3725b284a756a9...77ab6a325498a7dd8f4a60e4c7cf1c6385f1ad98,2,72,5,77,6,2013-07-19 17:11:05,2013-07-08 15:58:52
77ab6a325498a7dd8f4a60e4c7cf1c6385f1ad98...846fee4f9a82922e04fd66221736f24f29e68a80,2,0,15,15,2,2013-07-19 17:17:55,2013-07-19 17:17:55
846fee4f9a82922e04fd66221736f24f29e68a80...f7dfc4db117e0111aabf34c422a03b446c56bffa,1,3,4,7,2,2013-07-19 18:03:29,2013-07-19 17:33:02
f7dfc4db117e0111aabf34c422a03b446c56bffa...80963d908389e65926a32c6ac4dd67185b7248f9,4,42,0,42,8,2013-07-19 18:07:30,2013-07-19 18:07:30
80963d908389e65926a32c6ac4dd67185b7248f9...ede1257b6fc1169beedcf59b241fc07b921ddcb9,3,83,45,128,22,2013-07-19 18:28:49,2013-07-17 18:43:19
ede1257b6fc1169beedcf59b241fc07b921ddcb9...37b7c5c0fcd4a3a9115e0e112323d123b578a60c,4,26,8,34,4,2013-07-19 18:34:11,2013-07-19 18:33:37
37b7c5c0fcd4a3a9115e0e112323d123b578a60c...afac7785f2b8a286327abfea9c5343c33055f61c,1,0,50,50,2,2013-07-19 20:50:42,2013-07-19 20:50:42
afac7785f2b8a286327abfea9c5343c33055f61c...dc70e61fc3300bb5f4f27d6f1c2a0cb7669c4fbc,1,3,1,4,2,2013-07-19 21:02:33,2013-07-19 19:54:57
dc70e61fc3300bb5f4f27d6f1c2a0cb7669c4fbc...2f3bb8c8550a798c7388313273fe8c71e94dc552,1,0,8,8,1,2013-07-19 21:02:33,2013-07-19 19:57:54
2f3bb8c8550a798c7388313273fe8c71e94dc552...04469544920312ead0bd1a85b1f2d26a4bc4f52d,1,1,1,2,1,2013-07-19 21:42:48,2013-07-12 15:11:50
04469544920312ead0bd1a85b1f2d26a4bc4f52d...efcc0b99d66d5acc5d64e03e953b376146d3f2eb,1,85,88,173,28,2013-07-20 11:31:38,2013-07-20 11:31:38
efcc0b99d66d5acc5d64e03e953b376146d3f2eb...14e3de5ca929ef3187768146c7bf6a102f56db1f,1,4,1,5,1,2013-07-20 12:16:26,2013-07-20 12:16:26
14e3de5ca929ef3187768146c7bf6a102f56db1f...9a4ac2f650a3c55218a50dd275665f81b016e7d9,2,5,72,77,6,2013-07-20 17:55:55,2013-07-20 17:55:55
9a4ac2f650a3c55218a50dd275665f81b016e7d9...9bf70757db09b3a7166440c508bf798d50bd212a,1,8,0,8,1,2013-07-20 19:38:03,2013-07-20 19:38:03
9bf70757db09b3a7166440c508bf798d50bd212a...27c4e7fbd2ef6eeb04dccd1bcdecdb21b00522d1,21,1828,50,1878,48,2013-07-22 14:43:40,2013-07-15 18:30:17
27c4e7fbd2ef6eeb04dccd1bcdecdb21b00522d1...96c541693cc5b6954a5286788f7ef88f5c680bc6,9,93,47,140,40,2013-07-22 14:43:40,2013-07-22 14:38:19
96c541693cc5b6954a5286788f7ef88f5c680bc6...90526f8ca838873e40cda563e77c9f4ba71936e5,1,1,1,2,1,2013-07-22 14:51:16,2013-07-22 14:50:18
90526f8ca838873e40cda563e77c9f4ba71936e5...f33b633a7110d60a54626f17421c283e90a47c2f,3,95,28,123,18,2013-07-22 18:01:41,2013-07-20 21:06:03
f33b633a7110d60a54626f17421c283e90a47c2f...4e2b1743b1366a5c6f943dbb40df2d19ac190da5,13,73,82,155,74,2013-07-22 18:03:04,2013-07-19 21:22:54
4e2b1743b1366a5c6f943dbb40df2d19ac190da5...cd03b044d5050a763f7572471aaf2d8c9b3b59d2,21,123,228,351,308,2013-07-22 18:03:59,2013-07-19 21:41:14
cd03b044d5050a763f7572471aaf2d8c9b3b59d2...819bc8fc804a9be8f36dc53d2f0008072adb137c,3,218,0,218,7,2013-07-22 18:13:55,2013-07-22 17:47:30
819bc8fc804a9be8f36dc53d2f0008072adb137c...aa44eb2ce901ab2d82e8faa0799550ca15ccaf7e,5,50,5,55,18,2013-07-22 18:23:01,2013-07-17 22:06:14
aa44eb2ce901ab2d82e8faa0799550ca15ccaf7e...bc05a457d5acb38e818996a6ffaac2b74149cb40,2,35,33,68,6,2013-07-22 19:22:54,2013-07-22 19:22:54
bc05a457d5acb38e818996a6ffaac2b74149cb40...8f0c10ec3f576b9c44213114ce8540f8a6698206,4,42,60,102,22,2013-07-22 19:42:39,2013-07-16 22:02:56
8f0c10ec3f576b9c44213114ce8540f8a6698206...6f1068dca58b4f51bf8859c98bba6fc28b10bdea,4,81,1,82,11,2013-07-22 19:42:39,2013-07-18 20:49:14
6f1068dca58b4f51bf8859c98bba6fc28b10bdea...90514f2d84a389060c63e826449b32dca8cab0f5,1,6,8,14,4,2013-07-22 19:42:39,2013-07-10 23:21:30
90514f2d84a389060c63e826449b32dca8cab0f5...7923b6c994b63bcf7ae4d8a41ee134885509c866,8,42,17,59,18,2013-07-22 19:43:10,2013-07-17 21:49:42
7923b6c994b63bcf7ae4d8a41ee134885509c866...dc6683226d664a38036382750c9776b3df894ca0,7,44,18,62,9,2013-07-22 19:44:57,2013-07-10 20:25:19
dc6683226d664a38036382750c9776b3df894ca0...4b156454bcd549b1e87d4b5eec36a842c5b3e32f,3,13,27,40,6,2013-07-22 19:53:00,2013-07-22 19:52:56
4b156454bcd549b1e87d4b5eec36a842c5b3e32f...53ebfd3a3d4b14602150a323f8967fb18609dc01,1,6,5,11,6,2013-07-22 19:56:47,2013-07-22 19:50:55
53ebfd3a3d4b14602150a323f8967fb18609dc01...8ef6f6a883b86b69c132931e29ded1d53b9442c6,1,18,0,18,2,2013-07-22 19:56:47,2013-07-22 19:51:15
8ef6f6a883b86b69c132931e29ded1d53b9442c6...0ba6f77490f2814ed0772e52385e2a124f05f7a9,4,15,0,15,6,2013-07-22 20:23:09,2013-07-22 19:33:27
0ba6f77490f2814ed0772e52385e2a124f05f7a9...3cf081b971bc0bc8efccf1b9591e95ec71a42d7c,4,64,3,67,5,2013-07-22 20:33:35,2013-07-22 20:33:35
3cf081b971bc0bc8efccf1b9591e95ec71a42d7c...b51ad40a7b582baea1ba25b46020f6b4275878e9,6,147,10,157,12,2013-07-22 21:39:15,2013-07-20 17:59:57
b51ad40a7b582baea1ba25b46020f6b4275878e9...c8fac60210477e7c716dc4c5e67556d63b703bb4,1,4,0,4,2,2013-07-22 22:19:40,2013-07-22 19:57:03
c8fac60210477e7c716dc4c5e67556d63b703bb4...b7215685ff469fd04d5581df54537bedbb976f14,3,47,17,64,6,2013-07-23 12:40:36,2013-07-23 12:31:16
b7215685ff469fd04d5581df54537bedbb976f14...4211c6a8de32fa774b1c28fb82a96f965fd550b7,3,124,24,148,19,2013-07-23 12:40:36,2013-07-23 12:36:52
4211c6a8de32fa774b1c28fb82a96f965fd550b7...9fdbade1caa618f32016a19e4fb7ddd5475c59f9,3,5,2,7,4,2013-07-23 16:27:30,2013-07-23 16:27:30
9fdbade1caa618f32016a19e4fb7ddd5475c59f9...10c130a0c7fc88bde739beb725a20aa600f32ff1,2,30,4,34,4,2013-07-23 17:08:00,2013-07-22 19:25:00
10c130a0c7fc88bde739beb725a20aa600f32ff1...b9cf1dabbe193d3717d8b53a24f666ecf91b40d8,11,227,165,392,49,2013-07-23 18:44:14,2013-07-22 19:55:45
b9cf1dabbe193d3717d8b53a24f666ecf91b40d8...37f7f30a5abc3f16bbc2001bb44eb6c65d360bef,4,6,6,12,6,2013-07-23 18:51:17,2013-07-23 18:51:17
37f7f30a5abc3f16bbc2001bb44eb6c65d360bef...a36c34b7f6fc2120e0cdf1e43609fe7cef2eb82c,1,5,4,9,1,2013-07-23 21:32:12,2013-07-23 21:32:02
a36c34b7f6fc2120e0cdf1e43609fe7cef2eb82c...32ecefa73b82c45dd40701cbd64275fbfed11e4c,2,209,410,619,57,2013-07-23 23:50:31,2013-07-22 20:19:11
32ecefa73b82c45dd40701cbd64275fbfed11e4c...f9b40bf3ae57a0ee9301d70bf45c127a463563da,2,39,0,39,3,2013-07-23 23:50:31,2013-07-22 20:22:18
f9b40bf3ae57a0ee9301d70bf45c127a463563da...cefa4cf1d64db11822f73c3a9cd25263dd013d38,1,1,1,2,1,2013-07-24 12:21:10,2013-07-24 12:20:59
cefa4cf1d64db11822f73c3a9cd25263dd013d38...9ba3ea135b9f8e13e32c737899e301c73eedf735,4,16,0,16,8,2013-07-24 15:11:03,2013-07-24 15:11:03
9ba3ea135b9f8e13e32c737899e301c73eedf735...105ffd335638a80d90297321d5806cc8b2b67d80,1,3,3,6,3,2013-07-24 16:03:56,2013-07-24 00:38:15
105ffd335638a80d90297321d5806cc8b2b67d80...b159c99796a977ca74f20451f9552fadab8d8cda,1,9,3,12,2,2013-07-24 16:04:31,2013-07-23 23:10:02
b159c99796a977ca74f20451f9552fadab8d8cda...0c9209c6d59477eadf27697999f6af59d931251c,6,157,36,193,15,2013-07-24 16:48:42,2013-07-23 22:44:16
0c9209c6d59477eadf27697999f6af59d931251c...66d94037a5c2498809abc2c596f2c7a2e332068d,4,18,7,25,10,2013-07-24 16:48:42,2013-07-24 00:37:48
66d94037a5c2498809abc2c596f2c7a2e332068d...d10114734e1e718f1184714d0d0db8b7ccd70e10,14,84,103,187,33,2013-07-24 16:48:42,2013-07-24 00:53:47
d10114734e1e718f1184714d0d0db8b7ccd70e10...7996179c7162acf54ff654d13178ef29e1bb1748,1,1,1,2,1,2013-07-24 18:20:08,2013-07-24 18:18:44
7996179c7162acf54ff654d13178ef29e1bb1748...0f1415f54297c5a9fedeeee0f50020194720018c,5,1,17,18,9,2013-07-24 18:57:45,2013-07-23 20:14:08
0f1415f54297c5a9fedeeee0f50020194720018c...b46e9909da93aeef4ba49c9923f023e6a4887d0e,5,22,9,31,9,2013-07-24 18:57:45,2013-07-23 20:59:22
b46e9909da93aeef4ba49c9923f023e6a4887d0e...3ef5807b169f033b1e2d4db1a0d8e2f46a7c1d13,2,16,0,16,2,2013-07-24 20:03:13,2013-07-24 20:03:07
3ef5807b169f033b1e2d4db1a0d8e2f46a7c1d13...127ebecce02c06939d76dfaee5a4a7fb11535448,1,1,1,2,1,2013-07-24 20:22:05,2013-07-24 20:22:05
127ebecce02c06939d76dfaee5a4a7fb11535448...9b4367bfc32e2e937da154e87db6e97fb2509b46,1,0,1,1,1,2013-07-24 20:31:46,2013-07-24 20:31:46
9b4367bfc32e2e937da154e87db6e97fb2509b46...52ab34807bc0887e62bc3df2ed959cd7dd4f6d08,2,15,1,16,3,2013-07-24 20:49:27,2013-07-24 20:43:32
52ab34807bc0887e62bc3df2ed959cd7dd4f6d08...3a4fe89b3447d71195a2f70be235b00223fc4288,1,42,29,71,21,2013-07-24 20:54:49,2013-07-19 18:44:57
3a4fe89b3447d71195a2f70be235b00223fc4288...899c017dd024f487d0601ec7a9b5389b723adf9a,1,4,3,7,3,2013-07-24 21:01:58,2013-07-24 19:53:25
899c017dd024f487d0601ec7a9b5389b723adf9a...737faaff67f71ebee46e115f5278c48e62617a1e,166,565,521,1086,300,2013-07-24 21:26:42,2013-05-13 23:47:49
737faaff67f71ebee46e115f5278c48e62617a1e...546fc3686e659b44a0145bb62c8e2897abf31bb2,2,32,2,34,7,2013-07-24 22:11:33,2013-07-24 20:49:11
546fc3686e659b44a0145bb62c8e2897abf31bb2...25395ab8e296d61a79f52a87020c01ef9ec075e4,1,12,6,18,4,2013-07-24 22:11:41,2013-07-24 22:06:47
25395ab8e296d61a79f52a87020c01ef9ec075e4...23f4d9fc683492e780159b6f495ab227fdf3cb5e,1,2,2,4,2,2013-07-25 08:53:56,2013-07-25 08:53:56
23f4d9fc683492e780159b6f495ab227fdf3cb5e...f396b0f32070ae2ef68fd5c1c02f426d4167cf19,4,36,27,63,15,2013-07-25 13:53:46,2013-07-22 20:24:39
f396b0f32070ae2ef68fd5c1c02f426d4167cf19...aff08928fef26148d401ab66f6e597378b212a26,3,183,23,206,12,2013-07-25 14:12:36,2013-07-24 17:58:38
aff08928fef26148d401ab66f6e597378b212a26...dfc0b15b259553f1bb528c1a65fec2bffec152cf,1,2,1,3,1,2013-07-25 16:14:10,2013-07-25 16:14:10
dfc0b15b259553f1bb528c1a65fec2bffec152cf...50dc157e0d617b3aa9014bf47b9531e6e510912b,2,73,49,122,6,2013-07-25 18:22:29,2013-07-25 18:22:29
50dc157e0d617b3aa9014bf47b9531e6e510912b...f69cfc007eed38592c879ebf9345ec70f9587aa0,33,1367,49,1416,172,2013-07-25 18:27:04,2013-07-23 23:07:48
f69cfc007eed38592c879ebf9345ec70f9587aa0...df0b4c10f397e281ae6350ed35310fd994ff0539,2,8,0,8,2,2013-07-25 18:45:05,2013-07-25 18:33:25
df0b4c10f397e281ae6350ed35310fd994ff0539...be38be003e81fc7b6c0621c1549d24182d077517,4,74,0,74,17,2013-07-25 19:26:04,2013-07-25 19:26:04
be38be003e81fc7b6c0621c1549d24182d077517...ca2128865d2113622bab4fb23e61dc9926871797,6,112,62,174,34,2013-07-25 20:03:03,2013-07-25 16:20:23
ca2128865d2113622bab4fb23e61dc9926871797...6e28cfc2c03a85b70e84e0a4998d8ef86aa06a54,1,1,10,11,1,2013-07-25 21:26:30,2013-07-25 21:26:30
6e28cfc2c03a85b70e84e0a4998d8ef86aa06a54...01b4f0ad09c244fd7f83bb045ff844416aa8ca96,3,52,1,53,8,2013-07-26 14:29:19,2013-07-24 17:58:06
01b4f0ad09c244fd7f83bb045ff844416aa8ca96...78b54e5608d1a49da4228ee2b45489a9d0cc9182,5,37,6,43,10,2013-07-26 15:40:31,2013-07-08 23:19:05
78b54e5608d1a49da4228ee2b45489a9d0cc9182...6e2a5530082c8d22bfb1a2f17f54e636137aadeb,1,6,1,7,3,2013-07-26 15:54:01,2013-07-26 15:54:01
6e2a5530082c8d22bfb1a2f17f54e636137aadeb...c9d2edf6816e622fc6cfab9f84aa1a27a7597c5d,2,8,0,8,2,2013-07-26 16:58:00,2013-07-26 15:35:56
c9d2edf6816e622fc6cfab9f84aa1a27a7597c5d...aad2e95550ef8b497318cbd366dc06f38898684d,6,72,46,118,34,2013-07-26 17:49:32,2013-07-25 16:55:25
aad2e95550ef8b497318cbd366dc06f38898684d...5bf58caa4bd08ebc6291174fda8fa9e886c9539d,4,309,11,320,14,2013-07-26 19:34:05,2013-07-26 19:33:59
5bf58caa4bd08ebc6291174fda8fa9e886c9539d...a856222627ce97d1ace25a14d6f2b69e8471a1e6,8,157,48,205,24,2013-07-26 19:37:26,2013-07-26 16:55:27
a856222627ce97d1ace25a14d6f2b69e8471a1e6...e721e9df43caf1433040dde1fd7ff54384f2497d,4,36,15,51,17,2013-07-26 20:36:07,2013-07-26 16:05:39
e721e9df43caf1433040dde1fd7ff54384f2497d...6f8b9d5515591beaaa6f58c8fdabb9ddd2b2450f,1,4,2,6,2,2013-07-26 20:37:15,2013-07-26 16:07:00
6f8b9d5515591beaaa6f58c8fdabb9ddd2b2450f...950d8deb486b4608828e0c4f7e9caa3e7d84fed8,5,259,0,259,9,2013-07-26 20:37:53,2013-07-26 19:37:21
950d8deb486b4608828e0c4f7e9caa3e7d84fed8...07336d045cce6f11f0b3ceaeb327a8a8d438ae67,4,29,1,30,7,2013-07-26 20:37:53,2013-07-26 20:15:47
07336d045cce6f11f0b3ceaeb327a8a8d438ae67...8a1429687d6259203db2d96b829e8e020b1a99e6,6,178,1,179,8,2013-07-26 20:37:53,2013-07-26 19:53:40
8a1429687d6259203db2d96b829e8e020b1a99e6...51a46c5f9a42dc68ca5a05c7771440f509b7a742,5,358,437,795,28,2013-07-26 21:01:00,2013-07-26 20:35:24
51a46c5f9a42dc68ca5a05c7771440f509b7a742...ea776af8e3f982c488ca6d7476ab79e20733e9a9,8,228,35,263,28,2013-07-26 21:41:35,2013-07-24 18:03:25
ea776af8e3f982c488ca6d7476ab79e20733e9a9...21431f5bc46c292bd2962d5bf9aa16dc6f43a121,9,62,53,115,44,2013-07-26 21:44:06,2013-07-26 21:44:06
21431f5bc46c292bd2962d5bf9aa16dc6f43a121...01296c1617fa8b003967c63dbbc1af911d6cd223,9,558,183,741,59,2013-07-26 22:32:24,2013-07-16 18:43:05
01296c1617fa8b003967c63dbbc1af911d6cd223...10602c474190fdbbfc15ec2028b1b0b105b6aa9d,1,2,1,3,1,2013-07-27 03:24:28,2013-07-27 03:24:28
10602c474190fdbbfc15ec2028b1b0b105b6aa9d...edeab0376dc35946fe1b5fd0c505af20fb91c8bb,1,2,2,4,2,2013-07-27 03:44:15,2013-07-27 03:44:15
edeab0376dc35946fe1b5fd0c505af20fb91c8bb...4640e0776c8d5e7514f4484fa5fe42e0d54e3fe9,1,0,6,6,2,2013-07-27 12:24:37,2013-07-27 12:24:37
4640e0776c8d5e7514f4484fa5fe42e0d54e3fe9...1a072fc6cce47088804db327d98d4c56d5416450,1,7,0,7,1,2013-07-28 01:56:10,2013-07-28 01:56:10
1a072fc6cce47088804db327d98d4c56d5416450...0240a87080bb00b273900d965c13731f931f624d,2,54,0,54,4,2013-07-29 14:38:17,2013-07-23 18:42:55
0240a87080bb00b273900d965c13731f931f624d...761a59942350db8523bddc105ac5509c8aac18d0,1,1,0,1,1,2013-07-29 16:12:29,2013-07-29 16:12:29
761a59942350db8523bddc105ac5509c8aac18d0...95407950b51f17a116dc87909a85df603d8def78,1,11,0,11,2,2013-07-29 18:01:48,2013-07-29 17:59:46
95407950b51f17a116dc87909a85df603d8def78...47edf5d5590798986ea721e06a3595cad381f196,1,6,6,12,6,2013-07-29 18:40:31,2013-07-29 14:30:33
47edf5d5590798986ea721e06a3595cad381f196...9db572c59ee80375e0c4b6547a0a883bd175036b,2,44,24,68,14,2013-07-29 18:40:31,2013-07-29 15:45:51
9db572c59ee80375e0c4b6547a0a883bd175036b...d2ce20775779a3116f693b9e60744234bdbc5f50,2,22,7,29,8,2013-07-29 18:40:31,2013-07-29 18:38:18
d2ce20775779a3116f693b9e60744234bdbc5f50...11f47af7789e8825d92bbcf76b6930d2962fbb7e,1,1,1,2,1,2013-07-29 18:40:31,2013-07-29 18:39:19
11f47af7789e8825d92bbcf76b6930d2962fbb7e...212bd21d7528a86305bb399b6261a90ea8263953,1,5,0,5,1,2013-07-29 18:40:31,2013-07-29 18:39:56
212bd21d7528a86305bb399b6261a90ea8263953...9498d1148cb14c862b615a528e65aa757705aa00,1,12,6,18,3,2013-07-29 19:51:02,2013-07-29 19:51:02
9498d1148cb14c862b615a528e65aa757705aa00...88575437aa688e748b41862263b7d9f43763a28f,1,6,2,8,2,2013-07-29 20:20:19,2013-07-29 17:04:45
88575437aa688e748b41862263b7d9f43763a28f...f6a77ea2f6ae26f8408055f395ccc000db6008a8,1,3,2,5,1,2013-07-29 20:33:35,2013-07-29 19:25:28
f6a77ea2f6ae26f8408055f395ccc000db6008a8...dcc392f4355d5328a4d4512cb43ad19ed6d3a6af,2,9,5,14,5,2013-07-30 13:17:08,2013-07-30 13:11:16
dcc392f4355d5328a4d4512cb43ad19ed6d3a6af...24332496186afa78b3bb0cad4020206f962c0b72,1,10,1,11,2,2013-07-30 13:20:58,2013-07-30 13:20:58
24332496186afa78b3bb0cad4020206f962c0b72...a277977911509f91e19847b85c2498437d8859a1,1,5,3,8,2,2013-07-30 13:41:46,2013-07-30 13:26:31
a277977911509f91e19847b85c2498437d8859a1...090aaa9be722a9d8ad6f1ea4d592e9d5c3ccd6b6,14,526,11,537,26,2013-07-30 14:50:53,2013-07-25 19:44:30
090aaa9be722a9d8ad6f1ea4d592e9d5c3ccd6b6...430c1eaadc9dfff6323605fe5fed22f6a8cc33a7,1,4,1,5,1,2013-07-30 14:54:05,2013-07-29 23:18:16
430c1eaadc9dfff6323605fe5fed22f6a8cc33a7...80cc025c4850a59bcf4cf15b1d2433f1ad1f42bc,1,1,1,2,1,2013-07-30 15:17:20,2013-07-30 15:16:05
80cc025c4850a59bcf4cf15b1d2433f1ad1f42bc...47fbdb86773189df3c1b3b0dde838cf07a11d8f3,5,7,5,12,10,2013-07-30 15:25:07,2013-07-30 15:17:20
47fbdb86773189df3c1b3b0dde838cf07a11d8f3...0bc4c30550668d547889b80af209f7623e72a1a9,2,15,4,19,5,2013-07-30 15:37:36,2013-07-30 15:15:31
0bc4c30550668d547889b80af209f7623e72a1a9...9f6cf548d5fe19daf4478e5ffd4072a3993302e0,1,17,3,20,1,2013-07-30 15:37:36,2013-07-30 15:16:44
9f6cf548d5fe19daf4478e5ffd4072a3993302e0...0650bbfbcee9655a22adf01c95e44e069a65e32b,1,3,1,4,1,2013-07-30 18:40:37,2013-07-22 19:48:56
0650bbfbcee9655a22adf01c95e44e069a65e32b...00945fb065a7003c6e7936992b9486988358dec9,14,74,248,322,39,2013-07-30 19:42:03,2013-06-17 20:27:26
00945fb065a7003c6e7936992b9486988358dec9...08c17bd683b4acd1c704173db6048f6ddd81d7cf,1,1,0,1,1,2013-07-30 19:49:50,2013-07-30 19:03:55
08c17bd683b4acd1c704173db6048f6ddd81d7cf...60f9f92f966d7bfabe722d96bc6e196292a4d051,1,1,1,2,1,2013-07-30 19:51:22,2013-07-30 14:55:51
60f9f92f966d7bfabe722d96bc6e196292a4d051...3015fc5f5ecd588c0e7873cf07f2b8818c191165,1,4,1,5,1,2013-07-30 21:35:13,2013-07-27 13:13:10
3015fc5f5ecd588c0e7873cf07f2b8818c191165...6211f4436abfff2fe1154302fa352b104464120e,1,2,1,3,1,2013-07-30 21:35:13,2013-07-30 21:35:04
6211f4436abfff2fe1154302fa352b104464120e...30817e8bec4fcebf9b2fa0e272ce0a37b9b3862f,5,18,8,26,8,2013-07-30 21:50:33,2013-07-23 21:36:06
30817e8bec4fcebf9b2fa0e272ce0a37b9b3862f...3a625ac9a01fef0514e3a49de6cb0028fe7eeee6,8,307,6,313,12,2013-07-30 21:50:33,2013-07-24 19:45:04
3a625ac9a01fef0514e3a49de6cb0028fe7eeee6...c0b1115a5be9d554199ce014fe57c479b8ea105b,1,10,9,19,1,2013-07-30 21:50:33,2013-07-24 19:51:14
c0b1115a5be9d554199ce014fe57c479b8ea105b...213f27b7cb23486e62fecbb59659b9ec1a36a8c0,8,64,25,89,17,2013-07-30 21:50:33,2013-07-29 19:16:32
213f27b7cb23486e62fecbb59659b9ec1a36a8c0...5246d2964edd69f1e499cce9389deed10b20659b,6,135,12,147,28,2013-07-31 10:46:07,2013-07-31 10:46:07
5246d2964edd69f1e499cce9389deed10b20659b...3a14b391a8c997361777d74d69e0b7bef21a7723,1,2,1,3,1,2013-07-31 16:52:52,2013-07-31 16:47:20
3a14b391a8c997361777d74d69e0b7bef21a7723...88a74d69fb5b48fcd752ff53faa4c3fad193a205,3,18,10,28,10,2013-07-31 17:47:24,2013-07-30 18:05:03
88a74d69fb5b48fcd752ff53faa4c3fad193a205...ba8ae2540ca5c2ed418262fb222be2aaf225def2,3,63,7,70,9,2013-07-31 18:13:58,2013-07-29 20:42:18
ba8ae2540ca5c2ed418262fb222be2aaf225def2...c5afca5be18c26faeb7a8c0ca6ad8281d7dc376c,1,4,2,6,3,2013-07-31 18:50:03,2013-07-30 20:07:57
c5afca5be18c26faeb7a8c0ca6ad8281d7dc376c...ac382bfb46c692841a766712c078f229366ae2de,1,12,12,24,8,2013-07-31 18:50:03,2013-07-31 18:10:55
ac382bfb46c692841a766712c078f229366ae2de...2cffe8566344160ff078bee67a421986f6e1214c,4,1059,0,1059,4,2013-07-31 19:50:33,2013-07-26 21:05:27
2cffe8566344160ff078bee67a421986f6e1214c...46f9caf7217bfc411301b22ecac80a67c79611b7,2,3,3,6,2,2013-07-31 20:44:17,2013-07-31 20:19:14
46f9caf7217bfc411301b22ecac80a67c79611b7...9cd384edef1db23eb72544d8040a930014a7650f,1,1,15,16,2,2013-07-31 20:55:33,2013-07-30 22:20:48
9cd384edef1db23eb72544d8040a930014a7650f...3646f02d1e89c9ab478a2a3ace18c48e237b2803,1,25,3,28,7,2013-07-31 21:02:16,2013-07-30 19:13:54
3646f02d1e89c9ab478a2a3ace18c48e237b2803...188a0237bdbb84d308373f024a9a43e7d4715ef4,1,4,3,7,4,2013-07-31 21:30:00,2013-05-31 20:11:22
188a0237bdbb84d308373f024a9a43e7d4715ef4...878cc4e5c93ce66b06f66bc80038a3d55a514226,1,1,1,2,1,2013-07-31 21:32:43,2013-07-31 21:32:43
878cc4e5c93ce66b06f66bc80038a3d55a514226...d18a45b231b8085b59702e6157e4a80b3fc19464,4,33,0,33,8,2013-08-01 09:29:21,2013-08-01 09:29:21
d18a45b231b8085b59702e6157e4a80b3fc19464...57213bdd0d1abf214f4a7db3f6e4aa161a69a9c5,5,313,0,313,7,2013-08-01 14:01:55,2013-07-30 14:50:22
57213bdd0d1abf214f4a7db3f6e4aa161a69a9c5...51af8d67570b33fa5d5b4d36b18215535d38dd85,5,83,29,112,21,2013-08-01 15:00:00,2013-08-01 15:00:00
51af8d67570b33fa5d5b4d36b18215535d38dd85...ef36e0d91f7071c78ec898eb933caff330b01dd5,3,25,5,30,6,2013-08-01 17:39:58,2013-07-31 18:56:41
ef36e0d91f7071c78ec898eb933caff330b01dd5...aa62052a194c49ae449a0d8c2d2ab17e468a3e39,1,2,4,6,3,2013-08-01 17:40:19,2013-08-01 17:40:19
aa62052a194c49ae449a0d8c2d2ab17e468a3e39...2acb6f2bdaf6a0f0ffa3ed64cf3b24003fbbceee,9,11,17,28,10,2013-08-01 18:08:46,2013-07-29 21:25:50
2acb6f2bdaf6a0f0ffa3ed64cf3b24003fbbceee...bdad6392922a467eaeda060b69471557beb6a955,10,164,0,164,10,2013-08-01 18:12:09,2013-07-31 21:38:35
bdad6392922a467eaeda060b69471557beb6a955...211099e4bb2709d5fbd501d0bd44b49a77c2435b,14,66,28,94,19,2013-08-01 18:12:09,2013-07-31 22:32:24
211099e4bb2709d5fbd501d0bd44b49a77c2435b...75a5362fce511a0b4100cd4ce6b19f04ce1fc7c7,1,1,1,2,1,2013-08-01 20:00:19,2013-08-01 20:00:19
75a5362fce511a0b4100cd4ce6b19f04ce1fc7c7...a54de9ea07fa12fd1126b1ebe7ae4daa72640859,1,5,0,5,1,2013-08-01 20:17:25,2013-08-01 19:22:21
a54de9ea07fa12fd1126b1ebe7ae4daa72640859...af698e6cc9c6d377bf6c679aa33a018ccf35176c,1,8,6,14,4,2013-08-01 20:17:25,2013-08-01 19:53:24
af698e6cc9c6d377bf6c679aa33a018ccf35176c...d45bbff92d27a18a55a7f1c4a1f47381a4c76d8f,1,3,8,11,2,2013-08-01 20:17:25,2013-08-01 19:53:55
d45bbff92d27a18a55a7f1c4a1f47381a4c76d8f...69e0e90c062f826f12f44d99a63deac0f74af3e5,1,6,4,10,5,2013-08-01 20:17:25,2013-08-01 19:55:01
69e0e90c062f826f12f44d99a63deac0f74af3e5...5647c97e2b618144801c75651f59010088823810,1,4,0,4,1,2013-08-01 20:17:26,2013-08-01 19:56:22
5647c97e2b618144801c75651f59010088823810...869557aabbd8837ec86a852957f24ea76e8e13e4,38,479,139,618,140,2013-08-01 20:17:26,2013-08-01 20:00:24
869557aabbd8837ec86a852957f24ea76e8e13e4...c5fcc5d71623bccc52df70c010685c2743e98d9a,1,6,1,7,1,2013-08-01 20:24:58,2013-07-31 22:02:50
c5fcc5d71623bccc52df70c010685c2743e98d9a...e5e0da93d60bc578bbc8539a7a1b02c8c18bfe21,2,14,1,15,4,2013-08-01 20:24:58,2013-07-31 22:05:59
e5e0da93d60bc578bbc8539a7a1b02c8c18bfe21...3ffea6597a22d3570f0cd66850aa1975ed980131,1,3,0,3,1,2013-08-01 20:24:59,2013-08-01 15:55:47
3ffea6597a22d3570f0cd66850aa1975ed980131...ed239a91184f30940c2971aadbca3bb95106b93d,1,1,1,2,1,2013-08-01 20:24:59,2013-08-01 18:22:12
ed239a91184f30940c2971aadbca3bb95106b93d...6e2ffbbb921c94ff0a15f507aa2f03b7f659a65c,3,10,8,18,5,2013-08-01 21:16:35,2013-07-31 20:54:44
6e2ffbbb921c94ff0a15f507aa2f03b7f659a65c...4758b24a3826d3a64ec2f975e2c97c9bd4053dce,1,1,1,2,1,2013-08-01 21:16:35,2013-07-31 21:11:49
4758b24a3826d3a64ec2f975e2c97c9bd4053dce...bce6506b7129c5b8fa14e03f0321914e8e58cf78,3,24,2,26,8,2013-08-01 21:16:35,2013-07-31 21:12:18
bce6506b7129c5b8fa14e03f0321914e8e58cf78...1b371f53ffbfd06329f7f4bbfc3171ab0c988a30,9,108,130,238,32,2013-08-01 21:16:35,2013-07-31 22:09:37
1b371f53ffbfd06329f7f4bbfc3171ab0c988a30...56c359263b56f640c8b1ad1b2e87d7e6c3e655cf,1,3,3,6,3,2013-08-01 21:16:35,2013-08-01 13:29:52
56c359263b56f640c8b1ad1b2e87d7e6c3e655cf...c653fd6983ce8d8bbcca1930c37535661ffb240f,7,6,6,12,6,2013-08-01 21:16:35,2013-08-01 15:41:23
c653fd6983ce8d8bbcca1930c37535661ffb240f...2c12438d9a1ff940d7e4317e141f4e4cb27166f0,2,15,0,15,2,2013-08-01 21:16:35,2013-08-01 15:46:17
2c12438d9a1ff940d7e4317e141f4e4cb27166f0...d08ca6efeab283585a7c4f1e5ac8ce2932509a75,1,7,5,12,4,2013-08-01 21:16:35,2013-08-01 15:50:11
d08ca6efeab283585a7c4f1e5ac8ce2932509a75...bf626a002f1eecc839f03a7d2efbd5093283fcfc,1,200,0,200,1,2013-08-02 00:05:21,2013-08-02 00:05:21
bf626a002f1eecc839f03a7d2efbd5093283fcfc...0af4f9e36a621e9455e732b0aec8757682d911b9,1,90,4,94,4,2013-08-02 00:14:48,2013-08-02 00:14:48
0af4f9e36a621e9455e732b0aec8757682d911b9...52555982a2ae033a3f1aa56c4b64fb7020ab41a9,4,30,24,54,22,2013-08-02 11:06:43,2013-08-02 11:06:43
52555982a2ae033a3f1aa56c4b64fb7020ab41a9...e3b8349ec305b00bdb7107f2d887549640a15c90,1,6,2,8,5,2013-08-02 12:00:13,2013-08-02 12:00:12
e3b8349ec305b00bdb7107f2d887549640a15c90...52c2a3a99cd12a9031b231fa66ac1b1286a56b38,1,3,3,6,3,2013-08-02 13:33:16,2013-08-02 13:31:49
52c2a3a99cd12a9031b231fa66ac1b1286a56b38...6de757ee07cd340f2d31b70d4645090611bd3564,1,17,2,19,5,2013-08-02 13:33:16,2013-08-02 13:32:54
6de757ee07cd340f2d31b70d4645090611bd3564...785264298b7e415becfa882816f7aef49dbdda36,4,135,0,135,4,2013-08-02 15:54:21,2013-08-02 15:06:15
785264298b7e415becfa882816f7aef49dbdda36...a2fedf45ff92b714b7e704d7547b76b815988d4d,5,13,4,17,5,2013-08-02 16:51:06,2013-08-02 15:52:37
a2fedf45ff92b714b7e704d7547b76b815988d4d...0faf9d4d50319235f0d51be8c62fb9ccd8bd5d3d,1,37,96,133,10,2013-08-02 16:58:15,2013-08-01 20:33:55
0faf9d4d50319235f0d51be8c62fb9ccd8bd5d3d...1388d07a027c598b5f0a6465986a0be6c7cfad52,1,23,16,39,8,2013-08-02 17:42:14,2013-08-02 17:16:32
1388d07a027c598b5f0a6465986a0be6c7cfad52...a6135157d916bd1ac08cb13563ee7d87ed91146b,1,1,0,1,1,2013-08-02 18:07:13,2013-07-31 18:56:04
a6135157d916bd1ac08cb13563ee7d87ed91146b...726495176586802518b0fda1e25f1e3d88b27dac,1,4,2,6,3,2013-08-02 18:07:13,2013-07-30 20:07:57
726495176586802518b0fda1e25f1e3d88b27dac...5e9f82f54988c464e6925e48182b909b1b3fe115,2,14,0,14,2,2013-08-02 18:07:13,2013-07-31 18:55:21
5e9f82f54988c464e6925e48182b909b1b3fe115...bc18509d0f2d902a9692f6bddfa3ec289314e6a7,4,39,0,39,6,2013-08-02 18:07:13,2013-07-29 21:22:37
bc18509d0f2d902a9692f6bddfa3ec289314e6a7...f736febe5a0d6d5a197b012eebad0243161830b6,7,33,0,33,11,2013-08-02 20:11:12,2013-07-31 22:11:52
f736febe5a0d6d5a197b012eebad0243161830b6...07faf6eef1d11d0cf9cff3c527dc98656d8f2a21,5,6,10,16,6,2013-08-02 21:31:14,2013-07-31 22:21:56
07faf6eef1d11d0cf9cff3c527dc98656d8f2a21...edf57d1fc027f859eab90cdc33abbd039f18ef08,1,1,5,6,1,2013-08-03 06:34:19,2013-08-03 06:34:19
edf57d1fc027f859eab90cdc33abbd039f18ef08...ffc485ea55142cb53649fc11728684c0ace7551c,2,8,3,11,4,2013-08-03 06:35:48,2013-08-03 06:35:48
ffc485ea55142cb53649fc11728684c0ace7551c...4ae9434714b4f060953fa200a0ad1e99b70eecad,1,4,1,5,1,2013-08-03 17:45:31,2013-08-03 17:45:21
4ae9434714b4f060953fa200a0ad1e99b70eecad...751bb5215271dff24abdbffe9d5fbdf8f18bd816,2,34,17,51,4,2013-08-03 21:59:14,2013-08-03 17:49:39
751bb5215271dff24abdbffe9d5fbdf8f18bd816...dfc343cdf11462e89201d833db515de85f97bb45,1,4,1,5,1,2013-08-03 22:47:10,2013-08-03 22:47:10
dfc343cdf11462e89201d833db515de85f97bb45...ce7031944c520f3f34344a060eba9c9a80d18cc6,2,31,31,62,3,2013-08-04 05:10:24,2013-08-04 04:52:36
ce7031944c520f3f34344a060eba9c9a80d18cc6...27c90569e13f0e9903035df1a8e2871a285d5000,3,54,9,63,12,2013-08-04 05:42:50,2013-08-04 05:42:50
27c90569e13f0e9903035df1a8e2871a285d5000...0ab11657c330c9233be64e997a1627dc82e1a647,1,4,4,8,2,2013-08-04 11:15:42,2013-08-04 11:15:42
0ab11657c330c9233be64e997a1627dc82e1a647...f141a861efcbefd72101544c8990fdff7ca27741,1,1,0,1,1,2013-08-04 11:54:44,2013-08-04 11:54:44
f141a861efcbefd72101544c8990fdff7ca27741...7f239865b136a6aef682cb114fc871b0c81a70b8,2,0,14,14,2,2013-08-04 12:20:47,2013-08-04 12:20:47
7f239865b136a6aef682cb114fc871b0c81a70b8...00eeec1ab83c8f4921d1bc1352221168a3a01900,1,11,2,13,2,2013-08-05 14:20:25,2013-08-05 14:20:25
00eeec1ab83c8f4921d1bc1352221168a3a01900...bd0cdbf21d2e91a4b63db6d092378a86f058c73d,47,837,323,1160,216,2013-08-05 14:46:23,2013-08-01 15:01:23
bd0cdbf21d2e91a4b63db6d092378a86f058c73d...af5548a026225cae0e481630076b4c7fd1905a17,1,4,0,4,4,2013-08-05 14:56:41,2013-08-05 14:56:41
af5548a026225cae0e481630076b4c7fd1905a17...be395711165d0bc1d96bcb51fb5b3586032d8f9a,6,36,3,39,13,2013-08-05 16:19:49,2013-08-05 16:19:49
be395711165d0bc1d96bcb51fb5b3586032d8f9a...4c1e37975ab551e02b1b3f6d9902302666f3b4af,5,26,37,63,14,2013-08-05 18:52:28,2013-08-02 17:42:31
4c1e37975ab551e02b1b3f6d9902302666f3b4af...6b1cb2cd32ca32c23e00618eae3fa3fe73a0e938,1,1,1,2,1,2013-08-05 19:06:56,2013-08-05 19:06:56
6b1cb2cd32ca32c23e00618eae3fa3fe73a0e938...1fa0480e4241d64c13d35c6777bca1599ba443eb,3,18,4,22,5,2013-08-05 21:10:17,2013-08-05 21:09:54
1fa0480e4241d64c13d35c6777bca1599ba443eb...60110bef7f1cf4f01a87833e909147b35fb4c44e,1,2,2,4,2,2013-08-05 22:08:04,2013-08-05 18:46:01
60110bef7f1cf4f01a87833e909147b35fb4c44e...96bbaa57d1ce5ebbff5edd0888210ce3f9549d43,1,14,8,22,3,2013-08-05 22:08:04,2013-08-05 18:46:17
96bbaa57d1ce5ebbff5edd0888210ce3f9549d43...85e79d7ad2db6fa0607957cac536d20a3738f6a5,1,2,0,2,2,2013-08-06 10:06:27,2013-08-06 10:06:27
85e79d7ad2db6fa0607957cac536d20a3738f6a5...3bbe57a1e825a98a0c6e2601ac87978f02faecd6,7,574,9,583,19,2013-08-06 13:01:52,2013-07-24 20:01:49
3bbe57a1e825a98a0c6e2601ac87978f02faecd6...25e934ac1a262e90ad555235bf5b2de6ddb246a0,10,620,147,767,39,2013-08-06 13:01:52,2013-07-31 19:46:04
25e934ac1a262e90ad555235bf5b2de6ddb246a0...58d68a95c050daceee6c0122a72b8e43c5157261,1,2,2,4,1,2013-08-06 13:01:52,2013-08-05 21:15:35
58d68a95c050daceee6c0122a72b8e43c5157261...e0d9e65fd3c2dfaec1c82504c310288aacac9ce4,4,69,1,70,7,2013-08-06 13:39:14,2013-07-09 15:59:16
e0d9e65fd3c2dfaec1c82504c310288aacac9ce4...cee23aa7958874aca663d7de4c83804b9c80468d,4,8,0,8,4,2013-08-06 15:14:51,2013-08-06 15:14:51
cee23aa7958874aca663d7de4c83804b9c80468d...017a17bf24ef68a4595d007135a2d5fdc1b93dca,2,0,18,18,2,2013-08-06 15:50:38,2013-08-06 15:50:38
017a17bf24ef68a4595d007135a2d5fdc1b93dca...8c6537087f14d59eb674a20e74798a42a4ea195d,2,31,2,33,7,2013-08-06 16:04:28,2013-08-06 14:52:10
8c6537087f14d59eb674a20e74798a42a4ea195d...d940f71c92af01c0229537de5d3b1713daee406c,1,0,1,1,1,2013-08-06 17:38:34,2013-08-06 15:17:28
d940f71c92af01c0229537de5d3b1713daee406c...ae9604709b5594a5c05e5ddeb7c7d0ea71b3230c,3,62,45,107,20,2013-08-06 17:38:34,2013-08-06 17:38:31
ae9604709b5594a5c05e5ddeb7c7d0ea71b3230c...7f2c86d8938fe0e02f7c2deb7c630e5f2c7e1076,3,9,3,12,4,2013-08-06 20:05:45,2013-08-06 15:31:14
7f2c86d8938fe0e02f7c2deb7c630e5f2c7e1076...54c65b6e324781f7b8c97ceeeecd28145cb4c013,1,2,1,3,2,2013-08-06 20:37:57,2013-08-06 20:20:14
54c65b6e324781f7b8c97ceeeecd28145cb4c013...43933bbd73f78460e0b28d0025683df7683172b0,6,0,759,759,8,2013-08-06 22:47:22,2013-08-06 21:05:12
43933bbd73f78460e0b28d0025683df7683172b0...bac3b67d20128e03487680b8d713195a18315d6e,2,6,0,6,2,2013-08-07 14:19:29,2013-08-06 23:07:43
bac3b67d20128e03487680b8d713195a18315d6e...155a8a54a4274358eaf6c7a7e3557aa21e1af2db,1,21,0,21,7,2013-08-07 15:51:09,2013-08-07 15:51:09
155a8a54a4274358eaf6c7a7e3557aa21e1af2db...703fbad99ac3e02c804c1dc2bd63b84f29168dea,1,0,57,57,1,2013-08-07 18:04:48,2013-08-07 18:04:48
703fbad99ac3e02c804c1dc2bd63b84f29168dea...e323f9cb025348a8a349685595d8933cb3070775,1,2,0,2,2,2013-08-07 19:12:04,2013-08-07 19:12:04
e323f9cb025348a8a349685595d8933cb3070775...d11c7e78d447882b05e993ce60e311e9db959087,6,214,77,291,37,2013-08-07 19:28:15,2013-08-06 22:44:11
d11c7e78d447882b05e993ce60e311e9db959087...6c66e41e95c542a627ea007599b8a8c0417185bb,2,14,0,14,2,2013-08-07 19:54:26,2013-07-31 18:55:21
6c66e41e95c542a627ea007599b8a8c0417185bb...b304acfde047511aa5ab148f0dc3706651afbe93,2,14,10,24,2,2013-08-07 19:54:26,2013-08-07 17:52:09
b304acfde047511aa5ab148f0dc3706651afbe93...3e50406c655679a5a3ed52cb64b5750c7518fe6f,1,1,0,1,1,2013-08-07 19:54:26,2013-08-07 17:52:52
3e50406c655679a5a3ed52cb64b5750c7518fe6f...3d3719bd3881b437f136d8ea8a8dfd22de2f3d52,22,1051,944,1995,242,2013-08-07 21:20:58,2013-08-05 20:13:06
3d3719bd3881b437f136d8ea8a8dfd22de2f3d52...ba4faaab57c08199cd53accc3772f5201a0d44eb,14,417,64,481,62,2013-08-07 21:26:21,2013-08-07 16:26:59
ba4faaab57c08199cd53accc3772f5201a0d44eb...8302c679d3de7edc54947c0717e429cd3eed1d2d,1,3,3,6,3,2013-08-07 21:36:48,2013-08-07 21:36:48
8302c679d3de7edc54947c0717e429cd3eed1d2d...465e77533959576ed36e06ddd640db62ad10ffd6,1,1,1,2,1,2013-08-08 10:54:59,2013-08-08 10:54:59
465e77533959576ed36e06ddd640db62ad10ffd6...4686ae36b50ad0eabd03012a833d126db1676bc9,2,21,20,41,12,2013-08-08 14:10:57,2013-08-08 14:10:57
4686ae36b50ad0eabd03012a833d126db1676bc9...a97f74585b958bd9c4a3f28d91a8049aa5286504,5,385,175,560,5,2013-08-08 15:39:00,2013-07-15 01:07:26
a97f74585b958bd9c4a3f28d91a8049aa5286504...a5c4978b510d24bfaa3a4b2ee6570fd747326e1e,2,8,1,9,2,2013-08-08 18:20:23,2013-08-08 18:20:23
a5c4978b510d24bfaa3a4b2ee6570fd747326e1e...fa72bb1f863e2539c5d4a3c06c147b04e5066bab,1,2,0,2,1,2013-08-08 19:13:14,2013-08-08 19:11:39
fa72bb1f863e2539c5d4a3c06c147b04e5066bab...84c163bbbc6a0179ed02c16c3442edde39dff1f1,1,1,0,1,1,2013-08-08 19:17:37,2013-08-08 19:17:29
84c163bbbc6a0179ed02c16c3442edde39dff1f1...17b3f0fa4e42735c2d233984bf61fab87b49dde3,1,26,33,59,8,2013-08-08 19:48:24,2013-08-08 15:52:49
17b3f0fa4e42735c2d233984bf61fab87b49dde3...8e93f578191525c7dd96d3e5ab85c66b4802df55,4,13,47,60,12,2013-08-08 20:04:30,2013-07-26 22:21:00
8e93f578191525c7dd96d3e5ab85c66b4802df55...b51d448db276dba21766bd733b2dbab60f6789e0,9,475,24,499,23,2013-08-08 20:11:35,2013-07-25 19:00:52
b51d448db276dba21766bd733b2dbab60f6789e0...72cbbb5697ad341cdd3241db138ffeaf6aed3754,3,75,36,111,10,2013-08-08 20:12:13,2013-08-01 18:18:15
72cbbb5697ad341cdd3241db138ffeaf6aed3754...29492436f852fd6600d9f1ac0e409e5db2b29c34,6,83,52,135,30,2013-08-08 20:13:09,2013-08-05 22:36:55
29492436f852fd6600d9f1ac0e409e5db2b29c34...9064d78640cf87fce2349a0fca9843da08c18f4d,5,36,4,40,11,2013-08-08 20:14:09,2013-08-06 16:54:32
9064d78640cf87fce2349a0fca9843da08c18f4d...bf528ad019f5773bb95c90f934c265f46adc8e44,1,111,0,111,1,2013-08-08 20:14:54,2013-08-08 18:30:32
bf528ad019f5773bb95c90f934c265f46adc8e44...de01ac616542d721276e3f96cd95a0afb39b7137,1,1,0,1,1,2013-08-08 21:59:32,2013-08-08 21:59:32
de01ac616542d721276e3f96cd95a0afb39b7137...0ab0b695ec26828c94edd5bd220cde215fd85a60,2,3,3,6,2,2013-08-09 01:54:47,2013-08-09 01:29:46
0ab0b695ec26828c94edd5bd220cde215fd85a60...d679581a15dbbdbcc3541ad2b509e6e3567fa7ae,6,12,0,12,6,2013-08-09 08:44:27,2013-08-09 08:44:27
d679581a15dbbdbcc3541ad2b509e6e3567fa7ae...b68af6a0f9f200e893bd41d878428bedf69f688e,1,30,9,39,4,2013-08-09 12:01:15,2013-08-08 18:43:17
b68af6a0f9f200e893bd41d878428bedf69f688e...0d464f85693d3264cff66a3d499e148ee0c1227b,2,5,8,13,3,2013-08-09 12:01:15,2013-08-08 18:47:27
0d464f85693d3264cff66a3d499e148ee0c1227b...790c6462b72613862a3c25dcc8ba14bc24d9d87d,2,15,1,16,2,2013-08-09 12:01:15,2013-08-09 00:03:28
790c6462b72613862a3c25dcc8ba14bc24d9d87d...216513d3c7a819e14953dbc05d5a0829af149128,3,12,20,32,12,2013-08-09 12:01:15,2013-08-09 00:25:01
216513d3c7a819e14953dbc05d5a0829af149128...9192eb24518d41b1e58168628f6d28a1d17990ae,2,13,10,23,8,2013-08-09 12:01:15,2013-08-09 00:42:17
9192eb24518d41b1e58168628f6d28a1d17990ae...3d1dd2f5cc905fe0458e3d76d223ec9ee6d3358c,1,6,6,12,6,2013-08-09 12:19:40,2013-08-09 12:19:40
3d1dd2f5cc905fe0458e3d76d223ec9ee6d3358c...98117924c40a32d2f7be8f446c39a4b46268d537,2,12,3,15,5,2013-08-09 15:24:12,2013-08-09 15:24:12
98117924c40a32d2f7be8f446c39a4b46268d537...0a86018f3ec8c079bbded1f9b2dd3917e9c6516f,1,0,4,4,2,2013-08-09 15:56:09,2013-08-09 15:07:03
0a86018f3ec8c079bbded1f9b2dd3917e9c6516f...7ef3ff6668c05a44745e62d02c40b6041df80bf3,3,6,6,12,5,2013-08-09 15:56:09,2013-08-09 15:12:26
7ef3ff6668c05a44745e62d02c40b6041df80bf3...ee0b4a412fbcd8bb60afd6321c2c934387f40d46,20,3000,2,3002,19,2013-08-09 16:19:55,2013-07-13 16:59:25
ee0b4a412fbcd8bb60afd6321c2c934387f40d46...be2495b481323dff954c5ea1890f210806b4d8a3,1,7,0,7,1,2013-08-09 16:37:31,2013-08-09 15:36:35
be2495b481323dff954c5ea1890f210806b4d8a3...84ef789d4af1c89986acc737364302e70e973744,1,11,4,15,5,2013-08-09 16:44:27,2013-08-09 16:40:38
84ef789d4af1c89986acc737364302e70e973744...1d539cb19a0b20bfec14706da4dd7d4870364f87,7,62,20,82,8,2013-08-09 16:51:01,2013-08-09 16:42:39
1d539cb19a0b20bfec14706da4dd7d4870364f87...c4b3dd888d864923fe8ad51b0a89e95fd3d7d02c,1,7,0,7,4,2013-08-09 17:13:01,2013-08-09 17:13:01
c4b3dd888d864923fe8ad51b0a89e95fd3d7d02c...2c9a4671edfcbce8343606d8827fdf85fa0e05fa,7,0,238,238,7,2013-08-09 17:38:27,2013-08-06 17:21:12
2c9a4671edfcbce8343606d8827fdf85fa0e05fa...cceff51b744ace213d1bc2adae37ecfaf35439d4,4,0,168,168,4,2013-08-09 17:38:27,2013-08-06 17:27:13
cceff51b744ace213d1bc2adae37ecfaf35439d4...311aafaf4d17470f9d5b1ae2090acf38fb4d00a3,18,275,825,1100,175,2013-08-09 17:38:27,2013-08-02 23:34:34
311aafaf4d17470f9d5b1ae2090acf38fb4d00a3...cefbca64b1406f6e389afd2e2b817982879c17e9,19,29,313,342,144,2013-08-09 17:38:27,2013-08-06 18:04:00
cefbca64b1406f6e389afd2e2b817982879c17e9...ed045d1497ebb3f89d2972cbeae79bf8123d5637,4,20,70,90,18,2013-08-09 17:38:27,2013-08-06 23:01:22
ed045d1497ebb3f89d2972cbeae79bf8123d5637...cc5dd54b64ffece231ba7ec917e8a92252b7be63,1,6,1,7,3,2013-08-09 17:38:27,2013-08-06 23:09:46
cc5dd54b64ffece231ba7ec917e8a92252b7be63...6b7cce6be7d9fbec8b0b262654b9a5512bd06746,2,27,14,41,8,2013-08-09 17:38:27,2013-08-07 22:14:21
6b7cce6be7d9fbec8b0b262654b9a5512bd06746...bab9ab6d5b8687aa2a5bc0907ea07f8f5a90caf1,8,55,78,133,41,2013-08-09 17:38:27,2013-08-07 22:44:39
bab9ab6d5b8687aa2a5bc0907ea07f8f5a90caf1...b7e05118930c60c3ae4be09f2c35baa75421eeb4,17,61,139,200,46,2013-08-09 17:38:27,2013-08-08 23:36:19
b7e05118930c60c3ae4be09f2c35baa75421eeb4...f1e163ba01fcececd052a972e1c372f9d08ad50d,3,7,259,266,70,2013-08-09 17:38:27,2013-08-09 17:16:27
f1e163ba01fcececd052a972e1c372f9d08ad50d...58f5cb783155df93020c15b81d24515c0fbee488,1,8,4,12,3,2013-08-09 17:54:29,2013-08-09 17:54:22
58f5cb783155df93020c15b81d24515c0fbee488...254444b8113d9eb8291dbde67ee75307839eaf40,1,1,1,2,1,2013-08-09 18:13:17,2013-08-09 18:04:07
254444b8113d9eb8291dbde67ee75307839eaf40...a9b7d683cbb8b56a854deac57b1da99ff76f77b1,1,27,2,29,6,2013-08-09 18:32:09,2013-08-09 17:31:32
a9b7d683cbb8b56a854deac57b1da99ff76f77b1...4d51d8feb80abdf995b3c4d75d57dca33283d742,4,2,7,9,5,2013-08-09 18:49:13,2013-08-09 18:46:15
4d51d8feb80abdf995b3c4d75d57dca33283d742...ef7dc8033448b079aa2063f09e50e33c081f5fcd,2,101,4,105,5,2013-08-09 18:54:57,2013-08-02 18:06:31
ef7dc8033448b079aa2063f09e50e33c081f5fcd...a58ac6c4c0bdaa7d401df581f7a44119e29770ef,5,87,44,131,25,2013-08-09 18:54:57,2013-08-02 19:01:57
a58ac6c4c0bdaa7d401df581f7a44119e29770ef...40574e41cfcd89df3e173af4df8feed09fed3579,2,50,1,51,3,2013-08-09 18:55:54,2013-08-09 02:00:34
40574e41cfcd89df3e173af4df8feed09fed3579...f03d58d18bd379e35e0b17c2a5676aaf5dd7fb03,2,67,3,70,3,2013-08-09 20:22:20,2013-08-09 19:52:05
f03d58d18bd379e35e0b17c2a5676aaf5dd7fb03...7fc597e0aecacb4155edcc7b56531f1f0371968f,3,19,31,50,17,2013-08-09 21:32:54,2013-07-26 14:54:29
7fc597e0aecacb4155edcc7b56531f1f0371968f...a3ac5c0d4548a259b55aae11440ade070bc66195,4,628,0,628,8,2013-08-09 21:32:54,2013-07-22 20:22:11
a3ac5c0d4548a259b55aae11440ade070bc66195...af6828e05aaea88e181cad598cc1274e2838d25a,3,244,12,256,23,2013-08-09 21:45:17,2013-07-25 21:23:33
af6828e05aaea88e181cad598cc1274e2838d25a...cd81198d0280abc8144bd7fa291a15564c1c0ae4,3,29,1,30,6,2013-08-09 21:48:46,2013-07-29 20:27:09
cd81198d0280abc8144bd7fa291a15564c1c0ae4...827b08520963c0243b5d3b66d2e73a659af8525d,3,34,1,35,5,2013-08-12 15:34:36,2013-08-09 22:25:33
827b08520963c0243b5d3b66d2e73a659af8525d...554b31cde9256f77fbf880261ea90067ef277abd,3,19,10,29,8,2013-08-12 15:47:37,2013-08-08 14:50:08
554b31cde9256f77fbf880261ea90067ef277abd...525f2f11ac545221f1b0af0746d0891c40ed9aa7,18,682,132,814,107,2013-08-12 15:47:37,2013-08-08 20:30:51
525f2f11ac545221f1b0af0746d0891c40ed9aa7...69f264e93dee509597f787773e1f05e1ec313d2b,19,665,137,802,44,2013-08-12 15:52:13,2013-08-09 03:15:00
69f264e93dee509597f787773e1f05e1ec313d2b...9c4e27095054023a393ff263582121d3f1a80486,1,0,1,1,1,2013-08-12 16:13:56,2013-08-12 16:13:56
9c4e27095054023a393ff263582121d3f1a80486...cbbfdade56c4863d5c350f3196415ed43034d6ca,9,246,212,458,66,2013-08-12 18:34:54,2013-08-12 17:56:12
cbbfdade56c4863d5c350f3196415ed43034d6ca...d4f670c95a3cc81f4ea297ff0cf809568261dcaf,10,32,21,53,17,2013-08-12 21:25:41,2013-08-12 17:45:24
d4f670c95a3cc81f4ea297ff0cf809568261dcaf...b2b0616c613177255f7db56029c4d9934443d4c7,1,1,1,2,1,2013-08-13 15:04:16,2013-08-13 15:04:16
b2b0616c613177255f7db56029c4d9934443d4c7...a58ae77d0e5035cb4b541751dbe042e9173deea5,16,1096,60,1156,33,2013-08-13 15:35:36,2013-07-29 21:10:45
a58ae77d0e5035cb4b541751dbe042e9173deea5...5c94494146e1f38c81a497ac7300b65d85456cc7,3,9,7,16,5,2013-08-13 16:19:44,2013-08-09 15:35:03
5c94494146e1f38c81a497ac7300b65d85456cc7...5c03be3aca41801c807ed49666020c4a8088549d,16,60,1096,1156,32,2013-08-13 16:35:55,2013-08-13 16:35:55
5c03be3aca41801c807ed49666020c4a8088549d...2e7d6a71d544e5c3ee0d3a161179b39babd5162a,1,3,1,4,1,2013-08-13 19:18:47,2013-08-13 19:17:20
2e7d6a71d544e5c3ee0d3a161179b39babd5162a...072e12a5e5b853435e47046d979b307fa2676951,1,9,5,14,3,2013-08-13 21:00:04,2013-08-13 17:58:29
072e12a5e5b853435e47046d979b307fa2676951...dda99507af1eef8368d5d26a226d4d94f50d5a30,12,168,3804,3972,48,2013-08-13 22:02:42,2013-08-13 16:11:06
dda99507af1eef8368d5d26a226d4d94f50d5a30...e2f7e8e75c8a0cfd70c2082e6ad7e84d94f0f457,11,419,341,760,61,2013-08-13 22:02:42,2013-08-13 21:56:13
e2f7e8e75c8a0cfd70c2082e6ad7e84d94f0f457...d42628ece83ebf3a6b340ae8c894e45a2c2ec9b9,1,8,1,9,2,2013-08-14 15:11:05,2013-08-12 23:24:16
d42628ece83ebf3a6b340ae8c894e45a2c2ec9b9...8f8ab9162c78f49b0ada3a0b8073c53755f0fc87,1,14,14,28,3,2013-08-14 17:39:01,2013-08-14 17:17:37
8f8ab9162c78f49b0ada3a0b8073c53755f0fc87...9b98517497f44c49bc6374ba1d7b5a1480721d1c,3,10,15,25,3,2013-08-14 18:32:50,2013-08-14 17:19:54
9b98517497f44c49bc6374ba1d7b5a1480721d1c...ca81b44e30d4803da3d6994d0278350ac02f3d88,1,4,3,7,1,2013-08-14 20:20:55,2013-08-14 20:20:55
ca81b44e30d4803da3d6994d0278350ac02f3d88...dc31cddf24741317861376ec511d50e7425fc365,1,16,1,17,2,2013-08-14 21:27:41,2013-08-14 21:27:30
dc31cddf24741317861376ec511d50e7425fc365...350392319a81bc9a43dd7befff33ff41798504f3,16,1096,60,1156,33,2013-08-14 21:48:14,2013-07-29 21:10:45
350392319a81bc9a43dd7befff33ff41798504f3...35008eaeaebf8245af14f0ea9bbca42b51ed23e2,6,447,114,561,26,2013-08-15 02:11:03,2013-08-12 21:33:57
35008eaeaebf8245af14f0ea9bbca42b51ed23e2...3bd462d9e4c30a2002449dd0d17b7d8ca6b0825b,28,756,380,1136,228,2013-08-15 02:28:01,2013-08-13 21:20:54
3bd462d9e4c30a2002449dd0d17b7d8ca6b0825b...18b387d77f1bf16f4aa9087298eae362c3ebdaba,1,2,11,13,4,2013-08-15 02:50:57,2013-08-15 02:50:57
18b387d77f1bf16f4aa9087298eae362c3ebdaba...c9b019d326dca25c7f88abb5b74aef2476b69aec,1,3,1,4,2,2013-08-15 03:46:05,2013-08-15 03:46:05
c9b019d326dca25c7f88abb5b74aef2476b69aec...23b676781c096cbc3acc83cfaf188cb219d6a06d,1,1,0,1,1,2013-08-15 14:13:09,2013-08-01 18:22:42
23b676781c096cbc3acc83cfaf188cb219d6a06d...c841975ca8752c27a4bb1484876f23d5360afef9,1,12,3,15,4,2013-08-15 14:13:10,2013-08-14 15:11:58
c841975ca8752c27a4bb1484876f23d5360afef9...d53c3240e3f83080f6a9e36edb9b118ff9f97f9b,6,476,34,510,18,2013-08-15 19:46:01,2013-08-12 21:19:33
d53c3240e3f83080f6a9e36edb9b118ff9f97f9b...d37eb1a01e0947b689d232430eac782a41e89ae0,2,12,1,13,2,2013-08-15 20:13:53,2013-06-24 21:50:03
d37eb1a01e0947b689d232430eac782a41e89ae0...468eb5426a84d80033473ac14dde91b95fb6f7cb,1,6,3,9,1,2013-08-15 22:16:24,2013-08-15 19:44:48
468eb5426a84d80033473ac14dde91b95fb6f7cb...4dea25eed39f79a2211c6c892a04162cf7c2bec5,1,3,4,7,1,2013-08-15 22:18:21,2013-08-15 18:34:09
4dea25eed39f79a2211c6c892a04162cf7c2bec5...90d8b6915eba4447bb8b7b2adadd47509c685d4a,1,2,0,2,1,2013-08-15 22:18:21,2013-08-15 18:35:20
90d8b6915eba4447bb8b7b2adadd47509c685d4a...38b35f7595415ab583f4ffe0da981fa5007460ef,5,69,2,71,9,2013-08-16 13:18:46,2013-08-15 13:18:25
38b35f7595415ab583f4ffe0da981fa5007460ef...48e43f299bebb88f9f8e435642e31105b42bb434,6,4,4,8,7,2013-08-16 13:18:46,2013-08-15 13:22:39
48e43f299bebb88f9f8e435642e31105b42bb434...0ea79f6e86fb059478468a583f30cda8a1360318,8,107,49,156,55,2013-08-16 13:18:46,2013-08-15 14:28:41
0ea79f6e86fb059478468a583f30cda8a1360318...ac1c12cb75ee05528e569311a7adfdf2fff9773f,4,28,24,52,14,2013-08-16 13:18:46,2013-08-15 20:23:21
ac1c12cb75ee05528e569311a7adfdf2fff9773f...ed3d20966665a8a458cdb242c3de424f43750a21,3,36,3,39,7,2013-08-16 13:18:46,2013-08-16 13:18:10
ed3d20966665a8a458cdb242c3de424f43750a21...9c57a94477344706c357fb11f05c12e2403a1b91,3,59,60,119,39,2013-08-16 13:18:46,2013-08-16 13:18:28
9c57a94477344706c357fb11f05c12e2403a1b91...b4b3b5a24178733626e21ace724a4f7815d75fa5,1,1,0,1,1,2013-08-16 19:07:27,2013-08-16 18:48:31
b4b3b5a24178733626e21ace724a4f7815d75fa5...dc54b25c89c5b1978c16359ef4230d73f46a5d19,6,14,19,33,16,2013-08-16 20:18:42,2013-08-05 14:44:13
dc54b25c89c5b1978c16359ef4230d73f46a5d19...68ba556626b05cfe6e32c883c3ca34fbdff5661f,1,56,0,56,1,2013-08-19 11:57:35,2013-08-15 12:44:02
68ba556626b05cfe6e32c883c3ca34fbdff5661f...82bcddfd8ef49159bab48778cf99e7ccc9b27297,8,115,90,205,27,2013-08-19 12:57:00,2013-08-16 21:52:46
82bcddfd8ef49159bab48778cf99e7ccc9b27297...342261c258f4bbcab04993a756f9d7d5534d8ff0,1,43,0,43,1,2013-08-19 12:58:14,2013-07-19 19:37:33
342261c258f4bbcab04993a756f9d7d5534d8ff0...961f3761203d4c1e78f44b898b6bb2cf2b98d00b,1,2,1,3,1,2013-08-19 13:51:20,2013-08-15 22:29:07
961f3761203d4c1e78f44b898b6bb2cf2b98d00b...a30754091bf2aaac3a9a3156ba82c5c96d6a3c6e,3,13,1,14,4,2013-08-19 18:16:48,2013-08-19 18:16:48
a30754091bf2aaac3a9a3156ba82c5c96d6a3c6e...f83c49b25beb75aed0d7d2ced779a4550d566252,1,1,1,2,1,2013-08-19 18:50:16,2013-08-19 18:29:37
f83c49b25beb75aed0d7d2ced779a4550d566252...6eaa0b4f0b58cd4c845109f0a5164adcc453fbe7,2,6,8,14,4,2013-08-19 19:02:12,2013-08-19 14:14:50
6eaa0b4f0b58cd4c845109f0a5164adcc453fbe7...176e5716c009535bfa2ee074d0b2f74c7ab4beda,1,1,1,2,1,2013-08-19 19:38:00,2013-08-19 17:39:39
176e5716c009535bfa2ee074d0b2f74c7ab4beda...6fea4eb1774119e6431bf251d008d062c67c73f2,2,28,2,30,3,2013-08-19 19:47:44,2013-08-19 15:51:46
6fea4eb1774119e6431bf251d008d062c67c73f2...33342134b8a72434b4281296740ff14f60c20c77,2,47,0,47,5,2013-08-19 19:47:44,2013-08-19 17:01:25
33342134b8a72434b4281296740ff14f60c20c77...c3d5e1ec7008eacf4c7e0d4f18ade3d979402bf0,1,3,1,4,1,2013-08-19 20:31:11,2013-08-19 20:29:52
c3d5e1ec7008eacf4c7e0d4f18ade3d979402bf0...e726d215f06146bb83d42427d7e9d7e37bd294d5,1,2,2,4,2,2013-08-19 20:31:11,2013-08-19 20:31:05
e726d215f06146bb83d42427d7e9d7e37bd294d5...d5b52f08ce9757f1a6825ddc91d4792e266784df,4,33,48,81,15,2013-08-19 20:49:44,2013-08-14 21:35:37
d5b52f08ce9757f1a6825ddc91d4792e266784df...4140e3743026af40d83b29f10cfbc6d7cd8505fa,1,1,1,2,1,2013-08-19 20:58:59,2013-08-19 20:58:59
4140e3743026af40d83b29f10cfbc6d7cd8505fa...e8a98c47fcf80829adae349c09efa1f6e2e1d9af,4,63,1,64,4,2013-08-19 21:03:51,2013-08-12 22:18:08
e8a98c47fcf80829adae349c09efa1f6e2e1d9af...558f2790d564cf6f27ccb76a90fdfc46e29d7d83,5,323,0,323,5,2013-08-19 21:52:19,2013-07-24 23:18:59
558f2790d564cf6f27ccb76a90fdfc46e29d7d83...48cc6e8d9d21345713d9938709e4da9255269629,8,35,30,65,28,2013-08-19 22:04:21,2013-08-13 16:47:18
48cc6e8d9d21345713d9938709e4da9255269629...8f8963e798caefb026bfbe045fa49ac785134b23,5,18,18,36,11,2013-08-19 22:04:21,2013-08-13 17:37:58
8f8963e798caefb026bfbe045fa49ac785134b23...9d3699513993b174b0fc23ba538851715f689b16,26,234,1454,1688,78,2013-08-19 22:04:21,2013-08-13 20:05:06
9d3699513993b174b0fc23ba538851715f689b16...9101b27c2303c2d1a2125234b518292068b1733c,2,45,8,53,8,2013-08-19 22:56:20,2013-07-15 21:51:06
9101b27c2303c2d1a2125234b518292068b1733c...a300d98f535d2a6b915c8e4a7ea9245c00e9de18,1,96,2,98,7,2013-08-19 22:56:25,2013-07-15 23:05:43
a300d98f535d2a6b915c8e4a7ea9245c00e9de18...6fa67b7fc1e4fb94de9ea9cfd9afd2d37d25df54,3,99,175,274,42,2013-08-19 22:56:35,2013-08-12 19:49:24
6fa67b7fc1e4fb94de9ea9cfd9afd2d37d25df54...a852f2a5f1d575ed7a20adfc63bbf4c04151ba5e,5,227,650,877,171,2013-08-19 22:57:42,2013-08-14 21:51:43
a852f2a5f1d575ed7a20adfc63bbf4c04151ba5e...d4b18b0cd61b0b9e4b50870ae4ca06229bdf0e5c,1,68,73,141,47,2013-08-19 22:59:10,2013-08-14 22:51:40
d4b18b0cd61b0b9e4b50870ae4ca06229bdf0e5c...f8e37b3b9daffbb721e231bc4418b6c7aac93e8d,2,21,4,25,5,2013-08-19 23:00:48,2013-08-15 21:16:09
f8e37b3b9daffbb721e231bc4418b6c7aac93e8d...afffc8aee9f8c8b46d8ef6b5dd4197a9dcff42bb,2,19,5,24,2,2013-08-19 23:00:48,2013-08-15 21:47:17
afffc8aee9f8c8b46d8ef6b5dd4197a9dcff42bb...40f7dbf921b6a185051d3c040ed1c3913b36982a,8,6,68,74,14,2013-08-19 23:00:48,2013-08-15 22:00:20
40f7dbf921b6a185051d3c040ed1c3913b36982a...906a8dae26108c3176e024df8c48e5fc037ddefe,1,12,23,35,6,2013-08-19 23:00:48,2013-08-16 22:21:16
906a8dae26108c3176e024df8c48e5fc037ddefe...09d28e81e81506b30e1365175d4fd9af48a04357,2,2,2,4,2,2013-08-19 23:00:48,2013-08-19 19:56:09
09d28e81e81506b30e1365175d4fd9af48a04357...0f99864fcf8f82ff2c7cb685281bc9e5d6bc6616,2,5,5,10,5,2013-08-19 23:26:17,2013-08-19 23:20:22
0f99864fcf8f82ff2c7cb685281bc9e5d6bc6616...9fb1245ae1133f76c52105f561dd4d02f531f2de,3,59,0,59,5,2013-08-20 11:09:44,2013-08-19 23:41:24
9fb1245ae1133f76c52105f561dd4d02f531f2de...0db5ea9c643ca7f5ef9b9d1fd2c0515b612e7bd9,1,4,6,10,1,2013-08-20 14:01:47,2013-08-20 14:01:47
0db5ea9c643ca7f5ef9b9d1fd2c0515b612e7bd9...cc30bffdea3da939728079ebbeaf82733b15327e,10,39,58,97,44,2013-08-20 15:02:47,2013-08-20 15:02:47
cc30bffdea3da939728079ebbeaf82733b15327e...4a0bee590b9a7c57812db89b795914ad7578b8e3,1,1,2,3,1,2013-08-20 15:39:33,2013-08-20 15:09:45
4a0bee590b9a7c57812db89b795914ad7578b8e3...a8eab606724de2d23a6cafd069f4001a031ed909,1,37,23,60,5,2013-08-20 15:48:46,2013-08-19 13:38:46
a8eab606724de2d23a6cafd069f4001a031ed909...fce3b4ce8fe848c332657f3accf596e6b087bce9,6,242,12,254,19,2013-08-20 15:48:46,2013-08-19 14:23:30
fce3b4ce8fe848c332657f3accf596e6b087bce9...95f78edec079e130c58bed831cfe341f45250784,4,251,2,253,7,2013-08-20 15:48:46,2013-08-19 20:54:09
95f78edec079e130c58bed831cfe341f45250784...4a6f0941c13ac6a197bb787e238ddbc12120b641,1,7,0,7,3,2013-08-20 15:48:46,2013-08-19 20:57:23
4a6f0941c13ac6a197bb787e238ddbc12120b641...c735600b22a78b8736c89568332a321a6753e924,5,56,11,67,13,2013-08-20 15:48:47,2013-08-19 21:26:20
c735600b22a78b8736c89568332a321a6753e924...3615218927e28d12410841c3ca77f9d93e8246dc,7,1164,1013,2177,18,2013-08-20 16:13:58,2013-08-15 19:46:56
3615218927e28d12410841c3ca77f9d93e8246dc...a61d12943d0873c7b2c3f5f452501c1b759b3fa2,3,449,193,642,58,2013-08-20 16:13:58,2013-08-15 22:24:39
a61d12943d0873c7b2c3f5f452501c1b759b3fa2...1508f53a898fa4d70b543bf4fd55817b4a3f1252,2,82,1,83,2,2013-08-20 16:13:58,2013-08-19 22:59:40
1508f53a898fa4d70b543bf4fd55817b4a3f1252...5e5bf40a5a3ce6b6ffd643faa50da34ef7d79311,3,100,3,103,3,2013-08-20 16:13:58,2013-08-19 23:42:26
5e5bf40a5a3ce6b6ffd643faa50da34ef7d79311...e54b41cc40c8240db4461a69f8100d3bee1ac3e8,44,812,445,1257,225,2013-08-20 17:39:27,2013-08-15 23:18:54
e54b41cc40c8240db4461a69f8100d3bee1ac3e8...eab481bd1a0a58418e80d087462edf3d80231951,1,1,1,2,1,2013-08-20 17:58:48,2013-08-20 17:58:48
eab481bd1a0a58418e80d087462edf3d80231951...bce592fe7c5f21c7d9e7cd3b3b6d0fa97df4096d,1,16,15,31,2,2013-08-20 18:01:31,2013-08-20 18:01:23
bce592fe7c5f21c7d9e7cd3b3b6d0fa97df4096d...f1f9514ad9840bfd7dea9cf9ee1b6b3ce7563e11,1,1,1,2,1,2013-08-20 18:49:09,2013-08-20 15:15:29
f1f9514ad9840bfd7dea9cf9ee1b6b3ce7563e11...712619f82fec8290eb1a1ecd1dd0185dfcb92a16,1,3,1,4,1,2013-08-20 18:50:47,2013-08-20 18:37:13
712619f82fec8290eb1a1ecd1dd0185dfcb92a16...07c221086ff5c20d4d62ba69837d90404459c335,4,68,14,82,20,2013-08-20 18:50:47,2013-08-12 19:53:16
07c221086ff5c20d4d62ba69837d90404459c335...3ecbcd7f3bf4a5c6920cda53bb91a120a59a149f,1,1,1,2,1,2013-08-20 21:55:03,2013-08-20 21:49:24
3ecbcd7f3bf4a5c6920cda53bb91a120a59a149f...3ae747331fc37e7826f6cd20088bee76b3a7bb00,2,7,1,8,2,2013-08-20 22:52:48,2013-08-20 22:13:41
3ae747331fc37e7826f6cd20088bee76b3a7bb00...2fb049df6f695179a02bd71cd4a6be53fd0b9bfc,7,63,39,102,32,2013-08-21 15:37:11,2013-08-21 15:33:55
2fb049df6f695179a02bd71cd4a6be53fd0b9bfc...6d461683496ca128e89bb09912564a1e5f631981,5,162,38,200,25,2013-08-21 16:46:41,2013-08-20 16:03:58
6d461683496ca128e89bb09912564a1e5f631981...5d8c1c9cc60a2ba7395691c237f8a0560d5312ae,1,0,1,1,1,2013-08-21 17:13:27,2013-08-21 17:13:27
5d8c1c9cc60a2ba7395691c237f8a0560d5312ae...252f42781db4b1019433968b7293287d18b2ec40,1,66,0,66,1,2013-08-21 17:14:04,2013-08-21 17:14:04
252f42781db4b1019433968b7293287d18b2ec40...a02c3c2f20610bee93fd68cad2324cccc629e2ff,1,0,42,42,1,2013-08-21 17:21:08,2013-08-21 17:15:03
a02c3c2f20610bee93fd68cad2324cccc629e2ff...5f86ad54f492a352c589dd949706c0e820c2a453,1,4,3,7,3,2013-08-21 17:26:43,2013-08-21 17:26:23
5f86ad54f492a352c589dd949706c0e820c2a453...2e4660cfa090e6b73181edd14f38dc1a0e4beb8b,1,1,0,1,1,2013-08-21 18:23:37,2013-08-21 18:23:10
2e4660cfa090e6b73181edd14f38dc1a0e4beb8b...401b30bc474e51658268c9a27b7ca3f6ae70aa41,4,32,13,45,17,2013-08-21 21:01:28,2013-08-21 18:59:13
401b30bc474e51658268c9a27b7ca3f6ae70aa41...3696ac227caa1dd04aa133ad202b8250ebd7c02d,2,10,1,11,2,2013-08-21 23:24:25,2013-08-21 21:36:22
3696ac227caa1dd04aa133ad202b8250ebd7c02d...7dfeb872e97a331d88f34a56b5a68ca4fb2ac93f,3,25,7,32,6,2013-08-22 14:22:06,2013-08-22 14:22:06
7dfeb872e97a331d88f34a56b5a68ca4fb2ac93f...11c0a28046f49909da3e9a7c681de9f2994ebc9a,3,18,10,28,6,2013-08-22 17:00:31,2013-08-22 17:00:31
11c0a28046f49909da3e9a7c681de9f2994ebc9a...c5a876e531ef57c3b7e60ec53ef9617bc7475969,1,7,2,9,3,2013-08-22 17:09:59,2013-08-22 15:59:21
c5a876e531ef57c3b7e60ec53ef9617bc7475969...c7412ac58c1c7052157c85bed8d07840ffe1a6fb,1,26,33,59,6,2013-08-22 17:58:28,2013-08-22 17:55:01
c7412ac58c1c7052157c85bed8d07840ffe1a6fb...13aaa9b292270514672c86cf9c39c063217b7dc7,1,1,1,2,1,2013-08-22 17:59:56,2013-08-22 17:59:56
13aaa9b292270514672c86cf9c39c063217b7dc7...0e5d98084e7c37bdbd1917caf13045af5b0e9575,1,1,2,3,1,2013-08-22 21:42:19,2013-08-22 21:42:19
0e5d98084e7c37bdbd1917caf13045af5b0e9575...e71ca210ed90143394cdade334d834d9c4ec9303,1,5,1,6,3,2013-08-22 22:21:49,2013-08-22 22:21:49
e71ca210ed90143394cdade334d834d9c4ec9303...b283169ae51328f3fb5e3c8a3c9017a2e42c148f,2,2,2,4,2,2013-08-23 03:54:07,2013-08-23 03:54:07
b283169ae51328f3fb5e3c8a3c9017a2e42c148f...f43b2308111dcece1ff7ab916109c10cd876d673,1,7,1,8,1,2013-08-23 18:11:05,2013-08-23 18:11:05
f43b2308111dcece1ff7ab916109c10cd876d673...37737595abc1abc7f56fc844696e2c666556b7d2,1,10,0,10,2,2013-08-23 18:11:40,2013-08-23 18:11:40
37737595abc1abc7f56fc844696e2c666556b7d2...d65a85dd1f7a60d78cccdaed55d1a0735aec5d15,2,2,2,4,2,2013-08-26 03:20:05,2013-08-26 03:20:05
d65a85dd1f7a60d78cccdaed55d1a0735aec5d15...6a6bc2da6536ebf4a4c2faae99f1963cd8772f87,1,3,0,3,1,2013-08-26 14:13:29,2013-08-26 14:13:29
6a6bc2da6536ebf4a4c2faae99f1963cd8772f87...c8c9cf9abe7636b75c876752656b3b730c8b2bdd,13,185,75,260,46,2013-08-26 14:43:10,2013-08-20 17:55:53
c8c9cf9abe7636b75c876752656b3b730c8b2bdd...f70a657c890f510318efc4c3e087f1142a891b47,2,1,1,2,2,2013-08-26 14:41:23,2013-08-22 21:58:10
f70a657c890f510318efc4c3e087f1142a891b47...dea748ec5697dab634deb90755720cc6cdc7f4ef,2,0,249,249,2,2013-08-26 15:37:54,2013-08-26 15:37:23
dea748ec5697dab634deb90755720cc6cdc7f4ef...33bd62f684db326aca3c4246a2cd8ed6595bae0b,1,4,13,17,2,2013-08-26 15:49:00,2013-08-23 20:30:35
33bd62f684db326aca3c4246a2cd8ed6595bae0b...4693cd6124b50bc73208c7dc81b498ff435c14b6,6,10,10,20,6,2013-08-26 15:49:00,2013-08-21 23:15:13
4693cd6124b50bc73208c7dc81b498ff435c14b6...9a0d053d7f6047a515a9c1a022550d687fe45165,6,594,597,1191,25,2013-08-26 15:49:00,2013-08-20 19:22:04
9a0d053d7f6047a515a9c1a022550d687fe45165...8564ca3e2bdaffd5a698fc23ed315706391dbe9b,2,128,63,191,35,2013-08-26 15:49:00,2013-08-20 22:57:09
8564ca3e2bdaffd5a698fc23ed315706391dbe9b...642e50abf557b339531bea4b767e1d3a81b4d669,5,14,28,42,13,2013-08-26 15:49:00,2013-08-21 18:07:17
642e50abf557b339531bea4b767e1d3a81b4d669...435646a76bc7c49bc772702ad81761a9ecaf9154,1,47,0,47,2,2013-08-26 17:18:00,2013-08-02 22:11:24
435646a76bc7c49bc772702ad81761a9ecaf9154...398ef687b738e078e6801bf25c847b6f6c2236da,3,209,179,388,3,2013-08-26 19:28:14,2013-08-26 19:28:14
398ef687b738e078e6801bf25c847b6f6c2236da...1412b6fc6988e74ba7d14ff0826cf0decc2a2816,11,44,42,86,27,2013-08-26 19:29:45,2013-08-26 19:24:23
1412b6fc6988e74ba7d14ff0826cf0decc2a2816...d5c242e1d5857ee62e339a80db4a6876a189ea43,1,1,0,1,1,2013-08-26 19:40:08,2013-08-26 19:40:08
d5c242e1d5857ee62e339a80db4a6876a189ea43...27c3e7ede4c8d0e8b7e29ad46d010a276eb0aec6,2,2,2,4,2,2013-08-26 20:00:21,2013-08-26 20:00:21
27c3e7ede4c8d0e8b7e29ad46d010a276eb0aec6...d0502e5bd74203d50ce5b4c8341de3ed01c6c508,2,2,2,4,2,2013-08-26 20:52:21,2013-08-26 20:52:21
d0502e5bd74203d50ce5b4c8341de3ed01c6c508...73841f7a1ec1322d96179eb2712ab438f56add00,16,163,217,380,79,2013-08-26 21:22:39,2013-08-22 19:11:53
73841f7a1ec1322d96179eb2712ab438f56add00...36f80f77a3370d858ac203035da8e4c29039f1b4,2,2,2,4,2,2013-08-26 21:32:57,2013-08-26 21:31:55
36f80f77a3370d858ac203035da8e4c29039f1b4...c9cb874f227531c9cffe7e292185a8c8a3e61c32,2,13,17,30,9,2013-08-26 22:23:11,2013-08-21 17:32:34
c9cb874f227531c9cffe7e292185a8c8a3e61c32...e4ccee5ee54f76cd3ecba0b8c55d38fa4ef7b212,3,35,71,106,20,2013-08-26 22:23:11,2013-08-21 17:44:58
e4ccee5ee54f76cd3ecba0b8c55d38fa4ef7b212...c7493c4c4729b99be4bc293ad299ae55906fb79d,2,18,2,20,3,2013-08-26 22:23:12,2013-08-21 18:07:20
c7493c4c4729b99be4bc293ad299ae55906fb79d...4dd9f1651b748e8640d4ea75031adffa097be3da,3,61,11,72,10,2013-08-26 22:25:24,2013-08-21 23:01:06
4dd9f1651b748e8640d4ea75031adffa097be3da...85905aab8dae4a2dfc9458c4c69b720a6cf77ac7,1,35,0,35,1,2013-08-26 22:25:32,2013-08-23 18:02:19
85905aab8dae4a2dfc9458c4c69b720a6cf77ac7...820d678f3561abb5660e27ff3204bd0e69dfe66c,1,1,1,2,1,2013-08-26 22:37:04,2013-08-26 22:37:04
820d678f3561abb5660e27ff3204bd0e69dfe66c...fab3e0c8588d206ff93bbf083a0e773e9bdeacc4,6,61,65,126,18,2013-08-27 13:55:47,2013-08-27 13:55:47
fab3e0c8588d206ff93bbf083a0e773e9bdeacc4...b54527bc9379c8d3c73ea78906b90cf6a87032ea,3,147,1,148,4,2013-08-27 17:24:43,2013-08-27 17:24:43
b54527bc9379c8d3c73ea78906b90cf6a87032ea...ab0a0a92a1cc056e841dbcdac94c2f181ce29d2b,110,1320,0,1320,110,2013-08-27 19:45:44,2013-08-27 16:03:17
ab0a0a92a1cc056e841dbcdac94c2f181ce29d2b...e5228931a9bb25a607cf19ec4881bf0d2e132a42,11,245,103,348,73,2013-08-27 20:05:36,2013-08-22 18:49:53
e5228931a9bb25a607cf19ec4881bf0d2e132a42...f64d0aeb2b6deb9aee857760ac489f6ff3412388,1,1,1,2,1,2013-08-27 20:31:49,2013-08-27 19:54:10
f64d0aeb2b6deb9aee857760ac489f6ff3412388...accaa87593a11453ddd799411832083bf4a906ff,1,8,0,8,1,2013-08-27 20:38:28,2013-08-27 20:19:00
accaa87593a11453ddd799411832083bf4a906ff...0002e082c61a9271fc68580253e1a4fb99185a9d,1,4,1,5,3,2013-08-27 20:43:38,2013-08-27 20:25:53
0002e082c61a9271fc68580253e1a4fb99185a9d...edd4f04314cb7f984d783ab37023ea965c9f1158,1,2,1,3,2,2013-08-27 21:17:16,2013-08-27 20:27:58
edd4f04314cb7f984d783ab37023ea965c9f1158...31f032eacc98c0dae39edaedb5bcee25f4bf23b5,1,17,17,34,7,2013-08-28 14:00:09,2013-08-25 01:13:42
31f032eacc98c0dae39edaedb5bcee25f4bf23b5...b823518d4c237522aacf33e17b8e57b077022ddd,1,1,1,2,1,2013-08-28 16:25:53,2013-08-28 16:25:15
b823518d4c237522aacf33e17b8e57b077022ddd...5a282cc42c381c6103b1c903c745c64ea6af9f5b,56,672,0,672,56,2013-08-28 17:14:27,2013-08-28 17:14:21
5a282cc42c381c6103b1c903c745c64ea6af9f5b...04fce192cd8a768209ed8b59ae409de0aa786b6b,1,6,0,6,1,2013-08-28 17:25:55,2013-08-28 17:25:48
04fce192cd8a768209ed8b59ae409de0aa786b6b...719771abe2217e53df3c3640501b4b460d584995,1,1,1,2,1,2013-08-28 18:04:09,2013-08-28 16:02:33
719771abe2217e53df3c3640501b4b460d584995...4a0d9d56bf56715e6488c886226caa258c500e04,1,4,3,7,3,2013-08-28 18:11:13,2013-08-28 15:45:25
4a0d9d56bf56715e6488c886226caa258c500e04...92a254d7d8e999e6d57360b431892b5c70a6f8c8,1,4,1,5,1,2013-08-28 18:45:50,2013-08-28 18:45:50
92a254d7d8e999e6d57360b431892b5c70a6f8c8...c0e30cdd562359d5f3c9afd78bf77fe35cc439d4,1,2,1,3,1,2013-08-28 18:57:24,2013-08-24 09:35:17
c0e30cdd562359d5f3c9afd78bf77fe35cc439d4...3c3ec0774e5d1a8eca63fb4d052c86ea6d2c9d8a,1,9,3,12,4,2013-08-28 19:07:17,2013-07-26 17:15:36
3c3ec0774e5d1a8eca63fb4d052c86ea6d2c9d8a...91fd0fc12938a2017897fe527ce1d195aeaa7881,2,509,2,511,4,2013-08-28 19:07:18,2013-07-26 19:48:54
91fd0fc12938a2017897fe527ce1d195aeaa7881...05433e56cf721d8fcf6a622034540e0cfe3cd527,1,1,1,2,1,2013-08-28 19:28:26,2013-08-28 13:51:04
05433e56cf721d8fcf6a622034540e0cfe3cd527...40132af8cf5b0b9ab79f24dbce72d4d5b6af88f2,3,19,1,20,4,2013-08-28 19:52:46,2013-08-12 20:52:35
40132af8cf5b0b9ab79f24dbce72d4d5b6af88f2...47272101ae458bfa0c01809bf5309a4c08c8e9c6,22,188,285,473,124,2013-08-28 19:52:46,2013-08-12 20:53:05
47272101ae458bfa0c01809bf5309a4c08c8e9c6...19282a067e489fa7e91b767812a0819ea77e1e5c,10,312,109,421,28,2013-08-28 20:31:29,2013-07-21 20:26:43
19282a067e489fa7e91b767812a0819ea77e1e5c...0ebdd89f49cc8a690dec98ba725f72ade451fc76,1,5,9,14,3,2013-08-28 21:47:41,2013-07-22 19:04:57
0ebdd89f49cc8a690dec98ba725f72ade451fc76...399c4e2ef06e62cf5c5725ebae4d3d981d0a755c,18,1171,314,1485,109,2013-08-29 14:09:10,2013-08-26 15:19:40
399c4e2ef06e62cf5c5725ebae4d3d981d0a755c...51a0bf4aefa71821b421fcdab57f1c34aa3e81c2,1,5,0,5,2,2013-08-29 14:55:37,2013-08-29 14:55:33
51a0bf4aefa71821b421fcdab57f1c34aa3e81c2...d328dd5227fd0480ff55a5d3b85adcd3e287d1da,1,1,0,1,1,2013-08-29 15:24:30,2013-08-28 19:38:12
d328dd5227fd0480ff55a5d3b85adcd3e287d1da...d4806a96d5e210361bf8212bb88a1f27152c30d9,1,1,1,2,1,2013-08-29 15:38:09,2013-08-29 15:38:09
d4806a96d5e210361bf8212bb88a1f27152c30d9...4b6fcde3430ef3ce527ebdb628bcb99696a7b194,1,1,1,2,1,2013-08-29 19:58:47,2013-07-23 20:31:05
4b6fcde3430ef3ce527ebdb628bcb99696a7b194...9436f8fe392cbd1bb3920fb627ec614853dfcb10,7,138,74,212,79,2013-08-29 20:08:39,2013-07-23 22:30:50
9436f8fe392cbd1bb3920fb627ec614853dfcb10...578bafdbee5f2a98948ad675d433e4c96cb64284,4,15,24,39,6,2013-08-29 20:54:23,2013-08-29 19:02:40
578bafdbee5f2a98948ad675d433e4c96cb64284...794646c2028da8cc4ea9db1ffd22eb1f8f2cedde,2,0,15,15,2,2013-08-29 20:54:23,2013-08-29 19:15:46
794646c2028da8cc4ea9db1ffd22eb1f8f2cedde...bfdd9917c2e2dea22a6673d45d10882d1d567362,7,87,17,104,13,2013-08-29 21:03:18,2013-08-27 21:20:19
bfdd9917c2e2dea22a6673d45d10882d1d567362...84ff1694c4bf92f3deef5c013ac9a5b912e6f96f,2,69,8,77,8,2013-08-29 22:06:52,2013-08-29 20:25:18
84ff1694c4bf92f3deef5c013ac9a5b912e6f96f...e315e755d2d20dd46864ddb671b87bbdc93914d6,2,9,4,13,4,2013-08-30 17:10:03,2013-08-29 19:30:05
e315e755d2d20dd46864ddb671b87bbdc93914d6...c0d3a2fc9969c36045c5b753a3a7a7a26bb990be,1,1,1,2,1,2013-08-30 19:07:15,2013-08-30 19:07:15
c0d3a2fc9969c36045c5b753a3a7a7a26bb990be...c9ca461c7e45abc620cd89a388fb2a253a024ca3,2,15,0,15,2,2013-08-30 19:21:26,2013-08-30 19:13:39
c9ca461c7e45abc620cd89a388fb2a253a024ca3...bd8ecf1eddc777d5763532920a20f442690a8545,1,10,4,14,7,2013-08-30 19:32:46,2013-08-30 19:28:20
bd8ecf1eddc777d5763532920a20f442690a8545...8b7ab2786e10cbe6bb84363ccb20c46ad5096f64,1,1,4,5,2,2013-08-30 22:42:14,2013-08-30 19:53:10
8b7ab2786e10cbe6bb84363ccb20c46ad5096f64...804f5dbe1f7633d7c04722a905bad252dea47a21,1,7,0,7,1,2013-08-30 22:42:14,2013-08-30 22:06:33
804f5dbe1f7633d7c04722a905bad252dea47a21...9ca2fb094b3d61d98f47ca5558cf8105f3d8306f,6,284,177,461,93,2013-09-02 12:51:33,2013-09-02 08:59:56
9ca2fb094b3d61d98f47ca5558cf8105f3d8306f...1ce8dc6c575f5b6a15a224f397c302dc602d5dec,1,5,0,5,2,2013-09-02 16:41:15,2013-09-02 16:41:15
1ce8dc6c575f5b6a15a224f397c302dc602d5dec...a61f53f26f90d05ac2835f29ff6c2000308694e6,2,13,7,20,2,2013-09-03 15:20:05,2013-09-03 11:18:56
a61f53f26f90d05ac2835f29ff6c2000308694e6...fd0e48d5bd6826eebcf15608944e524082bd700d,1,11,0,11,2,2013-09-03 15:35:55,2013-08-27 19:24:38
fd0e48d5bd6826eebcf15608944e524082bd700d...a87a966ef47900b669cf47bfdf23b3f5f019050b,4,52,20,72,17,2013-09-03 17:00:47,2013-08-26 21:10:38
a87a966ef47900b669cf47bfdf23b3f5f019050b...af844b835ae121f2ac14b603a118620b18119df3,1,1,1,2,1,2013-09-03 21:46:52,2013-09-03 21:46:52
af844b835ae121f2ac14b603a118620b18119df3...2f0c929ee17921cf122a3f3fb73f826841126a0c,2,6,1,7,2,2013-09-03 21:55:33,2013-09-03 20:47:52
2f0c929ee17921cf122a3f3fb73f826841126a0c...5fb2c2c35426d907057bccf6ffefec0493897af6,15,858,118,976,78,2013-09-03 22:14:01,2013-08-23 21:13:35
5fb2c2c35426d907057bccf6ffefec0493897af6...805c07c3bb33cae573d90d748ffc5dc9d396f2cd,1,1,1,2,1,2013-09-03 22:51:41,2013-09-03 22:51:41
805c07c3bb33cae573d90d748ffc5dc9d396f2cd...e6ed9e9a4fb5e662bc5aa20a158ddeb1fea00ded,3,17,2,19,4,2013-09-04 14:35:04,2013-09-04 14:34:00
e6ed9e9a4fb5e662bc5aa20a158ddeb1fea00ded...89ef961861e0a53b0e9355046364b2ada2c5143b,1,1,1,2,1,2013-09-04 17:11:17,2013-09-04 17:09:35
89ef961861e0a53b0e9355046364b2ada2c5143b...3e89164820991245a14f7902dc5f988e6434f192,2,3,5,8,3,2013-09-04 17:13:18,2013-09-04 16:56:28
3e89164820991245a14f7902dc5f988e6434f192...bb9bcf8822174355aa104c37f262b91a3488508d,1,4,3,7,2,2013-09-04 17:23:57,2013-09-04 17:23:57
bb9bcf8822174355aa104c37f262b91a3488508d...bb91efe5d1222ce57ec89429d0f5e5e89932f72a,1,5,1,6,1,2013-09-04 17:32:44,2013-09-04 17:14:34
bb91efe5d1222ce57ec89429d0f5e5e89932f72a...9dc48cc9760f84b1482f57b3bfd6d241d0910901,3,24,1,25,5,2013-09-04 17:40:30,2013-08-29 21:41:24
9dc48cc9760f84b1482f57b3bfd6d241d0910901...f38124f816483a2e87c3056d161035d3d1013a15,1,0,49,49,1,2013-09-04 18:31:23,2013-08-26 20:16:25
f38124f816483a2e87c3056d161035d3d1013a15...5f40281d1463a4925086b29567499924dec04889,6,152,97,249,10,2013-09-04 18:31:23,2013-09-04 03:34:32
5f40281d1463a4925086b29567499924dec04889...d564102905bf073b8370f872d1a2cac664084006,13,0,237,237,19,2013-09-04 20:25:48,2013-09-03 18:53:58
d564102905bf073b8370f872d1a2cac664084006...f51d5f797a89f7dbf152f74668c6b93065822bd2,1,10,8,18,2,2013-09-04 20:49:14,2013-09-01 18:29:15
f51d5f797a89f7dbf152f74668c6b93065822bd2...607ae1384b26ebcb5e275a845f9806104852257f,9,50,40,90,30,2013-09-04 20:50:47,2013-09-04 18:47:46
607ae1384b26ebcb5e275a845f9806104852257f...dd3a6cf40e5259ad0ce5b3eb41fae9cd76f6bf95,1,1,1,2,1,2013-09-04 21:36:13,2013-09-04 21:36:13
dd3a6cf40e5259ad0ce5b3eb41fae9cd76f6bf95...4d905c46a1cbc6f96bdd0522d0bd08f0c6c3f1c0,9,40,50,90,30,2013-09-04 23:35:32,2013-09-04 23:35:32
4d905c46a1cbc6f96bdd0522d0bd08f0c6c3f1c0...4b4fd431f5c28a4d138c113f9173abd5bb6526b3,1,3,3,6,3,2013-09-05 14:04:08,2013-09-05 13:46:45
4b4fd431f5c28a4d138c113f9173abd5bb6526b3...50a2462a66402499fa81c9fdb84ee6bab0e5d1a3,1,4,2,6,1,2013-09-05 17:49:33,2013-08-19 01:50:26
50a2462a66402499fa81c9fdb84ee6bab0e5d1a3...5ee03db5cdc40ecc0a28aaad8031df177188ffee,6,808,18,826,30,2013-09-05 17:49:33,2013-08-15 15:59:46
5ee03db5cdc40ecc0a28aaad8031df177188ffee...4ffd53218fc9d8ad63e34c7cfec4247da2d1bef7,2,95,70,165,31,2013-09-05 17:49:33,2013-08-19 04:52:37
4ffd53218fc9d8ad63e34c7cfec4247da2d1bef7...43e7502572b4a217eb3f57eee479585ae2a2d19e,6,163,6,169,9,2013-09-05 17:49:33,2013-08-18 18:23:55
43e7502572b4a217eb3f57eee479585ae2a2d19e...ace97f9b21cb9a043020e8ecab4309e35461df09,20,11,499,510,42,2013-09-05 17:49:34,2013-08-08 19:57:56
ace97f9b21cb9a043020e8ecab4309e35461df09...3de119ff3e2acd33d54a6190cbaefe38b13366e0,8,1,158,159,13,2013-09-05 17:49:34,2013-08-08 20:29:18
3de119ff3e2acd33d54a6190cbaefe38b13366e0...19013c4049d2dc018128c5bf2e63781fb5499b0e,6,142,76,218,31,2013-09-05 17:49:34,2013-08-17 20:11:06
19013c4049d2dc018128c5bf2e63781fb5499b0e...89495a86aa59f62cc36dfec0c3391155e46ee919,2,40,0,40,2,2013-09-05 17:49:34,2013-08-20 03:35:58
89495a86aa59f62cc36dfec0c3391155e46ee919...9c9f50ea6b89547c3150e0876f74366b3fba080f,5,4,5,9,5,2013-09-05 17:49:34,2013-08-24 18:30:07
9c9f50ea6b89547c3150e0876f74366b3fba080f...98b224b13cbd868745864a8817a60b801144872f,6,126,47,173,22,2013-09-05 17:49:34,2013-08-26 04:37:26
98b224b13cbd868745864a8817a60b801144872f...da10ef908dc3c94b068d96356362229c9b10af18,2,44,2,46,3,2013-09-05 17:49:34,2013-08-26 23:29:28
da10ef908dc3c94b068d96356362229c9b10af18...293cd70bc35b9fb76281599bcae1dbb6c9e03fc4,1,56,0,56,1,2013-09-05 17:49:34,2013-08-28 18:12:49
293cd70bc35b9fb76281599bcae1dbb6c9e03fc4...90ce220accd6fc9cebadce1f4d7efe2639747af5,1,0,2,2,1,2013-09-05 17:49:34,2013-08-29 22:54:12
90ce220accd6fc9cebadce1f4d7efe2639747af5...25cfd5733501d2182616305d8174daae665038bd,1,7,7,14,7,2013-09-05 17:49:34,2013-09-01 02:40:58
25cfd5733501d2182616305d8174daae665038bd...23732505d365829021f26b4d23dc59f40b75e8a2,6,153,64,217,20,2013-09-05 17:49:34,2013-08-28 21:26:42
23732505d365829021f26b4d23dc59f40b75e8a2...2729fe1381afa41f87d4be66e97e50ef93fcec5e,14,1154,343,1497,82,2013-09-05 17:49:35,2013-08-15 16:03:29
2729fe1381afa41f87d4be66e97e50ef93fcec5e...ea40937c304ad77884cc3087b491de502dca66b6,2,229,116,345,11,2013-09-05 17:49:35,2013-08-29 22:27:41
ea40937c304ad77884cc3087b491de502dca66b6...03ca1e173f4ad480a817d542780035532a4efb0f,17,1480,656,2136,136,2013-09-05 17:49:35,2013-08-14 15:54:01
03ca1e173f4ad480a817d542780035532a4efb0f...9d6ae725a6bf4a8a57bac8bfd6e5f598055e9fdf,2,23,1,24,3,2013-09-05 17:49:35,2013-09-04 13:56:18
9d6ae725a6bf4a8a57bac8bfd6e5f598055e9fdf...49fd378c1de587c185da9e47d753e5622be1d16c,8,157,1,158,12,2013-09-05 20:03:15,2013-09-05 20:03:15
49fd378c1de587c185da9e47d753e5622be1d16c...c5b115ce983b23a375a7fff32aa3b9cd013547f3,4,31,12,43,15,2013-09-05 20:32:20,2013-09-05 20:32:20
c5b115ce983b23a375a7fff32aa3b9cd013547f3...dabd77bdfa696084de7507f86733eaf563841f49,1,4,4,8,2,2013-09-05 22:33:14,2013-09-05 22:32:56
dabd77bdfa696084de7507f86733eaf563841f49...def8f6fb859a04a9c7111b98a1f1571339a644c8,2,10,2,12,2,2013-09-06 14:34:28,2013-09-06 14:32:01
def8f6fb859a04a9c7111b98a1f1571339a644c8...70cd77270cf85a2b43cd3fed6d8172fd59872f93,1,6,0,6,2,2013-09-06 15:29:57,2013-09-03 23:28:03
70cd77270cf85a2b43cd3fed6d8172fd59872f93...b9a1874e3e839aa130fe73d112470debb33e59b8,2,14,0,14,4,2013-09-06 15:29:57,2013-09-03 23:34:01
b9a1874e3e839aa130fe73d112470debb33e59b8...25785ee485220aa468fbc3eedfec1f05b36d502a,22,1051,362,1413,88,2013-09-06 15:29:57,2013-08-27 00:02:22
25785ee485220aa468fbc3eedfec1f05b36d502a...74d584f48055ad76408e8c9406a92e9b22869a83,5,24,281,305,28,2013-09-06 15:29:57,2013-09-03 18:26:55
74d584f48055ad76408e8c9406a92e9b22869a83...369f8711e2e99ba3438ed47aa7da5a412249294c,6,43,23,66,12,2013-09-06 15:29:57,2013-09-03 20:55:41
369f8711e2e99ba3438ed47aa7da5a412249294c...05c25731039dfe83994fe19bf65704c41c9f2a23,1,19,19,38,8,2013-09-06 15:29:57,2013-09-03 22:53:19
05c25731039dfe83994fe19bf65704c41c9f2a23...00c0f07bb5f875b24a3db21dc91541dad5dfdcc9,1,6,6,12,6,2013-09-06 15:29:57,2013-09-04 18:56:45
00c0f07bb5f875b24a3db21dc91541dad5dfdcc9...1a2d5ede29501a063f66da108fbb3d9a57eb1289,1,48,35,83,19,2013-09-06 15:29:57,2013-08-30 21:45:29
1a2d5ede29501a063f66da108fbb3d9a57eb1289...ec23a4a3587f83c603b36b7761881c9edb8c503b,60,357,495,852,165,2013-09-06 16:31:22,2013-09-04 19:00:54
ec23a4a3587f83c603b36b7761881c9edb8c503b...1b8b6b67ce650b4a8ce5c8df53fe20bcf50ed16a,1,1,1,2,1,2013-09-06 16:31:22,2013-09-03 15:40:42
1b8b6b67ce650b4a8ce5c8df53fe20bcf50ed16a...1529c13b783c412aee225e8a25f25882016909d2,3,63,36,99,32,2013-09-06 18:18:57,2013-09-05 21:38:13
1529c13b783c412aee225e8a25f25882016909d2...a49945291704d4554584461ff1217cb3933782a6,2,30,0,30,5,2013-09-06 18:51:25,2013-09-06 17:50:36
a49945291704d4554584461ff1217cb3933782a6...253496f54b83cbda7f13fdf48a6377bb122d9e6a,1,1,1,2,1,2013-09-06 19:11:42,2013-09-06 19:11:42
253496f54b83cbda7f13fdf48a6377bb122d9e6a...b91195fe8f9fecc7d4318d430a3c1c064b32d811,1,19,11,30,6,2013-09-06 19:22:24,2013-09-06 19:22:11
b91195fe8f9fecc7d4318d430a3c1c064b32d811...68a5d567d6c56a07a7875effaf2ac1dd37ad2b5d,2,11,3,14,4,2013-09-06 19:22:58,2013-09-06 15:24:02
68a5d567d6c56a07a7875effaf2ac1dd37ad2b5d...1d12521aef13942080808d6e1ea36f961f8c964b,1,10,4,14,4,2013-09-06 19:33:29,2013-09-06 19:33:29
1d12521aef13942080808d6e1ea36f961f8c964b...eeb7bb1ce2d530b4c00ce86383979eacac8c8e8c,166,166,166,332,166,2013-09-06 19:46:12,2013-09-06 19:27:17
eeb7bb1ce2d530b4c00ce86383979eacac8c8e8c...66379f85a208933322a54ff98895392f40d4a7a0,632,7584,0,7584,632,2013-09-06 20:15:35,2013-09-06 20:15:35
66379f85a208933322a54ff98895392f40d4a7a0...c6d6dd531e92559a74c60f4149f1d22b40f26201,1,1,1,2,1,2013-09-06 22:00:06,2013-09-06 21:59:56
c6d6dd531e92559a74c60f4149f1d22b40f26201...2dce8da5635db14c735e317f5446bda386af90e6,9,228,10,238,24,2013-09-07 16:02:32,2013-09-07 16:02:32
2dce8da5635db14c735e317f5446bda386af90e6...e84726c0abae3a5677456590b08fa9933f9db0d6,4,22,16,38,12,2013-09-09 14:46:04,2013-09-09 14:46:04
e84726c0abae3a5677456590b08fa9933f9db0d6...c6479e89bb07063c071eb30508ed0c445feb94cb,4,3,4,7,5,2013-09-09 14:52:37,2013-09-09 14:52:37
c6479e89bb07063c071eb30508ed0c445feb94cb...c2f8b3643398d9e48611e528a64cd6e631d23018,8,92,26,118,28,2013-09-09 15:35:41,2013-09-09 15:35:07
c2f8b3643398d9e48611e528a64cd6e631d23018...667648a2d9e97ca0ecf995e89eba75fd3e70a08c,1,0,6,6,1,2013-09-09 15:42:27,2013-09-06 18:15:03
667648a2d9e97ca0ecf995e89eba75fd3e70a08c...eb46cc62a0d6e08e2cabc0862490d76f2833e8b1,6,68,5,73,14,2013-09-09 15:43:45,2013-09-06 18:12:13
eb46cc62a0d6e08e2cabc0862490d76f2833e8b1...861e7d14c7a84c241063107af7eae30fd90ba197,1,10,10,20,10,2013-09-09 16:05:31,2013-09-09 16:05:31
861e7d14c7a84c241063107af7eae30fd90ba197...05c383947bf3d3d1ad0419ec3304e0e2bdf22ea3,10,524,352,876,64,2013-09-09 17:01:53,2013-09-06 20:48:32
05c383947bf3d3d1ad0419ec3304e0e2bdf22ea3...f1e09016d390badbfd9d1c75ed7683c12fb45c10,1,4,0,4,4,2013-09-09 17:23:35,2013-09-09 15:52:18
f1e09016d390badbfd9d1c75ed7683c12fb45c10...abb240549a0174f52d1ee18a8866e0ad65a10881,3,44,0,44,3,2013-09-09 18:04:00,2013-09-09 17:20:20
abb240549a0174f52d1ee18a8866e0ad65a10881...a6f74a5a6e0691488ac372ee594ed18960488040,1,9,7,16,7,2013-09-09 18:09:32,2013-09-09 18:09:15
a6f74a5a6e0691488ac372ee594ed18960488040...b6a47bf423307eff6aaa1c0c7e44b15a65c21a82,5,23,27,50,16,2013-09-09 19:18:06,2013-09-09 17:15:03
b6a47bf423307eff6aaa1c0c7e44b15a65c21a82...019d8edf1970451908bc5ed17832f6619ee61ac8,3,53,53,106,35,2013-09-09 19:18:06,2013-09-09 17:29:05
019d8edf1970451908bc5ed17832f6619ee61ac8...a6f6542f067500a1bea72ef5da723367418a6fe6,1,4,2,6,2,2013-09-09 19:37:49,2013-09-05 19:20:46
a6f6542f067500a1bea72ef5da723367418a6fe6...59eaedfdb43c1765ba91aa2c78dfc54de4844bb3,1,12,4,16,4,2013-09-09 19:50:54,2013-09-05 19:29:42
59eaedfdb43c1765ba91aa2c78dfc54de4844bb3...157e4342c22c72fa16268bf2be34617e519922be,1,1,1,2,1,2013-09-10 15:06:26,2013-09-04 19:07:38
157e4342c22c72fa16268bf2be34617e519922be...e28400200538da57d4183c58925de511c2ad8e66,10,57,40,97,32,2013-09-10 17:22:14,2013-09-04 18:47:46
e28400200538da57d4183c58925de511c2ad8e66...894828f3836184b3d6710bfa43d3ad3d876ffa8e,1,3,2,5,5,2013-09-10 17:33:40,2013-09-09 20:54:56
894828f3836184b3d6710bfa43d3ad3d876ffa8e...ce6607fd28df1cc7c57a6ea03dcb0676e7a009ce,1,8,2,10,2,2013-09-10 18:15:23,2013-08-29 16:08:37
ce6607fd28df1cc7c57a6ea03dcb0676e7a009ce...ebd13ab35a338370a44e3e2891a06d31718f83aa,1,18,3,21,2,2013-09-10 20:43:34,2013-09-06 19:19:37
ebd13ab35a338370a44e3e2891a06d31718f83aa...2c1a91e5c0570d2a00cba8675b8b4b85afd4cd96,1,16,4,20,1,2013-09-10 20:52:15,2013-09-10 14:03:44
2c1a91e5c0570d2a00cba8675b8b4b85afd4cd96...5532f53fe8ebe11ab5f90c00b46eed8504e34d73,1,5,3,8,2,2013-09-10 21:33:13,2013-09-10 21:25:43
5532f53fe8ebe11ab5f90c00b46eed8504e34d73...5e15f8978b1456a2b8d120b741a22d43e07321b3,2,2,1,3,2,2013-09-11 20:08:00,2013-09-11 20:08:00
5e15f8978b1456a2b8d120b741a22d43e07321b3...5b762d52cc78e52061120050e2a7da571543eab0,1,2,2,4,1,2013-09-11 20:20:16,2013-04-05 03:30:09
5b762d52cc78e52061120050e2a7da571543eab0...63e22137559e3589b49cb173ddb6cfe84e5dfb07,1,2,2,4,1,2013-09-11 20:26:59,2013-09-11 20:26:59
63e22137559e3589b49cb173ddb6cfe84e5dfb07...260079ce653ece2fca028d6171e8f3cdfe486bd1,9,147,43,190,24,2013-09-11 20:30:52,2013-09-10 17:54:57
260079ce653ece2fca028d6171e8f3cdfe486bd1...a688dfed6143fb16775008dd9bd63ac94722956b,5,36,4,40,16,2013-09-11 20:33:27,2013-09-10 19:02:00
a688dfed6143fb16775008dd9bd63ac94722956b...e07d6ab1354b5434948c49907fea78c4e8c8f4ca,9,14,12,26,14,2013-09-11 20:40:52,2013-09-10 19:17:13
e07d6ab1354b5434948c49907fea78c4e8c8f4ca...f0deda49e359f644e4045f9588b4d39e9398a095,8,1,558,559,15,2013-09-11 20:46:52,2013-06-24 23:30:27
f0deda49e359f644e4045f9588b4d39e9398a095...73ce2fd28b095983be6a9ba95e2a8c4568444667,4,62,31,93,22,2013-09-11 20:46:52,2013-09-10 15:56:57
73ce2fd28b095983be6a9ba95e2a8c4568444667...1bd77478ad81a008bf908acba22eb8e5aa1a7887,1,13,8,21,8,2013-09-11 21:23:37,2013-09-05 21:38:19
1bd77478ad81a008bf908acba22eb8e5aa1a7887...f4ffff0e9570f6cc0f353434705b69728d46408b,1,4,0,4,1,2013-09-11 21:39:27,2013-09-11 17:36:53
f4ffff0e9570f6cc0f353434705b69728d46408b...3933363992530034111111ae8f46b01826bfec85,1,9,1,10,1,2013-09-11 22:03:45,2013-09-06 21:26:26
3933363992530034111111ae8f46b01826bfec85...cf2000150acc7d02fb7c58669e8d5541b2ee4783,1,13,0,13,1,2013-09-11 22:42:15,2013-09-10 16:50:30
cf2000150acc7d02fb7c58669e8d5541b2ee4783...755dee05b9bbc5059b61ec09085c8ef003eb3f74,21,1555,471,2026,161,2013-09-12 00:35:08,2013-09-08 19:51:15
755dee05b9bbc5059b61ec09085c8ef003eb3f74...304acad4f7c021441aa3e5d019d5a9060bca9532,2,101,30,131,4,2013-09-12 10:06:55,2013-09-12 10:02:42
304acad4f7c021441aa3e5d019d5a9060bca9532...98c273d6a9a0aa62182e46ef5c45ed5549d7ce04,2,33,1,34,2,2013-09-12 12:38:09,2013-09-12 12:38:09
98c273d6a9a0aa62182e46ef5c45ed5549d7ce04...e82786a9f03cb18e924f72f787e184740576111b,25,3408,10,3418,33,2013-09-12 14:51:48,2013-09-01 18:43:08
e82786a9f03cb18e924f72f787e184740576111b...0d6d7f72126ab8924d44ea1bfa7d647dd05ddd6c,1,1,1,2,2,2013-09-12 16:10:26,2013-08-08 20:20:11
0d6d7f72126ab8924d44ea1bfa7d647dd05ddd6c...19e7f781a2b76e523344a3fe1d55987fd5c96395,6,75,66,141,38,2013-09-12 16:10:26,2013-08-08 20:43:15
19e7f781a2b76e523344a3fe1d55987fd5c96395...8abc4f2f2562bc10bbebfe32c9afadf8d1da3707,1,5,2,7,2,2013-09-12 16:10:26,2013-08-12 20:32:45
8abc4f2f2562bc10bbebfe32c9afadf8d1da3707...f1d9169054bbc24e4823761049211ab307417875,1,11,4,15,4,2013-09-12 16:10:26,2013-08-14 23:35:30
f1d9169054bbc24e4823761049211ab307417875...a6177c60770d8612bf13118b72be2ecdcd23f0fc,1,4,4,8,4,2013-09-12 16:10:26,2013-08-15 14:47:09
a6177c60770d8612bf13118b72be2ecdcd23f0fc...917adade854b8301e5956d37093db02b1a248070,2,27,20,47,10,2013-09-12 16:10:27,2013-08-19 16:45:49
917adade854b8301e5956d37093db02b1a248070...8ac3b7789b45edf72516834426119da565edbfac,2,127,0,127,11,2013-09-12 16:11:07,2013-08-12 21:56:34
8ac3b7789b45edf72516834426119da565edbfac...b7565690f4f3e40df4d959cfcac095d7d85b7a48,7,7,7,14,7,2013-09-12 16:46:47,2013-09-12 16:46:37
b7565690f4f3e40df4d959cfcac095d7d85b7a48...5d0cb99278bcd6a476fd85b901f37170ce64c2af,15,333,134,467,130,2013-09-12 17:58:46,2013-09-09 19:33:45
5d0cb99278bcd6a476fd85b901f37170ce64c2af...ed6874549c3fbc35a74b7f4a7b3190ebb8206a2f,2,3,2,5,3,2013-09-12 18:40:08,2013-09-12 18:40:08
ed6874549c3fbc35a74b7f4a7b3190ebb8206a2f...767a1420151cd6749c6a402e71ba19a326fbd2d1,1,0,5,5,1,2013-09-12 18:46:57,2013-09-12 18:46:57
767a1420151cd6749c6a402e71ba19a326fbd2d1...bf0055f56e4d0ff32a120f32e5597e1240c87c9d,1,16,8,24,9,2013-09-12 19:36:22,2013-09-12 19:16:23
bf0055f56e4d0ff32a120f32e5597e1240c87c9d...63f777e29558b271c9cda72791553faf94cc3deb,7,129,46,175,26,2013-09-12 19:37:17,2013-09-12 19:17:07
63f777e29558b271c9cda72791553faf94cc3deb...887aa5ba231e7ed8b7be86d4dac6bf0a211f91d5,4,93,0,93,11,2013-09-12 19:54:38,2013-09-12 19:15:07
887aa5ba231e7ed8b7be86d4dac6bf0a211f91d5...8214ffd81ccc4d6f485f9c0b9c1417136706054a,1,5,0,5,2,2013-09-12 20:05:43,2013-09-10 21:11:44
8214ffd81ccc4d6f485f9c0b9c1417136706054a...9ab28c9b500d1fea9367d8eaee337b70b66ca11f,2,87,7,94,7,2013-09-12 20:05:44,2013-09-10 21:11:13
9ab28c9b500d1fea9367d8eaee337b70b66ca11f...5b4f7a872805ceb8a9360ff1ee5f32848b65394b,7,396,13,409,16,2013-09-12 20:34:33,2013-09-12 14:57:40
5b4f7a872805ceb8a9360ff1ee5f32848b65394b...25f1dcbd1fc74198673b9777e203e4547ac74433,6,135,149,284,26,2013-09-12 22:32:01,2013-09-12 22:31:45
25f1dcbd1fc74198673b9777e203e4547ac74433...25257eef8a7e1d3b8a8bbfa12f8e9f7f0ebea7aa,1,11,11,22,10,2013-09-12 22:58:59,2013-08-26 15:08:16
25257eef8a7e1d3b8a8bbfa12f8e9f7f0ebea7aa...74b09795ac361e56d57fbc9b3ab75db6d7404cb0,1,42,11,53,17,2013-09-12 22:58:59,2013-08-26 23:00:35
74b09795ac361e56d57fbc9b3ab75db6d7404cb0...3631059a2ad3714159e064db453463c9410aabe1,1,4,16,20,2,2013-09-12 23:03:34,2013-09-12 14:50:31
3631059a2ad3714159e064db453463c9410aabe1...ea80923daacb18b922533720d6d6d008e524244a,1,0,3,3,1,2013-09-13 14:39:54,2013-09-09 08:34:30
ea80923daacb18b922533720d6d6d008e524244a...eb22c8e590a60dde9adde997f34cddcea9d166f8,4,9,9,18,8,2013-09-13 14:50:07,2013-09-13 14:15:59
eb22c8e590a60dde9adde997f34cddcea9d166f8...2110a136ef89f761928014364acef203d1feca4e,2,24,1,25,2,2013-09-13 15:17:22,2013-09-13 14:57:37
2110a136ef89f761928014364acef203d1feca4e...89d8e55e2e56c32efbc47330dbc8bef3832f8b22,11,243,55,298,41,2013-09-13 19:49:13,2013-09-09 23:46:38
89d8e55e2e56c32efbc47330dbc8bef3832f8b22...f835c63943f27c57aa7281e1505c44c60f016482,1,5,0,5,1,2013-09-13 19:59:49,2013-09-12 22:51:43
f835c63943f27c57aa7281e1505c44c60f016482...fa5170f35ebdcc6a58bf2b65cdf2d6ae2fd1acd0,1,19,6,25,4,2013-09-13 19:59:49,2013-09-11 19:24:15
fa5170f35ebdcc6a58bf2b65cdf2d6ae2fd1acd0...d279a473e4d8c73ad1655f2716ce68a27db688dc,9,172,757,929,19,2013-09-13 20:19:41,2013-09-12 00:57:48
d279a473e4d8c73ad1655f2716ce68a27db688dc...6c4f29bf67da8b796c112e9a875463a6c5b52340,1,16,0,16,1,2013-09-13 21:21:10,2013-09-13 21:21:10
6c4f29bf67da8b796c112e9a875463a6c5b52340...c3afc0341bd84dbbd68c040647c0fbcf7c7816ec,1,19,0,19,1,2013-09-13 21:22:16,2013-09-13 21:22:16
c3afc0341bd84dbbd68c040647c0fbcf7c7816ec...ae082c0c88c857f1434cace7b9172e87fbba0db0,1,21,5,26,5,2013-09-13 21:24:53,2013-09-13 21:24:53
ae082c0c88c857f1434cace7b9172e87fbba0db0...4f807d17e26a182692b451c4c980e336c0e3a0f1,2,9,1,10,6,2013-09-13 21:26:11,2013-09-13 18:14:12
4f807d17e26a182692b451c4c980e336c0e3a0f1...92eaaca216f439df7e4e990dd23a7b74cc6a13cd,4,305,13,318,17,2013-09-13 22:12:28,2013-09-12 20:07:50
92eaaca216f439df7e4e990dd23a7b74cc6a13cd...e2e5928c784e37d6cd29270d7e891f02ebf28fbc,3,44,1,45,4,2013-09-14 01:21:29,2013-09-14 01:13:56
e2e5928c784e37d6cd29270d7e891f02ebf28fbc...9c477e581a2be731e43dd1271b88e6e450c32acd,2,15,2,17,4,2013-09-14 01:21:29,2013-09-13 20:23:37
9c477e581a2be731e43dd1271b88e6e450c32acd...e0a1922b64cc771c6d04308deb58f62e59158f52,1,0,152,152,2,2013-09-14 01:42:14,2013-09-14 01:42:14
e0a1922b64cc771c6d04308deb58f62e59158f52...03247a903113971300ed417aa25368a6b04ddb27,1,4,0,4,2,2013-09-14 15:00:15,2013-09-14 15:00:02
03247a903113971300ed417aa25368a6b04ddb27...3145d2440b9ca1a61871aeb7043865a85f6b76ec,1,1,0,1,1,2013-09-16 15:17:44,2013-09-13 18:39:53
3145d2440b9ca1a61871aeb7043865a85f6b76ec...007a551ccffa23908c5dfb1c7291281916f2371a,6,17,9,26,13,2013-09-16 18:21:35,2013-09-13 14:17:18
007a551ccffa23908c5dfb1c7291281916f2371a...dd0114c4085d488469d595c07af66e89a5a0626c,1,41,0,41,2,2013-09-16 18:21:36,2013-09-16 18:21:27
dd0114c4085d488469d595c07af66e89a5a0626c...49ee714510e677bad35180cc35a529bad22ab9a1,2,1,3,4,3,2013-09-16 18:42:59,2013-09-16 18:36:57
49ee714510e677bad35180cc35a529bad22ab9a1...a9506ab7fc36ed852415ef9931e56eecdf2ca867,1,12,7,19,8,2013-09-16 18:50:19,2013-09-16 18:49:17
a9506ab7fc36ed852415ef9931e56eecdf2ca867...8ba48088a377ff819e696b1123594005d6d98d01,1,188,97,285,31,2013-09-16 21:36:35,2013-09-13 21:36:54
8ba48088a377ff819e696b1123594005d6d98d01...cf873596c7559e2b394391f5b5bdab9beceeaab4,1,19,7,26,9,2013-09-16 21:58:43,2013-09-16 19:49:25
cf873596c7559e2b394391f5b5bdab9beceeaab4...3a87320cb548be3ffddbf943da0af2833f433875,1,272,10,282,11,2013-09-16 22:34:41,2013-09-13 15:47:10
3a87320cb548be3ffddbf943da0af2833f433875...187fd3c34db7c1de32b057598aeb8a4a64ab014a,7,96,10,106,22,2013-09-16 23:01:39,2013-09-13 22:46:55
187fd3c34db7c1de32b057598aeb8a4a64ab014a...88b88bd49c2ecdc4a3f0be050360099401310566,3,103,4,107,8,2013-09-16 23:13:04,2013-09-13 22:27:23
88b88bd49c2ecdc4a3f0be050360099401310566...539f8740d2737ac054f2faf4ae55c5a4ae303e91,8,162,126,288,23,2013-09-16 23:25:46,2013-09-12 19:18:39
539f8740d2737ac054f2faf4ae55c5a4ae303e91...f0e336263bd18c0b1ba64c842509efe1e4e9d1f6,1,0,0,0,0,2013-09-17 00:30:41,2013-09-17 00:30:41
f0e336263bd18c0b1ba64c842509efe1e4e9d1f6...aea2b5a090662837c0f1b51fa34bbd6bb727f429,3,4,103,107,8,2013-09-17 01:18:36,2013-09-17 01:18:36
aea2b5a090662837c0f1b51fa34bbd6bb727f429...eea81493e27f992c7a8d604b5e60a693841e4128,8,22,22,44,18,2013-09-17 13:25:11,2013-09-11 13:23:29
eea81493e27f992c7a8d604b5e60a693841e4128...148ad7589282a8dd67527bd0c6323a655a3e9ff0,2,3,4,7,3,2013-09-17 13:25:11,2013-09-16 14:44:49
148ad7589282a8dd67527bd0c6323a655a3e9ff0...457d9ced23d82d73eaa9430a154d03584213889e,1,1,1,2,1,2013-09-17 13:25:11,2013-09-17 13:24:50
457d9ced23d82d73eaa9430a154d03584213889e...527dd9cbea88737325e12a47121e09acfeb6f1d3,1,6,0,6,1,2013-09-17 14:48:03,2013-09-13 14:46:59
527dd9cbea88737325e12a47121e09acfeb6f1d3...85304aa6b3b1a833362c993d2b0844343eb87434,8,104,81,185,34,2013-09-17 15:32:35,2013-09-17 14:41:41
85304aa6b3b1a833362c993d2b0844343eb87434...ae422036c9693096c9a3732a2ec76567d48112e3,3,106,4,110,8,2013-09-17 17:29:46,2013-09-13 22:27:23
ae422036c9693096c9a3732a2ec76567d48112e3...fbed011f2958405d2cf7bd1dafde2e7bd3df0db6,3,66,23,89,22,2013-09-17 23:00:37,2013-09-17 13:01:02
fbed011f2958405d2cf7bd1dafde2e7bd3df0db6...c57435f5c99c3c2d7cbdf29e77cca2005ade2573,3,165,0,165,9,2013-09-17 23:00:37,2013-09-17 22:16:03
c57435f5c99c3c2d7cbdf29e77cca2005ade2573...ea83ad3103fef1664e9385d48537c4163344ce8a,2,55,22,77,19,2013-09-18 00:08:13,2013-09-17 22:59:19
ea83ad3103fef1664e9385d48537c4163344ce8a...166e00122ccd947beddae28274f38677cc789980,1,1,1,2,1,2013-09-18 03:44:09,2013-09-18 03:44:09
166e00122ccd947beddae28274f38677cc789980...168f86f76612d2f56014cb610b75612c2134957b,1,1,1,2,1,2013-09-18 15:59:49,2013-09-17 17:19:24
168f86f76612d2f56014cb610b75612c2134957b...00f71c5019377b888fd847fcbec46902d3f6904e,1,10,4,14,8,2013-09-18 15:59:49,2013-09-17 21:21:17
00f71c5019377b888fd847fcbec46902d3f6904e...62309f042fd7aee9cbc7be939c3d6b5db695cbfc,2,4,2,6,2,2013-09-18 17:54:10,2013-09-12 18:36:47
62309f042fd7aee9cbc7be939c3d6b5db695cbfc...c69859f9e723f7c7930729930b688d392157a596,1,16,0,16,3,2013-09-18 19:13:56,2013-09-13 18:20:05
c69859f9e723f7c7930729930b688d392157a596...de25d5b966fae434669df47b41c076445d2303f6,2,60,20,80,6,2013-09-18 19:13:56,2013-09-17 18:52:04
de25d5b966fae434669df47b41c076445d2303f6...311ebc33f399b555309ee6eba04af8c605108529,44,1587,267,1854,142,2013-09-18 20:42:20,2013-09-18 15:57:21
311ebc33f399b555309ee6eba04af8c605108529...ef2647b519e5ed3912ca17c2107e830de7c621ce,4,85,1,86,10,2013-09-18 20:52:13,2013-08-30 17:59:27
ef2647b519e5ed3912ca17c2107e830de7c621ce...be4bc7d410dce6d82015143964c6f9bf76b16eec,1,13,4,17,2,2013-09-18 21:38:57,2013-09-18 19:55:35
be4bc7d410dce6d82015143964c6f9bf76b16eec...681bc4c9be6a3628a0a0a7d0a3fc8443c2e63091,1,4,0,4,1,2013-09-18 21:39:40,2013-09-18 20:43:19
681bc4c9be6a3628a0a0a7d0a3fc8443c2e63091...73ca6bf23e0d37ee781085466df6c989558c64a3,11,226,159,385,30,2013-09-19 04:28:58,2013-09-17 17:45:13
73ca6bf23e0d37ee781085466df6c989558c64a3...93e02c84fbd494daf5695a9b2ebce6b921da6455,1,0,21,21,1,2013-09-19 04:28:58,2013-09-18 18:29:07
93e02c84fbd494daf5695a9b2ebce6b921da6455...449cc345cf7eda2aba21c23209d3dc2d098bf8c4,12,104,107,211,36,2013-09-19 04:28:58,2013-09-19 04:28:48
449cc345cf7eda2aba21c23209d3dc2d098bf8c4...30f4e0801ab576eda3825ca671062f3736ba0f51,4,39,8,47,9,2013-09-19 15:29:48,2013-09-18 19:04:57
30f4e0801ab576eda3825ca671062f3736ba0f51...c8f2a70ba8cb346d3bd630319d39c298ed45be5a,2,39,5,44,3,2013-09-19 15:40:22,2013-09-18 20:22:31
c8f2a70ba8cb346d3bd630319d39c298ed45be5a...c9a0ca7792ecfc14eb0fefc618a2d31534b11004,2,2,1,3,2,2013-09-19 16:06:57,2013-09-16 14:38:50
c9a0ca7792ecfc14eb0fefc618a2d31534b11004...f0498832b5771b86693a89f89eae1e9c67cc8283,1,3,1,4,1,2013-09-19 16:06:57,2013-09-17 18:06:14
f0498832b5771b86693a89f89eae1e9c67cc8283...0c9e4550fe5ebad8e32193058c2ad18f1de3e518,1,3,3,6,1,2013-09-19 16:06:57,2013-09-17 18:23:23
0c9e4550fe5ebad8e32193058c2ad18f1de3e518...40e84030fbeeae06bd5229d32f91252fd1632aad,2,35,0,35,3,2013-09-19 16:06:57,2013-09-17 19:15:21
40e84030fbeeae06bd5229d32f91252fd1632aad...e97a10851c8ca7424655a5c5acd301e13178b6fa,1,1,0,1,1,2013-09-19 16:06:57,2013-09-17 19:15:58
e97a10851c8ca7424655a5c5acd301e13178b6fa...1dca33811dea7e28dc94bd6895d2b1377445c934,1,1,0,1,1,2013-09-19 16:06:57,2013-09-17 19:16:58
1dca33811dea7e28dc94bd6895d2b1377445c934...5cc06f4050fc25762579556dc079575a16b45e5d,1,21,9,30,3,2013-09-19 16:06:57,2013-09-17 19:24:05
5cc06f4050fc25762579556dc079575a16b45e5d...00557bc11c4c6d96903a39b62ff3940b5f80118b,1,38,0,38,1,2013-09-19 16:06:57,2013-09-17 19:25:30
00557bc11c4c6d96903a39b62ff3940b5f80118b...8993f914a4e4b68d07d4a81b37a2869d26c45344,1,1,0,1,1,2013-09-19 16:06:57,2013-09-17 19:26:00
8993f914a4e4b68d07d4a81b37a2869d26c45344...150d27eede6b7ccc83ffdb9bd944864a8db81ffc,1,1,0,1,1,2013-09-19 16:06:58,2013-09-17 19:26:11
150d27eede6b7ccc83ffdb9bd944864a8db81ffc...275a53427455e0dd96223b0ed203b42cf8f761e5,1,3,0,3,1,2013-09-19 16:06:58,2013-09-17 19:46:46
275a53427455e0dd96223b0ed203b42cf8f761e5...2a9f0980019fdb74377af21f86afc14cb766b860,1,12,0,12,1,2013-09-19 16:06:58,2013-09-17 20:19:24
2a9f0980019fdb74377af21f86afc14cb766b860...cd389a5b66eab681c96f7fd7515a498773c0df28,1,4,0,4,1,2013-09-19 16:06:58,2013-09-17 20:20:08
cd389a5b66eab681c96f7fd7515a498773c0df28...a4e5462387b93d7f5d79291aa8033a7f206348a8,5,5,5,10,5,2013-09-19 16:06:58,2013-09-17 21:23:54
a4e5462387b93d7f5d79291aa8033a7f206348a8...6f642d62d1fa57fbf7ec2f8ca3e0868e9b95e1eb,4,174,0,174,6,2013-09-19 16:06:58,2013-09-17 21:37:25
6f642d62d1fa57fbf7ec2f8ca3e0868e9b95e1eb...e38ef3a34a3a1f8f7eef0592379578999c00032f,2,5,1,6,2,2013-09-19 16:06:58,2013-09-17 21:51:33
e38ef3a34a3a1f8f7eef0592379578999c00032f...b753f054d56b6c63c97db963b13a9bf57cf89c2d,1,1,0,1,1,2013-09-19 16:06:58,2013-09-17 21:55:31
b753f054d56b6c63c97db963b13a9bf57cf89c2d...df6978cff0688eaa7b770396ccddfc2ae1b9bcf5,2,6,4,10,2,2013-09-19 16:06:58,2013-09-18 20:32:18
df6978cff0688eaa7b770396ccddfc2ae1b9bcf5...931efa060edf81dccd99bbe704818c9a512b49fa,1,35,24,59,9,2013-09-19 16:06:58,2013-09-18 20:43:50
931efa060edf81dccd99bbe704818c9a512b49fa...ebbe4cc7490836c7d59c2bcbfc4927afea561102,2,4,4,8,4,2013-09-19 16:06:59,2013-09-18 20:46:45
ebbe4cc7490836c7d59c2bcbfc4927afea561102...2d03c9f6e06199ba1a5453396ffe75aaadc31c0f,1,3,3,6,2,2013-09-19 16:06:59,2013-09-18 20:49:13
2d03c9f6e06199ba1a5453396ffe75aaadc31c0f...9ff7f06556943da071e1059e8e26ad0db32b3185,1,7,0,7,2,2013-09-19 16:06:59,2013-09-18 20:59:28
9ff7f06556943da071e1059e8e26ad0db32b3185...a2298b61a9e31e252ed2c779910e73e3066c0d70,9,9,40,49,9,2013-09-19 16:06:59,2013-09-18 21:18:12
a2298b61a9e31e252ed2c779910e73e3066c0d70...0b3fb180379e745f2839f78580de3e1a0269b0aa,1,9,4,13,5,2013-09-19 17:08:45,2013-09-17 20:07:28
0b3fb180379e745f2839f78580de3e1a0269b0aa...658f57fcbc975b520854e6737b1845a85f48ab1b,1,6,6,12,3,2013-09-19 17:12:46,2013-09-17 22:04:51
658f57fcbc975b520854e6737b1845a85f48ab1b...984168c52bd4d0469a807b3d76e6043409ce6f2f,1,1,1,2,1,2013-09-19 17:14:27,2013-09-17 21:31:34
984168c52bd4d0469a807b3d76e6043409ce6f2f...cf8991ad81121433019dcea4d3ba22cd427d4e51,1,915,909,1824,148,2013-09-19 17:20:08,2013-09-16 23:52:55
cf8991ad81121433019dcea4d3ba22cd427d4e51...49dca97bd8bd83b27fe9448da857d86e18921f61,2,123,0,123,2,2013-09-19 17:20:08,2013-09-17 15:58:05
49dca97bd8bd83b27fe9448da857d86e18921f61...bce3d927ca3013e54f111161f3b3cc9b752066e3,1,40,21,61,17,2013-09-19 17:20:08,2013-09-17 17:48:10
bce3d927ca3013e54f111161f3b3cc9b752066e3...4be4d5b25da64dccb1d9c41abeea43c9b5ddd997,1,63,7,70,16,2013-09-19 17:27:35,2013-09-17 19:50:15
4be4d5b25da64dccb1d9c41abeea43c9b5ddd997...9bb04443ccbcdd4f462cb2f07532c977a39bbf0d,1,20,11,31,4,2013-09-19 18:58:34,2013-09-17 15:43:44
9bb04443ccbcdd4f462cb2f07532c977a39bbf0d...2c0f016d28f2245ed8000dcecb346329ba0ed55c,11,0,272,272,19,2013-09-19 18:58:34,2013-09-17 21:22:41
2c0f016d28f2245ed8000dcecb346329ba0ed55c...8798b7e6c1e4916de7ff110129e9116c3e482fc8,2,48,5,53,4,2013-09-19 20:56:35,2013-09-18 00:22:21
8798b7e6c1e4916de7ff110129e9116c3e482fc8...b93111964cb247d636ebdb0dd92f9709287eaa8c,12,0,74,74,15,2013-09-20 01:43:07,2013-09-20 01:43:07
b93111964cb247d636ebdb0dd92f9709287eaa8c...809f199116f4f23f786c92baa73af4bd3f036237,2,77,0,77,2,2013-09-20 15:39:02,2013-09-20 12:58:03
809f199116f4f23f786c92baa73af4bd3f036237...c3ae26de5f00a1547d3e99b4da4ede775d8f6516,2,11,11,22,2,2013-09-20 15:52:01,2013-09-19 23:27:26
c3ae26de5f00a1547d3e99b4da4ede775d8f6516...761ebc17e7099314396e78baadd639cdb3101f02,1,6,6,12,3,2013-09-20 16:07:17,2013-09-20 16:03:58
761ebc17e7099314396e78baadd639cdb3101f02...46221d91b40b62d60182e389c2e4fcf7b3c75118,1,0,1,1,1,2013-09-20 17:43:00,2013-08-28 13:49:59
46221d91b40b62d60182e389c2e4fcf7b3c75118...13e8f783b5f1fa695514158e0a8fbd7ba9be48f6,2,150,364,514,33,2013-09-20 18:31:30,2013-09-19 19:25:13
13e8f783b5f1fa695514158e0a8fbd7ba9be48f6...b8d5ea09f7d34b9f1d4e438b101291cc2e27bcc2,4,494,114,608,24,2013-09-20 19:39:18,2013-09-20 19:39:12
b8d5ea09f7d34b9f1d4e438b101291cc2e27bcc2...ef6cf5605e52f33f42a946c520fb4a3b014d6e8f,3,2,6,8,3,2013-09-20 19:46:19,2013-09-18 17:20:47
ef6cf5605e52f33f42a946c520fb4a3b014d6e8f...b7d4551298e2f55a46d42a9fff993c1e7e354883,1,3,1,4,1,2013-09-20 19:46:19,2013-09-19 17:14:05
b7d4551298e2f55a46d42a9fff993c1e7e354883...0d9769e34c47dac2ec90386c46e69b6a48050232,3,0,118,118,10,2013-09-20 19:46:19,2013-08-30 20:34:58
0d9769e34c47dac2ec90386c46e69b6a48050232...2616160bb68adc7748587100c52216edee60d6fc,5,17,35,52,12,2013-09-20 19:46:19,2013-08-30 20:52:37
2616160bb68adc7748587100c52216edee60d6fc...755e7956642c01d2ba6ae7cf184b0f1a8aa0eab1,5,50,126,176,13,2013-09-20 19:46:19,2013-08-30 21:55:58
755e7956642c01d2ba6ae7cf184b0f1a8aa0eab1...7bf16104e2d7a2d0e9ee653606eaa83947bdccf1,2,27,36,63,8,2013-09-20 19:57:57,2013-08-30 22:59:35
7bf16104e2d7a2d0e9ee653606eaa83947bdccf1...a186a177704ea69502624c256f84b95e5832d86b,8,27,100,127,22,2013-09-20 20:48:01,2013-09-11 21:31:08
a186a177704ea69502624c256f84b95e5832d86b...508b3bbaf866eb3ac4eaa5e415da25a29ad0fc58,4,635,0,635,5,2013-09-20 20:59:31,2013-09-19 14:21:00
508b3bbaf866eb3ac4eaa5e415da25a29ad0fc58...06c5548f9fc1b47b59d5405d5f5d99c57ae1e6f1,1,5,1,6,1,2013-09-20 22:10:17,2013-09-20 22:03:41
06c5548f9fc1b47b59d5405d5f5d99c57ae1e6f1...ca1fa9d82a3b180f623774f86ab4ee3a8a43b6e3,1,5,2,7,2,2013-09-21 15:52:26,2013-09-21 15:52:26
ca1fa9d82a3b180f623774f86ab4ee3a8a43b6e3...fc8201aec8acb3ee46fde6915702f1269b448c6c,8,107,57,164,41,2013-09-23 14:38:13,2013-09-20 16:44:35
fc8201aec8acb3ee46fde6915702f1269b448c6c...9eb13c83ea429762c6a3d3c011fee23c81a720e2,9,227,237,464,46,2013-09-23 15:42:10,2013-09-20 23:38:40
9eb13c83ea429762c6a3d3c011fee23c81a720e2...234f50a33cd6d2a2e0a30c4b1bddb1c7de176799,1,18,15,33,2,2013-09-23 16:10:34,2013-09-20 20:39:50
234f50a33cd6d2a2e0a30c4b1bddb1c7de176799...a7f7c028c4cdda1ab0939c6c7788bb39bd94cc5f,69,872,531,1403,355,2013-09-23 20:20:12,2013-09-20 14:36:01
a7f7c028c4cdda1ab0939c6c7788bb39bd94cc5f...390d879b1bd8b40505cafcfc7b31fe9aea2dc8c6,3,498,1,499,3,2013-09-23 20:25:39,2013-09-19 22:51:11
390d879b1bd8b40505cafcfc7b31fe9aea2dc8c6...6f7f26fd08544d72da5ee0289bb25210e4791371,15,536,908,1444,99,2013-09-23 20:28:28,2013-09-20 18:57:12
6f7f26fd08544d72da5ee0289bb25210e4791371...e9e6effc6bdd4e1e64baff266fb93515367e9db7,1,1,1,2,1,2013-09-23 21:10:14,2013-09-23 21:10:14
e9e6effc6bdd4e1e64baff266fb93515367e9db7...69a0994c38b2ff5919325f4bc7af6c9802c6eaac,1,1,1,2,1,2013-09-23 21:17:01,2013-09-23 21:17:01
69a0994c38b2ff5919325f4bc7af6c9802c6eaac...19140c53ad460ebf741de9c48b224f2443cdb18e,5,43,9,52,12,2013-09-23 21:18:39,2013-09-20 22:41:21
19140c53ad460ebf741de9c48b224f2443cdb18e...221b1d1c23cf66a6609e0e0c9ab63f23c0142b3a,2,2,1,3,2,2013-09-23 21:43:41,2013-09-23 21:25:13
221b1d1c23cf66a6609e0e0c9ab63f23c0142b3a...44ae87438efc76040d93b039233d7f2ff4f46e3d,17,556,208,764,56,2013-09-23 23:28:10,2013-09-23 14:42:41
44ae87438efc76040d93b039233d7f2ff4f46e3d...abc6784faa11658b485d9b69f483ee0279c0c1f3,5,27,18,45,7,2013-09-24 01:35:01,2013-09-24 01:34:11
abc6784faa11658b485d9b69f483ee0279c0c1f3...6fd8a847809b626bf13762045c7b75730c55e784,1,2,11,13,2,2013-09-24 13:35:34,2013-09-24 13:35:15
6fd8a847809b626bf13762045c7b75730c55e784...555cbd552bf404d4e9344fe19495fcb7a36e95ac,1,12,2,14,9,2013-09-24 15:39:10,2013-09-24 15:38:56
555cbd552bf404d4e9344fe19495fcb7a36e95ac...e87726c246e50c05739bbb8f8ccfbb43384397ea,1,32,16,48,11,2013-09-24 16:16:41,2013-09-24 16:16:41
e87726c246e50c05739bbb8f8ccfbb43384397ea...3245c356ba9006309f7a340d1bd21733d67b3c27,7,425,20,445,19,2013-09-24 17:12:16,2013-09-20 22:49:12
3245c356ba9006309f7a340d1bd21733d67b3c27...0134c37b466f72d11d04d311bd390ce71fe52665,6,129,1,130,12,2013-09-24 17:12:16,2013-09-21 00:46:31
0134c37b466f72d11d04d311bd390ce71fe52665...947864ed70551afa8fea409e566c6de4e062263f,1,0,2,2,1,2013-09-24 17:38:13,2013-09-24 17:38:13
947864ed70551afa8fea409e566c6de4e062263f...52cf8ca8e15295690a21d9442cbd7d066651fc62,1,9,9,18,3,2013-09-24 17:55:21,2013-09-24 17:55:21
52cf8ca8e15295690a21d9442cbd7d066651fc62...ff60a1debd72cda29197871d1c19f536fb434eac,1,14,8,22,14,2013-09-24 18:29:54,2013-09-24 17:49:39
ff60a1debd72cda29197871d1c19f536fb434eac...ddb216a374b3daf5c2ee438803c6bf2ff7290fe4,3,6,5,11,7,2013-09-24 18:38:28,2013-09-24 05:16:55
ddb216a374b3daf5c2ee438803c6bf2ff7290fe4...0be5ade7cdccccaef2f11b31819fd671c7476c71,2,72,0,72,4,2013-09-24 19:02:53,2013-09-20 20:47:28
0be5ade7cdccccaef2f11b31819fd671c7476c71...cb545b3187782f66669060de89f8d5949517d498,4,31,38,69,5,2013-09-24 19:31:57,2013-09-24 15:52:38
cb545b3187782f66669060de89f8d5949517d498...8b2e3dc176c1cbdcea5b57e080185b4fd48796c2,4,277,123,400,60,2013-09-24 20:58:44,2013-09-24 19:30:03
8b2e3dc176c1cbdcea5b57e080185b4fd48796c2...c30d78afdab3cfc95d1ece9f1e8680b7a2e1dc28,5,35,12,47,7,2013-09-24 21:17:40,2013-09-23 16:05:52
c30d78afdab3cfc95d1ece9f1e8680b7a2e1dc28...14837002ef926c56f9ac3683127325833885594f,1,8,2,10,2,2013-09-24 21:17:40,2013-09-23 17:02:58
14837002ef926c56f9ac3683127325833885594f...6d0f6d995c61561a75b522d00eaab43f2a2119cb,1,26,4,30,5,2013-09-24 22:38:24,2013-09-24 03:33:03
6d0f6d995c61561a75b522d00eaab43f2a2119cb...42d97fdd535b1287c9dbeaa1cb1ddaab139a5d52,10,147,97,244,46,2013-09-24 22:38:24,2013-09-24 05:07:44
42d97fdd535b1287c9dbeaa1cb1ddaab139a5d52...d3da966f577ca0f646ecf63b7b5d61dec376dd4f,6,115,32,147,18,2013-09-24 22:38:24,2013-09-24 15:55:00
d3da966f577ca0f646ecf63b7b5d61dec376dd4f...97c82b16b21d2fe06f933e406909322115e79eaf,4,9,5,14,8,2013-09-25 14:40:14,2013-09-19 19:39:50
97c82b16b21d2fe06f933e406909322115e79eaf...366dee7392723b826f7409359f77be8efb863822,3,3,0,3,3,2013-09-25 15:52:34,2013-09-23 22:04:25
366dee7392723b826f7409359f77be8efb863822...22c276a037ad102738e7b7c86070d3d613fd8e10,1,2,2,4,4,2013-09-25 17:26:06,2013-09-25 15:51:51
22c276a037ad102738e7b7c86070d3d613fd8e10...a938bebde04c1320aa267f0990251d83e9bd4cfc,15,144,155,299,126,2013-09-25 18:04:13,2013-09-25 15:40:54
a938bebde04c1320aa267f0990251d83e9bd4cfc...6faea24a8e6889c7a46c8e1c305cfa9cd430b0e7,6,114,89,203,17,2013-09-25 18:19:57,2013-09-25 18:19:20
6faea24a8e6889c7a46c8e1c305cfa9cd430b0e7...4616eae3efe8301ac12574bfc7c6d54338b58bd7,6,67,44,111,15,2013-09-25 18:21:49,2013-08-25 14:55:22
4616eae3efe8301ac12574bfc7c6d54338b58bd7...03095b15c71886456ac46a315ea03614bb7aced4,1,57,51,108,23,2013-09-25 18:21:49,2013-09-22 21:56:13
03095b15c71886456ac46a315ea03614bb7aced4...2f23c6ecb941d94fa7705475f47634ee57205e82,2,11,4,15,3,2013-09-25 18:21:49,2013-09-23 23:45:37
2f23c6ecb941d94fa7705475f47634ee57205e82...cd9b71b197d47404e2ceab2d1ec189e016b73f76,1,72,0,72,1,2013-09-25 19:51:45,2013-09-25 19:51:45
cd9b71b197d47404e2ceab2d1ec189e016b73f76...3b6112691e7c9e6ed42bc46f434c75d29c23a9b1,1,2,1,3,1,2013-09-25 20:43:03,2013-09-25 19:53:18
3b6112691e7c9e6ed42bc46f434c75d29c23a9b1...602fa4c70120da815d93014773eee0454076a7d9,2,12,2,14,3,2013-09-25 21:16:24,2013-09-25 19:17:24
602fa4c70120da815d93014773eee0454076a7d9...7f9402ad7a5d5c741636f04ce1dbdf48b076d65a,1,7,1,8,2,2013-09-25 23:11:43,2013-09-25 22:21:15
7f9402ad7a5d5c741636f04ce1dbdf48b076d65a...cd2f9548a39b1fd215e983610ddb2edd0d694abf,5,99,101,200,34,2013-09-26 01:41:28,2013-09-10 23:25:45
cd2f9548a39b1fd215e983610ddb2edd0d694abf...787d2d85a8693dce18137866e5ac969e5f97e66a,3,9,8,17,6,2013-09-26 01:41:28,2013-09-13 16:54:31
787d2d85a8693dce18137866e5ac969e5f97e66a...5a590d8514813f6cb169ab1f8ab6eb7ef03678ea,1,4,2,6,2,2013-09-26 01:41:28,2013-09-17 01:00:28
5a590d8514813f6cb169ab1f8ab6eb7ef03678ea...d32637303b9dedd812d8bc9c10b173755e3602eb,1,1,1,2,1,2013-09-26 01:41:28,2013-09-17 17:21:01
d32637303b9dedd812d8bc9c10b173755e3602eb...e01dfe96c73e89fb5e20f55faff4fcbfb54de1b5,8,23,23,46,16,2013-09-26 01:41:28,2013-09-17 20:04:50
e01dfe96c73e89fb5e20f55faff4fcbfb54de1b5...f3a980467f6d1488e961c0311a438ba361bebc95,1,10,3,13,5,2013-09-26 14:27:38,2013-09-26 14:27:38
f3a980467f6d1488e961c0311a438ba361bebc95...fb4944060d8636f37dc400a9ce1339fd20fd96f6,10,115,13,128,28,2013-09-26 17:20:44,2013-09-23 21:29:52
fb4944060d8636f37dc400a9ce1339fd20fd96f6...baf629bdeeaa6a3069fbe087eeb5078d3d0b1f7c,5,227,1,228,9,2013-09-26 17:50:11,2013-09-25 20:09:40
baf629bdeeaa6a3069fbe087eeb5078d3d0b1f7c...0bbbff4e4dd257e85c088bc948247c875afa9a59,2,97,28,125,7,2013-09-26 17:50:11,2013-09-25 23:02:05
0bbbff4e4dd257e85c088bc948247c875afa9a59...7400583ce8c0d56f63ec8e7dde00ee820059dcb3,7,157,13,170,21,2013-09-26 17:55:41,2013-09-26 00:01:17
7400583ce8c0d56f63ec8e7dde00ee820059dcb3...25d5d2ae7c22267d942532de72109d3d7bf67a8c,1,1,1,2,1,2013-09-26 17:59:11,2013-09-23 22:06:19
25d5d2ae7c22267d942532de72109d3d7bf67a8c...3bc344db791e74f378880fd4ccd2ea045ba238f9,24,622,837,1459,128,2013-09-26 18:33:43,2013-09-19 19:46:08
3bc344db791e74f378880fd4ccd2ea045ba238f9...15db6be024ef4d385e09047357f1a61fe824aee8,11,551,528,1079,92,2013-09-26 19:07:32,2013-09-25 02:03:57
15db6be024ef4d385e09047357f1a61fe824aee8...79961a63ad9f54735643b7458da634d566e08e15,12,277,151,428,83,2013-09-26 19:07:32,2013-09-25 21:22:08
79961a63ad9f54735643b7458da634d566e08e15...7c6275aa25e251d0f78c418a9b30a18cd315941b,1,1,1,2,1,2013-09-26 19:12:05,2013-09-26 19:12:05
7c6275aa25e251d0f78c418a9b30a18cd315941b...3d5569423449fc395c22ad3faac453e4ed672bc8,2,13,1,14,5,2013-09-26 19:10:51,2013-09-24 19:56:46
3d5569423449fc395c22ad3faac453e4ed672bc8...b721a34ec418cbf79598e284a1409db2f93a3aa9,1,51,51,102,12,2013-09-26 19:27:26,2013-09-26 18:19:54
b721a34ec418cbf79598e284a1409db2f93a3aa9...c24fcb963a2e9f112f21fd05229f48e6dd48d32a,1,1,1,2,1,2013-09-26 20:29:54,2013-09-26 19:09:00
c24fcb963a2e9f112f21fd05229f48e6dd48d32a...74c0439725e525689f04ad64a906a824ec8dd49c,1,1,1,2,1,2013-09-26 20:54:17,2013-09-26 20:44:07
74c0439725e525689f04ad64a906a824ec8dd49c...86241d5da584018ef9bcfa779c1cc47459f2d155,1,11,2,13,5,2013-09-26 22:26:40,2013-09-26 22:25:50
86241d5da584018ef9bcfa779c1cc47459f2d155...3efaca47f92922f406da45a959ebfb44d9f2d59a,127,7261,10,7271,131,2013-09-26 22:35:24,2013-09-25 22:41:09
3efaca47f92922f406da45a959ebfb44d9f2d59a...0c134de2923a858298d8f38db62480a901ba4f39,1,2,11,13,5,2013-09-27 03:40:14,2013-09-27 03:40:14
0c134de2923a858298d8f38db62480a901ba4f39...56eb5057b8d817026ea299249bbc428da3b11a6f,7,106,16,122,21,2013-09-27 14:23:07,2013-09-27 00:48:08
56eb5057b8d817026ea299249bbc428da3b11a6f...e2c0abfa3746aa034d2a279a6da276ea8cdca6e0,6,711,0,711,6,2013-09-27 15:55:11,2013-09-25 16:12:28
e2c0abfa3746aa034d2a279a6da276ea8cdca6e0...f2d1b125b59b23f7be0d2e696bae706405124837,1,1,1,2,1,2013-09-27 16:35:14,2013-09-26 22:19:33
f2d1b125b59b23f7be0d2e696bae706405124837...8965a37fee24afc50919ba1df9c4952bec929ca2,1,1,1,2,1,2013-09-27 16:41:16,2013-09-27 16:40:59
8965a37fee24afc50919ba1df9c4952bec929ca2...5356c87e34275379e0a9de2ff441055d0da0bf5f,4,75,27,102,7,2013-09-27 17:03:56,2013-09-20 16:51:05
5356c87e34275379e0a9de2ff441055d0da0bf5f...40b90318d5e94fa2112650f72c371d6bd2e535c7,1,13,2,15,1,2013-09-27 17:55:31,2013-09-19 18:04:41
40b90318d5e94fa2112650f72c371d6bd2e535c7...d4237ac1b5e948b6ac302d1816bcb2b465dafcf3,1,0,4,4,1,2013-09-27 18:52:48,2013-09-27 18:51:15
d4237ac1b5e948b6ac302d1816bcb2b465dafcf3...70b6a29e99a1087330092a8a16b25d1d7fa6b493,3,27,0,27,4,2013-09-27 19:18:13,2013-09-25 19:33:52
70b6a29e99a1087330092a8a16b25d1d7fa6b493...b3616bea4afb813427f601764c65f1e291f82a6e,9,221,37,258,41,2013-09-27 20:48:50,2013-09-27 18:36:10
b3616bea4afb813427f601764c65f1e291f82a6e...8a2181ba012c8d28faeb5f5dd56cc7e19ae4ec56,3,15,7,22,6,2013-09-27 20:53:16,2013-09-19 18:15:17
8a2181ba012c8d28faeb5f5dd56cc7e19ae4ec56...152e2750461f8410010a30f95431e43314f131ab,4,217,1,218,5,2013-09-27 21:11:07,2013-09-25 18:33:33
152e2750461f8410010a30f95431e43314f131ab...7e206a4fa6e9aa6ea283f4da3daec127c41f88b5,10,58,27,85,36,2013-09-27 21:12:50,2013-09-25 21:33:02
7e206a4fa6e9aa6ea283f4da3daec127c41f88b5...01142042154d9ae47f5435c5a8df47c650dc376c,6,540,489,1029,10,2013-09-27 21:12:55,2013-09-25 22:53:06
01142042154d9ae47f5435c5a8df47c650dc376c...7f3eab9a44d4e3f9fffa8b14fca3b61a444306c4,7,162,163,325,18,2013-09-27 21:28:51,2013-09-27 21:19:19
7f3eab9a44d4e3f9fffa8b14fca3b61a444306c4...2deab8693871e0d762eb5810c1ea1beefd29dea6,1,17,9,26,2,2013-09-27 23:56:07,2013-09-27 19:10:18
2deab8693871e0d762eb5810c1ea1beefd29dea6...f294acf6512a11ee06ed88555b02947f2fbe2c79,4,574,0,574,5,2013-09-27 23:56:07,2013-09-27 19:15:18
f294acf6512a11ee06ed88555b02947f2fbe2c79...02d5e9521f71e1a090da489a594087352a00016c,4,735,0,735,5,2013-09-27 23:56:07,2013-09-27 19:33:21
02d5e9521f71e1a090da489a594087352a00016c...68b9892772fc012dc4d15bef8deb19bc2af8cdaf,1,3,0,3,2,2013-09-28 02:29:33,2013-09-28 02:29:33
68b9892772fc012dc4d15bef8deb19bc2af8cdaf...d72362a3ecb69f8f504b2b99a0adf64ae5cf7a12,4,9,6,15,6,2013-09-29 12:53:02,2013-09-29 12:51:44
d72362a3ecb69f8f504b2b99a0adf64ae5cf7a12...7e57c5311b0b660cf2df6d3c2cd01245adbafe21,2,4,10,14,2,2013-09-30 15:56:14,2013-09-30 15:56:14
7e57c5311b0b660cf2df6d3c2cd01245adbafe21...b81f8287901093ee883926358817488b5a45e247,1,1,1,2,1,2013-09-30 17:35:13,2013-09-30 16:03:40
b81f8287901093ee883926358817488b5a45e247...10870bd2798db3c257d35a905985a066a8df82ec,1,1,1,2,1,2013-09-30 17:42:44,2013-09-27 22:06:48
10870bd2798db3c257d35a905985a066a8df82ec...625e971353db40be3a3c91aa1c1d708af9705693,13,314,24,338,35,2013-09-30 18:10:54,2013-09-25 20:42:45
625e971353db40be3a3c91aa1c1d708af9705693...043238005510c70d2d59a6228c58f0f44685d143,1,3,3,6,1,2013-09-30 19:00:50,2013-09-30 18:33:23
043238005510c70d2d59a6228c58f0f44685d143...bbb2659eff533a362e43d60914b0cda0f44a9343,2,0,104,104,2,2013-09-30 22:33:35,2013-09-30 22:32:47
bbb2659eff533a362e43d60914b0cda0f44a9343...257d3f5361627bdd1b719c288381a959793246a2,18,1237,639,1876,180,2013-09-30 22:56:52,2013-09-28 22:48:55
257d3f5361627bdd1b719c288381a959793246a2...e41385a98e2a03f8f48249017924e79170dedabe,1,3,3,6,1,2013-10-01 12:26:35,2013-10-01 12:26:35
e41385a98e2a03f8f48249017924e79170dedabe...278f1b43f51a62989ac91741b20fbf3adb6733b2,3,94,0,94,9,2013-10-01 12:52:16,2013-09-30 21:28:14
278f1b43f51a62989ac91741b20fbf3adb6733b2...cf45f57ac3f6b3c665dd214ec29162093bbd4875,3,0,13,13,3,2013-10-01 13:58:58,2013-10-01 13:57:35
cf45f57ac3f6b3c665dd214ec29162093bbd4875...fff69fa431248586ee4ccfdb0c43960040421558,3,291,113,404,44,2013-10-01 15:59:11,2013-10-01 14:32:11
fff69fa431248586ee4ccfdb0c43960040421558...113f69d81273fac7c08befca10751f44039faf06,1,2,2,4,2,2013-10-01 17:51:48,2013-10-01 17:51:48
113f69d81273fac7c08befca10751f44039faf06...8bcb0be94d3f1add3fc11e859be1f87c1e507e46,2,6,32,38,5,2013-10-01 18:54:15,2013-10-01 18:54:15
8bcb0be94d3f1add3fc11e859be1f87c1e507e46...393194020e81707824b90622cf365333944133ef,1,0,1,1,1,2013-10-01 21:00:04,2013-10-01 18:11:41
393194020e81707824b90622cf365333944133ef...95e54e3cfc433d5ae016aecf95dbded8ae58b8a5,34,2257,402,2659,161,2013-10-02 01:01:41,2013-09-27 15:36:43
95e54e3cfc433d5ae016aecf95dbded8ae58b8a5...d423807c7b136c0d74e83fd45e3701c37b799506,2,3,3,6,3,2013-10-02 02:14:18,2013-10-02 02:14:18
d423807c7b136c0d74e83fd45e3701c37b799506...3b14e72704f640aff26385142d1aa61666e912fc,19,416,213,629,128,2013-10-02 02:37:37,2013-10-01 01:32:58
3b14e72704f640aff26385142d1aa61666e912fc...a65c8d5a1d26ab3a06f664b9c683f9c4b4cfaf93,3,11,6,17,6,2013-10-02 12:37:34,2013-10-02 12:37:34
a65c8d5a1d26ab3a06f664b9c683f9c4b4cfaf93...cd2d98b52ea1c3f11e0e733f1315723130ffbe67,3,24,14,38,8,2013-10-02 13:39:02,2013-10-02 13:39:02
cd2d98b52ea1c3f11e0e733f1315723130ffbe67...8318950d68d0b1f5e1390ac8c419512ca788ecda,1,1,1,2,1,2013-10-02 16:40:54,2013-10-02 16:40:54
8318950d68d0b1f5e1390ac8c419512ca788ecda...7966d19ab827fadceef4e824fc12d90b7fd968da,4,23,15,38,12,2013-10-02 17:10:26,2013-09-28 03:11:30
7966d19ab827fadceef4e824fc12d90b7fd968da...b10684823d59bf751f6bc174265b331c17dab119,6,224,23,247,22,2013-10-02 17:30:16,2013-09-27 21:42:12
b10684823d59bf751f6bc174265b331c17dab119...9a6183bc5953bd8f63385623d43ab0ed782a436c,3,97,21,118,11,2013-10-02 17:30:16,2013-09-30 19:24:37
9a6183bc5953bd8f63385623d43ab0ed782a436c...0a2ba6104b60ea8d6ae62b0b0238078ca55aaa2f,1,1,1,2,1,2013-10-02 17:41:26,2013-10-02 17:26:20
0a2ba6104b60ea8d6ae62b0b0238078ca55aaa2f...bc1bcd19d3ad22ce64f2574a2ea7f69842d8c6b9,1,10,2,12,3,2013-10-02 17:54:38,2013-10-02 17:26:01
0a2ba6104b60ea8d6ae62b0b0238078ca55aaa2f...f5168c9ae8d1e6c1bc8b09dee72dc604a75c203d,1,61,0,61,1,2013-10-02 17:52:14,2013-10-01 15:30:25
cc506fc6a274b57ee31dac021cdecd5aee084d08...d2651c8f82d90d097f5a53f69ab7edddc0844d47,8,85,37,122,12,2013-10-02 19:31:18,2013-10-01 22:39:02
d2651c8f82d90d097f5a53f69ab7edddc0844d47...e0daa0e656c7bf5ad1c7dca806b989795f52814d,4,101,17,118,13,2013-10-02 21:29:49,2013-10-02 19:50:36
e0daa0e656c7bf5ad1c7dca806b989795f52814d...c5f3e652908f1a6aa906f111c190fec7f7702a27,5,43,3,46,5,2013-10-02 21:34:01,2013-10-02 21:33:52
c5f3e652908f1a6aa906f111c190fec7f7702a27...1bd6d8a5bef49955c18b14aef95e0bfb74c228dc,4,20,1,21,6,2013-10-02 22:09:07,2013-10-02 21:50:50
1bd6d8a5bef49955c18b14aef95e0bfb74c228dc...ea7287e2caed0694a99cfef8f63290f1b213c698,2,5,0,5,5,2013-10-02 22:20:55,2013-10-02 22:06:11
ea7287e2caed0694a99cfef8f63290f1b213c698...1889f62726d1fe85339ddaccc3ea72bb499dee43,1,3,2,5,1,2013-10-02 23:09:36,2013-10-02 23:01:35
1889f62726d1fe85339ddaccc3ea72bb499dee43...1660c6c78eae0fc21a4b7fb51444a677ecc51d54,3,162,121,283,3,2013-10-03 15:25:42,2013-09-28 22:16:17
1660c6c78eae0fc21a4b7fb51444a677ecc51d54...5b74302fb716ed3ee812a008d4341a3c4355299d,3,189,107,296,18,2013-10-03 15:25:42,2013-10-03 15:25:00
5b74302fb716ed3ee812a008d4341a3c4355299d...fe65e214eb4c230c3a55f4a2744a8d9bd1517bcd,1,67,0,67,1,2013-10-03 15:36:23,2013-10-03 15:35:40
fe65e214eb4c230c3a55f4a2744a8d9bd1517bcd...61279ce0ba766a181748125d1a8dd48cec0a1d1b,1,2,0,2,1,2013-10-03 15:25:15,2013-10-03 15:25:15
61279ce0ba766a181748125d1a8dd48cec0a1d1b...65a6723ab729190c4b37ea1f207b56150b6536a6,17,1896,61,1957,46,2013-10-03 15:26:57,2013-09-24 21:11:32
65a6723ab729190c4b37ea1f207b56150b6536a6...7b1577a4cbd54670f805b2c103f99955ff26b88f,1,10,1,11,1,2013-10-03 15:26:57,2013-10-03 15:12:48
7b1577a4cbd54670f805b2c103f99955ff26b88f...b2b5a13324bc0ec61121ca983862acb3160fdf88,2,2,0,2,2,2013-10-03 15:26:57,2013-10-03 15:20:33
b2b5a13324bc0ec61121ca983862acb3160fdf88...b9420625a99eca29a02946ee24e9cfa1a4311342,1,1,2,3,2,2013-10-03 16:14:08,2013-10-03 16:14:08
b9420625a99eca29a02946ee24e9cfa1a4311342...7db361fe2dac4a533f3f51bf51a2c35b99488cc1,6,106,2,108,6,2013-10-03 16:25:08,2013-10-02 21:43:16
7db361fe2dac4a533f3f51bf51a2c35b99488cc1...c56527efedb882c74be4925cbaa97a1986421cf7,1,7,13,20,7,2013-10-03 17:13:17,2013-10-03 16:17:35
c56527efedb882c74be4925cbaa97a1986421cf7...96e1074a9b5ee3e6b609adac4cb46fcf599c7298,4,5,4,9,4,2013-10-03 17:37:06,2013-10-03 17:36:39
96e1074a9b5ee3e6b609adac4cb46fcf599c7298...88848ea94aaedf17f9b7f46631231d95b9a46038,1,2,0,2,2,2013-10-03 18:26:31,2013-10-03 16:16:22
88848ea94aaedf17f9b7f46631231d95b9a46038...09778704b9d7f8fb8b0d1ab170e2cf502387b78b,1,11,1,12,2,2013-10-03 18:32:55,2013-10-03 13:59:15
09778704b9d7f8fb8b0d1ab170e2cf502387b78b...ed276d0dfa27d9a53cbc5bb674be0e195f8d035d,1,0,4,4,1,2013-10-03 18:46:46,2013-10-03 18:45:49
ed276d0dfa27d9a53cbc5bb674be0e195f8d035d...adabaf90744d3e661622849e44b63f2395188703,1,1,1,2,1,2013-10-03 19:38:12,2013-10-03 19:38:12
adabaf90744d3e661622849e44b63f2395188703...1ccb9e93cd3013798cbfe6f5b6322ec5f6137906,1,4,4,8,2,2013-10-03 20:54:24,2013-10-03 19:59:37
1ccb9e93cd3013798cbfe6f5b6322ec5f6137906...1819d0083db9d71560a886598a245f12704d4403,2,35,0,35,2,2013-10-03 22:21:44,2013-10-03 18:08:36
1819d0083db9d71560a886598a245f12704d4403...1475a45bf38637670170fff57823ee1aa8a193df,7,145,12,157,13,2013-10-03 22:37:11,2013-10-01 15:16:51
1475a45bf38637670170fff57823ee1aa8a193df...d1a4564bbac9b1317ee3d684bb26931a3f450b29,5,44,0,44,8,2013-10-03 22:51:18,2013-09-27 17:45:54
d1a4564bbac9b1317ee3d684bb26931a3f450b29...ddadab1bbd8739df2c2a91b5f88c254d7e14380d,1,3,1,4,1,2013-10-04 12:44:15,2013-10-03 20:03:17
ddadab1bbd8739df2c2a91b5f88c254d7e14380d...060a5527947a4facdacfb15cbbfa18d75dbfdb19,1,2,1,3,1,2013-10-04 16:29:14,2013-10-04 16:29:14
060a5527947a4facdacfb15cbbfa18d75dbfdb19...09ffdcc9274e20b879710cdb5d1271a65e6c6470,5,13,13,26,9,2013-10-04 17:25:27,2013-09-26 22:06:20
09ffdcc9274e20b879710cdb5d1271a65e6c6470...ef582b64cb3013bed2165f3bc35f180e52710b66,3,16,16,32,7,2013-10-04 17:25:27,2013-09-30 17:33:08
ef582b64cb3013bed2165f3bc35f180e52710b66...a83a7fb0788ddb589a18216abfea06c6f264921b,1,1,1,2,1,2013-10-04 17:25:27,2013-10-02 15:16:08
a83a7fb0788ddb589a18216abfea06c6f264921b...886e2c6ff3f35c40ac6bd8dd3bd5e8d9159f63e6,1,1,1,2,1,2013-10-04 17:25:27,2013-10-02 16:45:01
886e2c6ff3f35c40ac6bd8dd3bd5e8d9159f63e6...c3a1079ef7518536e7ee0014f510b392d4daea4a,1,1,1,2,1,2013-10-04 17:25:27,2013-10-02 16:45:58
c3a1079ef7518536e7ee0014f510b392d4daea4a...fc780bfec97713119dd16c4996cd0c484de4ab71,3,11,14,25,11,2013-10-04 17:25:27,2013-10-02 21:34:41
fc780bfec97713119dd16c4996cd0c484de4ab71...37a7f2f07fddce4e413a56753473a7333da35432,1,2,2,4,2,2013-10-04 17:25:27,2013-10-02 15:22:59
37a7f2f07fddce4e413a56753473a7333da35432...06fe9abbfac09d4dec29501280b796965568a284,4,20,0,20,4,2013-10-04 19:52:11,2013-10-04 19:46:26
06fe9abbfac09d4dec29501280b796965568a284...cebbd10b9729b3cf889e918ee4dd1a4204eb5c26,1,4,0,4,1,2013-10-04 19:52:11,2013-10-04 19:46:58
cebbd10b9729b3cf889e918ee4dd1a4204eb5c26...6c68034f641f9f50e10ab68ac660242a53373ec1,2,117,154,271,17,2013-10-04 20:21:14,2013-10-04 20:21:14
6c68034f641f9f50e10ab68ac660242a53373ec1...b297497910d07493c84eab330d2ed4fcd9e34502,1,16,15,31,5,2013-10-04 20:42:09,2013-10-04 16:58:23
b297497910d07493c84eab330d2ed4fcd9e34502...8e2c2af3e3bb2129018d956fe19db897197a76a9,1,32,10,42,11,2013-10-04 20:46:31,2013-10-03 19:08:48
8e2c2af3e3bb2129018d956fe19db897197a76a9...2a3826d6e7fc67d3698e8115c6e27412db1778b7,14,2159,1161,3320,924,2013-10-04 20:58:27,2013-10-04 20:58:27
2a3826d6e7fc67d3698e8115c6e27412db1778b7...a2e95cdc71af9efe34b0d7cec138dcc16065a397,2,6,6,12,6,2013-10-04 20:58:54,2013-09-10 21:12:17
a2e95cdc71af9efe34b0d7cec138dcc16065a397...05dd65e6a7718ce80e3f452d88fe5105a10e9247,3,17,15,32,5,2013-10-04 20:58:54,2013-09-11 18:27:36
05dd65e6a7718ce80e3f452d88fe5105a10e9247...d61cdb37d5fcc83f649c912df2c590649935eac1,15,314,199,513,26,2013-10-04 20:58:54,2013-09-10 20:23:15
d61cdb37d5fcc83f649c912df2c590649935eac1...99372153dfe9dd9251e49371d872b5f27dfd6f2c,1,15,10,25,11,2013-10-04 20:58:54,2013-10-03 14:20:22
99372153dfe9dd9251e49371d872b5f27dfd6f2c...6fc951d492881a32754bc3e38e8b5eca78929197,152,2667,2103,4770,587,2013-10-04 20:58:54,2013-09-18 18:02:36
6fc951d492881a32754bc3e38e8b5eca78929197...e4a5720eed6d08d3207e02f5bfe0ceb40f5f6b8d,32,2455,1332,3787,348,2013-10-04 20:58:55,2013-09-11 19:41:18
e4a5720eed6d08d3207e02f5bfe0ceb40f5f6b8d...fb23a35f33bdc1931185abd4c06ef48783555191,6,429,310,739,43,2013-10-04 20:58:55,2013-09-09 20:15:29
fb23a35f33bdc1931185abd4c06ef48783555191...46bfd183986454ef9ccf5f333cb38be4ce4b1255,5,358,242,600,30,2013-10-04 20:58:55,2013-09-01 17:47:06
46bfd183986454ef9ccf5f333cb38be4ce4b1255...e0f70cdb67a36c831a23b452e7b9fba41f512ae0,6,457,1105,1562,79,2013-10-04 21:17:49,2013-10-03 21:26:47
e0f70cdb67a36c831a23b452e7b9fba41f512ae0...d09e608691aae000f3176b27cc67a7900229cd1e,8,822,205,1027,60,2013-10-04 21:17:51,2013-09-30 22:40:39
d09e608691aae000f3176b27cc67a7900229cd1e...ab167c642f49206b4328882286cd5b83c19088bd,54,1650,507,2157,256,2013-10-05 03:27:44,2013-10-02 02:43:48
ab167c642f49206b4328882286cd5b83c19088bd...0a3c952a2490e9e995d3773d89e085db6d042d2a,2,7,7,14,7,2013-10-05 13:29:58,2013-10-05 13:29:58
0a3c952a2490e9e995d3773d89e085db6d042d2a...2ecb17f186ba8bde7dd22c409b1c93be6ba08a79,1,1,1,2,1,2013-10-05 15:11:38,2013-10-05 15:11:38
2ecb17f186ba8bde7dd22c409b1c93be6ba08a79...c09abfd19ee0787f505e17d1c50c24ec049e88f5,2,14,0,14,3,2013-10-05 18:01:04,2013-10-05 16:12:20
c09abfd19ee0787f505e17d1c50c24ec049e88f5...ae56a7275c630dff4c8afa5805356953d8901c4d,3,69,7,76,14,2013-10-05 18:02:46,2013-10-05 16:14:36
ae56a7275c630dff4c8afa5805356953d8901c4d...4a075b087bb93598413bd99cc6cba75c313e1bef,1,1,0,1,1,2013-10-05 20:09:56,2013-10-05 02:00:59
4a075b087bb93598413bd99cc6cba75c313e1bef...07c18d3c1147bd11ea50902542432a178f4f685f,2,26,42,68,5,2013-10-05 21:39:16,2013-10-05 16:34:42
07c18d3c1147bd11ea50902542432a178f4f685f...ee34eb5c05c5b8072dc1354845ed34989596456b,2,33,3,36,6,2013-10-05 21:39:16,2013-10-05 16:36:03
ee34eb5c05c5b8072dc1354845ed34989596456b...2fd675487ee609e35067021376b18d0ce01da086,2,39,24,63,10,2013-10-05 21:39:16,2013-10-05 16:59:28
2fd675487ee609e35067021376b18d0ce01da086...54d8fdb24becdeed847567624475a96c7128fee0,24,1447,576,2023,246,2013-10-05 21:39:17,2013-10-05 17:02:04
54d8fdb24becdeed847567624475a96c7128fee0...1f5a1ba9f0b73bd1594959bacc03e4fbc1feccaf,1,8,1,9,1,2013-10-06 00:27:09,2013-10-06 00:24:39
1f5a1ba9f0b73bd1594959bacc03e4fbc1feccaf...8aaf9fa86aeaeeeede230d8d80a20b22c97745ac,1,7,2,9,1,2013-10-06 00:54:59,2013-10-06 00:54:59
8aaf9fa86aeaeeeede230d8d80a20b22c97745ac...31d759f0fc3ac453b5297df2012fce9c1118ce6f,1,7,2,9,1,2013-10-06 15:04:03,2013-10-06 15:04:03
31d759f0fc3ac453b5297df2012fce9c1118ce6f...3e5905a8d427539d62d56e4bb72ae55638544a99,15,128,117,245,106,2013-10-06 16:02:45,2013-10-05 22:08:33
3e5905a8d427539d62d56e4bb72ae55638544a99...1fde4728583e1ca5f6432b2ba517a90e7b1d8e17,19,100,94,194,66,2013-10-06 16:02:45,2013-10-05 22:23:47
1fde4728583e1ca5f6432b2ba517a90e7b1d8e17...11be81456ec4c24aa19cdf475fe9e7e79abe2066,3,37,31,68,6,2013-10-06 17:56:53,2013-10-05 22:38:57
11be81456ec4c24aa19cdf475fe9e7e79abe2066...6e59b0de50d518bba9addb89b80c9160e438a3b2,6,366,322,688,22,2013-10-06 18:07:09,2013-10-05 23:42:01
6e59b0de50d518bba9addb89b80c9160e438a3b2...480e8e81f5d4a12134d55bfb8c91c0f33ff07741,1,5,4,9,5,2013-10-06 18:11:29,2013-10-05 23:51:09
480e8e81f5d4a12134d55bfb8c91c0f33ff07741...4f481600f817f5d3c6d2c1cee74e3c133c453681,1,1,5,6,2,2013-10-06 20:25:08,2013-10-05 23:46:39
4f481600f817f5d3c6d2c1cee74e3c133c453681...3a122656855ca33ee3ee84744b6d413ed30ade04,16,60,54,114,36,2013-10-06 20:25:25,2013-10-06 17:47:22
3a122656855ca33ee3ee84744b6d413ed30ade04...4de73d9215a0a72424d65b6dac0d0d295ee88e35,5,95,7,102,13,2013-10-06 20:25:31,2013-10-06 19:29:07
4de73d9215a0a72424d65b6dac0d0d295ee88e35...ee7ea7ea7f8eb423cd2ee8ec928f2b50e014ac52,14,270,136,406,50,2013-10-06 21:19:23,2013-10-06 18:49:49
ee7ea7ea7f8eb423cd2ee8ec928f2b50e014ac52...dbc0880c91a773a45046e14fba14dd1586c16b9a,3,420,5,425,7,2013-10-06 22:04:32,2013-10-02 20:20:51
dbc0880c91a773a45046e14fba14dd1586c16b9a...678a83d64dcf14d5214c6bbc4c8477d8f9fd70db,1,1,1,2,1,2013-10-06 23:20:50,2013-10-06 23:20:50
678a83d64dcf14d5214c6bbc4c8477d8f9fd70db...0b40bfbd29511acf9f075df34c048b1b98cf0094,2,10,1,11,2,2013-10-07 01:50:02,2013-10-07 01:50:02
0b40bfbd29511acf9f075df34c048b1b98cf0094...ac2bd108337a6de9765ac396c6e5911ca5bdff7d,2,29,8,37,7,2013-10-07 12:47:51,2013-10-05 18:15:03
ac2bd108337a6de9765ac396c6e5911ca5bdff7d...1875c6f9b4347a528f0ec8004e8a6ad6484ac124,14,62,48,110,15,2013-10-07 14:41:26,2013-10-06 23:52:19
1875c6f9b4347a528f0ec8004e8a6ad6484ac124...69079a7fd2144b71153a77934947b62794b6d824,1,7,0,7,2,2013-10-07 16:35:48,2013-10-02 13:05:53
69079a7fd2144b71153a77934947b62794b6d824...b7660950c4888052f2c68a02f6667c114a72dfbd,1,27,27,54,6,2013-10-07 16:35:48,2013-10-02 13:09:20
b7660950c4888052f2c68a02f6667c114a72dfbd...a5c4104bb28f2870602a8c7a5e4a4b506dbc99a1,26,980,495,1475,201,2013-10-07 19:07:16,2013-10-05 17:04:39
a5c4104bb28f2870602a8c7a5e4a4b506dbc99a1...ca8b122cd49c049a6a8aa220b91a2f49687c69fb,1,1,1,2,1,2013-10-07 20:09:09,2013-10-07 20:09:09
ca8b122cd49c049a6a8aa220b91a2f49687c69fb...58eb7b1300d8e8a623a62592f510763a3eae1b0c,15,1973,45,2018,43,2013-10-07 20:10:53,2013-10-03 17:15:09
58eb7b1300d8e8a623a62592f510763a3eae1b0c...50c817d7dbfcb0764e921248d510a62b1b39330e,1,1,1,2,1,2013-10-07 20:21:02,2013-10-07 20:20:54
50c817d7dbfcb0764e921248d510a62b1b39330e...9cbdc4fa38c14a27213189d137fd6a3f3e2d3c63,11,237,160,397,62,2013-10-07 20:51:46,2013-10-07 20:51:46
9cbdc4fa38c14a27213189d137fd6a3f3e2d3c63...9501c1bfce47079de54e0aba7b78bae341e3e916,1,6,5,11,2,2013-10-07 21:16:09,2013-10-07 17:12:40
9501c1bfce47079de54e0aba7b78bae341e3e916...af5bab59517363df5c9bfe307525676073677756,2,27,15,42,4,2013-10-07 21:16:09,2013-10-07 18:22:09
af5bab59517363df5c9bfe307525676073677756...df04b01b1b6aa2ef56406f4a53ead3b9fe472f43,5,36,5,41,6,2013-10-07 21:54:46,2013-10-05 18:10:24
df04b01b1b6aa2ef56406f4a53ead3b9fe472f43...fb65792d774388ce9a4fdf7c4b2cc45d08dc0ee8,7,31,12,43,17,2013-10-07 22:06:10,2013-10-07 18:03:01
fb65792d774388ce9a4fdf7c4b2cc45d08dc0ee8...cbe5d8c77986e940f3bb5fccf7c63732b9b0e907,11,160,237,397,62,2013-10-07 22:33:12,2013-10-07 22:33:12
cbe5d8c77986e940f3bb5fccf7c63732b9b0e907...d119fc2d92ce0ffb4e42a117872ec8e3b6dff15a,5,107,8,115,8,2013-10-07 22:41:00,2013-10-02 18:54:00
d119fc2d92ce0ffb4e42a117872ec8e3b6dff15a...eb09362ff4996de88dab11b782d2e52413405495,1,13,0,13,1,2013-10-07 22:41:00,2013-10-03 20:06:43
eb09362ff4996de88dab11b782d2e52413405495...603a1fae2efcffa7e4185731408a5454821bc3e3,11,237,160,397,62,2013-10-07 23:19:21,2013-10-07 23:19:21
603a1fae2efcffa7e4185731408a5454821bc3e3...6652508fdeef334595aa7d059caf73c0586830b7,1,3,3,6,1,2013-10-07 23:26:28,2013-10-07 23:26:28
6652508fdeef334595aa7d059caf73c0586830b7...2603ba8d2ae338e18635621dc0965965f0f9c5cb,1,5,1,6,1,2013-10-07 23:26:40,2013-10-07 23:26:40
2603ba8d2ae338e18635621dc0965965f0f9c5cb...7866bc2dafb20fb1bb2b8fcd36738b92d733c5ea,10,34,34,68,34,2013-10-07 23:27:34,2013-10-07 21:18:00
7866bc2dafb20fb1bb2b8fcd36738b92d733c5ea...321ea9901307df9d8de9d8edcc164c807dcb84c6,3,23,2,25,8,2013-10-08 04:28:09,2013-10-08 04:28:09
321ea9901307df9d8de9d8edcc164c807dcb84c6...95566879c8fc1ea4ed61917d14367858167e15d2,3,4,7,11,4,2013-10-08 12:34:25,2013-10-08 12:34:25
95566879c8fc1ea4ed61917d14367858167e15d2...4b5cfc190c702aad25a353d8b3e275f71599b05f,18,345,122,467,111,2013-10-08 14:05:53,2013-10-07 19:23:43
4b5cfc190c702aad25a353d8b3e275f71599b05f...45daf873a213859c3ea01b37eb29a1c17bb77cee,1,9,8,17,4,2013-10-08 14:05:53,2013-10-07 22:01:33
45daf873a213859c3ea01b37eb29a1c17bb77cee...490f50a98649400e24566bb59b31f61c28ea5df7,1,2,2,4,1,2013-10-08 14:06:49,2013-10-08 13:31:20
490f50a98649400e24566bb59b31f61c28ea5df7...6069172335a0750b2477e3e2c31232ef9e9769f4,1,2,2,4,1,2013-10-08 14:19:19,2013-10-08 13:44:53
6069172335a0750b2477e3e2c31232ef9e9769f4...2b4444c09fdf46adfda8e34116a7a8cae12dd18a,17,94,82,176,37,2013-10-08 17:47:11,2013-10-08 17:47:00
2b4444c09fdf46adfda8e34116a7a8cae12dd18a...97dbb580840a23470304d728bcc5887f3c86fd88,3,2,27,29,4,2013-10-08 17:58:23,2013-10-08 17:58:23
97dbb580840a23470304d728bcc5887f3c86fd88...d1677de5267ca8a289eb6f53297978fa36fbed58,2,49,40,89,8,2013-10-08 18:08:38,2013-10-08 13:56:05
d1677de5267ca8a289eb6f53297978fa36fbed58...c70a72b151fcfab26d0db5e8ceeb7c04a96ce449,3,27,12,39,3,2013-10-08 18:09:38,2013-10-07 23:10:19
c70a72b151fcfab26d0db5e8ceeb7c04a96ce449...dd6872edef9ce246dbdb7be5dacf116a61154dac,1,1,1,2,1,2013-10-08 20:07:19,2013-10-08 18:53:21
dd6872edef9ce246dbdb7be5dacf116a61154dac...d685bf21a23a0e2b4ae5dfcf83662d86319ef42a,1,2,2,4,2,2013-10-08 20:27:04,2013-10-08 19:33:14
d685bf21a23a0e2b4ae5dfcf83662d86319ef42a...035779805c6348a66d32bd555ff63fa3933678c8,1,2,3,5,2,2013-10-08 20:34:46,2013-10-08 20:34:06
035779805c6348a66d32bd555ff63fa3933678c8...39fc9f48e81816af09de7f86c24934836c8b8dd5,11,552,282,834,155,2013-10-08 20:44:49,2013-10-07 23:15:36
39fc9f48e81816af09de7f86c24934836c8b8dd5...e04fad14208c0ade3cbaf4aa301366d340b81261,4,73,17,90,15,2013-10-08 20:44:49,2013-10-08 20:37:47
e04fad14208c0ade3cbaf4aa301366d340b81261...061a086641a2638d73884ad573eaea2a3ab8459f,59,175,211,386,127,2013-10-08 21:35:02,2013-10-08 17:29:04
061a086641a2638d73884ad573eaea2a3ab8459f...62d754f99182f2f59b34eb5024848204a4de62dd,1,3,0,3,1,2013-10-08 21:35:05,2013-10-08 19:40:13
62d754f99182f2f59b34eb5024848204a4de62dd...4f3813fc249ce9295f8ec682476bb8336d2cd76c,3,0,621,621,18,2013-10-08 21:35:05,2013-10-08 19:49:26
4f3813fc249ce9295f8ec682476bb8336d2cd76c...340c96304d46b9020869e1fe907ae12cafa787ea,2,0,50,50,7,2013-10-08 21:35:06,2013-10-08 20:02:11
340c96304d46b9020869e1fe907ae12cafa787ea...bfb9dee8600606525f850273ac9a5e8d8c7d67c8,4,49,90,139,9,2013-10-08 22:11:05,2013-10-08 19:01:31
bfb9dee8600606525f850273ac9a5e8d8c7d67c8...631d4312066b143eeec36d7ff2a91448ac53065b,1,9,1,10,1,2013-10-08 22:27:50,2013-10-08 22:13:22
631d4312066b143eeec36d7ff2a91448ac53065b...010673cad390054b3f31cfcd593bdf38e6cbf438,1,7,2,9,2,2013-10-09 04:16:56,2013-10-09 04:16:56
010673cad390054b3f31cfcd593bdf38e6cbf438...606b6ee6cab9809a0124d13b5a7aebcddad027cc,1,16,14,30,2,2013-10-09 04:23:43,2013-10-09 04:23:43
606b6ee6cab9809a0124d13b5a7aebcddad027cc...8e0d464a453fcaf6ebb6c1916542d642220e1da5,1,20,0,20,1,2013-10-10 17:33:30,2013-10-10 14:32:49
606b6ee6cab9809a0124d13b5a7aebcddad027cc...fc67141dcb245aaaa47321c863c8d26aef6bb5ee,2,235,2,237,2,2013-10-09 14:06:37,2013-10-08 16:04:58
fc67141dcb245aaaa47321c863c8d26aef6bb5ee...f8a42a561a37d683234a383ccdae5721030560e1,26,503,387,890,136,2013-10-09 14:06:37,2013-10-07 16:13:02
f8a42a561a37d683234a383ccdae5721030560e1...f112796ee44768ff9a4d694600724203adf84bd1,2,31,8,39,6,2013-10-09 14:15:16,2013-10-08 23:22:02
f112796ee44768ff9a4d694600724203adf84bd1...627744b1cdac2dc2103ee69ae65f94212ccd97b3,1,5,0,5,1,2013-10-09 15:02:54,2013-10-08 21:03:07
627744b1cdac2dc2103ee69ae65f94212ccd97b3...aef4db124df3be35e544fbd4c39705a67f673646,4,38,14,52,8,2013-10-09 15:02:54,2013-10-08 21:19:51
aef4db124df3be35e544fbd4c39705a67f673646...b467c670b3020f650c367a9e943c6281a475d89f,1,7,0,7,1,2013-10-09 15:02:54,2013-10-08 21:31:46
b467c670b3020f650c367a9e943c6281a475d89f...3aa47f21fa5d0370cd7a0ef277e7d1d8d359edbb,1,3,2,5,2,2013-10-09 15:02:54,2013-10-08 22:26:45
3aa47f21fa5d0370cd7a0ef277e7d1d8d359edbb...3c831f3014fe9502a1ec78afce0448757bf7d7f7,2,67,7,74,14,2013-10-09 15:02:54,2013-10-08 23:28:44
3c831f3014fe9502a1ec78afce0448757bf7d7f7...655e78b8742ddaa860b8fb1cee4edc4368ac09ca,2,75,1,76,3,2013-10-09 15:02:54,2013-10-09 00:55:44
655e78b8742ddaa860b8fb1cee4edc4368ac09ca...1da79b6df6a930139cddba33229d969f2c286180,9,0,0,0,0,2013-10-09 15:02:54,2013-10-09 01:03:28
1da79b6df6a930139cddba33229d969f2c286180...0f7940d5395f0af129337de2f53f0e23fcec50f2,4,98,55,153,15,2013-10-09 15:02:54,2013-10-09 13:32:58
0f7940d5395f0af129337de2f53f0e23fcec50f2...24031eede8fbc6cf75a1854f7a1427d05da8746f,3,9,2,11,7,2013-10-09 15:02:54,2013-10-09 15:02:50
24031eede8fbc6cf75a1854f7a1427d05da8746f...9ebc833bd9966a83b4dc4f83a0e4c2de422e1846,2,1,2,3,2,2013-10-09 15:22:17,2013-10-09 15:22:17
9ebc833bd9966a83b4dc4f83a0e4c2de422e1846...42b1dfce39fc77156a6bbad531893d6deee6e049,2,257,0,257,4,2013-10-09 15:31:23,2013-10-08 21:36:37
42b1dfce39fc77156a6bbad531893d6deee6e049...d29d8008c20143e52ed11890d8728ed19e4f56eb,2,11,0,11,2,2013-10-09 15:58:21,2013-10-09 15:40:24
d29d8008c20143e52ed11890d8728ed19e4f56eb...c4c2ae9662f84912b6f1d7e54b929c4609c5b2dc,1,1,1,2,1,2013-10-09 16:10:07,2013-10-09 16:06:02
c4c2ae9662f84912b6f1d7e54b929c4609c5b2dc...18730d0b894b1e6c4494041b4936a742842e87d1,1,1,1,2,1,2013-10-09 16:17:38,2013-10-09 16:17:38
18730d0b894b1e6c4494041b4936a742842e87d1...31e6059e96f47ba651b1ad06ff08f8a44f3c913c,1,10,8,18,9,2013-10-09 16:52:12,2013-10-09 15:33:15
31e6059e96f47ba651b1ad06ff08f8a44f3c913c...184224c7c18acb2111b96aaef16da9d76833a774,2,96,1,97,10,2013-10-09 17:21:37,2013-09-16 18:12:08
184224c7c18acb2111b96aaef16da9d76833a774...d66535982976960ada4d2a05db213e40d08740ab,1,1,1,2,1,2013-10-09 17:39:53,2013-10-09 17:39:53
d66535982976960ada4d2a05db213e40d08740ab...7ada7a8e110f5dc2c22a49aa7cea175bb9704a81,14,508,403,911,16,2013-10-09 17:59:08,2013-10-07 13:14:18
7ada7a8e110f5dc2c22a49aa7cea175bb9704a81...aef38b7e2ce7c78716f1ed3ab0f7252e4664cfe2,17,119,45,164,38,2013-10-09 18:24:29,2013-10-08 01:22:46
aef38b7e2ce7c78716f1ed3ab0f7252e4664cfe2...18a4798fcd3fb4b9da0f5dc1613e6e99a1ea4bcc,1,123,0,123,1,2013-10-09 19:01:04,2013-10-06 21:11:50
18a4798fcd3fb4b9da0f5dc1613e6e99a1ea4bcc...1da10e829ebcc03eee3fe834bc91ee17b11b329e,3,235,11,246,10,2013-10-09 19:01:04,2013-10-06 22:30:15
1da10e829ebcc03eee3fe834bc91ee17b11b329e...1cf9e0b71ee1b9108c57a626d40582d843e47026,4,9,252,261,13,2013-10-09 19:04:32,2013-10-08 20:42:13
1cf9e0b71ee1b9108c57a626d40582d843e47026...aa69818996e5a61ac09bf3527b9a32c3ed67b19f,1,1,1,2,1,2013-10-09 20:16:51,2013-10-09 20:16:51
aa69818996e5a61ac09bf3527b9a32c3ed67b19f...91480e08d9a6dd41ad6118ee0bf5461a99cbdbc3,6,73,0,73,25,2013-10-09 21:21:10,2013-10-08 21:36:58
91480e08d9a6dd41ad6118ee0bf5461a99cbdbc3...15ec6531ea275dd651487df198e24be1ae248315,2,104,80,184,79,2013-10-09 21:53:02,2013-10-09 17:34:10
15ec6531ea275dd651487df198e24be1ae248315...b4e1f62aed6b166a89f04e6bb7636f8a5f0a1ba6,6,1,187,188,10,2013-10-10 00:30:02,2013-10-09 21:54:07
b4e1f62aed6b166a89f04e6bb7636f8a5f0a1ba6...9630c5a8595ee00fa1902db0b181a8a4beb4dc8a,6,0,73,73,25,2013-10-10 00:35:44,2013-10-10 00:32:48
9630c5a8595ee00fa1902db0b181a8a4beb4dc8a...90e3298d7fce0cfc37f4dba8c0d69ab5ec593f51,12,426,125,551,53,2013-10-10 01:36:27,2013-10-10 00:32:51
90e3298d7fce0cfc37f4dba8c0d69ab5ec593f51...b49b13c48e0450398642d240b4dbbd259c399dc1,2,241,6,247,6,2013-10-10 02:27:19,2013-10-10 02:27:19
b49b13c48e0450398642d240b4dbbd259c399dc1...34f6c8e7db271ae320b0ae384b1d2f67cafb8e16,3,25,37,62,8,2013-10-10 12:59:46,2013-10-09 15:47:44
34f6c8e7db271ae320b0ae384b1d2f67cafb8e16...5bdf45f7e8d5c8b5645d8a20b4a94a331801d8df,1,15,4,19,1,2013-10-10 14:09:56,2013-10-09 19:30:25
5bdf45f7e8d5c8b5645d8a20b4a94a331801d8df...668cf5bd574eb3832d8735a48f411b7eb159ada5,3,60,51,111,13,2013-10-10 14:47:15,2013-10-10 14:47:15
668cf5bd574eb3832d8735a48f411b7eb159ada5...13f3b5dd4b0f9a2defd0c8a1aec78a6fb44228b6,2,1,61,62,2,2013-10-10 14:56:13,2013-10-09 16:08:53
13f3b5dd4b0f9a2defd0c8a1aec78a6fb44228b6...3a24d28e23f8ef86ae5b592ea103420c8868f58b,1,13,0,13,1,2013-10-10 14:56:13,2013-10-09 16:51:48
3a24d28e23f8ef86ae5b592ea103420c8868f58b...c88e13fbe4afc8bb1089c20fbe3fc2031a2f5da4,6,33,13,46,11,2013-10-10 14:56:13,2013-10-09 17:19:29
c88e13fbe4afc8bb1089c20fbe3fc2031a2f5da4...3ef2c5215d98df154d6aa01da16c3dc5c6f4007a,3,64,27,91,7,2013-10-10 14:56:13,2013-10-09 19:54:41
3ef2c5215d98df154d6aa01da16c3dc5c6f4007a...c8bed4944dac6bf3f08831773d26068413b1388a,10,179,76,255,61,2013-10-10 14:56:13,2013-10-10 01:50:27
c8bed4944dac6bf3f08831773d26068413b1388a...bbf4667c8c437d6db93b9c3ec711e40d49349b45,6,286,42,328,13,2013-10-10 15:50:11,2013-10-08 19:53:19
bbf4667c8c437d6db93b9c3ec711e40d49349b45...586c2dea5a72bfc2917af91d0751fcd399c0209b,9,593,138,731,43,2013-10-10 15:52:06,2013-10-08 20:26:48
586c2dea5a72bfc2917af91d0751fcd399c0209b...3f3bf961cb9676235f5d24989bbf8b30fb125563,2,69,37,106,16,2013-10-10 15:52:06,2013-10-09 23:12:21
3f3bf961cb9676235f5d24989bbf8b30fb125563...8093bb525d453cf880a3525c78f87178b493128c,13,119,135,254,108,2013-10-10 15:52:06,2013-10-10 00:05:09
8093bb525d453cf880a3525c78f87178b493128c...b2ee3b565e5f721e671db1480396de39dcaa9d97,1,1,0,1,1,2013-10-10 17:33:24,2013-10-10 17:33:13
ac290ee9b4edeca71c5d6575b851146e00ecd645...dbae94b4a6a83ad32817038259f1d2d6ac5314f1,1,30,0,30,14,2013-10-10 17:54:03,2013-09-27 21:37:04
dbae94b4a6a83ad32817038259f1d2d6ac5314f1...3b33315ab3dedf8314eb3da126dd0fc56555deb9,6,116,24,140,11,2013-10-10 18:52:36,2013-10-09 17:46:43
3b33315ab3dedf8314eb3da126dd0fc56555deb9...f86275a74e9470a2715fe0b654ac7ee1d7f772a4,1,1,3,4,3,2013-10-10 18:52:44,2013-10-10 15:48:04
f86275a74e9470a2715fe0b654ac7ee1d7f772a4...cda26fb2e200406154b943a9baebb2de47afe64b,1,3,3,6,2,2013-10-10 19:24:14,2013-10-10 19:06:27
cda26fb2e200406154b943a9baebb2de47afe64b...bf312205b5e5c9f6bdf1d0968c3fe601430f8a38,1,1,0,1,1,2013-10-10 19:25:19,2013-10-10 19:23:30
bf312205b5e5c9f6bdf1d0968c3fe601430f8a38...84e1053cc47db7fe49692e3d9adb295da035511d,2,74,0,74,3,2013-10-10 19:40:45,2013-10-09 00:30:55
84e1053cc47db7fe49692e3d9adb295da035511d...dc2c5c5b81e96d19b466d21cba3da03549a1994b,1,12,20,32,13,2013-10-10 20:19:59,2013-10-10 14:27:28
dc2c5c5b81e96d19b466d21cba3da03549a1994b...dd4b720028801ca6dfc8ee9e7051e6557d569c41,2,40,1,41,2,2013-10-10 21:34:15,2013-10-10 19:54:40
dd4b720028801ca6dfc8ee9e7051e6557d569c41...1ecabbf312ca97c1c64e0faa315ee3c860ad2b26,2,34,6,40,8,2013-10-10 21:36:06,2013-10-09 19:47:09
1ecabbf312ca97c1c64e0faa315ee3c860ad2b26...59fbb0a9cb15096c3ebd5ad6b9f6e337d0b73dfe,1,9,2,11,3,2013-10-10 21:59:01,2013-10-10 21:42:28
59fbb0a9cb15096c3ebd5ad6b9f6e337d0b73dfe...82cf5fea18b566a00bd9d29c1ff6a983bb301e6b,3,48,0,48,3,2013-10-10 22:03:50,2013-10-10 21:26:59
82cf5fea18b566a00bd9d29c1ff6a983bb301e6b...3c469372db7db7a3ce13c59a85a619108b6adec1,3,8,8,16,6,2013-10-10 22:14:53,2013-10-10 21:53:29
3c469372db7db7a3ce13c59a85a619108b6adec1...a02bfe597b6d703741b96f1a8fcbe1279b946c58,1,5,1,6,1,2013-10-10 22:25:08,2013-10-09 23:00:24
a02bfe597b6d703741b96f1a8fcbe1279b946c58...c5b32e97207bf0edbdf3567eedc9082cdb96b4fb,1,5,1,6,2,2013-10-10 22:30:27,2013-10-09 17:04:59
c5b32e97207bf0edbdf3567eedc9082cdb96b4fb...0b67abbe480f84832798bdcbea34a514bf07c880,1,7,0,7,1,2013-10-10 22:39:25,2013-10-10 19:52:17
0b67abbe480f84832798bdcbea34a514bf07c880...5437f86664faaa75b36edf1c0d6e1277034aedf3,1,2,2,4,1,2013-10-10 22:39:25,2013-10-10 20:47:00
5437f86664faaa75b36edf1c0d6e1277034aedf3...5784cd972939a8bc54e7a2b8492e5edf94c03514,2,6,1,7,2,2013-10-10 22:39:25,2013-10-10 20:47:43
5784cd972939a8bc54e7a2b8492e5edf94c03514...9a37b9f48505fb49604c6d9b99f448a18d524969,1,0,5,5,1,2013-10-10 22:39:25,2013-10-10 21:03:42
9a37b9f48505fb49604c6d9b99f448a18d524969...49901a5d8ac97a41d72c4f89fd5ba2fb5a8789b8,4,118,1,119,5,2013-10-10 22:55:55,2013-10-10 20:56:10
49901a5d8ac97a41d72c4f89fd5ba2fb5a8789b8...c7cc79f0cae037bd1d94ed2693dd9bc345c5433d,4,79,52,131,24,2013-10-10 23:17:23,2013-10-10 22:27:06
c7cc79f0cae037bd1d94ed2693dd9bc345c5433d...5cdcedd9902edb97985a21df3b4e6f8a2cd483cf,21,457,276,733,105,2013-10-10 23:17:23,2013-10-10 22:27:49
5cdcedd9902edb97985a21df3b4e6f8a2cd483cf...a0f00754f2b5292e221cf25ec7024864a34bf294,1,0,39,39,1,2013-10-10 23:17:23,2013-10-10 23:17:15
a0f00754f2b5292e221cf25ec7024864a34bf294...b5121aef9a69e4f9bef2e71457e6840b0f97576a,1,0,2,2,1,2013-10-10 23:29:19,2013-10-10 23:29:15
b5121aef9a69e4f9bef2e71457e6840b0f97576a...c1ab952e098b24f691f2fd5e6bf162a972b9c5f9,1,5,5,10,1,2013-10-10 23:30:12,2013-10-10 23:28:05
c1ab952e098b24f691f2fd5e6bf162a972b9c5f9...80c79f8464d26ca128b2455a8e02c9882f8c4640,9,110,34,144,32,2013-10-11 01:51:57,2013-10-08 16:06:00
80c79f8464d26ca128b2455a8e02c9882f8c4640...410a9ee2999b1f5ae2bb4d8585f157915adcc7ed,2,2,2,4,2,2013-10-11 02:52:49,2013-10-11 02:52:49
410a9ee2999b1f5ae2bb4d8585f157915adcc7ed...b2bda16ef3c0ad75b0ee63bac65842d4de513470,4,235,8,243,15,2013-10-11 13:08:42,2013-10-11 13:08:42
b2bda16ef3c0ad75b0ee63bac65842d4de513470...cc3c80cb841f35f2ef315d6db0eba9e9c3ddc46c,1,2,2,4,2,2013-10-11 13:34:03,2013-10-11 13:34:03
cc3c80cb841f35f2ef315d6db0eba9e9c3ddc46c...7c0051361a68b4ce53e9ad1bdf02e2013ede4cbc,1,2,1,3,1,2013-10-11 14:11:48,2013-10-11 03:05:16
7c0051361a68b4ce53e9ad1bdf02e2013ede4cbc...a5864af36ea85273965b6edd3322eb590a611763,1,1,1,2,1,2013-10-11 14:15:58,2013-10-11 14:15:58
a5864af36ea85273965b6edd3322eb590a611763...200ca4c480ae7fa4fd713b8aea33a246d11bfa21,1,1,1,2,1,2013-10-11 14:16:52,2013-10-11 14:16:18
200ca4c480ae7fa4fd713b8aea33a246d11bfa21...cb5f37d727bcdff4ff8b67b302ebdadd2fb75d15,1,2,2,4,2,2013-10-11 14:49:17,2013-10-11 14:49:17
cb5f37d727bcdff4ff8b67b302ebdadd2fb75d15...4e50e1e592e2109b7bf1a0fd6002cb0285916d0b,3,145,49,194,28,2013-10-11 14:52:29,2013-10-07 20:50:21
4e50e1e592e2109b7bf1a0fd6002cb0285916d0b...0e179669313b05bd3709343e301f657b00d33872,1,3,3,6,3,2013-10-11 14:54:00,2013-10-11 14:54:00
0e179669313b05bd3709343e301f657b00d33872...c614cd4ebebb8b45cddd9116cbc19e3ff1bab1e5,5,404,20,424,19,2013-10-11 15:25:13,2013-10-11 02:48:27
c614cd4ebebb8b45cddd9116cbc19e3ff1bab1e5...6c50d750e168eebf68b9b79d6ab9306cc3ad6aa7,1,6,3,9,1,2013-10-11 15:33:07,2013-10-11 15:33:07
6c50d750e168eebf68b9b79d6ab9306cc3ad6aa7...a37211ef485bdf4e53b1b8beb2c7e66f07a514ff,1,15,6,21,6,2013-10-11 15:42:01,2013-08-29 21:53:52
a37211ef485bdf4e53b1b8beb2c7e66f07a514ff...3c21f4ae6c925b08de57f4d850c8d5ca0341e4c2,1,1,1,2,1,2013-10-11 15:42:55,2013-10-11 15:42:55
3c21f4ae6c925b08de57f4d850c8d5ca0341e4c2...0397775a52a814135225e6e8407455ba86dc117d,3,18,37,55,13,2013-10-11 15:59:27,2013-10-11 00:13:57
0397775a52a814135225e6e8407455ba86dc117d...caa7f77beba714d23ec3722e387f2e64e6a47642,3,15,6,21,7,2013-10-11 16:20:43,2013-10-09 19:30:09
caa7f77beba714d23ec3722e387f2e64e6a47642...f3e324f10697bd4f0c9bdebced4a1e69d91cdd89,23,408,369,777,110,2013-10-11 16:20:43,2013-10-11 14:49:52
f3e324f10697bd4f0c9bdebced4a1e69d91cdd89...bfead9163f1cd1ca06d7c358a93fedbe48e9f512,11,524,36,560,56,2013-10-11 16:34:47,2013-10-11 14:11:08
bfead9163f1cd1ca06d7c358a93fedbe48e9f512...e76e27acacd2e2665e741be3cb58b4071f6616a4,1,20,7,27,4,2013-10-11 16:54:08,2013-10-11 16:46:33
e76e27acacd2e2665e741be3cb58b4071f6616a4...257292ade0ce14ca4785ca9889b0579be8a3e36b,19,94,107,201,80,2013-10-11 17:00:53,2013-09-30 22:53:53
257292ade0ce14ca4785ca9889b0579be8a3e36b...b7d3dccc728ba17c89d30cc134f48326ba68098f,4,417,0,417,8,2013-10-11 17:17:19,2013-10-01 22:29:13
b7d3dccc728ba17c89d30cc134f48326ba68098f...5b592cc3439b3315a14938c738fc10caca0ee06e,1,1,0,1,1,2013-10-11 17:22:16,2013-10-11 17:22:03
5b592cc3439b3315a14938c738fc10caca0ee06e...bb7ba88009afc1691a9b954687cb0a18091f54f2,1,0,150,150,1,2013-10-11 17:29:58,2013-10-11 17:29:58
bb7ba88009afc1691a9b954687cb0a18091f54f2...332e4f1a23b182a278b7a5ee8d458d184b266ac6,4,13,12,25,5,2013-10-11 17:36:35,2013-10-09 21:26:53
332e4f1a23b182a278b7a5ee8d458d184b266ac6...583e3000de9525d6ea47b81c4e98845f64f45c2a,2,3,2,5,2,2013-10-11 17:47:42,2013-10-11 17:47:29
583e3000de9525d6ea47b81c4e98845f64f45c2a...1016dea64ab9a2c26e1da9c71991f9234d3806ec,1,1,1,2,1,2013-10-11 18:03:59,2013-10-09 18:12:45
1016dea64ab9a2c26e1da9c71991f9234d3806ec...0ffa31cb9e1fdd281710aa872cac27c5ef8e3145,3,37,1,38,5,2013-10-11 18:05:41,2013-10-10 23:01:04
0ffa31cb9e1fdd281710aa872cac27c5ef8e3145...3293653f6d6f8d3bcd9e1ae11107923dd056d35e,4,10,8,18,10,2013-10-11 18:38:43,2013-10-08 21:36:37
3293653f6d6f8d3bcd9e1ae11107923dd056d35e...cbd990534291bd55d5e7ac6508ae0ae499c2a719,6,61,0,61,20,2013-10-11 18:38:58,2013-10-08 21:36:58
cbd990534291bd55d5e7ac6508ae0ae499c2a719...843df1203958c4fd55c2078ff11098697084bf98,4,19,0,19,10,2013-10-11 18:52:48,2013-10-11 18:51:27
843df1203958c4fd55c2078ff11098697084bf98...ef132b3aa10765022cb9c1e23f3d91025094848d,1,1,1,2,1,2013-10-11 18:55:01,2013-10-11 18:54:54
ef132b3aa10765022cb9c1e23f3d91025094848d...39c6861e3a012cd6cc2148cd961be9cb7502ac3e,43,332,438,770,203,2013-10-11 19:01:24,2013-10-10 20:50:28
39c6861e3a012cd6cc2148cd961be9cb7502ac3e...8af35e1ed355a413782a45d13ce50b582ab91355,13,161,50,211,28,2013-10-11 19:09:26,2013-10-02 21:47:24
8af35e1ed355a413782a45d13ce50b582ab91355...0502950b1cf05c64f1a367e00911c06baa65688a,14,322,193,515,139,2013-10-11 19:09:26,2013-10-11 01:32:08
0502950b1cf05c64f1a367e00911c06baa65688a...6cf723b050e87fa6d816ea41a36b3168e6a8aafd,1,20,8,28,3,2013-10-11 19:39:53,2013-10-11 19:36:10
6cf723b050e87fa6d816ea41a36b3168e6a8aafd...24b6d27d9a00808ece23ba133ea658ef72c8e174,3,116,11,127,9,2013-10-11 19:53:41,2013-10-07 18:21:46
24b6d27d9a00808ece23ba133ea658ef72c8e174...fe7933f15fb1bde83584fedc694da1b9a1fb8bc7,1,62,0,62,1,2013-10-11 20:28:05,2013-10-10 20:06:25
fe7933f15fb1bde83584fedc694da1b9a1fb8bc7...1b3bc8c3d9158cf1eac88003d1357a7b1dfed098,1,2,2,4,1,2013-10-11 20:35:24,2013-10-11 20:35:24
1b3bc8c3d9158cf1eac88003d1357a7b1dfed098...8952535c3dc337957f68e11b9b48c8709771a0e7,1,3,0,3,1,2013-10-11 20:52:10,2013-10-11 20:18:08
8952535c3dc337957f68e11b9b48c8709771a0e7...967dbe1b27ac6459c15d02c30dd6a0790203d54e,3,324,23,347,31,2013-10-11 20:55:35,2013-10-11 14:56:42
967dbe1b27ac6459c15d02c30dd6a0790203d54e...71dbf90bfb81c036e3dd345bb1b5e6d2a798ad9b,2,7,3,10,3,2013-10-11 21:00:01,2013-10-10 14:05:52
71dbf90bfb81c036e3dd345bb1b5e6d2a798ad9b...8cd3c95861417614dfac3a8cbf9f6c7621d40e93,3,26,20,46,9,2013-10-11 21:14:20,2013-10-11 18:16:10
8cd3c95861417614dfac3a8cbf9f6c7621d40e93...d538a7729829a5cd24b6ec8bb8ffdae22d616a0f,1,2,0,2,2,2013-10-11 21:18:09,2013-10-11 21:00:04
d538a7729829a5cd24b6ec8bb8ffdae22d616a0f...716b1a5b3895b5822700c0c478043f7f15a227f4,20,271,659,930,101,2013-10-11 21:23:39,2013-10-09 18:45:56
716b1a5b3895b5822700c0c478043f7f15a227f4...100fc6d278597a4e119ac70b07b0f7c38cd2c4ab,1,2,2,4,2,2013-10-11 21:40:17,2013-10-11 21:37:59
100fc6d278597a4e119ac70b07b0f7c38cd2c4ab...f0c6cebd73410c711ff2fc1167f7bded692dad1e,48,152,105,257,80,2013-10-11 22:14:12,2013-10-11 00:04:15
f0c6cebd73410c711ff2fc1167f7bded692dad1e...179e7c1cdc5d80515892d5d938624a2d70350d4f,1,12,3,15,1,2013-10-11 22:14:50,2013-10-11 22:06:46
179e7c1cdc5d80515892d5d938624a2d70350d4f...bb421d824fbff1c70ac94fd60772b356a2b3074e,1,9,9,18,6,2013-10-11 22:24:19,2013-10-11 20:45:40
bb421d824fbff1c70ac94fd60772b356a2b3074e...3b2050ef315f39314909509dcfa9676a971ff988,1,12,76,88,17,2013-10-11 22:31:05,2013-10-11 22:31:05
3b2050ef315f39314909509dcfa9676a971ff988...6ba8fc2f0ee77cffd2270556afc5984e44c1b243,2,72,2,74,10,2013-10-11 22:38:46,2013-09-26 19:13:26
6ba8fc2f0ee77cffd2270556afc5984e44c1b243...7555171ac736cd06c59fd5ebd958041d55c8420e,2,19,20,39,6,2013-10-11 22:55:39,2013-10-11 22:55:32
7555171ac736cd06c59fd5ebd958041d55c8420e...71c1d57dbc3af19c6832ba7361c44eff98d540cf,1,4,1,5,2,2013-10-11 23:08:29,2013-10-11 23:08:29
71c1d57dbc3af19c6832ba7361c44eff98d540cf...50682334073f0289d8700080a09299e6e061276c,1,2,4,6,2,2013-10-11 23:16:54,2013-10-11 23:16:50
50682334073f0289d8700080a09299e6e061276c...08fde2e6a23a98d8ca1ef9593891f4de027d2474,9,317,4,321,16,2013-10-12 00:27:40,2013-10-10 14:52:42
08fde2e6a23a98d8ca1ef9593891f4de027d2474...a1d5f24d910d1407b8c166d99f0df99640845a2e,7,448,13,461,13,2013-10-12 00:32:19,2013-10-10 15:17:55
a1d5f24d910d1407b8c166d99f0df99640845a2e...34b88976c91fdeec5ff0b8816d35deef72f3767e,12,214,9,223,22,2013-10-12 00:32:19,2013-10-11 23:53:46
34b88976c91fdeec5ff0b8816d35deef72f3767e...0b19be208f91e70c683d60c22011cad14a9fa78c,6,152,21,173,8,2013-10-12 01:27:17,2013-10-11 22:10:35
0b19be208f91e70c683d60c22011cad14a9fa78c...3a2776f0d66a03cd2c8de51117e14a0afffb716e,1,1,1,2,1,2013-10-12 01:46:06,2013-10-12 01:46:06
3a2776f0d66a03cd2c8de51117e14a0afffb716e...535665987c26169e5bdb942371365b03f328e348,1,2,2,4,2,2013-10-12 02:25:29,2013-10-12 02:25:26
535665987c26169e5bdb942371365b03f328e348...7a677b1d6a5f4ac115d69957a18671f77d889dbb,1,1,0,1,1,2013-10-12 03:45:26,2013-10-12 03:44:53
7a677b1d6a5f4ac115d69957a18671f77d889dbb...b1b968db74a834692e48fbd613d9d9fa01dd4029,3,11,3,14,5,2013-10-12 04:38:21,2013-10-12 04:38:17
b1b968db74a834692e48fbd613d9d9fa01dd4029...e9542d111dcd02f93113ad448ca15a1c9b95f1e7,1,1,1,2,1,2013-10-12 04:46:16,2013-10-12 04:46:16
e9542d111dcd02f93113ad448ca15a1c9b95f1e7...bf0f29709b19565245be370aa3f8c46f0332de91,4,353,95,448,25,2013-10-12 04:55:01,2013-10-12 04:54:58
bf0f29709b19565245be370aa3f8c46f0332de91...6a70c219c62990c3c350983fd57753a00d5dc69c,1,2,2,4,2,2013-10-12 05:05:39,2013-10-12 05:05:39
6a70c219c62990c3c350983fd57753a00d5dc69c...d81fd6a358208eb52f84711f9a0d7774bdddc743,1,3,3,6,1,2013-10-12 13:45:21,2013-10-12 13:45:21
d81fd6a358208eb52f84711f9a0d7774bdddc743...45a9b3929a1f8ce20188e0979be9fae6ac67fd2a,1,1,1,2,1,2013-10-12 13:45:39,2013-10-12 13:45:39
45a9b3929a1f8ce20188e0979be9fae6ac67fd2a...c1a09966ff05c42c184870715e7a7383d02c477d,1,3,2,5,1,2013-10-12 17:18:38,2013-10-12 17:18:38
c1a09966ff05c42c184870715e7a7383d02c477d...7d1097b8468e1ff753bb6dc3169fd1f09e1d3f61,1,4,2,6,1,2013-10-12 17:35:33,2013-10-12 17:34:10
7d1097b8468e1ff753bb6dc3169fd1f09e1d3f61...dfd532ea43966e5f10c691fe0211d8170c8b1e23,2,8,7,15,5,2013-10-12 19:17:02,2013-10-12 19:17:02
dfd532ea43966e5f10c691fe0211d8170c8b1e23...23ebec9445bf7b4b290ade91464b52d23d29d3a2,1,12,1,13,1,2013-10-12 19:29:32,2013-10-12 19:29:32
23ebec9445bf7b4b290ade91464b52d23d29d3a2...3f145f2bc86d9e72e992529c4db3439be0b755ff,7,48,10,58,15,2013-10-12 20:11:54,2013-10-12 20:11:54
3f145f2bc86d9e72e992529c4db3439be0b755ff...3e47a48bd6b26d1b857be7c8c960b7fa18fd768a,1,1,2,3,1,2013-10-12 21:01:52,2013-10-12 17:13:38
3e47a48bd6b26d1b857be7c8c960b7fa18fd768a...7b3a60ddc4ba5f3380825ba4f10c8543ded5fde1,1,64,59,123,7,2013-10-12 21:01:52,2013-10-12 17:30:24
7b3a60ddc4ba5f3380825ba4f10c8543ded5fde1...b92263ded10ad1b9363978c55d84b151c45701ae,3,20,4,24,5,2013-10-12 21:01:52,2013-10-12 19:33:40
b92263ded10ad1b9363978c55d84b151c45701ae...973f199c11040e3dcdebdf544aaae614367df1b1,1,1,1,2,1,2013-10-12 21:22:26,2013-10-12 21:22:26
973f199c11040e3dcdebdf544aaae614367df1b1...b2f87f53245b8c15eff65700a929984ebeab75a8,1,4,2,6,1,2013-10-12 21:28:25,2013-10-12 21:08:50
b2f87f53245b8c15eff65700a929984ebeab75a8...b57a0b403ef86071c2d8d8e8c32f54abb8907a75,3,227,382,609,8,2013-10-12 22:20:01,2013-10-05 00:12:44
b57a0b403ef86071c2d8d8e8c32f54abb8907a75...31713e0af43e23ba6a46f44684d41877bebf0fde,6,291,9,300,9,2013-10-12 22:20:01,2013-10-07 22:54:29
31713e0af43e23ba6a46f44684d41877bebf0fde...2b413fa86b435986771e50a6c0de48a127422f30,1,66,46,112,22,2013-10-12 22:20:01,2013-10-08 00:50:23
2b413fa86b435986771e50a6c0de48a127422f30...c7a50d739c50a96690a6acb1818a783d618ed64a,1,5,5,10,5,2013-10-12 22:20:01,2013-10-04 23:36:48
c7a50d739c50a96690a6acb1818a783d618ed64a...ba2dde72a07371d8500c69ee98ef4c82399607c2,2,3,1,4,3,2013-10-12 22:20:01,2013-10-04 23:08:27
ba2dde72a07371d8500c69ee98ef4c82399607c2...96effe4d13852215eabcdb1eb33bd72cb285624d,2,11,1,12,11,2013-10-12 22:20:02,2013-10-10 20:18:18
96effe4d13852215eabcdb1eb33bd72cb285624d...732c43fd8786fed550b033f47372a9225f9d047c,2,2,2,4,2,2013-10-12 22:20:02,2013-10-12 20:58:50
732c43fd8786fed550b033f47372a9225f9d047c...041d432fc3f17e4b78d4056972f8577273357ce4,1,17,9,26,3,2013-10-12 22:20:02,2013-10-12 22:08:45
041d432fc3f17e4b78d4056972f8577273357ce4...96ef70bb25526f6387b95d0332dba33e69df0aa2,1,2,4,6,1,2013-10-13 00:05:55,2013-10-12 23:59:38
96ef70bb25526f6387b95d0332dba33e69df0aa2...db089e849ad5a67dfb5d26c697f83205d2363c0f,1,2,1,3,1,2013-10-13 00:05:55,2013-10-13 00:00:55
db089e849ad5a67dfb5d26c697f83205d2363c0f...9b1589d125be777745d73c79f1eab23da92f8c35,1,1,1,2,1,2013-10-13 02:20:58,2013-10-13 02:20:58
9b1589d125be777745d73c79f1eab23da92f8c35...580e963f5e2618cca1e0db81f14d1924fc5ca881,2,7,1,8,3,2013-10-13 14:18:44,2013-10-13 14:18:44
580e963f5e2618cca1e0db81f14d1924fc5ca881...563657a6d65184d4efb3326a999bab2abcb083c2,1,11,10,21,4,2013-10-13 15:44:44,2013-10-12 00:31:35
563657a6d65184d4efb3326a999bab2abcb083c2...f5dd5e4287198a37500d1d4ce0408541b908f473,1,3,1,4,1,2013-10-13 22:52:06,2013-10-13 22:52:06
f5dd5e4287198a37500d1d4ce0408541b908f473...ae9897079d2139bb451d2c2183bfe4a96f879899,1,4,0,4,2,2013-10-14 01:34:10,2013-10-14 01:34:10
ae9897079d2139bb451d2c2183bfe4a96f879899...3f2c4c4afd0169a594d766d54f8b0444ecdc8d6a,1,53,0,53,1,2013-10-14 03:20:36,2013-10-14 02:55:38
3f2c4c4afd0169a594d766d54f8b0444ecdc8d6a...a428f58a6fd4f9497b60b10fa749e5cf2eec7b7c,4,174,39,213,9,2013-10-14 14:25:47,2013-10-13 02:53:52
a428f58a6fd4f9497b60b10fa749e5cf2eec7b7c...486efd8f13fcfc433821451f13844c8071aa5b62,1,7,3,10,1,2013-10-14 16:03:29,2013-10-14 04:43:24
486efd8f13fcfc433821451f13844c8071aa5b62...fc3b552e788e027af40523173790a20f49b27ec5,1,5,1,6,1,2013-10-14 20:07:37,2013-10-14 20:07:28
fc3b552e788e027af40523173790a20f49b27ec5...9fcdfeb195c42e91a49e37212a65fea624d71c13,1,8,0,8,1,2013-10-14 20:17:23,2013-10-14 20:17:13
9fcdfeb195c42e91a49e37212a65fea624d71c13...d1c2ae72c4829ed77cb6b7fe42e486910483caff,1,1,1,2,1,2013-10-14 23:25:47,2013-10-14 23:25:47
d1c2ae72c4829ed77cb6b7fe42e486910483caff...506fe5ad46b9a0d083af61f4e52a5726f2656949,1,5,11,16,4,2013-10-15 16:13:11,2013-10-15 16:13:11
506fe5ad46b9a0d083af61f4e52a5726f2656949...cc737bb7aaa38fb6ec32f616ab5fc29e124be691,1,6,3,9,2,2013-10-15 18:24:45,2013-10-15 18:24:45
cc737bb7aaa38fb6ec32f616ab5fc29e124be691...cb43564b19d4dd0c418568fd559a28dac980ce8a,1,12,7,19,6,2013-10-15 18:25:46,2013-10-15 13:17:30
cb43564b19d4dd0c418568fd559a28dac980ce8a...038338603c41475f97b5919e3f6365f6163f12c5,3,83,34,117,21,2013-10-15 18:25:46,2013-10-15 15:16:27
038338603c41475f97b5919e3f6365f6163f12c5...1364fd2651d68469e2793266c9ce4ba2bba983a9,1,6,11,17,2,2013-10-15 18:25:46,2013-10-15 15:41:15
1364fd2651d68469e2793266c9ce4ba2bba983a9...5152744c408572a5b91dda3e8959f77d888a7b0e,2,11,1,12,2,2013-10-15 18:29:05,2013-10-15 16:15:54
5152744c408572a5b91dda3e8959f77d888a7b0e...6ee3ed887a44c850faadc8c5debcff4a135b8c5f,1,9,2,11,3,2013-10-15 18:29:06,2013-10-15 16:21:40
6ee3ed887a44c850faadc8c5debcff4a135b8c5f...2a1753c33971126e48705d0364a99977e30f5559,1,4,1,5,1,2013-10-15 18:29:23,2013-10-15 18:24:32
2a1753c33971126e48705d0364a99977e30f5559...487d9e61dba245cfb58af084b802ee4fc41e6288,1,6,1,7,2,2013-10-15 18:35:52,2013-10-15 18:35:47
487d9e61dba245cfb58af084b802ee4fc41e6288...2e972e1e7de2966dd5e39ebd79f9fad8dcf5a78c,3,16,10,26,10,2013-10-15 18:45:48,2013-10-15 18:23:01
2e972e1e7de2966dd5e39ebd79f9fad8dcf5a78c...1ea7e56cb2b8653d4b0453f04728033df34be9e1,1,3,2,5,1,2013-10-15 19:26:56,2013-10-15 19:14:02
1ea7e56cb2b8653d4b0453f04728033df34be9e1...7a4dfa13328f47eb1fa4e5ef5de264883366571f,1,4,3,7,3,2013-10-15 22:06:45,2013-10-15 22:06:45
7a4dfa13328f47eb1fa4e5ef5de264883366571f...b25cce86256206a0fd3d136c5b5e13dbf04476ba,1,3,4,7,3,2013-10-16 00:57:38,2013-10-16 00:56:39
b25cce86256206a0fd3d136c5b5e13dbf04476ba...94ce941611abf2fd3826936a90d93b09e483d99c,1,0,58,58,1,2013-10-16 01:15:17,2013-10-16 01:15:17
94ce941611abf2fd3826936a90d93b09e483d99c...4850a6ae10601226642c6594f3b93e052d62bdf6,1,4,4,8,2,2013-10-16 11:42:46,2013-10-16 11:42:39
4850a6ae10601226642c6594f3b93e052d62bdf6...e948b4b843c7e972bece22ceb2d2cf0907732499,2,6,5,11,6,2013-10-16 14:45:16,2013-10-16 14:43:30
e948b4b843c7e972bece22ceb2d2cf0907732499...5747ceaf63f5c6b713cd1874a4a01b048b5442b6,6,287,9,296,14,2013-10-16 15:00:41,2013-10-16 14:57:36
5747ceaf63f5c6b713cd1874a4a01b048b5442b6...7d1febe107917b8378023ab9af26f5e4f0d1a30c,2,10,0,10,3,2013-10-16 19:39:21,2013-10-16 19:33:25
7d1febe107917b8378023ab9af26f5e4f0d1a30c...d908b872604852be119317fd6b2d63e6149d023d,2,4,3,7,4,2013-10-16 20:52:58,2013-10-16 20:52:58
d908b872604852be119317fd6b2d63e6149d023d...75ae13adcbe1d16c14581d6357c915be2f9795b2,1,1,1,2,1,2013-10-17 14:56:11,2013-10-17 14:56:01
75ae13adcbe1d16c14581d6357c915be2f9795b2...1a90352d5f09b436eb67ec53b9bdf77a75dd70f5,1,10,8,18,9,2013-10-17 17:56:35,2013-10-17 17:56:35
1a90352d5f09b436eb67ec53b9bdf77a75dd70f5...78a5cc81af2209e10e1357a41e02f1689b60ef1e,2,2,2,4,2,2013-10-17 21:49:50,2013-10-17 21:49:50
78a5cc81af2209e10e1357a41e02f1689b60ef1e...428be313f4ac309d792de049fbab966c19f02bb9,2,2,2,4,2,2013-10-18 15:17:53,2013-10-18 15:17:53
78a5cc81af2209e10e1357a41e02f1689b60ef1e...8051e469a4d794d09df658b8f6dbf2d95974a1ce,2,14,20,34,2,2013-10-18 14:39:19,2013-10-18 14:36:48
f7ade31677f9cd93d0195b52713c40f2b709b324...363c19f1a8b14398128d81ba7a6db7de058298b0,1,4,4,8,3,2013-10-18 16:45:30,2013-10-18 16:45:22
363c19f1a8b14398128d81ba7a6db7de058298b0...ba367884d4d1f04969622755464bc094cff22c4c,1,1,1,2,1,2013-10-18 18:22:21,2013-10-16 22:00:53
ba367884d4d1f04969622755464bc094cff22c4c...e8d644bff47f975d3470a7b74ebe113229012689,1,1313,0,1313,1,2013-10-18 18:29:24,2013-10-15 19:29:59
e8d644bff47f975d3470a7b74ebe113229012689...978af985464daba35e139619ed9fc3c67e3ecfd4,1,3,1,4,2,2013-10-18 18:46:47,2013-10-18 15:30:11
978af985464daba35e139619ed9fc3c67e3ecfd4...670c981819ed1512b9f623d3879901dda606ed20,1,2,1,3,1,2013-10-18 18:47:15,2013-10-16 15:34:16
670c981819ed1512b9f623d3879901dda606ed20...715d1a6629b86d4a892d6ff74889e84bda00c522,1,16,0,16,2,2013-10-18 18:47:51,2013-10-15 03:05:29
715d1a6629b86d4a892d6ff74889e84bda00c522...86ea362635929038c827616d26c07ef0d70fb709,1,3,3,6,2,2013-10-18 19:03:39,2013-10-18 19:03:39
86ea362635929038c827616d26c07ef0d70fb709...ee36f600438b349a2325bb12dcdaa7ea238053e7,1,1,0,1,1,2013-10-18 19:03:39,2013-10-18 19:03:39
ee36f600438b349a2325bb12dcdaa7ea238053e7...d88fa196ad24d2061ae29e608106b2d075485bdb,9,123,6,129,15,2013-10-18 19:03:39,2013-10-18 19:03:39
d88fa196ad24d2061ae29e608106b2d075485bdb...4f86462b86c1c2ee06495c93181e345819930dcc,2,0,8,8,4,2013-10-18 19:03:39,2013-10-18 19:03:39
4f86462b86c1c2ee06495c93181e345819930dcc...55b49f25f683e7ff86eae40937b0d09d96cfd40d,1,1,1,2,1,2013-10-18 19:13:06,2013-10-16 19:40:32
55b49f25f683e7ff86eae40937b0d09d96cfd40d...9838fe08ae217ac47b46f338100b7ea3e87c1c83,1,12,4,16,2,2013-10-18 19:34:01,2013-10-12 18:10:31
9838fe08ae217ac47b46f338100b7ea3e87c1c83...04c63390531b22857bd8110761b5cf631278f9b6,4,22,22,44,22,2013-10-20 19:13:40,2013-10-17 21:56:08
04c63390531b22857bd8110761b5cf631278f9b6...3f62f60004908d5eb99ed4ed870add8560ec2dd4,5,32,15,47,13,2013-10-21 17:29:29,2013-10-18 20:03:37
3f62f60004908d5eb99ed4ed870add8560ec2dd4...83c26f301d3374ebc08b802e1d050410b85e0449,1,46,29,75,4,2013-10-21 17:49:33,2013-10-15 22:08:18
83c26f301d3374ebc08b802e1d050410b85e0449...4b6afeee682836a596f2f949449f9dce334ab33a,7,23,22,45,15,2013-10-21 17:49:33,2013-10-11 19:15:03
4b6afeee682836a596f2f949449f9dce334ab33a...615357b9f15f6a9104d4a82a21fdbe24e6630201,5,214,69,283,29,2013-10-21 17:49:33,2013-10-11 22:07:17
615357b9f15f6a9104d4a82a21fdbe24e6630201...a6335f74f438868867f6e28bbf3efe2d400351d1,6,21,21,42,18,2013-10-21 17:49:33,2013-10-16 19:12:50
a6335f74f438868867f6e28bbf3efe2d400351d1...e454b6a732e15a35c29757a92e73b1ca0bc4c98d,6,48,44,92,40,2013-10-21 17:49:34,2013-10-10 21:57:27
e454b6a732e15a35c29757a92e73b1ca0bc4c98d...da9e1729507fd00c39dc940dccbffe68130e8ead,2,9,0,9,2,2013-10-21 17:49:34,2013-10-10 22:07:51
da9e1729507fd00c39dc940dccbffe68130e8ead...eb9b6deb0ed04a602420990ab621814eadd5ba54,2,54,84,138,15,2013-10-21 17:49:34,2013-10-15 19:48:34
eb9b6deb0ed04a602420990ab621814eadd5ba54...ebe18abffda4d3aad1c4ee9a170a63e1d570de3b,3,4,47,51,6,2013-10-21 17:49:34,2013-10-16 17:16:27
ebe18abffda4d3aad1c4ee9a170a63e1d570de3b...247191fdd87bbec859ca759ab0fd1c4b9fa9e8bc,10,16,146,162,16,2013-10-21 17:49:34,2013-10-16 20:49:57
247191fdd87bbec859ca759ab0fd1c4b9fa9e8bc...22fe229c4700de724ef64fe929c1b58186db3a15,6,24,64,88,14,2013-10-21 17:49:34,2013-10-16 22:51:48
22fe229c4700de724ef64fe929c1b58186db3a15...c36cd416195ddcbf092480fdacdf0a0a081cc9c6,3,52,14,66,11,2013-10-21 17:49:34,2013-10-17 20:24:48
c36cd416195ddcbf092480fdacdf0a0a081cc9c6...7fb5aa479b0801c1c3de9389e0016a4442a9deae,1,8,1,9,1,2013-10-21 17:49:34,2013-10-18 22:34:36
7fb5aa479b0801c1c3de9389e0016a4442a9deae...9e1ac1e79ad750fc913c607c9af99d6cd7e79dc8,1,15,2,17,4,2013-10-21 17:49:34,2013-10-21 16:02:02
9e1ac1e79ad750fc913c607c9af99d6cd7e79dc8...c187aceff59e7f2997416d9011da0b43e9ae34cb,1,4,0,4,4,2013-10-21 18:02:23,2013-10-21 18:02:23
c187aceff59e7f2997416d9011da0b43e9ae34cb...982d5d281806d470696809d11dceaa098aed4906,3,24,31,55,15,2013-10-21 18:05:14,2013-09-10 22:10:15
982d5d281806d470696809d11dceaa098aed4906...886c5d5c50437d49ab9f4702b86110cb3448cef3,1,3,0,3,1,2013-10-21 18:41:42,2013-10-16 17:50:42
886c5d5c50437d49ab9f4702b86110cb3448cef3...b67de10c6307468636b91fddd5d67b066f86b526,5,281,14,295,13,2013-10-21 20:18:28,2013-10-14 01:23:05
b67de10c6307468636b91fddd5d67b066f86b526...4e5bb06c7156a2a6e7bf878f3cf2c90a94771b2d,13,158,379,537,96,2013-10-21 21:22:16,2013-10-18 00:12:21
4e5bb06c7156a2a6e7bf878f3cf2c90a94771b2d...a4e7a4f5068c96faaffec93e0b2e86d084f27e92,6,21,165,186,8,2013-10-21 21:59:43,2013-10-18 19:05:04
a4e7a4f5068c96faaffec93e0b2e86d084f27e92...4f1e7a20d981612ff48a1f42499d6275dc864466,1,4,4,8,2,2013-10-21 22:27:15,2013-10-21 22:14:23
4f1e7a20d981612ff48a1f42499d6275dc864466...3b87e21f115188af7b47e7c50486133450a5d029,1,0,5,5,1,2013-10-21 23:11:12,2013-10-21 23:11:12
3b87e21f115188af7b47e7c50486133450a5d029...296ddd1ce096cb91a863d9438ff3aabd4b1d0a78,7,185,26,211,17,2013-10-22 16:07:53,2013-10-18 09:01:57
296ddd1ce096cb91a863d9438ff3aabd4b1d0a78...8a392fee1f44fab3c9b8158d1dc74de6521804a6,4,4,51,55,7,2013-10-22 16:24:11,2013-10-22 16:24:11
8a392fee1f44fab3c9b8158d1dc74de6521804a6...82c69b1bf96473f7d5795ad9ab3fa7b60a7a02a4,1,1,1,2,1,2013-10-22 17:39:08,2013-10-22 17:38:45
82c69b1bf96473f7d5795ad9ab3fa7b60a7a02a4...98bdc3025f4f0527cc09a90834cdecf6b7c235d8,1,12,0,12,1,2013-10-22 17:44:22,2013-10-22 17:44:22
98bdc3025f4f0527cc09a90834cdecf6b7c235d8...4221d2384a648d158e86041d05c353445412a025,1,1,1,2,1,2013-10-22 18:31:04,2013-10-15 18:43:10
4221d2384a648d158e86041d05c353445412a025...75135b965a7d9af110bd42bc40e9ad6dfac254ab,1,13,0,13,2,2013-10-22 18:31:04,2013-10-15 20:12:01
75135b965a7d9af110bd42bc40e9ad6dfac254ab...1452ef1ef0439bb9ee7a44df6d3bce73f4b12f63,4,87,3,90,7,2013-10-22 18:34:45,2013-10-11 17:56:29
1452ef1ef0439bb9ee7a44df6d3bce73f4b12f63...f978484e16c20de3b93c62d46fc3f2fe7e9a1c02,1,22,11,33,5,2013-10-22 19:42:12,2013-10-21 20:38:51
f978484e16c20de3b93c62d46fc3f2fe7e9a1c02...483df488c35c0058e5eea1e9af90ecde77d57a29,5,89,11,100,16,2013-10-22 21:47:18,2013-10-21 22:10:25
483df488c35c0058e5eea1e9af90ecde77d57a29...a942dd1d88c1c6dddb68f85a02f72434c2999f9e,45,1855,1192,3047,184,2013-10-23 11:32:08,2013-10-23 11:32:08
a942dd1d88c1c6dddb68f85a02f72434c2999f9e...50859472c4edda2b777065015d5c3a450b2b6000,1,1,1,2,2,2013-10-23 13:57:10,2013-10-22 20:43:32
50859472c4edda2b777065015d5c3a450b2b6000...931356acb43c115ca6430338ff5c69fc39ac3a16,1,4,0,4,1,2013-10-23 15:49:17,2013-10-23 15:48:45
931356acb43c115ca6430338ff5c69fc39ac3a16...f797a11b08fc27b03029e13d0f51549c1e1944ba,2,7,2,9,5,2013-10-23 16:28:14,2013-10-23 01:25:28
f797a11b08fc27b03029e13d0f51549c1e1944ba...03e75c506ce3ce4a9e6ad7126ded0e8c88cfb44e,1,1,1,2,1,2013-10-23 16:28:22,2013-10-23 01:26:09
03e75c506ce3ce4a9e6ad7126ded0e8c88cfb44e...34c1b5b421f05feb3d3772a0d582a79fb2665221,2,8,1,9,2,2013-10-23 17:05:28,2013-10-16 17:29:29
34c1b5b421f05feb3d3772a0d582a79fb2665221...667ea0bdbd3ec255820f9318383d4ae6c7c10a59,1,17,10,27,4,2013-10-23 17:14:32,2013-10-23 17:14:07
667ea0bdbd3ec255820f9318383d4ae6c7c10a59...08adb27c9e9c3d48ba6a66f6cea98ba72965d5df,1,2,2,4,2,2013-10-23 17:20:23,2013-10-23 17:20:23
08adb27c9e9c3d48ba6a66f6cea98ba72965d5df...4896c73dc63d71a1b5bcf66a69ddc651fda09ffd,3,41,36,77,15,2013-10-23 18:29:29,2013-10-22 20:23:55
4896c73dc63d71a1b5bcf66a69ddc651fda09ffd...2b16aca77cbd4486d780e21636b7043733e12765,4,16,25,41,16,2013-10-23 18:30:25,2013-10-23 18:18:53
2b16aca77cbd4486d780e21636b7043733e12765...3da760bdd1f63e5254d56c4104f6676277ebdcfd,4,18,18,36,15,2013-10-23 19:14:19,2013-10-22 22:46:50
3da760bdd1f63e5254d56c4104f6676277ebdcfd...6c95fdd95c4182cc396c3714a7cf13bbfe627de6,3,3,7,10,4,2013-10-23 19:35:46,2013-10-23 19:03:52
6c95fdd95c4182cc396c3714a7cf13bbfe627de6...ba067e496f04fa15ea7740d4e1d29200409e0296,1,17,12,29,3,2013-10-23 19:35:46,2013-10-23 19:07:01
ba067e496f04fa15ea7740d4e1d29200409e0296...43f453706df0cb14c5479e1908220527f9f919b1,1,3,3,6,3,2013-10-23 20:13:28,2013-10-23 19:51:33
43f453706df0cb14c5479e1908220527f9f919b1...ded1ee8af0efcd9b14cfdd336e6809da6f6da473,1,2,0,2,2,2013-10-23 20:12:33,2013-10-22 22:26:29
ded1ee8af0efcd9b14cfdd336e6809da6f6da473...74cdecee315cacadb46d5fe170ce392fb32f3df1,7,28,35,63,15,2013-10-23 20:22:40,2013-10-23 20:22:40
74cdecee315cacadb46d5fe170ce392fb32f3df1...13962a0f8ebbaf0de9db9c10ed4da9aaf607f070,1,3,0,3,1,2013-10-23 21:07:43,2013-10-23 21:07:43
13962a0f8ebbaf0de9db9c10ed4da9aaf607f070...6ccab4d17b0732d630cdaed7f5c4f3f94bb20e6e,1,86,60,146,11,2013-10-23 21:12:33,2013-10-22 21:13:41
6ccab4d17b0732d630cdaed7f5c4f3f94bb20e6e...c9b501f8776655806fe11b2649a7c1b9a14e503d,1,8,0,8,1,2013-10-23 21:18:18,2013-10-23 20:17:00
c9b501f8776655806fe11b2649a7c1b9a14e503d...deea07bcc3ab166cc6cb5c025d46b89fb4c02236,1,17,3,20,3,2013-10-23 22:15:51,2013-10-22 05:08:49
deea07bcc3ab166cc6cb5c025d46b89fb4c02236...2bc327964e59cfc7d2a0a5241df04d56b5a039a3,1,1,1,2,1,2013-10-23 22:35:19,2013-10-23 22:35:19
2bc327964e59cfc7d2a0a5241df04d56b5a039a3...a9eb91679a5df939c8fbe0fb5737588ee0f758a1,3,64,4,68,8,2013-10-23 22:38:18,2013-10-18 22:34:31
a9eb91679a5df939c8fbe0fb5737588ee0f758a1...007665da8b3c2c622ab5fe112f64b7d475bb3220,3,47,1,48,4,2013-10-23 22:47:01,2013-10-22 16:34:38
007665da8b3c2c622ab5fe112f64b7d475bb3220...18634c0b8798ddfd98d1370e038f82f8b372db0d,4,186,82,268,30,2013-10-23 23:28:02,2013-10-16 19:01:30
18634c0b8798ddfd98d1370e038f82f8b372db0d...e7089550acfde9507dcae677e03000e8b2dad3b4,2,30,0,30,2,2013-10-23 23:38:44,2013-10-23 23:37:54
e7089550acfde9507dcae677e03000e8b2dad3b4...107978292c125ebb6674ad57548f1a4dc8f977d1,6,322,16,338,22,2013-10-23 23:41:30,2013-10-18 02:23:45
107978292c125ebb6674ad57548f1a4dc8f977d1...89218f62b7ad5114df7e956bec47b4c1f96f1fed,30,300,241,541,148,2013-10-23 23:41:30,2013-10-18 22:22:30
89218f62b7ad5114df7e956bec47b4c1f96f1fed...22f5a8622731353890352dbaccdebdc937ae8508,43,6362,400,6762,75,2013-10-23 23:41:30,2013-10-21 06:02:26
22f5a8622731353890352dbaccdebdc937ae8508...1c6ad3e411e431cf81da9f7d514fa20ec4fe792a,17,682,1122,1804,59,2013-10-23 23:41:30,2013-10-21 17:00:20
1c6ad3e411e431cf81da9f7d514fa20ec4fe792a...0f9712f7a666699b83cee27fa7136ea92aa9e555,7,405,339,744,102,2013-10-23 23:41:30,2013-10-21 20:03:06
0f9712f7a666699b83cee27fa7136ea92aa9e555...4686f81fe1ad2dc700ab17748d96e9c24f824579,20,846,12,858,547,2013-10-23 23:41:30,2013-10-10 14:53:56
4686f81fe1ad2dc700ab17748d96e9c24f824579...26f1aa281843b901219c49ad5f35e69fe4119bac,5,503,34,537,19,2013-10-23 23:41:30,2013-10-23 01:32:36
26f1aa281843b901219c49ad5f35e69fe4119bac...ec409bbf8271fa5e10284961fe9106c28cbb6023,1,1,1,2,1,2013-10-23 23:41:30,2013-10-23 21:14:50
ec409bbf8271fa5e10284961fe9106c28cbb6023...1a58dde196331e0719ffe36a398f5ab8a93cbad5,1,12,0,12,1,2013-10-24 01:27:13,2013-10-24 01:27:13
1a58dde196331e0719ffe36a398f5ab8a93cbad5...d431dc6ca4b15bed750463fccd334d3b681da73e,1,6,4,10,2,2013-10-24 02:10:07,2013-10-24 02:07:16
d431dc6ca4b15bed750463fccd334d3b681da73e...c59072955c5294282d643a28536dbb6e6eeb453b,14,1064,0,1064,532,2013-10-24 14:38:09,2013-10-23 22:34:12
c59072955c5294282d643a28536dbb6e6eeb453b...3a40ae32970eba3ad93607a81d252800a802a834,25,142,257,399,60,2013-10-24 14:38:13,2013-10-23 23:19:07
3a40ae32970eba3ad93607a81d252800a802a834...e8fe7befcf2f698f988e0ac80a5b48ac51e6f922,1,0,2,2,1,2013-10-24 15:18:45,2013-10-24 15:18:40
e8fe7befcf2f698f988e0ac80a5b48ac51e6f922...cfff07276553e9a4131a1699a9f58c3e6cb0b3b3,44,125,50,175,65,2013-10-24 15:25:24,2013-10-24 15:24:19
cfff07276553e9a4131a1699a9f58c3e6cb0b3b3...dc288a87a0e40eba11015a26e85659396ce9aea7,2,37,7,44,6,2013-10-24 15:00:24,2013-10-15 17:52:56
dc288a87a0e40eba11015a26e85659396ce9aea7...7023936764956d0e7c2383d89b4203fad2741596,1,1,1,2,1,2013-10-24 15:00:24,2013-10-16 18:52:53
7023936764956d0e7c2383d89b4203fad2741596...50ec2a895783239dde6ed0d51ffa9d522e2bebf2,1,3,1,4,2,2013-10-24 15:00:24,2013-10-17 18:26:06
50ec2a895783239dde6ed0d51ffa9d522e2bebf2...32729a2482b57d0c6cf976d6958920611cdcc015,2,12,18,30,7,2013-10-24 15:00:25,2013-10-17 17:45:19
32729a2482b57d0c6cf976d6958920611cdcc015...2d1b78d00700a4d0db6e739cc888bcf74944f00b,1,4,2,6,1,2013-10-24 15:00:25,2013-10-17 20:44:20
2d1b78d00700a4d0db6e739cc888bcf74944f00b...c3019ad939da94e44689c49a92a86b357b8c2596,6,40,26,66,16,2013-10-24 15:00:25,2013-10-17 20:07:56
c3019ad939da94e44689c49a92a86b357b8c2596...6332ae304a743abf86d47d92c12bf7f3f2169368,2,40,5,45,5,2013-10-24 16:08:41,2013-10-24 16:08:41
6332ae304a743abf86d47d92c12bf7f3f2169368...5682288d907ae593a4ab12d7cedab90cff2c3c04,3,48,5,53,6,2013-10-24 16:55:22,2013-10-23 15:41:08
5682288d907ae593a4ab12d7cedab90cff2c3c04...dd6d28a356d2768ed2b6d0e5bf8a510dfd561bdf,1,20,17,37,2,2013-10-24 16:55:22,2013-10-23 15:48:09
dd6d28a356d2768ed2b6d0e5bf8a510dfd561bdf...bc05262b903baafd4a286008ab3323172d8c3275,1,2,2,4,2,2013-10-24 18:46:43,2013-10-24 17:55:10
bc05262b903baafd4a286008ab3323172d8c3275...6cfb561b21444b562df7f4e486b0cbd8de17ec42,3,28,2,30,5,2013-10-24 19:19:57,2013-10-16 21:18:37
6cfb561b21444b562df7f4e486b0cbd8de17ec42...3228ad9c3ca78d55f814689686bf2e619fcde9a9,6,12,12,24,10,2013-10-24 20:12:47,2013-10-23 22:05:23
3228ad9c3ca78d55f814689686bf2e619fcde9a9...9d7c6dd9a2a662c741a9f960d9c6b2da1968d532,40,2487,345,2832,130,2013-10-24 20:41:06,2013-10-16 21:29:43
9d7c6dd9a2a662c741a9f960d9c6b2da1968d532...73fda21577693c645d643c57418d4bd5b2adb31e,35,766,492,1258,185,2013-10-24 20:41:06,2013-10-22 17:38:55
73fda21577693c645d643c57418d4bd5b2adb31e...2a584994ee747b46ada6c6383c7e983dcdf861a6,1,42,4,46,3,2013-10-24 20:45:16,2013-10-24 13:53:51
2a584994ee747b46ada6c6383c7e983dcdf861a6...3a71bf6a21c02048466a97f6a45066a830b9785d,1,1,1,2,1,2013-10-24 21:19:58,2013-10-24 21:19:58
3a71bf6a21c02048466a97f6a45066a830b9785d...fc7d11c5d981ebc1ef1b5a851c8dfee0e3d5548d,2,16,4,20,4,2013-10-24 22:35:08,2013-10-23 22:46:12
fc7d11c5d981ebc1ef1b5a851c8dfee0e3d5548d...c68386498187d810c7357c01e6f7b88dcbd5d289,4,325,0,325,4,2013-10-24 22:35:20,2013-10-23 17:49:53
c68386498187d810c7357c01e6f7b88dcbd5d289...4061eacd5665b966551227c88cd526b1cfdf4ba9,1,1,6,7,2,2013-10-24 22:45:26,2013-10-24 22:45:26
4061eacd5665b966551227c88cd526b1cfdf4ba9...f5e9945357a00808340edce07bb5434af692ea3e,2,2,2,4,2,2013-10-25 11:51:45,2013-10-25 11:51:45
f5e9945357a00808340edce07bb5434af692ea3e...668bbb03e41da7b1a6d17062c81307e67c7a6d7b,1,10,0,10,1,2013-10-25 13:28:01,2013-10-25 13:28:01
668bbb03e41da7b1a6d17062c81307e67c7a6d7b...b7876925662e986e8ca5def4cf7aecfcbcc5429e,1,9,7,16,6,2013-10-25 13:45:41,2013-10-24 20:47:14
b7876925662e986e8ca5def4cf7aecfcbcc5429e...8a2bca9ecaa4a6b203a80d8432c7033036eb467b,3,19,11,30,5,2013-10-25 16:11:37,2013-10-25 16:11:37
8a2bca9ecaa4a6b203a80d8432c7033036eb467b...1143e17d3425e78a727df56b1c214824cc8c44fd,4,7,4,11,5,2013-10-25 16:46:37,2013-10-03 16:30:49
1143e17d3425e78a727df56b1c214824cc8c44fd...bf2b4ee2ead2fabcb2e3263b30903cd12e8ee9ac,1,62,0,62,2,2013-10-25 16:52:52,2013-10-23 22:18:20
bf2b4ee2ead2fabcb2e3263b30903cd12e8ee9ac...e01542ba7a9e069214540ab7be92a21badd9bf44,4,88,158,246,14,2013-10-25 16:52:52,2013-10-24 15:55:46
e01542ba7a9e069214540ab7be92a21badd9bf44...17397f441842a66a271ed6490c92d8eb56545e5e,3,57,3,60,10,2013-10-25 16:52:52,2013-10-24 16:47:50
17397f441842a66a271ed6490c92d8eb56545e5e...dedd6bfea9b15e1e10de5cb67216f89ecb36fea8,4,11,48,59,5,2013-10-25 16:52:52,2013-10-24 18:12:58
dedd6bfea9b15e1e10de5cb67216f89ecb36fea8...bb597087d1d8aa4c0aecb34bd37ca60588dd61aa,10,69,68,137,27,2013-10-25 16:52:52,2013-10-24 20:26:43
bb597087d1d8aa4c0aecb34bd37ca60588dd61aa...46d8af46ac3c734d4e87c6da9a36f5517d14c8a4,13,2,16,18,15,2013-10-25 16:52:52,2013-10-24 20:41:53
46d8af46ac3c734d4e87c6da9a36f5517d14c8a4...6aadb9dcb12c21e7ec4d5665f52cc6e18d87a2ae,4,7,3,10,7,2013-10-25 16:52:52,2013-10-24 20:46:43
6aadb9dcb12c21e7ec4d5665f52cc6e18d87a2ae...27900becdf3bbeda9414ffeb03d0dcb465206ba6,3,149,139,288,38,2013-10-25 16:52:52,2013-10-24 21:35:36
27900becdf3bbeda9414ffeb03d0dcb465206ba6...5e58c72061b11949db2d15254af99a9c34b242ce,4,21,9,30,8,2013-10-25 16:52:52,2013-10-24 22:14:35
5e58c72061b11949db2d15254af99a9c34b242ce...715e6a89e1db69d695588962dc5c9d35c699d1e8,8,32,18,50,20,2013-10-25 16:52:52,2013-10-25 14:32:31
715e6a89e1db69d695588962dc5c9d35c699d1e8...f95946f6908447dd1b27e5537f3a5ef5d1df723d,1,0,2,2,1,2013-10-25 16:52:52,2013-10-25 16:26:58
f95946f6908447dd1b27e5537f3a5ef5d1df723d...9cbcecebe3b2735f45aed1b2cde95c66396fa2ca,1,2,2,4,2,2013-10-25 17:24:46,2013-10-24 00:18:15
9cbcecebe3b2735f45aed1b2cde95c66396fa2ca...cc54c2a1a85a4943ac818ad5310660082a1966b7,1,17,3,20,2,2013-10-25 17:26:52,2013-10-25 15:24:26
cc54c2a1a85a4943ac818ad5310660082a1966b7...41633fff781a94fdac26895a55b5741a035d9c81,17,529,138,667,72,2013-10-25 17:50:28,2013-10-23 17:59:57
41633fff781a94fdac26895a55b5741a035d9c81...5ab631f4f4e64d8c336474f42d61a87d547804ef,1,1,1,2,1,2013-10-25 18:18:50,2013-10-25 18:18:50
5ab631f4f4e64d8c336474f42d61a87d547804ef...ea84e033a8c61d492e322cd7de69331aa09058d9,10,429,126,555,77,2013-10-25 19:10:43,2013-10-25 18:17:44
ea84e033a8c61d492e322cd7de69331aa09058d9...d56278b9d8dbecd2a6ca041c8bd07000dfcf015f,10,82,39,121,38,2013-10-25 19:10:43,2013-10-25 18:17:44
d56278b9d8dbecd2a6ca041c8bd07000dfcf015f...b74dec9a8a8d8b2ec8771148f3edc6aa575db246,2,14,2,16,5,2013-10-25 19:10:43,2013-10-25 18:17:44
b74dec9a8a8d8b2ec8771148f3edc6aa575db246...3d61067308f7f526ec00d79bcbb158d31fd413fa,8,69,20,89,21,2013-10-25 19:10:43,2013-10-25 18:17:44
3d61067308f7f526ec00d79bcbb158d31fd413fa...63f43a42b916ead71cce107a76754e032cbc06cf,2,5,5,10,4,2013-10-25 20:10:58,2013-10-25 20:10:58
63f43a42b916ead71cce107a76754e032cbc06cf...63e564c8feccae4def0de5579ffee8d7feae7075,1,25,11,36,11,2013-10-25 19:38:55,2013-10-24 21:55:58
63e564c8feccae4def0de5579ffee8d7feae7075...91925374d97489ddc2f5d1dcc0bf8f563edbd78b,1,4,1,5,1,2013-10-25 20:47:26,2013-10-25 18:40:14
91925374d97489ddc2f5d1dcc0bf8f563edbd78b...bf2464cabe4053f8fac008bd029aecf416f7c108,2,34,11,45,11,2013-10-25 21:06:37,2013-10-25 21:02:52
bf2464cabe4053f8fac008bd029aecf416f7c108...1429bc8a91004e120866bdc6fccb007a7d0f10fc,1,0,257,257,1,2013-10-25 21:05:37,2013-10-25 21:05:37
1429bc8a91004e120866bdc6fccb007a7d0f10fc...befe2af3c63844b08519452a5fd11eadef2b273f,1,0,1,1,1,2013-10-25 21:08:57,2013-10-25 19:27:17
befe2af3c63844b08519452a5fd11eadef2b273f...fa758ec5a8a4eb0cbc325a1e7d8ababf47243aab,1,2,0,2,2,2013-10-25 21:24:29,2013-10-25 21:21:26
fa758ec5a8a4eb0cbc325a1e7d8ababf47243aab...62785e188f42bba661c1f108e70a92aef29c0e92,1,1,11,12,1,2013-10-25 21:31:06,2013-10-25 21:30:49
62785e188f42bba661c1f108e70a92aef29c0e92...ff9f15747c7f9e3d20436a66b2d90384e06fd4f2,5,236,3,239,13,2013-10-25 21:42:27,2013-10-23 16:03:33
ff9f15747c7f9e3d20436a66b2d90384e06fd4f2...774860337ea71d1f8b4711971dc9fa61115cd003,8,20,68,88,21,2013-10-25 22:15:23,2013-10-25 22:15:23
774860337ea71d1f8b4711971dc9fa61115cd003...4729ca809b99da06ef7b57f9962740089088242d,1,8,2,10,3,2013-10-26 03:06:32,2013-10-21 23:21:58
4729ca809b99da06ef7b57f9962740089088242d...60e9928620dbb71aea8bd195456e4247beb3989c,3,411,367,778,4,2013-10-26 12:58:48,2013-10-25 18:05:36
60e9928620dbb71aea8bd195456e4247beb3989c...ef4cb38c07a72f70e703f8949cbe87e9267227e4,1,54,43,97,30,2013-10-26 12:58:48,2013-10-25 18:11:36
ef4cb38c07a72f70e703f8949cbe87e9267227e4...4042dab63468646b5efd6459e897eb241a589f24,1,8,2,10,2,2013-10-26 12:58:48,2013-10-25 18:13:57
4042dab63468646b5efd6459e897eb241a589f24...d47828fa73dd7930c7b200c2a2ab594ac539a5d6,1,7,2,9,2,2013-10-26 12:58:48,2013-10-25 19:05:00
d47828fa73dd7930c7b200c2a2ab594ac539a5d6...98133b76bec6d2b1bcec5329af461bc8b0c14725,1,13,9,22,8,2013-10-26 12:58:48,2013-10-25 22:11:47
98133b76bec6d2b1bcec5329af461bc8b0c14725...1c6132d444d3c19a168e7e943d5595df08cfb477,2,27,16,43,13,2013-10-26 12:58:48,2013-10-25 22:51:55
1c6132d444d3c19a168e7e943d5595df08cfb477...23fd1682cba522fae1cf9c108244d7f4a22b2179,1,0,4,4,1,2013-10-26 12:58:48,2013-10-25 22:53:53
23fd1682cba522fae1cf9c108244d7f4a22b2179...74392743f7df0ae1abb820549b8c4b802e260cc9,1,12,6,18,5,2013-10-26 12:58:48,2013-10-25 22:58:27
74392743f7df0ae1abb820549b8c4b802e260cc9...d6881313aea5957fdbf12e0b983a9eafb4182283,3,26,16,42,19,2013-10-26 12:58:48,2013-10-25 23:15:03
d6881313aea5957fdbf12e0b983a9eafb4182283...a348801dd5640b0c2cae22f5e3f8017bf5d68465,3,41,22,63,12,2013-10-26 12:58:48,2013-10-25 23:28:58
a348801dd5640b0c2cae22f5e3f8017bf5d68465...2d32e99f5e67243f41e91c5d142b2a735e22d46a,1,5,1,6,2,2013-10-26 13:05:48,2013-10-26 13:05:48
2d32e99f5e67243f41e91c5d142b2a735e22d46a...726ad87f8b0bc75a5b9e53027c3c70baa204f745,1,2,1,3,1,2013-10-26 13:11:28,2013-10-26 13:11:28
726ad87f8b0bc75a5b9e53027c3c70baa204f745...d23caedc07564b6ea05ad0b96fa6e6f57a5b1260,4,18,13,31,8,2013-10-26 14:33:43,2013-10-26 14:33:43
d23caedc07564b6ea05ad0b96fa6e6f57a5b1260...d8ca8b5faa1447365403cfb8da16a041e7d31d95,2,1,2,3,2,2013-10-26 14:49:07,2013-10-26 14:49:07
d8ca8b5faa1447365403cfb8da16a041e7d31d95...911461fc883aa34e0deec661261f0ea5486c105e,1,8,3,11,3,2013-10-28 07:37:19,2013-10-25 16:18:05
911461fc883aa34e0deec661261f0ea5486c105e...063359489fb718845d1db8dc9185a7f9ebe3e6ab,2,8,2,10,5,2013-10-28 07:47:13,2013-10-23 23:00:07
063359489fb718845d1db8dc9185a7f9ebe3e6ab...ed9e214360ce91c07adf41aa6071c402baaa8dda,2,43,22,65,10,2013-10-28 12:10:23,2013-10-28 12:10:02
ed9e214360ce91c07adf41aa6071c402baaa8dda...1cb14a267bf1509e50d31932e25e930af6493561,3,40,6,46,5,2013-10-28 13:19:49,2013-10-22 21:16:21
1cb14a267bf1509e50d31932e25e930af6493561...878f2da2f8e87dac0f6b34a97a393576e4d8ff99,2,304,134,438,101,2013-10-28 15:23:54,2013-10-25 00:14:33
878f2da2f8e87dac0f6b34a97a393576e4d8ff99...7e452de2877845b27c0c1205b99d2057998da810,4,72,27,99,18,2013-10-28 15:50:41,2013-10-28 14:54:28
7e452de2877845b27c0c1205b99d2057998da810...0ca21679b816a8ca55da8b619d50e0edde477a62,1,3,11,14,1,2013-10-28 15:50:41,2013-10-28 15:50:15
0ca21679b816a8ca55da8b619d50e0edde477a62...c86a094c97b97de8b34f6bba66068df470ff4d10,2,15,1,16,4,2013-10-28 16:48:21,2013-10-28 16:48:08
c86a094c97b97de8b34f6bba66068df470ff4d10...4b146301e61a7bf6dbb1c046a2a8698811f20fd3,1,13,27,40,7,2013-10-28 18:40:59,2013-10-28 14:48:07
4b146301e61a7bf6dbb1c046a2a8698811f20fd3...ba1c7d57ea1a5e82e5af93e41344cf068cdc675b,1,0,1,1,1,2013-10-28 18:45:04,2013-10-27 01:02:38
ba1c7d57ea1a5e82e5af93e41344cf068cdc675b...38b665b22722ab442a9c022b54558e3cd7a9b84f,9,219,68,287,14,2013-10-28 18:16:06,2013-10-21 17:27:03
38b665b22722ab442a9c022b54558e3cd7a9b84f...0e35f9154fe51586d4bbc30267772a664b8df907,14,251,82,333,33,2013-10-28 18:57:51,2013-10-25 19:03:59
0e35f9154fe51586d4bbc30267772a664b8df907...7844d0500166db2ebb49d866bdd2d2f2af8c3b09,1,1,1,2,1,2013-10-28 19:19:07,2013-10-28 19:18:39
7844d0500166db2ebb49d866bdd2d2f2af8c3b09...a3b2652ec9a042396eefc469a7bea38c9106a678,1,2,0,2,1,2013-10-28 23:01:47,2013-10-28 23:01:33
a3b2652ec9a042396eefc469a7bea38c9106a678...45178f5933e1104083d790fe6a901db7a3291423,2,7,2,9,3,2013-10-28 23:06:46,2013-10-28 23:06:46
45178f5933e1104083d790fe6a901db7a3291423...a154dfd0c61129d154e0eb3782b4f4110ce150f1,5,39,13,52,17,2013-10-29 04:24:47,2013-10-29 04:22:39
a154dfd0c61129d154e0eb3782b4f4110ce150f1...451d6babfd1801b8bbfd746b1586c541acb078ee,1,1,1,2,1,2013-10-29 04:33:13,2013-10-29 04:33:13
451d6babfd1801b8bbfd746b1586c541acb078ee...202fe3e238fc378656482291d724728786581a2b,1,14,4,18,10,2013-10-29 06:14:05,2013-10-29 06:14:05
202fe3e238fc378656482291d724728786581a2b...f64377ea68e0f0003639672b886fc9e7be37942c,3,56,7,63,7,2013-10-29 13:14:54,2013-10-28 21:44:18
f64377ea68e0f0003639672b886fc9e7be37942c...faae4bd1cd1fc0d89da9d5ffe7d1945c4154f6c9,13,88,33,121,37,2013-10-29 13:20:01,2013-10-28 18:41:48
faae4bd1cd1fc0d89da9d5ffe7d1945c4154f6c9...6b80fc72e0ec7ad6b23382fe1f47a09e2b56cb8c,1,1,1,2,1,2013-10-29 14:57:42,2013-10-29 14:57:42
6b80fc72e0ec7ad6b23382fe1f47a09e2b56cb8c...866c51bf79610d8406c5016dd55bf28486201be2,1,15,5,20,8,2013-10-29 16:02:29,2013-10-28 20:53:34
866c51bf79610d8406c5016dd55bf28486201be2...2d14d3fd473713be56a634dc3d17ac46d85450e1,1,68,22,90,18,2013-10-29 16:02:29,2013-10-28 21:03:06
2d14d3fd473713be56a634dc3d17ac46d85450e1...1361ad0eacf7b924226d71aaab12e6f62e76e476,1,1,0,1,1,2013-10-29 16:36:46,2013-10-29 00:24:59
1361ad0eacf7b924226d71aaab12e6f62e76e476...2e10439eba106c1edd57522f6c549fccb245b1a0,88,164,157,321,125,2013-10-29 17:11:41,2013-09-26 01:59:42
2e10439eba106c1edd57522f6c549fccb245b1a0...4c21ddbe80d4e77c5f6ca6b4df405f4921c1000b,1,3,3,6,3,2013-10-29 18:19:30,2013-10-29 17:32:53
4c21ddbe80d4e77c5f6ca6b4df405f4921c1000b...a704c10f10d236b1ff1bc48549896ec6d9dd2ca3,1,9,1,10,2,2013-10-29 18:19:47,2013-10-29 18:19:47
a704c10f10d236b1ff1bc48549896ec6d9dd2ca3...97c3a3d2b487e9376d484d33ede2895e379a3033,1,1,0,1,1,2013-10-29 18:31:51,2013-10-29 18:27:21
97c3a3d2b487e9376d484d33ede2895e379a3033...826a1134be97f577c49a555b3192a9e48b74e7d4,2,4,1,5,2,2013-10-29 19:33:32,2013-10-28 23:40:58
826a1134be97f577c49a555b3192a9e48b74e7d4...7a72a514edc22bf24f689c8f5616731e479a1f48,4,4,6,10,6,2013-10-29 19:33:56,2013-10-28 23:35:30
7a72a514edc22bf24f689c8f5616731e479a1f48...11a9388c7d8aa00316eae0d62ad93a85e9f6b648,1,9,1,10,1,2013-10-29 21:23:09,2013-10-29 21:22:36
11a9388c7d8aa00316eae0d62ad93a85e9f6b648...83772eae23d31e06183e0c2e594b8935a30be3fb,3,12,7,19,7,2013-10-29 21:57:03,2013-10-29 16:33:19
83772eae23d31e06183e0c2e594b8935a30be3fb...04284234e1a353e68655382b26ef2998bd8f2bdc,11,547,32,579,24,2013-10-29 23:02:46,2013-10-24 19:22:28
04284234e1a353e68655382b26ef2998bd8f2bdc...69737f45ccf23fe218c0f8d51c060e8e988551bf,2,45,2,47,4,2013-10-29 23:42:21,2013-10-29 00:10:50
69737f45ccf23fe218c0f8d51c060e8e988551bf...8c37eeba9df4bdb392dad6c7b9b4632a28d5216c,1,2,2,4,2,2013-10-30 15:07:21,2013-10-30 15:07:21
8c37eeba9df4bdb392dad6c7b9b4632a28d5216c...9cdbbf0f2dd835cf1d316bac3a7e02e4bc2c84f3,9,27,0,27,9,2013-10-30 15:38:40,2013-10-29 22:51:18
9cdbbf0f2dd835cf1d316bac3a7e02e4bc2c84f3...e2b0c88ed2d50962d2f433fcfb85cb0262c16950,2,169,43,212,29,2013-10-30 15:43:46,2013-10-24 22:28:14
e2b0c88ed2d50962d2f433fcfb85cb0262c16950...6c36992cc9e2c505c54676afed9cce9d94e42428,1,55,28,83,11,2013-10-30 15:54:35,2013-10-29 23:11:44
6c36992cc9e2c505c54676afed9cce9d94e42428...6ba2b81c3260ad0f62a8b1f03ec6c99e51c0b35d,1,10,8,18,7,2013-10-30 17:30:36,2013-10-30 17:30:36
6ba2b81c3260ad0f62a8b1f03ec6c99e51c0b35d...d22a2f3e9541470deb294ab30e08dd0fc5d627df,1,5,1,6,1,2013-10-30 18:21:51,2013-10-30 15:37:58
d22a2f3e9541470deb294ab30e08dd0fc5d627df...a154946a48b3fea77747f810ff60dce734e9b0dd,2,19,24,43,13,2013-10-30 19:38:41,2013-10-30 19:38:16
a154946a48b3fea77747f810ff60dce734e9b0dd...67defc7ee10099e727a6091bbd0ff154e2908b00,35,923,481,1404,251,2013-10-30 20:07:48,2013-10-30 01:41:09
67defc7ee10099e727a6091bbd0ff154e2908b00...d8ed1f0d9475f55943515f23ca33a93c9fa64aba,1,6,0,6,2,2013-10-30 19:32:50,2013-10-30 19:01:20
d8ed1f0d9475f55943515f23ca33a93c9fa64aba...5d0005c6eb28fdeaacf0fa80c477863bb09d2898,1,2,2,4,2,2013-10-30 20:54:53,2013-10-30 20:54:49
5d0005c6eb28fdeaacf0fa80c477863bb09d2898...bfea19f2b68ad5fe5426b70f452d985b8a24f036,6,105,35,140,16,2013-10-30 21:03:47,2013-10-30 18:36:46
bfea19f2b68ad5fe5426b70f452d985b8a24f036...c63749eda51417e26bee88654845c689701bd919,2,108,3,111,10,2013-10-30 21:05:05,2013-10-29 22:11:12
c63749eda51417e26bee88654845c689701bd919...98fcff0c91c39794d37a08a86c37334406af2873,24,86,64,150,54,2013-10-30 21:02:41,2013-10-29 14:49:28
98fcff0c91c39794d37a08a86c37334406af2873...4089f1eb9ea9982558b19c206643405615fec5f2,1,18,0,18,4,2013-10-31 08:02:11,2013-10-24 19:10:46
4089f1eb9ea9982558b19c206643405615fec5f2...aaff692940fdf0a57f37d4e9b1d45d8203049647,1,11,1,12,3,2013-10-31 09:03:07,2013-10-31 08:19:10
aaff692940fdf0a57f37d4e9b1d45d8203049647...5c26124ba4a9829a417a8f652ce009eef0b98a72,4,32,6,38,7,2013-10-31 09:03:12,2013-10-31 08:23:42
5c26124ba4a9829a417a8f652ce009eef0b98a72...195c99e44a1483816b3be2a1f6f42bffed7ec18e,6,234,11,245,27,2013-10-31 09:06:25,2013-10-31 09:02:02
195c99e44a1483816b3be2a1f6f42bffed7ec18e...323abaca6f8168b4ff42d3fe08931e7fed3d0fc1,5,43,2,45,12,2013-10-31 10:16:32,2013-10-31 08:55:54
323abaca6f8168b4ff42d3fe08931e7fed3d0fc1...59c349c00ecd5de1adb18f398a63917c36c8334b,2,30,1,31,7,2013-10-31 10:16:32,2013-10-31 08:58:38
59c349c00ecd5de1adb18f398a63917c36c8334b...3fcc1206716d8a89b91a932b58fae059b8f750e6,3,32,9,41,5,2013-10-31 13:57:35,2013-10-18 17:30:46
3fcc1206716d8a89b91a932b58fae059b8f750e6...ab09b4d6369c8623d4d56248da899e685782d908,2,1,5,6,2,2013-10-31 13:57:35,2013-10-28 21:14:33
ab09b4d6369c8623d4d56248da899e685782d908...01afc9b2b1290f16c10c8d591affbdbe157a6d18,6,44,13,57,16,2013-10-31 13:57:35,2013-10-28 17:51:37
01afc9b2b1290f16c10c8d591affbdbe157a6d18...655598aba916197c260a88cc49978faf9b51a048,2,6,3,9,3,2013-10-31 14:03:37,2013-10-30 20:48:13
655598aba916197c260a88cc49978faf9b51a048...5743d6e7216f96bab55bb7bdd2c3ab33e7c415e7,1,1,3,4,2,2013-10-31 14:27:50,2013-10-30 19:54:05
5743d6e7216f96bab55bb7bdd2c3ab33e7c415e7...cc5320ccccb6faf2765ded034daee479abafc284,1,7,28,35,2,2013-10-31 14:39:52,2013-10-31 14:39:52
cc5320ccccb6faf2765ded034daee479abafc284...b76d47accaefb558d2e0e9175d53e991e74630b2,3,8,84,92,7,2013-10-31 17:37:07,2013-10-29 22:12:11
b76d47accaefb558d2e0e9175d53e991e74630b2...7efb2853b2b50225c748aa38a8c48a4ee7d47805,1,20,0,20,1,2013-10-31 18:26:46,2013-10-31 16:12:03
7efb2853b2b50225c748aa38a8c48a4ee7d47805...02d96b609930ce10ea82a4a317baf5731ed04989,1,1,0,1,1,2013-10-31 18:44:58,2013-10-31 18:41:03
02d96b609930ce10ea82a4a317baf5731ed04989...07a8845fbec58c90b642bb55060d05ad006719c3,4,6,5,11,4,2013-10-31 18:22:52,2013-10-31 18:03:43
07a8845fbec58c90b642bb55060d05ad006719c3...eab2644c221206c121ac1ab93fcf95c8100f4ff3,1,6,4,10,5,2013-10-31 19:33:04,2013-10-31 19:32:20
eab2644c221206c121ac1ab93fcf95c8100f4ff3...864fd719213c88720af58d17efb3ec969c87b4eb,4,28,28,56,20,2013-10-31 21:19:20,2013-10-31 19:48:32
864fd719213c88720af58d17efb3ec969c87b4eb...60b4b2ccebcace38b844ccfaf7cd4979d769dbd2,1,2,0,2,1,2013-10-31 22:44:17,2013-10-31 21:51:46
60b4b2ccebcace38b844ccfaf7cd4979d769dbd2...94879b490f786395624f221450d1bc2c5553441f,1,1,1,2,1,2013-10-31 23:12:58,2013-10-31 23:12:58
94879b490f786395624f221450d1bc2c5553441f...a6678a47b6e2700a502984cc1b990ded37f61c7f,1,4,4,8,8,2013-11-01 05:53:13,2013-11-01 05:53:13
a6678a47b6e2700a502984cc1b990ded37f61c7f...af91bd74e7ecbd06ecf20136fd7b06f8e8f4a49d,22,399,251,650,69,2013-11-01 14:10:03,2013-10-28 21:28:24
af91bd74e7ecbd06ecf20136fd7b06f8e8f4a49d...708f37e22b00e5705e333b7cf2179afea0e788a4,2,101,0,101,2,2013-11-01 15:10:13,2013-10-24 17:23:49
708f37e22b00e5705e333b7cf2179afea0e788a4...46bce060109df1272f10c3cff154a0a74dce450a,9,99,8,107,21,2013-11-01 15:23:13,2013-10-29 14:43:21
46bce060109df1272f10c3cff154a0a74dce450a...991e6a89e5b05b4c6adb5252cb7f803785742f8d,1,1,1,2,1,2013-11-01 15:29:22,2013-11-01 09:52:12
991e6a89e5b05b4c6adb5252cb7f803785742f8d...b9b626c584b02ae607beaf16a2c0d748ceec98e4,11,295,196,491,79,2013-11-01 16:56:29,2013-10-31 17:53:00
b9b626c584b02ae607beaf16a2c0d748ceec98e4...6b7d6962a9c8836c54e678d3dddb297c3c76089c,5,13,15,28,11,2013-11-01 18:24:04,2013-10-30 21:17:16
6b7d6962a9c8836c54e678d3dddb297c3c76089c...948ae1886077c520d5adc73840858d6bf79ca4af,1,2,2,4,2,2013-11-01 18:09:36,2013-11-01 18:05:04
948ae1886077c520d5adc73840858d6bf79ca4af...471bc7a3de80fae0551f164a4a0d51e2325cae30,1,2,2,4,2,2013-11-01 18:56:27,2013-11-01 17:59:25
471bc7a3de80fae0551f164a4a0d51e2325cae30...defb7631265b55f15c001393858f30e0bd388805,3,22,0,22,3,2013-11-01 20:13:34,2013-11-01 19:58:25
defb7631265b55f15c001393858f30e0bd388805...ce43f6c474d099f85b8dd02848ce4a1faecbc178,2,56,37,93,2,2013-11-01 20:19:38,2013-11-01 17:22:19
ce43f6c474d099f85b8dd02848ce4a1faecbc178...2171249d6e32178e13e712c53b166bae57b525da,1,1,1,2,1,2013-11-01 21:03:11,2013-11-01 20:45:23
2171249d6e32178e13e712c53b166bae57b525da...dde5ead47e54458c4629e59e8139cf4bb3bb1e3a,4,6,16,22,15,2013-11-01 21:23:16,2013-11-01 18:06:10
dde5ead47e54458c4629e59e8139cf4bb3bb1e3a...50030f55d08d5ffe6a10e76542487b1b989e4972,1,2,1,3,1,2013-11-01 21:45:16,2013-11-01 21:45:16
50030f55d08d5ffe6a10e76542487b1b989e4972...cc2e41be23c7052f28aa985b99e0c03a84017593,23,582,164,746,71,2013-11-02 14:19:06,2013-10-31 19:34:38
cc2e41be23c7052f28aa985b99e0c03a84017593...8f73459ac4c750f9aaa957ec2c6e6569df43d8e4,4,41,28,69,18,2013-11-02 17:19:53,2013-10-29 20:08:06
8f73459ac4c750f9aaa957ec2c6e6569df43d8e4...8bc2fd8c35414b99017068e68c505a2a1b14a2b2,3,10,9,19,7,2013-11-02 17:19:53,2013-10-30 13:53:25
8bc2fd8c35414b99017068e68c505a2a1b14a2b2...c83e2593e8ad68bd2ad09eaaa4e28df34d0da068,4,18,10,28,9,2013-11-02 17:19:54,2013-10-30 14:04:29
c83e2593e8ad68bd2ad09eaaa4e28df34d0da068...f4752b153a3294bd6dfbfb3b626526c7baf7f90e,8,103,70,173,40,2013-11-02 17:19:54,2013-10-30 20:36:01
f4752b153a3294bd6dfbfb3b626526c7baf7f90e...ac7b0f59ee5ee58a27d1927047426a2d0d354e4e,15,267,168,435,124,2013-11-02 17:31:16,2013-11-02 17:31:16
ac7b0f59ee5ee58a27d1927047426a2d0d354e4e...c030501eaa60f71deeb6ece0c5cb9a05476b57de,2,14,1,15,3,2013-11-02 18:03:16,2013-11-02 18:03:16
c030501eaa60f71deeb6ece0c5cb9a05476b57de...83e056702108e7693e58886a8364aaa036eb6edd,1,2,1,3,1,2013-11-03 00:07:36,2013-11-03 00:07:36
83e056702108e7693e58886a8364aaa036eb6edd...beaeb05efd7f70cb7885555be36d47b8beb2d2be,1,7,2,9,2,2013-11-03 16:49:29,2013-11-03 16:49:29
beaeb05efd7f70cb7885555be36d47b8beb2d2be...4c900822abedd44779eaf2e9b8679690e69f9750,1,1,1,2,1,2013-11-04 14:42:45,2013-10-31 00:20:44
4c900822abedd44779eaf2e9b8679690e69f9750...67bd639528d6d81c0a425c1889147fc25f97915e,15,207,42,249,47,2013-11-04 15:16:27,2013-11-01 14:35:06
67bd639528d6d81c0a425c1889147fc25f97915e...ec07ce4b09da2adedb8c0520f56a78cf7f78a562,2,9,5,14,6,2013-11-04 15:16:27,2013-11-01 15:40:34
ec07ce4b09da2adedb8c0520f56a78cf7f78a562...4506877ce60378c2d1359e534d4b4c5f0b3e8239,1,4,2,6,2,2013-11-04 15:40:13,2013-11-04 15:40:10
4506877ce60378c2d1359e534d4b4c5f0b3e8239...ccf75cf8300d5e050d524da82bdec03d8d6e303f,1,1,1,2,1,2013-11-04 15:42:59,2013-10-26 13:52:06
ccf75cf8300d5e050d524da82bdec03d8d6e303f...0b1f32bd5e8adf5e56396f001ac97d0200146ff6,9,211,20,231,28,2013-11-04 16:30:34,2013-10-24 19:06:44
0b1f32bd5e8adf5e56396f001ac97d0200146ff6...241715adf1185955466e44eb111e61bb8f92324e,1,2,1,3,3,2013-11-04 18:21:41,2013-11-04 17:12:29
241715adf1185955466e44eb111e61bb8f92324e...03b7aa34cb32861396d9040a91b2ff3e6f707d3f,2,51,5,56,12,2013-11-04 19:01:10,2013-10-30 18:45:22
03b7aa34cb32861396d9040a91b2ff3e6f707d3f...deed8cde1760734143524349a6d511494894b575,1,1,0,1,1,2013-11-04 19:47:46,2013-11-01 21:43:17
deed8cde1760734143524349a6d511494894b575...e4f1752b21a7f76ff569a426570f40531993379d,3,40,13,53,3,2013-11-04 19:49:32,2013-11-01 20:44:08
e4f1752b21a7f76ff569a426570f40531993379d...b42d0215a515a7851bee818595bc67c2e9a955c5,1,5,0,5,3,2013-11-04 21:14:09,2013-11-04 21:14:09
b42d0215a515a7851bee818595bc67c2e9a955c5...9e7a90df5dbfd7c4414df1a5391903dc8d8dfda7,1,20,20,40,15,2013-11-04 21:55:49,2013-11-04 21:42:29
9e7a90df5dbfd7c4414df1a5391903dc8d8dfda7...c521a14c9ce1a8cd642f0ea8801269daff1b74cc,2,45,45,90,18,2013-11-04 22:25:40,2013-10-31 20:54:08
c521a14c9ce1a8cd642f0ea8801269daff1b74cc...607c5a8364dcc14f6b775622f391240f66d7a8e5,4,69,113,182,9,2013-11-04 22:25:41,2013-10-31 21:16:10
607c5a8364dcc14f6b775622f391240f66d7a8e5...44680ab9835615856f144e9f027d91ef5b16682d,21,712,636,1348,39,2013-11-04 22:25:41,2013-10-31 22:35:31
44680ab9835615856f144e9f027d91ef5b16682d...d1f06420857ea4a3ed5b6f8ffd0304398cffa3cb,8,53,121,174,27,2013-11-04 22:25:41,2013-11-01 20:12:52
d1f06420857ea4a3ed5b6f8ffd0304398cffa3cb...bd3f07e2369a05bd97f1bae70800e9cb8c091113,4,2609,1465,4074,4,2013-11-04 23:45:04,2013-10-21 14:53:21
bd3f07e2369a05bd97f1bae70800e9cb8c091113...fc39d9cc80fe321686b8bf5626025fed5c2114d1,127,0,7323,7323,127,2013-11-05 01:34:06,2013-11-05 01:34:06
fc39d9cc80fe321686b8bf5626025fed5c2114d1...c2d573d82da78c4bd897029670189e300f3f59ee,2,9,21,30,5,2013-11-05 02:21:17,2013-11-05 02:21:17
c2d573d82da78c4bd897029670189e300f3f59ee...69a5c5c78c6281ec2a62e9dbf0f7f7b41dd8fd06,1,6,1,7,3,2013-11-05 14:05:20,2013-11-05 14:05:20
69a5c5c78c6281ec2a62e9dbf0f7f7b41dd8fd06...f7bdc39d13a4ee8415698dfd63a95961f7e80062,2,34,4,38,4,2013-11-05 15:46:36,2013-10-30 18:24:25
f7bdc39d13a4ee8415698dfd63a95961f7e80062...c18dfd852cb222a61f6393ebac6e6edf05c52386,2,60,9,69,8,2013-11-05 15:46:36,2013-10-31 21:56:50
c18dfd852cb222a61f6393ebac6e6edf05c52386...3d97d00c3a94283241210c0abc27eb0039093ae0,3,50,0,50,7,2013-11-05 17:39:00,2013-10-09 21:05:34
3d97d00c3a94283241210c0abc27eb0039093ae0...f46f05426f2da3fa396099c0c73c74de6de8c2d0,1,9,2,11,3,2013-11-05 18:24:35,2013-11-04 21:39:19
f46f05426f2da3fa396099c0c73c74de6de8c2d0...6fc17c30a8b88c778aa0d0a93c9f4145fbf0ba46,1,1,14,15,1,2013-11-05 19:02:46,2013-11-04 17:07:53
6fc17c30a8b88c778aa0d0a93c9f4145fbf0ba46...f7443bad6cafdb24940d2dc262f760e8a66cc950,1,1,1,2,1,2013-11-05 19:02:46,2013-11-04 17:12:07
f7443bad6cafdb24940d2dc262f760e8a66cc950...f02719c6b5bbe2f6c5ffba6f329d4c6f6a7ab9af,3,2,2,4,2,2013-11-05 20:11:48,2013-11-05 20:11:48
f02719c6b5bbe2f6c5ffba6f329d4c6f6a7ab9af...cd80af1cfb2fcd2284d4f2a902a84e7423cf0a58,1,12,1,13,1,2013-11-05 22:33:18,2013-11-05 22:20:21
cd80af1cfb2fcd2284d4f2a902a84e7423cf0a58...935d0a4c8203edf276520e499591db80c75432cf,12,14,14,28,13,2013-11-06 00:04:52,2013-11-04 14:53:24
935d0a4c8203edf276520e499591db80c75432cf...63b306be67be3cc73cc7ad174d2b576f0b1b0e5e,1,0,2,2,1,2013-11-06 00:04:52,2013-11-04 16:48:29
63b306be67be3cc73cc7ad174d2b576f0b1b0e5e...83750fbba020aa248ff50c57b6d4b70b3874c7e6,4,40,46,86,26,2013-11-06 00:04:52,2013-11-04 16:48:36
83750fbba020aa248ff50c57b6d4b70b3874c7e6...19147f5b100b45de8fc4597d5c2d207249625c4f,4,19,39,58,14,2013-11-06 00:04:52,2013-11-04 17:37:13
19147f5b100b45de8fc4597d5c2d207249625c4f...6611642ebe93a72fad82ebd65e0d52cf4f41c170,1,2,1,3,1,2013-11-06 00:04:52,2013-11-05 05:26:18
6611642ebe93a72fad82ebd65e0d52cf4f41c170...6d8c36fa3343b3bf9308357d7194bebff2f59ad1,4,20,14,34,7,2013-11-06 00:04:52,2013-11-05 20:58:55
6d8c36fa3343b3bf9308357d7194bebff2f59ad1...0f7bd3d2d308ea2c7c154977bde301c87129d0df,1,5,16,21,2,2013-11-06 00:04:52,2013-11-05 23:52:50
0f7bd3d2d308ea2c7c154977bde301c87129d0df...dcd569ac549275cd3b81642325f63001cb33cd64,12,267,283,550,78,2013-11-06 15:01:33,2013-11-01 20:24:55
dcd569ac549275cd3b81642325f63001cb33cd64...1cf65f1b1f63784033ea21d7cd656c6ee961e6f1,1,5,3,8,3,2013-11-06 15:56:25,2013-11-06 15:56:25
1cf65f1b1f63784033ea21d7cd656c6ee961e6f1...049f439ea3c8153d3f46663462c70bdf8f1fb602,1,1,1,2,1,2013-11-06 16:39:33,2013-11-06 15:55:56
049f439ea3c8153d3f46663462c70bdf8f1fb602...7bedc9e99f109dfad50af2c792e358f78abd5812,1,7,10,17,1,2013-11-06 17:09:47,2013-10-31 18:51:30
7bedc9e99f109dfad50af2c792e358f78abd5812...68c52f54dc4d81673b01c9964dfec3eed10de5a0,10,224,136,360,67,2013-11-06 17:29:08,2013-10-30 21:47:19
68c52f54dc4d81673b01c9964dfec3eed10de5a0...662dcd9962a3665ccafb9c862e025c53054f4235,4,54,32,86,26,2013-11-06 18:20:22,2013-11-05 21:33:02
662dcd9962a3665ccafb9c862e025c53054f4235...2554888623373de8da4c8fb045acb4eaa294fa3b,1,19,21,40,11,2013-11-06 19:11:48,2013-11-06 18:20:43
2554888623373de8da4c8fb045acb4eaa294fa3b...292ea3dff8107bb86ba0c88e8b94964080bcc926,3,8,10,18,3,2013-11-06 19:23:51,2013-11-06 17:50:11
292ea3dff8107bb86ba0c88e8b94964080bcc926...4ace30d39c3ebc9bc7044e9dac69041c2d83c2af,1,4,3,7,2,2013-11-06 19:24:37,2013-11-06 19:23:48
4ace30d39c3ebc9bc7044e9dac69041c2d83c2af...b79c42855e9c9b8a95a6137b9486f95810d0036d,10,195,95,290,22,2013-11-06 19:33:04,2013-11-04 19:37:19
b79c42855e9c9b8a95a6137b9486f95810d0036d...d7d128468f1f6ecd68eb3ae6f8ddda74082e7706,4,273,3,276,6,2013-11-06 19:38:26,2013-10-19 17:32:22
d7d128468f1f6ecd68eb3ae6f8ddda74082e7706...9d9598668bbcf658b257b4d5e858e286be4148f1,1,35,42,77,7,2013-11-06 20:18:08,2013-11-06 14:30:02
9d9598668bbcf658b257b4d5e858e286be4148f1...573560edeb1bced0bd9d3202d93a986dd5d6344c,2,21,6,27,3,2013-11-06 20:18:08,2013-11-06 15:42:17
573560edeb1bced0bd9d3202d93a986dd5d6344c...ba752b46d1cce09b1462580639459743cc56bfe8,3,1,27,28,7,2013-11-06 20:18:08,2013-11-06 15:53:52
ba752b46d1cce09b1462580639459743cc56bfe8...25aad028837244924cb32a30b214d209018b50e5,1,5,3,8,2,2013-11-06 20:18:08,2013-11-06 19:50:23
25aad028837244924cb32a30b214d209018b50e5...68abb897ed83b12b99bbf322f91d6343e778ee05,5,123,125,248,13,2013-11-06 20:19:16,2013-11-06 20:11:59
68abb897ed83b12b99bbf322f91d6343e778ee05...fe3eabdf8126f975594048b3df33ec023af70cb9,1,18,6,24,6,2013-11-06 20:19:16,2013-11-06 20:17:18
fe3eabdf8126f975594048b3df33ec023af70cb9...985037fb56f20b5fb2733b5b143bfa303e1938bc,1,0,4,4,1,2013-11-06 20:24:32,2013-11-06 20:24:32
985037fb56f20b5fb2733b5b143bfa303e1938bc...f2ae6a0732ce5fdfe1a2aac8f2fc12e5a04a650c,1,1,1,2,1,2013-11-06 20:48:39,2013-11-06 20:14:56
f2ae6a0732ce5fdfe1a2aac8f2fc12e5a04a650c...49fd6dbb2b6d9432cb4d94aaf3e06ca6943042d6,56,159,139,298,100,2013-11-06 22:11:39,2013-11-06 19:49:35
49fd6dbb2b6d9432cb4d94aaf3e06ca6943042d6...341f5785ce158c2889ec36b5938d4a3c11efe96e,2,66,9,75,13,2013-11-06 23:07:40,2013-11-04 23:27:19
341f5785ce158c2889ec36b5938d4a3c11efe96e...1ca5a7f1107f709d62de4f14e04ebb2b63ac2de5,1,2,0,2,2,2013-11-06 23:51:35,2013-11-06 22:43:32
1ca5a7f1107f709d62de4f14e04ebb2b63ac2de5...5f695995bda5b9a51c813a5f571a785f2bf3101f,1,2,0,2,1,2013-11-07 00:10:19,2013-11-01 15:24:46
5f695995bda5b9a51c813a5f571a785f2bf3101f...ca5b94c240863d20b2eaa341d9242624c9452822,3,13,3,16,6,2013-11-07 00:13:14,2013-11-01 18:09:40
ca5b94c240863d20b2eaa341d9242624c9452822...9766387567e366e167835880818369cee7f8d42d,1,9,3,12,2,2013-11-07 00:02:49,2013-10-24 18:47:48
9766387567e366e167835880818369cee7f8d42d...1b25233a587cec21dbfe6f6ecc24bd5da9a249a3,2,8,3,11,2,2013-11-07 14:14:27,2013-11-06 22:19:46
1b25233a587cec21dbfe6f6ecc24bd5da9a249a3...47c06933a4b2a7cb4b89b5ba3c6204615b49b1f2,3,42,24,66,17,2013-11-07 14:14:28,2013-11-06 22:20:28
47c06933a4b2a7cb4b89b5ba3c6204615b49b1f2...63fc8dcbb67b2dd7773b3f189c4eb0c32b649943,1,1,1,2,1,2013-11-07 14:14:29,2013-11-06 22:55:40
63fc8dcbb67b2dd7773b3f189c4eb0c32b649943...96e763793b5e9b1f08ac00de37b095466d846981,1,3,1,4,1,2013-11-07 14:14:29,2013-11-06 22:55:59
96e763793b5e9b1f08ac00de37b095466d846981...2307d854227d1929e8a1c5a89fac0e22688325e1,1,12,11,23,6,2013-11-07 14:14:30,2013-11-06 22:57:26
2307d854227d1929e8a1c5a89fac0e22688325e1...ee147e8c6b75ea83143c5d5659fbf6f367c93ba9,1,9,9,18,8,2013-11-07 16:17:47,2013-11-07 16:17:35
ee147e8c6b75ea83143c5d5659fbf6f367c93ba9...75fdb3e7312adcf187985a90e3c6f3700be1c20e,1,17,2,19,1,2013-11-07 17:03:51,2013-11-07 17:03:09
75fdb3e7312adcf187985a90e3c6f3700be1c20e...75c757d5818e598ee8d2083e5eaa212ce8b088bc,1,2,0,2,1,2013-11-07 18:15:52,2013-11-07 18:15:52
75c757d5818e598ee8d2083e5eaa212ce8b088bc...0622abaebbbc6bda7de0598ab91444e5d1887572,6,72,2,74,7,2013-11-07 18:44:53,2013-11-07 18:44:53
0622abaebbbc6bda7de0598ab91444e5d1887572...cf0103d736d93d14f1b3eaa7fe3e97a2c77a8080,3,9,3,12,5,2013-11-07 22:14:46,2013-11-07 22:14:46
cf0103d736d93d14f1b3eaa7fe3e97a2c77a8080...fb7dfc56527680bd386de0a2024f7a2bfd216ad1,3,22,2,24,5,2013-11-08 00:44:09,2013-11-08 00:42:22
fb7dfc56527680bd386de0a2024f7a2bfd216ad1...222862b67b7cf49075e72457808d297d8438f5d0,31,898,499,1397,86,2013-11-08 13:59:34,2013-11-06 19:29:30
222862b67b7cf49075e72457808d297d8438f5d0...9670309358767dc1ce7325dda76cc21323573061,3,94,11,105,6,2013-11-08 13:59:53,2013-11-07 20:21:11
9670309358767dc1ce7325dda76cc21323573061...05460998feedfc74bac1406ffc7431e7a17998a1,3,12,3,15,5,2013-11-08 13:59:53,2013-11-07 20:38:13
05460998feedfc74bac1406ffc7431e7a17998a1...b8fd0b30946d0e1599cb730c155a01a25e572f24,7,139,17,156,18,2013-11-08 15:02:13,2013-11-01 17:02:54
b8fd0b30946d0e1599cb730c155a01a25e572f24...dd0857bd037487c65b12113f042510b88c08bea4,7,119,35,154,22,2013-11-08 15:11:58,2013-11-07 15:17:57
dd0857bd037487c65b12113f042510b88c08bea4...b6c8f3bc6bfb11c15d0b6708ca7bc0dfe584a39f,1,13,0,13,1,2013-11-08 16:02:21,2013-11-08 15:46:16
b6c8f3bc6bfb11c15d0b6708ca7bc0dfe584a39f...c9d07bdb8f92ec72c9ca8ddf6db821a2e087b3d0,1,1,1,2,1,2013-11-08 16:41:55,2013-11-07 17:19:27
c9d07bdb8f92ec72c9ca8ddf6db821a2e087b3d0...490ffed0e9aaad65ff421a3e620d8eee7e68b686,2,5,5,10,4,2013-11-08 19:12:21,2013-11-06 23:33:28
490ffed0e9aaad65ff421a3e620d8eee7e68b686...0ba4291e45869b93709f3137b859e265b773f480,2,0,74,74,6,2013-11-08 19:22:13,2013-11-07 15:17:42
0ba4291e45869b93709f3137b859e265b773f480...3bb685079761a085b4ab7e7047251ef06fe62532,3,72,298,370,36,2013-11-08 19:22:13,2013-11-07 15:16:49
3bb685079761a085b4ab7e7047251ef06fe62532...d0fa8b74df7c4a5d1ac897110610d6582f17556b,9,111,241,352,47,2013-11-08 19:22:14,2013-11-07 15:32:59
d0fa8b74df7c4a5d1ac897110610d6582f17556b...33f16ec7ed5faf0f5bcf8e6677447a8024f0e7f7,8,590,452,1042,45,2013-11-08 19:22:14,2013-11-07 16:56:08
33f16ec7ed5faf0f5bcf8e6677447a8024f0e7f7...e392f087336daac43b2e52ffc83a5be7663feef6,1,13,39,52,13,2013-11-08 19:22:14,2013-11-07 20:10:28
e392f087336daac43b2e52ffc83a5be7663feef6...27ab5af194c5702c41bea72e75274935dd8519e8,2,0,16,16,8,2013-11-08 19:38:41,2013-11-06 23:50:16
27ab5af194c5702c41bea72e75274935dd8519e8...ea1d6a8a9e21a70ff57bda7ca47197ab58d3e7a9,1,4,0,4,1,2013-11-08 20:20:03,2013-11-08 20:20:03
ea1d6a8a9e21a70ff57bda7ca47197ab58d3e7a9...c5682b4510724fe275a20476fd23667025844d93,2,3,4,7,5,2013-11-08 21:08:28,2013-11-06 23:22:38
c5682b4510724fe275a20476fd23667025844d93...931141bdacd66ea0b94adbffbb5cb954d377016e,9,73,58,131,28,2013-11-09 05:18:39,2013-11-08 14:50:18
931141bdacd66ea0b94adbffbb5cb954d377016e...6d2efe67384417124291f0dc2eb8a29f24bf7d97,5,28,32,60,21,2013-11-09 05:18:39,2013-11-08 15:13:07
6d2efe67384417124291f0dc2eb8a29f24bf7d97...be549eef41a9fbffc3841724c8c9f9e0eb935dcf,1,0,5,5,3,2013-11-09 05:18:39,2013-11-08 17:35:11
be549eef41a9fbffc3841724c8c9f9e0eb935dcf...3ea5ba78bb5527d0505e8436e4905c884122e2f6,3,12,9,21,4,2013-11-09 05:18:39,2013-11-08 18:21:52
3ea5ba78bb5527d0505e8436e4905c884122e2f6...a8c350b746f68f2d2ad289aedeaeca1aa0a5a2f4,1,3,1,4,2,2013-11-09 05:18:39,2013-11-08 18:38:21
a8c350b746f68f2d2ad289aedeaeca1aa0a5a2f4...55d9adbec9de4bcbeda165bb910c898ab07c45eb,5,85,61,146,18,2013-11-09 05:18:39,2013-11-08 19:44:31
55d9adbec9de4bcbeda165bb910c898ab07c45eb...08e3c3597ffa2d301c2be9a05e455cbd839e4bf5,3,15,11,26,5,2013-11-09 05:18:39,2013-11-09 02:28:15
08e3c3597ffa2d301c2be9a05e455cbd839e4bf5...794372e39010b1a5ec0c783425760a7e252578c7,5,26,26,52,15,2013-11-09 05:18:39,2013-11-09 02:42:52
794372e39010b1a5ec0c783425760a7e252578c7...d5d401401a77ae3a8da4fe6e97a7308d2e9eeb71,3,6,2,8,3,2013-11-09 05:18:39,2013-11-09 05:18:24
d5d401401a77ae3a8da4fe6e97a7308d2e9eeb71...9f1ee9e89ca05ba2dd5dcd4f43a4bad1cbe9ec74,1,8,8,16,2,2013-11-09 16:43:24,2013-11-08 16:59:16
9f1ee9e89ca05ba2dd5dcd4f43a4bad1cbe9ec74...e5da694cb5e24734d07bf676fcb506e6e5e22acb,2,2,5,7,2,2013-11-09 20:14:10,2013-11-09 20:13:42
e5da694cb5e24734d07bf676fcb506e6e5e22acb...fcd5d158870368b6957fa0f2db9f58a5559a14be,2,3,6,9,5,2013-11-09 20:48:43,2013-11-03 14:13:32
fcd5d158870368b6957fa0f2db9f58a5559a14be...3d28d63ec6fb6f285d279b529f945f43ec3b2b48,4,16,11,27,6,2013-11-09 20:48:43,2013-11-03 14:37:19
3d28d63ec6fb6f285d279b529f945f43ec3b2b48...151237b24af3a2f5a2a2076b651f4e5745cc45f9,7,6,29,35,13,2013-11-09 20:48:43,2013-11-05 02:48:32
151237b24af3a2f5a2a2076b651f4e5745cc45f9...989fd71aa5931a61f2028e51b3ffc2b144cd9cfa,7,25,74,99,10,2013-11-09 20:48:44,2013-11-05 03:42:10
989fd71aa5931a61f2028e51b3ffc2b144cd9cfa...8763f2868b3c1470ebfdb8490370c7cb1ee40301,12,232,52,284,38,2013-11-09 23:20:08,2013-11-08 20:03:15
8763f2868b3c1470ebfdb8490370c7cb1ee40301...3256b1812830868858753b361939b5deb084dee5,20,438,131,569,91,2013-11-09 23:20:08,2013-11-08 21:21:29
3256b1812830868858753b361939b5deb084dee5...791e4d4b5d614ed13cc3eb67369aee83219d5baa,1,13,4,17,3,2013-11-10 19:05:05,2013-11-10 15:29:53
791e4d4b5d614ed13cc3eb67369aee83219d5baa...3c707bd5a995776d70cc740a0c7220c5986aacde,9,170,31,201,25,2013-11-10 21:57:12,2013-11-08 18:59:11
3c707bd5a995776d70cc740a0c7220c5986aacde...be7406205df94a74b25e628e9ec04dd9fab8dacf,6,39,18,57,13,2013-11-11 14:51:13,2013-11-07 22:51:29
be7406205df94a74b25e628e9ec04dd9fab8dacf...fe59d4249bfd65fd05a86203e6de8ab0c0d3a8ef,3,21,6,27,8,2013-11-11 14:51:18,2013-11-10 21:48:34
fe59d4249bfd65fd05a86203e6de8ab0c0d3a8ef...4e4a746769a899bbfb2daaf262dfb341da09e24b,1,8,0,8,2,2013-11-11 16:34:37,2013-10-30 18:25:38
4e4a746769a899bbfb2daaf262dfb341da09e24b...c843789db1438098fadbc2db53563646f411b8e0,1,1,1,2,1,2013-11-11 16:36:29,2013-11-05 03:41:16
c843789db1438098fadbc2db53563646f411b8e0...fae554af51a26a54eed54a5884a1d94a564a5b4b,1,67,11,78,4,2013-11-11 17:09:03,2013-11-07 19:31:41
fae554af51a26a54eed54a5884a1d94a564a5b4b...b358e6f40d6cc8895fef55379b5a0040cf46e6e3,5,145,89,234,40,2013-11-11 17:09:03,2013-11-08 20:53:38
b358e6f40d6cc8895fef55379b5a0040cf46e6e3...2b665282f23903c963f4c0f9c0c6cc355246722a,1,5,1,6,2,2013-11-11 19:49:35,2013-11-10 13:47:39
2b665282f23903c963f4c0f9c0c6cc355246722a...dd2ef77cb39b02afd7fc346cdc894af384860960,1,1,0,1,1,2013-11-11 19:50:26,2013-11-11 16:50:13
dd2ef77cb39b02afd7fc346cdc894af384860960...268f85261996bf51781bfce3c5ca6efb07587c22,8,251,48,299,25,2013-11-11 21:16:27,2013-11-08 00:44:31
268f85261996bf51781bfce3c5ca6efb07587c22...8826cba78c4b75cb31a21c1f34002d23a611601b,2,21,1,22,6,2013-11-11 21:17:43,2013-11-11 19:26:45
8826cba78c4b75cb31a21c1f34002d23a611601b...b3af50b16b97b1db9711e8fa8ece33d3e001566b,3,12,1,13,3,2013-11-11 21:37:19,2013-11-07 22:23:42
b3af50b16b97b1db9711e8fa8ece33d3e001566b...a2dbf35932d0cdd1fe54eb11a36f9bcde60b7333,4,24,11,35,9,2013-11-11 22:06:14,2013-11-08 18:47:08
a2dbf35932d0cdd1fe54eb11a36f9bcde60b7333...93f76a53ba6e6c779604c1bfb0581b69c86a0c4f,53,120,120,240,92,2013-11-11 23:11:07,2013-11-11 23:02:26
93f76a53ba6e6c779604c1bfb0581b69c86a0c4f...2c0c5469ed59701a6c5ac676eab019cf56267b2e,2,89,0,89,3,2013-11-12 03:27:53,2013-11-11 18:58:18
2c0c5469ed59701a6c5ac676eab019cf56267b2e...d0043ed509ff27707dc158259f00515a72fd343c,1,87,48,135,8,2013-11-12 04:13:17,2013-11-11 22:50:23
d0043ed509ff27707dc158259f00515a72fd343c...45155a897e1060cffc83ac9f49d0d17e062d3d24,1,1,0,1,1,2013-11-12 13:05:24,2013-11-12 13:05:24
45155a897e1060cffc83ac9f49d0d17e062d3d24...b5d36ec05cd4f22e02a8b4143954980946710648,16,424,25,449,43,2013-11-13 08:50:07,2013-11-12 19:02:22
b5d36ec05cd4f22e02a8b4143954980946710648...4a3c57f5d2e5295cd4d93609b06743f6f153405b,1,7,2,9,2,2013-11-12 14:24:41,2013-11-12 13:59:57
a1c04c3377a3d9b9a586db49b868bbd57d2c8201...b7434b66409c8d4515b94d3d7e647cf68b2c46ec,2,3,8,11,5,2013-11-12 14:31:52,2013-11-06 15:57:28
b7434b66409c8d4515b94d3d7e647cf68b2c46ec...11db6a808ca368c5b596ff0e4066de599b912439,4,61,45,106,16,2013-11-12 16:57:25,2013-11-11 22:42:25
11db6a808ca368c5b596ff0e4066de599b912439...bd4ee11df9d41eaeceed2ef2bf5454276ab8cfa5,3,521,8,529,21,2013-11-12 16:59:38,2013-11-07 18:41:19
bd4ee11df9d41eaeceed2ef2bf5454276ab8cfa5...cdc26b4613526d0dc9e389c581cb8243955a76e1,5,86,0,86,5,2013-11-12 16:59:38,2013-11-08 23:32:48
cdc26b4613526d0dc9e389c581cb8243955a76e1...f4946ff4166a830e204ab14653d88996542770b4,1,3,3,6,3,2013-11-12 17:54:54,2013-11-12 17:54:54
f4946ff4166a830e204ab14653d88996542770b4...e2f1d1b750d6dca8680c7792fbd008bce9a1aa88,1,0,7,7,1,2013-11-12 18:24:08,2013-11-12 18:24:08
e2f1d1b750d6dca8680c7792fbd008bce9a1aa88...530c21a9f87b971aa149e80af778fa48473b7e75,1,1,1,2,1,2013-11-12 18:41:56,2013-11-12 18:35:02
530c21a9f87b971aa149e80af778fa48473b7e75...fbff6ad5d9e10ed0c40042e90759f9e74e73d892,1,12,0,12,1,2013-11-12 19:11:35,2013-11-12 18:51:26
fbff6ad5d9e10ed0c40042e90759f9e74e73d892...47cacf3a19f9b15fe5f586483b3f3992bb12e7bf,1,3,0,3,1,2013-11-12 19:53:13,2013-11-12 19:24:56
47cacf3a19f9b15fe5f586483b3f3992bb12e7bf...5c6545d9345a85f03d36dbbd91f986d6d5e2f1b9,3,533,0,533,3,2013-11-12 20:26:36,2013-11-12 00:15:22
5c6545d9345a85f03d36dbbd91f986d6d5e2f1b9...4e630a02a7a10be9767891886b63c1cf79c7e625,8,28,47,75,35,2013-11-12 20:55:07,2013-11-01 19:08:49
4e630a02a7a10be9767891886b63c1cf79c7e625...a0c23d9a57b6af51dee4aa8acbe431c800b484e4,2,66,36,102,17,2013-11-12 21:14:25,2013-11-09 01:44:10
a0c23d9a57b6af51dee4aa8acbe431c800b484e4...d82aeea13e826352932cbfa10c683529e53208bd,2,170,0,170,2,2013-11-12 21:14:25,2013-11-12 20:05:01
d82aeea13e826352932cbfa10c683529e53208bd...0be500e771b210650741d5b5783896d4dff2679a,12,133,1,134,12,2013-11-13 16:16:12,2013-11-13 10:54:50
0be500e771b210650741d5b5783896d4dff2679a...456a72d926b1e4d44635533bc1e6e5a152661b71,1,0,6,6,4,2013-11-12 21:26:02,2013-11-12 17:01:56
456a72d926b1e4d44635533bc1e6e5a152661b71...70358fafe17252c983eaed5e95bfb70ca24522d3,2,2,2,4,2,2013-11-12 22:15:02,2013-11-12 21:26:27
70358fafe17252c983eaed5e95bfb70ca24522d3...613d8b223c9568672b244ee80ae5eb01e191b939,3,3,0,3,3,2013-11-12 22:27:15,2013-11-12 22:27:15
613d8b223c9568672b244ee80ae5eb01e191b939...47499ce5427e190d76eea978f8e212d9b71f05b0,2,37,26,63,10,2013-11-13 00:08:06,2013-11-11 22:47:36
47499ce5427e190d76eea978f8e212d9b71f05b0...98f35d3ff6e4b6b547618eae26936e69ebff45c0,1,8,1,9,1,2013-11-13 00:08:06,2013-11-05 21:52:02
98f35d3ff6e4b6b547618eae26936e69ebff45c0...e4a1f917ad7a808e70018079ba1dac6d75831833,3,91,1,92,5,2013-11-13 00:08:06,2013-10-21 19:45:24
e4a1f917ad7a808e70018079ba1dac6d75831833...74b59951d5a4f1ed454b8e328725bdd27a3124a5,1,12,4,16,6,2013-11-13 00:08:06,2013-10-24 16:13:27
74b59951d5a4f1ed454b8e328725bdd27a3124a5...6d9a3302fde4b89ecf9458450383b2abf20c82a9,2,11,10,21,3,2013-11-13 00:08:06,2013-10-24 20:04:40
6d9a3302fde4b89ecf9458450383b2abf20c82a9...7ed038d3a009c4ee55699b825d5dab207157de85,1,0,4,4,1,2013-11-13 00:08:06,2013-10-21 18:32:15
7ed038d3a009c4ee55699b825d5dab207157de85...dd6c8449c0d3be8a66fa8446caed5b9071765dc2,2,27,3,30,3,2013-11-13 00:08:06,2013-11-04 20:32:18
dd6c8449c0d3be8a66fa8446caed5b9071765dc2...0588759bcbdf8481fe01ea90986f17059c18a7fe,2,17,2,19,5,2013-11-13 00:08:06,2013-10-24 22:44:13
0588759bcbdf8481fe01ea90986f17059c18a7fe...1c05609c89ecb6c53787d05d01cdf1b2e4acdada,1,10,2,12,5,2013-11-13 00:08:06,2013-10-30 17:43:37
1c05609c89ecb6c53787d05d01cdf1b2e4acdada...3da9897c064711734d161bc38ee637734cc759fa,1,10,5,15,6,2013-11-13 00:08:06,2013-11-12 17:43:30
3da9897c064711734d161bc38ee637734cc759fa...ef9a27f0feaa44ad4f897e49a52c9b755cf3d496,1,1,1,2,1,2013-11-13 07:54:32,2013-11-13 07:54:32
ef9a27f0feaa44ad4f897e49a52c9b755cf3d496...075ff3c615cc9c53aab272af32a180d9f1ceda4a,26,567,90,657,75,2013-11-13 08:46:19,2013-11-13 08:46:19
075ff3c615cc9c53aab272af32a180d9f1ceda4a...d6ed1e86a1ec84cad7bb4980627a8ac034b73aa0,11,805,61,866,46,2013-11-13 14:50:59,2013-11-11 17:08:27
d6ed1e86a1ec84cad7bb4980627a8ac034b73aa0...b4d54124ca66f1cdc248ae9dc542fae35f636f83,1,12,38,50,10,2013-11-13 16:14:43,2013-11-13 16:14:11
b4d54124ca66f1cdc248ae9dc542fae35f636f83...aa8b52b8c50d2186ea58d4972b875f275f53b56e,1,2,1,3,1,2013-11-13 17:03:17,2013-11-13 17:03:17
aa8b52b8c50d2186ea58d4972b875f275f53b56e...cf79f24096a017c2290f7524997813b266e09d71,2,9,5,14,3,2013-11-13 18:07:37,2013-11-12 18:35:38
cf79f24096a017c2290f7524997813b266e09d71...c2036cf47e4b771bc455a1a3c02256b541874f4f,8,63,67,130,27,2013-11-13 18:07:37,2013-11-12 19:39:37
c2036cf47e4b771bc455a1a3c02256b541874f4f...3b742225a7db2ad9a2e10dbe8efefbc0d7a6757b,1,2,2,4,2,2013-11-13 18:11:00,2013-11-13 18:11:00
3b742225a7db2ad9a2e10dbe8efefbc0d7a6757b...f798fa7be0594b64f86c8c18573e133337680858,2,0,11,11,2,2013-11-13 18:25:25,2013-11-13 18:25:25
f798fa7be0594b64f86c8c18573e133337680858...748093d2e57af5e6e2205546dc31d39a32af123b,13,215,50,265,46,2013-11-13 19:13:00,2013-11-05 22:35:32
748093d2e57af5e6e2205546dc31d39a32af123b...6e793a146df74a641f294618e560bf541796f3e0,2,4,2,6,2,2013-11-13 20:18:48,2013-11-13 20:18:36
6e793a146df74a641f294618e560bf541796f3e0...c2892bbb48a4e63a4dbce9c30daadcbfb0c72647,1,1,1,2,1,2013-11-13 20:56:50,2013-11-13 20:56:45
c2892bbb48a4e63a4dbce9c30daadcbfb0c72647...a92a78e2bb9e0444ff256896ec2e86f7edb31c10,1,6,3,9,3,2013-11-13 21:33:47,2013-11-13 20:00:14
a92a78e2bb9e0444ff256896ec2e86f7edb31c10...38edfba653196620516bb8d4949b62ce011ffe94,2,6,71,77,5,2013-11-13 21:40:11,2013-11-13 17:37:15
38edfba653196620516bb8d4949b62ce011ffe94...0a1c8c986f31f49c4d878c3819fe10608f4b2b06,2,0,9,9,2,2013-11-13 21:12:08,2013-11-13 20:52:51
0a1c8c986f31f49c4d878c3819fe10608f4b2b06...c9168762e4870e2305143aeb3aee462f7a3bbc5d,97,10794,224,11018,111,2013-11-13 21:46:49,2013-11-09 20:38:08
c9168762e4870e2305143aeb3aee462f7a3bbc5d...e997b559cf4958e735bccb1b59ab029f20427f68,2,276,0,276,2,2013-11-13 22:07:49,2013-11-13 22:07:49
e997b559cf4958e735bccb1b59ab029f20427f68...94749ae43fa3c8bbd532ad46f29dbbf063de9eb3,3,85,34,119,12,2013-11-13 22:09:19,2013-11-12 19:41:18
94749ae43fa3c8bbd532ad46f29dbbf063de9eb3...ceecafadac2206dc402bcd5fe2a88625d3037202,1,44,13,57,9,2013-11-13 22:11:43,2013-10-29 21:22:57
ceecafadac2206dc402bcd5fe2a88625d3037202...4290019980d65512b764c62512a61bc8c646779c,4,15,273,288,17,2013-11-13 22:18:56,2013-11-13 22:06:50
4290019980d65512b764c62512a61bc8c646779c...da0da30a91a035a68427e30793c27492df9cc022,2,14,6,20,3,2013-11-13 22:46:19,2013-11-13 18:59:51
da0da30a91a035a68427e30793c27492df9cc022...7688ccdf103191f89ed3c285889f9264dba48d8a,2,34,18,52,15,2013-11-13 22:59:35,2013-10-30 19:56:28
7688ccdf103191f89ed3c285889f9264dba48d8a...4d5ba6b01fa2d38640ba5bc8bf5c99f305e619bf,17,382,68,450,70,2013-11-14 00:01:57,2013-11-08 23:02:05
4d5ba6b01fa2d38640ba5bc8bf5c99f305e619bf...f85ceb17b37210eef71e8113162c41368bfd5c12,2,17,0,17,3,2013-11-14 00:04:42,2013-11-13 23:46:59
f85ceb17b37210eef71e8113162c41368bfd5c12...9030cdfa8707c06b3f8ad9dfb635c2244abcc84e,1,63,0,63,2,2013-11-14 19:11:40,2013-11-14 16:14:50
9030cdfa8707c06b3f8ad9dfb635c2244abcc84e...914602bfd51a6a9e83d24abe6e293c749c09c7e0,7,133,30,163,16,2013-11-14 19:11:40,2013-11-14 18:34:21
914602bfd51a6a9e83d24abe6e293c749c09c7e0...a87e0ed4ec30725e3ffd7de75c0f204ca0f42b45,2,34,15,49,13,2013-11-14 00:19:58,2013-11-13 07:53:33
a87e0ed4ec30725e3ffd7de75c0f204ca0f42b45...b98712c551e8ab27c33e1a5e7c694fa36c3334ce,49,1284,1061,2345,226,2013-11-14 00:30:18,2013-11-07 17:42:20
b98712c551e8ab27c33e1a5e7c694fa36c3334ce...e6f797347a3cf235f8948ff8bfca49855ee5b052,3,148,49,197,18,2013-11-14 00:30:18,2013-11-13 23:11:59
e6f797347a3cf235f8948ff8bfca49855ee5b052...31eba1a06f997491189f3eeade642b02ada85627,7,204,99,303,93,2013-11-14 00:34:28,2013-10-21 22:50:44
31eba1a06f997491189f3eeade642b02ada85627...06cfa88df67067b7e8108b283a604f0e9169d0a3,3,146,53,199,43,2013-11-14 00:44:38,2013-10-22 17:14:56
06cfa88df67067b7e8108b283a604f0e9169d0a3...1f9ac013237d1b6ba2fa17769d6dac59e515f373,8,132,121,253,113,2013-11-14 00:44:41,2013-10-22 17:46:42
1f9ac013237d1b6ba2fa17769d6dac59e515f373...9f5101d6e90e1da2b76423bf2f066107639ba4e0,8,218,117,335,78,2013-11-14 00:44:41,2013-10-22 20:30:56
9f5101d6e90e1da2b76423bf2f066107639ba4e0...8041835681df6b4b7b606aa45f979e274cacbe5d,23,76,76,152,52,2013-11-14 19:55:55,2013-11-14 19:08:35
8041835681df6b4b7b606aa45f979e274cacbe5d...d0c460291f467ac144dbe39102b6d13d51ea38c3,1,4,2,6,3,2013-11-14 03:53:41,2013-11-14 00:27:31
d0c460291f467ac144dbe39102b6d13d51ea38c3...b88b6e6c6e783d10bf3f73f4778f45cbe848cff6,4,136,78,214,18,2013-11-14 03:56:57,2013-11-13 18:08:58
b88b6e6c6e783d10bf3f73f4778f45cbe848cff6...423a65720edb43703cca9aef04592c709afbd9b7,6,49,20,69,6,2013-11-14 04:30:02,2013-11-14 04:29:54
423a65720edb43703cca9aef04592c709afbd9b7...48268f23932ed93e69054eaa7e34b8d9c79a8008,2,4,2,6,4,2013-11-14 12:05:28,2013-11-14 12:05:28
48268f23932ed93e69054eaa7e34b8d9c79a8008...9a28a092d50eeb1bd45815b256f0180044a5c588,1,10,9,19,2,2013-11-14 13:00:09,2013-11-14 13:00:09
9a28a092d50eeb1bd45815b256f0180044a5c588...103da34ddbc32d8345655471fc46afc6352a6624,2,42,53,95,14,2013-11-14 14:26:00,2013-11-14 14:13:38
103da34ddbc32d8345655471fc46afc6352a6624...58ed9775c96676a8c6dab2a83ea4ee55f1dcaa38,1,2,2,4,2,2013-11-14 15:39:21,2013-11-14 15:39:21
58ed9775c96676a8c6dab2a83ea4ee55f1dcaa38...3f60ef6360fb18ccf6d32df89639071e7076b1af,1,0,1,1,1,2013-11-14 17:09:21,2013-11-14 17:07:36
3f60ef6360fb18ccf6d32df89639071e7076b1af...792a3f9e7fd259f5cacf4c58e1082c1cda165fac,2,11,10,21,6,2013-11-14 18:04:45,2013-11-14 15:04:00
792a3f9e7fd259f5cacf4c58e1082c1cda165fac...fba8f1efc17f2f24dd0ccf808d143de9ea24d347,4,70,8,78,9,2013-11-14 18:04:45,2013-11-14 16:18:34
fba8f1efc17f2f24dd0ccf808d143de9ea24d347...fd9415a2d86157f21b7084f2dbc37e8de37a8d54,4,16,20,36,9,2013-11-14 21:00:02,2013-11-14 18:00:36
fd9415a2d86157f21b7084f2dbc37e8de37a8d54...9ec9a7f6057ccaacfb915f4bca6b7ab8e8c02b13,1,6,1,7,1,2013-11-14 21:30:41,2013-11-14 19:55:08
9ec9a7f6057ccaacfb915f4bca6b7ab8e8c02b13...86f1890527ff058a878c7ace8bd3e9ef621bde58,1,1,1,2,1,2013-11-14 22:26:10,2013-11-14 22:25:59
86f1890527ff058a878c7ace8bd3e9ef621bde58...787023e2c42bf7e65b1286887243e9177384d0c4,1,0,1,1,1,2013-11-15 01:04:50,2013-11-15 01:04:50
787023e2c42bf7e65b1286887243e9177384d0c4...43b948a35d2e4080304ea90b0a2c62a8dc0fea58,1,2,0,2,2,2013-11-15 13:30:57,2013-11-15 13:30:57
43b948a35d2e4080304ea90b0a2c62a8dc0fea58...ae6b7fadf7b5be38c304fba3e166cdfe66c646c0,1,19,4,23,2,2013-11-15 15:10:18,2013-11-15 15:10:18
ae6b7fadf7b5be38c304fba3e166cdfe66c646c0...c2ec6bbfe8429d72add39594579b3d7fb3f382f6,1,1,1,2,1,2013-11-15 15:23:23,2013-11-15 15:23:23
c2ec6bbfe8429d72add39594579b3d7fb3f382f6...1d9e58d26bfbd14663d18eab4504bb295a22d90e,2,225,0,225,2,2013-11-15 15:43:31,2013-11-15 00:07:49
1d9e58d26bfbd14663d18eab4504bb295a22d90e...ec0cd8663f18875fd11c7bec136ace9763e8cf22,1,7,0,7,1,2013-11-15 16:03:21,2013-11-14 21:33:38
ec0cd8663f18875fd11c7bec136ace9763e8cf22...5686d13d0dc12425987bfc8518580d7a2644296d,1,0,4,4,2,2013-11-15 16:42:48,2013-11-14 16:43:07
5686d13d0dc12425987bfc8518580d7a2644296d...79bd9b3f40622fef11eb695e27ff18decf6703fc,6,290,66,356,30,2013-11-15 16:42:48,2013-11-14 19:56:31
79bd9b3f40622fef11eb695e27ff18decf6703fc...dbd7ea09116612bcbb6f524f101fcf40b8f0ed06,1,3,6,9,2,2013-11-15 16:53:48,2013-11-15 16:49:33
dbd7ea09116612bcbb6f524f101fcf40b8f0ed06...79418fd25a163cf1ed29c5ee451f8b092e7bcb65,1,2,0,2,1,2013-11-15 17:38:47,2013-11-15 16:59:14
79418fd25a163cf1ed29c5ee451f8b092e7bcb65...42a9c840d346d88c23bc3fb241ab113c85cc7660,1,6,7,13,3,2013-11-15 19:10:30,2013-11-15 18:17:47
42a9c840d346d88c23bc3fb241ab113c85cc7660...d316ada1bcb8caf21d79b82ff4e424186dca507f,1,6,6,12,3,2013-11-15 19:34:07,2013-11-15 19:30:49
d316ada1bcb8caf21d79b82ff4e424186dca507f...694be63030e61a97d8cc8416679f3f75580fdd23,1,4,0,4,2,2013-11-15 22:12:13,2013-11-15 21:44:43
694be63030e61a97d8cc8416679f3f75580fdd23...58b3bbcc1c366185cfbf9b8551a4c7150f6553d9,2,3,5,8,2,2013-11-15 22:12:16,2013-11-15 20:11:14
58b3bbcc1c366185cfbf9b8551a4c7150f6553d9...279415ae330f8e0b2cfa933d9a6d11d40d9db2b0,1,1,9,10,1,2013-11-17 01:01:50,2013-11-17 00:59:56
279415ae330f8e0b2cfa933d9a6d11d40d9db2b0...c64ddd2d609e844ab4e9fcc2376f903e5f145d74,1,1,1,2,1,2013-11-17 20:31:25,2013-11-17 20:31:25
c64ddd2d609e844ab4e9fcc2376f903e5f145d74...4461f5cb37fbd1f5f4b6c9bf2d78e442a94f805c,2,2,2,4,2,2013-11-17 21:25:22,2013-11-16 22:45:08
4461f5cb37fbd1f5f4b6c9bf2d78e442a94f805c...a6db386c9b8461e1d0123ce2a13aa3bdf1d02061,1,5,0,5,1,2013-11-18 01:33:51,2013-11-17 21:26:50
a6db386c9b8461e1d0123ce2a13aa3bdf1d02061...ffd52e5f46cf2ba74ba931c78da62d4a7f480d8e,2,2,2,4,2,2013-11-18 04:44:40,2013-11-18 04:44:40
ffd52e5f46cf2ba74ba931c78da62d4a7f480d8e...295b5afd29e3fe2a966316db86de05b929a4f8a8,2,2,2,4,2,2013-11-18 19:35:16,2013-11-18 19:35:16
295b5afd29e3fe2a966316db86de05b929a4f8a8...a1162d854dfd7e6aefbcd2295369eee6e77401c1,3,82,27,109,18,2013-11-18 19:55:56,2013-11-14 21:28:39
a1162d854dfd7e6aefbcd2295369eee6e77401c1...d2d30af82f797f428610df8d224f5f441f86456c,3,5,19,24,5,2013-11-18 19:55:56,2013-11-15 16:22:17
d2d30af82f797f428610df8d224f5f441f86456c...04d753daf245d2037e531c67e0142070d54a9c30,2,120,20,140,9,2013-11-18 20:27:57,2013-11-14 22:46:09
04d753daf245d2037e531c67e0142070d54a9c30...0bc6188105b9c42ee10cbb4cbc04aaaed0b91842,1,27,26,53,1,2013-11-18 20:37:13,2013-11-15 01:05:39
0bc6188105b9c42ee10cbb4cbc04aaaed0b91842...d2b8a2070709d8b9a2646a0a33467a9480c728dd,1,392,196,588,99,2013-11-18 20:56:39,2013-11-14 15:15:25
d2b8a2070709d8b9a2646a0a33467a9480c728dd...838c9da795068ed41bc9feea3e495d2002fdb63f,1,16,43,59,12,2013-11-18 21:12:40,2013-11-15 22:06:37
838c9da795068ed41bc9feea3e495d2002fdb63f...cc9756ce74fb334413ca27bd1815313144fd4651,1,0,1,1,1,2013-11-18 21:12:40,2013-11-15 22:11:38
cc9756ce74fb334413ca27bd1815313144fd4651...938ebe6981529f3c7b62b11ccf39b3533c6c2c8a,1,4,7,11,3,2013-11-18 21:12:40,2013-11-15 22:16:17
938ebe6981529f3c7b62b11ccf39b3533c6c2c8a...030988fb8e08c14cbbcab4fe3a22ed6d6d6a524c,1,8,13,21,5,2013-11-18 21:12:40,2013-11-15 22:34:08
030988fb8e08c14cbbcab4fe3a22ed6d6d6a524c...51b6f31888366615be756f15bd40cf7510798ada,2,633,11,644,18,2013-11-18 21:21:15,2013-11-14 19:01:00
51b6f31888366615be756f15bd40cf7510798ada...856d1bb7e126247fd6453d12cfe229b224217887,7,656,30,686,44,2013-11-18 21:21:15,2013-11-14 22:06:27
856d1bb7e126247fd6453d12cfe229b224217887...4de74f61147f576477618af17a4014b6a325023f,6,181,1,182,7,2013-11-18 21:21:38,2013-10-25 04:07:33
4de74f61147f576477618af17a4014b6a325023f...75d67cdf5ab747385d85f06ad0995e7db099007f,1,8,4,12,5,2013-11-18 21:28:20,2013-11-18 20:19:31
75d67cdf5ab747385d85f06ad0995e7db099007f...31891452456fa4a73e39f9e78cbf99fb82c09aee,1,0,55,55,1,2013-11-18 21:29:25,2013-11-18 21:23:39
31891452456fa4a73e39f9e78cbf99fb82c09aee...406ca294a71842f279d59ebdd42c1a92f0b72791,4,0,0,0,0,2013-11-18 23:05:19,2013-11-18 23:04:51
406ca294a71842f279d59ebdd42c1a92f0b72791...b0cd366ef38cd300a19379628dd89088b4b19774,27,440,440,880,98,2013-11-19 02:20:32,2013-11-18 19:39:45
b0cd366ef38cd300a19379628dd89088b4b19774...92de1c52afeb7adda499bd2c83b1cdac0669c70e,2,4,2,6,2,2013-11-19 14:18:06,2013-11-18 21:45:00
92de1c52afeb7adda499bd2c83b1cdac0669c70e...9795d501bb74edcfbcd518300fd1b96e4f2856e1,1,13,7,20,6,2013-11-19 14:19:51,2013-11-18 21:32:13
9795d501bb74edcfbcd518300fd1b96e4f2856e1...8b98dc053dae6a0db11dfb52d4a86b0274403d52,1,13,7,20,2,2013-11-19 14:24:25,2013-11-18 21:44:26
8b98dc053dae6a0db11dfb52d4a86b0274403d52...31e272af4f900964997af2ce8b2e44013ea40187,2,14,1,15,2,2013-11-19 15:32:19,2013-11-15 16:58:04
31e272af4f900964997af2ce8b2e44013ea40187...91809b1861893ee2d3bd2ceca8d2ca6dd05f9000,1,1,0,1,1,2013-11-19 15:39:43,2013-11-19 15:39:06
91809b1861893ee2d3bd2ceca8d2ca6dd05f9000...7cb1def4e5a1a38792436c83ae22ace4c572c73c,4,195,6,201,8,2013-11-19 15:41:13,2013-11-05 01:04:04
7cb1def4e5a1a38792436c83ae22ace4c572c73c...041f89d751c3c980f5305933f4e4fd5b9b6a6d16,1,2,1,3,1,2013-11-19 15:42:43,2013-11-18 21:40:15
041f89d751c3c980f5305933f4e4fd5b9b6a6d16...5a2c6c18c1bfa0a141a40b02e0cbb32de110f9c0,2,48,2,50,5,2013-11-19 16:01:19,2013-11-18 21:47:50
5a2c6c18c1bfa0a141a40b02e0cbb32de110f9c0...eda5e00441fed56511c65d1f493b7f271fa0c040,1,1,1,2,2,2013-11-19 17:41:11,2013-11-19 14:26:19
eda5e00441fed56511c65d1f493b7f271fa0c040...44b3e91b927d09ed6101d9bac158308de47992ed,1,27,36,63,1,2013-11-19 17:44:49,2013-11-18 18:51:49
44b3e91b927d09ed6101d9bac158308de47992ed...272b6607b6a1b3f5da199d217d5bc85ad8ec4ea1,1,64,32,96,15,2013-11-19 17:44:49,2013-11-18 21:22:10
272b6607b6a1b3f5da199d217d5bc85ad8ec4ea1...b303efd6b2ec39e2805fea8c814be02e0a1ca8bb,1,26,11,37,4,2013-11-19 19:40:19,2013-11-18 22:30:06
b303efd6b2ec39e2805fea8c814be02e0a1ca8bb...eb1f40c7ef0c53047eda306db5185350deeac8d3,1,1,0,1,1,2013-11-19 20:02:12,2013-11-19 20:02:09
eb1f40c7ef0c53047eda306db5185350deeac8d3...1b4c5d4f2c1ea6f25a035884adc7fea884c25334,3,31,3,34,4,2013-11-19 21:02:08,2013-11-06 23:25:39
1b4c5d4f2c1ea6f25a035884adc7fea884c25334...ebaf91105ed8c22d9f7d140cd077858acd744185,4,20,20,40,20,2013-11-19 21:04:55,2013-11-11 23:22:38
ebaf91105ed8c22d9f7d140cd077858acd744185...4a3d5aa6f430530b8a44e581c430176e15da19c2,2,57,1,58,3,2013-11-19 22:01:10,2013-11-18 22:50:58
4a3d5aa6f430530b8a44e581c430176e15da19c2...0c35bfb4b1af88e4b302efead6e618baeda576c5,1,1,2,3,2,2013-11-19 23:04:14,2013-11-19 21:44:03
0c35bfb4b1af88e4b302efead6e618baeda576c5...dc798ccd02dd96e902beb4bf767da36775eb39c8,1,1,1,2,1,2013-11-20 00:07:01,2013-11-20 00:07:01
dc798ccd02dd96e902beb4bf767da36775eb39c8...89472ab787f3f9ed817a07861080664c61158e97,2,1,57,58,3,2013-11-20 01:52:14,2013-11-20 01:52:14
89472ab787f3f9ed817a07861080664c61158e97...99cd81c29e4c9a77c50ffa7c8dd6bcb3c1c93945,5,253,7,260,14,2013-11-20 16:41:04,2013-11-09 00:34:28
99cd81c29e4c9a77c50ffa7c8dd6bcb3c1c93945...2640c3e347e752b8819273e329c6d0e705b364b3,3,117,1,118,3,2013-11-20 18:07:59,2013-11-15 22:37:21
2640c3e347e752b8819273e329c6d0e705b364b3...696c4e260c5c731201fbd993eaf4c785cc6aeca1,1,11,0,11,1,2013-11-20 18:26:37,2013-11-20 14:32:11
696c4e260c5c731201fbd993eaf4c785cc6aeca1...f0bdf1b3a437dae1d32496147fdee166ad5b826a,1,0,1,1,1,2013-11-20 19:16:14,2013-11-20 19:16:14
f0bdf1b3a437dae1d32496147fdee166ad5b826a...76dd5954e69f1a9c3b7fe38a2654b52abce6d461,1,1,1,2,1,2013-11-20 20:26:54,2013-11-20 20:26:54
76dd5954e69f1a9c3b7fe38a2654b52abce6d461...abe4653b2b96fada1c59916105dcd1cb89d0be2e,4,41,5,46,7,2013-11-20 21:51:14,2013-11-18 22:33:38
abe4653b2b96fada1c59916105dcd1cb89d0be2e...57a20249889f413febee14f5fa1c731f1bcf8e20,3,123,52,175,29,2013-11-20 22:41:33,2013-11-20 20:47:46
57a20249889f413febee14f5fa1c731f1bcf8e20...12d8903c8a16ca7aa12090846b2a0a0cce7654b0,6,125,37,162,33,2013-11-20 23:33:36,2013-11-09 00:34:28
12d8903c8a16ca7aa12090846b2a0a0cce7654b0...2cd39093e92fa7b4779beb68073f949c0880fd30,8,410,172,582,150,2013-11-21 03:14:54,2013-11-13 17:01:42
2cd39093e92fa7b4779beb68073f949c0880fd30...b5aad6eccd3b934b6109be9091b23c4d64034c33,11,1821,1511,3332,42,2013-11-21 15:22:12,2013-11-20 21:33:07
b5aad6eccd3b934b6109be9091b23c4d64034c33...0ca6f73c92b8eb313ed2fee5bcb2dbfa35b82904,7,94,110,204,21,2013-11-21 15:22:12,2013-11-20 22:41:20
0ca6f73c92b8eb313ed2fee5bcb2dbfa35b82904...c4cdc5bea6172bffb98002e7a24f4cb4157fb460,18,593,335,928,94,2013-11-21 15:54:52,2013-11-15 22:28:45
c4cdc5bea6172bffb98002e7a24f4cb4157fb460...c058efbd6190a06c4cf2db5f26ed5a2df2bcfd4e,1,16,5,21,6,2013-11-21 16:13:58,2013-11-21 16:13:58
c058efbd6190a06c4cf2db5f26ed5a2df2bcfd4e...634b34eb69d8e05065ad38b878fe9e2e662e1620,1,1,1,2,1,2013-11-21 16:17:21,2013-11-14 17:57:30
634b34eb69d8e05065ad38b878fe9e2e662e1620...8be0b2c53e00f769ef480bbc882ae6828c6795b3,3,55,2,57,8,2013-11-21 16:18:47,2013-11-12 19:08:41
8be0b2c53e00f769ef480bbc882ae6828c6795b3...d555eb8feff4aa1bd595d29e165bfe6fac0256d4,2,11,10,21,2,2013-11-21 16:27:06,2013-11-21 16:27:06
d555eb8feff4aa1bd595d29e165bfe6fac0256d4...d4e174badc531fef4b6bc44fdcbf41d7d82c2f82,1,3,1,4,1,2013-11-21 18:30:24,2013-11-20 23:18:04
d4e174badc531fef4b6bc44fdcbf41d7d82c2f82...2cdc0c87b3333f7ac14226f3398587f9a7079110,2,4,3,7,1,2013-11-21 22:54:16,2013-11-21 22:47:44
2cdc0c87b3333f7ac14226f3398587f9a7079110...e34325d78543aca3a9f37469aee64c8a9bd23772,1,62,0,62,1,2013-11-22 00:18:51,2013-11-21 22:36:09
e34325d78543aca3a9f37469aee64c8a9bd23772...4d722953fa6e7f0cd8732601ed7c5c1cb8808bad,3,43,51,94,13,2013-11-22 02:56:46,2013-11-21 18:58:11
4d722953fa6e7f0cd8732601ed7c5c1cb8808bad...e2e02f9e58fa7ed8e8a3dd04b44b3ed68ad81787,5,117,110,227,86,2013-11-22 15:40:53,2013-11-21 21:51:00
e2e02f9e58fa7ed8e8a3dd04b44b3ed68ad81787...ed2742a551948d859ab2881f26c52c16e7cc32ed,1,1,1,2,1,2013-11-22 16:07:36,2013-11-22 15:26:14
ed2742a551948d859ab2881f26c52c16e7cc32ed...a20f6909f076f7595d526143ad724e96c245af39,5,39,7,46,10,2013-11-22 19:03:43,2013-11-22 18:31:59
a20f6909f076f7595d526143ad724e96c245af39...4f92e24c00fe2751bbbd02b3d82eac18a8b69909,1,1,1,2,1,2013-11-22 19:43:13,2013-11-22 19:43:13
4f92e24c00fe2751bbbd02b3d82eac18a8b69909...a68075e50322910b018815ade7f7c77887cc488b,4,112,60,172,41,2013-11-22 19:50:02,2013-11-21 00:17:38
a68075e50322910b018815ade7f7c77887cc488b...7669448d1a41e0e9ef6237926c0173949b5d9868,3,54,0,54,3,2013-11-22 19:50:03,2013-11-20 21:28:32
7669448d1a41e0e9ef6237926c0173949b5d9868...50ce8f67dbea91a0f8f471021c1432dfc7452a62,1,1,1,2,1,2013-11-22 20:25:48,2013-11-22 20:25:48
50ce8f67dbea91a0f8f471021c1432dfc7452a62...34f76adc0fb9d771c044466a7e6dabfa16db4047,2,27,18,45,13,2013-11-22 20:57:33,2013-11-22 20:56:43
34f76adc0fb9d771c044466a7e6dabfa16db4047...8e3635dad80633495b0be44edd6cd782921aff4c,1,2,1,3,1,2013-11-22 21:11:12,2013-11-22 19:43:56
8e3635dad80633495b0be44edd6cd782921aff4c...0b4202bb531dbdccd87215396ccb3726f55c1421,2,5,1,6,2,2013-11-22 21:25:33,2013-11-22 21:24:22
0b4202bb531dbdccd87215396ccb3726f55c1421...f267bf1ff81e02185ef2a316aefa31c6459234f9,2,5,2,7,4,2013-11-22 21:47:11,2013-11-22 21:47:11
f267bf1ff81e02185ef2a316aefa31c6459234f9...0d9c674d959c8209e4056aa825461b4e70d378ff,1,12,0,12,6,2013-11-23 02:09:20,2013-11-21 15:56:58
0d9c674d959c8209e4056aa825461b4e70d378ff...37ede6b109228b1c12b6e08914fe10b0183bbe48,2,84,0,84,5,2013-11-23 17:50:09,2013-11-22 02:22:21
37ede6b109228b1c12b6e08914fe10b0183bbe48...95586f19acca1258a819930e206100efb1ce4000,1,2,2,4,2,2013-11-25 01:11:06,2013-11-22 22:18:52
95586f19acca1258a819930e206100efb1ce4000...7fdecdbe6901c23faf9febd1d52368218375877f,2,30,8,38,10,2013-11-25 14:49:08,2013-11-25 14:48:42
7fdecdbe6901c23faf9febd1d52368218375877f...f937dbeba8bf3ddb907b7bccfdc2c88ed0c0c664,2,46,9,55,10,2013-11-25 16:28:12,2013-11-25 15:14:19
f937dbeba8bf3ddb907b7bccfdc2c88ed0c0c664...c0bfcf83377220ae5fe79322e55ce96ef7dc470d,2,113,71,184,3,2013-11-25 17:00:28,2013-11-23 18:35:28
c0bfcf83377220ae5fe79322e55ce96ef7dc470d...c625d03f2dcc5086c0f4cb7e23cf31bf59c08836,1,12,0,12,2,2013-11-25 18:33:23,2013-11-25 18:32:57
c625d03f2dcc5086c0f4cb7e23cf31bf59c08836...80f0e7bd7a12c3e7f573161b9ee7333f1b0e33d9,3,55,25,80,4,2013-11-25 19:28:22,2013-11-22 22:49:32
80f0e7bd7a12c3e7f573161b9ee7333f1b0e33d9...622da8a5b71f1f7eedfd7830676369b4cbbbedfa,3,71,26,97,15,2013-11-25 19:44:02,2013-11-22 18:04:01
622da8a5b71f1f7eedfd7830676369b4cbbbedfa...29d0e69a262825891484c2def0788dd89f47dbcb,1,4,3,7,2,2013-11-25 20:04:12,2013-11-25 19:48:26
29d0e69a262825891484c2def0788dd89f47dbcb...fe45bf70ca9ebd865dad424b581e0bab10e16cb0,3,33,2,35,3,2013-11-25 20:17:51,2013-11-25 16:27:28
fe45bf70ca9ebd865dad424b581e0bab10e16cb0...03a3e1c7afef6e49f56e3bd5b058331646098147,1,1,1,2,1,2013-11-25 21:26:19,2013-11-25 21:26:19
03a3e1c7afef6e49f56e3bd5b058331646098147...130741d128210ec82afec4401b9b4ad96603538c,1,1,0,1,1,2013-11-25 23:19:19,2013-11-25 16:13:16
130741d128210ec82afec4401b9b4ad96603538c...fd1b086c8ba051da355157776c07733c4b7dc107,1,1,1,2,1,2013-11-26 00:34:15,2013-08-14 22:18:57
fd1b086c8ba051da355157776c07733c4b7dc107...82b6436726d172568baa4ff82d68e8183e084b66,1,1,1,2,1,2013-11-26 15:57:59,2013-11-26 15:45:23
82b6436726d172568baa4ff82d68e8183e084b66...6015f1f2706201e52f66eede33ef41114dec5550,2,10,2,12,4,2013-11-26 16:02:21,2013-11-26 04:48:52
6015f1f2706201e52f66eede33ef41114dec5550...86b4f30e0359f02777739cc15cdd6052cfdafeaa,2,224,0,224,2,2013-11-26 16:19:05,2013-11-26 16:19:05
86b4f30e0359f02777739cc15cdd6052cfdafeaa...37ff0bf3149d92704186147904219b062f95506b,2,3,4,7,2,2013-11-26 18:14:44,2013-11-23 00:04:41
37ff0bf3149d92704186147904219b062f95506b...a2cf5a59b7e6abe9a481230b3ad9c5fc3b257d8e,1,29,29,58,29,2013-11-26 18:14:59,2013-11-25 22:46:45
a2cf5a59b7e6abe9a481230b3ad9c5fc3b257d8e...305cd93b4c04b3b5828d1e81516e667d92a1f9e7,4,109,212,321,40,2013-11-26 18:15:03,2013-11-15 00:04:11
305cd93b4c04b3b5828d1e81516e667d92a1f9e7...0279986672290bac8e323bc0dbfcb006651cc466,2,12,14,26,10,2013-11-26 19:09:02,2013-10-29 14:54:23
0279986672290bac8e323bc0dbfcb006651cc466...b70d00ae773250bc72918e893843f2cc893fd263,1,2,8,10,2,2013-11-26 19:59:34,2013-11-22 20:12:27
b70d00ae773250bc72918e893843f2cc893fd263...132ffcb23b8573241bacb57524cc4f6a9ef01d38,1,4,4,8,1,2013-11-26 19:59:34,2013-11-22 20:12:45
132ffcb23b8573241bacb57524cc4f6a9ef01d38...4779e48b49c8e153bd3874d061d120cf7e5e75b9,1,7,2,9,2,2013-11-26 20:27:31,2013-11-23 19:50:46
4779e48b49c8e153bd3874d061d120cf7e5e75b9...41c1172aad09331e0cfe23e82642a46fada91fd8,1,6,0,6,1,2013-11-26 20:34:39,2013-11-19 21:31:20
41c1172aad09331e0cfe23e82642a46fada91fd8...4794dea52363a8e5be65648f69d7f98421666964,1,5,0,5,1,2013-11-26 20:34:39,2013-11-19 21:35:48
4794dea52363a8e5be65648f69d7f98421666964...8ac29783efce6e5caa595afffb65767d278fd53f,1,1,1,2,1,2013-11-26 20:34:39,2013-11-19 21:44:32
8ac29783efce6e5caa595afffb65767d278fd53f...727ee88a88ce95f041ae53b9c11336424b8850e2,1,2,0,2,2,2013-11-26 22:03:53,2013-11-26 20:53:40
727ee88a88ce95f041ae53b9c11336424b8850e2...1ee023824d669de56c8223f6e3da5a10e6274f2c,1,2,0,2,2,2013-11-26 22:53:52,2013-11-26 22:43:02
1ee023824d669de56c8223f6e3da5a10e6274f2c...08790c849539ff868c101050860e56154297145f,2,94,0,94,2,2013-11-26 22:58:54,2013-11-26 22:56:48
08790c849539ff868c101050860e56154297145f...1a78c32529cd9378479170b7577b1eb2509c61ca,3,31,2,33,7,2013-11-27 04:25:26,2013-10-30 19:06:50
1a78c32529cd9378479170b7577b1eb2509c61ca...c9808ef30896aba0196247052d282fb77d43a347,1,1,1,2,1,2013-11-27 18:17:08,2013-11-13 23:16:42
c9808ef30896aba0196247052d282fb77d43a347...730c2513f4f0af9068ce7ba0852cb63db56d2c99,8,117,10,127,18,2013-11-27 18:24:45,2013-11-26 18:12:23
730c2513f4f0af9068ce7ba0852cb63db56d2c99...8212bca05a89ac393d9b897e4a31954684f51e6a,11,359,75,434,20,2013-11-27 20:33:10,2013-11-26 16:07:12
8212bca05a89ac393d9b897e4a31954684f51e6a...268575e7690e6a9fd2652fcfcc7154f81b91519b,1,2,1,3,1,2013-11-27 21:20:03,2013-11-27 21:20:03
268575e7690e6a9fd2652fcfcc7154f81b91519b...b2a7d6099e8a0a937e8dd9cbed88b65b42676e97,7,248,2,250,9,2013-11-27 22:38:18,2013-11-22 21:46:15
b2a7d6099e8a0a937e8dd9cbed88b65b42676e97...7798b53d7c23a45f7b2782c517c3f8ec5fb80988,1,1,2,3,1,2013-11-30 02:52:35,2013-11-30 02:52:35
7798b53d7c23a45f7b2782c517c3f8ec5fb80988...828afdcdddbb4a88d6e542f3ff971e7f15ef51f5,1,15,16,31,1,2013-11-30 02:53:38,2013-11-30 02:53:38
828afdcdddbb4a88d6e542f3ff971e7f15ef51f5...ae5d69aff2bc5bed43e5a7536f295e655ab3bcf5,1,9,0,9,1,2013-12-02 03:21:52,2013-11-05 17:08:01
ae5d69aff2bc5bed43e5a7536f295e655ab3bcf5...024a6739ac52ce669bff42b8782484f27a8cbc34,7,637,59,696,26,2013-12-02 14:12:05,2013-11-22 21:51:20
024a6739ac52ce669bff42b8782484f27a8cbc34...b3ffbcfb747ef3e6efa2b75dc409592087b207ce,11,329,159,488,53,2013-12-02 15:52:26,2013-11-22 17:50:14
b3ffbcfb747ef3e6efa2b75dc409592087b207ce...cde3f4bd1aab5c29c880da9e606864f31377889b,8,7,48,55,10,2013-12-02 16:25:46,2013-11-21 18:22:36
cde3f4bd1aab5c29c880da9e606864f31377889b...bcfc8f0ae35fe08c5336c21cfd9752c06b089956,8,279,35,314,22,2013-12-02 17:25:46,2013-11-25 22:31:58
bcfc8f0ae35fe08c5336c21cfd9752c06b089956...7fd22c5572a53ee0491f4a7bf6d8440be9ea60df,1,24,0,24,12,2013-12-02 17:47:41,2013-11-26 22:56:28
7fd22c5572a53ee0491f4a7bf6d8440be9ea60df...bad97aeec714c895fa23ee90aebbffeacc6d621d,4,80,4,84,11,2013-12-02 17:52:17,2013-11-26 21:33:31
bad97aeec714c895fa23ee90aebbffeacc6d621d...dc50cacf30ee57958149aa00171aa0b9015cd01b,1,9,6,15,5,2013-12-02 17:29:49,2013-12-02 13:25:19
dc50cacf30ee57958149aa00171aa0b9015cd01b...a315b35fc81df3bc090c5b8adb5f930625c527e2,1,9,0,9,1,2013-12-02 18:37:27,2013-11-27 20:23:22
a315b35fc81df3bc090c5b8adb5f930625c527e2...253ca6ed273c963aa4842f0b5447d2f3bd429a53,1,23,11,34,11,2013-12-02 20:01:49,2013-11-27 18:43:26
253ca6ed273c963aa4842f0b5447d2f3bd429a53...a4b73fd001b877a58c66d3381ea939f5251caa6a,6,143,2,145,10,2013-12-02 20:16:31,2013-12-02 19:33:12
a4b73fd001b877a58c66d3381ea939f5251caa6a...bfeeb036b57588d46b39e445e576f7b0538f75d7,1,4,2,6,2,2013-12-02 20:26:27,2013-11-27 17:47:33
bfeeb036b57588d46b39e445e576f7b0538f75d7...02db387c70f8e4e828c5297ae9fa06e667421c37,1,2,1,3,1,2013-12-02 20:36:59,2013-12-02 20:36:56
02db387c70f8e4e828c5297ae9fa06e667421c37...2cba1f50e34982a8eb764da0e2589441958153fc,2,14,4,18,3,2013-12-02 21:03:56,2013-12-02 21:03:56
2cba1f50e34982a8eb764da0e2589441958153fc...55554bc090024c137155ad2f3fbaa4a60b448788,1,3,1,4,3,2013-12-02 22:16:33,2013-11-30 03:35:30
55554bc090024c137155ad2f3fbaa4a60b448788...edbc2f5a1eeb9c978526beed5ea9862031809bd6,1,4,4,8,4,2013-12-02 22:16:33,2013-12-01 19:37:45
edbc2f5a1eeb9c978526beed5ea9862031809bd6...ec176dd577988fc1aa2366de8152c5e97bb95466,4,13,41,54,4,2013-12-02 22:45:24,2013-12-02 21:50:14
ec176dd577988fc1aa2366de8152c5e97bb95466...5ea897e30b45447d55289e33f636da3017b1e8db,1,18,0,18,1,2013-12-02 23:09:01,2013-11-25 23:51:05
5ea897e30b45447d55289e33f636da3017b1e8db...2b77cff5450a06226f4074a6d7b5aaf03eb30ce4,1,24,7,31,6,2013-12-03 16:16:50,2013-12-02 22:41:05
2b77cff5450a06226f4074a6d7b5aaf03eb30ce4...d256499b9e3583abb14e16d128712e25a4d498ee,1,0,7,7,2,2013-12-03 16:35:16,2013-12-03 16:33:42
d256499b9e3583abb14e16d128712e25a4d498ee...3a374cb5d0c13d1e7b376d316da6b8652b99738d,1,5,1,6,2,2013-12-03 20:30:37,2013-12-03 15:31:10
3a374cb5d0c13d1e7b376d316da6b8652b99738d...54e3bd6c818a20d8e3c963c335875a25cdc51221,1,13,9,22,5,2013-12-03 21:03:47,2013-11-26 23:04:03
54e3bd6c818a20d8e3c963c335875a25cdc51221...f3461dd26d4a0e84a2cc8d14224bb1bfa5e4e5af,1,4,2,6,3,2013-12-03 22:32:46,2013-11-26 00:00:49
f3461dd26d4a0e84a2cc8d14224bb1bfa5e4e5af...3873e146a896e1140576001ac14e7a2bc6b29163,1,24,0,24,12,2013-12-03 22:32:46,2013-11-26 23:18:35
3873e146a896e1140576001ac14e7a2bc6b29163...31ae185c623ea2d1662c48ce8f5c07daae33dd24,1,2,1,3,1,2013-12-03 22:32:46,2013-12-02 22:08:35
31ae185c623ea2d1662c48ce8f5c07daae33dd24...22a03afae8a1a3b9e9218e8e9985f5bfb8d9ac04,4,476,418,894,231,2013-12-03 23:24:51,2013-11-26 19:16:00
22a03afae8a1a3b9e9218e8e9985f5bfb8d9ac04...cb7bea77aa5796af6016e3b8e0d725f1e4fb1d14,13,126,143,269,52,2013-12-04 02:24:55,2013-11-27 15:35:45
cb7bea77aa5796af6016e3b8e0d725f1e4fb1d14...422008092af78f42d4df67baa9bab15162872328,3,157,134,291,5,2013-12-04 02:24:55,2013-11-27 15:45:15
422008092af78f42d4df67baa9bab15162872328...4fa4012a60147450b8c201ebb90687596fe673d5,1,1,1,2,1,2013-12-04 02:24:55,2013-11-27 16:51:06
4fa4012a60147450b8c201ebb90687596fe673d5...ff4308beb1716d245779effef81acdef7686cc2c,8,265,177,442,45,2013-12-04 02:24:55,2013-11-28 05:21:23
ff4308beb1716d245779effef81acdef7686cc2c...1766b460efaaee908ebe664cb6e5b28c702ab12d,3,19,17,36,13,2013-12-04 02:24:55,2013-12-02 08:41:33
1766b460efaaee908ebe664cb6e5b28c702ab12d...f2b96d98f8c5be601832d984fe089940a4012624,3,16,2,18,7,2013-12-04 02:24:55,2013-12-02 21:00:51
f2b96d98f8c5be601832d984fe089940a4012624...85274e6dd5bd2b38983a43aa1e9af419b9d3f1b2,1,10,0,10,1,2013-12-04 02:24:55,2013-12-02 21:14:57
85274e6dd5bd2b38983a43aa1e9af419b9d3f1b2...05b96df46795366f2ea395fb20062a7ba3874358,3,188,145,333,3,2013-12-04 02:24:55,2013-12-02 21:21:01
05b96df46795366f2ea395fb20062a7ba3874358...fd2d7dabb55ed87e3e081bfba9e07972f738569c,1,52,27,79,8,2013-12-04 02:24:55,2013-12-02 22:52:46
fd2d7dabb55ed87e3e081bfba9e07972f738569c...97d0ed7fa6467e7b0db91577c3f4871e98b90238,1,20,20,40,10,2013-12-04 02:24:56,2013-12-03 16:09:26
97d0ed7fa6467e7b0db91577c3f4871e98b90238...472e289e2a264b177913dc644368727fe6e9e147,1,1,1,2,1,2013-12-04 02:24:56,2013-12-03 16:16:27
472e289e2a264b177913dc644368727fe6e9e147...6915fce7fa2609b8214c4fc211465d5e005f3017,1,8,1,9,2,2013-12-04 02:24:56,2013-12-03 16:17:54
6915fce7fa2609b8214c4fc211465d5e005f3017...e836e71b13e091ed06defa87b91c49e5f720c72f,1,13,5,18,5,2013-12-04 02:24:56,2013-12-03 17:17:49
e836e71b13e091ed06defa87b91c49e5f720c72f...043966cc4ab7c78558bb3bf8cc7627acba29f4fa,1,7,6,13,1,2013-12-04 02:24:56,2013-12-03 17:25:23
043966cc4ab7c78558bb3bf8cc7627acba29f4fa...7b9746e9ae487bc5e47da042a05fd31adbceaf81,1,0,23,23,1,2013-12-04 02:24:56,2013-12-03 17:48:12
7b9746e9ae487bc5e47da042a05fd31adbceaf81...4af02504fea1a0f94e5da691f771ba200d62041f,3,14,14,28,6,2013-12-04 02:24:56,2013-12-03 19:58:43
4af02504fea1a0f94e5da691f771ba200d62041f...42a87f45b983188631b0081fdc2ca30abb9ea332,1,22,10,32,4,2013-12-04 02:24:56,2013-12-03 22:17:34
42a87f45b983188631b0081fdc2ca30abb9ea332...110ec04e053a4f55a0b35407fedf32d85cc3a931,1,108,101,209,11,2013-12-04 02:24:56,2013-12-03 22:48:46
110ec04e053a4f55a0b35407fedf32d85cc3a931...4ef1858bf853a72f6553538c7340cc3353612dfd,1,2,1,3,1,2013-12-04 02:24:56,2013-12-04 02:24:40
4ef1858bf853a72f6553538c7340cc3353612dfd...6d66a10732d3eba3b993cb2b5ef7962717d94c26,1,11,5,16,6,2013-12-04 04:32:28,2013-12-04 04:32:28
6d66a10732d3eba3b993cb2b5ef7962717d94c26...ed76da14b416376045dfe84cf3ad5866bd4feb1f,1,3,3,6,3,2013-12-04 05:38:24,2013-12-04 05:38:24
ed76da14b416376045dfe84cf3ad5866bd4feb1f...2b213f59b9c2734703d3264c3dc3be960a82c1e8,1,2,1,3,1,2013-12-04 11:52:32,2013-12-04 11:52:32
2b213f59b9c2734703d3264c3dc3be960a82c1e8...927f1b7cf5b312a35e54816429d5339852fbc612,4,8,11,19,6,2013-12-04 15:16:10,2013-12-04 15:16:10
927f1b7cf5b312a35e54816429d5339852fbc612...1ed9cd9471ff1b3f7abfc8d1afd5696064a88772,1,2,1,3,1,2013-12-04 15:17:53,2013-12-03 19:16:22
1ed9cd9471ff1b3f7abfc8d1afd5696064a88772...85bc0574d3b61594cc861bdaee167d682606902b,16,306,231,537,25,2013-12-04 15:37:37,2013-12-02 18:15:17
85bc0574d3b61594cc861bdaee167d682606902b...f44e121b665e09ec634c4e7006a14fb1507bb274,12,54,13,67,23,2013-12-04 15:37:37,2013-12-02 19:31:19
f44e121b665e09ec634c4e7006a14fb1507bb274...1a391cb596fbcf043702c98b4fe7b85a8e325ea2,7,203,555,758,71,2013-12-04 15:37:37,2013-12-03 01:45:51
1a391cb596fbcf043702c98b4fe7b85a8e325ea2...19ebc49d3fb30492378fe67aeba4efbb259c45a0,5,57,5,62,8,2013-12-04 15:37:37,2013-12-03 17:31:29
19ebc49d3fb30492378fe67aeba4efbb259c45a0...f24b3bb577003137f7fd40f0699e144df998bd58,4,174,6,180,8,2013-12-04 15:38:21,2013-12-03 19:56:44
f24b3bb577003137f7fd40f0699e144df998bd58...0498f81e2553598862747392a4aa5a75a26807c0,5,393,21,414,6,2013-12-04 16:47:03,2013-12-02 17:14:59
0498f81e2553598862747392a4aa5a75a26807c0...a523a77c9601d3d8c1bd6175ead83702b95409b9,11,66,55,121,37,2013-12-04 17:22:50,2013-11-25 18:51:54
a523a77c9601d3d8c1bd6175ead83702b95409b9...00106cf107e5e6fdf73ca6a226add1235752ca97,6,159,52,211,21,2013-12-04 17:22:50,2013-11-22 18:58:50
00106cf107e5e6fdf73ca6a226add1235752ca97...7c996bd402e4fa44a1884169d06841e4c3d6edb5,3,121,60,181,20,2013-12-04 17:22:51,2013-12-04 16:44:29
7c996bd402e4fa44a1884169d06841e4c3d6edb5...3efa89a5b6738c57db72994e7c8bbebdbf266479,1,2,1,3,3,2013-12-04 19:12:58,2013-12-04 17:08:41
3efa89a5b6738c57db72994e7c8bbebdbf266479...051d74136ee5f920dbab72150a33a31405757ab9,2,11,2,13,4,2013-12-04 19:38:42,2013-12-03 21:04:28
051d74136ee5f920dbab72150a33a31405757ab9...84a20358b16eb9cbe92d9d55014d9e0cc0606f35,6,7,10,17,10,2013-12-04 20:03:31,2013-12-04 19:25:23
84a20358b16eb9cbe92d9d55014d9e0cc0606f35...57a4f1697eebfeac1294dd740a1e3e3c4356d74a,4,27,29,56,23,2013-12-04 20:03:31,2013-12-04 19:29:29
57a4f1697eebfeac1294dd740a1e3e3c4356d74a...ec353f534593770eeb9c93fd965d591c73d4b11a,6,139,174,313,22,2013-12-04 19:35:59,2013-10-24 17:07:40
ec353f534593770eeb9c93fd965d591c73d4b11a...47d01133dfa5e1aa9fce6d8cb743aedaabe2629f,7,61,51,112,29,2013-12-04 20:19:55,2013-12-02 22:36:46
47d01133dfa5e1aa9fce6d8cb743aedaabe2629f...bea51dd281f49b3f0bf0fb6fa627d01205b72de4,1,24,0,24,1,2013-12-04 20:55:18,2013-12-04 19:23:06
bea51dd281f49b3f0bf0fb6fa627d01205b72de4...7816de1dbc43f93c06cfeb28ab5f7d65009e8372,1,311,185,496,97,2013-12-04 21:14:22,2013-12-02 21:20:24
7816de1dbc43f93c06cfeb28ab5f7d65009e8372...20e58c1e87d1abd8105fac04d2fbacb215015f37,2,48,2,50,2,2013-12-04 21:42:06,2013-12-04 18:35:35
20e58c1e87d1abd8105fac04d2fbacb215015f37...82a185ede3165175fc1a7adcd8c4e613571ff645,1,1,1,2,1,2013-12-04 21:48:59,2013-12-04 21:41:32
82a185ede3165175fc1a7adcd8c4e613571ff645...c75445659d6217fac374da6871875ae8c710adde,1,12,1,13,1,2013-12-04 21:57:47,2013-12-04 21:12:12
c75445659d6217fac374da6871875ae8c710adde...6eabf5f7b46ac470bbf803ed7ea67995904d9877,2,151,2,153,3,2013-12-04 22:49:52,2013-12-02 22:23:54
6eabf5f7b46ac470bbf803ed7ea67995904d9877...092c19d9958d65738de8e1e8ab6554e2990317a1,3,10,6,16,7,2013-12-04 23:23:56,2013-12-04 20:55:42
092c19d9958d65738de8e1e8ab6554e2990317a1...47022f14d2f2582ba07abcb35f4fec9706d6dbb8,2,18,8,26,5,2013-12-04 23:25:59,2013-12-03 21:30:36
47022f14d2f2582ba07abcb35f4fec9706d6dbb8...db57baaeaf3a629991b956bd1628cede5c779aa7,1,5,5,10,3,2013-12-04 23:50:30,2013-11-30 16:38:24
db57baaeaf3a629991b956bd1628cede5c779aa7...35c2c7aff4f88fd8bad0c318bee97cb3eabb1752,1,2,1,3,1,2013-12-04 23:51:10,2013-11-30 16:44:54
35c2c7aff4f88fd8bad0c318bee97cb3eabb1752...0df4877961b7b98fa904a804d876c10b63083f4e,1,18,16,34,2,2013-12-05 13:44:23,2013-12-05 13:44:23
0df4877961b7b98fa904a804d876c10b63083f4e...1f0b640fb7b0f6de22fe098f12d3b05b23c1caf4,3,62,91,153,18,2013-12-05 15:08:17,2013-12-04 20:48:37
1f0b640fb7b0f6de22fe098f12d3b05b23c1caf4...ac5baf851f16c8d14800864d2fad04c3e67d7cf6,4,41,13,54,8,2013-12-05 16:41:10,2013-12-03 21:35:36
ac5baf851f16c8d14800864d2fad04c3e67d7cf6...ea3005a525e1bacedb6b626aa93c8ad5df5e94dd,3,28,15,43,10,2013-12-05 16:41:10,2013-12-03 22:17:37
ea3005a525e1bacedb6b626aa93c8ad5df5e94dd...ea9033b729b3ca3f3158fd83094e1b7dd96a2b2f,4,116,93,209,14,2013-12-05 16:41:10,2013-11-26 22:41:55
ea9033b729b3ca3f3158fd83094e1b7dd96a2b2f...08fda16ab279ed379161b1e75c64d5462e98815e,3,13,13,26,6,2013-12-05 18:01:10,2013-12-04 18:01:52
08fda16ab279ed379161b1e75c64d5462e98815e...b3d6506f0788c80c1bec9a74611239fc15977591,1,2,1,3,1,2013-12-05 18:10:51,2013-12-05 16:16:42
b3d6506f0788c80c1bec9a74611239fc15977591...2ede70e2eba64ba3a6891c2c292c70d4c02a93e3,17,108,56,164,34,2013-12-05 18:36:35,2013-12-04 17:59:54
2ede70e2eba64ba3a6891c2c292c70d4c02a93e3...5bca982220a8dab88ccf0d19d1b4bd47815963bc,13,100,1355,1455,27,2013-12-05 18:43:08,2013-12-04 19:56:46
5bca982220a8dab88ccf0d19d1b4bd47815963bc...328860612f91e1de4fbe97b0a098aa31353cd152,1,6,6,12,6,2013-12-06 00:26:46,2013-11-30 17:45:39
328860612f91e1de4fbe97b0a098aa31353cd152...e03a07465c6a580a23d328a98197474ec77c5329,2,2,2,4,2,2013-12-06 00:27:30,2013-11-30 16:42:52
e03a07465c6a580a23d328a98197474ec77c5329...5a4c4003b14846aec41a4b6d235967652f281194,1,1,1,2,1,2013-12-06 00:27:30,2013-12-01 14:39:11
5a4c4003b14846aec41a4b6d235967652f281194...b533ba3953d905aeb100740121cdbb19b91b0868,3,41,38,79,5,2013-12-06 15:36:31,2013-12-06 15:36:31
b533ba3953d905aeb100740121cdbb19b91b0868...0f0bd1d058375234a639928f90dab26293a584eb,1,20,0,20,1,2013-12-06 16:13:42,2013-12-04 21:08:04
0f0bd1d058375234a639928f90dab26293a584eb...6bef7b4fa2b5648e11da5aeb4f44b2f6bae7952d,7,139,6,145,13,2013-12-06 17:57:58,2013-12-06 08:15:44
6bef7b4fa2b5648e11da5aeb4f44b2f6bae7952d...ae0a5132d127da644dbfbe54ce2e152553c4ce8d,4,103,40,143,15,2013-12-06 18:11:31,2013-12-04 18:46:04
ae0a5132d127da644dbfbe54ce2e152553c4ce8d...ed086215c93b69356147c4c27cb5b2de0cd33267,4,269,44,313,29,2013-12-06 18:42:54,2013-12-06 05:30:36
ed086215c93b69356147c4c27cb5b2de0cd33267...a0233da2e8533335e2037b6dab780eb06272be67,2,12,20,32,11,2013-12-06 19:02:38,2013-12-06 17:46:31
a0233da2e8533335e2037b6dab780eb06272be67...5020c2a16ae383d15d51676c328157c4f801147c,1,1,0,1,1,2013-12-06 20:25:37,2013-12-06 20:25:37
5020c2a16ae383d15d51676c328157c4f801147c...9639cd76bff9668feaad96b89a6df7ecb313cca5,1,1,0,1,1,2013-12-06 21:19:33,2013-12-06 21:19:33
9639cd76bff9668feaad96b89a6df7ecb313cca5...11cda2f697157e3832bc09d842f8fc71d319a87d,2,14,0,14,2,2013-12-06 22:41:32,2013-12-06 22:41:32
11cda2f697157e3832bc09d842f8fc71d319a87d...2613691bbba98eed388240897311bfdebb731bf5,1,3,1,4,1,2013-12-06 23:02:30,2013-12-04 23:52:34
2613691bbba98eed388240897311bfdebb731bf5...8e2d6557f8b3e17b7230377a89b6dece9e87e461,2,54,33,87,14,2013-12-08 19:55:24,2013-12-08 19:47:30
8e2d6557f8b3e17b7230377a89b6dece9e87e461...daa2acbba25387621326f708ec0a7afbb746664a,1,1,1,2,1,2013-12-08 22:37:17,2013-12-08 22:37:17
daa2acbba25387621326f708ec0a7afbb746664a...9239e7335c6a539b6a658ddbed9d7f4702c452f2,3,201,173,374,3,2013-12-09 05:24:54,2013-12-04 17:03:34
9239e7335c6a539b6a658ddbed9d7f4702c452f2...51d4176ec3d6aa5d3c54814e452bb745f93c9042,2,24,7,31,5,2013-12-09 05:24:54,2013-12-04 18:07:57
51d4176ec3d6aa5d3c54814e452bb745f93c9042...8426029d0f85a5a6a3f21e3127fb6838c0934bd7,7,13,10,23,10,2013-12-09 05:24:54,2013-12-05 20:59:24
8426029d0f85a5a6a3f21e3127fb6838c0934bd7...e7dce6441d29464a616565b946e0c7a78580f2cc,4,3,3,6,3,2013-12-09 05:24:54,2013-12-05 21:35:22
e7dce6441d29464a616565b946e0c7a78580f2cc...95e425138e9bc404f95ebc7a6c549d6d9a68b7c0,1,6,2,8,4,2013-12-09 14:55:43,2013-12-09 14:55:43
95e425138e9bc404f95ebc7a6c549d6d9a68b7c0...6ea28a261ff80e27cf0accaca421df3b13e3b20b,1,43,5,48,6,2013-12-09 16:26:11,2013-12-09 16:26:11
6ea28a261ff80e27cf0accaca421df3b13e3b20b...86848b30c3014247ab27fdff38ffaa36c1baa2fa,7,102,24,126,20,2013-12-09 17:05:40,2013-12-05 21:53:18
86848b30c3014247ab27fdff38ffaa36c1baa2fa...3100d120989881a47b9efbaaad5aec49980301d4,3,67,1,68,4,2013-12-09 19:37:40,2013-12-05 19:52:36
3100d120989881a47b9efbaaad5aec49980301d4...1df18f9530aec174f384d5f4ff5efda8218ecd32,2,50,0,50,2,2013-12-09 19:37:40,2013-12-05 20:50:43
1df18f9530aec174f384d5f4ff5efda8218ecd32...5a741123578072e0439f8b3b837f43643b809e0b,4,36,3,39,7,2013-12-09 19:52:48,2013-12-06 20:44:02
5a741123578072e0439f8b3b837f43643b809e0b...d6936eb860bc973fd092128979fa2a93e84e0ce5,17,457,417,874,62,2013-12-09 20:30:19,2013-12-04 16:29:14
d6936eb860bc973fd092128979fa2a93e84e0ce5...ea1bcc2beb6638034c1c811042d399f1b92e5cd2,2,12,1,13,2,2013-12-09 20:55:46,2013-12-06 18:40:48
ea1bcc2beb6638034c1c811042d399f1b92e5cd2...985f05b42e948890b149d1c0570da717edbcc599,3,11,1,12,6,2013-12-09 21:02:28,2013-12-06 15:52:41
985f05b42e948890b149d1c0570da717edbcc599...0789de6960c7ab76aaa297d57174b79acc35a68a,1,1,1,2,1,2013-12-09 21:14:48,2013-12-09 21:14:48
0789de6960c7ab76aaa297d57174b79acc35a68a...a7ca46483bcb18ca3fb8c276797b765b4c1c0ada,9,564,41,605,49,2013-12-09 21:20:44,2013-12-05 17:56:36
a7ca46483bcb18ca3fb8c276797b765b4c1c0ada...2a0b5f2e171db7e6fac39b94794d9c0e0b3a5ff0,3,34,1,35,3,2013-12-09 21:43:16,2013-12-09 16:27:04
2a0b5f2e171db7e6fac39b94794d9c0e0b3a5ff0...32311b5f0e7a6d00cc2253d7f21397b51f0e126b,1,6,1,7,1,2013-12-09 22:31:11,2013-12-05 19:21:57
32311b5f0e7a6d00cc2253d7f21397b51f0e126b...9818dcb439741d0eac48a2a804297a074923874a,4,107,0,107,4,2013-12-09 22:31:12,2013-12-09 19:45:13
9818dcb439741d0eac48a2a804297a074923874a...a37edf789fb1aaff178525c6b1916b5e9a24b3ed,2,27,212,239,12,2013-12-09 23:46:57,2013-12-09 16:49:58
a37edf789fb1aaff178525c6b1916b5e9a24b3ed...d03813a061ecc7cbbeff8234cf4c2b29f6f3ee7e,3,382,3,385,6,2013-12-10 00:14:00,2013-12-05 20:14:41
d03813a061ecc7cbbeff8234cf4c2b29f6f3ee7e...c3e150afe50bc0606be6b4c3efbba0eba9bcecc1,1,241,824,1065,1,2013-12-10 00:41:25,2013-12-08 05:10:41
c3e150afe50bc0606be6b4c3efbba0eba9bcecc1...976bbf60bfa42d412cfdd59d791a3d5ef36e5d4e,1,3,0,3,1,2013-12-10 14:49:40,2013-12-10 14:49:40
976bbf60bfa42d412cfdd59d791a3d5ef36e5d4e...1772eef330e7ed06700b2d1560f40147412fb685,3,160,1,161,3,2013-12-10 16:04:22,2013-12-09 21:00:09
1772eef330e7ed06700b2d1560f40147412fb685...8d5e83075ed1ffc989b4e04ec981fc5355f0f9e7,187,2244,0,2244,187,2013-12-10 18:04:53,2013-12-10 18:04:53
8d5e83075ed1ffc989b4e04ec981fc5355f0f9e7...67383748612e186e6e2ba14f14b6a2a3f89c1982,1,3,2,5,2,2013-12-10 20:48:48,2013-12-10 20:28:20
67383748612e186e6e2ba14f14b6a2a3f89c1982...82e8115bacf418f3fe8af50e04b7d6ca218d87f1,2,45,37,82,24,2013-12-10 22:54:04,2013-12-09 21:59:08
82e8115bacf418f3fe8af50e04b7d6ca218d87f1...2f61f0248d0d41078d3c0b94092493361557ec29,11,112,80,192,53,2013-12-10 22:54:04,2013-12-05 20:56:14
2f61f0248d0d41078d3c0b94092493361557ec29...1760fb0ee9dad49f36131c62bbb4bf873aa837f5,2,195,0,195,2,2013-12-10 23:22:44,2013-12-10 19:32:51
1760fb0ee9dad49f36131c62bbb4bf873aa837f5...35fb01568fa27426a8b2bb701e628e8a62fd0c78,2,322,0,322,5,2013-12-11 00:18:26,2013-12-09 21:48:51
35fb01568fa27426a8b2bb701e628e8a62fd0c78...f0b52231c208586413137b6c7c4854918a482b31,2,2,3,5,3,2013-12-11 00:18:26,2013-12-10 20:17:57
f0b52231c208586413137b6c7c4854918a482b31...aac9e25fb096234bed6ea48217651a05afa9e10e,2,5,3,8,2,2013-12-11 16:43:48,2013-12-11 00:36:56
aac9e25fb096234bed6ea48217651a05afa9e10e...13d6adbaa8c291d7aa73b887fa5cfdcb3b5eeba5,17,54,2175,2229,31,2013-12-11 17:32:48,2013-12-10 19:12:29
13d6adbaa8c291d7aa73b887fa5cfdcb3b5eeba5...913e08fc92778efadcc0f00d975017f09bf61696,1,2,3,5,2,2013-12-11 18:18:41,2013-12-04 19:28:28
913e08fc92778efadcc0f00d975017f09bf61696...f0ff2b32938f65d6f8625dbdb45cec479c87113d,4,703,3,706,10,2013-12-11 18:18:41,2013-12-04 20:56:59
f0ff2b32938f65d6f8625dbdb45cec479c87113d...dc7147dc394a10fb8ef2b1aa51f0f9d7593fc95a,2,185,188,373,67,2013-12-11 18:18:41,2013-12-04 20:57:32
dc7147dc394a10fb8ef2b1aa51f0f9d7593fc95a...71143283f58bea945bd41a5d62f2a3a95a3191af,5,247,77,324,35,2013-12-11 18:18:41,2013-12-06 16:57:14
71143283f58bea945bd41a5d62f2a3a95a3191af...be7c5f961bd163cb315c561ebd5a47a3b54dcfe8,2,25,20,45,16,2013-12-11 18:18:41,2013-12-11 15:44:42
be7c5f961bd163cb315c561ebd5a47a3b54dcfe8...76e5458c48460de585bbde25c87bd4046c67198b,40,599,3624,4223,107,2013-12-11 19:19:22,2013-12-10 18:15:29
76e5458c48460de585bbde25c87bd4046c67198b...8e310d69785e49afb015637f67ca38603c57089a,1,1,1,2,1,2013-12-11 19:24:00,2013-12-11 19:24:00
8e310d69785e49afb015637f67ca38603c57089a...d72a99997d86f1eb480ade64a031a81466e67e5a,1,1,1,2,1,2013-12-11 22:13:25,2013-12-06 21:16:23
d72a99997d86f1eb480ade64a031a81466e67e5a...10270c7b5cf81f63cdf5720b70f517ab2a725d63,1,0,14,14,1,2013-12-11 22:13:25,2013-12-09 17:55:30
10270c7b5cf81f63cdf5720b70f517ab2a725d63...e0a4cb5c5d6421805632d680c79e5bbc06853e99,2,0,79,79,3,2013-12-11 22:20:11,2013-12-11 22:20:08
e0a4cb5c5d6421805632d680c79e5bbc06853e99...435cc691824b63eea422ff75be52af0ad39c285c,1,270,0,270,1,2013-12-11 23:00:13,2013-12-11 01:06:16
435cc691824b63eea422ff75be52af0ad39c285c...3c028606952aaa726e98859208f40b09e5cc4343,1,74,0,74,1,2013-12-11 23:15:10,2013-12-11 17:32:17
3c028606952aaa726e98859208f40b09e5cc4343...172bf6a4e24a65da9a6269507c2385c797d35cb7,2,3,5,8,2,2013-12-12 00:07:39,2013-12-12 00:07:39
172bf6a4e24a65da9a6269507c2385c797d35cb7...143e99cf0c36aaffbdbc74d4a8a2a7f50f119139,16,216,436,652,69,2013-12-12 14:54:02,2013-12-11 21:55:46
143e99cf0c36aaffbdbc74d4a8a2a7f50f119139...c5ca62db83eaf23f61f17504c570ffb9f3e50d9d,1,0,46,46,2,2013-12-12 15:05:38,2013-12-12 15:05:38
c5ca62db83eaf23f61f17504c570ffb9f3e50d9d...6a13bdab4b65807884fe975d669ebf234b4fd6f2,1,4,10,14,7,2013-12-12 16:20:22,2013-12-10 20:19:50
6a13bdab4b65807884fe975d669ebf234b4fd6f2...4450abfa43e7781e6f16ac9cc23206dbb6b2b673,2,72,12,84,18,2013-12-12 19:27:23,2013-12-11 17:42:44
4450abfa43e7781e6f16ac9cc23206dbb6b2b673...6923d227113a44bdec68e450a27a191284d465a1,2,2,2,4,2,2013-12-12 18:57:28,2013-12-12 15:26:35
6923d227113a44bdec68e450a27a191284d465a1...8d3220958d1ffd5f9bb89f1e574ef8235075bef5,1,1,0,1,1,2013-12-12 18:57:28,2013-12-12 15:52:53
8d3220958d1ffd5f9bb89f1e574ef8235075bef5...c47b59b9461760398ca5027310704b6d8f6a2376,1,1,1,2,1,2013-12-12 19:06:19,2013-12-12 19:06:19
c47b59b9461760398ca5027310704b6d8f6a2376...fd28dc38c37a4022082f2cb1a81a682d49fca7cb,10,233,42,275,39,2013-12-12 21:10:38,2013-12-10 17:53:09
fd28dc38c37a4022082f2cb1a81a682d49fca7cb...56b5c7cef7e44aaf8c2174a61eae69766e1c7606,1,50,0,50,2,2013-12-12 21:11:16,2013-12-12 19:23:37
56b5c7cef7e44aaf8c2174a61eae69766e1c7606...7b719b476a3ecd7ef213ae8833886278708e33cc,2,21,8,29,3,2013-12-12 22:04:58,2013-12-12 21:52:22
7b719b476a3ecd7ef213ae8833886278708e33cc...b28ffc9ae294cfb4390882cb21c1ca32d2d90a47,1,406,173,579,125,2013-12-12 22:28:49,2013-12-12 21:55:03
b28ffc9ae294cfb4390882cb21c1ca32d2d90a47...bf44f7690aadf1f99e7979adf6c33d4dea2f5464,3,16,3,19,5,2013-12-13 00:18:27,2013-12-12 20:00:14
bf44f7690aadf1f99e7979adf6c33d4dea2f5464...b0c2eab53f6733e87d69fe8c1f22324efa735952,72,69,16494,16563,147,2013-12-13 16:54:44,2013-12-12 16:56:21
b0c2eab53f6733e87d69fe8c1f22324efa735952...0d085c545f5c4ba3a7f5eaad5d675c5a8bd6ab00,1,233,0,233,1,2013-12-13 17:00:20,2013-12-11 23:51:43
0d085c545f5c4ba3a7f5eaad5d675c5a8bd6ab00...11530d4e38cfff2ab0f4b6ab69ee58932074b58b,1,7,1,8,2,2013-12-13 17:16:07,2013-11-26 15:06:55
11530d4e38cfff2ab0f4b6ab69ee58932074b58b...4c5c052a038ba8fd0f0743cb2fa5dd3bf79bfb6c,1,1,1,2,1,2013-12-13 17:16:07,2013-12-02 17:11:45
4c5c052a038ba8fd0f0743cb2fa5dd3bf79bfb6c...c90068fa13ef447dc1a67f6c6603bcb177931b14,2,23,5,28,8,2013-12-13 17:16:08,2013-12-02 17:45:16
c90068fa13ef447dc1a67f6c6603bcb177931b14...afeae9cf7d3bfd96166f221fe8c64c9e194b0621,2,3,2,5,3,2013-12-13 17:16:08,2013-12-02 19:37:11
afeae9cf7d3bfd96166f221fe8c64c9e194b0621...3c86a0b8f78928de3d89cac005ef71cba6fa3859,1,2,1,3,1,2013-12-13 17:16:09,2013-12-02 19:40:19
3c86a0b8f78928de3d89cac005ef71cba6fa3859...ea923ba23ea90df88a7239d9e14967945a4cefdf,12,1,1201,1202,17,2013-12-13 18:02:39,2013-12-13 17:21:30
ea923ba23ea90df88a7239d9e14967945a4cefdf...3769b3046df920d5e323a0c18475f5e0d4c891af,16,7,182,189,19,2013-12-13 18:34:49,2013-12-13 18:10:09
3769b3046df920d5e323a0c18475f5e0d4c891af...d2c3a1d23dc49b38145748bbb0a1b3839f69a176,2,12,10,22,6,2013-12-13 18:34:53,2013-12-13 18:30:01
d2c3a1d23dc49b38145748bbb0a1b3839f69a176...1d034bab093f4f7d3b264c50e78207b94a0e267e,10,43,43,86,32,2013-12-13 19:01:30,2013-12-13 00:32:38
1d034bab093f4f7d3b264c50e78207b94a0e267e...f5bc2c78e4e14785e0a39970d4163ebb062d05f9,6,39,23,62,21,2013-12-13 19:01:30,2013-12-13 04:15:28
f5bc2c78e4e14785e0a39970d4163ebb062d05f9...d07f4b8115c21449d691e056f264f6f3d7d2d7f4,17,48,85,133,20,2013-12-13 19:01:30,2013-12-13 18:51:34
d07f4b8115c21449d691e056f264f6f3d7d2d7f4...24f90ef17edf397f2ca61772f0da7497b24d55fa,1,12,3,15,4,2013-12-13 19:52:17,2013-12-05 18:45:59
24f90ef17edf397f2ca61772f0da7497b24d55fa...779be6eeb263c9dab4072650602366e46d331b1b,1,1,1,2,1,2013-12-13 20:40:28,2013-12-13 20:39:24
779be6eeb263c9dab4072650602366e46d331b1b...2c54682ce88e2c4e7fe8c99baeadfece0831dbd2,12,451,40,491,13,2013-12-13 20:42:28,2013-12-12 20:16:14
2c54682ce88e2c4e7fe8c99baeadfece0831dbd2...34738d8f39dae85b10687b207473e61b52b5b93c,10,66,170,236,52,2013-12-13 20:51:49,2013-12-11 16:00:32
34738d8f39dae85b10687b207473e61b52b5b93c...fe185a30da0616ec9cff3f4fc6a90c025724b64b,11,140,21,161,52,2013-12-13 20:51:49,2013-12-13 13:44:24
fe185a30da0616ec9cff3f4fc6a90c025724b64b...4d2042d297fe386e5139e8d7bec24931a440e627,1,6,0,6,2,2013-12-13 20:55:55,2013-12-13 20:55:55
4d2042d297fe386e5139e8d7bec24931a440e627...44906b1bbdde6499be01dbb099a45a2fca888f08,1,1,0,1,1,2013-12-13 21:31:06,2013-12-13 21:31:06
44906b1bbdde6499be01dbb099a45a2fca888f08...80b394459f939893631290c0d56f9d65fd2b3898,4,45,10,55,8,2013-12-13 21:31:29,2013-12-13 19:39:38
80b394459f939893631290c0d56f9d65fd2b3898...74f9d4248f8c879c1bf914486785dc290c0129be,3,7,508,515,15,2013-12-13 21:31:29,2013-12-13 19:59:27
74f9d4248f8c879c1bf914486785dc290c0129be...9d5d7f0ec9d6ee1914b218a567bcb7b23f5df527,1,33,0,33,2,2013-12-13 21:31:29,2013-12-13 20:30:04
9d5d7f0ec9d6ee1914b218a567bcb7b23f5df527...bc71c30027e751e971191c596020c7271516153e,5,4,90,94,8,2013-12-13 21:31:29,2013-12-13 20:45:02
bc71c30027e751e971191c596020c7271516153e...e479eb35efbacb06be0bfcc3d627de9758665fac,1,23,26,49,2,2013-12-13 21:34:17,2013-12-13 21:34:17
e479eb35efbacb06be0bfcc3d627de9758665fac...9ebb366ef046a10875640493cf0560359e9221b2,1,3,3,6,1,2013-12-13 21:55:39,2013-12-07 19:11:10
9ebb366ef046a10875640493cf0560359e9221b2...5accd55022ed89fccfa0228772d2dc5087ec5b18,2,119,1,120,2,2013-12-13 22:10:28,2013-12-12 18:17:33
5accd55022ed89fccfa0228772d2dc5087ec5b18...84b8c0e86e72b5fbb81649f0e599f0c73d5c9f64,3,25,9,34,4,2013-12-13 22:22:39,2013-12-13 00:41:57
84b8c0e86e72b5fbb81649f0e599f0c73d5c9f64...323a7a919278c261b6ebfc485ad9cdb71f4dcf44,2,9,1,10,4,2013-12-13 22:32:40,2013-12-11 18:57:42
323a7a919278c261b6ebfc485ad9cdb71f4dcf44...c3e4cd6c722e78b1da5caa3f72bc654d2719a764,2,39,35,74,19,2013-12-13 22:38:51,2013-12-10 22:37:44
c3e4cd6c722e78b1da5caa3f72bc654d2719a764...8416afb7c5724076b1231626f27f5198a5a2cce7,1,107,43,150,16,2013-12-13 22:40:44,2013-12-03 22:39:23
8416afb7c5724076b1231626f27f5198a5a2cce7...0abf27ae913dc3ca15b97480b1e35775ec2efbda,2,239,82,321,37,2013-12-13 22:43:25,2013-12-02 15:31:54
0abf27ae913dc3ca15b97480b1e35775ec2efbda...766f22656f17a882bacd0cd4786acd04512758c2,1,0,6,6,2,2013-12-14 13:20:50,2013-12-14 13:18:34
766f22656f17a882bacd0cd4786acd04512758c2...6c398c64c723f0521a225dddf2c0bfb53658c39b,4,26,7,33,5,2013-12-14 14:48:04,2013-12-10 19:57:32
6c398c64c723f0521a225dddf2c0bfb53658c39b...7c72e8b52934f2daedeee4f289c75246dc665487,4,7,26,33,5,2013-12-14 16:36:10,2013-12-14 16:36:10
7c72e8b52934f2daedeee4f289c75246dc665487...1e5bf026379f767171d5ebb8344217f534bdffc9,1,17,1,18,2,2013-12-16 02:36:50,2013-11-27 20:14:35
1e5bf026379f767171d5ebb8344217f534bdffc9...8c127cb46e05d8e10e273d588fd493dc9972ef70,1,1,1,2,1,2013-12-16 02:50:58,2013-12-16 02:47:37
8c127cb46e05d8e10e273d588fd493dc9972ef70...725e52bee717a570e435b1b7eb4acf62ab813f3a,1,1,2,3,1,2013-12-16 04:39:04,2012-09-05 23:39:01
725e52bee717a570e435b1b7eb4acf62ab813f3a...6902c6b643f645613f231bcde4bf2b1a86f63c21,1,1,1,2,1,2013-12-16 04:51:11,2013-12-16 04:51:11
6902c6b643f645613f231bcde4bf2b1a86f63c21...99dff054c8b83caf43c42d01b0497dcb0e1ee5bf,1,7,0,7,1,2013-12-16 16:39:22,2013-12-11 21:01:56
99dff054c8b83caf43c42d01b0497dcb0e1ee5bf...b0cc3e092880c00cdbd531d88f38cb9e0a52d881,36,651,269,920,168,2013-12-16 19:49:01,2013-12-14 21:01:30
b0cc3e092880c00cdbd531d88f38cb9e0a52d881...287b2da1270b8f77ecf0b03d0463770403d5fb43,1,1,1,2,1,2013-12-16 20:01:05,2012-12-26 20:52:21
287b2da1270b8f77ecf0b03d0463770403d5fb43...91ee7a4219678449d3b8e626181abaae57cee31d,1,0,3,3,1,2013-12-16 20:50:44,2013-12-14 16:29:09
91ee7a4219678449d3b8e626181abaae57cee31d...8ec09aaed76eb11ac9a1eb1d19e22fbf06dd9818,1,21,0,21,1,2013-12-16 21:02:51,2013-12-13 22:50:18
8ec09aaed76eb11ac9a1eb1d19e22fbf06dd9818...60a62aabd8b5301da37b05641709c12ee1b17baa,3,34,7,41,4,2013-12-16 21:06:02,2013-12-16 17:07:19
60a62aabd8b5301da37b05641709c12ee1b17baa...8e3fda2d14c9cc7626bfbabfd834a34ee0d95e64,2,68,19,87,14,2013-12-16 21:23:12,2013-12-12 20:08:07
8e3fda2d14c9cc7626bfbabfd834a34ee0d95e64...0f629b3212a22e5ec5838f5e4e9f96567ca3e72d,27,238,238,476,181,2013-12-16 22:21:44,2013-12-16 22:04:25
0f629b3212a22e5ec5838f5e4e9f96567ca3e72d...7fdabead275b6ab7c20dddfbe5fcb57608606033,6,353,1,354,16,2013-12-16 22:27:45,2013-12-16 19:42:21
7fdabead275b6ab7c20dddfbe5fcb57608606033...ac579bb1bd03235086de2cd82d9731f69b7d4d33,1,1,1,2,1,2013-12-16 22:27:45,2013-12-16 20:17:34
ac579bb1bd03235086de2cd82d9731f69b7d4d33...d68f6bccbf4f1acdf09b1546ee9883821b7a9edd,3,52,22,74,5,2013-12-16 22:42:13,2013-12-13 16:37:15
d68f6bccbf4f1acdf09b1546ee9883821b7a9edd...f69b8e905df73ca663910f428a207873ab2bc625,14,349,114,463,69,2013-12-17 01:58:00,2013-11-19 04:03:10
f69b8e905df73ca663910f428a207873ab2bc625...7b16d40afbc6320539cb1933b9e6a60d3db86607,2,66,1,67,2,2013-12-17 14:40:26,2013-12-16 21:25:07
7b16d40afbc6320539cb1933b9e6a60d3db86607...d73db8af612528d5dff98f0112a24edf36c085e6,2,32,6,38,8,2013-12-17 15:26:04,2013-09-24 00:38:38
d73db8af612528d5dff98f0112a24edf36c085e6...4a6d915d378bfbd1dc03796db80c85f846c68bc9,4,26,7,33,5,2013-12-17 15:42:16,2013-12-14 19:57:21
4a6d915d378bfbd1dc03796db80c85f846c68bc9...b1daf8ef3e362a64a9c459c4993d53d0a7b1208d,2,19,68,87,14,2013-12-17 19:26:44,2013-12-17 19:26:37
b1daf8ef3e362a64a9c459c4993d53d0a7b1208d...b43c12902599e0ecea596975c081655a0cdc121c,3,37,1,38,4,2013-12-17 19:46:09,2013-12-16 19:08:24
b43c12902599e0ecea596975c081655a0cdc121c...3050f432fe144a16516f7de0a346c0586f650ac6,3,149,10,159,13,2013-12-17 21:26:12,2013-12-17 20:27:27
3050f432fe144a16516f7de0a346c0586f650ac6...b44edc42e42524d2f8bf66d389eeb6d973fbf40e,3,126,23,149,9,2013-12-17 21:46:33,2013-12-17 21:35:56
b44edc42e42524d2f8bf66d389eeb6d973fbf40e...135a586d4954eac2ddf0e3f6f5b047177acce667,3,11,1,12,4,2013-12-17 21:57:56,2013-12-17 21:57:56
135a586d4954eac2ddf0e3f6f5b047177acce667...140de5abeda99dcebfebc7536cc43c4a40aeda11,1,7,1,8,2,2013-12-17 22:03:40,2013-12-17 21:55:47
140de5abeda99dcebfebc7536cc43c4a40aeda11...35bf3e7660a1ff6ad7d3fa6024604f01029b401b,1,24,5,29,3,2013-12-17 22:21:13,2013-12-17 22:05:00
35bf3e7660a1ff6ad7d3fa6024604f01029b401b...2bff949748dc4b9eb63225abbe08907d1fe1d444,1,19,24,43,11,2013-12-17 22:21:13,2013-12-17 22:10:26
2bff949748dc4b9eb63225abbe08907d1fe1d444...1709ca73ab967526b8fe0e32c20506d47142393e,1,8,1,9,2,2013-12-18 15:34:10,2013-12-17 15:49:10
1709ca73ab967526b8fe0e32c20506d47142393e...0155cd5bc6fb62300ec26130c0f8c16a8a669c82,1,2,1,3,1,2013-12-18 16:42:14,2013-12-18 16:40:33
0155cd5bc6fb62300ec26130c0f8c16a8a669c82...5d54ce99eb7c805f567419f1d473b818fff10bdf,5,14,7,21,6,2013-12-18 17:57:34,2013-12-18 17:57:34
5d54ce99eb7c805f567419f1d473b818fff10bdf...9b6697949d5e9e2c7d330f8e01c663ccfbb38f35,1,23,2,25,3,2013-12-18 18:50:47,2013-11-26 15:55:29
9b6697949d5e9e2c7d330f8e01c663ccfbb38f35...140ccec2dc0933afc6f680457304f156df9db560,1,0,8,8,1,2013-12-18 19:04:15,2013-12-18 18:43:11
140ccec2dc0933afc6f680457304f156df9db560...e2a66c54f5ae80f0055ed3b09799b717842e4f25,4,465,0,465,6,2013-12-18 19:18:02,2013-12-17 18:17:10
e2a66c54f5ae80f0055ed3b09799b717842e4f25...eae98a4bba372213daf5a6f080b92346d6d01cab,1,2,2,4,2,2013-12-18 19:56:12,2013-12-17 18:32:08
eae98a4bba372213daf5a6f080b92346d6d01cab...63578f4a440f94c9fecf71dcc093e2885dfe18f1,1,1,1,2,1,2013-12-18 19:56:12,2013-12-18 19:15:18
63578f4a440f94c9fecf71dcc093e2885dfe18f1...63732d3884573512fb8a906774a7500b3a2405eb,2,11,5,16,5,2013-12-18 19:56:12,2013-12-18 19:55:33
63732d3884573512fb8a906774a7500b3a2405eb...00ec2dfd342a5bdf9824ab13ba4a62b45fc72ae8,4,6,2,8,5,2013-12-18 19:56:13,2013-12-18 19:56:04
00ec2dfd342a5bdf9824ab13ba4a62b45fc72ae8...e4c2ff13439e0a36ebdaa93a5a636306a792ded9,2,1,2,3,2,2013-12-18 20:05:12,2013-12-18 20:05:12
e4c2ff13439e0a36ebdaa93a5a636306a792ded9...31927fbf34eb9a5e684aa29e406580dc2b685285,1,3,10,13,3,2013-12-18 20:40:13,2013-12-17 20:50:17
31927fbf34eb9a5e684aa29e406580dc2b685285...0ec3c8d281bf634aba07b73f1ff88aa68ec46a6a,1,1,0,1,1,2013-12-18 22:32:52,2013-12-18 22:06:36
0ec3c8d281bf634aba07b73f1ff88aa68ec46a6a...edc9da17c4abd325a85134fe5551effe8ee58977,1,4,9,13,5,2013-12-19 00:09:17,2013-12-16 21:08:29
edc9da17c4abd325a85134fe5551effe8ee58977...4b214cdb0174400cd40a59bd39bfa5bb490e6f6f,2,7,5,12,4,2013-12-19 00:09:17,2013-10-30 21:00:27
4b214cdb0174400cd40a59bd39bfa5bb490e6f6f...cf9d4de0599bea469467c4380a24cdd9e8634161,2,64,10,74,6,2013-12-19 00:09:17,2013-10-22 21:39:58
cf9d4de0599bea469467c4380a24cdd9e8634161...7cd242247570278ce63047ff102cb700c17feeb8,3,104,0,104,7,2013-12-19 00:09:17,2013-10-24 21:03:57
7cd242247570278ce63047ff102cb700c17feeb8...54cee6c07af4c2973f34b25de271f7258dafbc84,1,79,16,95,7,2013-12-19 00:09:17,2013-12-06 19:07:50
54cee6c07af4c2973f34b25de271f7258dafbc84...3e707bcd22b7c0e8275d25bf8e8b28c3cec4cc67,3,15,5,20,9,2013-12-19 00:09:17,2013-12-09 17:27:13
3e707bcd22b7c0e8275d25bf8e8b28c3cec4cc67...170e563e4cfa069f2128379e7b997e6777e0ee99,19,436,50,486,67,2013-12-19 00:09:17,2013-12-13 18:39:01
170e563e4cfa069f2128379e7b997e6777e0ee99...faa1b95e619b7d50c3e445bd0f03b6ed5edc29a0,2,0,9,9,2,2013-12-19 12:50:22,2013-12-18 21:12:25
faa1b95e619b7d50c3e445bd0f03b6ed5edc29a0...02415f853e9a851e7d5a43cf8ef100e0b30cad9e,1,1,1,2,1,2013-12-19 14:31:28,2013-12-19 14:23:01
02415f853e9a851e7d5a43cf8ef100e0b30cad9e...b7a23c83481055a5daaec8e5686096fa7edadbb2,1,5,3,8,2,2013-12-19 16:23:18,2013-12-19 16:23:18
b7a23c83481055a5daaec8e5686096fa7edadbb2...5d64d36763fcbb51850e2c7d6fd3c6cfbda6b1cc,1,1,1,2,1,2013-12-19 16:30:28,2013-12-19 16:30:28
5d64d36763fcbb51850e2c7d6fd3c6cfbda6b1cc...bd9b6d70ef6acd431997860f40b830d29b58f56c,15,154,235,389,77,2013-12-19 16:32:39,2013-12-17 20:24:54
bd9b6d70ef6acd431997860f40b830d29b58f56c...9a34ccdde43942a4095c7a5b7285096993ed4860,1,4,2,6,2,2013-12-19 16:59:48,2013-12-19 16:59:27
9a34ccdde43942a4095c7a5b7285096993ed4860...597251304e2633e89d260a8c55a0ab11e0d0f6b2,2,90,19,109,14,2013-12-19 17:01:56,2013-12-17 19:27:30
597251304e2633e89d260a8c55a0ab11e0d0f6b2...c2f072309bf3d5e64757ebf49d98c005f3c47498,1,8,8,16,1,2013-12-19 18:12:10,2013-12-19 16:39:12
c2f072309bf3d5e64757ebf49d98c005f3c47498...66d4032fb7ca5a07a9bcb3d52fcf5acb62b449f7,8,31,110,141,23,2013-12-19 19:27:30,2013-12-19 18:10:42
66d4032fb7ca5a07a9bcb3d52fcf5acb62b449f7...5d123c850fc87e7f965db9c55cec520d88cbb996,4,13,11,24,9,2013-12-19 19:48:17,2013-12-18 21:32:27
5d123c850fc87e7f965db9c55cec520d88cbb996...c9f492cddb75624d870f9b3dfcc0b8e841e85ed8,9,496,23,519,29,2013-12-19 21:00:23,2013-12-13 16:53:25
c9f492cddb75624d870f9b3dfcc0b8e841e85ed8...3bb6baf7ac2c8e8a90f09fcba40aa436c6195285,1,2,2,4,1,2013-12-20 02:04:05,2013-12-20 01:52:37
3bb6baf7ac2c8e8a90f09fcba40aa436c6195285...3c9c156fa0aa4416310d043887528fc46a09820b,5,87,30,117,25,2013-12-20 15:24:03,2013-12-12 20:06:38
3c9c156fa0aa4416310d043887528fc46a09820b...15727f68617036f50194703267bcd134a9bad05e,6,13,12,25,7,2013-12-20 16:01:00,2013-11-26 04:06:57
15727f68617036f50194703267bcd134a9bad05e...77384d0a36a20a361f4b17260c127c5bb2aeacc1,4,34,5,39,5,2013-12-20 16:11:34,2013-12-20 15:40:19
77384d0a36a20a361f4b17260c127c5bb2aeacc1...d31fc15acc18f4600cecae45bfd1a6b1257fc554,2,24,1,25,13,2013-12-20 17:27:52,2013-12-20 17:27:52
d31fc15acc18f4600cecae45bfd1a6b1257fc554...a8dcfd60fe25ba1ad7b4198743da2ec657a09c66,1,9,7,16,6,2013-12-20 17:49:54,2013-12-19 22:04:45
a8dcfd60fe25ba1ad7b4198743da2ec657a09c66...b007da8af5f9af988f8debd41e35e054e0df8732,1,2,2,4,2,2013-12-20 17:49:54,2013-12-20 14:26:09
b007da8af5f9af988f8debd41e35e054e0df8732...82e1fdc81552c4c1da18a129287ac4eef03d9310,2,22,5,27,5,2013-12-20 18:45:24,2013-12-20 06:50:53
82e1fdc81552c4c1da18a129287ac4eef03d9310...3b5b35c15690769df2a11a75a3c6e6afd7c2169a,2,8,62,70,9,2013-12-20 19:13:11,2013-12-20 18:43:03
3b5b35c15690769df2a11a75a3c6e6afd7c2169a...191e9e47d8c211acdf7bef6850c261c2a40e2a8c,3,25,9,34,10,2013-12-20 19:16:08,2013-12-20 17:44:40
191e9e47d8c211acdf7bef6850c261c2a40e2a8c...3e6d6e56c0a8ff1db6c1518fd404c0b37d9db0dd,1,22,4,26,2,2013-12-20 19:23:55,2013-12-20 01:42:12
3e6d6e56c0a8ff1db6c1518fd404c0b37d9db0dd...6f1225ce6ed724e3dcc13a0acecb9d57a2e1dc47,1,0,1,1,1,2013-12-20 20:05:47,2013-12-19 21:24:50
6f1225ce6ed724e3dcc13a0acecb9d57a2e1dc47...e0af66d3ac4da46a4c2946a3d4056315cfb6653a,16,1074,90,1164,51,2013-12-20 20:51:05,2013-11-30 18:08:30
e0af66d3ac4da46a4c2946a3d4056315cfb6653a...82bc60e052b4d226632bf2c9d73e8fb2c3b509ec,4,4,4,8,4,2013-12-20 20:59:55,2013-12-06 01:55:57
82bc60e052b4d226632bf2c9d73e8fb2c3b509ec...5d29b14ecf01637f2a0a2e27e02abb7f645d6881,2,95,1,96,2,2013-12-20 21:29:07,2013-12-20 21:29:07
5d29b14ecf01637f2a0a2e27e02abb7f645d6881...a272fcfb0382f2bc2050a194a653b26c30c1dee6,1,19,27,46,10,2013-12-20 21:29:41,2013-12-20 21:29:41
a272fcfb0382f2bc2050a194a653b26c30c1dee6...358affcdd4112e1db0451a4c088cd8eaca79a704,9,0,111,111,23,2013-12-20 21:34:09,2013-12-20 16:37:56
358affcdd4112e1db0451a4c088cd8eaca79a704...49379b2f0cf23621cf7b5cd5abc9170f562c81cf,3,141,6,147,7,2013-12-20 21:34:09,2013-12-20 18:56:36
49379b2f0cf23621cf7b5cd5abc9170f562c81cf...66fb73662d77b8a085ca52a96324c1c6b2d40633,1,0,3,3,3,2013-12-20 21:34:09,2013-12-20 19:06:39
66fb73662d77b8a085ca52a96324c1c6b2d40633...cb4cfbd0c62311f74ed7dd7cb7f230b00dc6b54c,1,1,1,2,1,2013-12-20 21:44:31,2013-12-20 21:43:35
cb4cfbd0c62311f74ed7dd7cb7f230b00dc6b54c...62dc058e5fee631c4e78fb3116cb131b36b2c39b,7,580,316,896,71,2013-12-20 21:45:53,2013-12-20 21:43:56
62dc058e5fee631c4e78fb3116cb131b36b2c39b...a425c81c1dd224ebc9ed611653375f2a5cfffd46,2,35,32,67,27,2013-12-20 21:46:28,2013-12-04 16:29:38
a425c81c1dd224ebc9ed611653375f2a5cfffd46...a36903ef715cc962a254904e56b0ac1b7efd922f,2,4,1,5,3,2013-12-21 00:54:37,2013-12-21 00:54:37
a36903ef715cc962a254904e56b0ac1b7efd922f...f54536ac4e33bc18e8d7c1289c22e2e4d6c13eca,3,162,5,167,7,2013-12-22 15:04:35,2013-12-21 20:30:16
f54536ac4e33bc18e8d7c1289c22e2e4d6c13eca...5ce04be64d3421479e69f8f53a097425c77cfe18,1,36,0,36,1,2013-12-22 21:00:53,2013-12-22 21:00:53
5ce04be64d3421479e69f8f53a097425c77cfe18...e581d37e8dd0fdad3ed4d3b6179dc225972eb842,1,2,2,4,2,2013-12-22 22:53:39,2013-12-22 22:53:39
e581d37e8dd0fdad3ed4d3b6179dc225972eb842...317ee65c1d3a1d4ceadc1fc06ac2825ed111d0a1,7,172,7,179,14,2013-12-23 01:21:50,2013-12-19 05:01:49
317ee65c1d3a1d4ceadc1fc06ac2825ed111d0a1...a150514ab2382ed87ba2d66079e9d415c50f30cf,1,3,5,8,1,2013-12-23 01:21:50,2013-12-19 05:08:45
a150514ab2382ed87ba2d66079e9d415c50f30cf...30f296cb008dff4936545fceb94a6c247e633b67,1,21,17,38,12,2013-12-23 01:21:50,2013-12-19 14:29:18
30f296cb008dff4936545fceb94a6c247e633b67...be828115141bb24373fcf395a8140e289a8e9b89,11,178,52,230,44,2013-12-23 01:21:50,2013-12-19 23:54:39
be828115141bb24373fcf395a8140e289a8e9b89...68f0e4c16e9c38b8a04c697e58c6ff81f04a9c6e,1,28,28,56,5,2013-12-23 01:21:50,2013-12-20 21:28:44
68f0e4c16e9c38b8a04c697e58c6ff81f04a9c6e...90bdeb9e6657afb9ca71a62db0996c040e0fafdd,15,151,31,182,36,2013-12-23 01:21:50,2013-12-20 23:55:43
90bdeb9e6657afb9ca71a62db0996c040e0fafdd...a03bc6e323dcacfbea5073681c3ee23326f1f967,3,18,4,22,8,2013-12-23 01:21:50,2013-12-21 03:22:13
a03bc6e323dcacfbea5073681c3ee23326f1f967...21dbb5ed31125557a2c7177b901e3a579b376915,1,1,1,2,1,2013-12-23 01:21:50,2013-12-21 06:05:47
21dbb5ed31125557a2c7177b901e3a579b376915...48228e1fb73389405575b8f349d87d04e7de9841,1,3,1,4,2,2013-12-23 01:21:50,2013-12-21 14:30:10
48228e1fb73389405575b8f349d87d04e7de9841...7b11aa72f41cac7b4f4961a9a6ece9812f9eafac,3,3,5,8,7,2013-12-23 01:21:50,2013-12-21 20:15:44
7b11aa72f41cac7b4f4961a9a6ece9812f9eafac...d278f4567f82d07fd270e0df17616ccf93337f37,2,9,7,16,9,2013-12-23 01:21:50,2013-12-23 01:21:25
d278f4567f82d07fd270e0df17616ccf93337f37...178412408c0c29711cb9ee2798c410b2a3fd66d1,1,4,1,5,1,2013-12-23 05:46:21,2013-12-23 05:46:21
178412408c0c29711cb9ee2798c410b2a3fd66d1...5bc0c87690e5f27bd7b2c7e53959c6cc3b98e39c,1,5,0,5,2,2013-12-23 14:34:47,2013-12-23 14:34:47
5bc0c87690e5f27bd7b2c7e53959c6cc3b98e39c...88a82062a05b2a969219581d066afc3b9580c4bc,2,4,3,7,3,2013-12-23 16:19:29,2013-12-23 03:57:52
88a82062a05b2a969219581d066afc3b9580c4bc...b00647b114f7f7f36b37acb6217025ba1bd378c2,14,200,105,305,30,2013-12-23 17:55:55,2013-12-20 00:13:11
b00647b114f7f7f36b37acb6217025ba1bd378c2...e3a5eb3ecece3bc41e09d75a6df4b5ac5f99402b,2,29,4,33,6,2013-12-23 18:04:15,2013-12-20 17:58:10
e3a5eb3ecece3bc41e09d75a6df4b5ac5f99402b...1a30d06d98370f7804c99b18b6ae5bc7503f25dd,1,17,7,24,6,2013-12-23 22:32:53,2013-12-23 22:24:39
1a30d06d98370f7804c99b18b6ae5bc7503f25dd...7b3ef44c8b2f8f54ebcca47de940e855369c8be6,1,2,0,2,2,2013-12-23 23:40:12,2013-12-23 23:35:11
7b3ef44c8b2f8f54ebcca47de940e855369c8be6...ee0365ac659fa89758263d19327d69c547eb2d50,1,22,0,22,1,2013-12-24 03:27:19,2013-12-23 23:56:15
ee0365ac659fa89758263d19327d69c547eb2d50...f148caa11e97727949b5e8594b7439856faff499,24,330,51,381,50,2013-12-24 19:04:22,2013-12-19 22:12:12
f148caa11e97727949b5e8594b7439856faff499...4fd4c6ed97acad43178c6a004757cf5d73f9071f,18,2049,844,2893,507,2013-12-24 21:21:52,2013-10-29 17:46:54
4fd4c6ed97acad43178c6a004757cf5d73f9071f...9d46b36cd227bd6ec7737aaad57f71a8509bff0e,3,692,0,692,5,2013-12-25 03:01:07,2013-12-10 16:25:30
9d46b36cd227bd6ec7737aaad57f71a8509bff0e...491c91c6bf7532903a5bd4baf8b96b38b7c59266,1,1,1,2,1,2013-12-25 04:35:38,2013-12-25 04:35:38
491c91c6bf7532903a5bd4baf8b96b38b7c59266...d9b651d1f57a53b9079c236b875b9876b04a5996,1,1,1,2,1,2013-12-25 08:12:16,2013-12-25 08:11:59
d9b651d1f57a53b9079c236b875b9876b04a5996...e63ebb10569e05b65a34071f0a9360374b4d7139,1,1,1,2,1,2013-12-25 23:26:08,2013-12-25 23:25:58
e63ebb10569e05b65a34071f0a9360374b4d7139...6c5777102a973d9b5e41619f2315b75da3be3084,29,209,180,389,194,2013-12-28 16:32:36,2013-12-18 20:24:59
6c5777102a973d9b5e41619f2315b75da3be3084...1ec346c8de320fc404e9361e647c8dc1181752e6,1,7,5,12,7,2013-12-29 02:26:52,2013-12-23 18:32:38
1ec346c8de320fc404e9361e647c8dc1181752e6...90350818b40b54b2859d0c6aefdaa171b929a7ad,7,152,145,297,65,2013-12-29 02:26:52,2013-12-23 18:33:46
90350818b40b54b2859d0c6aefdaa171b929a7ad...3d017c25f5b6988f854ad6d0a50762ff2fd12e14,2,0,22,22,2,2013-12-29 02:26:52,2013-12-23 18:54:46
3d017c25f5b6988f854ad6d0a50762ff2fd12e14...47297ff0f5efe253345bd692e8229b03c1ce20a0,1,7,2,9,2,2013-12-29 02:26:52,2013-12-23 18:55:11
47297ff0f5efe253345bd692e8229b03c1ce20a0...438c631c48a3da079eb27cf90049f9e9eab5232f,1,5,3,8,2,2013-12-29 02:26:52,2013-12-23 18:55:25
438c631c48a3da079eb27cf90049f9e9eab5232f...6ef65f8e21454d35febc7b992a6a23c2b98a3ebd,2,41,29,70,13,2013-12-29 02:26:53,2013-12-23 18:55:34
6ef65f8e21454d35febc7b992a6a23c2b98a3ebd...09be6f838b48ef35ac79d0dd4efbc2a0e7717843,10,49,35,84,27,2013-12-29 02:26:53,2013-12-23 19:32:09
09be6f838b48ef35ac79d0dd4efbc2a0e7717843...4a7e99ce2bb7bcff19f4d76a09f584cbf34706b6,1,1,1,2,1,2013-12-29 02:26:53,2013-12-23 20:32:17
4a7e99ce2bb7bcff19f4d76a09f584cbf34706b6...1403644604daa0f34712696edc7a8c0b33bb1b30,1,0,1,1,1,2013-12-29 02:26:53,2013-12-23 20:32:46
1403644604daa0f34712696edc7a8c0b33bb1b30...c2ce4e5d2789ba42977ffe9caef6facd22108549,1,4,1,5,1,2013-12-29 02:26:53,2013-12-23 20:32:56
c2ce4e5d2789ba42977ffe9caef6facd22108549...b5050a2465b523b3fb868701f9d44bf226e67443,5,129,154,283,27,2013-12-29 02:26:53,2013-12-23 22:27:44
b5050a2465b523b3fb868701f9d44bf226e67443...598e00dc8ca2ebc80ff67c822a0c580d7627f6f7,3,14,11,25,6,2013-12-29 02:26:53,2013-12-23 22:40:58
598e00dc8ca2ebc80ff67c822a0c580d7627f6f7...084d3ddd773cdd2843aaa5c32d1b5b2680f1634b,1,1,1,2,1,2013-12-29 02:26:53,2013-12-24 01:33:05
084d3ddd773cdd2843aaa5c32d1b5b2680f1634b...d10dbc7ff125f7c4c87fcec02dc5ac9e553c301c,2,5,25,30,7,2013-12-29 02:26:53,2013-12-24 01:49:38
d10dbc7ff125f7c4c87fcec02dc5ac9e553c301c...616db7ddb0df0b4b5f7d2e7e118caf1f3023ca51,1,14,0,14,1,2013-12-29 02:26:53,2013-12-24 05:53:14
616db7ddb0df0b4b5f7d2e7e118caf1f3023ca51...773034467c1ec8d55983ec058fd314ed6ab89a06,1,21,21,42,6,2013-12-30 05:40:40,2013-12-24 14:08:48
773034467c1ec8d55983ec058fd314ed6ab89a06...490d0ab02d32f7fc79e9b74d2051bab67d92d9f8,3,1,37,38,20,2013-12-30 05:41:04,2013-12-24 14:20:18
490d0ab02d32f7fc79e9b74d2051bab67d92d9f8...86c25935a3ae93366f7745ceff72e5b4e517b223,1,3,4,7,3,2013-12-30 05:41:04,2013-12-24 14:24:29
86c25935a3ae93366f7745ceff72e5b4e517b223...4223bcc9879b74a069acfd8662d3351609d3cfa8,2,0,18,18,2,2013-12-30 05:41:04,2013-12-24 14:24:58
4223bcc9879b74a069acfd8662d3351609d3cfa8...dee4d75286ec771d38e9b9be7ff0931983aa18ea,6,7,5,12,8,2013-12-30 05:41:04,2013-12-24 14:39:34
dee4d75286ec771d38e9b9be7ff0931983aa18ea...7baf6b7172c521e20781c2be2b74cce1e1100578,2,2,2,4,2,2013-12-30 05:41:04,2013-12-24 14:50:27
7baf6b7172c521e20781c2be2b74cce1e1100578...e036417146aefb98446b0a5ad1ddf9fd9a33c7bd,5,73,48,121,18,2013-12-30 05:41:05,2013-12-24 15:32:30
e036417146aefb98446b0a5ad1ddf9fd9a33c7bd...78eaaa09bd8c2cf0c818447a98a45857db3162ad,1,0,2,2,1,2013-12-30 05:41:05,2013-12-24 16:18:36
78eaaa09bd8c2cf0c818447a98a45857db3162ad...29e691a91c72b28ef50faddc7ef6f24523788aee,25,33,40,73,30,2013-12-30 05:41:05,2013-12-24 16:35:45
29e691a91c72b28ef50faddc7ef6f24523788aee...7de1f17148231074cdf74177dcbf8e8fc534949b,72,957,634,1591,412,2013-12-30 05:41:27,2013-12-24 23:44:18
7de1f17148231074cdf74177dcbf8e8fc534949b...4bd4ef8d8e3002baf3e5e6b6bbed5ae883152590,1,15,6,21,4,2013-12-30 05:41:57,2013-12-25 00:02:27
4bd4ef8d8e3002baf3e5e6b6bbed5ae883152590...730bcd52f2a0d17e8fab2c70fd83260a05575d20,1,8,0,8,1,2013-12-30 05:42:20,2013-12-25 00:13:52
730bcd52f2a0d17e8fab2c70fd83260a05575d20...2742ffe792e8ca072557ce2c34728c21d1d69b8d,5,8,28,36,14,2013-12-30 05:42:23,2013-12-25 02:30:52
2742ffe792e8ca072557ce2c34728c21d1d69b8d...4879aee55baa067f665e57e53b798e27ba04e091,2,2,7,9,3,2013-12-30 05:42:31,2013-12-25 02:54:05
4879aee55baa067f665e57e53b798e27ba04e091...5ede5847727c7160c9b7d995ced97401b3a2c9ef,1,8,0,8,3,2013-12-30 05:42:52,2013-12-25 18:40:48
5ede5847727c7160c9b7d995ced97401b3a2c9ef...60c1adb8617637029554e0610c0319b660422eb3,3,5,333,338,9,2013-12-30 05:42:59,2013-12-25 18:53:08
60c1adb8617637029554e0610c0319b660422eb3...bf2d8120ccb230f088d742bb5ddfad9b93c62041,6,27,21,48,12,2013-12-30 05:43:17,2013-12-25 19:42:23
bf2d8120ccb230f088d742bb5ddfad9b93c62041...80df92c8c51c1255adc40e12dc70312859983e65,4,14,24,38,10,2013-12-30 05:43:24,2013-12-26 02:11:00
80df92c8c51c1255adc40e12dc70312859983e65...889a5182325c0842a48c17dd252d02e3b919fbf2,3,197,196,393,8,2013-12-30 05:43:24,2013-12-26 02:34:44
889a5182325c0842a48c17dd252d02e3b919fbf2...696cc2d77849fceaf22a0f27a85d2a344a3e1751,2,11,11,22,3,2013-12-30 05:43:36,2013-12-27 00:46:06
696cc2d77849fceaf22a0f27a85d2a344a3e1751...e10159da29f812b190c6c86fa20b2c8f21ef754f,3,6,2,8,4,2013-12-30 05:44:15,2013-12-29 03:07:56
e10159da29f812b190c6c86fa20b2c8f21ef754f...9ed59dd2cd3ba625591e2c2e0330065b43519f0a,2,7,3,10,4,2013-12-30 05:44:24,2013-12-29 11:58:49
9ed59dd2cd3ba625591e2c2e0330065b43519f0a...cf18a3d461977e700235cc3ccbb3e818c19d0938,1,1,0,1,1,2013-12-30 05:44:35,2013-12-29 12:48:37
cf18a3d461977e700235cc3ccbb3e818c19d0938...d920867fd39c04022c22e419f09e47397f6d25f6,5,4,4,8,6,2013-12-30 05:44:55,2013-12-30 00:19:18
d920867fd39c04022c22e419f09e47397f6d25f6...b293e3e736de66d86d3012a534bd11a62c33c1c9,2,5,32,37,4,2013-12-30 05:45:08,2013-12-30 05:33:06
b293e3e736de66d86d3012a534bd11a62c33c1c9...a51d160fd256118c1c5ac8ea25e39f716686155c,5,19,7,26,10,2013-12-30 05:47:23,2013-12-30 05:47:23
a51d160fd256118c1c5ac8ea25e39f716686155c...6710af95fc2dcda97d5ce07ee559c03ceaa7df5c,1,6,0,6,1,2013-12-30 06:09:39,2013-12-30 06:09:39
6710af95fc2dcda97d5ce07ee559c03ceaa7df5c...1491a7382982110e185f5917f462a8a372488627,2,38,37,75,2,2013-12-30 13:11:49,2013-12-30 13:11:49
1491a7382982110e185f5917f462a8a372488627...c0ff282b7cf7a70a7f60c44b9f2c2ad8d67bd35e,2,31,0,31,4,2013-12-30 13:49:11,2013-12-26 20:52:40
c0ff282b7cf7a70a7f60c44b9f2c2ad8d67bd35e...44a01e7e4f4e86933ea792c1d110542d66560b6c,2,34,1,35,2,2013-12-30 17:33:35,2013-12-23 22:57:30
44a01e7e4f4e86933ea792c1d110542d66560b6c...67573b22240f455ed425ed040b6f0ac1a7077b74,4,75,33,108,17,2013-12-30 17:58:37,2013-12-29 18:14:02
67573b22240f455ed425ed040b6f0ac1a7077b74...1b599c9f17c6dd10b320e5d642a03604164aec2d,1,4,7,11,2,2013-12-30 18:46:52,2013-12-29 01:42:36
1b599c9f17c6dd10b320e5d642a03604164aec2d...6486c53c2de908d90f098eb1295a07440a8cc6b0,2,33,0,33,3,2013-12-30 19:10:33,2013-12-29 18:34:27
6486c53c2de908d90f098eb1295a07440a8cc6b0...7964cab85a28baaff6534a91b6b379b79e7a738a,7,63,12,75,12,2013-12-31 20:16:54,2013-12-31 20:15:59
7964cab85a28baaff6534a91b6b379b79e7a738a...271ecb700eaad773baa052cddfb426b19f5598f5,10,1480,372,1852,41,2013-12-31 20:19:28,2013-12-17 16:58:45
271ecb700eaad773baa052cddfb426b19f5598f5...ffe170ed99cbb04918e75ebbee408871a810123a,6,183,25,208,17,2013-12-31 20:26:44,2013-12-31 20:26:01
ffe170ed99cbb04918e75ebbee408871a810123a...de8af0f35153b718307f5a96cd5be255a90e0e8e,12,2104,10,2114,32,2013-12-31 23:46:38,2013-12-19 22:28:57
de8af0f35153b718307f5a96cd5be255a90e0e8e...419be507ff3ccafd1a5dcda9a40144ed6fb4901e,1,61,0,61,6,2014-01-02 00:02:08,2014-01-02 00:02:08
419be507ff3ccafd1a5dcda9a40144ed6fb4901e...e4fe380f5173678720adeefd98b15f87140109e3,8,180,56,236,31,2014-01-02 16:40:13,2013-12-20 22:36:03
e4fe380f5173678720adeefd98b15f87140109e3...d1fc0022af89d70fee77f13470cce1b9c73bf90b,2,6,2,8,2,2014-01-02 16:44:54,2013-12-23 22:56:35
d1fc0022af89d70fee77f13470cce1b9c73bf90b...b844faf0a0793153979273e8e9a46e22777e7ff0,1,8,6,14,5,2014-01-02 16:45:55,2014-01-02 16:45:07
b844faf0a0793153979273e8e9a46e22777e7ff0...6de0da15e46398dfc1b1747ec2c27c61c2e8bca9,3,8,0,8,3,2014-01-02 16:16:30,2013-12-30 20:42:52
6de0da15e46398dfc1b1747ec2c27c61c2e8bca9...44664c856e3ef744f18753cc01afcff7d359d9df,1,3,3,6,2,2014-01-02 17:56:23,2014-01-02 17:56:23
44664c856e3ef744f18753cc01afcff7d359d9df...da176cb44bbfcaff5c1cbd59d8866f3cf7cc791d,10,20,34,54,21,2014-01-02 18:00:27,2013-12-19 17:38:57
da176cb44bbfcaff5c1cbd59d8866f3cf7cc791d...44abf68eeab7e40557fc3e2358030584d34163ac,2,14,8,22,6,2014-01-02 18:00:27,2013-12-19 19:31:09
44abf68eeab7e40557fc3e2358030584d34163ac...b71af1bc88e0ee2bab90d1f2a7400dc65649e087,1,5,3,8,2,2014-01-02 18:00:27,2013-12-19 22:08:22
b71af1bc88e0ee2bab90d1f2a7400dc65649e087...3e12a615522f5a00b5b3fbd07159c42b898a0aa1,7,41,47,88,11,2014-01-02 18:21:02,2013-12-30 21:06:29
3e12a615522f5a00b5b3fbd07159c42b898a0aa1...044bbff557853c9a4dac9018622ccbc7aaba9f99,1,1,1,2,1,2014-01-02 19:27:44,2013-12-09 21:04:33
044bbff557853c9a4dac9018622ccbc7aaba9f99...7cccec0ff61f573baf17cde32e325b7f2b08e2cb,1,2,2,4,2,2014-01-02 21:03:38,2014-01-02 19:56:36
7cccec0ff61f573baf17cde32e325b7f2b08e2cb...94aa072feddc099ccd7579a5b41d8d567b86b194,1,20,10,30,2,2014-01-02 22:00:02,2014-01-02 18:54:07
94aa072feddc099ccd7579a5b41d8d567b86b194...b4caa84a9f8a49ccafae06730b9e0087dbbfbb92,2,2,2,4,2,2014-01-02 23:54:18,2014-01-02 23:53:47
b4caa84a9f8a49ccafae06730b9e0087dbbfbb92...04221630900335fc6ee0d9922edae9d29f02d66d,1,20,19,39,21,2014-01-03 14:19:00,2014-01-01 15:45:22
04221630900335fc6ee0d9922edae9d29f02d66d...ab48b396e5bc48cb27ce3bc2dbd28bf3b6a96851,8,173,108,281,42,2014-01-03 17:50:26,2013-12-24 20:27:14
ab48b396e5bc48cb27ce3bc2dbd28bf3b6a96851...62777be1aa94d4bbdae593b931cc37561d905a96,1,1,1,2,1,2014-01-03 20:24:45,2014-01-02 15:14:14
62777be1aa94d4bbdae593b931cc37561d905a96...cd69950fab2cb1f55b87300bfd88218f49500da5,5,56,3,59,10,2014-01-03 21:17:05,2013-12-27 07:23:43
cd69950fab2cb1f55b87300bfd88218f49500da5...c321c9c0b668c8006e3a43971cbf6e0e37778efb,4,78,26,104,20,2014-01-03 21:47:04,2014-01-02 18:32:17
c321c9c0b668c8006e3a43971cbf6e0e37778efb...1168a2605f7351a121f89e64eb7592e91cc869a5,2,2,0,2,2,2014-01-03 22:50:59,2013-12-31 22:41:09
1168a2605f7351a121f89e64eb7592e91cc869a5...83aec0c8a58ba16d63dd4092152b2e4dfd611c09,1,1,1,2,1,2014-01-03 23:20:10,2014-01-03 23:05:03
83aec0c8a58ba16d63dd4092152b2e4dfd611c09...fdcaa37f78789c4bdedac8fd98c0fdfc517fb978,10,1391,4,1395,11,2014-01-03 23:20:15,2014-01-03 18:30:13
fdcaa37f78789c4bdedac8fd98c0fdfc517fb978...22424987d2f0df32671998f0c7574adcfa07bf32,4,59,42,101,6,2014-01-04 00:00:17,2014-01-04 00:00:17
22424987d2f0df32671998f0c7574adcfa07bf32...25135aa82d3f54db2dce6ca64781efcdde2e55d0,2,0,2,2,2,2014-01-04 02:27:18,2014-01-04 02:27:18
25135aa82d3f54db2dce6ca64781efcdde2e55d0...5e1212b15f37acc2d0fd8b943661732333991daa,1,2,2,4,2,2014-01-04 16:19:26,2014-01-04 16:19:26
5e1212b15f37acc2d0fd8b943661732333991daa...06851f4859a61019a17147ea96c4e6d9462f354b,1,4,4,8,4,2014-01-04 16:27:04,2014-01-04 16:27:04
06851f4859a61019a17147ea96c4e6d9462f354b...cc350cdb65f90070ee45b83cf27d47a610a55b08,2,14,1,15,3,2014-01-04 19:55:31,2013-12-22 17:08:53
cc350cdb65f90070ee45b83cf27d47a610a55b08...42dce2cb1debd7c6b73aba01d9e038c41726a530,1,8,2,10,1,2014-01-04 19:55:32,2013-12-22 17:18:22
42dce2cb1debd7c6b73aba01d9e038c41726a530...a1ebb6624c8b17438f84392638639d874a789392,3,17,1,18,5,2014-01-04 19:55:32,2013-12-22 18:22:25
a1ebb6624c8b17438f84392638639d874a789392...7829e62e06559b75c6121e0486d4f1769f4dbfa6,1,24,23,47,24,2014-01-04 19:55:32,2013-12-31 17:56:36
7829e62e06559b75c6121e0486d4f1769f4dbfa6...344b86426595713e32fefa2e5a627988b04529fb,10,71,116,187,56,2014-01-04 19:55:32,2013-12-22 15:49:36
344b86426595713e32fefa2e5a627988b04529fb...1d0ac3e882c6323fc99fb98c861629caf8e3918e,9,75,36,111,29,2014-01-04 19:55:32,2013-12-23 18:47:43
1d0ac3e882c6323fc99fb98c861629caf8e3918e...c8c1dfc29da5f2232f17865fb4cb0d94ed1da2da,1,11,8,19,3,2014-01-04 19:55:56,2013-12-30 22:15:39
c8c1dfc29da5f2232f17865fb4cb0d94ed1da2da...4cd551544a4f25dcb5c2447b9ee14cf0591a3cfe,1,8,8,16,8,2014-01-05 10:15:00,2014-01-05 10:15:00
4cd551544a4f25dcb5c2447b9ee14cf0591a3cfe...8bad5a8633eeca3bcbb975aabf268db9921f2c57,3,62,0,62,6,2014-01-05 15:32:01,2013-12-27 20:25:13
8bad5a8633eeca3bcbb975aabf268db9921f2c57...81d8d29c4e2a7a706b6fb0f4d4f821ca2ed38161,3,67,67,134,15,2014-01-06 16:07:24,2014-01-02 18:25:27
81d8d29c4e2a7a706b6fb0f4d4f821ca2ed38161...e89dccbef9b83ac8101dcceab64f5c6e09b6de50,14,224,124,348,86,2014-01-06 17:11:34,2014-01-03 19:33:07
e89dccbef9b83ac8101dcceab64f5c6e09b6de50...cc6e1b9cab1e42e4b41ff9689cca500ff106074c,20,580,273,853,97,2014-01-06 20:45:55,2013-12-02 16:17:52
cc6e1b9cab1e42e4b41ff9689cca500ff106074c...8bfce9bcce36c2250f17fb51cadbdabb74754e10,1,7,3,10,3,2014-01-06 20:53:27,2014-01-06 19:25:13
8bfce9bcce36c2250f17fb51cadbdabb74754e10...f2c66a95752628a1c51fd7b35148ff76e0718722,1,1,1,2,1,2014-01-06 20:53:27,2014-01-06 19:40:35
f2c66a95752628a1c51fd7b35148ff76e0718722...8efec57e697a3bdbd72e4cdebf39e8e8fa9c2df4,1,307,0,307,1,2014-01-06 21:41:20,2013-12-12 22:04:53
8efec57e697a3bdbd72e4cdebf39e8e8fa9c2df4...c7ad0ea79722bb806ae4f5b8f8adfd67fa3ca180,1,171,0,171,1,2014-01-06 21:41:20,2013-12-13 22:03:40
c7ad0ea79722bb806ae4f5b8f8adfd67fa3ca180...c066779f8418835827eb0c48ce4ddb1ecccd416c,1,229,0,229,1,2014-01-06 21:41:20,2013-12-16 23:51:14
c066779f8418835827eb0c48ce4ddb1ecccd416c...e08d7acd008b68259832a7479d817ad6e087779f,2,202,0,202,2,2014-01-06 21:41:20,2013-12-18 20:11:15
e08d7acd008b68259832a7479d817ad6e087779f...46068dbc19b0223f2b1da316482d46a3cdcc29b6,2,53,15,68,21,2014-01-06 21:41:20,2013-12-16 22:18:55
46068dbc19b0223f2b1da316482d46a3cdcc29b6...df7f129d1fb76934b1d45653f86df6a6411c66ad,1,31,31,62,31,2014-01-06 21:41:20,2014-01-03 22:22:24
df7f129d1fb76934b1d45653f86df6a6411c66ad...9f009f6aeaafeff034e4f658002f4c131bfd45ee,1,4,3,7,3,2014-01-06 23:36:39,2014-01-06 23:36:39
9f009f6aeaafeff034e4f658002f4c131bfd45ee...f4c05fbb804842a449e8131784069c2757ab2b23,4,20,11,31,12,2014-01-07 01:15:21,2013-12-17 20:21:43
f4c05fbb804842a449e8131784069c2757ab2b23...8b57f45b149b9df8ed2e9d7f74bf5d33a650cd5c,30,174,111,285,83,2014-01-07 01:15:21,2013-12-30 19:14:14
8b57f45b149b9df8ed2e9d7f74bf5d33a650cd5c...38a8592abd02960a56f0b167d3a2366e130a8e9d,10,145,54,199,26,2014-01-07 02:43:59,2014-01-02 16:43:29
38a8592abd02960a56f0b167d3a2366e130a8e9d...620a73f36ec8c6bc1fb8782dcf3f637045cea5d9,9,35,38,73,41,2014-01-07 13:58:27,2014-01-06 19:06:41
620a73f36ec8c6bc1fb8782dcf3f637045cea5d9...fe0a2607127f13504b4a42fb1c08a4dd7384d844,2,0,17,17,7,2014-01-07 13:58:27,2014-01-06 19:07:45
fe0a2607127f13504b4a42fb1c08a4dd7384d844...57364a7de52c030af0d305c918de7180d0459ed1,6,81,48,129,28,2014-01-07 16:01:32,2013-12-20 22:11:00
57364a7de52c030af0d305c918de7180d0459ed1...fe567abc1d6bf07972c0f2704079298b67c6a1f6,1,74,55,129,10,2014-01-07 16:03:07,2013-12-10 18:12:35
fe567abc1d6bf07972c0f2704079298b67c6a1f6...949a331bfd2fa878324879089da2e58e333d3928,1,1,1,2,1,2014-01-07 16:24:19,2014-01-07 16:19:46
949a331bfd2fa878324879089da2e58e333d3928...24e5bfbc032512ef36ce641cea547f24df83e434,1,14,11,25,4,2014-01-07 16:38:56,2014-01-07 16:38:56
24e5bfbc032512ef36ce641cea547f24df83e434...fb925afd65723878fa2911f513f275eada1c8337,7,134,2,136,9,2014-01-07 16:40:46,2013-12-23 22:38:57
fb925afd65723878fa2911f513f275eada1c8337...133d28b56d04e67004aac22a18f068d70624393d,1,0,1,1,1,2014-01-07 18:37:09,2014-01-03 15:38:15
133d28b56d04e67004aac22a18f068d70624393d...edcfd827189045b8b64d38cf803d7555cc04132d,4,354,174,528,51,2014-01-07 18:37:09,2014-01-03 20:19:30
edcfd827189045b8b64d38cf803d7555cc04132d...c1bf7733d24108fc5543abb872cad6d7a5491dc2,13,947,603,1550,118,2014-01-07 18:37:09,2013-12-20 20:20:01
c1bf7733d24108fc5543abb872cad6d7a5491dc2...735a759908a3a8e792909eb23160ec29eba83e9c,1,10,0,10,1,2014-01-07 19:11:56,2013-12-23 21:02:37
735a759908a3a8e792909eb23160ec29eba83e9c...df3d84e688efbaa7c83666a1122761c29d10dfbe,3,75,1,76,2,2014-01-07 19:19:50,2013-12-10 12:57:01
df3d84e688efbaa7c83666a1122761c29d10dfbe...c9edb7fd03e67827227a7cb3c7c40555efcae152,1,2,2,4,2,2014-01-07 19:19:50,2013-12-10 14:05:01
c9edb7fd03e67827227a7cb3c7c40555efcae152...e6997d6ab5e5e048b1f99c764cd5e0c17d30808d,5,43,31,74,25,2014-01-07 20:04:16,2013-12-19 22:23:14
e6997d6ab5e5e048b1f99c764cd5e0c17d30808d...97176b9b73f8a5f2903865f80fcdc87586fa30af,1,1,1,2,1,2014-01-07 21:00:44,2014-01-07 20:40:37
97176b9b73f8a5f2903865f80fcdc87586fa30af...6535996c87f3430d8b084106c94e4763be50427a,1,1,1,2,1,2014-01-07 21:15:49,2014-01-07 20:41:44
6535996c87f3430d8b084106c94e4763be50427a...ae0745b758683f3fbdaf77071d75e5c8c6df30f3,1,7,4,11,4,2014-01-07 21:19:45,2014-01-07 18:42:31
ae0745b758683f3fbdaf77071d75e5c8c6df30f3...cabbc7fb299776129127fea730ebe6cfab8212e4,1,6,4,10,3,2014-01-07 21:37:10,2014-01-07 15:29:59
cabbc7fb299776129127fea730ebe6cfab8212e4...0950f1736f3175dc8160d527ccc6addeca33b51c,1,4,1,5,4,2014-01-07 21:37:11,2014-01-07 18:48:50
0950f1736f3175dc8160d527ccc6addeca33b51c...8c2b72f7f76368653e417778cddb0793ffed64e7,1,8,0,8,1,2014-01-07 21:37:11,2014-01-07 18:49:31
8c2b72f7f76368653e417778cddb0793ffed64e7...7ad6ad2e90f4b17c73c0f74f57460ef50469fa0b,3,109,2,111,8,2014-01-07 21:42:09,2013-12-23 19:19:12
7ad6ad2e90f4b17c73c0f74f57460ef50469fa0b...115c899ba16ce7bad943f121891f332058ec7055,4,138,418,556,38,2014-01-07 21:42:51,2014-01-06 18:36:25
115c899ba16ce7bad943f121891f332058ec7055...f921842ed25534bb62b3d3aeac7fe6392d2a8da6,1,1,1,2,1,2014-01-07 21:44:26,2014-01-07 21:22:56
f921842ed25534bb62b3d3aeac7fe6392d2a8da6...3be94e6c074a53a0a203561b57540ff4f2cdc689,7,83,30,113,11,2014-01-07 21:46:27,2014-01-06 19:23:11
3be94e6c074a53a0a203561b57540ff4f2cdc689...bf0efac7a9ce524341fb3967eb2b41c09afd1f1e,3,4,21,25,6,2014-01-07 23:17:42,2013-12-04 22:36:24
bf0efac7a9ce524341fb3967eb2b41c09afd1f1e...e129b9b625da164551471d68ccf9d2602abe4a3c,1,2,1,3,2,2014-01-07 23:32:28,2014-01-07 23:32:28
e129b9b625da164551471d68ccf9d2602abe4a3c...5432e4836aec87fe9b53efe19d3bfff90ef0f6ef,1,0,1,1,1,2014-01-07 23:40:16,2013-11-22 20:24:35
5432e4836aec87fe9b53efe19d3bfff90ef0f6ef...0d818f66f1a2429ce65b19afd9b5e7b64076732b,11,536,153,689,98,2014-01-08 00:33:13,2014-01-02 21:59:36
0d818f66f1a2429ce65b19afd9b5e7b64076732b...f87ff5cb5721eabffaae1ccc4a8dab8098d114fc,11,153,536,689,98,2014-01-08 02:18:58,2014-01-08 02:18:58
f87ff5cb5721eabffaae1ccc4a8dab8098d114fc...864682e70d12668bb1db67b052b5de6ee21fda35,2,2,2,4,2,2014-01-08 02:19:26,2014-01-07 22:25:21
864682e70d12668bb1db67b052b5de6ee21fda35...0e2410ee069deedc719778ff64a8faf452758ded,11,76,77,153,43,2014-01-08 14:41:53,2014-01-06 22:21:17
0e2410ee069deedc719778ff64a8faf452758ded...692222cd457c6d370647664627d248aebe05b8ab,4,11,0,11,6,2014-01-08 15:44:05,2014-01-07 18:33:16
692222cd457c6d370647664627d248aebe05b8ab...8dfa08c32ed52628cd7960b0c96fcc2a1ee34839,1,3,6,9,2,2014-01-08 16:49:27,2014-01-08 16:49:27
8dfa08c32ed52628cd7960b0c96fcc2a1ee34839...067894d8da40927ddb5c919a421a7f52ec39dd55,1,0,1,1,1,2014-01-08 16:54:24,2014-01-08 16:54:24
067894d8da40927ddb5c919a421a7f52ec39dd55...7a66f1eda0a3eaff3952357233680a528ffaa22c,15,280,423,703,41,2014-01-08 17:23:29,2014-01-06 22:22:23
7a66f1eda0a3eaff3952357233680a528ffaa22c...a548f5d0e555166bfef2e99ab52def93f3f1fa16,12,547,165,712,99,2014-01-08 17:29:27,2014-01-08 02:19:37
a548f5d0e555166bfef2e99ab52def93f3f1fa16...a1d62317d7d8266e5e40d81d8553ea796c7e57cd,15,596,2436,3032,66,2014-01-08 19:15:36,2014-01-06 15:26:12
a1d62317d7d8266e5e40d81d8553ea796c7e57cd...77e85d4e2a77ace7eb4f89fb81ca71c0b825326e,13,13,13,26,22,2014-01-08 19:15:36,2014-01-06 18:35:58
77e85d4e2a77ace7eb4f89fb81ca71c0b825326e...6fe729fdc28b23f105ff4466602615c8cd3585e8,1,240,363,603,120,2014-01-08 21:03:53,2013-12-23 18:38:55
6fe729fdc28b23f105ff4466602615c8cd3585e8...247d666dfe30db7aa1c3450dcab7c18ed9eb9c1c,3,15,33,48,5,2014-01-08 22:33:23,2014-01-08 16:52:37
247d666dfe30db7aa1c3450dcab7c18ed9eb9c1c...26fd0b03e7b41940a1b7a6de7d23ea3d00d9dc47,7,276,273,549,54,2014-01-08 22:40:01,2014-01-07 18:07:27
26fd0b03e7b41940a1b7a6de7d23ea3d00d9dc47...dfdfcefb7d0d7c484ffb6ca2519ec2e0272e25d7,1,5,0,5,1,2014-01-08 23:18:13,2014-01-08 00:00:23
dfdfcefb7d0d7c484ffb6ca2519ec2e0272e25d7...c3aff7ead075d1ed955d072e083b8527b4bc07fe,2,60,7,67,3,2014-01-08 23:18:13,2014-01-08 00:06:21
c3aff7ead075d1ed955d072e083b8527b4bc07fe...fa01bee42fa6b495474eded723ec0c4a538d802f,7,273,276,549,54,2014-01-09 05:36:19,2014-01-09 05:36:19
fa01bee42fa6b495474eded723ec0c4a538d802f...c8faa8a1bcb4f9eb9ad7d320b9fa720264fed115,1,0,2,2,1,2014-01-09 15:06:07,2014-01-08 22:12:38
c8faa8a1bcb4f9eb9ad7d320b9fa720264fed115...10e1d82ec69683259f6c35cb349431a86ad70ef0,1,0,5,5,1,2014-01-09 19:21:49,2014-01-02 14:37:31
10e1d82ec69683259f6c35cb349431a86ad70ef0...fcfa7ac2bd4b8f2c3a007c10fbba4ed7b487630d,24,191,225,416,83,2014-01-09 19:21:49,2014-01-02 22:33:14
fcfa7ac2bd4b8f2c3a007c10fbba4ed7b487630d...e2161d0d4e668bb51b13cd38992c7f6c65e21f94,7,27,38,65,14,2014-01-09 19:21:49,2014-01-03 04:05:40
e2161d0d4e668bb51b13cd38992c7f6c65e21f94...2ef97ca0ad9f72043e3daf7f2a1b0e13683d9eb3,4,101,19,120,5,2014-01-09 19:21:49,2014-01-03 19:50:58
2ef97ca0ad9f72043e3daf7f2a1b0e13683d9eb3...8ce65f16a3043e655730da37a6e9102ca8f8ca57,4,11,11,22,8,2014-01-09 19:21:49,2014-01-03 20:32:41
8ce65f16a3043e655730da37a6e9102ca8f8ca57...6b2bd70cf5d7f2cb04b351fc24279b702ebb6fec,2,29,31,60,10,2014-01-09 19:21:49,2014-01-03 20:35:52
6b2bd70cf5d7f2cb04b351fc24279b702ebb6fec...ea5d43f74e4ddf990a156ce37b05369cd9ee3479,29,867,413,1280,194,2014-01-09 19:21:49,2014-01-04 06:38:14
ea5d43f74e4ddf990a156ce37b05369cd9ee3479...aa0d807497e09fcee93a21b437b354ad0dcffd11,35,333,498,831,177,2014-01-09 19:21:49,2014-01-06 19:25:45
aa0d807497e09fcee93a21b437b354ad0dcffd11...4e148e971ffaaf74200702cfeb8d4bf591d456a4,7,78,48,126,31,2014-01-09 19:21:49,2014-01-06 22:07:38
4e148e971ffaaf74200702cfeb8d4bf591d456a4...87a5e280ae24bb1283b6e55378eee00ee088fb54,11,286,242,528,10,2014-01-09 19:21:50,2014-01-07 02:49:42
87a5e280ae24bb1283b6e55378eee00ee088fb54...79de42e8eff5236b09ab074127e422494087c2ab,6,44,12,56,7,2014-01-09 19:21:50,2014-01-07 03:50:20
79de42e8eff5236b09ab074127e422494087c2ab...6f6628fafff4d5864f1a82dd2b8591329bd0e984,2,21,19,40,2,2014-01-09 19:21:50,2014-01-07 04:44:17
6f6628fafff4d5864f1a82dd2b8591329bd0e984...ab60e47f8aaa989f276ae9bab7a75c03633f82c7,1,1,0,1,1,2014-01-09 19:21:50,2014-01-07 22:33:11
ab60e47f8aaa989f276ae9bab7a75c03633f82c7...3baaa39793e678789cef9f764852f975541af235,18,436,616,1052,63,2014-01-09 19:21:50,2014-01-07 22:33:33
3baaa39793e678789cef9f764852f975541af235...482a4383775c1db191a57dfc9f31afad22d96386,2,27,16,43,13,2014-01-09 19:21:50,2014-01-08 05:08:21
482a4383775c1db191a57dfc9f31afad22d96386...41f749323bd4ddedab2d52364f62e40ebd6f2c27,1,2,2,4,2,2014-01-09 19:21:50,2014-01-08 14:29:34
41f749323bd4ddedab2d52364f62e40ebd6f2c27...79dc4de53c86d0b9884b558575f0119e964408d8,4,223,175,398,23,2014-01-09 19:21:50,2014-01-08 15:06:11
79dc4de53c86d0b9884b558575f0119e964408d8...be9e89f5be0c3c976c8a61498aa82a23972b9ffe,3,13,0,13,4,2014-01-09 19:21:50,2014-01-08 17:29:33
be9e89f5be0c3c976c8a61498aa82a23972b9ffe...df19eb28abdc08e4c1c86dac0125dc8b8d3b2c52,4,108,67,175,24,2014-01-09 19:21:50,2014-01-08 18:23:41
df19eb28abdc08e4c1c86dac0125dc8b8d3b2c52...a99791ec7dc15b7d81340d13da9339adf80d467e,5,33,22,55,25,2014-01-09 19:21:50,2014-01-08 18:53:20
a99791ec7dc15b7d81340d13da9339adf80d467e...d77c296b2ccc0f9363f70fce0788a0672f8f073c,3,153,132,285,46,2014-01-09 19:21:50,2014-01-08 20:39:41
d77c296b2ccc0f9363f70fce0788a0672f8f073c...24ea972c1c2546d9de62856d9fcb10de5cd49078,4,71,45,116,24,2014-01-09 19:21:50,2014-01-08 20:59:31
24ea972c1c2546d9de62856d9fcb10de5cd49078...1a26bffb5ce4de70b5a0376e658391a2aeb97fd5,4,22,4,26,8,2014-01-09 19:21:50,2014-01-08 22:52:33
1a26bffb5ce4de70b5a0376e658391a2aeb97fd5...959064ba5d33fc68b5fef75bc73e881787dcfcca,4,30,9,39,7,2014-01-09 19:21:50,2014-01-08 22:32:42
959064ba5d33fc68b5fef75bc73e881787dcfcca...d2dada86c25adc8fb5af0b8af1318aeacf76f8fb,2,19,1,20,8,2014-01-09 19:21:50,2014-01-09 14:33:26
d2dada86c25adc8fb5af0b8af1318aeacf76f8fb...5e8d44f76165d8416bb1b9cba9c9bec6ec546e3c,6,0,114,114,10,2014-01-09 19:31:41,2014-01-09 19:31:41
5e8d44f76165d8416bb1b9cba9c9bec6ec546e3c...b1d0ab1422a2ec618f678b36fc5e4e253bbc8f2c,1,23,3,26,4,2014-01-09 21:48:38,2014-01-09 21:48:38
b1d0ab1422a2ec618f678b36fc5e4e253bbc8f2c...07f1f4787c2f4fc713a180326683bfdea3bedcf5,4,173,22,195,11,2014-01-09 22:28:13,2014-01-09 22:17:13
07f1f4787c2f4fc713a180326683bfdea3bedcf5...80455be8a4c1e6e63e7236a51668b0e446748b91,3,107,2,109,5,2014-01-09 22:28:13,2014-01-09 22:19:12
80455be8a4c1e6e63e7236a51668b0e446748b91...121671dcb9cef964f6a1332456afff18d05f7dfc,2,34,0,34,2,2014-01-09 22:28:13,2014-01-09 22:26:06
121671dcb9cef964f6a1332456afff18d05f7dfc...1b2af152b9806b0b3443bd4facddf87c8adecb0e,1,26,13,39,5,2014-01-09 23:55:22,2014-01-09 20:48:45
1b2af152b9806b0b3443bd4facddf87c8adecb0e...7a06ec8610e2bae128fbac03bdedcf0f89199e90,2,4,0,4,4,2014-01-10 01:41:09,2014-01-10 01:41:03
7a06ec8610e2bae128fbac03bdedcf0f89199e90...0815ed104abdca1c7443c641ab2b0eade0c776fd,2,8,2,10,2,2014-01-10 11:44:05,2014-01-10 03:08:52
0815ed104abdca1c7443c641ab2b0eade0c776fd...cd77abcb81b466094d02b747a530b0762e0c82d4,7,159,11,170,24,2014-01-10 15:08:30,2014-01-08 19:14:17
cd77abcb81b466094d02b747a530b0762e0c82d4...c55cc6aea43f2a71d90a44e955464656c84846e4,7,276,273,549,54,2014-01-10 15:12:13,2014-01-09 15:28:53
c55cc6aea43f2a71d90a44e955464656c84846e4...5af9a7433876664ac75bc0345f5903e04b5e1e7f,2,7,21,28,3,2014-01-10 15:12:13,2014-01-09 15:29:58
5af9a7433876664ac75bc0345f5903e04b5e1e7f...dd17ec43de5d4a716995ef3ed57220dac62b382f,1,29,19,48,6,2014-01-10 15:36:10,2014-01-09 16:24:52
dd17ec43de5d4a716995ef3ed57220dac62b382f...0abcd25376977c3f63db11446ab0b18c0ce88fff,5,84,31,115,18,2014-01-10 15:37:01,2014-01-09 20:39:18
0abcd25376977c3f63db11446ab0b18c0ce88fff...74f5f12f83f5dc6e221e4218ebe6832930822627,13,432,69,501,28,2014-01-10 18:03:51,2013-12-23 17:52:09
74f5f12f83f5dc6e221e4218ebe6832930822627...a0685f508ddb97b1a515e60973af2abb39d05926,1,266,0,266,1,2014-01-10 18:04:06,2014-01-07 20:42:11
a0685f508ddb97b1a515e60973af2abb39d05926...f35f54388e65df56a2a00e12395a63c3b5c9e3fc,1,0,3,3,1,2014-01-10 18:28:43,2014-01-10 18:28:34
f35f54388e65df56a2a00e12395a63c3b5c9e3fc...9cfca59caf6426bf3c14fa3730aa58003b223386,5,471,108,579,35,2014-01-10 19:48:59,2014-01-09 15:56:06
9cfca59caf6426bf3c14fa3730aa58003b223386...1d84ad9a0b48e1707d90196c5b6d60d33af58525,1,1,1,2,1,2014-01-10 21:44:20,2014-01-10 21:44:20
1d84ad9a0b48e1707d90196c5b6d60d33af58525...c2133cd477f36ff902956374604d0823f5e20416,1,4,0,4,2,2014-01-10 21:56:44,2014-01-10 20:40:49
c2133cd477f36ff902956374604d0823f5e20416...2c89a18fd406a673effd10884e9adaf55b68d78d,4,35,8,43,8,2014-01-10 22:11:49,2014-01-08 19:41:51
2c89a18fd406a673effd10884e9adaf55b68d78d...e0c69afcf27e690ebb518b4a56e05d4d09e06510,5,221,3,224,5,2014-01-13 02:21:49,2014-01-08 17:25:27
e0c69afcf27e690ebb518b4a56e05d4d09e06510...32646abb0b93eee036739d9e48a13c88d5956cc0,1,1,5,6,3,2014-01-13 03:19:00,2014-01-12 18:43:30
32646abb0b93eee036739d9e48a13c88d5956cc0...0e1d3ea041f92397ef896574b00b51930d32fb1a,9,158,23,181,25,2014-01-13 03:19:00,2014-01-10 21:07:17
0e1d3ea041f92397ef896574b00b51930d32fb1a...ee5bf211dd5db16a8fd8e40d0fadae4114014b4b,1,14,4,18,7,2014-01-13 04:39:41,2014-01-11 13:26:57
ee5bf211dd5db16a8fd8e40d0fadae4114014b4b...b6ddefed994b490a5828cd2d455395075de35d4d,8,410,332,742,23,2014-01-13 04:45:51,2014-01-13 04:45:51
b6ddefed994b490a5828cd2d455395075de35d4d...63ee8470a45ac3f25d80a10dc2256dc5d4a7ccbb,3,53,0,53,4,2014-01-13 06:03:24,2014-01-13 02:41:57
63ee8470a45ac3f25d80a10dc2256dc5d4a7ccbb...fef75c6b2d337151b37e3e77c54df72a9327b54e,1,2,0,2,2,2014-01-13 12:51:26,2014-01-13 12:51:26
fef75c6b2d337151b37e3e77c54df72a9327b54e...77148d5a6c3e775c8e5e2944fac9695833f11b52,11,109,60,169,52,2014-01-13 16:41:31,2014-01-10 18:07:04
77148d5a6c3e775c8e5e2944fac9695833f11b52...24e794f5d3515469685a45703ca0d0505d4b5687,1,5,4,9,2,2014-01-13 16:58:16,2014-01-09 16:25:52
24e794f5d3515469685a45703ca0d0505d4b5687...ff9150f79740233c21c658cd368a3255bba0d400,7,287,48,335,30,2014-01-13 18:29:34,2014-01-13 16:48:32
ff9150f79740233c21c658cd368a3255bba0d400...a21be0c3496c2664aa28412bb5b0d3ad94a14c80,2,12,2,14,2,2014-01-13 18:37:03,2014-01-10 22:02:59
a21be0c3496c2664aa28412bb5b0d3ad94a14c80...adb2c9c330f67e24adbb5f1a306f8484befe93a9,2,4,0,4,2,2014-01-13 19:42:18,2013-12-31 22:41:09
adb2c9c330f67e24adbb5f1a306f8484befe93a9...dbedf3ba22cb98e31b2decc06504832325890b97,1,1,1,2,1,2014-01-13 20:30:59,2014-01-13 20:12:45
dbedf3ba22cb98e31b2decc06504832325890b97...939fa9c7460236b7bab9c7704096bcd240503389,2,63,7,70,3,2014-01-13 20:51:48,2014-01-07 16:22:05
939fa9c7460236b7bab9c7704096bcd240503389...5d1464e687e82df464e911d302b2b859d4e3e8b9,5,52,53,105,35,2014-01-13 21:58:46,2014-01-13 20:53:21
5d1464e687e82df464e911d302b2b859d4e3e8b9...192f4bcd1b9a91cad4f184ad7cd3679b56cb9f5f,2,86,0,86,2,2014-01-13 22:13:04,2014-01-13 15:04:47
192f4bcd1b9a91cad4f184ad7cd3679b56cb9f5f...6105f6aa2408ff6f2f95e302e3e39adff51867c8,4,78,0,78,4,2014-01-13 22:26:11,2013-12-30 23:25:34
6105f6aa2408ff6f2f95e302e3e39adff51867c8...fb2c23ae94e9acf8549d8cc95e584c7e7836a952,1,3,3,6,3,2014-01-13 22:42:59,2014-01-13 22:42:26
fb2c23ae94e9acf8549d8cc95e584c7e7836a952...4f9c0008b9c046690d9d84579ccd98b8553412ab,1,2,1,3,1,2014-01-13 23:45:55,2014-01-13 23:39:12
4f9c0008b9c046690d9d84579ccd98b8553412ab...cec1b16a90acadf97b892a56fb15943a72f04398,1,3,1,4,1,2014-01-13 23:50:48,2014-01-13 21:05:58
cec1b16a90acadf97b892a56fb15943a72f04398...fe6f35789408efa034fca45c11b61230f603c6d1,4,17,2,19,7,2014-01-14 02:49:03,2014-01-14 02:49:03
fe6f35789408efa034fca45c11b61230f603c6d1...e426173c5086da93d0a311c151141f4396acd2c5,1,31,29,60,24,2014-01-14 03:07:55,2014-01-14 03:07:55
e426173c5086da93d0a311c151141f4396acd2c5...9154de8aea7424d0b26b92d1b09d0164caee7c66,2,0,86,86,2,2014-01-14 04:16:27,2014-01-14 04:16:27
9154de8aea7424d0b26b92d1b09d0164caee7c66...212d0b2975ba4564875a97ad44e61ebb8eb04a8f,8,468,106,574,10,2014-01-14 14:19:37,2014-01-09 19:36:54
212d0b2975ba4564875a97ad44e61ebb8eb04a8f...2fdf989382a6911d75afbb885c5d400d187fbb2b,1,1,0,1,1,2014-01-14 14:32:59,2014-01-14 14:32:59
2fdf989382a6911d75afbb885c5d400d187fbb2b...9f99f49ceb00fdd2bfdc895baf91a90a24e223c4,1,1,1,2,1,2014-01-14 15:06:53,2014-01-14 15:06:53
9f99f49ceb00fdd2bfdc895baf91a90a24e223c4...59b0371902b5b278ef1e88a9c15424c6efeea666,3,15,3,18,5,2014-01-14 15:28:58,2014-01-13 21:53:53
59b0371902b5b278ef1e88a9c15424c6efeea666...12c261b2cb30ed3e50261abad95df249a5503283,64,173,175,348,115,2014-01-14 15:30:26,2014-01-13 19:28:54
12c261b2cb30ed3e50261abad95df249a5503283...74ef4462c7d0a50ebc658a4f3f84f3c3e3ef3a99,13,942,187,1129,82,2014-01-14 17:22:10,2014-01-12 20:49:34
74ef4462c7d0a50ebc658a4f3f84f3c3e3ef3a99...20a414a4809aa5d20f3a09f129f08c918cddf032,1,1,0,1,1,2014-01-14 19:36:31,2014-01-14 16:51:12
20a414a4809aa5d20f3a09f129f08c918cddf032...13226efcd6638b707e0f4a64564d655cea9bc9c7,16,545,675,1220,69,2014-01-14 19:41:04,2014-01-13 23:50:02
13226efcd6638b707e0f4a64564d655cea9bc9c7...89126c21f0eb3b9b1674ee64d0f75d91a841084e,4,242,95,337,10,2014-01-14 20:23:42,2014-01-08 22:12:26
89126c21f0eb3b9b1674ee64d0f75d91a841084e...7cb2e9607aa593bc619fc8e194920144863d0061,3,7,85,92,3,2014-01-14 21:14:38,2014-01-10 21:17:07
7cb2e9607aa593bc619fc8e194920144863d0061...30df99dd7edd8696d1d0ac3f8b0a3f7d49082bc0,1,9,4,13,4,2014-01-14 22:12:42,2014-01-14 22:12:20
30df99dd7edd8696d1d0ac3f8b0a3f7d49082bc0...e5f17aafb8c2fbdcb9f7e6b478594a676fd2955b,17,410,340,750,69,2014-01-14 22:14:50,2014-01-13 17:23:16
e5f17aafb8c2fbdcb9f7e6b478594a676fd2955b...1ca54ce0c33b691b1427e2b9f4a709835a02e25e,9,32,25,57,27,2014-01-14 22:21:07,2014-01-14 22:20:36
1ca54ce0c33b691b1427e2b9f4a709835a02e25e...e6257f5996ffcfb3c1d1b1aed734a599b05d3456,1,22,6,28,4,2014-01-14 23:10:06,2014-01-14 23:10:06
e6257f5996ffcfb3c1d1b1aed734a599b05d3456...740526fa345d5eed2070602c0ad986591003c9e5,1,4,2,6,1,2014-01-14 23:36:17,2014-01-14 21:12:40
740526fa345d5eed2070602c0ad986591003c9e5...93f27e7d3bc6db0b0ba6b92cfe9cf69d54a82d0e,1,1,1,2,1,2014-01-14 23:36:17,2014-01-14 21:13:45
93f27e7d3bc6db0b0ba6b92cfe9cf69d54a82d0e...6ebe63c5d211a932ebc38bcce7bfa2f803fa00fe,1,5,0,5,1,2014-01-14 23:36:17,2014-01-14 21:18:18
6ebe63c5d211a932ebc38bcce7bfa2f803fa00fe...5faea8c7afbeaf271539e536dd9fee7f5be8723e,1,2,1,3,1,2014-01-14 23:37:52,2014-01-14 21:51:14
5faea8c7afbeaf271539e536dd9fee7f5be8723e...db151b44bce6975fd66e6eece4088035526e57ae,2,16,2,18,3,2014-01-14 23:40:02,2014-01-14 19:19:46
db151b44bce6975fd66e6eece4088035526e57ae...76fc4baa3004af615066ba82ef458908ff2eb041,2,1,9,10,2,2014-01-14 23:56:53,2013-12-09 22:36:56
76fc4baa3004af615066ba82ef458908ff2eb041...bc25799bbeaee8e6133804ffa6fece31e8a62236,4,29,8,37,12,2014-01-15 00:14:35,2014-01-14 19:32:31
bc25799bbeaee8e6133804ffa6fece31e8a62236...2ce9e49b26cc97dc0ea978d7e12effbc5a20a097,10,3,246,249,20,2014-01-15 00:32:28,2014-01-14 23:24:27
2ce9e49b26cc97dc0ea978d7e12effbc5a20a097...96afe1fc3fff700046344f9cc59004151fb02bc1,91,120,120,240,117,2014-01-15 00:32:28,2014-01-14 23:31:19
96afe1fc3fff700046344f9cc59004151fb02bc1...288056872d40a1b40194937603f4456458586f22,3,13,11,24,7,2014-01-15 07:05:40,2014-01-14 21:34:32
288056872d40a1b40194937603f4456458586f22...ea103d7bce187a9d48bc286ac574c239260fdde8,38,47,44,91,44,2014-01-15 14:19:00,2014-01-15 14:19:00
ea103d7bce187a9d48bc286ac574c239260fdde8...53a4b444ce35f5ac7bef14eccbcff60c0fee3081,10,239,1408,1647,133,2014-01-15 14:50:39,2014-01-13 16:12:04
53a4b444ce35f5ac7bef14eccbcff60c0fee3081...1edc1e6ed554fb10d9a650e641d55bb4ce7e5213,8,21,9,30,15,2014-01-15 15:01:50,2014-01-15 14:34:27
1edc1e6ed554fb10d9a650e641d55bb4ce7e5213...09487a6fe2759e653c0ff3c64b70d7c1990acc05,2,20,10,30,6,2014-01-15 15:21:23,2014-01-15 15:21:19
09487a6fe2759e653c0ff3c64b70d7c1990acc05...bebbcac06efd48abb2f9224150c7ae93b85fcf72,1,1,5,6,1,2014-01-15 15:26:12,2014-01-15 15:24:43
bebbcac06efd48abb2f9224150c7ae93b85fcf72...5e5fdb51b78b84a9acfaa5a18d3f59438a04841c,7,1,7,8,7,2014-01-15 16:21:50,2014-01-15 16:21:27
5e5fdb51b78b84a9acfaa5a18d3f59438a04841c...ecd69fcfb4c844835441c532ef07aac093db3459,5,54,237,291,14,2014-01-15 16:45:16,2014-01-10 21:04:42
ecd69fcfb4c844835441c532ef07aac093db3459...4e62d347f090ce1afd91dc59b3db2fab8f930bc0,1,3,1,4,1,2014-01-15 18:12:07,2014-01-15 18:09:55
4e62d347f090ce1afd91dc59b3db2fab8f930bc0...7a0aa7d3b23ddae748894806e4fa2a6949a5d7c1,1,3,1,4,1,2014-01-15 19:40:45,2014-01-15 16:57:02
7a0aa7d3b23ddae748894806e4fa2a6949a5d7c1...c75e1809030e09513560181b2d161d0e517ad836,23,205,226,431,216,2014-01-15 20:28:56,2014-01-15 15:58:36
c75e1809030e09513560181b2d161d0e517ad836...26a8aaf0e660c247c2667e0f182bc4964096735b,5,5,5,10,5,2014-01-15 20:46:27,2014-01-15 20:44:20
26a8aaf0e660c247c2667e0f182bc4964096735b...9b94912fe8847977c4d23a12604cb900e6f426b7,31,1842,195,2037,83,2014-01-15 21:35:44,2014-01-09 20:05:55
9b94912fe8847977c4d23a12604cb900e6f426b7...5a3a5eeb6a4646e932b11eda5fb7df79821daf15,1,0,4,4,1,2014-01-15 22:06:48,2014-01-15 21:30:35
5a3a5eeb6a4646e932b11eda5fb7df79821daf15...449f8519f4653fd01e34a1902859ef4e06f63c08,1,1,13,14,2,2014-01-15 22:28:20,2014-01-15 22:28:20
449f8519f4653fd01e34a1902859ef4e06f63c08...f211f148068b7acff6a06f5ccaa31feab654fd0f,5,146,17,163,25,2014-01-15 22:38:30,2014-01-15 00:30:51
f211f148068b7acff6a06f5ccaa31feab654fd0f...ab09662b279c8965005391350d8e56924533d128,2,38,14,52,11,2014-01-16 15:26:59,2014-01-15 22:24:32
ab09662b279c8965005391350d8e56924533d128...1721db7bddcec2c61c121de961a899622f47c6ec,2,9,2,11,4,2014-01-16 15:48:17,2014-01-16 15:33:32
1721db7bddcec2c61c121de961a899622f47c6ec...6be5ff60cf3233dff7fff542ded1a06b541076b1,14,747,271,1018,38,2014-01-16 16:39:53,2014-01-14 21:35:28
6be5ff60cf3233dff7fff542ded1a06b541076b1...8e9f6fe665cc67576bffaf922d16f4570da12efe,5,60,27,87,23,2014-01-16 17:53:00,2014-01-15 17:48:51
8e9f6fe665cc67576bffaf922d16f4570da12efe...a65256c7d95911d40e3d015752e4eca1856f9f62,15,108,61,169,42,2014-01-16 17:53:00,2014-01-15 20:02:00
a65256c7d95911d40e3d015752e4eca1856f9f62...692e238afc24d33a0282754e390f3b215bbaa91a,2,12,15,27,3,2014-01-16 18:04:36,2014-01-16 18:04:36
692e238afc24d33a0282754e390f3b215bbaa91a...70ca1f3933c4a89808bcc1a1fca37c7c45ec840d,1,2,1,3,1,2014-01-16 18:49:46,2014-01-16 18:48:19
70ca1f3933c4a89808bcc1a1fca37c7c45ec840d...f8671e9dc3565fac7cf9784b096b3b8e5a496717,1,1,2,3,1,2014-01-16 20:39:20,2014-01-16 16:39:35
f8671e9dc3565fac7cf9784b096b3b8e5a496717...06516d13e81a52b0080a5d825a20d5db71ae5649,3,15,15,30,10,2014-01-16 20:51:34,2014-01-16 12:40:04
06516d13e81a52b0080a5d825a20d5db71ae5649...3169e1d6d7eb7306302c423b5710c5ce077ca7be,1,7,2,9,2,2014-01-16 21:50:34,2014-01-16 21:42:07
3169e1d6d7eb7306302c423b5710c5ce077ca7be...575ce48bb4dbeef3980c9c47a7cb1dae91576949,1,4,2,6,3,2014-01-16 22:07:31,2014-01-16 20:47:17
575ce48bb4dbeef3980c9c47a7cb1dae91576949...2bea8060ce966275cd1424e18157ca790af34636,4,32,8,40,6,2014-01-16 22:26:43,2014-01-15 00:06:59
2bea8060ce966275cd1424e18157ca790af34636...6787339f2721619a4f33816e16e4cc9eae3121eb,6,43,16,59,20,2014-01-17 00:00:30,2014-01-16 18:33:13
6787339f2721619a4f33816e16e4cc9eae3121eb...3930732761638a6bbc10f66e4ee80009c8c403e0,3,129,47,176,18,2014-01-17 16:21:50,2014-01-15 22:27:00
3930732761638a6bbc10f66e4ee80009c8c403e0...1fa665f79dcc84eacbfe1f0a0cebcd75a93d4aa4,6,48,13,61,13,2014-01-17 16:27:34,2014-01-16 00:25:58
1fa665f79dcc84eacbfe1f0a0cebcd75a93d4aa4...e3569aeb23884abfc50ff32135055441a691142d,2,76,25,101,13,2014-01-17 18:07:05,2014-01-15 01:37:19
e3569aeb23884abfc50ff32135055441a691142d...d5163be022cecb3c58fa2456e2031a223cc341ad,1,2,2,4,2,2014-01-17 18:14:11,2014-01-17 18:14:11
d5163be022cecb3c58fa2456e2031a223cc341ad...88b256c5edcc13634338d51388dc42c355d1fc31,1,1,1,2,1,2014-01-17 19:08:48,2014-01-16 23:42:19
88b256c5edcc13634338d51388dc42c355d1fc31...93b398f8808358846cab939e6c93d3b1d96a2230,28,31,119,150,34,2014-01-17 19:36:27,2014-01-17 18:18:01
93b398f8808358846cab939e6c93d3b1d96a2230...1b44a81f70869fd24e2eccf1cfa2faa9bc372e45,11,17,17,34,12,2014-01-17 20:00:17,2014-01-17 14:45:17
1b44a81f70869fd24e2eccf1cfa2faa9bc372e45...3b5b31f42d390e9da23f66e78a300d997ae653c4,2,16,12,28,6,2014-01-17 20:15:00,2014-01-17 19:54:43
3b5b31f42d390e9da23f66e78a300d997ae653c4...344596a194f5ae2ac474d24a744f1caa5877023f,1,3,11,14,4,2014-01-17 21:52:59,2014-01-17 21:52:59
344596a194f5ae2ac474d24a744f1caa5877023f...7af069e5ac40a7b7a5324124e66a82d16d30e9b5,4,22,8,30,13,2014-01-17 22:18:06,2014-01-17 22:18:00
7af069e5ac40a7b7a5324124e66a82d16d30e9b5...50b47b93b3bb63e609c55bd45127f49e60919e12,4,53,55,108,31,2014-01-17 22:37:33,2014-01-17 16:42:24
50b47b93b3bb63e609c55bd45127f49e60919e12...5f169de0c5a1651efe39eaa6165c4a3414470dd7,2,12,16,28,6,2014-01-17 23:29:46,2014-01-17 23:29:02
5f169de0c5a1651efe39eaa6165c4a3414470dd7...69908f52f07b7faefff68e87e1d8822f6d22fcd0,13,69,41,110,32,2014-01-18 04:12:28,2014-01-07 00:08:54
69908f52f07b7faefff68e87e1d8822f6d22fcd0...320397d71a0344db775146e42a54d755241533b2,1,18,6,24,7,2014-01-20 18:38:38,2014-01-20 18:38:15
320397d71a0344db775146e42a54d755241533b2...400f00648f2ade62031d6dc2efe0cf7f51de9010,1,3,3,6,3,2014-01-21 07:11:48,2014-01-14 23:53:42
400f00648f2ade62031d6dc2efe0cf7f51de9010...4d96802d9699a36aa32f954e223f6da1aa47f8b1,2,86,0,86,2,2014-01-21 07:11:54,2014-01-13 15:04:47
4d96802d9699a36aa32f954e223f6da1aa47f8b1...df45324b26d66f8a5155a0a9799b0ba000544ebb,1,2,1,3,1,2014-01-21 08:07:21,2014-01-21 08:07:21
df45324b26d66f8a5155a0a9799b0ba000544ebb...5402118336e74b96ea50002e43dd393d219866ec,19,126,63,189,77,2014-01-21 15:09:57,2014-01-07 04:53:21
5402118336e74b96ea50002e43dd393d219866ec...2e18778f1556117f499fe778a3a44987795e8e91,2,92,55,147,2,2014-01-21 15:59:46,2014-01-15 19:50:41
2e18778f1556117f499fe778a3a44987795e8e91...278537043b7f6149eedc6392bbaab4caa5820ab2,3,4,11,15,6,2014-01-21 17:50:46,2014-01-16 19:21:44
278537043b7f6149eedc6392bbaab4caa5820ab2...51e761f1f76581f6c43cd81cb132c3f5c39c12d3,6,12,471,483,18,2014-01-21 17:55:49,2014-01-16 20:38:27
51e761f1f76581f6c43cd81cb132c3f5c39c12d3...8bab6b0c9fad64286c22d928bbe8ebfae7e8b2c4,1,1,1,2,1,2014-01-21 17:55:49,2014-01-14 20:51:56
8bab6b0c9fad64286c22d928bbe8ebfae7e8b2c4...d0037946dc103ffa648f7e8937f2c55351b03c53,16,481,331,812,100,2014-01-21 17:55:49,2013-12-20 19:57:18
d0037946dc103ffa648f7e8937f2c55351b03c53...c9fc8a468e1fa9d6421ef35f5a23db0e0f014b4f,6,188,47,235,14,2014-01-21 17:55:49,2013-10-25 19:46:22
c9fc8a468e1fa9d6421ef35f5a23db0e0f014b4f...5df691c9c829b6ef1666b41943e13e72c9a89520,17,599,23,622,30,2014-01-21 18:04:51,2014-01-16 21:14:05
5df691c9c829b6ef1666b41943e13e72c9a89520...6d52377da1545aef697889a7e83800e80cf93084,2,50,1,51,3,2014-01-21 18:33:04,2014-01-16 23:37:01
6d52377da1545aef697889a7e83800e80cf93084...410405e01c0c9bb5d1c9ed4f8d2a28b865cd19c8,1,3,1,4,1,2014-01-21 19:23:08,2014-01-17 20:50:07
410405e01c0c9bb5d1c9ed4f8d2a28b865cd19c8...1299b1166ebc0856775566a4b7edd7b02b695734,1,1,1,2,2,2014-01-21 20:08:57,2014-01-21 20:06:05
1299b1166ebc0856775566a4b7edd7b02b695734...faf2c75e163fc72c37f25725adc39ca1b314b9b5,1,4,0,4,1,2014-01-21 20:20:26,2014-01-21 19:37:40
faf2c75e163fc72c37f25725adc39ca1b314b9b5...58f700145e3f3b2894699900f6d573a488ee3319,1,3,5,8,1,2014-01-21 20:20:26,2014-01-21 19:52:44
58f700145e3f3b2894699900f6d573a488ee3319...6d460f440dbe30fae04663771db8c9c9bbe79779,1,1,0,1,1,2014-01-21 20:45:28,2014-01-21 17:29:24
6d460f440dbe30fae04663771db8c9c9bbe79779...f65a0b814b8c77e3fbe90bca0c061c9b77f6acdb,1,1,1,2,1,2014-01-21 21:45:47,2014-01-21 21:26:23
f65a0b814b8c77e3fbe90bca0c061c9b77f6acdb...06f7f3ca68c95277b1c11f469f01e61cbeb3cc76,4,19,24,43,15,2014-01-21 23:14:07,2014-01-21 20:30:45
06f7f3ca68c95277b1c11f469f01e61cbeb3cc76...7ca37c59bb1527ed613425a7575574c1c574df4b,15,507,219,726,127,2014-01-21 23:19:28,2014-01-16 02:06:20
7ca37c59bb1527ed613425a7575574c1c574df4b...d91079d6d0d85b070c7d94376a441a7d41ae49f5,1,2,2,4,1,2014-01-22 01:22:38,2014-01-22 01:14:01
d91079d6d0d85b070c7d94376a441a7d41ae49f5...718e98de486123afc8e9c190f4790cd5e1c16648,5,435,59,494,24,2014-01-22 19:25:18,2014-01-21 19:24:44
718e98de486123afc8e9c190f4790cd5e1c16648...7f15f0c898b796ff7eeeeb84ee60ee56ddc92385,1,61,0,61,4,2014-01-22 20:34:37,2014-01-17 20:50:07
7f15f0c898b796ff7eeeeb84ee60ee56ddc92385...746249b843422e2e74ce0e524f8805799d53a3f7,3,27,1,28,6,2014-01-22 21:02:03,2014-01-22 19:18:28
746249b843422e2e74ce0e524f8805799d53a3f7...78bf8771fa3237d534575d9831992235c6bb9de8,1,1,1,2,1,2014-01-22 21:33:48,2014-01-22 21:33:48
78bf8771fa3237d534575d9831992235c6bb9de8...544f130753c04b83397ff156cca873273c7977f2,8,170,64,234,26,2014-01-22 22:02:10,2014-01-17 21:55:05
544f130753c04b83397ff156cca873273c7977f2...8af9af8fabd27dcde862e9cc2ccc039142c1ec1a,2,20,59,79,9,2014-01-22 22:29:28,2014-01-14 18:15:49
8af9af8fabd27dcde862e9cc2ccc039142c1ec1a...82146730b9eb94e9e97f2c913b5844151f7001cb,2,52,8,60,9,2014-01-22 23:37:55,2014-01-22 21:27:48
82146730b9eb94e9e97f2c913b5844151f7001cb...b82f438f807681ff409c31abdee58b3f0ead5ab0,1,3,3,6,2,2014-01-22 23:49:09,2014-01-22 17:01:37
b82f438f807681ff409c31abdee58b3f0ead5ab0...92cf0713b74ce2f8b011e6768a66c4e99d75a8ea,3,914,0,914,3,2014-01-23 01:33:29,2013-12-13 22:50:55
92cf0713b74ce2f8b011e6768a66c4e99d75a8ea...eff37e9c0e5f4a3cd1178cb42fa4c1f518b8b597,1,5,1,6,1,2014-01-23 13:47:50,2014-01-22 16:22:59
eff37e9c0e5f4a3cd1178cb42fa4c1f518b8b597...6f7364be380fd69a9725339123e5476518ddbaee,1,8,3,11,2,2014-01-23 13:47:51,2014-01-22 16:24:14
6f7364be380fd69a9725339123e5476518ddbaee...a6c4e86b0aba95fd34ef4b912909e9dd89d8425e,2,21,39,60,11,2014-01-23 13:47:52,2014-01-17 21:55:29
a6c4e86b0aba95fd34ef4b912909e9dd89d8425e...cf99842a3a495cb86efca4d702fb8a45e5768072,15,589,184,773,116,2014-01-23 16:29:56,2014-01-16 17:40:27
cf99842a3a495cb86efca4d702fb8a45e5768072...05db1ea493f0bb00215e0dd94988f9aa927925bc,18,925,118,1043,52,2014-01-23 19:18:03,2014-01-21 18:19:59
05db1ea493f0bb00215e0dd94988f9aa927925bc...4989b84929bcb9112c5a0257c5ae32db2067b80f,1,3,2,5,1,2014-01-23 19:25:56,2014-01-22 19:43:47
05db1ea493f0bb00215e0dd94988f9aa927925bc...66b4b67e6de014a5ec8fbc48e87cace60a09b0b9,1,2,0,2,2,2014-01-23 19:22:46,2014-01-17 21:37:41
3a74ea414ee538b74e7074e8ef63d6d50cdcef57...2f1865e898437c36e39e6e153bac097fb09259a6,1,19,13,32,6,2014-01-24 00:40:34,2014-01-24 00:39:55
2f1865e898437c36e39e6e153bac097fb09259a6...59ffbe2a8db0ff498009e786e651b94e7770ed81,8,8,8,16,8,2014-01-23 20:27:05,2014-01-23 20:26:56
59ffbe2a8db0ff498009e786e651b94e7770ed81...e1dfecd4b530f1d2172270471f4c2c77bdb2639a,1,6,2,8,1,2014-01-23 20:36:01,2014-01-23 19:43:08
e1dfecd4b530f1d2172270471f4c2c77bdb2639a...69e5d7fdbe6c1ae38d5c6a3cb784c8c21e3c1b67,1,2,1,3,1,2014-01-23 20:36:01,2014-01-23 20:07:42
69e5d7fdbe6c1ae38d5c6a3cb784c8c21e3c1b67...45ac2c3e3a4dc67751383b3f2c3f974ecd8d0c06,1,12,2,14,3,2014-01-23 21:52:13,2014-01-23 21:32:05
45ac2c3e3a4dc67751383b3f2c3f974ecd8d0c06...29f796ddd8f5383b3d389e43318fac433df1cb71,2,7,2,9,4,2014-01-23 22:43:53,2014-01-23 19:22:48
29f796ddd8f5383b3d389e43318fac433df1cb71...640a450f0d894001a073c4da02c99d4c01c8bad7,1,1,1,2,1,2014-01-23 22:57:57,2014-01-23 22:57:57
640a450f0d894001a073c4da02c99d4c01c8bad7...f5049622d58df88f11369427b5e535fd79e22ef6,1,2,2,4,1,2014-01-23 23:12:59,2014-01-23 23:06:58
f5049622d58df88f11369427b5e535fd79e22ef6...f49669ffe3f267bedc258dd17ec1b2d45970ec8a,1,4,0,4,2,2014-01-24 00:00:10,2014-01-23 19:13:35
f49669ffe3f267bedc258dd17ec1b2d45970ec8a...8afbec33f4de266a552f50c608621053523a7a15,10,753,334,1087,75,2014-01-28 21:20:57,2014-01-28 21:19:59
f49669ffe3f267bedc258dd17ec1b2d45970ec8a...f03c5b1f6163be5de62b38294deeab310969a4ac,2,17,1,18,2,2014-01-24 13:23:53,2014-01-10 19:52:48
f03c5b1f6163be5de62b38294deeab310969a4ac...5762995d5ef67f32149f3b6cb471a052ad7fe1ba,1,11,8,19,5,2014-01-24 15:01:22,2014-01-22 18:39:07
5762995d5ef67f32149f3b6cb471a052ad7fe1ba...1d2662097d056641a544cfc84e91ef2f1b86623e,9,71,17,88,30,2014-01-24 15:23:35,2014-01-23 22:11:50
1d2662097d056641a544cfc84e91ef2f1b86623e...c42f5d873c0a0b6622f04b9b4d0235e6f0ec5f9c,3,13,16,29,8,2014-01-24 15:48:48,2014-01-24 02:55:44
c42f5d873c0a0b6622f04b9b4d0235e6f0ec5f9c...2200ec891db98519701ba7192f42a644a405652e,8,79,4,83,15,2014-01-24 16:26:47,2014-01-22 20:10:11
2200ec891db98519701ba7192f42a644a405652e...d6c659c7d2d7a20ba640b4981b9e8c82d2948e02,1,2,2,4,1,2014-01-24 18:23:20,2014-01-24 18:23:20
d6c659c7d2d7a20ba640b4981b9e8c82d2948e02...a23a3f35d5fa97bdeca2e71211924e01fe87d07d,8,8,8,16,8,2014-01-24 18:23:33,2014-01-24 18:23:33
a23a3f35d5fa97bdeca2e71211924e01fe87d07d...ed58b0dfe564253067b4cab11ab75477b7e48388,1,2,3,5,1,2014-01-24 18:23:36,2014-01-24 18:23:36
ed58b0dfe564253067b4cab11ab75477b7e48388...7349ba70a0e68627dc322113c561afe3a9ed37a1,47,1143,733,1876,242,2014-01-24 20:47:07,2014-01-24 20:47:07
7349ba70a0e68627dc322113c561afe3a9ed37a1...354916227db89c5c1cd6a4ed293c0e70dc6494f5,1,1,1,2,1,2014-01-24 21:12:00,2014-01-24 21:12:00
354916227db89c5c1cd6a4ed293c0e70dc6494f5...56e6f5ac4bbff54b95ce956823e4b80fc6769bc9,2,8,3,11,3,2014-01-24 21:42:26,2014-01-24 17:30:28
56e6f5ac4bbff54b95ce956823e4b80fc6769bc9...81fd5b90caed8970e4190a3286e4741567009b21,1,3,3,6,3,2014-01-24 23:17:18,2014-01-24 22:01:11
81fd5b90caed8970e4190a3286e4741567009b21...9fece5929aa234cb71625b57f765050993957a07,1,16,8,24,3,2014-01-24 23:17:18,2014-01-24 22:02:30
9fece5929aa234cb71625b57f765050993957a07...c510dfd31130f98b9ab392d79945f27f7768e043,1,1,1,2,1,2014-01-25 04:33:06,2014-01-25 04:33:06
c510dfd31130f98b9ab392d79945f27f7768e043...fc0280414c48c1c7f85ab32c1999cb9e04184986,1,2,0,2,1,2014-01-25 16:43:49,2014-01-23 22:59:33
fc0280414c48c1c7f85ab32c1999cb9e04184986...27fc2e488079ca2bfc04dadfa4512b7ca5c3bc54,1,4,0,4,2,2014-01-26 01:14:30,2014-01-25 14:40:42
27fc2e488079ca2bfc04dadfa4512b7ca5c3bc54...7bf8e2f83d9cdccdbb9834ffe34ba67259a4b451,1,1,1,2,1,2014-01-26 01:14:30,2014-01-25 23:40:04
7bf8e2f83d9cdccdbb9834ffe34ba67259a4b451...11407fb2e013ed366b269269b7eee62f803fff7c,3,70,30,100,9,2014-01-26 01:14:30,2014-01-26 01:13:48
11407fb2e013ed366b269269b7eee62f803fff7c...b6e77fdd60351d5001d700ae9fa0d0c5a03867b7,5,14,3,17,7,2014-01-26 01:57:18,2014-01-26 01:57:18
b6e77fdd60351d5001d700ae9fa0d0c5a03867b7...92e7ba92da8e1915b8a19d8d485c2b7d3df2b114,1,1,0,1,1,2014-01-26 03:23:10,2014-01-26 03:23:10
92e7ba92da8e1915b8a19d8d485c2b7d3df2b114...f61d103df71dbcf5fc9b72e9742e3dffd10f36b3,2,2,1,3,3,2014-01-26 03:30:30,2014-01-26 03:30:30
f61d103df71dbcf5fc9b72e9742e3dffd10f36b3...c51857a44af6fc69f1e21bb9c6b2b6adda0ef80e,26,364,172,536,67,2014-01-26 21:36:28,2014-01-23 21:53:25
c51857a44af6fc69f1e21bb9c6b2b6adda0ef80e...e6c3c69c508b431a1c38dc5011928e236ddb09df,4,64,48,112,13,2014-01-27 15:53:59,2014-01-23 16:48:15
e6c3c69c508b431a1c38dc5011928e236ddb09df...e7160fcd26cc0508f9fe2a47bb0a78561250565d,2,59,12,71,11,2014-01-27 15:53:59,2014-01-24 20:38:17
e7160fcd26cc0508f9fe2a47bb0a78561250565d...6ed357d1ed175e772c9dbac985d6511bdb9090e0,1,4,0,4,1,2014-01-27 17:56:17,2014-01-27 16:39:42
6ed357d1ed175e772c9dbac985d6511bdb9090e0...497fa9bc0b9634587c29e241490b8dfcb0ef8063,1,11,4,15,1,2014-01-27 17:56:17,2014-01-27 16:45:58
497fa9bc0b9634587c29e241490b8dfcb0ef8063...582eeef05e3e654cfe1a9d508e83a42f17582ddf,1,1,1,2,1,2014-01-27 18:46:09,2014-01-26 16:13:02
582eeef05e3e654cfe1a9d508e83a42f17582ddf...f6c590f3ea5c7cf45f6e331dc25ed88680c3a56b,1,3,4,7,2,2014-01-27 18:46:09,2014-01-27 18:31:05
f6c590f3ea5c7cf45f6e331dc25ed88680c3a56b...4ae262e2715092700e8fab73eb0b2bea1a119a3b,4,261,0,261,4,2014-01-27 20:19:04,2014-01-24 21:00:19
4ae262e2715092700e8fab73eb0b2bea1a119a3b...e9423c914367cf0ae89d27999e824da70864c59c,1,1,1,2,1,2014-01-27 20:58:26,2014-01-24 17:17:55
e9423c914367cf0ae89d27999e824da70864c59c...9384c692b89034008c419e3779282a41f00a4a61,5,4,6,10,8,2014-01-27 21:58:32,2014-01-27 19:59:12
9384c692b89034008c419e3779282a41f00a4a61...c4c0f3b6b849deba4b6ebb31ab13b0b26b626c55,8,47,1,48,11,2014-01-27 22:19:06,2014-01-24 23:10:10
c4c0f3b6b849deba4b6ebb31ab13b0b26b626c55...b47ffb84c84bdc57a0b1484415b3a5322925eda2,8,1,47,48,11,2014-01-28 00:07:10,2014-01-28 00:06:23
b47ffb84c84bdc57a0b1484415b3a5322925eda2...692155f68924f19cbaae2892e56aa5edbf62fca2,1,22,0,22,1,2014-01-28 13:58:11,2014-01-24 19:47:55
692155f68924f19cbaae2892e56aa5edbf62fca2...5ed289416778ee4c6c5f5847826bc68da593459c,11,24,17,41,12,2014-01-28 15:45:32,2014-01-24 18:26:23
5ed289416778ee4c6c5f5847826bc68da593459c...d3941f5b930bbd75c8a4fc33606e774ec92a0186,1,2,1,3,1,2014-01-28 16:11:57,2014-01-23 16:12:49
d3941f5b930bbd75c8a4fc33606e774ec92a0186...22a35b2aa4985cfead698920d015f691b11076f0,1,15,2,17,2,2014-01-28 17:06:40,2014-01-27 22:24:10
22a35b2aa4985cfead698920d015f691b11076f0...c27f12a95a0d8f774174ceb974414707f214f4d8,1,40,12,52,2,2014-01-28 18:24:24,2014-01-22 17:02:25
c27f12a95a0d8f774174ceb974414707f214f4d8...3e62df4ebfdba59cc38dfbf33ea30cc8cf4ae15a,1,10,1,11,1,2014-01-28 20:08:09,2014-01-28 19:47:21
3e62df4ebfdba59cc38dfbf33ea30cc8cf4ae15a...04d12169e630bc4d270dd370f1bdecee473559a5,2,63,73,136,25,2014-01-28 20:17:14,2014-01-27 21:35:58
04d12169e630bc4d270dd370f1bdecee473559a5...7f7aba27b7a5bd310f3fe7f61af8f8dd21cbd3e5,1,7,7,14,7,2014-01-28 20:23:29,2014-01-28 14:38:41
7f7aba27b7a5bd310f3fe7f61af8f8dd21cbd3e5...89d0788919b2c162155c5f32ea485abdab120390,2,7,4,11,7,2014-01-28 20:27:53,2014-01-28 15:08:01
89d0788919b2c162155c5f32ea485abdab120390...8869eab327d4ab783a9dc5dae54f2261fe692cfb,24,887,291,1178,133,2014-01-28 20:49:46,2014-01-28 19:44:11
8869eab327d4ab783a9dc5dae54f2261fe692cfb...153d410a05d4fe7ebab63f04b5e62c756d33db0c,1,2,1,3,1,2014-01-28 22:34:34,2014-01-28 19:17:37
153d410a05d4fe7ebab63f04b5e62c756d33db0c...579c13d9d541de55c828a285eca596cc67c589d4,1,1,0,1,1,2014-01-28 23:28:49,2014-01-28 23:24:29
579c13d9d541de55c828a285eca596cc67c589d4...30deba805ed71280a46a8fa0688d19e652654d82,2,209,2,211,4,2014-01-29 00:52:31,2014-01-27 19:05:30
30deba805ed71280a46a8fa0688d19e652654d82...95fd79cb23c33470d40322c33b2508412ed77cab,2,12,2,14,3,2014-01-29 03:38:50,2014-01-18 00:53:05
95fd79cb23c33470d40322c33b2508412ed77cab...e3c5265fd0471f54d9d322eead31e05205537d3d,1,1,1,2,1,2014-01-29 03:56:38,2014-01-29 03:56:38
e3c5265fd0471f54d9d322eead31e05205537d3d...67253d75220d44a967a7ccdcead25bc37319136a,7,204,65,269,40,2014-01-29 12:17:24,2014-01-27 22:01:30
67253d75220d44a967a7ccdcead25bc37319136a...fc72190963cb527ece46ee407c04c1f99d0c461d,3,74,56,130,24,2014-01-29 14:00:42,2014-01-28 18:07:18
fc72190963cb527ece46ee407c04c1f99d0c461d...e76c27f0b7d2aeb6471bec4dacb295a0a8c0e51f,3,156,21,177,24,2014-01-29 14:07:51,2014-01-28 21:34:32
e76c27f0b7d2aeb6471bec4dacb295a0a8c0e51f...c944016bba355d29540129d8a37101f5441bc27a,15,178,128,306,59,2014-01-29 14:40:04,2013-12-17 00:07:59
c944016bba355d29540129d8a37101f5441bc27a...4adca0065aff4bd10b317f6fd03cfbb71ae82204,3,33,2,35,7,2014-01-29 15:03:52,2014-01-28 18:14:48
4adca0065aff4bd10b317f6fd03cfbb71ae82204...823a3e4929a62944e20ab808fc6324692d89ae68,2,11,3,14,3,2014-01-29 15:18:23,2014-01-29 15:16:39
823a3e4929a62944e20ab808fc6324692d89ae68...05b091054cfb75de6fafc73c9b3d3fdab75343c3,1,3,3,6,1,2014-01-29 17:25:13,2014-01-29 16:47:36
05b091054cfb75de6fafc73c9b3d3fdab75343c3...b9e2ba4a31c95a00f4fcee8ffe316a9c8136f6a7,2,1,1,2,1,2014-01-29 18:00:12,2014-01-28 21:25:54
b9e2ba4a31c95a00f4fcee8ffe316a9c8136f6a7...266626f3bc8a61a452e774b42686161ea773923b,3,1,71,72,6,2014-01-29 18:00:12,2014-01-28 21:35:29
266626f3bc8a61a452e774b42686161ea773923b...7c1edcfa9c017fc6bfdebdefeb918e2d91287d8f,6,194,101,295,24,2014-01-29 18:00:12,2014-01-28 22:14:40
7c1edcfa9c017fc6bfdebdefeb918e2d91287d8f...2906d67b2f1d9e7feff5e679489e835c491ec8bd,7,33,21,54,24,2014-01-29 18:00:12,2014-01-29 14:32:37
2906d67b2f1d9e7feff5e679489e835c491ec8bd...a2741dab6e7b447e610968002d835c60b7043773,5,27,85,112,7,2014-01-29 18:00:12,2014-01-29 14:44:14
a2741dab6e7b447e610968002d835c60b7043773...e5f5ff9ef84c38e2b66cc9bb31ada12c4ed26c50,4,65,14,79,14,2014-01-29 18:00:12,2014-01-29 14:44:43
e5f5ff9ef84c38e2b66cc9bb31ada12c4ed26c50...b3fce1aae16f2980e476331fe275499f06964fb4,3,289,0,289,3,2014-01-29 18:00:12,2014-01-29 16:05:11
b3fce1aae16f2980e476331fe275499f06964fb4...2bee3f018b8d4351f8261c405adcdff44c7f9a70,1,10,10,20,10,2014-01-29 18:05:33,2014-01-29 18:05:33
2bee3f018b8d4351f8261c405adcdff44c7f9a70...3b3c25e571852893373ae2e2b361397b260687c9,17,739,42,781,38,2014-01-29 18:18:47,2014-01-27 23:01:26
3b3c25e571852893373ae2e2b361397b260687c9...fd85ce79c397b96ed2da8787e75ca50146272c68,1,2,2,4,2,2014-01-29 18:27:48,2014-01-28 15:00:46
fd85ce79c397b96ed2da8787e75ca50146272c68...0a67590595841ef49dfc8ac83f227ece770689f3,1,0,36,36,1,2014-01-29 18:27:48,2014-01-28 15:06:39
0a67590595841ef49dfc8ac83f227ece770689f3...276c79f3246ec65060cc6dfeb8f8e1cf121ccdcc,3,5,162,167,7,2014-01-29 18:27:48,2014-01-28 15:06:54
276c79f3246ec65060cc6dfeb8f8e1cf121ccdcc...957da5dac2722480de985d117cd366ba492f5d7b,1,1,0,1,1,2014-01-29 18:30:38,2014-01-29 18:28:05
957da5dac2722480de985d117cd366ba492f5d7b...4b9ab5bd393d0742f1be81a8189fa1260469b0c5,1,2,1,3,2,2014-01-29 19:11:06,2014-01-29 18:56:33
4b9ab5bd393d0742f1be81a8189fa1260469b0c5...0f7c3ffaf78b241c0a491232e993ee7d695d02cd,5,352,1,353,5,2014-01-29 18:46:27,2014-01-15 17:38:26
0f7c3ffaf78b241c0a491232e993ee7d695d02cd...39266981d3c3b6d277af2dbdd68448c6c040d692,1,474,0,474,1,2014-01-29 18:46:27,2014-01-29 16:18:36
39266981d3c3b6d277af2dbdd68448c6c040d692...b84ad8285bffc1e2274aa9455c1e9394c813cdbf,20,323,316,639,142,2014-01-29 19:32:41,2014-01-28 23:35:34
b84ad8285bffc1e2274aa9455c1e9394c813cdbf...5c7f1ad47ec54152435a5541aa3912a2bacd0196,1,52,34,86,6,2014-01-29 19:38:59,2014-01-29 15:46:41
5c7f1ad47ec54152435a5541aa3912a2bacd0196...d5cb9b629e6033c4cca354aad8928ba1b7148601,1,56,4,60,5,2014-01-29 19:38:59,2014-01-29 16:11:00
d5cb9b629e6033c4cca354aad8928ba1b7148601...36665580fa0156e5fb85874ccdc29d1edb1e7c60,3,160,45,205,24,2014-01-29 19:41:22,2014-01-27 22:14:19
36665580fa0156e5fb85874ccdc29d1edb1e7c60...60aed407af862350c3208a748cc8018a0dd379a4,1,25,0,25,8,2014-01-29 19:53:11,2014-01-29 19:37:26
60aed407af862350c3208a748cc8018a0dd379a4...a4f66393f2713b3034ff39e06958e85e5870b7dd,1,73,11,84,7,2014-01-29 20:31:46,2014-01-29 20:31:46
a4f66393f2713b3034ff39e06958e85e5870b7dd...184856715e4953e00d554f518a16cb9e0011619c,1,8,1,9,3,2014-01-29 20:39:11,2014-01-29 20:33:25
184856715e4953e00d554f518a16cb9e0011619c...8f8ef66e1b259372d4b6fccda6e57e7988b6f506,16,1,8558,8559,24,2014-01-29 20:55:07,2014-01-29 19:51:22
8f8ef66e1b259372d4b6fccda6e57e7988b6f506...0085fa29b9aa795c67caecc1a080b2259d4b8450,1,2,5,7,1,2014-01-29 20:28:41,2014-01-29 18:56:26
0085fa29b9aa795c67caecc1a080b2259d4b8450...e31a4e112775b9b4d1b52871b9b5a0dc799cea67,1,3,2,5,1,2014-01-29 21:13:16,2014-01-29 21:10:12
e31a4e112775b9b4d1b52871b9b5a0dc799cea67...359f4cbfeacd9a952fb785ad469cad06eb6e8fcc,1,1,0,1,1,2014-01-29 20:46:48,2014-01-29 20:35:56
359f4cbfeacd9a952fb785ad469cad06eb6e8fcc...f2ece186b189b2b9d09636c708f768fb3822b511,2,97,0,97,4,2014-01-29 21:29:17,2014-01-29 14:48:02
f2ece186b189b2b9d09636c708f768fb3822b511...48bd31fe392c0dc9fea11bfd1cef7bf2b9da65ec,1,0,8,8,1,2014-01-29 22:06:46,2014-01-29 17:59:06
48bd31fe392c0dc9fea11bfd1cef7bf2b9da65ec...dab7af2409c775a69489fe09f72f39c1b4f445aa,5,171,106,277,12,2014-01-29 22:07:14,2014-01-29 16:21:51
dab7af2409c775a69489fe09f72f39c1b4f445aa...39032c059a318f1c9e0f917ba4af051cd1c2420f,13,8,42,50,28,2014-01-29 22:15:54,2014-01-29 22:12:35
39032c059a318f1c9e0f917ba4af051cd1c2420f...791d6d40fc94eaa7264bce319aab94d98d20df4c,3,3,82,85,8,2014-01-29 22:15:55,2014-01-29 22:14:59
791d6d40fc94eaa7264bce319aab94d98d20df4c...242b2247bdff32b536aaad36d92f963e4f8c959c,6,29,16,45,15,2014-01-29 23:28:47,2014-01-29 19:32:59
242b2247bdff32b536aaad36d92f963e4f8c959c...d175e9c13e5427b9105d2428c18fa36b75619063,1,6,9,15,3,2014-01-29 23:28:47,2014-01-23 18:44:08
d175e9c13e5427b9105d2428c18fa36b75619063...cf3753ffe909b3f8cc45072933ee5f0426d2329d,6,1656,1587,3243,10,2014-01-29 23:28:47,2014-01-21 21:44:10
cf3753ffe909b3f8cc45072933ee5f0426d2329d...e031dffb83c2a6f9f64a7d055493a8664af997d5,22,1733,1387,3120,400,2014-01-29 23:28:47,2014-01-13 17:43:48
e031dffb83c2a6f9f64a7d055493a8664af997d5...d30a0aec7c9f8e45d0b2b95f9e55fafe3bedf170,1,314,395,709,264,2014-01-29 23:28:47,2014-01-24 18:56:23
d30a0aec7c9f8e45d0b2b95f9e55fafe3bedf170...98a4ac46bfcc5cbaf7b6d0ab1530d3fd96202a0d,5,26,231,257,26,2014-01-29 23:28:47,2014-01-27 20:18:23
98a4ac46bfcc5cbaf7b6d0ab1530d3fd96202a0d...a195fdda02361abf7e74f8a99dc80550f46c2f84,1,3,0,3,1,2014-01-29 23:28:47,2014-01-29 23:19:48
fc2cbaf512630326868d8c948e2524cc8a4328ee...dac6264fb0f0040f7bd8784ed44c33e4a1318d5b,16,740,214,954,72,2014-01-29 23:50:17,2014-01-21 23:52:13
dac6264fb0f0040f7bd8784ed44c33e4a1318d5b...c4d95daf2de9b85f0282f2113f33bee64245467c,1,10,10,20,2,2014-01-30 00:02:26,2014-01-29 23:54:38
c4d95daf2de9b85f0282f2113f33bee64245467c...e97ed96f1726248d826d29feaf7fbaa5ec01ec9a,6,9,9,18,9,2014-01-30 00:02:26,2014-01-30 00:00:11
e97ed96f1726248d826d29feaf7fbaa5ec01ec9a...71de42f9467449e35016b3ba59b5149ba7c6e3c0,11,133,24,157,17,2014-01-30 00:03:04,2013-12-27 18:55:15
71de42f9467449e35016b3ba59b5149ba7c6e3c0...36c3d951c28cf752789cf881089f3a1683974ac8,3,47,12,59,14,2014-01-30 01:05:47,2014-01-29 02:05:28
36c3d951c28cf752789cf881089f3a1683974ac8...dbc5a216866359da39c9a43a5f52cd28df8cb60c,3,4,17,21,5,2014-01-30 04:06:44,2014-01-23 21:19:38
dbc5a216866359da39c9a43a5f52cd28df8cb60c...a40d78d52823547b5cfe8de8b50edb95b45cf902,4,90,17,107,18,2014-01-30 04:09:38,2014-01-23 20:35:00
a40d78d52823547b5cfe8de8b50edb95b45cf902...f83e6f60ab26f037b686d54168376fa1c8df82ce,7,86,19,105,25,2014-01-30 04:09:38,2014-01-24 16:19:18
f83e6f60ab26f037b686d54168376fa1c8df82ce...b24de3a4b00cf2023a99b42c5a7e4ff5c2f0c4f7,10,87,21,108,25,2014-01-30 04:12:25,2014-01-28 20:53:05
b24de3a4b00cf2023a99b42c5a7e4ff5c2f0c4f7...6a96bab90ebf69d5df1ca120e31599933c910a89,3,12,47,59,14,2014-01-30 15:47:18,2014-01-30 15:47:18
6a96bab90ebf69d5df1ca120e31599933c910a89...707fe683a31754c0bcbdd8abca0029815b96fce1,1,1,3,4,1,2014-01-30 18:09:13,2014-01-30 16:35:51
707fe683a31754c0bcbdd8abca0029815b96fce1...bb56b28f2171c69ce7d5d334d14823987fe21d7d,1,7,1,8,1,2014-01-30 19:13:12,2014-01-30 17:04:10
bb56b28f2171c69ce7d5d334d14823987fe21d7d...7b694b4b38e556af127b67c0b0be7aa08b982822,1,6,0,6,1,2014-01-30 19:13:27,2014-01-30 16:30:32
7b694b4b38e556af127b67c0b0be7aa08b982822...f53c7aef897f814d511c2e2b060ce69aebda6797,1,3,3,6,2,2014-01-30 21:45:46,2014-01-30 21:22:56
f53c7aef897f814d511c2e2b060ce69aebda6797...a032cf6ff24697aabc5940c0c3d20639e6ea99dd,1,9,4,13,2,2014-01-30 21:45:46,2014-01-30 21:23:29
a032cf6ff24697aabc5940c0c3d20639e6ea99dd...adf15ca89abe4027391582a213d649b0f5be62a8,1,8,2,10,1,2014-01-30 22:13:15,2014-01-30 21:32:56
adf15ca89abe4027391582a213d649b0f5be62a8...e472493129c095170f1322a98af67bdf5208fe51,4,28,40,68,13,2014-01-30 22:13:54,2014-01-30 20:57:28
e472493129c095170f1322a98af67bdf5208fe51...5548dbb7a13936911b1b482ddd417cf5879e01b4,1,13,4,17,3,2014-01-30 22:37:48,2014-01-30 22:37:26
5548dbb7a13936911b1b482ddd417cf5879e01b4...0455a09b22d2e5fc7d0fa47e0fd8f83a9d3e03e6,1,2,2,4,2,2014-01-30 23:02:18,2014-01-30 17:59:55
0455a09b22d2e5fc7d0fa47e0fd8f83a9d3e03e6...751f1101967da3593431f1b41a37867ccb169901,15,146,46,192,31,2014-01-30 23:02:18,2014-01-30 23:02:10
751f1101967da3593431f1b41a37867ccb169901...65e312942d3b24bdfa24ab8a2adcf7e4ab702802,1,15,1,16,2,2014-01-31 00:03:39,2014-01-31 00:02:32
65e312942d3b24bdfa24ab8a2adcf7e4ab702802...844101a37ba783ec8e1fdc4b0e73c0892e906150,2,5,5,10,3,2014-01-31 12:38:14,2014-01-31 12:05:26
844101a37ba783ec8e1fdc4b0e73c0892e906150...c9c1ef034da53b99709fd62acdc6c3502001ee90,2,2,0,2,2,2014-01-31 13:22:12,2014-01-31 13:03:34
c9c1ef034da53b99709fd62acdc6c3502001ee90...994103b66cbd41ba9169d628422e496e8cbd24c9,2,9,9,18,8,2014-01-31 14:00:33,2014-01-31 14:00:33
994103b66cbd41ba9169d628422e496e8cbd24c9...c78e0da1535764ab5429ecbbf6e974e04645a844,2,2,2,4,2,2014-01-31 18:08:10,2014-01-31 18:08:10
c78e0da1535764ab5429ecbbf6e974e04645a844...5f2ad3f6411cb1c727e4b836798b8ef06de25f2d,1,2,1,3,1,2014-01-31 19:36:55,2014-01-31 19:20:09
5f2ad3f6411cb1c727e4b836798b8ef06de25f2d...518cbb85a00e4e9ac7dc419569aacc3216db45d2,2,2,2,4,2,2014-02-01 00:37:22,2014-02-01 00:28:37
518cbb85a00e4e9ac7dc419569aacc3216db45d2...c383d4154b81fc01dd279b41e21bf997138ded3d,1,1,0,1,1,2014-02-03 15:10:55,2014-02-03 15:10:52
c383d4154b81fc01dd279b41e21bf997138ded3d...f7363214263451d23946ac895e128a10f9f6f821,2,6,3,9,3,2014-02-03 15:07:40,2014-01-31 19:30:09
f7363214263451d23946ac895e128a10f9f6f821...253520ad161f35a33264b5229ea1cac1d352eb9e,1,1,0,1,1,2014-02-03 15:07:40,2014-01-31 20:55:27
253520ad161f35a33264b5229ea1cac1d352eb9e...3149d5c8ec6f9ead89973a5fcf50fa86557f1940,1,1,1,2,1,2014-02-03 15:55:39,2014-02-03 15:45:38
3149d5c8ec6f9ead89973a5fcf50fa86557f1940...8ad91665c7d654b8d60f4065afde909b9c8502ca,4,80,76,156,10,2014-02-03 16:35:18,2014-02-02 21:58:38
8ad91665c7d654b8d60f4065afde909b9c8502ca...38ba557b50281fa8e1680cbaf7681f06942f4130,1,21,14,35,12,2014-02-03 16:48:18,2014-02-03 16:48:16
38ba557b50281fa8e1680cbaf7681f06942f4130...bffe64219d917b3da8df5b37a734e5e672406c3c,8,35,70,105,23,2014-02-03 17:15:22,2014-01-30 21:11:32
bffe64219d917b3da8df5b37a734e5e672406c3c...a54e8a3f6a6bb51b75a3d776010540ca5a70fd48,1,20,41,61,17,2014-02-03 21:32:45,2014-02-03 19:49:03
a54e8a3f6a6bb51b75a3d776010540ca5a70fd48...ad3e62b700dd70d17713951dee63e5fc3212c92e,1,2,1,3,1,2014-02-03 22:26:46,2014-02-03 20:12:07
ad3e62b700dd70d17713951dee63e5fc3212c92e...588dc81b0822ebb46f80e152b94527a882e6ea5e,2,7,4,11,3,2014-02-03 23:44:13,2014-02-03 23:41:12
588dc81b0822ebb46f80e152b94527a882e6ea5e...d332c23dc7c29329322b8481ea477e42e476db11,1,11,1,12,1,2014-02-04 15:14:43,2014-01-31 19:00:06
d332c23dc7c29329322b8481ea477e42e476db11...b84f4716d1b0c438872141e61bc24937a7800fed,1,1,1,2,1,2014-02-04 15:24:38,2014-02-03 15:53:09
b84f4716d1b0c438872141e61bc24937a7800fed...58e58b77bb5f3bef4a498a640fc55e4f1a416321,1,8,2,10,2,2014-02-04 15:24:38,2014-01-31 21:58:59
58e58b77bb5f3bef4a498a640fc55e4f1a416321...3331d1593aad20283ed2d74148c8ea43e2100386,34,89,320,409,76,2014-02-04 15:59:28,2014-01-29 21:18:53
3331d1593aad20283ed2d74148c8ea43e2100386...8f84eec7d3be1bf9ff21bc5943af3cdc7fdefe41,1,1,1,2,1,2014-02-04 16:05:28,2014-02-04 16:05:28
8f84eec7d3be1bf9ff21bc5943af3cdc7fdefe41...5fbccda28cf10f074e5ae079541a393476bc5565,2,16,10,26,4,2014-02-04 18:41:07,2014-02-03 19:00:35
5fbccda28cf10f074e5ae079541a393476bc5565...2c0785d40795e4e0f06e325e42dd47c9dbb8a97b,1,2,2,4,1,2014-02-04 18:41:07,2014-02-04 16:14:17
2c0785d40795e4e0f06e325e42dd47c9dbb8a97b...de228a1e9b570d7c7fdff4716be2b45863f2dfd4,6,0,42,42,6,2014-02-04 19:18:53,2014-02-04 18:30:22
de228a1e9b570d7c7fdff4716be2b45863f2dfd4...3eec306f42739fc2098c8cd8dc278c54e3376806,2,13,0,13,2,2014-02-04 19:51:28,2014-02-03 16:13:21
3eec306f42739fc2098c8cd8dc278c54e3376806...7e2aa0ba390796d46fd7d568fde0807c8a93f050,1,1,0,1,1,2014-02-04 19:51:05,2014-02-04 16:17:23
7e2aa0ba390796d46fd7d568fde0807c8a93f050...71219e3fa67520e1e0c93cbcdeaee2354d81cd9e,2,81,66,147,25,2014-02-04 20:14:38,2014-02-04 18:34:42
71219e3fa67520e1e0c93cbcdeaee2354d81cd9e...edfce78fcb8ab6abfe5224bd5678b8c11b5978d2,8,28,10,38,11,2014-02-04 20:16:54,2014-02-04 12:44:16
edfce78fcb8ab6abfe5224bd5678b8c11b5978d2...a51798c7d315bf111f53c5b3dd834303df5a0679,1,21,0,21,1,2014-02-04 20:16:55,2014-02-04 16:24:13
a51798c7d315bf111f53c5b3dd834303df5a0679...51e8eee65cdff953b283fe0b9bb3515e298a0e83,1,10,0,10,1,2014-02-04 20:26:23,2014-02-04 20:26:23
51e8eee65cdff953b283fe0b9bb3515e298a0e83...eb305dd9927cb781e9b01d92f1d59058c71380f8,1,1,1,2,1,2014-02-04 20:52:21,2014-02-04 17:40:59
eb305dd9927cb781e9b01d92f1d59058c71380f8...833d2a3f6ba4c8eb6c2daa52a66e45e4582d999d,1,2,0,2,1,2014-02-04 23:33:41,2014-02-04 17:28:11
833d2a3f6ba4c8eb6c2daa52a66e45e4582d999d...e3cc88909df12c1d04be02dcf95faa3d208b8ee1,9,79,10,89,15,2014-02-05 03:52:34,2014-01-31 21:47:55
e3cc88909df12c1d04be02dcf95faa3d208b8ee1...b8fc587a77801725ca001b14d5928e0d5868be00,3,56,59,115,9,2014-02-05 03:56:40,2014-01-31 17:30:11
b8fc587a77801725ca001b14d5928e0d5868be00...98e57eca44dd47e0d3f20df2da1d534086a30b23,3,75,25,100,6,2014-02-05 03:56:41,2014-02-03 20:44:12
98e57eca44dd47e0d3f20df2da1d534086a30b23...9f248cc6a4f885aa33cacbcaeb34cb24de7f1ac3,1,10,67,77,7,2014-02-05 15:55:42,2014-02-04 20:19:05
9f248cc6a4f885aa33cacbcaeb34cb24de7f1ac3...45fe9173ee01d69ff7e8286b37460424472bc06c,2,35,8,43,11,2014-02-05 16:13:39,2014-01-30 16:17:10
45fe9173ee01d69ff7e8286b37460424472bc06c...a1c9bdb119919d53de74c906888a4125ed0a8ab0,7,92,102,194,23,2014-02-05 16:14:15,2014-02-03 17:35:24
a1c9bdb119919d53de74c906888a4125ed0a8ab0...40af64b6940c8479e11e9a69fe9a9120ce2e0935,1,4,2,6,3,2014-02-05 16:59:42,2014-01-27 14:55:48
40af64b6940c8479e11e9a69fe9a9120ce2e0935...bd801007fa10cadfb25c1b211249a17fb0b97ac5,1,1,1,2,1,2014-02-05 17:04:52,2014-02-05 17:04:52
bd801007fa10cadfb25c1b211249a17fb0b97ac5...b270a715d8239d54bc52e29bac0ef970fa29f99e,2,23,3,26,3,2014-02-05 17:51:24,2014-02-05 17:51:19
b270a715d8239d54bc52e29bac0ef970fa29f99e...2005c58876346dba6cdc67025b8d244aca8e4e2c,2,10,0,10,4,2014-02-05 18:04:58,2014-02-04 19:25:39
2005c58876346dba6cdc67025b8d244aca8e4e2c...38dca84deb873a84b6ef736a5a52248581ffc42f,3,175,8,183,15,2014-02-05 18:07:05,2014-02-03 19:02:39
38dca84deb873a84b6ef736a5a52248581ffc42f...86e948fdf8e900fa187f9b34d85841bca580729a,1,5,2,7,2,2014-02-05 18:53:16,2014-02-04 19:28:51
86e948fdf8e900fa187f9b34d85841bca580729a...b156d2b33e99d108e9c3c30c8a277f9ed5ff6b9d,1,8,1,9,2,2014-02-05 19:15:13,2014-02-05 19:01:58
b156d2b33e99d108e9c3c30c8a277f9ed5ff6b9d...00f1db0d025aef71c91af00672f1bcc0110f3483,2,48,9,57,7,2014-02-05 20:08:57,2014-02-04 00:04:51
00f1db0d025aef71c91af00672f1bcc0110f3483...bcfc1335b7b9d63e13ec39b74ad4fa1ce49ad08b,1,2,2,4,2,2014-02-05 20:08:57,2014-02-04 20:08:58
bcfc1335b7b9d63e13ec39b74ad4fa1ce49ad08b...de2ae888633d972a0b2baddb16d794a6d28c3fd9,1,3,3,6,1,2014-02-05 20:08:57,2014-02-03 22:49:31
de2ae888633d972a0b2baddb16d794a6d28c3fd9...3c577a31cbdbb2722ebc2dd71c64e5ed2aab5f0f,1,9,15,24,8,2014-02-05 20:21:00,2014-02-04 23:12:07
3c577a31cbdbb2722ebc2dd71c64e5ed2aab5f0f...4bd3299bc5de987f61098135171692e6f39e725c,6,68,83,151,31,2014-02-05 20:34:25,2014-01-31 16:31:48
4bd3299bc5de987f61098135171692e6f39e725c...391dd744303dc1b615c40d39a1ca4a877480cd2c,8,54,2,56,13,2014-02-05 20:34:25,2014-02-03 18:52:45
391dd744303dc1b615c40d39a1ca4a877480cd2c...018913b3c059a17a1881e19500e6cb25d805e3c7,1,5,5,10,5,2014-02-05 20:57:25,2014-01-31 21:20:03
018913b3c059a17a1881e19500e6cb25d805e3c7...4679fe8e6ed456a869ca17233fa31f4341aff967,1,12,7,19,2,2014-02-05 21:19:47,2014-02-05 21:19:41
4679fe8e6ed456a869ca17233fa31f4341aff967...f3d00132e6251b578bbf24a08ce8ed0e6688e3ac,2,3,3,6,2,2014-02-05 22:41:37,2014-02-03 16:45:14
f3d00132e6251b578bbf24a08ce8ed0e6688e3ac...a56fff30fbe28b90ad3526fb285dec078be72979,55,140,136,276,138,2014-02-05 23:07:02,2014-02-02 16:21:12
a56fff30fbe28b90ad3526fb285dec078be72979...72cf1b8003183fb15f70be90e43b00de00ad5530,1,1,0,1,1,2014-02-05 23:16:26,2014-02-05 22:07:19
72cf1b8003183fb15f70be90e43b00de00ad5530...f2cf9f3ee5efce282db31e4f5de4293fa5e2382a,4,57,4,61,9,2014-02-05 23:16:26,2014-02-03 17:06:18
f2cf9f3ee5efce282db31e4f5de4293fa5e2382a...d262155c2d483f0fbcfb35297d72331dc9ca3043,1,11,10,21,5,2014-02-05 23:16:26,2014-01-31 20:01:49
d262155c2d483f0fbcfb35297d72331dc9ca3043...f6e6601bcf44b9d753c71bf3fdc211ecabbe160f,2,41,1,42,4,2014-02-05 23:16:26,2014-02-04 18:05:41
f6e6601bcf44b9d753c71bf3fdc211ecabbe160f...efeb3daac142483699f3b85809edc44e24a77ef2,2,12,0,12,2,2014-02-06 01:07:56,2014-02-03 17:50:20
efeb3daac142483699f3b85809edc44e24a77ef2...34d899304d971942e6ce4743489495d11a4d48c1,2,17,0,17,3,2014-02-06 14:22:03,2014-02-03 12:07:39
34d899304d971942e6ce4743489495d11a4d48c1...d7d110bfa62c51cf0d50ca248cd5dbe05ea34208,5,379,281,660,38,2014-02-06 15:49:00,2014-02-05 20:10:09
d7d110bfa62c51cf0d50ca248cd5dbe05ea34208...b4f14a19abc1de619f94676cfaf0611099959be5,2,162,162,324,7,2014-02-06 15:49:07,2014-02-03 16:40:48
b4f14a19abc1de619f94676cfaf0611099959be5...dc70aa94f66a383cd5e9e791ec633d12055c62a7,3,0,32,32,3,2014-02-06 18:54:31,2014-02-06 17:07:16
dc70aa94f66a383cd5e9e791ec633d12055c62a7...971cd7f952be5ccfddc518347e87f53e8f4ab22a,2,7,24,31,6,2014-02-06 18:54:31,2014-02-06 17:08:23
971cd7f952be5ccfddc518347e87f53e8f4ab22a...a4d29c5259098ddd2039d4d12f0a0f9786ebeeed,2,49,0,49,3,2014-02-06 19:47:14,2014-01-03 20:44:01
a4d29c5259098ddd2039d4d12f0a0f9786ebeeed...4ef1fec8348328429c11830c8789fb7376916f00,3,69,5,74,7,2014-02-06 20:00:57,2014-02-05 20:05:39
4ef1fec8348328429c11830c8789fb7376916f00...0d111ff5e5b1c38123149e4e4f69c92725981bb8,5,112,1,113,6,2014-02-06 21:13:23,2014-02-06 15:48:25
0d111ff5e5b1c38123149e4e4f69c92725981bb8...532b7e0f0b44c0dfab9a90eed3236f7aea342a92,1,0,3,3,1,2014-02-06 21:27:17,2014-02-06 21:24:31
532b7e0f0b44c0dfab9a90eed3236f7aea342a92...27fb434eaebc35646cdadf7acac562aa47c06ac8,2,94,17,111,5,2014-02-06 21:51:27,2014-02-04 20:33:15
27fb434eaebc35646cdadf7acac562aa47c06ac8...ef817ea8032358b7eb58f953fc3ef203c02fc578,2,6,1,7,3,2014-02-06 23:10:48,2014-02-06 23:10:48
ef817ea8032358b7eb58f953fc3ef203c02fc578...128b91e2bec8b9731c091771ba28a23f999d7b55,3,61,14,75,6,2014-02-07 03:02:42,2014-02-05 19:05:09
128b91e2bec8b9731c091771ba28a23f999d7b55...ce5ec7ad32c56a4b92e0745643911b4a1974e61e,1,2,1,3,2,2014-02-07 03:31:05,2014-02-07 01:25:43
ce5ec7ad32c56a4b92e0745643911b4a1974e61e...4ad2b23b83c96a272cb1a5c4f33ff15971ff69b9,3,100,12,112,13,2014-02-07 13:33:15,2014-02-06 14:24:27
4ad2b23b83c96a272cb1a5c4f33ff15971ff69b9...795353195c696a95a6f18a4deb38dfb5ad588ab9,4,10,3,13,6,2014-02-07 15:28:14,2014-02-07 00:04:45
795353195c696a95a6f18a4deb38dfb5ad588ab9...e01492875083bf30bba35b38a8a0301e66c422df,4,63,4,67,13,2014-02-07 18:16:44,2014-02-06 16:52:13
e01492875083bf30bba35b38a8a0301e66c422df...60949db97b08252d6c763bd645c70eed5c7b56dc,2,63,2,65,4,2014-02-07 18:20:33,2014-02-06 00:09:57
60949db97b08252d6c763bd645c70eed5c7b56dc...749126d5ea0f59828c370880f1b3fba3395015d5,3,48,12,60,15,2014-02-07 18:32:23,2014-02-05 19:36:40
749126d5ea0f59828c370880f1b3fba3395015d5...3a7950fcf73eaf96dacddf522a8e76531157dcdd,1,2,1,3,1,2014-02-07 19:32:57,2014-02-06 17:06:17
3a7950fcf73eaf96dacddf522a8e76531157dcdd...2399d0d6b32a941e4f2c6435d284227bd0df044a,1,10,0,10,1,2014-02-07 20:39:55,2014-02-05 20:41:10
2399d0d6b32a941e4f2c6435d284227bd0df044a...1e7aec1f31aa2794cdb3ca59d823d125d7896b58,1,8,0,8,1,2014-02-07 20:40:10,2014-02-05 22:55:59
1e7aec1f31aa2794cdb3ca59d823d125d7896b58...8ca048383099f4e0c70f79d2bccdcebd1c1df33c,1,1,1,2,1,2014-02-07 20:40:10,2014-02-05 23:18:55
8ca048383099f4e0c70f79d2bccdcebd1c1df33c...75d912c25ab2a2aabaab73b22a6cafddeb6c4906,3,102,129,231,4,2014-02-07 20:41:33,2014-02-06 19:16:40
75d912c25ab2a2aabaab73b22a6cafddeb6c4906...bde6bb4d8887760e2f54798eb54866de029601c1,1,1,1,2,1,2014-02-07 21:15:05,2014-02-07 14:28:36
bde6bb4d8887760e2f54798eb54866de029601c1...1c2af9a7e3b80fde43a345942c9092dc7d1c42a6,2,20,5,25,3,2014-02-07 21:35:19,2014-02-05 17:06:28
1c2af9a7e3b80fde43a345942c9092dc7d1c42a6...dacc99596ed466494c7d9a09c3ea7f04bfe08d4a,5,19,11,30,10,2014-02-08 00:12:17,2014-01-29 23:16:34
dacc99596ed466494c7d9a09c3ea7f04bfe08d4a...ce632548f3053a49ac2f2763663d21eee1ce14bc,4,90,43,133,22,2014-02-08 16:13:09,2014-02-03 23:37:47
ce632548f3053a49ac2f2763663d21eee1ce14bc...1cac4cc145951a7a2c67fa46925600ccd9a13d9c,1,5,2,7,1,2014-02-08 16:13:53,2014-02-07 18:24:03
1cac4cc145951a7a2c67fa46925600ccd9a13d9c...2376a47397551c9ea6bbf97d8ac890d978174e1a,1,0,1,1,1,2014-02-08 16:14:12,2014-02-07 16:55:27
2376a47397551c9ea6bbf97d8ac890d978174e1a...aff6a0bba39634759e24dfe116a7e393a79e6baf,3,104,34,138,15,2014-02-10 01:11:12,2014-02-03 15:37:36
aff6a0bba39634759e24dfe116a7e393a79e6baf...b572251d0452e6d3f9f8ed309b09a99e58b3bf5c,6,690,5,695,11,2014-02-10 15:06:00,2014-02-05 21:09:34
b572251d0452e6d3f9f8ed309b09a99e58b3bf5c...a16bce1003951dbbd5559892a267d51995c7c6dc,2,24,5,29,3,2014-02-10 15:38:25,2014-01-30 17:00:04
a16bce1003951dbbd5559892a267d51995c7c6dc...5999bc487e0b5a80c26676f396ba2544d9fadd5d,3,52,3,55,5,2014-02-10 16:32:04,2014-02-10 16:29:42
5999bc487e0b5a80c26676f396ba2544d9fadd5d...5d94703d7dbbf99de25152e69aacf47b4d09c2d4,3,213,12,225,7,2014-02-10 17:14:34,2014-02-06 17:14:53
5d94703d7dbbf99de25152e69aacf47b4d09c2d4...91204d077bb34b40d1cffa2bbe40c92a08c64d66,31,260,68,328,87,2014-02-10 17:23:27,2014-02-06 22:08:39
91204d077bb34b40d1cffa2bbe40c92a08c64d66...cc12c45a1053ab03db2ecc04c6396514a829733b,1,3,3,6,1,2014-02-10 19:02:09,2014-02-10 19:02:09
cc12c45a1053ab03db2ecc04c6396514a829733b...57c49a91767327fedd3b22a1363480f1a7d9ff20,1,2,0,2,1,2014-02-10 19:22:09,2014-02-09 16:26:36
57c49a91767327fedd3b22a1363480f1a7d9ff20...4c53c496eab4d15c3b8c5782faf1bf5f879237ca,2,36,11,47,3,2014-02-10 19:29:32,2014-02-06 22:29:37
4c53c496eab4d15c3b8c5782faf1bf5f879237ca...226ea3555737bc963d9a49e98a36f5cf0d2a8afd,1,1,1,2,1,2014-02-10 19:36:57,2014-02-10 19:36:57
226ea3555737bc963d9a49e98a36f5cf0d2a8afd...6adfd0c4a9a1900ecf77714695917c95706049b0,2,144,42,186,9,2014-02-10 19:48:54,2014-01-31 20:11:37
6adfd0c4a9a1900ecf77714695917c95706049b0...b8bc31bdb9ff9cc2510205158bd84edd1f5dfc8a,16,186,124,310,67,2014-02-10 20:31:29,2014-02-10 20:31:29
b8bc31bdb9ff9cc2510205158bd84edd1f5dfc8a...76d93c0efaf07e2ba3f3841a7d08e77ec4483b75,3,72,1,73,12,2014-02-10 21:20:06,2014-02-10 16:00:18
76d93c0efaf07e2ba3f3841a7d08e77ec4483b75...bbca96a512c580f13e044eeb7de15132fb3ce193,11,1152,389,1541,104,2014-02-10 21:31:41,2014-02-07 18:38:43
bbca96a512c580f13e044eeb7de15132fb3ce193...15d213f37d624009b0563ce2232d71ede940951c,1,14,8,22,6,2014-02-10 21:54:22,2014-02-05 22:30:04
15d213f37d624009b0563ce2232d71ede940951c...5c302e723656cc936ee0d7fa8e0d7bc6e60a0c59,5,191,14,205,11,2014-02-10 21:54:22,2014-02-05 19:14:05
5c302e723656cc936ee0d7fa8e0d7bc6e60a0c59...9f847a1a91a7f1861733ce6fe1617da89dd945c0,2,30,16,46,11,2014-02-10 22:14:51,2014-02-10 22:13:02
9f847a1a91a7f1861733ce6fe1617da89dd945c0...bdcce2e6717263406d1a5ac15ea72d07f61c6b7a,1,3,1,4,2,2014-02-10 23:48:28,2014-02-10 16:19:48
bdcce2e6717263406d1a5ac15ea72d07f61c6b7a...19820f5a435e4dfedef65b37089e5ed673bcc393,2,11,5,16,3,2014-02-10 23:48:28,2014-02-06 19:18:24
19820f5a435e4dfedef65b37089e5ed673bcc393...47dc95d429c3ae9c471344142defc7d0c5affab2,3,116,57,173,15,2014-02-11 00:05:31,2014-02-05 21:06:12
47dc95d429c3ae9c471344142defc7d0c5affab2...320ccdad6bd6975a3d7480e1bf8374353c545ec6,2,84,83,167,10,2014-02-11 00:05:33,2014-02-06 19:49:47
320ccdad6bd6975a3d7480e1bf8374353c545ec6...b5f67b6a6aec989aec7c01fd445b25c5804f9016,3,49,14,63,7,2014-02-11 00:05:33,2014-02-06 20:20:51
b5f67b6a6aec989aec7c01fd445b25c5804f9016...cc950771c0b7975be18b373f3e4fd009bccc606f,7,51,23,74,16,2014-02-11 12:26:13,2013-12-10 01:48:17
cc950771c0b7975be18b373f3e4fd009bccc606f...3623d555f54d7fe168029085142f6d6dee03c96e,5,76,8,84,10,2014-02-11 21:11:19,2014-02-07 17:09:54
3623d555f54d7fe168029085142f6d6dee03c96e...228c5a2e27cdaf35e1ac7e0a097d8172f7f4a387,6,70,96,166,13,2014-02-11 22:30:42,2014-02-06 21:38:15
228c5a2e27cdaf35e1ac7e0a097d8172f7f4a387...8a2536ddf2933e90c41ef5567aa6fbb0029547e9,1,3,0,3,2,2014-02-11 22:30:42,2014-02-06 21:41:41
8a2536ddf2933e90c41ef5567aa6fbb0029547e9...d8332443b6737565e32dc8d28317ed245173fa46,1,19,2,21,3,2014-02-11 22:50:24,2014-02-11 22:50:24
d8332443b6737565e32dc8d28317ed245173fa46...d6873ccb663a07de47738af913fd25ceff23296f,1,9,1,10,3,2014-02-11 23:05:52,2014-02-11 23:05:52
d6873ccb663a07de47738af913fd25ceff23296f...74c812066e9419eb5def5fab80f53f18971d6854,3,11,3,14,3,2014-02-12 14:34:14,2014-02-10 19:38:06
74c812066e9419eb5def5fab80f53f18971d6854...4de0fdb367ee24a1551989815ac8bff58d064118,1,1,9,10,3,2014-02-12 14:40:13,2014-02-12 14:30:59
4de0fdb367ee24a1551989815ac8bff58d064118...23e1c96acda3055ebc9c9c96ede5c812258b92de,2,18,0,18,4,2014-02-12 14:47:53,2014-02-10 19:17:17
23e1c96acda3055ebc9c9c96ede5c812258b92de...8c99c9ad5cd5ef14f808c1c135f807255330f025,1,17,0,17,1,2014-02-12 14:49:49,2014-02-10 23:26:22
8c99c9ad5cd5ef14f808c1c135f807255330f025...20806b5757b5bf4dbf524df0f332170012086af7,3,109,106,215,18,2014-02-12 16:38:38,2014-01-30 22:16:36
20806b5757b5bf4dbf524df0f332170012086af7...6244c5e5ef1a285ea0a6a28a411caa41a2691197,8,130,178,308,78,2014-02-12 16:39:35,2014-01-30 23:44:34
6244c5e5ef1a285ea0a6a28a411caa41a2691197...bfb1b6e84fe2ea27efd4966fe35d3f6078738a9c,2,4,4,8,4,2014-02-12 16:39:44,2014-02-03 21:00:24
bfb1b6e84fe2ea27efd4966fe35d3f6078738a9c...c8fdb667a2a461dfa1ea2f76791a1a1f94a2c729,1,2,0,2,2,2014-02-12 17:02:12,2014-02-12 16:45:47
c8fdb667a2a461dfa1ea2f76791a1a1f94a2c729...e42c285567ffae3d562b9743bf073cf25624b279,1,10,2,12,2,2014-02-12 18:29:32,2014-02-12 15:31:24
e42c285567ffae3d562b9743bf073cf25624b279...a0b316429eeb4159f6f39c44ad155e611faefc7b,1,0,6,6,2,2014-02-12 18:34:33,2014-02-12 18:28:10
a0b316429eeb4159f6f39c44ad155e611faefc7b...e5f2bc8346a6c7e9d103f16065d4c24b5ade4a87,1,5,4,9,3,2014-02-12 18:54:32,2014-01-31 00:27:16
e5f2bc8346a6c7e9d103f16065d4c24b5ade4a87...3c3b8ee5fcd3f26cf09f6d2997a1dbed55942e59,2,52,2,54,3,2014-02-12 18:55:10,2014-02-05 21:08:05
3c3b8ee5fcd3f26cf09f6d2997a1dbed55942e59...df79d68a7fec7032361146acdc1abfb85e26de22,1,5,6,11,6,2014-02-12 18:59:17,2014-01-31 19:04:29
df79d68a7fec7032361146acdc1abfb85e26de22...51d9c6e2f92001f9a6fd988548f86c1c9ed0c4e4,1,47,47,94,15,2014-02-12 19:05:32,2014-02-07 19:49:28
51d9c6e2f92001f9a6fd988548f86c1c9ed0c4e4...065d65bd64a4b5f9541a24fe491a1d27d56890ad,1,1,0,1,1,2014-02-12 19:32:04,2014-02-12 18:03:15
065d65bd64a4b5f9541a24fe491a1d27d56890ad...e203fc775578a42c88494639b15f9f67f350c4c1,1,26,13,39,7,2014-02-12 19:38:46,2014-02-06 22:32:17
e203fc775578a42c88494639b15f9f67f350c4c1...5e0365665f7244a9382b9bf078c890dce1cd5c03,5,88,32,120,14,2014-02-12 20:21:45,2014-02-05 22:43:15
5e0365665f7244a9382b9bf078c890dce1cd5c03...ee77fd29885faa4ccbe2b019d3645e992267ee34,6,6,48,54,17,2014-02-12 20:55:42,2014-02-12 20:28:15
ee77fd29885faa4ccbe2b019d3645e992267ee34...eb770cae186051282309ca4582b4a255d4b8cfeb,1,6,0,6,1,2014-02-12 23:00:12,2014-02-12 02:40:58
eb770cae186051282309ca4582b4a255d4b8cfeb...ea4ba610f072cbcdecd3fda4e5fb8b5c1833476c,4,49,14,63,11,2014-02-12 23:25:33,2013-12-08 14:54:28
ea4ba610f072cbcdecd3fda4e5fb8b5c1833476c...a210230220941b0a3b699ba0dce874ac137c66ae,1,3,3,6,3,2014-02-12 23:33:43,2014-02-12 23:33:43
a210230220941b0a3b699ba0dce874ac137c66ae...b40b20db5f5770cb4c1d0bc2899358a4d1860f7a,1,2,1,3,1,2014-02-13 00:02:34,2014-02-13 00:02:34
b40b20db5f5770cb4c1d0bc2899358a4d1860f7a...db7b5a93e9bdfee1826a91b94a9f8b904be89813,2,39,1,40,3,2014-02-13 03:01:27,2014-02-05 04:50:25
db7b5a93e9bdfee1826a91b94a9f8b904be89813...78b5eeb13142f0d9bcb43e67848d5fec2f29366d,3,42,2,44,7,2014-02-13 15:22:22,2014-02-10 17:16:04
78b5eeb13142f0d9bcb43e67848d5fec2f29366d...211cac34e574f92cfdf60b7b35312c8a7934118a,26,71,71,142,63,2014-02-13 15:32:17,2014-02-12 19:29:13
211cac34e574f92cfdf60b7b35312c8a7934118a...054fed4f846d1583f0ac9b9e4d5d32b776054589,1,1,1,2,1,2014-02-13 16:11:50,2014-02-13 16:11:50
054fed4f846d1583f0ac9b9e4d5d32b776054589...0003b39a16344bad7fbfa765863d3c712bff3aaa,1,2,6,8,2,2014-02-13 16:19:31,2014-02-13 16:19:27
0003b39a16344bad7fbfa765863d3c712bff3aaa...83f783b2affc4e1baf774cc496cf0740c580369e,1,1,1,2,1,2014-02-13 16:41:46,2014-02-13 15:40:32
83f783b2affc4e1baf774cc496cf0740c580369e...95fd16c297aba152feb99da9653ea234168ec257,1,1,1,2,1,2014-02-13 16:42:43,2014-02-13 16:41:12
95fd16c297aba152feb99da9653ea234168ec257...82f354996edb1e6726de37aee0ca17947a55fe0b,2,174,170,344,35,2014-02-13 17:25:10,2014-02-10 22:44:53
82f354996edb1e6726de37aee0ca17947a55fe0b...d8f7afc96a90ca3f158eebfe4ef3672a27788626,3,25,12,37,12,2014-02-13 17:55:48,2014-02-13 17:55:48
d8f7afc96a90ca3f158eebfe4ef3672a27788626...69ad51c4b8d70b5e17b3104a659e4407305f7b63,1,42,23,65,7,2014-02-13 17:58:50,2014-02-13 11:38:34
69ad51c4b8d70b5e17b3104a659e4407305f7b63...b3ec192e4991677e446e98f6e5c70d04d6a167ab,3,43,11,54,14,2014-02-13 17:58:50,2014-02-13 17:58:11
b3ec192e4991677e446e98f6e5c70d04d6a167ab...61b71b0c7b0c4f2a7dbe72d7cf773a5ce1fbf44a,1,1,1,2,1,2014-02-13 19:44:14,2014-02-13 19:44:05
61b71b0c7b0c4f2a7dbe72d7cf773a5ce1fbf44a...abc8fd203e7f3e031bc991e27cf36128e9f5792a,15,292,95,387,95,2014-02-13 20:01:54,2014-02-11 04:32:24
abc8fd203e7f3e031bc991e27cf36128e9f5792a...83323ce6c59c8c59809f19be982d50734d0778cf,1,1,1,2,1,2014-02-13 20:02:05,2014-02-13 19:53:05
83323ce6c59c8c59809f19be982d50734d0778cf...dad66801520c399a15a070ba089c766cb4c1608e,2,32,0,32,9,2014-02-13 20:24:54,2014-02-07 21:53:05
dad66801520c399a15a070ba089c766cb4c1608e...4d724d2b7a07a7353698917da3ce870507264198,3,3,9,12,6,2014-02-13 20:54:49,2014-02-13 20:04:57
4d724d2b7a07a7353698917da3ce870507264198...66f564bf028cfd44193a464daec890fd0de5929f,2,4,2,6,3,2014-02-13 21:42:56,2014-02-13 21:42:56
66f564bf028cfd44193a464daec890fd0de5929f...4b992a6f1cb2c2422ac7ca602f366a847f07e795,6,188,11,199,21,2014-02-13 22:15:18,2014-02-12 16:26:01
4b992a6f1cb2c2422ac7ca602f366a847f07e795...e9044996c0c3c1fa874e452acf3ef2402c6f162d,2,0,32,32,9,2014-02-13 22:25:53,2014-02-13 22:25:53
e9044996c0c3c1fa874e452acf3ef2402c6f162d...d2de709c117c016dadafcc889a40778d734a979b,2,7,0,7,2,2014-02-13 22:43:17,2014-02-13 16:11:39
d2de709c117c016dadafcc889a40778d734a979b...69e320cf6fde7a7cfd544d7f7b5aadd06f7560e4,9,133,1,134,16,2014-02-13 22:47:20,2014-02-13 01:37:01
69e320cf6fde7a7cfd544d7f7b5aadd06f7560e4...6ae6813f4aea671bc34aa832fd744d4651601d3b,5,248,40,288,21,2014-02-14 04:01:55,2014-02-09 02:07:04
6ae6813f4aea671bc34aa832fd744d4651601d3b...540b41b506a06f7928621e31bc10b766628d11f8,2,2,2,4,2,2014-02-14 13:38:32,2014-02-14 13:38:32
540b41b506a06f7928621e31bc10b766628d11f8...f2f9e69472feb42d5063d42f40cd5ec3926885ee,1,0,3,3,1,2014-02-14 15:55:15,2014-02-14 15:42:13
f2f9e69472feb42d5063d42f40cd5ec3926885ee...4c6907848726d815d6444bd8ac4bf770daaa0df0,1,5,0,5,2,2014-02-14 16:23:55,2014-02-14 14:00:16
4c6907848726d815d6444bd8ac4bf770daaa0df0...47fd56c4e5c5d84e60c9501305f9b680c8c828cf,2,43,35,78,13,2014-02-14 16:44:25,2014-02-12 18:41:20
47fd56c4e5c5d84e60c9501305f9b680c8c828cf...7aad87285f8149e1979699d9767815740e98dff4,1,1,0,1,1,2014-02-14 16:58:21,2014-02-14 15:59:59
7aad87285f8149e1979699d9767815740e98dff4...016cd39853ecdf7b5d38a03b6bd1ce9ad993ef7e,1,88,0,88,1,2014-02-14 18:02:34,2014-02-14 16:51:33
016cd39853ecdf7b5d38a03b6bd1ce9ad993ef7e...8b10468dcb91a856fbaa5e062cf67464127aa2b7,1,0,6,6,4,2014-02-14 19:21:12,2014-02-14 19:11:34
8b10468dcb91a856fbaa5e062cf67464127aa2b7...de8cdc77791f8145e26dafca6c6499c8c4023f60,4,342,134,476,6,2014-02-14 19:22:26,2014-02-14 16:58:42
de8cdc77791f8145e26dafca6c6499c8c4023f60...ec49a75b61297d5e266394d978d1a822fc1a41e9,5,29,17,46,5,2014-02-14 19:37:15,2014-02-14 19:37:15
ec49a75b61297d5e266394d978d1a822fc1a41e9...6dd40e54de4d62ed1c649f6f620a574e6de74fa8,7,148,64,212,12,2014-02-14 19:38:50,2014-02-13 05:47:37
6dd40e54de4d62ed1c649f6f620a574e6de74fa8...a6867c67c3fd2d3d3be3d13cba7840e3acedb575,2,36,0,36,9,2014-02-14 20:29:09,2014-02-07 21:53:05
a6867c67c3fd2d3d3be3d13cba7840e3acedb575...38e50fc06d6592e3e67257d7493416482a5d386d,1,2,2,4,2,2014-02-14 20:53:39,2014-02-14 18:41:31
38e50fc06d6592e3e67257d7493416482a5d386d...9cf49d907195530522600fd4add297ea779414ff,1,0,44,44,1,2014-02-14 21:22:41,2014-02-14 21:17:01
9cf49d907195530522600fd4add297ea779414ff...d7e88f5d08e3a872f7bfb223d1f695235f01909a,1,0,88,88,1,2014-02-14 22:40:10,2014-02-14 22:40:10
d7e88f5d08e3a872f7bfb223d1f695235f01909a...f3bbd9daf3f36b4fee3e577dcea9aa0d1aef8b11,6,279,105,384,13,2014-02-14 23:03:18,2014-02-14 15:53:51
f3bbd9daf3f36b4fee3e577dcea9aa0d1aef8b11...e82c2bf4310e8f0bb6a4041f01a0f5109f13a5a6,12,115,39,154,26,2014-02-14 23:23:22,2014-02-13 20:55:39
e82c2bf4310e8f0bb6a4041f01a0f5109f13a5a6...9f975e58f92330cf477f00044ff7800c497a7ed1,2,0,5,5,2,2014-02-14 23:23:23,2014-02-13 22:12:40
9f975e58f92330cf477f00044ff7800c497a7ed1...c3fae4601874dc8dc6c41fdb63080a08a3784e8d,1,0,1,1,1,2014-02-14 23:23:23,2014-02-14 14:47:14
c3fae4601874dc8dc6c41fdb63080a08a3784e8d...0d433501eba263194a81d4a92b53ac1b8cb0ff3e,1,0,2,2,2,2014-02-14 23:23:55,2014-02-14 14:54:54
0d433501eba263194a81d4a92b53ac1b8cb0ff3e...6c3a1e74f320e89db873266809b68dbf954682a2,2,2,22,24,6,2014-02-14 23:23:55,2014-02-14 16:09:52
6c3a1e74f320e89db873266809b68dbf954682a2...63fdcabe8dea353440e79b27bb334bdd2fe20929,1,0,1,1,1,2014-02-14 23:23:55,2014-02-14 14:50:16
63fdcabe8dea353440e79b27bb334bdd2fe20929...fd8b9c9ba1b55fd01fff062e75d33d9c683fe586,1,0,1,1,1,2014-02-14 23:23:56,2014-02-14 17:24:13
fd8b9c9ba1b55fd01fff062e75d33d9c683fe586...5a7ecde80c028947a9b29e82fe461013991e3d07,5,1,41,42,5,2014-02-14 23:23:56,2014-02-14 17:51:59
5a7ecde80c028947a9b29e82fe461013991e3d07...b855e3e54b2cbe9e93ab97866b37beef53d12696,16,553,105,658,41,2014-02-15 00:17:18,2014-02-12 22:21:12
b855e3e54b2cbe9e93ab97866b37beef53d12696...ecda90ce4ac91aea66f076aacbbe28f7286a7351,10,244,4,248,18,2014-02-15 18:56:12,2014-02-15 16:40:13
ecda90ce4ac91aea66f076aacbbe28f7286a7351...d18bbbd685aa80cce67a4642082f97a1cba9081f,1,88,0,88,1,2014-02-15 19:50:48,2014-02-15 00:54:03
d18bbbd685aa80cce67a4642082f97a1cba9081f...0c065ec66101960e27b4c6cff7f224ec74b8bfed,1,6,0,6,1,2014-02-16 22:26:51,2014-02-16 18:06:41
0c065ec66101960e27b4c6cff7f224ec74b8bfed...306dfabf132eb7ef850171d5407dfaa3cbaddf82,1,48,0,48,1,2014-02-17 02:01:55,2014-02-14 20:30:06
306dfabf132eb7ef850171d5407dfaa3cbaddf82...85396abfc18ec3f6a15cce41f6512ec013b747a4,2,44,69,113,17,2014-02-17 17:39:22,2014-02-14 16:01:33
85396abfc18ec3f6a15cce41f6512ec013b747a4...2850cc7253344c639bc9a01bc6dff3ffd2cca422,1,9,1,10,4,2014-02-18 02:25:26,2014-02-18 02:25:26
2850cc7253344c639bc9a01bc6dff3ffd2cca422...cddc7d0b797cbba7ee02481396414f003fd2c962,4,212,28,240,24,2014-02-18 02:51:24,2014-02-14 22:45:54
cddc7d0b797cbba7ee02481396414f003fd2c962...9e850c8cf6409bab4e0ea3d85ea04537f6b84c0c,1,5,5,10,2,2014-02-18 13:54:45,2014-02-14 20:08:36
9e850c8cf6409bab4e0ea3d85ea04537f6b84c0c...d2a27b0980651c8cb68c06ef3d677498c06ebb68,1,6,1,7,6,2014-02-18 15:52:55,2014-02-18 15:16:25
d2a27b0980651c8cb68c06ef3d677498c06ebb68...263bc242b025553c54a5d1d926386b5ecebfc807,2,5,3,8,2,2014-02-18 16:13:10,2014-02-18 03:47:06
263bc242b025553c54a5d1d926386b5ecebfc807...f1bf729abd78482a871deaf79a96ff26792329a3,1,2,0,2,1,2014-02-18 16:27:16,2014-02-18 16:23:19
f1bf729abd78482a871deaf79a96ff26792329a3...11a2ffdc03e4e3ed53fee893335c66cbff7681fc,2,3,5,8,2,2014-02-18 17:54:41,2014-02-18 17:54:30
11a2ffdc03e4e3ed53fee893335c66cbff7681fc...e5e4a2427b869e40f1a1e6f65dc5e3fd11f451ac,6,52,3,55,11,2014-02-18 18:37:18,2014-02-18 16:25:28
e5e4a2427b869e40f1a1e6f65dc5e3fd11f451ac...617b4896241649e2a3203e33e5901907790002b5,1,0,1,1,1,2014-02-18 20:49:43,2014-02-14 15:25:31
617b4896241649e2a3203e33e5901907790002b5...f85398cf07b9bf082d09689389234f9bc06cc6a3,3,28,11,39,14,2014-02-18 21:18:02,2014-02-18 19:24:53
f85398cf07b9bf082d09689389234f9bc06cc6a3...a7a21700a959498aae1383a50bc2a1a76f5d235f,1,8,2,10,2,2014-02-18 21:18:02,2014-02-13 21:20:38
a7a21700a959498aae1383a50bc2a1a76f5d235f...3a08be3bf2a1a650c97543a448a8ea0c143a89b6,3,96,3,99,4,2014-02-18 21:20:48,2014-02-14 20:44:56
3a08be3bf2a1a650c97543a448a8ea0c143a89b6...3042939e0f64bbb9076eef3ee1efcdd56fc02050,5,33,35,68,21,2014-02-18 22:17:59,2014-02-18 18:54:49
3042939e0f64bbb9076eef3ee1efcdd56fc02050...c43cc49609612800c37444de3a4ca0b434a8e061,1,1,1,2,1,2014-02-18 22:19:37,2014-02-18 22:16:53
c43cc49609612800c37444de3a4ca0b434a8e061...40b314894c7de615b09d633774f9146e4b097b02,1,8,1,9,3,2014-02-18 22:19:39,2014-02-18 22:18:17
40b314894c7de615b09d633774f9146e4b097b02...640ec7cc23fa5e2f4cdc4eb1cccbd94be7b7ed88,1,422,0,422,2,2014-02-18 23:34:54,2014-02-12 15:35:25
640ec7cc23fa5e2f4cdc4eb1cccbd94be7b7ed88...efc9a4a324fa7046be9ec41431c3edf6f9be24ef,1,5,0,5,2,2014-02-18 23:44:14,2014-02-18 12:21:13
efc9a4a324fa7046be9ec41431c3edf6f9be24ef...25c2e4bcb4d25fddf0eb2b214ff9229f26456b89,1,17,9,26,9,2014-02-19 00:12:42,2014-02-11 00:51:31
25c2e4bcb4d25fddf0eb2b214ff9229f26456b89...9a9baaaf78677b939b8267d6e9266ec88c345b6b,3,13,19,32,10,2014-02-19 03:46:09,2014-02-19 03:45:21
9a9baaaf78677b939b8267d6e9266ec88c345b6b...6718e33f5ecd0de4a8550afaf789c2fc416b6eee,36,978,548,1526,112,2014-02-19 04:11:00,2014-02-19 02:57:01
6718e33f5ecd0de4a8550afaf789c2fc416b6eee...85b43895e9f54277d1b9696951fc3e7550477e74,5,129,80,209,18,2014-02-19 07:06:42,2014-02-18 16:19:51
85b43895e9f54277d1b9696951fc3e7550477e74...16612e609a83ebb06891e220200d4014331701cb,14,587,360,947,30,2014-02-19 11:11:20,2014-02-18 19:38:58
16612e609a83ebb06891e220200d4014331701cb...681c74b3f2de1e3665f953dfb07bcb25f48ecd2c,1,3,0,3,1,2014-02-19 12:16:17,2014-02-19 12:16:17
681c74b3f2de1e3665f953dfb07bcb25f48ecd2c...63ba64be33b2c0dab6fb9bbfbbd265f0afa7e788,1,35,7,42,8,2014-02-19 12:45:54,2014-02-19 12:45:54
63ba64be33b2c0dab6fb9bbfbbd265f0afa7e788...dd56209bfcb34d59191d1b3a9caa1af177f8e16f,1,1,1,2,1,2014-02-19 15:42:58,2014-02-19 15:42:58
dd56209bfcb34d59191d1b3a9caa1af177f8e16f...4fa9b92fb4b0362630699e043ed52da7d59d48e7,1,1,1,2,1,2014-02-19 16:20:01,2014-02-18 20:10:01
4fa9b92fb4b0362630699e043ed52da7d59d48e7...00c7183b1a79b795f3d39c9079bb2f795c1cabb6,2,25,0,25,4,2014-02-19 16:22:50,2014-02-18 20:01:51
00c7183b1a79b795f3d39c9079bb2f795c1cabb6...cfdf055eee1b1d0eed3d13c0c2d4d66a27dff662,11,177,94,271,39,2014-02-19 17:45:44,2014-02-14 19:22:52
cfdf055eee1b1d0eed3d13c0c2d4d66a27dff662...05c1dd31bbb2f5e039845031213f1b1f243d598f,6,38,9,47,11,2014-02-19 17:58:19,2014-02-19 17:57:06
05c1dd31bbb2f5e039845031213f1b1f243d598f...637ca318fd8df656931591214fccaf219616fd91,1,9,1,10,1,2014-02-19 18:13:23,2014-02-19 14:13:53
637ca318fd8df656931591214fccaf219616fd91...548693879eddfe3051a7303245dcfedde3a0ac61,5,52,18,70,19,2014-02-19 19:57:34,2014-02-18 20:09:25
548693879eddfe3051a7303245dcfedde3a0ac61...1954504cacb580e06ab20742edf1f3a3c72f75fb,1,1,1,2,1,2014-02-19 19:58:58,2014-02-19 19:58:58
1954504cacb580e06ab20742edf1f3a3c72f75fb...9b93e7e43e279e2458d8e624750b561875611c18,7,222,87,309,26,2014-02-19 19:59:59,2014-02-19 00:13:00
9b93e7e43e279e2458d8e624750b561875611c18...28327ab66e97d3319ca2baf001385a38825da84c,4,33,15,48,15,2014-02-19 20:34:35,2014-02-18 15:20:33
28327ab66e97d3319ca2baf001385a38825da84c...7824eac06e596d26165744229c3121af55305534,2,15,2,17,5,2014-02-19 20:34:35,2014-02-19 15:19:15
7824eac06e596d26165744229c3121af55305534...3269a5e07acfadd8788294a29a45c9aa4963213c,5,12,13,25,12,2014-02-19 20:44:41,2014-02-19 19:48:12
3269a5e07acfadd8788294a29a45c9aa4963213c...e0cea6ad0766d273f2713622465926e47a143c76,4,150,76,226,45,2014-02-19 20:57:10,2013-12-10 01:48:17
e0cea6ad0766d273f2713622465926e47a143c76...0ffa7266291ab19cfe98109c77c9c3ac38c5e1f0,7,30,11,41,10,2014-02-19 22:15:07,2014-02-13 19:36:48
0ffa7266291ab19cfe98109c77c9c3ac38c5e1f0...61b70161b716fbe8e426cd316c551c07a4b4184c,1,0,1,1,1,2014-02-19 18:19:21,2014-02-19 18:19:21
61b70161b716fbe8e426cd316c551c07a4b4184c...a71a95ce4be07232a7dd4e9becf1249a987e7760,5,1,352,353,5,2014-02-19 18:19:54,2014-02-19 18:19:54
a71a95ce4be07232a7dd4e9becf1249a987e7760...269c683220692299b5fb9cf431359e3ec299f8fc,7,410,51,461,30,2014-02-20 02:36:18,2014-02-18 15:57:16
269c683220692299b5fb9cf431359e3ec299f8fc...f03fe8518989be07ebf741725a7d50ca66577d6f,17,623,390,1013,66,2014-02-20 02:51:35,2014-02-19 21:25:10
f03fe8518989be07ebf741725a7d50ca66577d6f...78ccc51be325d99e61e5bb2c0cb3029005a97b34,1,5,5,10,5,2014-02-20 03:05:23,2014-02-20 03:05:23
78ccc51be325d99e61e5bb2c0cb3029005a97b34...cb382700f1807de6c67456a8284c8e4415d4b741,8,165,78,243,13,2014-02-19 22:09:24,2014-02-18 16:41:08
cb382700f1807de6c67456a8284c8e4415d4b741...25bddf266b85a97d8bc17796cb0c2a0759ba639c,8,174,3,177,12,2014-02-19 22:09:24,2014-02-18 13:12:31
25bddf266b85a97d8bc17796cb0c2a0759ba639c...5611bb4517550031684c510fb7a60abe04712ca7,1,14,0,14,2,2014-02-20 17:01:29,2014-02-20 16:10:32
5611bb4517550031684c510fb7a60abe04712ca7...b6a6d3a7231291aaa748523033b46158ba2332c5,1,1,0,1,1,2014-02-20 16:20:45,2014-02-20 11:26:17
b6a6d3a7231291aaa748523033b46158ba2332c5...3172b29a062d7480ab0b7e0b9a5f13cb271415c1,2,17,1,18,5,2014-02-20 16:20:45,2014-02-20 13:02:26
3172b29a062d7480ab0b7e0b9a5f13cb271415c1...6b2a91d4fd17e3d1a4d4a8aab001cd98903e4d09,1,1,1,2,1,2014-02-20 16:20:45,2014-02-20 13:14:15
6b2a91d4fd17e3d1a4d4a8aab001cd98903e4d09...bc86b32e6f5c197b88f0f9fe82e9e9e340bfa630,1,20,21,41,15,2014-02-20 22:01:03,2014-02-20 14:37:07
bc86b32e6f5c197b88f0f9fe82e9e9e340bfa630...38615e63a675c318e2f5200e8446d0088f04556b,1,1,1,2,1,2014-02-20 22:01:03,2014-02-20 14:54:20
38615e63a675c318e2f5200e8446d0088f04556b...00cddf94d73330b208742f86c304b54b43533610,1,6,2,8,2,2014-02-20 22:01:03,2014-02-20 14:53:44
00cddf94d73330b208742f86c304b54b43533610...3779bf419438d2625277cf3c1c7216c497f683a8,7,7,7,14,7,2014-02-21 00:06:10,2014-02-21 00:06:10
3779bf419438d2625277cf3c1c7216c497f683a8...5708c7a2308817e3bc775802daf1ecbd1b80f777,2,2,2,4,2,2014-02-21 15:34:00,2014-02-21 15:34:00
5708c7a2308817e3bc775802daf1ecbd1b80f777...4cdbea7616eca3af21d211b0482a61690b481617,3,48,22,70,15,2014-02-21 15:41:44,2014-02-21 15:27:18
4cdbea7616eca3af21d211b0482a61690b481617...51300745542e7df3b0864069079e74114c0c42c6,15,472,441,913,54,2014-02-21 18:37:08,2014-02-18 20:32:01
51300745542e7df3b0864069079e74114c0c42c6...fb34a083e9ac3f50ddbdee72c5f0c029a4ba356e,1,17,8,25,5,2014-02-21 19:00:05,2014-02-19 22:22:42
fb34a083e9ac3f50ddbdee72c5f0c029a4ba356e...815f4f88e6953057b9c9f8ac4e9b94c959063dbc,1,613,0,613,1,2014-02-21 19:15:48,2013-12-10 21:20:41
815f4f88e6953057b9c9f8ac4e9b94c959063dbc...f9fac71d2e5bc70586c6d68acea5a4adc7a09c27,1,1,2,3,2,2014-02-21 19:20:46,2014-02-21 19:19:51
f9fac71d2e5bc70586c6d68acea5a4adc7a09c27...68eca9bf07dd3506b8cd4eba8bd5f39a10ad8baf,1,11,11,22,4,2014-02-21 19:49:38,2014-02-18 21:03:52
68eca9bf07dd3506b8cd4eba8bd5f39a10ad8baf...a52650febd73142b1785117032a9575e60d95fb3,1,694,0,694,1,2014-02-21 20:11:58,2014-02-20 15:48:05
a52650febd73142b1785117032a9575e60d95fb3...7a2c553be0eea5b5d118dd60398c4f5fda1d202b,1,1,1,2,1,2014-02-21 21:34:09,2014-02-21 16:34:49
7a2c553be0eea5b5d118dd60398c4f5fda1d202b...6c6844e9b012c16d78353ab226911d3b9f134606,1,4,4,8,3,2014-02-21 21:34:09,2014-02-21 21:32:32
6c6844e9b012c16d78353ab226911d3b9f134606...7729ff2bd1b14defafb22ad872af4d2ca3cf41db,1,8,1,9,1,2014-02-21 21:46:57,2014-02-21 19:20:18
7729ff2bd1b14defafb22ad872af4d2ca3cf41db...e1fd728336995a52e4b2ef7bf0770fc51586c552,2,17,6,23,5,2014-02-21 22:43:07,2014-02-20 15:54:02
e1fd728336995a52e4b2ef7bf0770fc51586c552...d073743e91afaae772385198c7c0819fb40cde20,6,20,1,21,13,2014-02-21 22:43:07,2014-02-20 21:48:00
d073743e91afaae772385198c7c0819fb40cde20...90419483250ca79da13293b4cf3f234ed805bb9b,5,193,45,238,26,2014-02-21 22:46:58,2014-02-20 18:20:49
90419483250ca79da13293b4cf3f234ed805bb9b...be2bdccc1bc5f8d501aa752282dcee2c3e7a277f,1,11,9,20,2,2014-02-22 05:18:08,2014-02-20 21:57:25
be2bdccc1bc5f8d501aa752282dcee2c3e7a277f...5e1c41438689e09c2122efdb3cd4e5a274b36099,1,2,2,4,2,2014-02-22 16:10:58,2014-02-22 16:10:58
5e1c41438689e09c2122efdb3cd4e5a274b36099...d0135ad0ed90118ad2015283f22b0219c0df3301,6,6,36,42,15,2014-02-22 18:09:20,2014-02-22 18:09:20
d0135ad0ed90118ad2015283f22b0219c0df3301...9110ba43e61d8d579ee8eec1bbfc3d16d5ece86f,1,2,2,4,2,2014-02-23 23:36:34,2014-02-23 19:53:07
9110ba43e61d8d579ee8eec1bbfc3d16d5ece86f...64d61703a6ef9986608861cd5614ae2c0bf05cf4,2,25,9,34,7,2014-02-24 06:45:58,2014-02-24 06:03:58
64d61703a6ef9986608861cd5614ae2c0bf05cf4...c1c58e880285c7ecd9eba3cb961068954a017249,2,6,5,11,2,2014-02-24 15:44:20,2014-02-24 13:46:02
c1c58e880285c7ecd9eba3cb961068954a017249...0c61493cd36a7aef42713af1cb2c14a23ccff746,14,53,28,81,26,2014-02-24 15:47:33,2014-02-24 14:58:39
0c61493cd36a7aef42713af1cb2c14a23ccff746...ce97325da8b0494b813c2777283fed532adda9db,22,308,221,529,72,2014-02-24 15:50:36,2014-02-21 15:45:05
ce97325da8b0494b813c2777283fed532adda9db...a9f00ca795116b48abe1396123245502b5aa4590,1,19,14,33,6,2014-02-24 17:54:47,2014-02-20 19:03:05
a9f00ca795116b48abe1396123245502b5aa4590...53a3ca2ffaeaf9b1eb067054cf36afac8ce53dd6,3,11,1,12,4,2014-02-24 18:33:01,2014-02-24 17:59:18
53a3ca2ffaeaf9b1eb067054cf36afac8ce53dd6...0ffa44a9bda36dbab227ed4514650773bbf59411,1,41,92,133,43,2014-02-24 18:33:44,2014-02-24 16:59:36
0ffa44a9bda36dbab227ed4514650773bbf59411...7ee0b022ced2adb3e12bad9fa6af3f6225b3fdb5,1,3,2,5,2,2014-02-24 19:14:18,2014-02-24 16:55:15
7ee0b022ced2adb3e12bad9fa6af3f6225b3fdb5...93d8298778fa7f11402755bbd23d28767227f86d,2,13,0,13,3,2014-02-24 19:56:49,2014-02-24 19:56:43
93d8298778fa7f11402755bbd23d28767227f86d...d137daf04d83465bfbceacc96b56d13ae0a3c4e8,2,15,0,15,4,2014-02-24 21:55:56,2014-02-24 15:46:35
d137daf04d83465bfbceacc96b56d13ae0a3c4e8...19aa6b6ca7fb1366565f31aa71420dd3f32a1433,8,110,13,123,19,2014-02-25 01:10:14,2014-02-21 07:38:24
19aa6b6ca7fb1366565f31aa71420dd3f32a1433...8bf16f9e54e61a6befa791a6378ffdd06ad35a5b,5,84,12,96,13,2014-02-25 14:55:36,2014-02-21 00:00:25
8bf16f9e54e61a6befa791a6378ffdd06ad35a5b...a4abdfcc602b944d9a08eeb5deadd7a2a813fecc,1,1,1,2,1,2014-02-25 15:05:50,2014-02-23 20:21:46
a4abdfcc602b944d9a08eeb5deadd7a2a813fecc...c46e41983184ec04d6be8c6667945b97163cb7f4,5,26,8,34,2,2014-02-25 16:16:44,2014-02-14 17:04:31
c46e41983184ec04d6be8c6667945b97163cb7f4...9d15c2e8cae042055f9d5814f792ab9b9cecad7c,1,2,2,4,2,2014-02-25 16:33:07,2014-02-25 16:33:03
9d15c2e8cae042055f9d5814f792ab9b9cecad7c...03b5eae78c653d7eb11df4ce26b9b28833e95e62,4,210,0,210,6,2014-02-25 18:11:01,2014-02-25 16:24:16
03b5eae78c653d7eb11df4ce26b9b28833e95e62...0b4ee727db118d01f28cb046c23068d4961990fe,4,64,70,134,5,2014-02-25 18:48:14,2014-02-22 16:50:10
0b4ee727db118d01f28cb046c23068d4961990fe...78b54a037a0ddcfde7c75e3d7d13f70f760246d3,1,5,5,10,2,2014-02-25 18:49:42,2014-02-10 21:50:00
78b54a037a0ddcfde7c75e3d7d13f70f760246d3...3c70a417f2442c40ad60e290edc02a9c43806a94,1,0,1,1,1,2014-02-25 19:35:18,2014-02-25 19:35:14
3c70a417f2442c40ad60e290edc02a9c43806a94...65151ad29acbc2e8ba0fd6eec9692752f8f3fcf6,1,5,5,10,2,2014-02-25 20:27:34,2014-02-25 19:33:36
65151ad29acbc2e8ba0fd6eec9692752f8f3fcf6...bad0ae59975151081e69e61ff361e5821b2408cc,1,9,0,9,2,2014-02-25 21:31:01,2014-02-25 20:53:42
bad0ae59975151081e69e61ff361e5821b2408cc...7766137467a41c02d053d81b65d55349bd865b29,6,36,6,42,15,2014-02-26 02:23:53,2014-02-24 23:57:02
7766137467a41c02d053d81b65d55349bd865b29...fafbd01bda9ef5a0969a56365d0af9ce4a4fc689,1,157,3,160,4,2014-02-26 02:25:47,2014-02-25 19:20:48
fafbd01bda9ef5a0969a56365d0af9ce4a4fc689...32b36216dd85697c614c4873021387658d31e1a0,1,46,3,49,6,2014-02-26 12:40:41,2014-02-25 19:01:36
32b36216dd85697c614c4873021387658d31e1a0...f4c7d400c8f938374474a37cde54e36168e60b26,1,4,34,38,29,2014-02-26 15:38:28,2014-02-25 23:13:06
f4c7d400c8f938374474a37cde54e36168e60b26...a56653e1df978f68b887788b39d053e3f88bb0ea,18,116,64,180,56,2014-02-26 17:11:30,2014-02-26 16:25:50
a56653e1df978f68b887788b39d053e3f88bb0ea...4c599a895994cc32593b68b84b79f42f9c6c348c,1,19,12,31,7,2014-02-26 18:49:10,2014-02-26 18:07:58
4c599a895994cc32593b68b84b79f42f9c6c348c...997798bde77060ce9d3990d3f4caabbb9e5058df,3,173,12,185,13,2014-02-26 19:01:59,2014-02-25 20:58:26
997798bde77060ce9d3990d3f4caabbb9e5058df...a3d910925350d2f0204b41ea145e24f74e5c39ce,7,183,85,268,29,2014-02-26 19:57:42,2014-02-26 18:09:41
a3d910925350d2f0204b41ea145e24f74e5c39ce...3709484b65d0c153d4d52713e8466b7b3a791233,1,7,4,11,2,2014-02-26 20:05:37,2014-02-26 20:05:32
3709484b65d0c153d4d52713e8466b7b3a791233...d908a87df9f601cec7be3d34abd00f258679ff44,1,2,4,6,1,2014-02-26 21:05:04,2014-02-26 16:56:31
d908a87df9f601cec7be3d34abd00f258679ff44...56e74d27c1a50ff945266e63a34643610fa3c46c,2,10,0,10,3,2014-02-26 22:54:27,2014-02-26 22:54:27
56e74d27c1a50ff945266e63a34643610fa3c46c...c5ce70cdef9102b1f71cbf2beb94da7ebb9f1c5c,4,21,23,44,13,2014-02-26 23:13:23,2014-02-18 20:06:06
c5ce70cdef9102b1f71cbf2beb94da7ebb9f1c5c...2f2bdc60421fc7459c32c11ca88a3f71bebf3fd3,1,1,1,2,1,2014-02-26 23:25:45,2014-02-26 23:12:40
2f2bdc60421fc7459c32c11ca88a3f71bebf3fd3...69314bca2ca7a6831f4aa657eba231fac2196901,1,12,8,20,4,2014-02-27 12:20:09,2014-02-26 20:43:07
69314bca2ca7a6831f4aa657eba231fac2196901...d9c5f2c2c0872519c68ec9200df9ff5ee7e7b071,1,6,6,12,3,2014-02-27 15:59:20,2014-02-27 15:59:20
d9c5f2c2c0872519c68ec9200df9ff5ee7e7b071...61fd3312022a49e44c9a2abd97554a941891d437,1,4,4,8,2,2014-02-27 17:43:23,2014-02-27 17:43:23
61fd3312022a49e44c9a2abd97554a941891d437...58baf1566fa1742a6540ca50c6dc77440991300f,5,44,2,46,11,2014-02-27 18:35:45,2014-02-27 17:21:27
58baf1566fa1742a6540ca50c6dc77440991300f...b605f98c68a03fd0e65be72f9a22af4f107dee6b,3,6,5,11,6,2014-02-27 19:05:18,2014-02-27 19:05:02
b605f98c68a03fd0e65be72f9a22af4f107dee6b...7ef1c038a8b7929a687eb931e8861deef444ce22,1,9,4,13,4,2014-02-27 19:39:02,2014-02-27 13:58:17
7ef1c038a8b7929a687eb931e8861deef444ce22...d8f5f9a8221498e3637971fb0a74818d1d4782c5,11,135,1,136,20,2014-02-27 20:14:00,2014-02-27 15:18:43
d8f5f9a8221498e3637971fb0a74818d1d4782c5...552cce169154293d27c9b782cac8a5dec146ceae,4,18,8,26,11,2014-02-27 20:14:01,2014-02-27 15:28:14
552cce169154293d27c9b782cac8a5dec146ceae...04f7ab3acc4e10edac4e34a7a8a4bc47b1934132,1,5,3,8,2,2014-02-27 21:39:48,2014-02-27 21:32:27
04f7ab3acc4e10edac4e34a7a8a4bc47b1934132...5e120d33c761d2dd89ae260751ab1368c512a8d5,3,332,6,338,27,2014-02-28 00:09:23,2014-02-26 02:23:31
5e120d33c761d2dd89ae260751ab1368c512a8d5...94cbec5589f05b257a48fd73e1153c02a5ae1ff5,4,37,42,79,15,2014-02-28 00:09:24,2014-02-26 21:02:19
94cbec5589f05b257a48fd73e1153c02a5ae1ff5...80fcae04c76b2d7264e93a0e1943a47c58b2d821,6,27,14,41,13,2014-02-28 00:09:24,2014-02-26 18:06:40
80fcae04c76b2d7264e93a0e1943a47c58b2d821...ba9db2cc41b42e8867d84d14761659fe292d5a95,4,75,7,82,13,2014-02-28 00:09:24,2014-02-26 18:09:05
ba9db2cc41b42e8867d84d14761659fe292d5a95...59de90f6d4b1aa9e753921031f1f821611720a2f,1,1,1,2,1,2014-02-28 01:30:04,2014-02-26 03:35:54
59de90f6d4b1aa9e753921031f1f821611720a2f...5f4dfa51a90066547f4856b8cff6096870b29810,1,14,10,24,2,2014-02-28 01:40:12,2014-02-27 07:27:34
5f4dfa51a90066547f4856b8cff6096870b29810...c0e81f4a321b365b853895caa06070a0c90e81ad,3,33,14,47,12,2014-02-28 15:31:32,2014-02-28 15:31:32
c0e81f4a321b365b853895caa06070a0c90e81ad...4b936ef90766ab327ea71468002c07e3020b94d7,9,114,26,140,29,2014-02-28 16:34:17,2014-02-27 21:36:30
4b936ef90766ab327ea71468002c07e3020b94d7...7851431d5b4b1dc0a5df17c1f7964d2bfc3ff623,4,41,59,100,6,2014-02-28 16:34:17,2014-02-27 21:37:21
7851431d5b4b1dc0a5df17c1f7964d2bfc3ff623...944807590b5d7a6a5b7b53f02bd032faf9406507,4,54,12,66,17,2014-02-28 16:39:58,2014-02-27 20:34:46
944807590b5d7a6a5b7b53f02bd032faf9406507...4d51c9ac8769223b5c2db1383325318d31f141b6,1,39,5,44,5,2014-02-28 18:50:58,2014-02-28 17:03:21
4d51c9ac8769223b5c2db1383325318d31f141b6...b6bcdd964c0a45348273fb5d61763d15a8ddcb3a,1,18,16,34,2,2014-02-28 18:50:59,2014-02-28 18:16:04
b6bcdd964c0a45348273fb5d61763d15a8ddcb3a...466ede2ed20cc5abcae3d48b56d78a0eb6e96966,5,79,29,108,20,2014-02-28 18:50:59,2014-02-28 17:59:50
466ede2ed20cc5abcae3d48b56d78a0eb6e96966...b2b0dd358bce9d76faba794f5a3ee82e177060fe,1,9,5,14,2,2014-02-28 18:53:03,2014-02-28 18:50:55
b2b0dd358bce9d76faba794f5a3ee82e177060fe...f18e88ffafd615d515f3359ee73f719b1667e193,3,34,5,39,5,2014-02-28 18:56:11,2014-02-27 23:53:50
f18e88ffafd615d515f3359ee73f719b1667e193...914a26f51ff7ffeb28922273925318da6a6eba71,3,31,2,33,4,2014-02-28 19:28:48,2014-02-28 15:58:22
914a26f51ff7ffeb28922273925318da6a6eba71...4223bd5d10578f16f814593873137b4cc16d5e65,1,1,1,2,1,2014-02-28 19:45:53,2014-02-28 19:45:39
4223bd5d10578f16f814593873137b4cc16d5e65...eed1cc1e26395667bc9e3ecf38a0dc9f274de362,2,24,0,24,3,2014-02-28 19:56:28,2014-02-28 19:08:39
eed1cc1e26395667bc9e3ecf38a0dc9f274de362...26487218cdf6203aef7c63bb379101c7e17f596d,1,0,25,25,1,2014-02-28 20:02:19,2014-02-28 18:36:13
26487218cdf6203aef7c63bb379101c7e17f596d...0171919dcf52278421715a90038d4ce97c483e6e,1,105,0,105,1,2014-02-28 20:13:29,2014-02-24 02:48:41
0171919dcf52278421715a90038d4ce97c483e6e...6a167a29bd3259ad77ccba6b4b70dd5b0a43c917,1,1,0,1,1,2014-02-28 20:15:58,2014-02-27 15:51:41
6a167a29bd3259ad77ccba6b4b70dd5b0a43c917...6ecd2ee44c888b5513f42bb5413881ee23ba71a1,1,23,6,29,6,2014-02-28 20:52:19,2014-02-28 16:46:18
6ecd2ee44c888b5513f42bb5413881ee23ba71a1...d43eb9202ff065364e0eac9a6b601186afd37fa5,1,29,17,46,8,2014-02-28 21:14:50,2014-02-18 21:54:11
d43eb9202ff065364e0eac9a6b601186afd37fa5...cd62080dcb036e83f8fca6d68d9bcab67bf7a21c,10,327,120,447,42,2014-02-28 21:14:50,2014-02-27 21:29:46
cd62080dcb036e83f8fca6d68d9bcab67bf7a21c...5595b945603b0712c537787e31e6da661c424fee,464,1116,1297,2413,248,2014-02-28 21:26:33,2014-01-14 19:09:42
5595b945603b0712c537787e31e6da661c424fee...7ace8d588d249f8ef558d59ab9dcb5e48babe55f,3,23,8,31,11,2014-03-01 02:53:59,2014-02-27 18:57:54
7ace8d588d249f8ef558d59ab9dcb5e48babe55f...8e744bf129d0435aa3b17368b76282432af26db6,3,31,5,36,12,2014-03-01 02:54:00,2014-02-26 19:11:28
8e744bf129d0435aa3b17368b76282432af26db6...fcc9f9533202466a1420e6eb539e9e8978d506df,2,2,3,5,3,2014-02-28 22:33:59,2014-02-28 21:44:56
fcc9f9533202466a1420e6eb539e9e8978d506df...2bf41261b20a02f06ec5ad7281f3c16e0b3d7fc3,2,179,19,198,11,2014-03-01 05:38:46,2014-02-28 21:17:46
2bf41261b20a02f06ec5ad7281f3c16e0b3d7fc3...1cd312b6faa138b39db2b94a2d7258cda15c68a1,1,16,0,16,2,2014-03-03 02:09:19,2014-02-28 06:42:00
1cd312b6faa138b39db2b94a2d7258cda15c68a1...10e298ddbc22e97a1286c9e7fdcb24366db894b6,3,113,53,166,12,2014-03-03 14:15:25,2014-02-25 22:19:50
10e298ddbc22e97a1286c9e7fdcb24366db894b6...fafb7dad7b87b3d6a0c359ad02b6bcd0ef7a79f7,1,3,3,6,1,2014-03-03 15:10:46,2014-03-03 15:10:46
fafb7dad7b87b3d6a0c359ad02b6bcd0ef7a79f7...779e4d12da9e3fa769ea3cccd9f00082b6ed434f,2,3,25,28,2,2014-03-03 16:17:44,2014-03-03 16:17:44
779e4d12da9e3fa769ea3cccd9f00082b6ed434f...8ea1893b027876922bb16a09fa9d4691946f7700,2,4,0,4,3,2014-03-03 17:00:05,2014-03-03 16:50:36
8ea1893b027876922bb16a09fa9d4691946f7700...1ffdd358b9fa048794a09bbc644f6043dde15eeb,1,1,0,1,1,2014-03-03 17:11:11,2014-02-28 14:35:54
1ffdd358b9fa048794a09bbc644f6043dde15eeb...803ae07cb3eb9cb9051995e9b2ac48958131fb3a,7,56,19,75,15,2014-03-03 17:24:06,2014-02-14 18:52:02
803ae07cb3eb9cb9051995e9b2ac48958131fb3a...f880299ae5eb78c3cb1789e3439135d5d33cb64f,3,27,7,34,4,2014-03-03 17:26:22,2014-03-03 16:53:23
f880299ae5eb78c3cb1789e3439135d5d33cb64f...24f85cdfdba1db685f4da499d8fcb77385e57da7,2,354,22,376,14,2014-03-03 17:52:27,2014-02-27 22:10:13
24f85cdfdba1db685f4da499d8fcb77385e57da7...785b41bb229d49352e883df2fe0f927888772c8f,2,73,11,84,9,2014-03-03 19:13:09,2014-03-03 17:17:49
785b41bb229d49352e883df2fe0f927888772c8f...e499f7a2394c19494d55c5b68370a2e53c241778,1,8,1,9,1,2014-03-03 14:44:35,2014-02-27 12:54:33
e499f7a2394c19494d55c5b68370a2e53c241778...30074e8c048032c0c3cd3ebde349e83a3d56713a,1,2,1,3,1,2014-03-03 14:44:35,2014-02-28 13:13:48
30074e8c048032c0c3cd3ebde349e83a3d56713a...6a10de0bb8fe996daca5ecd5687f1072abb0dd8b,1,41,2,43,1,2014-03-03 14:44:35,2014-02-28 13:45:02
6a10de0bb8fe996daca5ecd5687f1072abb0dd8b...f8534ae0d6c4e252d169c5bcf42f42cf6518ee7d,450,19437,0,19437,450,2014-03-03 20:29:00,2014-03-03 20:04:57
f8534ae0d6c4e252d169c5bcf42f42cf6518ee7d...cd1cdfcce54d4c0e06aed61b214c383edcae4b02,1,12,0,12,1,2014-03-03 21:21:10,2014-03-03 19:18:06
cd1cdfcce54d4c0e06aed61b214c383edcae4b02...e2ee0675ee7f97d2ed92d85ea514ebaef1d498d7,7,35,19,54,18,2014-03-03 21:54:35,2014-03-03 21:54:28
e2ee0675ee7f97d2ed92d85ea514ebaef1d498d7...cce595e3b3777610251a7c181ebba3cd907dac67,1,1,1,2,1,2014-03-04 03:38:34,2014-03-01 23:14:03
cce595e3b3777610251a7c181ebba3cd907dac67...32815d889ba6dd805cb520b2d8263ca7faf243bb,1,1,4,5,1,2014-03-04 03:38:50,2014-02-28 19:42:32
32815d889ba6dd805cb520b2d8263ca7faf243bb...9fae141a1f3fe652fa6002e47722c5ceb051cffb,3,23,1,24,6,2014-03-04 03:48:23,2014-03-04 00:27:40
9fae141a1f3fe652fa6002e47722c5ceb051cffb...3660343e0b4627d2fee4afb89b74d32644d16d18,300,578,766,1344,189,2014-03-04 03:54:10,2014-02-19 17:45:53
3660343e0b4627d2fee4afb89b74d32644d16d18...93d8befdbac74fb965faa4d3a8ae3e60d5a7a5b9,287,11572,0,11572,287,2014-03-04 03:54:14,2014-03-03 22:15:39
93d8befdbac74fb965faa4d3a8ae3e60d5a7a5b9...9a45a1f363cec95aa4e490cdd1261cf34226a003,6,76,438,514,21,2014-03-04 15:57:42,2014-02-07 19:36:30
9a45a1f363cec95aa4e490cdd1261cf34226a003...c9794d1885cf1e847b9543912287acc41909dfab,2,7,0,7,2,2014-03-04 16:15:28,2014-03-04 16:11:52
c9794d1885cf1e847b9543912287acc41909dfab...295e4ae32d0b0ab80247ae98eb5adf16899a4513,1,1,1,2,1,2014-03-04 16:15:29,2014-03-04 16:15:24
295e4ae32d0b0ab80247ae98eb5adf16899a4513...be24805004705e204a7640143f05bef408f6b210,2,12,10,22,2,2014-03-04 16:31:08,2014-03-03 19:14:00
be24805004705e204a7640143f05bef408f6b210...db0c430fe28d4f82e9b7b6fff41037d4d24c73a3,1,3,6,9,2,2014-03-04 20:34:58,2014-02-28 14:48:20
db0c430fe28d4f82e9b7b6fff41037d4d24c73a3...f937093d1817c50ddc2752b08929a9acfe8e6e29,1,0,3,3,1,2014-03-04 20:56:25,2014-03-04 16:34:59
f937093d1817c50ddc2752b08929a9acfe8e6e29...808c522cc32b9e4e8005fcd526dc3fe9bd6cf4d6,1,0,98,98,1,2014-03-04 21:12:56,2014-03-04 19:56:59
808c522cc32b9e4e8005fcd526dc3fe9bd6cf4d6...8298b133ed0bf6bebdac9141f5218785ccd14a66,5,44,42,86,14,2014-03-04 21:23:13,2014-03-04 18:00:11
8298b133ed0bf6bebdac9141f5218785ccd14a66...ba5c7343e5800b7b84a07a7c69ada22821342efd,5,13,13,26,13,2014-03-04 21:23:23,2014-03-04 18:08:57
ba5c7343e5800b7b84a07a7c69ada22821342efd...db6f4c6227581996ecba987be21912ed0824592c,1,18,6,24,5,2014-03-04 21:55:50,2014-02-21 22:40:46
db6f4c6227581996ecba987be21912ed0824592c...33912523e40467e1a41bed60ed7e198200a040ad,3,278,16,294,11,2014-03-04 22:20:59,2014-03-03 17:10:51
33912523e40467e1a41bed60ed7e198200a040ad...8470a1f87658277856a5a5be1a5e2bc34bc50cec,3,21,3,24,4,2014-03-04 22:47:20,2014-03-03 20:24:02
8470a1f87658277856a5a5be1a5e2bc34bc50cec...aa02cde1baf6bdb7840ac007f0a5603026409b9e,2,100,20,120,16,2014-03-05 03:29:56,2014-03-04 15:45:51
aa02cde1baf6bdb7840ac007f0a5603026409b9e...52fbcfdd6d40b5d53210a11fa3e2596a34c84fe7,1,6,18,24,5,2014-03-05 13:42:18,2014-03-05 13:40:57
52fbcfdd6d40b5d53210a11fa3e2596a34c84fe7...a2ebcca174d9df0c1454119057911ef7eddfd0ec,3,50,4,54,6,2014-03-05 13:42:18,2014-02-27 01:22:07
a2ebcca174d9df0c1454119057911ef7eddfd0ec...1655fff18e64179ef4e36565f25b6c06e6b453a9,2,57,0,57,3,2014-03-05 14:13:55,2014-03-03 20:53:27
1655fff18e64179ef4e36565f25b6c06e6b453a9...34bd3d0dd8e9c341a2f5f228cde741771af7ed25,7,199,88,287,54,2014-03-05 14:13:55,2014-03-03 21:17:29
34bd3d0dd8e9c341a2f5f228cde741771af7ed25...91886492a3a107102234e183d6d937e19e54e6c1,3,11,0,11,3,2014-03-05 14:17:28,2014-03-05 03:53:26
91886492a3a107102234e183d6d937e19e54e6c1...37abe9e1814e5c6ab9c18970690b157dc13e9ede,2,62,10,72,7,2014-03-05 15:12:57,2014-03-04 19:49:06
37abe9e1814e5c6ab9c18970690b157dc13e9ede...1d84c429f7a4d524a052e547c39d4589c386c2db,1,74,65,139,26,2014-03-05 11:28:07,2014-03-03 17:43:58
1d84c429f7a4d524a052e547c39d4589c386c2db...f2fac91080bf8eb8336044f889bbd82e2e661675,1,11,0,11,3,2014-03-05 11:28:07,2014-03-04 18:00:25
f2fac91080bf8eb8336044f889bbd82e2e661675...5a44d3b3913f27180c04fa072a1db57ad1a09d9d,13,815,95,910,36,2014-03-05 17:08:07,2014-02-14 21:37:37
5a44d3b3913f27180c04fa072a1db57ad1a09d9d...0ee6886263937f9ed0e9d74fa8753cac02a18617,2,39,28,67,11,2014-03-05 17:08:07,2014-02-27 08:07:54
0ee6886263937f9ed0e9d74fa8753cac02a18617...8e32f95f00f4527d31c7fdd0f4e96ee28efc5a08,1,7,4,11,5,2014-03-05 17:08:07,2014-03-04 20:48:37
8e32f95f00f4527d31c7fdd0f4e96ee28efc5a08...b924044bebc7c7b76eee513473adade189bf3ccd,7,7,7,14,7,2014-03-05 20:01:35,2014-03-05 19:56:30
b924044bebc7c7b76eee513473adade189bf3ccd...8d43b5cb9949c16452cb8d949c89d94cab9c8bad,1,7,0,7,3,2014-03-05 22:34:28,2014-03-05 22:22:49
8d43b5cb9949c16452cb8d949c89d94cab9c8bad...2fd0e517b11126e69c00be427aee17e9265bcacc,2,2,2,4,2,2014-03-06 17:06:49,2014-03-06 17:06:49
2fd0e517b11126e69c00be427aee17e9265bcacc...d1dc7cf2b213d77103658ccd2ea4816b33a27f6a,3,42,39,81,19,2014-03-06 18:15:41,2014-03-05 18:26:42
d1dc7cf2b213d77103658ccd2ea4816b33a27f6a...7700d67c74e66dcea25de69051df23185461a4ec,2,22,1,23,2,2014-03-06 18:35:38,2014-03-04 21:48:12
7700d67c74e66dcea25de69051df23185461a4ec...0b575dc0ba7a71d22bc4661d76f857d7be8a22ec,2,44,6,50,2,2014-03-06 20:40:17,2014-03-05 23:00:17
0b575dc0ba7a71d22bc4661d76f857d7be8a22ec...8171071440b1944429056f4df4f32f135648a177,1,2,1,3,1,2014-03-06 20:48:37,2014-03-06 20:20:22
8171071440b1944429056f4df4f32f135648a177...3befa12b80bc656e72cd80669ceb5e799ba762ff,1,5,1,6,1,2014-03-06 20:48:37,2014-03-05 17:10:17
3befa12b80bc656e72cd80669ceb5e799ba762ff...d8eb19991b01f9fc5e73f0a3acd3f8a59e2d7c7d,2,4,4,8,2,2014-03-06 22:19:19,2014-03-05 20:21:19
d8eb19991b01f9fc5e73f0a3acd3f8a59e2d7c7d...f6c94b9b45cc200addd2ac98afcb1cde77a03dc5,1,1,1,2,1,2014-03-06 23:41:25,2014-03-06 23:41:10
f6c94b9b45cc200addd2ac98afcb1cde77a03dc5...3ac69b3f5337e5e6f0cd36cc71173d07e74fa281,4,48,16,64,15,2014-03-07 00:49:30,2014-03-05 19:14:03
3ac69b3f5337e5e6f0cd36cc71173d07e74fa281...884543f695fabd1946491b8b6b612e1a7d5d2edd,1,1,1,2,1,2014-03-07 01:18:12,2014-03-06 15:23:47
884543f695fabd1946491b8b6b612e1a7d5d2edd...3b7a5187d788daa0544fb967e48653398054ed22,2,12,0,12,2,2014-03-07 01:20:06,2014-03-05 15:38:16
3b7a5187d788daa0544fb967e48653398054ed22...b6b2fdf5c26db35a7553e8069816dc7c8d2c0a5b,4,11,9,20,5,2014-03-07 01:20:06,2014-03-05 04:11:09
b6b2fdf5c26db35a7553e8069816dc7c8d2c0a5b...8d72b72643249914a47df0dd95898f1916972620,5,91,6,97,10,2014-03-07 01:20:06,2014-03-05 15:40:16
8d72b72643249914a47df0dd95898f1916972620...1f5e07c9800532d623f1a4e5abed21744e8719d5,3,19,11,30,6,2014-03-07 01:20:06,2014-03-05 17:11:08
1f5e07c9800532d623f1a4e5abed21744e8719d5...18b7f9c5f43556ecde34883ee046bdde16f0cd1c,6,50,16,66,16,2014-03-07 01:22:46,2014-03-06 17:01:35
18b7f9c5f43556ecde34883ee046bdde16f0cd1c...0e63bed927440d1531e0a2e26cf5cb79d6b52138,1,2,2,4,2,2014-03-07 15:11:32,2014-03-07 00:33:56
0e63bed927440d1531e0a2e26cf5cb79d6b52138...765409253203229a2c3577d1d8a3964f7a0d1554,2,63,0,63,3,2014-03-07 17:26:44,2014-03-07 00:24:59
765409253203229a2c3577d1d8a3964f7a0d1554...20a22bdf907a0e2cd60b79f242a7375d84a3ab6a,19,152,103,255,78,2014-03-07 22:08:01,2014-03-05 15:22:05
20a22bdf907a0e2cd60b79f242a7375d84a3ab6a...a1977962b7a1fccdd60d31ab3c27bb51bd3d6156,2,15,2,17,3,2014-03-07 22:49:00,2014-03-06 22:44:29
a1977962b7a1fccdd60d31ab3c27bb51bd3d6156...7240d05b07aebe766a9490a31459c6112620a6f6,1,2,2,4,1,2014-03-07 22:49:00,2014-03-07 18:41:03
7240d05b07aebe766a9490a31459c6112620a6f6...0a5193f04847dd5d1b449cff26bf91e308020785,2,127,0,127,2,2014-03-09 15:25:08,2014-03-07 22:59:15
0a5193f04847dd5d1b449cff26bf91e308020785...0f83758b8547f7c5aed49aa8a8558fe1c3c8b36b,3,25,24,49,13,2014-03-10 11:39:35,2014-03-05 16:40:18
0f83758b8547f7c5aed49aa8a8558fe1c3c8b36b...11bc3258feeb48642744c5a948c9879f9a5498d3,1,2,0,2,1,2014-03-10 11:39:35,2014-03-05 20:55:00
11bc3258feeb48642744c5a948c9879f9a5498d3...00f7aeaa25f98de5e66f0759d5b102951a247526,1,11,0,11,2,2014-03-10 11:39:35,2014-03-05 20:51:04
00f7aeaa25f98de5e66f0759d5b102951a247526...8b73e5c944903f2ec4c1ae62f0118759e1119da3,1,1,0,1,1,2014-03-10 11:39:35,2014-03-06 19:37:01
8b73e5c944903f2ec4c1ae62f0118759e1119da3...2a161f7e565bc8706bb311f4d68a1783f3d7141e,1,24,3,27,2,2014-03-10 16:08:04,2014-03-10 16:06:07
2a161f7e565bc8706bb311f4d68a1783f3d7141e...1beb3d92996d658e5612aec1b68fbcbe7e7ac4a9,1,21,1,22,2,2014-03-10 18:14:40,2014-03-08 03:04:14
1beb3d92996d658e5612aec1b68fbcbe7e7ac4a9...6311297efc74ee70ff2b01af5ebb25537587f9cf,3,11,9,20,3,2014-03-10 18:25:33,2014-03-04 19:24:16
6311297efc74ee70ff2b01af5ebb25537587f9cf...cc421d9723c67f0afa3efacc7ff4c766aceea332,1,4,3,7,1,2014-03-10 18:26:13,2014-03-10 16:00:59
cc421d9723c67f0afa3efacc7ff4c766aceea332...629de3b0f493ad7517b2aecd6ec616df015f53dc,1,7,0,7,1,2014-03-10 18:29:32,2014-03-07 20:22:54
629de3b0f493ad7517b2aecd6ec616df015f53dc...25596dbf48b18a76d3d2cdfdf1fcf23a43e46316,5,222,16,238,23,2014-03-10 20:02:02,2014-03-05 21:54:14
25596dbf48b18a76d3d2cdfdf1fcf23a43e46316...410fb275704f7743cb0902baf85a5c6058fca25b,1,27,6,33,6,2014-03-11 06:11:41,2014-03-11 06:10:10
410fb275704f7743cb0902baf85a5c6058fca25b...3c3c9152aa79e2a94b98eed00de8deeeeaad85c1,1,7,9,16,3,2014-03-11 13:20:46,2014-03-11 13:20:46
3c3c9152aa79e2a94b98eed00de8deeeeaad85c1...8ff46a852e18f41161a0061d3dd810fd2468d535,1,66,19,85,10,2014-03-11 15:49:49,2014-02-21 22:40:46
8ff46a852e18f41161a0061d3dd810fd2468d535...6816eddd30a0015f1eadb1bb48dff2f10cac187c,2,265,61,326,6,2014-03-11 15:49:49,2014-03-06 21:37:01
6816eddd30a0015f1eadb1bb48dff2f10cac187c...f2b8b2dd800e89ce2fa0eb14e893c650734d6f24,1,22,13,35,3,2014-03-11 16:06:28,2014-03-10 18:02:57
f2b8b2dd800e89ce2fa0eb14e893c650734d6f24...1ae45d8a71fa3948cd167e5c555e89627e8486c9,1,1,1,2,1,2014-03-11 16:06:28,2014-03-10 18:09:29
1ae45d8a71fa3948cd167e5c555e89627e8486c9...2ae43f11c9b4484c9a5c05bc4fdc90cf85697952,1,3,1,4,3,2014-03-11 16:06:28,2014-03-10 18:46:02
2ae43f11c9b4484c9a5c05bc4fdc90cf85697952...2109d8c1bd1e01df5e406b7c80118b62012af090,2,98,69,167,27,2014-03-11 16:06:28,2014-03-10 20:23:03
2109d8c1bd1e01df5e406b7c80118b62012af090...868749b831b1867c2993e979ce044895ee3177cc,1,2,2,4,2,2014-03-11 16:06:28,2014-03-11 15:17:08
868749b831b1867c2993e979ce044895ee3177cc...575c9cbe27ba6b9ba56b810e42508d120ae44a94,1,0,1,1,1,2014-03-11 16:06:28,2014-03-11 16:05:28
575c9cbe27ba6b9ba56b810e42508d120ae44a94...097f38faf2856f7776c75a48d985b6b3f1641860,4,85,21,106,19,2014-03-11 18:45:15,2014-03-11 15:30:31
097f38faf2856f7776c75a48d985b6b3f1641860...9aca47bec991f1ad679cfcf27eb037055886a25a,2,11,6,17,2,2014-03-11 20:20:16,2014-03-10 15:09:39
9aca47bec991f1ad679cfcf27eb037055886a25a...1ff73551566e30e1a2ca786115b5824bfeff188a,5,70,24,94,23,2014-03-11 20:25:14,2014-03-10 18:04:05
1ff73551566e30e1a2ca786115b5824bfeff188a...63ec93b3ee18c9c16f8adde07d0e8243911a7108,1,1,1,2,1,2014-03-11 21:24:06,2014-03-11 20:02:35
63ec93b3ee18c9c16f8adde07d0e8243911a7108...057a542daf11a62c1f57b3b406cb8fd33804a831,12,162,66,228,43,2014-03-11 21:47:58,2014-03-11 19:53:55
057a542daf11a62c1f57b3b406cb8fd33804a831...79624f53393bc94cff490153f6bc6939ccd076c8,3,173,41,214,8,2014-03-12 14:03:55,2014-03-11 14:41:47
79624f53393bc94cff490153f6bc6939ccd076c8...b28a5a869a0e02d73e25cd39c15adf86c383f319,1,43,11,54,7,2014-03-12 14:03:55,2014-03-11 10:02:10
b28a5a869a0e02d73e25cd39c15adf86c383f319...a58223aa670ddf841805ce7fa8520437d59dd02b,1,2,2,4,2,2014-03-12 09:23:12,2014-03-05 11:40:47
a58223aa670ddf841805ce7fa8520437d59dd02b...edb9bbc96ba5964be9a23a0617ec72ea277c2463,1,3,3,6,3,2014-03-12 09:23:12,2014-03-10 08:49:26
edb9bbc96ba5964be9a23a0617ec72ea277c2463...9c3e4354416d5fbc6c8f4a27cb0d7c6310a55914,1,3,2,5,1,2014-03-12 09:23:12,2014-03-10 09:16:51
9c3e4354416d5fbc6c8f4a27cb0d7c6310a55914...7d165159a265630e3059abdbfc1d09bf6c1fbe29,1,1,1,2,1,2014-03-12 09:23:12,2014-03-11 09:22:20
7d165159a265630e3059abdbfc1d09bf6c1fbe29...456febf80507a12085771b803c4d475484e726d9,1,5,3,8,4,2014-03-12 09:23:12,2014-03-11 09:31:08
456febf80507a12085771b803c4d475484e726d9...a950e940c6d2542d72cb4739c10b968270f6b8b5,1,8,4,12,2,2014-03-12 15:13:18,2014-03-11 21:29:33
a950e940c6d2542d72cb4739c10b968270f6b8b5...d751c80fe2e4a7922129c5ef47a53b29b9eea728,4,92,46,138,10,2014-03-12 15:47:49,2014-03-10 15:54:01
d751c80fe2e4a7922129c5ef47a53b29b9eea728...b0c31161d9fc58a18eaff398b48423b724b96a0e,3,56,8,64,8,2014-03-12 15:47:49,2014-03-10 20:10:21
b0c31161d9fc58a18eaff398b48423b724b96a0e...760c3976a86fe75e8c767625fb96af7b4e610a12,1,9,0,9,1,2014-03-12 15:47:49,2014-03-11 17:44:18
760c3976a86fe75e8c767625fb96af7b4e610a12...db2875aee372ea08ed7b6e6ad91494b2df29154f,1,52,21,73,13,2014-03-12 15:47:49,2014-03-11 19:56:19
db2875aee372ea08ed7b6e6ad91494b2df29154f...726c881816a14e359cb4c86057565ba20f133d6d,1,7,0,7,1,2014-03-12 17:03:21,2014-03-12 15:37:00
726c881816a14e359cb4c86057565ba20f133d6d...8981cd58e075605b505b3de0e57d2732e44989eb,2,14,12,26,2,2014-03-12 13:38:50,2014-03-11 13:15:58
8981cd58e075605b505b3de0e57d2732e44989eb...194e8253d1c8481d8b0b9f1486f83682ca05de8e,1,4,4,8,3,2014-03-12 13:38:50,2014-03-11 13:39:27
194e8253d1c8481d8b0b9f1486f83682ca05de8e...9bea47352928c4734e2e12318694d2389052e055,1,4,4,8,3,2014-03-12 13:38:50,2014-03-12 11:02:41
9bea47352928c4734e2e12318694d2389052e055...eadeef174f9e7df1a94c7db06b80277fb60efd25,1,18,6,24,4,2014-03-12 18:42:32,2014-03-12 17:40:45
eadeef174f9e7df1a94c7db06b80277fb60efd25...4ddba591cf7defc9aca5e9cab526e9c9a8941a95,4,23,13,36,6,2014-03-12 18:43:59,2014-03-10 22:04:36
4ddba591cf7defc9aca5e9cab526e9c9a8941a95...4b96cf10a83f1d34eb7264d0e42c343eae0da60b,7,450,169,619,27,2014-03-12 18:43:59,2014-03-07 22:35:36
4b96cf10a83f1d34eb7264d0e42c343eae0da60b...27afe048247d1ca3d32858bd9047fc92e97efea8,1,1,0,1,1,2014-03-12 18:53:30,2014-03-12 18:13:36
27afe048247d1ca3d32858bd9047fc92e97efea8...1da2d21ffe90db991715127bd4140bcc83abb98b,1,2,2,4,2,2014-03-12 20:32:57,2014-03-12 20:32:57
1da2d21ffe90db991715127bd4140bcc83abb98b...e972301dfc613bd7095a35024823f9d82a9fed37,7,100,84,184,36,2014-03-12 22:17:05,2014-03-11 19:37:50
e972301dfc613bd7095a35024823f9d82a9fed37...45f2cf47ea042c573995854a095f791c342d3307,5,18,14,32,13,2014-03-13 02:43:15,2014-03-12 20:19:01
45f2cf47ea042c573995854a095f791c342d3307...8043d3465f0b516fc3e890b2da528b7bac94201a,1,6,1,7,3,2014-03-13 02:43:27,2014-03-13 02:37:43
8043d3465f0b516fc3e890b2da528b7bac94201a...c59b877cb901fea2882dc62e6ec7ac85d5c96b46,1,2,1,3,1,2014-03-13 04:50:54,2014-03-13 04:43:04
c59b877cb901fea2882dc62e6ec7ac85d5c96b46...d66bf3e0a6d28d0cb7ad9cc485237a67b37e008e,8,124,2,126,11,2014-03-13 04:50:55,2014-03-13 04:46:39
d66bf3e0a6d28d0cb7ad9cc485237a67b37e008e...dad98f8d0e6b4ecc546110d00049f0adf52ffb81,1,2,2,4,2,2014-03-13 13:29:55,2014-03-13 13:28:55
dad98f8d0e6b4ecc546110d00049f0adf52ffb81...fa53389976b4b4871c53b3212765406f8eb0d0c0,2,19,13,32,12,2014-03-13 14:33:22,2014-03-12 23:20:54
fa53389976b4b4871c53b3212765406f8eb0d0c0...4233257f59e59b09579eac705e312fb0096a0b1e,1,10,6,16,3,2014-03-13 14:33:44,2014-03-12 16:10:32
4233257f59e59b09579eac705e312fb0096a0b1e...f4d08212ef92ed07f1a72b59f0b3b781db55810a,2,76,0,76,3,2014-03-13 14:44:57,2014-03-12 21:13:24
f4d08212ef92ed07f1a72b59f0b3b781db55810a...32085c5e4a59710b30bfdd7e335db2a374d15b13,1,1,0,1,1,2014-03-13 15:06:00,2014-03-13 14:50:08
32085c5e4a59710b30bfdd7e335db2a374d15b13...09acefaf1e0e79813ebe9b594a78b148a1ffb6dd,4,95,14,109,11,2014-03-13 15:11:56,2014-03-12 17:41:48
09acefaf1e0e79813ebe9b594a78b148a1ffb6dd...4cde62902c7a96a2bc60fab3fbe46c6c93baa59f,1,2,5,7,4,2014-03-13 15:38:30,2014-03-06 20:01:06
4cde62902c7a96a2bc60fab3fbe46c6c93baa59f...a5802c94f11a30b8b1736e68c57efc4d8077f860,1,14,5,19,4,2014-03-13 15:38:42,2014-03-10 18:53:21
a5802c94f11a30b8b1736e68c57efc4d8077f860...d1fa029106e01f1762e96af3d85183d849eb1d88,1,1,1,2,1,2014-03-13 15:51:53,2014-03-12 22:02:51
d1fa029106e01f1762e96af3d85183d849eb1d88...858f12a88f949ac8bc0ad009c2ce6a2c8558508a,1,9,5,14,4,2014-03-13 16:42:21,2014-03-11 20:10:42
858f12a88f949ac8bc0ad009c2ce6a2c8558508a...3956365fccb2ba7e4a622b848ce69a9aa4c8b273,2,212,187,399,25,2014-03-13 17:19:54,2014-03-13 17:17:22
3956365fccb2ba7e4a622b848ce69a9aa4c8b273...d878b59856c44e715185b03bba8fbe1bcd1c9f57,28,98,105,203,67,2014-03-13 20:04:50,2014-03-12 15:50:31
d878b59856c44e715185b03bba8fbe1bcd1c9f57...a53a7eec0594f065923a495a695cb5dde6679468,1,7,10,17,6,2014-03-13 20:58:22,2014-03-13 18:50:23
a53a7eec0594f065923a495a695cb5dde6679468...5bd9fa125cf91df4d9ec00eeb5e92cbcbf5db58e,8,15,19,34,13,2014-03-13 21:01:06,2014-03-11 18:38:27
5bd9fa125cf91df4d9ec00eeb5e92cbcbf5db58e...88d3c3f494f6e946ebccda82035b85d160ee0550,1,7,0,7,1,2014-03-13 21:54:41,2014-03-13 19:44:09
88d3c3f494f6e946ebccda82035b85d160ee0550...0716e47f14526def38c4190e91dde6a1d516a81b,1,4,8,12,4,2014-03-14 13:54:59,2014-03-13 20:50:24
0716e47f14526def38c4190e91dde6a1d516a81b...ad04c8caf4600b7a3bba3cc524bbbab7d7e5b02e,2,8,3,11,4,2014-03-14 13:55:00,2014-03-14 13:42:52
ad04c8caf4600b7a3bba3cc524bbbab7d7e5b02e...3b7aae27fef10e3359ea6164164e827ff5407c61,9,280,82,362,39,2014-03-14 14:36:41,2014-03-05 17:22:58
3b7aae27fef10e3359ea6164164e827ff5407c61...8c92b5ae5891b171bbdffee0b62d2135eb89bba9,42,359,393,752,188,2014-03-14 16:06:02,2014-03-03 16:27:18
8c92b5ae5891b171bbdffee0b62d2135eb89bba9...a4ad235adc26559819be5e8098d8867003930dc4,1,0,1,1,1,2014-03-14 17:17:57,2014-03-13 21:24:16
a4ad235adc26559819be5e8098d8867003930dc4...c6dad5a441265a1a6f7c93d115aec316ccff98ea,1,3,3,6,2,2014-03-14 17:45:57,2014-03-14 17:35:26
c6dad5a441265a1a6f7c93d115aec316ccff98ea...8cc495d5e099d3e32da0ed2fea6c6a4deaae6773,3,6,1,7,3,2014-03-14 18:57:11,2014-03-14 18:27:20
8cc495d5e099d3e32da0ed2fea6c6a4deaae6773...355010463819103cd4475079260ed9aae392354c,1,27,0,27,1,2014-03-14 19:43:53,2014-03-14 18:42:57
355010463819103cd4475079260ed9aae392354c...34559b85ba96d241392e25ea76f3f00c130e3f2b,1,11,1,12,1,2014-03-14 20:53:57,2014-03-14 17:03:45
34559b85ba96d241392e25ea76f3f00c130e3f2b...d2f973185de6c5cc5f583829f68fc7b66a3362cf,4,13,13,26,17,2014-03-14 21:50:08,2014-03-14 21:27:03
d2f973185de6c5cc5f583829f68fc7b66a3362cf...d2e6240d6b0ef80f4b692cd69b50f0e68aefbade,1,1,1,2,1,2014-03-14 22:07:10,2014-03-14 20:13:04
d2e6240d6b0ef80f4b692cd69b50f0e68aefbade...78f486cdc7cf46f948030138ce1c741988a5f842,1,10,12,22,7,2014-03-15 18:27:11,2014-03-14 21:40:15
78f486cdc7cf46f948030138ce1c741988a5f842...c81d07b9b2fc3b0996d01cdf7b8a6bb6069d89dd,2,2,2,4,2,2014-03-15 18:48:38,2014-03-15 16:05:46
c81d07b9b2fc3b0996d01cdf7b8a6bb6069d89dd...dc11b6e852acda8a1ebf5c56f5740c5e979650bf,5,68,6,74,13,2014-03-15 18:48:58,2014-03-15 15:59:28
dc11b6e852acda8a1ebf5c56f5740c5e979650bf...0dab427a0530aa6d423a8b745a800765c05494b5,4,134,13,147,11,2014-03-15 21:26:20,2014-03-15 19:50:02
0dab427a0530aa6d423a8b745a800765c05494b5...b5e634f8835b348319ad1fd889025ca2a21adcf9,1,2,1,3,1,2014-03-15 23:11:26,2014-03-15 23:10:12
b5e634f8835b348319ad1fd889025ca2a21adcf9...41f534dc96def169c9a870f10ef38e8c39feb638,12,1303,537,1840,234,2014-03-16 23:10:31,2014-03-14 14:04:49
41f534dc96def169c9a870f10ef38e8c39feb638...ff6d29cbf6cfde219afd5d5725eedf70cd7f834e,1,0,1,1,1,2014-03-17 08:01:51,2014-03-14 14:30:30
ff6d29cbf6cfde219afd5d5725eedf70cd7f834e...9c6fcdd2777b25ecd1a85c92704bf65bb5ca0c7c,4,40,22,62,9,2014-03-17 14:03:26,2014-03-14 15:59:18
9c6fcdd2777b25ecd1a85c92704bf65bb5ca0c7c...0de7cca4a1bca092d33c8be6456f505c0ffd6791,1,3,1,4,3,2014-03-17 14:36:19,2014-03-17 14:34:36
0de7cca4a1bca092d33c8be6456f505c0ffd6791...1c177bb5d91bcd763e6a5f9c12656a05aa95a140,1,18,4,22,1,2014-03-17 15:15:01,2014-03-14 19:14:20
1c177bb5d91bcd763e6a5f9c12656a05aa95a140...9f437614f40f07d627f2e2a16bdba08a7e12f890,3,106,27,133,24,2014-03-17 16:04:28,2014-03-13 18:13:35
9f437614f40f07d627f2e2a16bdba08a7e12f890...3319a45ff5c36510ca9c0d6fc992c370483d4017,2,2,0,2,2,2014-03-17 18:19:09,2014-03-17 15:55:48
3319a45ff5c36510ca9c0d6fc992c370483d4017...3e88add23c394764cd04c016aeb61a2907f4b604,1,7,3,10,6,2014-03-17 20:14:35,2014-03-17 18:18:40
3e88add23c394764cd04c016aeb61a2907f4b604...8d3be24f178c512d68d7dfc90cf494455a002c55,6,101,77,178,11,2014-03-17 20:53:50,2014-03-17 16:09:16
8d3be24f178c512d68d7dfc90cf494455a002c55...7e2f84ae565d5cb7136f0db0fadf42ff4259f280,3,22,4,26,4,2014-03-17 20:53:55,2014-03-17 18:37:57
7e2f84ae565d5cb7136f0db0fadf42ff4259f280...c78bdafae31dd77288fbe7366eb522f7cc8ab427,1,0,16,16,2,2014-03-17 21:32:41,2014-03-17 21:32:05
c78bdafae31dd77288fbe7366eb522f7cc8ab427...c17ce85e7bcb3ad078212a298298751e2b3b2d7b,1,1,1,2,1,2014-03-17 21:58:03,2014-03-17 20:57:51
c17ce85e7bcb3ad078212a298298751e2b3b2d7b...3603a62092e6b15c0ec81fe45eddec3958fa59dc,1,2,1,3,2,2014-03-17 22:13:46,2014-03-17 20:29:02
3603a62092e6b15c0ec81fe45eddec3958fa59dc...f72cfb449a8c10fea4e43f615893aff42852ca8f,2,4,3,7,4,2014-03-17 22:13:59,2014-03-17 20:40:26
f72cfb449a8c10fea4e43f615893aff42852ca8f...224c373b84d209bc70a8eafdd6015d174d9776ef,1,5,2,7,4,2014-03-17 22:38:02,2014-03-12 18:13:43
224c373b84d209bc70a8eafdd6015d174d9776ef...e08a0f09d064c9a5bb6212e89b04cef7b94ac073,3,8,4,12,6,2014-03-17 22:38:03,2014-03-12 19:14:18
e08a0f09d064c9a5bb6212e89b04cef7b94ac073...0838167a2769daf211677afcb3bd577f8b99ffd7,3,14,5,19,7,2014-03-17 22:38:03,2014-03-12 19:56:11
0838167a2769daf211677afcb3bd577f8b99ffd7...5109563d5e35a25e246248c761adfaa0e929f2bc,3,9,8,17,9,2014-03-17 22:38:04,2014-03-13 19:11:43
5109563d5e35a25e246248c761adfaa0e929f2bc...77fb13bbcec0335469af0a2fbdeb0d7dd7f687c7,1,13,2,15,4,2014-03-17 22:38:05,2014-03-17 15:53:07
77fb13bbcec0335469af0a2fbdeb0d7dd7f687c7...7226cdfa5199d4d77171cb274a5ff142a93dfc2c,1,1,1,2,1,2014-03-17 22:38:13,2014-03-17 22:32:17
7226cdfa5199d4d77171cb274a5ff142a93dfc2c...d1e423807afe060499c44c44863a59c764a4bc9d,1,2,13,15,4,2014-03-18 00:52:52,2014-03-18 00:17:02
d1e423807afe060499c44c44863a59c764a4bc9d...63861f53c4e12fdd3efbcde57e6a1c8d12e675c0,1,1,1,2,1,2014-03-18 12:55:39,2014-03-18 12:53:11
63861f53c4e12fdd3efbcde57e6a1c8d12e675c0...0de6511419aee109f2fb997e14b596f6295c90a8,4,23,6,29,9,2014-03-18 17:42:17,2014-03-18 05:05:56
0de6511419aee109f2fb997e14b596f6295c90a8...975cff4802c9042a736c142233b38312c2cd3a81,4,38,1,39,5,2014-03-18 17:42:17,2014-03-18 15:12:09
975cff4802c9042a736c142233b38312c2cd3a81...f0cc6f2fdb628d5c9779d9fa77c44137ddda7d86,2,0,66,66,2,2014-03-18 18:07:56,2014-03-18 18:00:20
f0cc6f2fdb628d5c9779d9fa77c44137ddda7d86...8034a8d6a1d7158739d66f9c6d0fa0893786f6c6,1,15,1,16,2,2014-03-18 18:10:50,2014-03-18 14:49:26
8034a8d6a1d7158739d66f9c6d0fa0893786f6c6...dfe3e9aaa5682b3e0bc6905e98a84cec03804ee1,1,1,0,1,1,2014-03-18 18:16:37,2014-03-17 21:14:23
dfe3e9aaa5682b3e0bc6905e98a84cec03804ee1...c5f6e32f2b2d4321700de302c05281f9290915fa,4,134,27,161,9,2014-03-18 13:53:32,2014-03-12 14:40:00
c5f6e32f2b2d4321700de302c05281f9290915fa...5fd8754e9b903bb51e7e6299a35c1c2416e898ff,1,77,0,77,1,2014-03-18 13:53:32,2014-03-14 16:54:18
5fd8754e9b903bb51e7e6299a35c1c2416e898ff...510e2dda4e8e2e229adb9aec5f077050ebfae1da,1,1,1,2,1,2014-03-18 13:53:32,2014-03-18 13:48:47
510e2dda4e8e2e229adb9aec5f077050ebfae1da...43be3d5a87c70a82a36f4116b733d35a514564ae,33,521,339,860,144,2014-03-18 19:26:54,2014-03-14 19:21:49
43be3d5a87c70a82a36f4116b733d35a514564ae...dd73cdcea6fcea561f79728a5c9ce0e4acfa6c7c,1,10,1,11,3,2014-03-18 19:35:23,2014-03-18 14:32:04
dd73cdcea6fcea561f79728a5c9ce0e4acfa6c7c...3e62600166ba6207295f6dbc5348c4b6043c7ffa,1,4,0,4,4,2014-03-18 20:52:26,2014-03-18 20:42:03
3e62600166ba6207295f6dbc5348c4b6043c7ffa...72e9bea86f89097fb65b9d392230235069302e96,3,6,6,12,6,2014-03-18 21:19:24,2014-03-17 16:13:25
72e9bea86f89097fb65b9d392230235069302e96...7497c50db07a987530e1f80cf0930b85494ec20d,1,6,2,8,2,2014-03-18 16:20:17,2014-03-17 20:53:32
7497c50db07a987530e1f80cf0930b85494ec20d...36c6964edd8ac40a335ad24b5d95ec02b603d7dd,14,830,141,971,46,2014-03-18 21:53:39,2014-03-15 20:55:41
36c6964edd8ac40a335ad24b5d95ec02b603d7dd...05aa222eb586991d10858dbad66365cfffe5201a,2,14,0,14,3,2014-03-19 13:55:52,2014-03-18 20:12:19
05aa222eb586991d10858dbad66365cfffe5201a...05bd38351d4624b269a16968df7521896776f73e,1,2,2,4,1,2014-03-19 14:00:56,2014-03-19 13:58:57
05bd38351d4624b269a16968df7521896776f73e...b92555698feda1c0dd766abec94dd0cd059eaed3,14,3541,2202,5743,595,2014-03-19 14:06:17,2014-02-28 16:16:26
b92555698feda1c0dd766abec94dd0cd059eaed3...094f1565d6f82859bc38300b45564dd1ea9f070e,2,36,23,59,10,2014-03-19 14:48:23,2014-03-19 13:27:10
094f1565d6f82859bc38300b45564dd1ea9f070e...286b6ba87ee9f6e26ccbf3586e36e3329ea06f53,1,1,1,2,1,2014-03-19 16:13:14,2014-03-19 16:12:31
286b6ba87ee9f6e26ccbf3586e36e3329ea06f53...99cd103ecfcaefbf01ccf9b080924e4ca52fd44c,1,1,1,2,1,2014-03-19 12:53:44,2014-03-18 11:56:37
99cd103ecfcaefbf01ccf9b080924e4ca52fd44c...8492832436f2a4cb1ffc621a0e982d262c97d6f3,1,4,2,6,5,2014-03-19 18:51:07,2014-03-19 18:44:27
8492832436f2a4cb1ffc621a0e982d262c97d6f3...0147b057c2d01fc6cd418af09fbee278a877baf1,1,4,4,8,4,2014-03-19 19:25:20,2014-03-14 22:58:12
0147b057c2d01fc6cd418af09fbee278a877baf1...5a1f1f28666f546bcaf3ef8e77423afbacd9533f,1,1,1,2,1,2014-03-19 19:29:11,2014-03-19 17:29:54
5a1f1f28666f546bcaf3ef8e77423afbacd9533f...b4a5812a05215957876fa2249a298988a44fa0e1,1,1,1,2,1,2014-03-19 19:30:57,2014-03-19 19:28:17
b4a5812a05215957876fa2249a298988a44fa0e1...d465ba1e2ea58afb43d1bcb3752e2fac69535031,9,748,469,1217,87,2014-03-19 20:44:37,2014-03-17 22:09:24
d465ba1e2ea58afb43d1bcb3752e2fac69535031...2758187dd41024a8f93fddc7edfc223eccf4a1ce,3,347,343,690,56,2014-03-19 21:02:09,2014-03-13 17:37:23
2758187dd41024a8f93fddc7edfc223eccf4a1ce...11e8a1d1b7d58b710a8a6f59e507dafcec01f247,1,2,2,4,2,2014-03-19 21:04:11,2014-03-19 21:04:11
11e8a1d1b7d58b710a8a6f59e507dafcec01f247...21426b3b8109fafb7fae997021cbd0357c968111,2,19,9,28,6,2014-03-19 21:13:45,2014-03-19 20:40:49
21426b3b8109fafb7fae997021cbd0357c968111...f5623ce7ed697e734402a75c70950ee7308b6280,3,14,2,16,6,2014-03-19 21:25:31,2014-03-19 15:30:50
f5623ce7ed697e734402a75c70950ee7308b6280...670a13d965a5bf949e33309ef47b49a23326a59c,1,1,1,2,1,2014-03-19 22:13:51,2014-03-19 22:12:51
670a13d965a5bf949e33309ef47b49a23326a59c...1c5e4d72d290388f2d1cb7e60c9f1e63aa24893c,6,160,8,168,10,2014-03-19 23:04:23,2014-03-18 22:40:41
1c5e4d72d290388f2d1cb7e60c9f1e63aa24893c...2b2cf4a9b4812885613ada9fc322d8bd4f8f09d8,2,84,18,102,14,2014-03-20 13:22:24,2014-03-18 20:30:25
2b2cf4a9b4812885613ada9fc322d8bd4f8f09d8...d3b45e4327368e0a44634b9c5288d729e706975e,8,411,65,476,53,2014-03-20 15:07:25,2014-03-20 13:28:35
d3b45e4327368e0a44634b9c5288d729e706975e...c19b54dd42a05208f1da8c8e68bb795c470f2754,1,4,0,4,4,2014-03-20 15:26:33,2014-03-20 15:16:12
c19b54dd42a05208f1da8c8e68bb795c470f2754...6b5e42ed2fb2c2f246eeaa13c85a2f7118402aa4,1,7,5,12,4,2014-03-20 15:33:28,2014-03-20 15:29:32
6b5e42ed2fb2c2f246eeaa13c85a2f7118402aa4...4b1e555f6b0ffd027e4c54f3b7034a4b8fb4ec1e,1,5,0,5,1,2014-03-20 16:32:11,2014-03-20 16:31:28
4b1e555f6b0ffd027e4c54f3b7034a4b8fb4ec1e...b9da5eed52b63d721d78bf76d58b4b8a6b6b8703,2,9,3,12,3,2014-03-20 17:06:47,2014-03-20 13:41:30
b9da5eed52b63d721d78bf76d58b4b8a6b6b8703...50a0399775276be4adcff96755e71f016028a368,1,1,0,1,1,2014-03-20 12:21:44,2014-03-20 11:51:38
50a0399775276be4adcff96755e71f016028a368...8b99b7e8b7f99783e1fd76382dbda415340e95fc,3,52,15,67,15,2014-03-20 17:49:48,2014-03-19 21:16:18
8b99b7e8b7f99783e1fd76382dbda415340e95fc...06af0c0546c1ded643ece9daae60fcf7f2957d66,1,0,1,1,1,2014-03-20 19:32:45,2014-03-20 19:25:56
06af0c0546c1ded643ece9daae60fcf7f2957d66...69ec3ce065a4ef0695bd36a7da224717a5aea458,2,3,4,7,2,2014-03-20 23:52:35,2014-03-20 20:33:12
69ec3ce065a4ef0695bd36a7da224717a5aea458...8ff2e19762ee4646ec0218b85dc3a235ae703524,1,16,14,30,2,2014-03-21 14:22:35,2014-03-21 14:15:50
8ff2e19762ee4646ec0218b85dc3a235ae703524...586200c20f5bed4b3cf7184ba2e013d46bb4059d,16,201,704,905,75,2014-03-21 14:22:35,2014-03-21 14:17:20
586200c20f5bed4b3cf7184ba2e013d46bb4059d...1b6ec9b66097ddb9b7f766cc36aea86cd7a89561,2,7,0,7,2,2014-03-21 15:14:10,2014-03-20 19:35:00
1b6ec9b66097ddb9b7f766cc36aea86cd7a89561...092deb74634465c62f6d47ea3405233d84400e36,1,10,2,12,6,2014-03-21 15:49:01,2014-03-18 21:57:07
092deb74634465c62f6d47ea3405233d84400e36...76f298f24ebf2547d26174d80f78e89ded83ddd1,4,76,9,85,12,2014-03-21 15:48:21,2014-03-20 19:17:23
76f298f24ebf2547d26174d80f78e89ded83ddd1...52a9e923df6a67a5849e77c460079c0c57bfdfd0,1,4,3,7,2,2014-03-21 16:55:31,2014-03-21 16:54:57
52a9e923df6a67a5849e77c460079c0c57bfdfd0...0966b812bd884607768a521c46fe9e88c00b89fb,9,321,38,359,24,2014-03-21 16:57:54,2014-03-20 18:57:34
0966b812bd884607768a521c46fe9e88c00b89fb...d2716598fc73a359f88f10d3c691979d727f287b,7,7,7,14,7,2014-03-21 17:03:23,2014-03-21 17:03:23
d2716598fc73a359f88f10d3c691979d727f287b...d44539de6758237c8b6eaa57a59988fa5b6ef9ac,2,5,0,5,2,2014-03-21 18:01:08,2014-03-21 18:00:34
d44539de6758237c8b6eaa57a59988fa5b6ef9ac...602cc638b3cd0ef9f2737eef53879e21c454a527,2,2,2,4,2,2014-03-22 02:41:08,2014-03-22 02:41:08
602cc638b3cd0ef9f2737eef53879e21c454a527...444bb62c24786a65334f4be214d1154dde00c71b,3,27,6,33,8,2014-03-24 14:28:01,2014-03-21 18:01:44
444bb62c24786a65334f4be214d1154dde00c71b...0820546eef02eecdc44c986e5ca1cf0829dea32e,1,2,1,3,2,2014-03-24 18:56:21,2014-03-24 18:51:40
0820546eef02eecdc44c986e5ca1cf0829dea32e...96d25f6e3010da5ebc031f255df0cfc2680259c0,2,62,14,76,4,2014-03-24 19:19:14,2014-03-21 18:59:27
96d25f6e3010da5ebc031f255df0cfc2680259c0...258d46ecee93b79a81e5d6d506ded223c69aa30d,1,1,1,2,1,2014-03-24 21:59:23,2014-03-24 19:38:04
258d46ecee93b79a81e5d6d506ded223c69aa30d...1751a13cc601320eec2973f2e59b062268b2e4f5,1,2,1,3,1,2014-03-25 08:10:06,2014-03-24 13:01:44
1751a13cc601320eec2973f2e59b062268b2e4f5...112c32c0fd03b2479f125dcc0f974cf1a682b72c,2,10,1,11,2,2014-03-25 14:25:45,2014-03-25 00:53:48
112c32c0fd03b2479f125dcc0f974cf1a682b72c...f77427bddf29b2f07dcd2620abffa57b1f7c2655,1,1,9,10,4,2014-03-25 15:12:50,2014-03-25 00:16:59
f77427bddf29b2f07dcd2620abffa57b1f7c2655...df1e0d4ab07fb37889ea3a102f1228442d844fb9,1,4,0,4,1,2014-03-25 10:58:26,2014-03-25 08:59:46
df1e0d4ab07fb37889ea3a102f1228442d844fb9...886e1c281d67eada7793972953ac4ddb96ad15a2,2,0,169,169,2,2014-03-25 11:04:37,2014-03-21 13:35:02
886e1c281d67eada7793972953ac4ddb96ad15a2...174f9bea00a46cb4e301dcc0f4dcbaddd2ec21cb,14,312,259,571,25,2014-03-25 18:24:08,2014-03-25 15:09:37
174f9bea00a46cb4e301dcc0f4dcbaddd2ec21cb...10c2badf2e9c7a5b5ed8fe4fd61c719281f93ebb,3,3,3,6,3,2014-03-25 20:00:27,2014-03-19 15:48:00
10c2badf2e9c7a5b5ed8fe4fd61c719281f93ebb...1502899e7fe49f45f736d29e6f46c05349d53f1f,1,1,0,1,1,2014-03-25 21:13:40,2014-03-25 20:42:09
1502899e7fe49f45f736d29e6f46c05349d53f1f...2c324c51b079af4df7256df9fdfd313d355d2e8d,2,3,2,5,2,2014-03-25 21:46:36,2014-03-24 21:46:54
2c324c51b079af4df7256df9fdfd313d355d2e8d...7444a98bef3d51bb4b1e30ef7b438e18ee031046,751,31,31700,31731,751,2014-03-25 22:42:15,2014-03-25 19:29:54
7444a98bef3d51bb4b1e30ef7b438e18ee031046...8f5d4b3afe3bda25226776694136b01c0dcc3817,1,3,2,5,2,2014-03-26 15:18:37,2014-03-21 20:00:21
8f5d4b3afe3bda25226776694136b01c0dcc3817...51cd272bb6001d6403728dbd0dbdecf168811a19,1,5,1,6,1,2014-03-26 15:18:58,2014-03-21 19:34:08
51cd272bb6001d6403728dbd0dbdecf168811a19...007615e15991a43a0cc37f2ff4821d711a748dcd,2,4,3,7,4,2014-03-26 16:15:41,2014-03-26 15:08:45
007615e15991a43a0cc37f2ff4821d711a748dcd...b90627fb9894108e94eec133bd7dfb3073d7f7ae,1,1,1,2,1,2014-03-26 16:50:50,2014-03-26 16:40:51
b90627fb9894108e94eec133bd7dfb3073d7f7ae...30fe38c527fde598d625f9e81995fca99d5da82c,1,1,2,3,2,2014-03-26 18:02:44,2014-03-25 21:30:33
30fe38c527fde598d625f9e81995fca99d5da82c...63a0c2647ef05884fb5e8f8ce90a2949dbd7243e,2,35,0,35,2,2014-03-26 18:02:50,2014-03-25 20:32:14
63a0c2647ef05884fb5e8f8ce90a2949dbd7243e...2998dbfb20d2ff5fa425428b166be944a7dc3635,3,7,7,14,5,2014-03-26 18:06:48,2014-03-26 17:41:06
2998dbfb20d2ff5fa425428b166be944a7dc3635...376a9b28361bb55a7d2cbd2ebd30df39a7526098,1,5,2,7,2,2014-03-26 18:28:54,2014-03-18 21:08:59
376a9b28361bb55a7d2cbd2ebd30df39a7526098...6d3cacf2bd81f2d818cbf5809bda9adb0a64f536,13,132,220,352,84,2014-03-26 19:56:05,2014-03-14 15:43:25
6d3cacf2bd81f2d818cbf5809bda9adb0a64f536...7595193acb6a4d67e84a960ae4b45dd4743bd1aa,1,7,5,12,5,2014-03-26 19:58:49,2014-03-26 19:43:53
7595193acb6a4d67e84a960ae4b45dd4743bd1aa...98e464bc2a21ad4b706854ad640957060fa0fa6f,2,2,2,4,2,2014-03-26 20:38:29,2014-03-26 20:37:07
98e464bc2a21ad4b706854ad640957060fa0fa6f...9e94da386750daca4adb87e8a35f9477b734432f,2,16,1,17,4,2014-03-27 14:29:58,2014-03-27 14:08:51
9e94da386750daca4adb87e8a35f9477b734432f...af443fd3e70215434efc2ca1ef7272a0ab92c2af,2,9,3,12,4,2014-03-27 16:05:57,2014-03-27 16:01:31
af443fd3e70215434efc2ca1ef7272a0ab92c2af...39b2a80cf017537c6ab439582363d2b7aa7da49a,2,20,9,29,6,2014-03-27 17:48:15,2014-03-27 15:42:33
39b2a80cf017537c6ab439582363d2b7aa7da49a...df37f6c6849bb148883d726466a868901335cc00,1,1,1,2,1,2014-03-27 18:28:25,2014-03-27 17:01:37
df37f6c6849bb148883d726466a868901335cc00...5047fba16c7840ac69e07933ad5843ac19ae047e,5,145,4,149,17,2014-03-27 20:28:38,2014-03-26 02:05:25
5047fba16c7840ac69e07933ad5843ac19ae047e...1e1d57093ac14f5effd451ddde1d6a3928ef6237,4,200,0,200,4,2014-03-27 21:08:55,2014-03-27 20:31:25
1e1d57093ac14f5effd451ddde1d6a3928ef6237...8bb2e09856750c7e5dd40713bc2b6ed100db4355,4,153,16,169,19,2014-03-27 21:18:08,2014-03-27 15:18:09
8bb2e09856750c7e5dd40713bc2b6ed100db4355...4201130bb08808b3d1ac6441b97fd2b6820a62a2,1,8,5,13,6,2014-03-27 21:21:16,2014-03-27 20:59:26
4201130bb08808b3d1ac6441b97fd2b6820a62a2...d061fb5f993aff589538c9add71af4765be1b65d,114,7,7,14,4,2014-03-27 21:47:08,2014-03-27 20:15:09
d061fb5f993aff589538c9add71af4765be1b65d...09ab1978448e64a884a862170650c04b66858d13,12,6,0,6,3,2014-03-27 21:47:08,2014-03-27 20:43:39
09ab1978448e64a884a862170650c04b66858d13...e6f210813e1b32f25885e1ea9d96cf1c8f5b05f4,2,77,0,77,6,2014-03-27 22:02:24,2014-03-27 20:51:31
e6f210813e1b32f25885e1ea9d96cf1c8f5b05f4...2f3c2123acb314f7542b8666151493d96a378b79,1,3,3,6,3,2014-03-27 22:35:49,2014-03-27 21:46:03
2f3c2123acb314f7542b8666151493d96a378b79...020e64123f217c5b0eaa95580273dacb9c0eae8e,3,78,72,150,23,2014-03-27 22:46:23,2014-03-27 22:01:19
020e64123f217c5b0eaa95580273dacb9c0eae8e...4692aaec6e3f57efd02c0ef759ec243aac326464,1,2,2,4,1,2014-03-27 23:15:09,2014-03-27 20:08:56
4692aaec6e3f57efd02c0ef759ec243aac326464...4d24c0155e2f7b4ae2b4c73468d246925e77121c,1,10,10,20,9,2014-03-27 23:15:09,2014-03-27 20:31:37
4d24c0155e2f7b4ae2b4c73468d246925e77121c...70f7743138d496608133f62975cd8508ac6c99a6,8,12,12,24,10,2014-03-27 23:15:09,2014-03-27 20:54:23
70f7743138d496608133f62975cd8508ac6c99a6...b48e15efdd02c3217356484ad462dcde9d57920d,1,3,2,5,1,2014-03-27 23:26:17,2014-03-27 23:23:33
b48e15efdd02c3217356484ad462dcde9d57920d...dbb698b61a244e66897e6aaa4cfed858da6c378c,2,79,12,91,4,2014-03-27 23:27:59,2014-03-27 23:24:03
dbb698b61a244e66897e6aaa4cfed858da6c378c...feaac6b42626de25742d766c12e3ec4a65dbc9a8,7,246,27,273,15,2014-03-27 23:37:10,2014-03-27 15:24:43
feaac6b42626de25742d766c12e3ec4a65dbc9a8...9298aabe184dccdda4db0fc3d57f3858ae80c2d9,3,16,7,23,6,2014-03-27 23:37:17,2014-03-27 21:56:21
9298aabe184dccdda4db0fc3d57f3858ae80c2d9...2b6315533317ac3758e512cc476c05072fa0043d,4,0,200,200,4,2014-03-28 04:51:53,2014-03-28 04:51:53
2b6315533317ac3758e512cc476c05072fa0043d...32514385e1b48abced71a661d6ade2f8b7b619c4,1,2,2,4,1,2014-03-28 14:27:02,2014-03-28 14:13:41
32514385e1b48abced71a661d6ade2f8b7b619c4...1cfdc9f9e8571d529b6cc2681d89567835946911,1,32,0,32,3,2014-03-28 15:40:44,2014-03-27 21:18:10
1cfdc9f9e8571d529b6cc2681d89567835946911...f2e8a05f846678c32575883f765151b36225a6a6,5,204,1,205,5,2014-03-28 16:46:44,2014-03-27 20:31:25
f2e8a05f846678c32575883f765151b36225a6a6...3ca3effff3fa15cf996a2f3929b3227f8f34e25a,1,1,1,2,1,2014-03-28 17:22:34,2014-03-28 15:53:10
3ca3effff3fa15cf996a2f3929b3227f8f34e25a...1b7fe7694cbf556ef9c307994a4ca273d9f06073,8,185,15,200,13,2014-03-28 17:49:44,2014-03-27 21:07:40
1b7fe7694cbf556ef9c307994a4ca273d9f06073...7f6bf41feeccd2a2ba4f191277a64221231c73e2,1,7,1,8,2,2014-03-28 17:49:44,2014-03-27 22:03:45
7f6bf41feeccd2a2ba4f191277a64221231c73e2...dcabd35e333ceeee3a8d944249fcde32a5ea631a,3,104,10,114,8,2014-03-28 17:49:44,2014-03-27 21:44:53
dcabd35e333ceeee3a8d944249fcde32a5ea631a...2005e174be33429519b519550e7d0dec9b607251,5,187,75,262,13,2014-03-28 17:49:44,2014-03-27 22:42:45
2005e174be33429519b519550e7d0dec9b607251...1b9917b39c4fa37fd2a5e42c78e5f1e50c4c50cc,3,78,4,82,4,2014-03-28 17:49:44,2014-03-27 23:01:00
1b9917b39c4fa37fd2a5e42c78e5f1e50c4c50cc...f81b9676fa3dac6aa24c03a0a97ee4b74e352706,3,59,6,65,5,2014-03-28 17:49:44,2014-03-27 23:28:27
f81b9676fa3dac6aa24c03a0a97ee4b74e352706...0d2fe93ded0fd0a8f5663ab9aa98ee45bd6068eb,4,179,48,227,20,2014-03-28 17:49:44,2014-03-28 00:11:11
0d2fe93ded0fd0a8f5663ab9aa98ee45bd6068eb...0c1fa12980c7b5489213f2349c0bc1f3d338c8f3,2,51,8,59,6,2014-03-28 17:49:44,2014-03-28 00:32:17
0c1fa12980c7b5489213f2349c0bc1f3d338c8f3...9c93634cccba831bb53c7be8d0719061978dde3f,4,38,11,49,6,2014-03-28 17:49:44,2014-03-28 00:43:37
9c93634cccba831bb53c7be8d0719061978dde3f...ce4afbc1c211559b33f7fd2145cd7b4120ce9113,3,115,13,128,9,2014-03-28 17:49:44,2014-03-28 13:41:15
ce4afbc1c211559b33f7fd2145cd7b4120ce9113...9537c9c5355de719d367914deb1f57bc8c6b5017,3,70,19,89,11,2014-03-28 17:49:44,2014-03-28 13:57:22
9537c9c5355de719d367914deb1f57bc8c6b5017...a73fb4cab5dbc5caf18ebccd3d6ef0eda3fd6d96,3,131,23,154,5,2014-03-28 17:49:45,2014-03-28 14:11:47
a73fb4cab5dbc5caf18ebccd3d6ef0eda3fd6d96...2f9a07b9aabd0f098b8e17c3f725dc2e353c242b,3,83,4,87,5,2014-03-28 17:49:45,2014-03-28 14:24:45
2f9a07b9aabd0f098b8e17c3f725dc2e353c242b...f9841e0136d9f7a667662581cda9ce9ddfbf20d8,3,97,28,125,14,2014-03-28 17:49:45,2014-03-28 14:43:58
f9841e0136d9f7a667662581cda9ce9ddfbf20d8...8af90cc7e196a63791e0b1b30c49e3f7b96bf4dc,3,82,16,98,14,2014-03-28 17:49:45,2014-03-28 15:00:46
8af90cc7e196a63791e0b1b30c49e3f7b96bf4dc...d0a29833d9427f91204fc0e27ce5429898ce6be0,1,1,1,2,1,2014-03-28 18:52:40,2014-03-28 18:48:24
d0a29833d9427f91204fc0e27ce5429898ce6be0...fb2cf5e3297bc0126ca2733a4a180cebfc938789,1,3,3,6,3,2014-03-28 19:03:21,2014-03-28 16:58:55
fb2cf5e3297bc0126ca2733a4a180cebfc938789...82f2df8b93138ec5e9980f46004bcdface30c97c,1,14,0,14,4,2014-03-28 19:13:30,2014-03-28 17:55:53
82f2df8b93138ec5e9980f46004bcdface30c97c...b1ee91acf6bddc7776f6ab3ab40abcb727f9cc26,3,0,0,0,0,2014-03-29 23:32:57,2014-03-29 18:22:17
b1ee91acf6bddc7776f6ab3ab40abcb727f9cc26...2ed3157c0c78d603116d96b36750d7f8463c3139,1,12,0,12,6,2014-03-30 16:42:56,2014-03-28 18:52:54
2ed3157c0c78d603116d96b36750d7f8463c3139...7810679187eb5bd82de81cc8f152e36ec38f2c4b,1,6,1,7,1,2014-03-30 16:42:58,2014-03-28 19:19:20
7810679187eb5bd82de81cc8f152e36ec38f2c4b...ee42f85b2c7497a78b56eb6e8b293305125b4cc2,49,1642,731,2373,161,2014-03-30 17:01:13,2014-03-28 23:13:37
ee42f85b2c7497a78b56eb6e8b293305125b4cc2...eea49e2e48202c8a05d3ffc8b91143d6da2f7126,3,28,12,40,21,2014-03-31 14:16:52,2014-03-29 04:34:24
eea49e2e48202c8a05d3ffc8b91143d6da2f7126...9de22c408e7080c8c35257302c416ca4941fa0ec,1,6,0,6,1,2014-03-31 14:16:57,2014-03-30 15:06:50
9de22c408e7080c8c35257302c416ca4941fa0ec...a12d09c9757301c3872cf4b45027d287e3dcc366,9,211,30,241,29,2014-03-31 15:48:45,2014-03-27 16:31:12
a12d09c9757301c3872cf4b45027d287e3dcc366...2927031d377002fd483ada3d63c2a58a3fa8b0b7,2,42,1,43,3,2014-03-31 17:35:36,2014-03-31 15:10:12
2927031d377002fd483ada3d63c2a58a3fa8b0b7...6016ef6ba48fbfef484a547b33eaf3e56615f57e,3,20,19,39,11,2014-03-31 17:59:58,2014-03-31 16:50:33
6016ef6ba48fbfef484a547b33eaf3e56615f57e...4f5e71237a70d7f5e1100f0b0a3b26700e945c84,1,1,1,2,1,2014-03-31 18:27:44,2014-03-31 18:26:59
4f5e71237a70d7f5e1100f0b0a3b26700e945c84...1aa9b7b3749064a7fd150203102e142f5415754e,1,0,8,8,2,2014-03-31 19:48:02,2014-03-31 14:49:13
1aa9b7b3749064a7fd150203102e142f5415754e...7ac1d212730ad3b1d03b4f10f18e52fa42914c64,1,0,10,10,2,2014-03-31 21:30:49,2014-03-31 20:42:11
7ac1d212730ad3b1d03b4f10f18e52fa42914c64...67ec5c5b2926b682db1e21c22b1878043438827c,2,35,3,38,4,2014-03-31 22:19:20,2014-03-31 19:50:42
67ec5c5b2926b682db1e21c22b1878043438827c...9d9fcde8659cb103d68632064550fb490e370bef,4,4,56,60,16,2014-04-01 07:28:00,2014-03-31 12:02:32
9d9fcde8659cb103d68632064550fb490e370bef...b3c2e5171b558bfa76bab83a36083eac5d5c363b,2,22,4,26,9,2014-04-01 15:04:01,2014-04-01 03:30:17
b3c2e5171b558bfa76bab83a36083eac5d5c363b...d2eedb1dda23d7aba2f4f38a69a05790cf706d72,1,1,1,2,1,2014-04-01 15:30:52,2014-04-01 14:40:34
d2eedb1dda23d7aba2f4f38a69a05790cf706d72...9b86a61a28200ffbbcbee0b04b22a725556575d5,1,2,0,2,1,2014-04-01 15:30:52,2014-04-01 15:25:56
9b86a61a28200ffbbcbee0b04b22a725556575d5...1d338b82d6942c5caf694941dd895da9ef59f019,1,10,0,10,2,2014-04-01 17:52:41,2014-04-01 15:51:53
1d338b82d6942c5caf694941dd895da9ef59f019...62d38e779ae09ed34543ac35593c36b6957be7ed,1,16,6,22,6,2014-04-01 20:23:36,2014-04-01 16:01:36
62d38e779ae09ed34543ac35593c36b6957be7ed...7ad0dc7be078ad948cc0d679b2a06160ae00fa6c,1,2,2,4,2,2014-04-01 20:24:47,2014-04-01 15:48:32
7ad0dc7be078ad948cc0d679b2a06160ae00fa6c...2013b68ddd9741cd894e35b0fc01e2475eaf3da5,3,100,27,127,11,2014-04-01 23:44:05,2014-04-01 18:46:57
2013b68ddd9741cd894e35b0fc01e2475eaf3da5...fda2dca224c42a24fc54e6f5192469084c49e0cc,8,16,98,114,19,2014-04-01 23:44:05,2014-04-01 17:17:36
fda2dca224c42a24fc54e6f5192469084c49e0cc...019f0ccc9efbdb3a76e8e50259dd2921b939d39a,5,15,92,107,10,2014-04-01 23:44:05,2014-04-01 19:24:59
019f0ccc9efbdb3a76e8e50259dd2921b939d39a...261233b6c11a8282b1f626d496a1743a0b48821d,9,302,391,693,28,2014-04-01 23:44:05,2014-04-01 22:11:43
261233b6c11a8282b1f626d496a1743a0b48821d...c7a673410edd0c9ff6a17ff333f72fb43c82fb2c,1,53,13,66,9,2014-04-02 00:04:12,2014-04-01 23:34:57
c7a673410edd0c9ff6a17ff333f72fb43c82fb2c...f93d14738c1abaa31b44a0af87700e72fd3979d3,9,258,15,273,24,2014-04-02 00:30:27,2014-04-01 19:40:26
f93d14738c1abaa31b44a0af87700e72fd3979d3...91e679c2102b2870cfc0b2eeb31035eabc234deb,3,7,29,36,3,2014-04-02 03:51:28,2014-04-02 03:12:33
91e679c2102b2870cfc0b2eeb31035eabc234deb...65b84b79e5bb514e658065d5d9028b85061deae6,2,3,5,8,2,2014-04-02 06:26:41,2014-04-02 06:21:22
65b84b79e5bb514e658065d5d9028b85061deae6...4bed1574b0179b54c0c49878638bfce210d91107,1,2,3,5,1,2014-04-02 10:30:38,2014-04-02 10:30:38
4bed1574b0179b54c0c49878638bfce210d91107...8e82f5620a230fe890d09872c48ca41734b66dca,7,7,7,14,7,2014-04-02 10:31:10,2014-04-02 10:31:10
8e82f5620a230fe890d09872c48ca41734b66dca...bafd9c7e0e39f86d251271517f518a24acb853c5,2,62,10,72,9,2014-04-02 15:04:58,2014-04-02 14:24:27
bafd9c7e0e39f86d251271517f518a24acb853c5...8a71a071e54d96361fcabb992cd82f60ce413eb8,2,2,2,4,2,2014-04-02 22:07:49,2014-04-02 22:07:49
8a71a071e54d96361fcabb992cd82f60ce413eb8...1c1c76aeca21c5983dc178920f5052c298db616c,2,2,2,4,2,2014-04-07 00:36:57,2014-04-07 00:36:57
1c1c76aeca21c5983dc178920f5052c298db616c...b588b9fccc5069ea358ca830330d5e91eaf3967e,2,2,2,4,2,2014-04-07 21:31:26,2014-04-07 21:31:26
b588b9fccc5069ea358ca830330d5e91eaf3967e...ffa99f0d369e9eabd8eafa4ac5ff412075458c34,1,6,1,7,4,2014-04-09 15:00:22,2014-04-09 14:10:02
ffa99f0d369e9eabd8eafa4ac5ff412075458c34...337729f2d0b943e0557a1c709a3bc155bf374d51,4,41,3,44,6,2014-04-09 22:40:07,2014-04-02 22:31:50
337729f2d0b943e0557a1c709a3bc155bf374d51...423ebc231ab8234ac3b2c8d11ca3759b0e99d19f,4,78,14,92,7,2014-04-09 22:40:07,2014-04-02 21:54:36
423ebc231ab8234ac3b2c8d11ca3759b0e99d19f...6850ecf70c9da11732d92f81fb81b411804f8671,1,11,8,19,1,2014-04-09 22:40:07,2014-04-02 16:56:33
6850ecf70c9da11732d92f81fb81b411804f8671...ba1b569cd99ea2b2639b5a0374ee355af9e378a9,1,16,4,20,8,2014-04-09 22:40:07,2014-04-02 21:45:57
ba1b569cd99ea2b2639b5a0374ee355af9e378a9...a9587732dc24b220ad687c06205da9e20906ab45,1,2,1,3,1,2014-04-09 22:40:07,2014-04-03 15:58:46
a9587732dc24b220ad687c06205da9e20906ab45...8cb4c299cacce221c6fc34722c27c5a9cc74c607,1,1,1,2,1,2014-04-09 22:40:08,2014-04-03 09:36:58
8cb4c299cacce221c6fc34722c27c5a9cc74c607...1bdf9bb5115bdc993828dc9addc27dd8e4488e1b,6,78,40,118,23,2014-04-09 22:40:08,2014-04-06 19:07:21
1bdf9bb5115bdc993828dc9addc27dd8e4488e1b...d2030ec6797f4d4238e03690eef8334c1f582ce2,1,11,9,20,4,2014-04-09 22:54:21,2014-04-04 12:53:38
d2030ec6797f4d4238e03690eef8334c1f582ce2...ac55e3f5a963f8ed2b0516703f8305e8091595f0,1,20,11,31,5,2014-04-09 22:54:21,2014-04-04 14:17:44
ac55e3f5a963f8ed2b0516703f8305e8091595f0...2af46bcef99628210d00a24edc5bfa37966cd9a4,1,6,4,10,2,2014-04-09 22:54:21,2014-04-08 20:48:02
2af46bcef99628210d00a24edc5bfa37966cd9a4...758f9f60ff799a76d6373de6b8ce820ebbd72bfc,2,27,3,30,3,2014-04-09 22:54:21,2014-04-08 23:55:32
758f9f60ff799a76d6373de6b8ce820ebbd72bfc...f5544e542d72c990fe4a3588ad632dd3acefe40b,2,20,18,38,11,2014-04-10 15:48:15,2014-04-08 17:47:34
f5544e542d72c990fe4a3588ad632dd3acefe40b...a280cb5a78e94229598c3a540a933e18037dbf5c,3,15,4,19,4,2014-04-10 15:48:15,2014-04-09 17:34:35
a280cb5a78e94229598c3a540a933e18037dbf5c...be1905c24c7e5ea258e537fbf0d2c502c4fc6de2,8,65,13,78,15,2014-04-10 15:48:15,2014-04-07 13:08:08
be1905c24c7e5ea258e537fbf0d2c502c4fc6de2...b14b921ba3b3424681212707d82b76097bf13c9d,6,147,9,156,10,2014-04-14 14:47:49,2014-04-09 14:28:13
b14b921ba3b3424681212707d82b76097bf13c9d...52da235706ca1713ae91475009348a0ceded5307,6,378,20,398,21,2014-04-14 14:48:20,2014-04-09 16:51:18
52da235706ca1713ae91475009348a0ceded5307...279163e3802cf5b538b22eac9302419f0f7bb6f8,2,19,0,19,3,2014-04-14 17:40:51,2014-04-10 00:07:16
279163e3802cf5b538b22eac9302419f0f7bb6f8...9f1ef97401471aaeb430cb5c4ad9c06ffe7e60c6,7,36,12,48,11,2014-04-14 17:40:51,2014-04-11 16:24:37
9f1ef97401471aaeb430cb5c4ad9c06ffe7e60c6...ccb02e83df89baebd889791c33dd72122a0f43b4,2,12,2,14,3,2014-04-14 17:40:51,2014-04-11 18:12:21
ccb02e83df89baebd889791c33dd72122a0f43b4...a386aa60368efb333424ab4bf7a9385d6c45a03a,1,3,3,6,3,2014-04-15 22:44:27,2014-04-14 10:26:47
a386aa60368efb333424ab4bf7a9385d6c45a03a...1b7b02db89e8a574cb2f5bff717090a8719d4fb9,3,67,4,71,3,2014-04-15 22:44:27,2014-04-14 17:31:31
1b7b02db89e8a574cb2f5bff717090a8719d4fb9...5636fd6504b1b5a649468e62f48b7bae00f24b0f,2,3,2,5,2,2014-04-15 22:44:28,2014-04-14 15:41:49
5636fd6504b1b5a649468e62f48b7bae00f24b0f...12279052c851ae5a1ed43d98433ced9db7682d3a,2,85,1,86,4,2014-04-15 22:44:28,2014-04-15 13:58:30
12279052c851ae5a1ed43d98433ced9db7682d3a...f0e41e169c8b38578c774af0b9cf38dd79e5ad23,2,75,2,77,3,2014-04-16 14:04:10,2014-04-14 22:25:40
f0e41e169c8b38578c774af0b9cf38dd79e5ad23...b39c5ee1eaf1507e7f9149330520e01d5c060340,2,49,1,50,6,2014-04-16 14:14:15,2014-04-10 16:26:03
b39c5ee1eaf1507e7f9149330520e01d5c060340...f621320bee2a36e560b65e4e1ffc754a9be95894,2,5,10,15,4,2014-04-16 14:49:15,2014-04-14 18:52:07
f621320bee2a36e560b65e4e1ffc754a9be95894...6ea3fac3176f8c08cd792b2ea7fccfe6dc819268,1,15,20,35,6,2014-04-16 14:51:22,2014-04-14 19:31:00
6ea3fac3176f8c08cd792b2ea7fccfe6dc819268...9d7f0555fcf2180ef87995c0a054da0c064cdf9d,1,2,1,3,2,2014-04-16 14:55:11,2014-04-09 16:00:44
9d7f0555fcf2180ef87995c0a054da0c064cdf9d...adbc29e06ebf142a3c14091db20b5e8a23bb8980,4,8,8,16,6,2014-04-16 14:56:41,2014-04-01 18:07:20
adbc29e06ebf142a3c14091db20b5e8a23bb8980...c18511e8eccb8940f3fbdb4ffede54c8ba8f955e,1,3,3,6,3,2014-04-16 14:57:43,2014-04-09 22:31:55
c18511e8eccb8940f3fbdb4ffede54c8ba8f955e...ea2102c1946506a888707aec06995c1c736075d6,1,15,1,16,2,2014-04-16 10:33:08,2014-04-15 16:12:28
ea2102c1946506a888707aec06995c1c736075d6...f70518f8879c1dc3cf7721b6232cc1e84af39182,1,5,4,9,2,2014-04-16 17:44:45,2014-04-16 11:40:35
f70518f8879c1dc3cf7721b6232cc1e84af39182...644f64524848bc0e41660ee13feeaf0620071cfb,2,24,13,37,12,2014-04-16 20:35:50,2014-04-13 10:44:48
644f64524848bc0e41660ee13feeaf0620071cfb...c27685781d30a2646b5e75270ee81b6954303210,2,47,10,57,5,2014-04-17 13:00:49,2014-04-17 04:40:02
c27685781d30a2646b5e75270ee81b6954303210...8d2e6aab88f62bd718fc262315b98c60af89a6bd,4,13,12,25,10,2014-04-17 13:05:14,2014-04-16 20:46:09
8d2e6aab88f62bd718fc262315b98c60af89a6bd...a093bfa703c4a63fb26b1bc16c0f6ae13261486e,1,86,23,109,7,2014-04-17 15:25:24,2014-03-19 22:20:06
a093bfa703c4a63fb26b1bc16c0f6ae13261486e...eeef3c3ded2d8d55345af8b11041bafae8783958,2,42,1,43,2,2014-04-17 17:26:47,2014-04-17 14:19:46
eeef3c3ded2d8d55345af8b11041bafae8783958...e1f859d6aee2991de7b56e8cf519aafee9223599,1,5,0,5,2,2014-04-17 20:45:15,2014-04-17 20:42:45
e1f859d6aee2991de7b56e8cf519aafee9223599...791fcf4495b08bd8c108f3275ba4e489b4928537,2,50,4,54,4,2014-04-17 21:01:19,2014-04-17 18:52:00
791fcf4495b08bd8c108f3275ba4e489b4928537...e83de252bac4f30b7a02bc08c6bc2e14c0f187bb,2,4,50,54,4,2014-04-17 22:01:11,2014-04-17 22:00:52
e83de252bac4f30b7a02bc08c6bc2e14c0f187bb...52faaa32ef9226cf6583e82d97caa40c46dade80,3,92,66,158,15,2014-04-18 16:02:23,2014-04-17 18:52:00
52faaa32ef9226cf6583e82d97caa40c46dade80...4a3e38949aa6bfe86bb7a56f7b5536cb25a54a33,1,1,15,16,2,2014-04-18 12:41:03,2014-04-18 12:41:03
4a3e38949aa6bfe86bb7a56f7b5536cb25a54a33...7303d9b39af069dd530ca59233dae2831585c7af,2,24,12,36,24,2014-04-18 21:02:58,2014-04-18 19:44:57
7303d9b39af069dd530ca59233dae2831585c7af...d4b1e9e2e5097ff777b69543183088fa1fbb0129,1,5,2,7,3,2014-04-18 21:33:29,2014-04-18 19:28:21
d4b1e9e2e5097ff777b69543183088fa1fbb0129...9ad97ac9fd08cf56d4e6c4bdb5c1b10085b9040c,2,123,35,158,21,2014-04-18 21:33:29,2014-04-18 19:28:50
9ad97ac9fd08cf56d4e6c4bdb5c1b10085b9040c...070d58c191ab626605bcdd45db2f7990faa46399,3,36,4,40,5,2014-04-18 21:33:29,2014-04-18 21:31:29
070d58c191ab626605bcdd45db2f7990faa46399...d4a70e8891182e0e6736442584203ab2984c8765,1,3,3,6,3,2014-04-21 14:46:00,2014-04-21 14:44:49
d4a70e8891182e0e6736442584203ab2984c8765...14e0ba91a9897018c6a0232eb25ab96f1c451a4f,1,1,1,2,1,2014-04-21 15:19:22,2014-04-21 15:19:22
14e0ba91a9897018c6a0232eb25ab96f1c451a4f...e17c3e6dc06362c268836f2d3289c42e14b81e04,3,81,2,83,4,2014-04-21 17:53:23,2014-04-21 14:32:51
e17c3e6dc06362c268836f2d3289c42e14b81e04...66da6ee14e6de327285f76ae73e48a56788ab901,3,36,43,79,5,2014-04-21 17:53:46,2014-04-21 14:45:56
66da6ee14e6de327285f76ae73e48a56788ab901...246bfa4e9c365f585e3dc323f91b72e1dd16d127,2,10,0,10,2,2014-04-21 17:59:02,2014-04-21 15:17:47
246bfa4e9c365f585e3dc323f91b72e1dd16d127...a7f594977627996aa8731e936ef9c3801d512fc0,7,7,7,14,7,2014-04-21 19:54:59,2014-04-21 19:54:59
a7f594977627996aa8731e936ef9c3801d512fc0...ed241301e5e2439af389a6dfb919d6498df89594,7,7,7,14,7,2014-04-22 15:59:10,2014-04-22 15:59:10
ed241301e5e2439af389a6dfb919d6498df89594...116d7d799a6edea172e612767d0605a913f7a9f5,3,0,0,0,0,2014-04-22 19:07:42,2014-04-09 21:41:25
116d7d799a6edea172e612767d0605a913f7a9f5...2516d36768448ee1b6a2246eb562f48e2f9a0751,1,17,6,23,5,2014-04-30 09:59:26,2014-04-30 04:16:07
2516d36768448ee1b6a2246eb562f48e2f9a0751...83460112e794277ef4aee3612773bf237144ee84,2,4,0,4,2,2014-04-30 11:56:41,2014-04-28 18:57:14
83460112e794277ef4aee3612773bf237144ee84...fce2652dca83bce5fcb823fccbd282c5815a899b,1,8,0,8,2,2014-04-30 14:35:23,2014-04-28 20:34:43
fce2652dca83bce5fcb823fccbd282c5815a899b...6a900b9d4f43f866c1762247689c60944889ce08,2,36,1,37,2,2014-04-30 14:36:30,2014-04-22 14:58:33
6a900b9d4f43f866c1762247689c60944889ce08...44a476ab53c36076667edfc94c84a621a6bb61bd,7,7,7,14,7,2014-04-30 15:58:56,2014-04-30 15:58:56
44a476ab53c36076667edfc94c84a621a6bb61bd...9568d9c60a45d63319ca1b03d3f602cb35892edf,7,7,7,14,7,2014-04-30 23:28:28,2014-04-30 23:28:28
9568d9c60a45d63319ca1b03d3f602cb35892edf...4b95b086d2374bdcfcdf2249272fb552c9c726e8,7,7,7,14,7,2014-05-05 02:29:43,2014-05-05 02:29:43
4b95b086d2374bdcfcdf2249272fb552c9c726e8...798f6c9a3c83e4fe243a9853c587e143e7f16b52,7,7,7,14,7,2014-05-05 12:18:15,2014-05-05 12:18:15
798f6c9a3c83e4fe243a9853c587e143e7f16b52...71e4c210ec024b8260d6bdee1bfe8dc21ab8c696,1,1,1,2,1,2014-05-05 12:39:03,2014-04-24 11:11:37
71e4c210ec024b8260d6bdee1bfe8dc21ab8c696...b267b2824ea6043cd27c14cfef6ff8af6f93b861,1,14,11,25,7,2014-05-08 13:05:19,2014-05-02 21:41:49
b267b2824ea6043cd27c14cfef6ff8af6f93b861...71534242a3dbf802bfb3728c1d0f74848509cca6,1,23,13,36,13,2014-05-08 13:05:19,2014-05-07 03:54:47
71534242a3dbf802bfb3728c1d0f74848509cca6...2ff4d735d3b9cc430c4a3af43afe4264a36bed3f,1,2,1,3,1,2014-05-08 13:05:19,2014-05-08 04:33:42
2ff4d735d3b9cc430c4a3af43afe4264a36bed3f...ac19511d677a871ab57a9506ee038bd8443ce25e,1,5,1,6,2,2014-05-08 19:29:21,2014-04-29 21:34:05
ac19511d677a871ab57a9506ee038bd8443ce25e...c22fbc9bc636c4c730569c741a2fb6c46193bf5f,1,8,4,12,3,2014-05-09 02:39:14,2014-04-29 17:04:51
c22fbc9bc636c4c730569c741a2fb6c46193bf5f...1e9944fbed01c900cb2d8c7e38b38a7acf9e657b,3,8,12,20,5,2014-05-15 18:23:14,2014-04-18 14:11:47
1e9944fbed01c900cb2d8c7e38b38a7acf9e657b...261a158b8729bb97c545edbe66c6a53a8aa8c7f4,2,10,4,14,4,2014-05-15 18:23:14,2014-04-18 15:02:21
261a158b8729bb97c545edbe66c6a53a8aa8c7f4...fef6805061b31e1c6269a438c1922f17db72213b,6,1534,16,1550,23,2014-05-15 18:23:14,2014-04-28 20:53:10
fef6805061b31e1c6269a438c1922f17db72213b...945ed48cc77ecbc97f7fdc6f7a06c8968a7a14c5,6,399,3,402,12,2014-05-15 18:23:15,2014-04-28 20:54:17
945ed48cc77ecbc97f7fdc6f7a06c8968a7a14c5...8ff445004bda16b05fcdc15d9276578e73e5f66d,1,42,8,50,7,2014-05-15 21:32:11,2014-05-01 21:30:43
8ff445004bda16b05fcdc15d9276578e73e5f66d...28bab1646931c346ff2e0fbc036ae4935d8c31b8,2,60,0,60,3,2014-05-15 21:32:20,2014-05-01 21:31:24
28bab1646931c346ff2e0fbc036ae4935d8c31b8...a07574aaa71a1fcea8239257bffef929f2fd53b3,3,33,8,41,7,2014-05-15 21:39:42,2014-05-13 19:11:58
a07574aaa71a1fcea8239257bffef929f2fd53b3...def6f6952a44499c6a0281f4f00e50f64d111e0f,1,9,1,10,1,2014-05-15 22:00:48,2014-05-14 13:48:59
def6f6952a44499c6a0281f4f00e50f64d111e0f...36cd42c86d454fe78052339e7e53bdcc7b9b86a7,2,6,1,7,4,2014-05-15 22:03:31,2014-04-28 20:29:47
36cd42c86d454fe78052339e7e53bdcc7b9b86a7...9436cd6cc5850f5afa70b98671425db0574f1243,2,86,40,126,17,2014-05-15 22:40:37,2014-05-08 21:27:23
9436cd6cc5850f5afa70b98671425db0574f1243...36a43587509d9caaae6480c533d59d894a2daec2,2,5,2,7,2,2014-05-15 22:45:27,2014-05-07 19:34:26
36a43587509d9caaae6480c533d59d894a2daec2...826903317459a630d3e0cd57653d65567a2144e3,1,1,1,2,1,2014-05-15 22:47:17,2014-05-09 15:11:00
826903317459a630d3e0cd57653d65567a2144e3...faaffb7477e70be293f0e1141f4fff28ffaa2771,3,78,10,88,13,2014-05-15 22:48:11,2014-04-24 19:27:18
faaffb7477e70be293f0e1141f4fff28ffaa2771...4a92104637e03230e651f5c3e3997368f965e86c,2,32,1,33,3,2014-05-15 22:57:33,2014-05-06 20:34:27
4a92104637e03230e651f5c3e3997368f965e86c...68ae4983b197cf853ae3367a95a03a4946141115,1,1,0,1,1,2014-05-15 23:11:09,2014-04-14 20:09:18
68ae4983b197cf853ae3367a95a03a4946141115...adc534fcdd0425f689954f44a940f6416e46673a,1,3,1,4,1,2014-05-15 23:15:16,2014-04-17 18:18:19
adc534fcdd0425f689954f44a940f6416e46673a...5f50fe901bdd34c5c539c612e22b30f339e57e81,4,77,19,96,21,2014-05-15 23:16:10,2014-04-25 18:16:46
5f50fe901bdd34c5c539c612e22b30f339e57e81...0661a4fa335f200b07c2a6afa6e5d0922bae60d6,2,16,3,19,3,2014-05-15 23:25:28,2014-04-28 10:38:03
0661a4fa335f200b07c2a6afa6e5d0922bae60d6...652d7a4c95719ccf619dba4a5b57ef21626df2a4,4,156,26,182,21,2014-05-15 23:31:06,2014-04-25 15:26:37
652d7a4c95719ccf619dba4a5b57ef21626df2a4...bf471cd8e2aaf70e7950ea179b9c22822b6ddc2c,2,31,9,40,8,2014-05-15 23:31:40,2014-05-07 18:22:05
bf471cd8e2aaf70e7950ea179b9c22822b6ddc2c...f791b9d40151a5aacda4c82c87c7490463b8efa3,1,5,1,6,1,2014-05-15 23:35:38,2014-04-17 20:05:55
f791b9d40151a5aacda4c82c87c7490463b8efa3...c2d90aad653b567be14798665e280b94525bb55d,4,534,80,614,43,2014-05-15 23:36:49,2014-04-24 17:13:25
c2d90aad653b567be14798665e280b94525bb55d...de14e3eed4040db2f105dada80100b9417c37045,3,131,9,140,8,2014-05-15 23:51:54,2014-04-30 17:02:47
de14e3eed4040db2f105dada80100b9417c37045...8b326cb33c3fa7c78be9c14cc0d9da8266ed9aa2,2,30,0,30,3,2014-05-15 23:55:34,2014-04-28 15:43:49
8b326cb33c3fa7c78be9c14cc0d9da8266ed9aa2...d08a911f0dc465c6f46a9d9f9105ec9a5e219ba0,3,3,3,6,3,2014-05-15 23:56:52,2014-04-21 17:55:58
d08a911f0dc465c6f46a9d9f9105ec9a5e219ba0...4649c7185dd3b7f650eb596646d4164d496e6d43,2,134,23,157,17,2014-05-15 23:58:56,2014-05-07 15:13:26
4649c7185dd3b7f650eb596646d4164d496e6d43...3fa0ec160da4a0858faf63f1d7ce600254594b37,1,5,1,6,1,2014-05-16 00:01:39,2014-05-05 15:26:17
3fa0ec160da4a0858faf63f1d7ce600254594b37...c26b53eaf60fdaa1413285a0892b782b33a9cf03,2,7,0,7,2,2014-05-16 00:12:21,2014-05-13 19:01:35
c26b53eaf60fdaa1413285a0892b782b33a9cf03...2cebdd054c5f1686179e5a2db1ea46adf6670f37,3,73,3,76,8,2014-05-16 00:14:57,2014-05-13 18:40:44
2cebdd054c5f1686179e5a2db1ea46adf6670f37...f076d57d427e7fde945303aaec32ba594de5872c,3,38,1,39,4,2014-05-16 00:21:08,2014-05-09 17:55:49
f076d57d427e7fde945303aaec32ba594de5872c...ef0072b437a26083d9c930cccab44042f716b8a5,1,5,1,6,1,2014-05-16 18:12:45,2014-05-01 22:25:05
ef0072b437a26083d9c930cccab44042f716b8a5...0ef9bcd431976a5384324db905a155f41f9fe1dc,1,13,17,30,3,2014-05-16 18:43:48,2014-05-05 13:33:06
0ef9bcd431976a5384324db905a155f41f9fe1dc...0366e4a86262a89e329fabbadde06e14bd4a33cb,2,22,10,32,7,2014-05-16 19:35:31,2014-04-28 19:00:24
0366e4a86262a89e329fabbadde06e14bd4a33cb...195a67eec3cf8a337b5f524d138206e83bf564d4,1,1,1,2,1,2014-05-16 23:56:40,2014-05-15 16:59:54
195a67eec3cf8a337b5f524d138206e83bf564d4...013e21bbe58c4d345df61576fb3cafe41c2ae49c,11,279,350,629,65,2014-05-17 00:00:07,2014-04-15 20:37:13
013e21bbe58c4d345df61576fb3cafe41c2ae49c...812af45b315b663b44ea9b03b8f20305408b2875,1,1,0,1,1,2014-05-20 17:56:05,2014-05-20 17:54:57
812af45b315b663b44ea9b03b8f20305408b2875...384e8e322958bdfb8f9932784c8a9d378dc3a425,4,71,2,73,6,2014-05-20 21:59:15,2014-05-15 16:20:23
384e8e322958bdfb8f9932784c8a9d378dc3a425...7c75cf1da8fe396eb0fff8dc9c7365e539ece611,1,5,13,18,7,2014-05-21 19:43:33,2014-05-19 17:08:47
7c75cf1da8fe396eb0fff8dc9c7365e539ece611...81b9d6df4f2476f46a5896bafc1639c5899e3130,2,39,11,50,6,2014-05-23 18:57:13,2014-05-20 20:34:25
81b9d6df4f2476f46a5896bafc1639c5899e3130...c86d218c92820da50d97849af2c057498d6c7283,1,7,1,8,2,2014-05-24 23:37:38,2014-05-19 20:56:55
c86d218c92820da50d97849af2c057498d6c7283...57bd9bd1d6f4903d78be8a8d106a2fae2a628be7,1,10,0,10,1,2014-05-24 23:38:05,2014-05-19 20:58:30
57bd9bd1d6f4903d78be8a8d106a2fae2a628be7...87fd9929f9cdc0a287db4603704ff69218a8465c,2,12,12,24,12,2014-05-24 23:45:56,2014-05-09 20:34:55
87fd9929f9cdc0a287db4603704ff69218a8465c...213700b3af4d53ce7e808dce2c638d98fc4f91db,10,499,443,942,15,2014-05-24 23:59:19,2014-05-24 23:59:19
213700b3af4d53ce7e808dce2c638d98fc4f91db...28f06d9343c06e7f2ac46e98bf264f5f9aab8b7f,1,9,0,9,1,2014-05-25 00:04:08,2014-04-17 21:58:05
28f06d9343c06e7f2ac46e98bf264f5f9aab8b7f...93dda51140446d51c5be01aafd2cc8fecb7eff31,1,2,0,2,2,2014-05-25 00:07:00,2014-05-01 19:08:31
93dda51140446d51c5be01aafd2cc8fecb7eff31...03f395347f137afb843e3fcc362181ee7adc884a,1,30,2,32,3,2014-05-25 00:08:32,2014-04-14 16:33:13
03f395347f137afb843e3fcc362181ee7adc884a...9a9b2e504d3c9cbbf4d9f58a1ff0e16c53719169,1,4,0,4,1,2014-05-25 00:10:25,2014-05-19 09:11:37
9a9b2e504d3c9cbbf4d9f58a1ff0e16c53719169...c02fb34f01e88c7f49d3887042f947060a4f4a90,2,60,4,64,5,2014-05-25 02:50:15,2014-05-25 02:50:15
c02fb34f01e88c7f49d3887042f947060a4f4a90...6646cd2d72aecb3b267467598835d0d0ac97614a,9,1433,2,1435,10,2014-05-27 21:37:00,2014-04-14 20:41:39
6646cd2d72aecb3b267467598835d0d0ac97614a...6a8781ee93fca9c8371275545d8190b1c291d5cb,1,1,0,1,1,2014-05-28 20:54:21,2014-05-28 19:06:42
6a8781ee93fca9c8371275545d8190b1c291d5cb...8f8192fa7316bf6823ab140c8fbe6960d5d8124f,1,1,1,2,1,2014-05-29 21:41:15,2014-05-28 22:22:27
8f8192fa7316bf6823ab140c8fbe6960d5d8124f...fa7af2e2b314e3dd615e44226ab61ef57c4a5a29,1,3,1,4,3,2014-05-29 22:13:02,2014-05-15 02:12:46
fa7af2e2b314e3dd615e44226ab61ef57c4a5a29...b1950f5fa70b5ac93f83546f8a49e64e58a35a31,2,101,0,101,6,2014-05-30 12:50:31,2014-05-30 12:42:30
b1950f5fa70b5ac93f83546f8a49e64e58a35a31...c73f7c12cde09575b11db1dba91d852c724d076c,1,16,4,20,1,2014-05-30 17:22:22,2014-05-30 10:24:30
c73f7c12cde09575b11db1dba91d852c724d076c...ad9df9f23b3ff4c831ff642817bd2befb8bf4609,7,101,8,109,12,2014-05-30 18:49:02,2014-05-13 21:01:04
ad9df9f23b3ff4c831ff642817bd2befb8bf4609...2eb48801e124665a72347302534a219edb8ed674,1,19,11,30,3,2014-06-01 14:27:47,2014-03-25 15:14:59
2eb48801e124665a72347302534a219edb8ed674...3f02f1a6a157eda94f8d10edbeb4148a11a4bdc1,4,522,337,859,49,2014-06-01 14:28:56,2014-05-22 15:37:43
3f02f1a6a157eda94f8d10edbeb4148a11a4bdc1...5900e7a03183f052bf5f2f17f177c65062ac75aa,4,255,8,263,6,2014-06-01 14:29:06,2014-05-30 20:59:32
5900e7a03183f052bf5f2f17f177c65062ac75aa...6dc02ec1d08825bb5ecd9b76d786d0d86bf37885,6,145,8,153,14,2014-06-01 14:44:03,2014-05-23 13:53:26
6dc02ec1d08825bb5ecd9b76d786d0d86bf37885...778c80e45507eedd7ed8a0320dab971880697467,1,1,1,2,1,2014-06-01 15:15:20,2014-06-01 15:15:20
778c80e45507eedd7ed8a0320dab971880697467...b064102f7c64fe0aa6ab16ec2378109b8081b286,7,7,7,14,7,2014-06-02 18:28:22,2014-06-02 18:28:22
b064102f7c64fe0aa6ab16ec2378109b8081b286...ac797bc824ca05f700618c23d6ee648ebc285bc5,7,7,7,14,7,2014-06-03 11:48:23,2014-06-03 11:48:23
ac797bc824ca05f700618c23d6ee648ebc285bc5...3b612717c5a5819dce90ccf6d02883108979488e,1,7,3,10,2,2014-06-03 20:01:31,2014-04-30 16:41:16
3b612717c5a5819dce90ccf6d02883108979488e...03c83b974897ce58d7cd6f69e27cae7bc1433e2f,9,423,45,468,21,2014-06-05 23:24:55,2014-06-03 17:57:13
03c83b974897ce58d7cd6f69e27cae7bc1433e2f...e52e4e2deb3732a7414cf64b9525843360f4c26d,2,22,20,42,3,2014-06-06 14:57:09,2014-06-05 23:00:41
e52e4e2deb3732a7414cf64b9525843360f4c26d...f8294a13108b43feb7de435f045b5b363c29faac,3,98,11,109,4,2014-06-06 15:44:44,2014-06-05 15:47:08
f8294a13108b43feb7de435f045b5b363c29faac...90d6761433af542814185a8ec45a11208df9fe6f,2,16,0,16,2,2014-06-06 15:48:08,2014-06-06 15:47:43
90d6761433af542814185a8ec45a11208df9fe6f...3f661319e52ba6cc47155721320fe32791a09958,3,59,8,67,9,2014-06-06 20:51:58,2014-06-06 20:51:58
3f661319e52ba6cc47155721320fe32791a09958...5dfc754e10bc411b0d23b6ec1bdadfe3c72ad91c,7,180,79,259,23,2014-06-06 21:16:50,2014-04-28 20:39:33
5dfc754e10bc411b0d23b6ec1bdadfe3c72ad91c...f65ef0b5c272d94f500ea615e36023b45cdf088e,2,41,12,53,6,2014-06-06 21:59:32,2014-06-06 19:39:33
f65ef0b5c272d94f500ea615e36023b45cdf088e...e017d55474e75ab74a80dac980100326868f38af,7,7,7,14,7,2014-06-07 19:27:02,2014-06-07 19:27:02
e017d55474e75ab74a80dac980100326868f38af...9f566f7fc41d0b0a04e17c45a3f5d5ce34cfdd3d,7,7,7,14,7,2014-06-09 02:35:58,2014-06-09 02:35:58
9f566f7fc41d0b0a04e17c45a3f5d5ce34cfdd3d...4d06e27876697d67348a397955b46dabb8443827,7,7,7,14,7,2014-06-15 14:23:35,2014-06-15 14:23:35
1da2d21ffe90db991715127bd4140bcc83abb98b...1afe5ef9e66f63150ab37446f307097f4b57bf5d,2,2,2,4,2,2014-03-12 21:49:14,2014-03-12 21:49:14
1afe5ef9e66f63150ab37446f307097f4b57bf5d...5b33dcf8eca51d1356d80099ef45276f55353dfc,7,100,84,184,36,2014-03-12 22:05:25,2014-03-11 19:37:50
5b33dcf8eca51d1356d80099ef45276f55353dfc...4c1db9421bd72fdac754ae007e6197b42d9ed5c6,5,18,14,32,13,2014-03-13 02:36:19,2014-03-12 20:19:01
4c1db9421bd72fdac754ae007e6197b42d9ed5c6...a114bf7f701bb7358a6069ce56ec03236da79b89,1,6,1,7,3,2014-03-13 02:37:43,2014-03-13 02:37:43
a114bf7f701bb7358a6069ce56ec03236da79b89...506431db2f82995ecd757820a6071449c628b9d5,1,2,1,3,1,2014-03-13 04:43:07,2014-03-13 04:43:04
506431db2f82995ecd757820a6071449c628b9d5...5253043325f42857efbb732b667ea8261ebcd4df,8,124,2,126,11,2014-03-13 04:50:21,2014-03-13 04:46:39
5253043325f42857efbb732b667ea8261ebcd4df...cc2fbb1b84f935b47f4b771072f8157c14de62cc,1,2,2,4,2,2014-03-13 13:29:12,2014-03-13 13:28:55
cc2fbb1b84f935b47f4b771072f8157c14de62cc...93f3f1b5028c52cdaff5974bf39858ae5e066d5e,1,1,1,2,1,2014-03-13 14:23:14,2014-03-12 22:02:51
93f3f1b5028c52cdaff5974bf39858ae5e066d5e...6ffc04f3f264542114bb1f7c645b899a761deced,2,19,13,32,12,2014-03-13 14:26:02,2014-03-12 23:20:54
6ffc04f3f264542114bb1f7c645b899a761deced...d64b7ee82217d2ac2d22a40d36961453ab8648f3,1,10,6,16,3,2014-03-13 14:26:02,2014-03-12 16:10:32
d64b7ee82217d2ac2d22a40d36961453ab8648f3...e2c1d460b874e4deffcd7f18e32a45284d84d0d5,2,76,0,76,3,2014-03-13 14:32:24,2014-03-12 21:13:24
e2c1d460b874e4deffcd7f18e32a45284d84d0d5...ab90f7fe5ec57e301a672c3696048f5a5c27fb8e,1,1,0,1,1,2014-03-13 14:50:08,2014-03-13 14:50:08
ab90f7fe5ec57e301a672c3696048f5a5c27fb8e...f111b99bd986fca3902730cf394d4f4260116dbe,4,95,14,109,11,2014-03-13 15:11:03,2014-03-12 17:41:48
f111b99bd986fca3902730cf394d4f4260116dbe...a21a6a47fab341155a08bf0505c86f5ac520379b,1,2,5,7,4,2014-03-13 15:32:24,2014-03-06 20:01:06
a21a6a47fab341155a08bf0505c86f5ac520379b...169da10f6c36eeed1655c897612f1ace16114257,1,14,5,19,4,2014-03-13 15:32:24,2014-03-10 18:53:21
169da10f6c36eeed1655c897612f1ace16114257...597bf63f3ae61af0c9994bcb8de06a68a7487e88,1,9,5,14,4,2014-03-13 16:34:59,2014-03-11 20:10:42
597bf63f3ae61af0c9994bcb8de06a68a7487e88...507ee08f3e30ed7ede8388e897efbe826583b31e,1,7,2,9,2,2014-03-13 16:56:04,2014-03-13 14:10:47
507ee08f3e30ed7ede8388e897efbe826583b31e...f40515fa26c91760117593f31e406dc022ea5fff,1,4,4,8,2,2014-03-13 16:56:05,2014-03-13 16:55:29
f40515fa26c91760117593f31e406dc022ea5fff...dc28d4a2d9336904ce302c9c3c8099cb27f402eb,2,212,187,399,25,2014-03-13 17:17:58,2014-03-13 17:17:22
dc28d4a2d9336904ce302c9c3c8099cb27f402eb...a08c9f4ee6d5389b3a6a96f093d8a1fdecc9cb8d,28,98,105,203,67,2014-03-13 19:58:06,2014-03-12 15:50:31
a08c9f4ee6d5389b3a6a96f093d8a1fdecc9cb8d...74ae391fba961176ec63973cc9393e024a21661b,1,7,10,17,6,2014-03-13 20:37:41,2014-03-13 18:50:23
74ae391fba961176ec63973cc9393e024a21661b...3bcbb33bc5f909b59635c5805373885933c8b78c,8,15,19,34,13,2014-03-13 21:00:16,2014-03-11 18:38:27
3bcbb33bc5f909b59635c5805373885933c8b78c...31332f83af8f33d21f34b0972ca0438e5a4db94c,1,0,1,1,1,2014-03-13 21:24:16,2014-03-13 21:24:16
31332f83af8f33d21f34b0972ca0438e5a4db94c...c6bef666334edc794e71ef9ddbbe4cca35fb4da9,1,7,0,7,1,2014-03-13 21:53:14,2014-03-13 19:44:09
c6bef666334edc794e71ef9ddbbe4cca35fb4da9...b83a8b935ac6fc34dffa42202dc22b122d65e02e,1,4,8,12,4,2014-03-14 13:42:56,2014-03-13 20:50:24
b83a8b935ac6fc34dffa42202dc22b122d65e02e...cde863db6f180479e250ea3e2172f624be3d2b18,2,8,3,11,4,2014-03-14 13:42:56,2014-03-14 13:42:52
cde863db6f180479e250ea3e2172f624be3d2b18...e44682821c37fdf3d4fd8cb58dcf5c34181ddbde,9,280,82,362,39,2014-03-14 14:29:28,2014-03-05 17:22:58
e44682821c37fdf3d4fd8cb58dcf5c34181ddbde...eb41492c6f1228077b92239524e4a607b70cd8e3,42,359,393,752,188,2014-03-14 16:05:05,2014-03-03 16:27:18
eb41492c6f1228077b92239524e4a607b70cd8e3...17c1212b5f84b0b2c666adc39c9f23d4a919a137,1,3,3,6,2,2014-03-14 17:35:26,2014-03-14 17:35:26
17c1212b5f84b0b2c666adc39c9f23d4a919a137...346f26f8ca4276c0594483659076400c67fb69b7,3,6,1,7,3,2014-03-14 18:54:20,2014-03-14 18:27:20
346f26f8ca4276c0594483659076400c67fb69b7...1083f8dec3870477407396b307aa426908491aef,1,27,0,27,1,2014-03-14 19:43:14,2014-03-14 18:42:57
1083f8dec3870477407396b307aa426908491aef...03b1216f8e0df3f71bc94e2f3abd4b0d6465a7c4,1,11,1,12,1,2014-03-14 21:06:52,2014-03-14 17:03:45
03b1216f8e0df3f71bc94e2f3abd4b0d6465a7c4...2f406195698b24785db0e46622001ab068c9e7cb,4,13,13,26,17,2014-03-14 21:36:34,2014-03-14 21:27:03
2f406195698b24785db0e46622001ab068c9e7cb...2ab0b308b4d1c045aad6d43faf77a5584892f8da,1,1,1,2,1,2014-03-14 22:06:24,2014-03-14 20:13:04
2ab0b308b4d1c045aad6d43faf77a5584892f8da...63583514f11f910c132e91dadbdc18a9f37adade,1,10,12,22,7,2014-03-15 18:26:35,2014-03-14 21:40:15
63583514f11f910c132e91dadbdc18a9f37adade...35d246c14208ebdba5482ccfdd17f83a3961715b,2,2,2,4,2,2014-03-15 18:46:12,2014-03-15 16:05:46
35d246c14208ebdba5482ccfdd17f83a3961715b...5a03d4cd7c591f43224f90669c3f2b38472567c3,5,68,6,74,13,2014-03-15 18:46:12,2014-03-15 15:59:28
5a03d4cd7c591f43224f90669c3f2b38472567c3...c2e9c9f8c2006b89156a52a2566868ce0e73b744,4,134,13,147,11,2014-03-15 21:13:34,2014-03-15 19:50:02
c2e9c9f8c2006b89156a52a2566868ce0e73b744...15503c9fdade2cd3602efbcb5e587616cb9b76fa,1,2,1,3,1,2014-03-15 23:10:12,2014-03-15 23:10:12
15503c9fdade2cd3602efbcb5e587616cb9b76fa...aaa29361e759a08c9fa9a44e983a962cecacc50b,12,1303,537,1840,234,2014-03-16 23:08:44,2014-03-14 14:04:49
aaa29361e759a08c9fa9a44e983a962cecacc50b...acc47ab1b993d1abc295974200ffc57d98f4b80e,3,106,27,133,24,2014-03-17 10:51:57,2014-03-13 18:13:35
acc47ab1b993d1abc295974200ffc57d98f4b80e...ecc00b5bfba8961e0884e591ba1866eeb0cb67ab,1,0,1,1,1,2014-03-17 08:01:02,2014-03-14 14:30:30
ecc00b5bfba8961e0884e591ba1866eeb0cb67ab...b5756056a7b5acba550a7d31a587f3a5b7651e00,4,40,22,62,9,2014-03-17 14:02:22,2014-03-14 15:59:18
b5756056a7b5acba550a7d31a587f3a5b7651e00...9ebf5f742ed816f1d020b889fe715dc26f3e0b69,1,3,1,4,3,2014-03-17 14:35:17,2014-03-17 14:34:36
9ebf5f742ed816f1d020b889fe715dc26f3e0b69...337b9dd3f926323aae5025acd3a52b8c1c497b2d,1,18,4,22,1,2014-03-17 14:49:26,2014-03-14 19:14:20
337b9dd3f926323aae5025acd3a52b8c1c497b2d...e7b7ed4cfdd110c98dac1d7ffa08be6bd9e25cfe,6,101,77,178,11,2014-03-17 16:09:16,2014-03-17 16:09:16
e7b7ed4cfdd110c98dac1d7ffa08be6bd9e25cfe...db9e1ec03fdb51669a3aa9d7d5af365c40e3daa2,2,2,0,2,2,2014-03-17 17:24:12,2014-03-17 15:55:48
db9e1ec03fdb51669a3aa9d7d5af365c40e3daa2...925d3c57e1c7af4566b989a760d6cfa15bdf3437,1,7,3,10,6,2014-03-17 20:12:01,2014-03-17 18:18:40
925d3c57e1c7af4566b989a760d6cfa15bdf3437...263cf8628ec80c74e5a59334d8998b52227a89c1,3,22,4,26,4,2014-03-17 20:50:49,2014-03-17 18:37:57
263cf8628ec80c74e5a59334d8998b52227a89c1...689e23eace05079e4db58ea92caff2aafb1c75db,1,2,1,3,2,2014-03-17 21:24:14,2014-03-17 20:29:02
689e23eace05079e4db58ea92caff2aafb1c75db...a173f84cb956fadc1169f32709679260bd517585,1,0,16,16,2,2014-03-17 21:32:21,2014-03-17 21:32:05
a173f84cb956fadc1169f32709679260bd517585...298470d138e0596c0f61fff46cbada3bf402a846,2,4,3,7,4,2014-03-17 21:31:11,2014-03-17 20:40:26
298470d138e0596c0f61fff46cbada3bf402a846...e9d85c3804e41730ccbe07efa36bf360ceb4f7e6,1,5,2,7,4,2014-03-17 21:48:06,2014-03-12 18:13:43
e9d85c3804e41730ccbe07efa36bf360ceb4f7e6...7510a554b8f38db470216c8213563b7c25a70896,3,8,4,12,6,2014-03-17 21:48:06,2014-03-12 19:14:18
7510a554b8f38db470216c8213563b7c25a70896...25aac5429dca3dfae108c6137a12d1ed48483b82,3,14,5,19,7,2014-03-17 21:48:07,2014-03-12 19:56:11
25aac5429dca3dfae108c6137a12d1ed48483b82...eaa83e8afb6bd800cbab0de01b051f2e1460a432,1,100,93,193,45,2014-03-17 21:48:07,2014-03-12 19:58:22
eaa83e8afb6bd800cbab0de01b051f2e1460a432...4f05d9ec581d0ab770200e3629ba25eee3715585,3,9,8,17,9,2014-03-17 21:48:08,2014-03-13 19:11:43
4f05d9ec581d0ab770200e3629ba25eee3715585...f0b367f3e04408f66fcc8f5bac1425155deec5c3,1,13,2,15,4,2014-03-17 21:48:08,2014-03-17 15:53:07
f0b367f3e04408f66fcc8f5bac1425155deec5c3...8150cc2965d024e5df989f1fd6742e7b67cf03ec,1,93,100,193,45,2014-03-17 21:55:54,2014-03-17 21:55:54
8150cc2965d024e5df989f1fd6742e7b67cf03ec...9faacb76de23e5b99904b4d5efc9ac2743415e1c,1,1,1,2,1,2014-03-17 21:57:07,2014-03-17 20:57:51
9faacb76de23e5b99904b4d5efc9ac2743415e1c...57eea817bbf74f34113b61e3fbae36d08132b770,1,1,1,2,1,2014-03-17 22:32:57,2014-03-17 22:32:17
57eea817bbf74f34113b61e3fbae36d08132b770...1aad465958f32bad33172b03b26012a786d80a86,1,2,13,15,4,2014-03-18 00:17:02,2014-03-18 00:17:02
1aad465958f32bad33172b03b26012a786d80a86...c2eeebe5c1861b4cbec0a0a2ff180b0adab652cd,1,1,1,2,1,2014-03-18 12:54:21,2014-03-18 12:53:11
c2eeebe5c1861b4cbec0a0a2ff180b0adab652cd...71245a471274b963db720792bd3ea622cce0d70f,4,23,6,29,9,2014-03-18 14:09:20,2014-03-18 05:05:56
71245a471274b963db720792bd3ea622cce0d70f...116cced41aa637ad4ae4042306489a324377b400,4,38,1,39,5,2014-03-18 15:12:09,2014-03-18 15:12:09
116cced41aa637ad4ae4042306489a324377b400...7d5325821e8c859188759e18a720a897c1e9071c,2,0,66,66,2,2014-03-18 18:00:46,2014-03-18 18:00:20
7d5325821e8c859188759e18a720a897c1e9071c...910005e639d96cd79c8d27a0237e3e51821407a5,1,15,1,16,2,2014-03-18 18:09:18,2014-03-18 14:49:26
910005e639d96cd79c8d27a0237e3e51821407a5...b2944e7c7ed6fc5195e99d7d2ec50f887ac1a9b3,1,1,0,1,1,2014-03-18 18:13:58,2014-03-17 21:14:23
b2944e7c7ed6fc5195e99d7d2ec50f887ac1a9b3...24b9ad0bc5029c42fdac44073a3cd75ed2f34780,4,134,27,161,9,2014-03-18 13:33:15,2014-03-12 14:40:00
24b9ad0bc5029c42fdac44073a3cd75ed2f34780...bbeca9384f3231cf6eb5da33a5d9ed52176dd8c3,1,77,0,77,1,2014-03-18 13:33:15,2014-03-14 16:54:18
bbeca9384f3231cf6eb5da33a5d9ed52176dd8c3...4184de903c4b5bb3f698d93aa607dd06756dfe40,1,1,1,2,1,2014-03-18 13:49:00,2014-03-18 13:48:47
4184de903c4b5bb3f698d93aa607dd06756dfe40...6ee3a36bdb672e0e7b893a77334e932d8d1eab8c,33,521,339,860,144,2014-03-18 19:26:25,2014-03-14 19:21:49
6ee3a36bdb672e0e7b893a77334e932d8d1eab8c...fc5ff25399278174f4784b85557a3c86d09e5b06,1,10,1,11,3,2014-03-18 19:33:40,2014-03-18 14:32:04
fc5ff25399278174f4784b85557a3c86d09e5b06...8d170f91b67d6e31677668c8c1e9406de8608fb4,1,4,0,4,4,2014-03-18 20:51:18,2014-03-18 20:42:03
8d170f91b67d6e31677668c8c1e9406de8608fb4...e200a2274f34ba016a123cc4bc943dfe22426e93,3,6,6,12,6,2014-03-18 21:18:12,2014-03-17 16:13:25
e200a2274f34ba016a123cc4bc943dfe22426e93...934c77bf4bc269ef53de4bc5b9b5046b13d1bed5,1,6,2,8,2,2014-03-18 16:19:41,2014-03-17 20:53:32
934c77bf4bc269ef53de4bc5b9b5046b13d1bed5...dcae4f6f020b0ee94a28ecb47577ad30fe11ddae,14,830,141,971,46,2014-03-18 21:51:17,2014-03-15 20:55:41
dcae4f6f020b0ee94a28ecb47577ad30fe11ddae...3b0a2b212f6003b4aaa9d8e1c0d8cb841cd2496f,14,3541,2202,5743,595,2014-03-19 13:52:12,2014-02-28 16:16:26
3b0a2b212f6003b4aaa9d8e1c0d8cb841cd2496f...19ad2f402b588887ede8001116c3ce48329987ab,1,6,3,9,3,2014-03-19 13:52:50,2014-03-18 20:41:24
19ad2f402b588887ede8001116c3ce48329987ab...16be7b9840df1df12421ed7ef009005c7d321ec7,2,14,0,14,3,2014-03-19 13:53:49,2014-03-18 20:12:19
16be7b9840df1df12421ed7ef009005c7d321ec7...eabded8aa6f78949535ed2ad5a2d01d4c3e58ea0,1,2,2,4,1,2014-03-19 14:00:04,2014-03-19 13:58:57
eabded8aa6f78949535ed2ad5a2d01d4c3e58ea0...267f56a7e0ce36eba21b4b2ef09e32a43370acbf,2,36,23,59,10,2014-03-19 14:42:29,2014-03-19 13:27:10
267f56a7e0ce36eba21b4b2ef09e32a43370acbf...dc7611456d70964939a8fad7a7679282c9666cea,1,1,1,2,1,2014-03-19 16:12:31,2014-03-19 16:12:31
dc7611456d70964939a8fad7a7679282c9666cea...9a53f30468a0c68e1167ce565041bbce22add8ff,1,1,1,2,1,2014-03-19 12:39:57,2014-03-18 11:56:37
9a53f30468a0c68e1167ce565041bbce22add8ff...ab95906e2ec341ce1298c7a4eab2185cf386d8cb,1,4,2,6,5,2014-03-19 18:50:22,2014-03-19 18:44:27
ab95906e2ec341ce1298c7a4eab2185cf386d8cb...3e0aa5769dd58c727726c3397f9678d7f767b7ff,1,4,4,8,4,2014-03-19 19:02:39,2014-03-14 22:58:12
3e0aa5769dd58c727726c3397f9678d7f767b7ff...9e8eb0482d9cdffe67c35757a5dfed73860582f4,1,1,1,2,1,2014-03-19 19:28:37,2014-03-19 17:29:54
9e8eb0482d9cdffe67c35757a5dfed73860582f4...4a299302a7312cebb076d0b356c5235c2f45918c,1,1,1,2,1,2014-03-19 19:30:13,2014-03-19 19:28:17
4a299302a7312cebb076d0b356c5235c2f45918c...b77054ef247c2b6ac11780f0a8676ecd0b4c3151,9,748,469,1217,87,2014-03-19 20:43:37,2014-03-17 22:09:24
b77054ef247c2b6ac11780f0a8676ecd0b4c3151...7300f943ab5423dfcf8ad66d916648a86f861b47,3,347,343,690,56,2014-03-19 21:01:29,2014-03-13 17:37:23
7300f943ab5423dfcf8ad66d916648a86f861b47...f005fc6b5275bda6b6988413d83b61aab099ff63,1,2,2,4,2,2014-03-19 21:04:21,2014-03-19 21:04:11
f005fc6b5275bda6b6988413d83b61aab099ff63...47ce3aebb48d9b9191584e3173774e29a0a3808c,2,19,9,28,6,2014-03-19 21:13:15,2014-03-19 20:40:49
47ce3aebb48d9b9191584e3173774e29a0a3808c...7be64ae7568306dcbf75335a5e80793f4ce1268d,3,14,2,16,6,2014-03-19 21:22:55,2014-03-19 15:30:50
7be64ae7568306dcbf75335a5e80793f4ce1268d...d9e4242d7f8c2631834a8b84cddf2f98cd1971b3,1,1,1,2,1,2014-03-19 22:12:51,2014-03-19 22:12:51
d9e4242d7f8c2631834a8b84cddf2f98cd1971b3...971bbb28a0c25ae26abe9da38e2b02b4cac36d9b,6,160,8,168,10,2014-03-19 23:03:31,2014-03-18 22:40:41
971bbb28a0c25ae26abe9da38e2b02b4cac36d9b...0056ff1c76e30011c6b0688e528ad7a15e0e8591,2,84,18,102,14,2014-03-20 13:20:13,2014-03-18 20:30:25
0056ff1c76e30011c6b0688e528ad7a15e0e8591...b9167f0fe82160967e591aefba5824a8a372353d,8,411,65,476,53,2014-03-20 14:48:00,2014-03-20 13:28:35
b9167f0fe82160967e591aefba5824a8a372353d...bd89a2c8040b17a7bd2c6d7e94199f26316bbd9b,1,4,0,4,4,2014-03-20 15:16:12,2014-03-20 15:16:12
bd89a2c8040b17a7bd2c6d7e94199f26316bbd9b...7001e916bd78097b34812c263274eaeb5fd712cf,1,7,5,12,4,2014-03-20 15:29:35,2014-03-20 15:29:32
7001e916bd78097b34812c263274eaeb5fd712cf...288745abb978e8d444a4e4bcbbd35176f05d2a06,1,5,0,5,1,2014-03-20 16:31:50,2014-03-20 16:31:28
288745abb978e8d444a4e4bcbbd35176f05d2a06...b03ec74111f0dc839d14bacf3f12267133cbc935,2,9,3,12,3,2014-03-20 17:06:04,2014-03-20 13:41:30
b03ec74111f0dc839d14bacf3f12267133cbc935...caf29197bdec6c0f251bae52ece0613beaa43859,1,1,0,1,1,2014-03-20 12:17:56,2014-03-20 11:51:38
caf29197bdec6c0f251bae52ece0613beaa43859...75927c64f1d48c2774d825858e8832f56f7e15cf,3,52,15,67,15,2014-03-20 17:42:37,2014-03-19 21:16:18
75927c64f1d48c2774d825858e8832f56f7e15cf...63fbd2ff4dbe5c80ad2c5ac1b35bc5b06e98a14b,1,0,1,1,1,2014-03-20 19:25:56,2014-03-20 19:25:56
63fbd2ff4dbe5c80ad2c5ac1b35bc5b06e98a14b...6e5c3296a9c8001307176f58fec0e632d0beebd0,2,3,4,7,2,2014-03-20 23:51:25,2014-03-20 20:33:12
6e5c3296a9c8001307176f58fec0e632d0beebd0...064702d6c3d0ef51ae9767390bf664df9f3e30f4,2,7,0,7,2,2014-03-21 13:40:46,2014-03-20 19:35:00
064702d6c3d0ef51ae9767390bf664df9f3e30f4...f6713955af2bfe8a2c5f5ac7d0dfcabebbc821c5,1,16,14,30,2,2014-03-21 14:15:53,2014-03-21 14:15:50
f6713955af2bfe8a2c5f5ac7d0dfcabebbc821c5...70c062eb0646506df8979b49c052a54e6e4f9f8e,16,201,704,905,75,2014-03-21 14:17:33,2014-03-21 14:17:20
70c062eb0646506df8979b49c052a54e6e4f9f8e...7ab2c849633e2162f0b5139f842a1a03731f19b2,1,10,2,12,6,2014-03-21 15:42:37,2014-03-18 21:57:07
7ab2c849633e2162f0b5139f842a1a03731f19b2...926d45b2cd43cf255f0994b9da8e518bc381b794,4,76,9,85,12,2014-03-21 15:47:25,2014-03-20 19:17:23
926d45b2cd43cf255f0994b9da8e518bc381b794...3792e501d812a51b796cc670aaf3e3b8c2439682,1,4,3,7,2,2014-03-21 16:55:05,2014-03-21 16:54:57
3792e501d812a51b796cc670aaf3e3b8c2439682...a79c8cfc2f3d778c9aa11d782b76adeec4624b37,9,321,38,359,24,2014-03-21 16:57:28,2014-03-20 18:57:34
a79c8cfc2f3d778c9aa11d782b76adeec4624b37...6849110b99b4fc4e9fd162ac897e1a8e5180e72e,2,5,0,5,2,2014-03-21 18:00:34,2014-03-21 18:00:34
6849110b99b4fc4e9fd162ac897e1a8e5180e72e...bfebf440342a2266f8febec161334a700dc713af,3,27,6,33,8,2014-03-21 18:25:00,2014-03-21 18:01:44
bfebf440342a2266f8febec161334a700dc713af...9d359723b373e6ca31bbd353f5d3add44777c9a3,1,2,1,3,2,2014-03-24 18:51:40,2014-03-24 18:51:40
9d359723b373e6ca31bbd353f5d3add44777c9a3...9713848c54f3a0a25f9682d21a35179e6b8a3a86,2,62,14,76,4,2014-03-24 19:18:27,2014-03-21 18:59:27
9713848c54f3a0a25f9682d21a35179e6b8a3a86...67fcecca64281afcefce51c61a1f08699145fc56,1,5,1,6,1,2014-03-24 20:32:13,2014-03-21 19:34:08
67fcecca64281afcefce51c61a1f08699145fc56...997eedb2565ac005a7c489d9234813de8b27bc2f,1,3,2,5,2,2014-03-24 20:38:21,2014-03-21 20:00:21
997eedb2565ac005a7c489d9234813de8b27bc2f...632ae4e7ad70426d5e2d36bd1fee4491eeac16b7,1,1,1,2,1,2014-03-24 20:41:23,2014-03-24 19:38:04
632ae4e7ad70426d5e2d36bd1fee4491eeac16b7...84ae6f501a9eb27d19c8c4f668fa806220421f7d,1,2,1,3,1,2014-03-25 08:07:24,2014-03-24 13:01:44
84ae6f501a9eb27d19c8c4f668fa806220421f7d...5138b611cbb384f87c0437d51f1fe3a72a4bf7b4,2,10,1,11,2,2014-03-25 14:24:43,2014-03-25 00:53:48
5138b611cbb384f87c0437d51f1fe3a72a4bf7b4...1f762a3478bb2f794e72670d333f35c6b7e6cfa7,1,1,9,10,4,2014-03-25 15:10:47,2014-03-25 00:16:59
1f762a3478bb2f794e72670d333f35c6b7e6cfa7...b8c7f25613fee7c6bf77dda941589fe367c14385,1,4,0,4,1,2014-03-25 10:50:55,2014-03-25 08:59:46
b8c7f25613fee7c6bf77dda941589fe367c14385...ce5a47a3b506cbd0154c60144deb5cd0e6a3aea9,2,0,169,169,2,2014-03-25 10:58:51,2014-03-21 13:35:02
ce5a47a3b506cbd0154c60144deb5cd0e6a3aea9...835a7cc8ea3c564d34876d20b90b37750d7e30c5,14,312,259,571,25,2014-03-25 17:46:52,2014-03-25 15:09:37
835a7cc8ea3c564d34876d20b90b37750d7e30c5...d238d44ac27a50604279b3c61077b88b5582103a,3,3,3,6,3,2014-03-25 19:57:43,2014-03-19 15:48:00
d238d44ac27a50604279b3c61077b88b5582103a...23adfff477e84ef38d342da5767e77a139bcacfe,1,1,0,1,1,2014-03-25 21:11:59,2014-03-25 20:42:09
23adfff477e84ef38d342da5767e77a139bcacfe...e0867ea625ccca214dd6fbf079001a6b097c0ef2,2,3,2,5,2,2014-03-25 21:45:02,2014-03-24 21:46:54
e0867ea625ccca214dd6fbf079001a6b097c0ef2...e73399e0e696aaaf1e859533e10cc2b74d46994f,1,84,23,107,7,2014-03-25 22:08:04,2014-03-19 22:20:06
e73399e0e696aaaf1e859533e10cc2b74d46994f...57f97f213346b7a0305c81fd70894a77ca35a886,751,31,31700,31731,751,2014-03-25 22:34:49,2014-03-25 19:29:54
57f97f213346b7a0305c81fd70894a77ca35a886...2d1f1b7c5e6a42a503dacee442ec8ebaa11a9ead,1,23,84,107,7,2014-03-26 11:44:49,2014-03-26 11:44:49
2d1f1b7c5e6a42a503dacee442ec8ebaa11a9ead...01a5355e051de90c93a5f1784c05ed314c797c7a,2,4,3,7,4,2014-03-26 16:12:41,2014-03-26 15:08:45
01a5355e051de90c93a5f1784c05ed314c797c7a...5205b62d5c0517a152ce739ab11ec0b3a9cd1859,1,1,1,2,1,2014-03-26 16:40:51,2014-03-26 16:40:51
5205b62d5c0517a152ce739ab11ec0b3a9cd1859...04bb7c24cd09fd54470734f12fcd045f091d1314,1,1,2,3,2,2014-03-26 17:46:19,2014-03-25 21:30:33
04bb7c24cd09fd54470734f12fcd045f091d1314...ecb7f241ec7dc6739a582dcd011a7e9264734c56,2,35,0,35,2,2014-03-26 17:54:41,2014-03-25 20:32:14
ecb7f241ec7dc6739a582dcd011a7e9264734c56...1bd05a191b680ddc258eb6110d1841210f864453,3,7,7,14,5,2014-03-26 18:05:44,2014-03-26 17:41:06
1bd05a191b680ddc258eb6110d1841210f864453...fd1ac5955a4f2d4d0c74ab3e88d4b49169973b11,1,5,2,7,2,2014-03-26 18:28:15,2014-03-18 21:08:59
fd1ac5955a4f2d4d0c74ab3e88d4b49169973b11...386f1b32babc38daafad97949056ac953d53b3b0,13,132,220,352,84,2014-03-26 19:34:37,2014-03-14 15:43:25
386f1b32babc38daafad97949056ac953d53b3b0...ed7c1769b534245f0bd10512c4b4a5995065a371,1,7,5,12,5,2014-03-26 19:54:29,2014-03-26 19:43:53
ed7c1769b534245f0bd10512c4b4a5995065a371...c6be2fcd03d979cdff8c555166c0aece809f63bd,2,2,2,4,2,2014-03-26 20:37:07,2014-03-26 20:37:07
c6be2fcd03d979cdff8c555166c0aece809f63bd...5817556b86b10cb763bba126ae8c020fc1910792,2,16,1,17,4,2014-03-27 14:08:51,2014-03-27 14:08:51
5817556b86b10cb763bba126ae8c020fc1910792...34bf20197d63511d366507a0437bcbc430886452,2,9,3,12,4,2014-03-27 16:04:15,2014-03-27 16:01:31
34bf20197d63511d366507a0437bcbc430886452...06c40ab0bb2a36c709fb4d3b91961e91fb08b1f1,2,20,9,29,6,2014-03-27 17:47:01,2014-03-27 15:42:33
06c40ab0bb2a36c709fb4d3b91961e91fb08b1f1...aa84f525eb4d651b19efef35f83e884adabda4ad,1,1,1,2,1,2014-03-27 18:27:40,2014-03-27 17:01:37
aa84f525eb4d651b19efef35f83e884adabda4ad...9f36a58c417478fb7c56f25f90de4cd5459324c4,5,145,4,149,17,2014-03-27 20:26:24,2014-03-26 02:05:25
9f36a58c417478fb7c56f25f90de4cd5459324c4...39143d55a37ea77b37433b8951a259c30c10cfc9,1,8,5,13,6,2014-03-27 20:59:26,2014-03-27 20:59:26
39143d55a37ea77b37433b8951a259c30c10cfc9...2850ecc726d6ef33ff4284e1ce0378fb42d3b854,4,200,0,200,4,2014-03-27 21:06:37,2014-03-27 20:31:25
2850ecc726d6ef33ff4284e1ce0378fb42d3b854...719134aa7985c0a697f199fc78e323d04e3a65ad,4,153,16,169,19,2014-03-27 21:14:39,2014-03-27 15:18:09
719134aa7985c0a697f199fc78e323d04e3a65ad...d0a1e84ab2fa1b6aa699721b5cb9a4f8d0bf3692,114,7,7,14,4,2014-03-27 21:35:16,2014-03-27 20:15:09
d0a1e84ab2fa1b6aa699721b5cb9a4f8d0bf3692...43d933a286bff0e98845368c84c10248388bc4a5,12,6,0,6,3,2014-03-27 21:35:16,2014-03-27 20:43:39
43d933a286bff0e98845368c84c10248388bc4a5...696fba3bc9607ec5885d072d68c609895b7f5831,2,77,0,77,6,2014-03-27 22:01:03,2014-03-27 20:51:31
696fba3bc9607ec5885d072d68c609895b7f5831...0798ac066e89b53b9dea581ed79737904e4cd8f3,1,3,3,6,3,2014-03-27 22:34:41,2014-03-27 21:46:03
0798ac066e89b53b9dea581ed79737904e4cd8f3...6412fa7eca5c834f29490ab6cdd1cb13b3d99c97,3,78,72,150,23,2014-03-27 22:45:26,2014-03-27 22:01:19
6412fa7eca5c834f29490ab6cdd1cb13b3d99c97...502bb27fae52b9d6a38be9e51e20ac82d8c10f00,1,2,2,4,1,2014-03-27 23:11:58,2014-03-27 20:08:56
502bb27fae52b9d6a38be9e51e20ac82d8c10f00...984fe4b418db3341132026050a446d8c64639881,1,10,10,20,9,2014-03-27 23:12:30,2014-03-27 20:31:37
984fe4b418db3341132026050a446d8c64639881...c27e46eceedfd68801ae79af4a5bf87b86a6319d,8,12,12,24,10,2014-03-27 23:12:36,2014-03-27 20:54:23
c27e46eceedfd68801ae79af4a5bf87b86a6319d...be9cd7b940531fe8a46e669155c81ca14e5189b0,1,3,2,5,1,2014-03-27 23:24:47,2014-03-27 23:23:33
be9cd7b940531fe8a46e669155c81ca14e5189b0...04eda9bb1b5a348201f0b81d56af950c1c538a09,2,79,12,91,4,2014-03-27 23:26:58,2014-03-27 23:24:03
04eda9bb1b5a348201f0b81d56af950c1c538a09...17882d68d1ee00e75e545abe65bda1b18876ef21,7,246,27,273,15,2014-03-27 23:36:36,2014-03-27 15:24:43
17882d68d1ee00e75e545abe65bda1b18876ef21...113d4a9e3d22f6d81e29252ea8170d5f48ad3c5d,3,16,7,23,6,2014-03-27 23:36:36,2014-03-27 21:56:21
113d4a9e3d22f6d81e29252ea8170d5f48ad3c5d...b47447b17e4b9b04d06b663c0c9e81dcd949c530,4,0,200,200,4,2014-03-28 03:41:24,2014-03-28 03:41:24
b47447b17e4b9b04d06b663c0c9e81dcd949c530...c74aba78d60806cb06b07e1307c6f72ae921c206,1,2,2,4,1,2014-03-28 14:26:10,2014-03-28 14:13:41
c74aba78d60806cb06b07e1307c6f72ae921c206...a924eeb8934297f2a499bb0e50cd6835b1741281,1,32,0,32,3,2014-03-28 15:36:18,2014-03-27 21:18:10
a924eeb8934297f2a499bb0e50cd6835b1741281...ec89a420a86c3c918f4bd634fc2134db0a9eb154,5,204,1,205,5,2014-03-28 16:44:07,2014-03-27 20:31:25
ec89a420a86c3c918f4bd634fc2134db0a9eb154...e4c7d8dec2ddd172ad788483846dcf8e670581a5,1,1,1,2,1,2014-03-28 17:21:29,2014-03-28 15:53:10
e4c7d8dec2ddd172ad788483846dcf8e670581a5...086c91313022d75c4ba6a8ee4655c61c84ed2590,8,185,15,200,13,2014-03-28 17:46:53,2014-03-27 21:07:40
086c91313022d75c4ba6a8ee4655c61c84ed2590...9265798fae9f784bff50755260c9536e15ceb7d7,1,7,1,8,2,2014-03-28 17:46:53,2014-03-27 22:03:45
9265798fae9f784bff50755260c9536e15ceb7d7...cbdf562d57b8419aaea83c26effbba14652ea7b3,3,104,10,114,8,2014-03-28 17:46:53,2014-03-27 21:44:53
cbdf562d57b8419aaea83c26effbba14652ea7b3...0a6b69f8b24b474749f5d4227d64ccb034229739,5,187,75,262,13,2014-03-28 17:46:54,2014-03-27 22:42:45
0a6b69f8b24b474749f5d4227d64ccb034229739...c5f52ad447f5ae0c1c577c270bff91c5af0d3436,3,78,4,82,4,2014-03-28 17:46:54,2014-03-27 23:01:00
c5f52ad447f5ae0c1c577c270bff91c5af0d3436...9f0e88d0a4c00c125ce52d3954503dd1c91eae7c,3,59,6,65,5,2014-03-28 17:46:54,2014-03-27 23:28:27
9f0e88d0a4c00c125ce52d3954503dd1c91eae7c...41d6c151f40d40ef0673bb4e5e28d8e9c15e3cc0,4,179,48,227,20,2014-03-28 17:46:54,2014-03-28 00:11:11
41d6c151f40d40ef0673bb4e5e28d8e9c15e3cc0...064fcf3fec061e0f3493f813016ee96a3668d14d,2,51,8,59,6,2014-03-28 17:46:54,2014-03-28 00:32:17
064fcf3fec061e0f3493f813016ee96a3668d14d...0c9df5cebac7a7a9f7a7e5c296af054cc71d20bd,4,38,11,49,6,2014-03-28 17:46:54,2014-03-28 00:43:37
0c9df5cebac7a7a9f7a7e5c296af054cc71d20bd...3973a76ece2b85b8258831ae7dae97e8e3da8eec,3,115,13,128,9,2014-03-28 17:46:54,2014-03-28 13:41:15
3973a76ece2b85b8258831ae7dae97e8e3da8eec...1c2ec3d69bbb5b6ae34f57abf1fabcaf32833a57,3,70,19,89,11,2014-03-28 17:46:54,2014-03-28 13:57:22
1c2ec3d69bbb5b6ae34f57abf1fabcaf32833a57...6ddce18d5ac886e9dadefb009454d4c8f0d2f5ae,3,131,23,154,5,2014-03-28 17:46:54,2014-03-28 14:11:47
6ddce18d5ac886e9dadefb009454d4c8f0d2f5ae...8d7e71c8c07ff15ece15d5494a77ed42fc309f11,3,83,4,87,5,2014-03-28 17:46:54,2014-03-28 14:24:45
8d7e71c8c07ff15ece15d5494a77ed42fc309f11...3fe346dedc89c9d154b1de30d497ae0caa529ecc,3,97,28,125,14,2014-03-28 17:46:54,2014-03-28 14:43:58
3fe346dedc89c9d154b1de30d497ae0caa529ecc...a574286b4f6d487bc18b214fba8aec5a0f64de66,3,82,16,98,14,2014-03-28 17:46:54,2014-03-28 15:00:46
a574286b4f6d487bc18b214fba8aec5a0f64de66...f90b360d2179857e617d18fb4fbc02a46d5a4780,1,1,1,2,1,2014-03-28 18:51:49,2014-03-28 18:48:24
f90b360d2179857e617d18fb4fbc02a46d5a4780...5b461a3eae881a0ca20fe6659d7959962753bb20,1,55,0,55,1,2014-03-28 18:51:49,2014-03-27 19:43:41
5b461a3eae881a0ca20fe6659d7959962753bb20...31bdbdb213372f9877f370bd072a478ce04060ba,1,66,1,67,6,2014-03-28 18:51:49,2014-03-27 20:24:45
31bdbdb213372f9877f370bd072a478ce04060ba...b59223f406209d8c259f73740631159e9fa0e659,1,0,55,55,1,2014-03-28 18:54:03,2014-03-28 18:54:03
b59223f406209d8c259f73740631159e9fa0e659...01732257a8c2b93e457b8365b31a67841080ba2f,1,1,66,67,6,2014-03-28 18:54:26,2014-03-28 18:54:26
01732257a8c2b93e457b8365b31a67841080ba2f...92ed1aa3e061f4f41d40f5a7463a1a624a28f40b,1,3,3,6,3,2014-03-28 19:02:28,2014-03-28 16:58:55
92ed1aa3e061f4f41d40f5a7463a1a624a28f40b...d75b92d849ebeb60fe8ba8ba43fd3bee114c9043,1,14,0,14,4,2014-03-28 19:05:30,2014-03-28 17:55:53
d75b92d849ebeb60fe8ba8ba43fd3bee114c9043...91a7d38a6beaf53aeb5390e64da7366db5b9d858,3,0,0,0,0,2014-03-29 18:22:17,2014-03-29 18:22:17
91a7d38a6beaf53aeb5390e64da7366db5b9d858...00c8264c88edbbda91c375063c2c612b1db18702,1,12,0,12,6,2014-03-30 16:40:11,2014-03-28 18:52:54
00c8264c88edbbda91c375063c2c612b1db18702...192fd947da5ba99e4a06c769670b08cc9820f955,1,6,1,7,1,2014-03-30 16:40:11,2014-03-28 19:19:20
192fd947da5ba99e4a06c769670b08cc9820f955...5d3070ecd0171700ea30ff7bd698d8b677b50bb6,3,28,12,40,21,2014-03-31 14:15:10,2014-03-29 04:34:24
5d3070ecd0171700ea30ff7bd698d8b677b50bb6...91b9d4ff3e913f74ee75610db2fa6d448b4df0bf,1,6,0,6,1,2014-03-31 14:15:10,2014-03-30 15:06:50
91b9d4ff3e913f74ee75610db2fa6d448b4df0bf...f71610672b0506b233a449bfafb303497c97ae50,9,211,30,241,29,2014-03-31 15:46:53,2014-03-27 16:31:12
f71610672b0506b233a449bfafb303497c97ae50...7ccb298ff2790f4d4b5e844e4124f9051a4ec437,2,42,1,43,3,2014-03-31 17:33:53,2014-03-31 15:10:12
7ccb298ff2790f4d4b5e844e4124f9051a4ec437...6c38102c43fe66faa5c282ac59c206f162ccc6ff,3,20,19,39,11,2014-03-31 17:59:24,2014-03-31 16:50:33
6c38102c43fe66faa5c282ac59c206f162ccc6ff...57be00c6bb250ffb98be5fd1ed86086b3cea7220,1,1,1,2,1,2014-03-31 18:26:59,2014-03-31 18:26:59
57be00c6bb250ffb98be5fd1ed86086b3cea7220...ae59693a8b1f2ed6dbef552ed479671ba70cfc49,1,0,10,10,2,2014-03-31 20:42:11,2014-03-31 20:42:11
ae59693a8b1f2ed6dbef552ed479671ba70cfc49...58f603c00d7ef8372c4f412755e43dee7d7f5ac9,2,35,3,38,4,2014-03-31 22:18:01,2014-03-31 19:50:42
58f603c00d7ef8372c4f412755e43dee7d7f5ac9...26f3c3140d6c49732d3462235d9dd496e17c504f,4,4,56,60,16,2014-03-31 18:08:10,2014-03-31 12:02:32
26f3c3140d6c49732d3462235d9dd496e17c504f...c4f3416806135c1d2d3289a0648fc9dc754a0adf,2,22,4,26,9,2014-04-01 15:02:32,2014-04-01 03:30:17
c4f3416806135c1d2d3289a0648fc9dc754a0adf...cffd39b33fd0c6e311237cacc7360da3ea776a21,1,1,1,2,1,2014-04-01 15:26:50,2014-04-01 14:40:34
cffd39b33fd0c6e311237cacc7360da3ea776a21...54123be0d616307b946122194586bd3cf93d2c3b,1,2,0,2,1,2014-04-01 15:26:50,2014-04-01 15:25:56
54123be0d616307b946122194586bd3cf93d2c3b...cfd144275d53cbca46de3280fdb50a9f10a733af,1,10,0,10,2,2014-04-01 15:52:00,2014-04-01 15:51:53
cfd144275d53cbca46de3280fdb50a9f10a733af...f4e6aa9ee7c0dccbb4789d3dff1d92b086d67b88,3,100,27,127,11,2014-04-01 19:47:12,2014-04-01 18:46:57
f4e6aa9ee7c0dccbb4789d3dff1d92b086d67b88...9d2e260f329696f22a75717510b106ea8c34c1f5,1,16,6,22,6,2014-04-01 20:23:14,2014-04-01 16:01:36
9d2e260f329696f22a75717510b106ea8c34c1f5...7863f05cb1cdb2d56d1f31928ec10521ac4f55f6,1,2,2,4,2,2014-04-01 20:24:01,2014-04-01 15:48:32
7863f05cb1cdb2d56d1f31928ec10521ac4f55f6...4e1eccfe64f424daead6ed22542377d2e1ce798e,8,16,98,114,19,2014-04-01 23:39:09,2014-04-01 17:17:36
4e1eccfe64f424daead6ed22542377d2e1ce798e...11e43325fa2b0139df1eb9c367b984a5b112dbb4,5,15,92,107,10,2014-04-01 23:39:09,2014-04-01 19:24:59
11e43325fa2b0139df1eb9c367b984a5b112dbb4...ad91eb0f75f39c1bb71b5e0ca4279b883cb9fe8d,9,302,391,693,28,2014-04-01 23:39:09,2014-04-01 22:11:43
ad91eb0f75f39c1bb71b5e0ca4279b883cb9fe8d...9e041ccf433660008ed2ddb1c2ed58ba78ef5488,1,53,13,66,9,2014-04-02 00:03:54,2014-04-01 23:34:57
9e041ccf433660008ed2ddb1c2ed58ba78ef5488...9b17edd15ffb0ba3a3a9309fafd9bd4fa04a4d92,9,258,15,273,24,2014-04-02 00:29:48,2014-04-01 19:40:26
9b17edd15ffb0ba3a3a9309fafd9bd4fa04a4d92...df0236cab083063fd125e289c6bac6b017bc6b67,2,3,5,8,2,2014-04-02 06:21:25,2014-04-02 06:21:22
df0236cab083063fd125e289c6bac6b017bc6b67...7a0fbca5a8dad17dcfb16ac4f9aec0d3ea4a64d8,1,2,3,5,1,2014-04-02 10:29:24,2014-04-02 10:29:24
7a0fbca5a8dad17dcfb16ac4f9aec0d3ea4a64d8...9b65ac6d4361c07374b9e95e41afd6c2a3199b8e,2,62,10,72,9,2014-04-02 15:03:03,2014-04-02 14:24:27
9b65ac6d4361c07374b9e95e41afd6c2a3199b8e...93b962665da9d3163cacaf55817d8d60a957a32a,1,25,2,27,4,2014-04-02 16:54:44,2014-04-02 16:54:44
93b962665da9d3163cacaf55817d8d60a957a32a...abf252cfe8833ab15dc8d62e8e05a30108484508,4,8,8,16,6,2014-04-03 16:54:51,2014-04-01 18:07:20
abf252cfe8833ab15dc8d62e8e05a30108484508...30a93a1016c2dc550ab3de3e5bf0e8155209645f,1,4,0,4,1,2014-04-03 16:54:51,2014-03-28 21:39:12
30a93a1016c2dc550ab3de3e5bf0e8155209645f...c7cfb2a6fa35f2d58f73a55ced9c9f3c67097974,2,321,0,321,2,2014-04-03 17:07:58,2014-03-24 22:04:55
c7cfb2a6fa35f2d58f73a55ced9c9f3c67097974...be9a874f3917061dd9e62f6a09edfbfb2de8fb4b,1,385,0,385,1,2014-04-03 17:07:58,2014-03-27 21:52:31
be9a874f3917061dd9e62f6a09edfbfb2de8fb4b...afd86488930bb1fd90815804e666f4a54785cdaf,1,282,0,282,1,2014-04-03 17:07:58,2014-03-28 21:39:50
afd86488930bb1fd90815804e666f4a54785cdaf...962b4ab67f58e80c2ee7d82f9415017d8fc17056,6,134,35,169,26,2014-04-03 17:16:44,2014-04-01 20:57:35
962b4ab67f58e80c2ee7d82f9415017d8fc17056...881b2ee9ff3b4cb1dfe1d01957e717d8497cf8cf,2,31,14,45,6,2014-04-03 17:16:44,2014-04-01 22:26:18
881b2ee9ff3b4cb1dfe1d01957e717d8497cf8cf...db847f131d1810622b974ba2fa20c9d8fd578a2d,1,0,3,3,1,2014-04-03 17:31:48,2014-03-03 18:06:59
db847f131d1810622b974ba2fa20c9d8fd578a2d...ee2e11d9a364677a5d495bf1252e87dcc5f0fb6c,9,69,60,129,45,2014-04-03 17:31:48,2014-03-03 22:39:34
ee2e11d9a364677a5d495bf1252e87dcc5f0fb6c...1e2175e1b4c230c2b7fce724cbafc61c5272b522,6,39,26,65,23,2014-04-03 17:31:48,2014-03-04 21:28:28
1e2175e1b4c230c2b7fce724cbafc61c5272b522...be55e5bab79eb29ce4b6d1027a57fa29421f1f0c,1,0,5,5,1,2014-04-03 17:31:48,2014-03-04 21:28:47
be55e5bab79eb29ce4b6d1027a57fa29421f1f0c...3aacfc36f6aa0a1ee31be5af566cc8a45d32e7d8,6,31,34,65,16,2014-04-03 17:31:48,2014-03-04 21:51:46
3aacfc36f6aa0a1ee31be5af566cc8a45d32e7d8...7c249de45bf8c92359e01fd3b9b0c5a66a4f956d,31,59,83,142,51,2014-04-03 17:31:48,2014-03-04 22:28:45
7c249de45bf8c92359e01fd3b9b0c5a66a4f956d...0070eae2d84ed90b652bc65d35114d5957506ad6,12,10,15,25,15,2014-04-03 17:31:48,2014-03-04 22:43:13
0070eae2d84ed90b652bc65d35114d5957506ad6...93f86aea3fae75a73197592005bd29b4ee52de1a,1,4,0,4,1,2014-04-03 17:31:49,2014-03-05 05:54:27
93f86aea3fae75a73197592005bd29b4ee52de1a...2e594a1219f44752fce9b8d82b22a0f59e4a7bd5,3,7,9,16,6,2014-04-03 17:31:49,2014-03-05 14:37:01
2e594a1219f44752fce9b8d82b22a0f59e4a7bd5...a17800eb598724f240862b3180a1aec29c1d0d52,3,0,24,24,3,2014-04-03 17:31:49,2014-03-05 14:41:10
a17800eb598724f240862b3180a1aec29c1d0d52...17458452bd0ccc6b86a372e9ccc9fd7163af94a4,2,0,19,19,2,2014-04-03 17:31:49,2014-03-06 23:25:19
17458452bd0ccc6b86a372e9ccc9fd7163af94a4...b01c395962d13784af8f7a9055dfd6aa7a53bdef,24,41,12,53,35,2014-04-03 17:31:49,2014-03-07 04:50:11
b01c395962d13784af8f7a9055dfd6aa7a53bdef...b167390a1ef91be758de37a5b585c370be75ee2d,1,15,32,47,10,2014-04-03 17:31:49,2014-03-07 14:44:42
b167390a1ef91be758de37a5b585c370be75ee2d...0987c1d3ce604c0bf0690bd0d0c4eaefebc5e05d,1,9,7,16,5,2014-04-03 17:31:49,2014-03-07 15:10:10
0987c1d3ce604c0bf0690bd0d0c4eaefebc5e05d...d4b46103cb02a8eeafd9376fea533820beb1dbb8,1,4,4,8,4,2014-04-03 17:31:49,2014-03-07 15:15:21
d4b46103cb02a8eeafd9376fea533820beb1dbb8...eecd33eb68036b1d0027b8ee1d297a58a395d9be,1,1,1,2,1,2014-04-03 17:31:49,2014-03-07 15:20:13
eecd33eb68036b1d0027b8ee1d297a58a395d9be...dc05a58dac1e57b60de4494a1cd352c30cf165bf,14,58,67,125,25,2014-04-03 17:31:49,2014-03-07 19:15:26
dc05a58dac1e57b60de4494a1cd352c30cf165bf...0a7fd1fe4dd20ae0ab7d94e66099f609db9a2ea9,10,86,157,243,35,2014-04-03 17:31:49,2014-03-17 17:25:54
0a7fd1fe4dd20ae0ab7d94e66099f609db9a2ea9...186d1545c6eba44e892d9a319a907de6fdf7cc16,4,20,82,102,10,2014-04-03 17:31:49,2014-03-18 16:13:53
186d1545c6eba44e892d9a319a907de6fdf7cc16...9ad381f8f93518a6564799aef0cce14c378157f7,7,84,87,171,24,2014-04-03 17:31:49,2014-03-20 21:23:08
9ad381f8f93518a6564799aef0cce14c378157f7...b62e61ff7ba1a3d36167d55abde95e26bae5dcc4,11,572,330,902,13,2014-04-03 17:31:49,2014-03-24 15:17:46
b62e61ff7ba1a3d36167d55abde95e26bae5dcc4...5234c5739a3dfbba1a831b6b818b29a1e9ec4f0d,6,264,197,461,48,2014-04-03 17:31:49,2014-03-24 16:28:35
5234c5739a3dfbba1a831b6b818b29a1e9ec4f0d...c50dcd3109d76d85c90e5786d5fe7aec73c4f8de,14,111,78,189,16,2014-04-03 17:31:49,2014-03-31 15:11:15
c50dcd3109d76d85c90e5786d5fe7aec73c4f8de...6a330b4d9300e2e0592e6a67687f227c8503b8b5,1,9,8,17,5,2014-04-03 17:31:49,2014-04-01 13:35:55
6a330b4d9300e2e0592e6a67687f227c8503b8b5...825c3fb55d1dd5be42f64268968dcf2366467631,18,39,55,94,38,2014-04-03 17:31:49,2014-04-01 19:03:35
825c3fb55d1dd5be42f64268968dcf2366467631...789097cb1823b849e6598ac8e4a3ecff9befd682,1,16,4,20,8,2014-04-03 18:01:33,2014-04-02 21:45:57
789097cb1823b849e6598ac8e4a3ecff9befd682...bc26f73ef697c844cde8e4561bbf9a9c2f4728be,4,41,3,44,6,2014-04-03 19:42:28,2014-04-02 22:31:50
bc26f73ef697c844cde8e4561bbf9a9c2f4728be...7aa932a23fd1c429d7b3d8cbd96d865526c149c9,4,78,14,92,7,2014-04-03 21:01:11,2014-04-02 21:54:36
7aa932a23fd1c429d7b3d8cbd96d865526c149c9...42e199594d2a9221307317ee6a9ae83b19ef875a,1,11,8,19,1,2014-04-04 11:49:29,2014-04-02 16:56:33
42e199594d2a9221307317ee6a9ae83b19ef875a...acc04078339e0a11a33a22ea7aacad8115d7f399,1,1,1,2,1,2014-04-04 11:49:29,2014-04-03 09:36:58
acc04078339e0a11a33a22ea7aacad8115d7f399...388524c02bd76b1d3af79b8622503f87a391d2fb,1,1,1,2,1,2014-04-04 17:38:32,2014-03-07 14:57:45
388524c02bd76b1d3af79b8622503f87a391d2fb...56136a9d8f165fe9ec74bb4928404206ce63610f,1,2,1,3,1,2014-04-04 17:45:50,2014-04-03 15:58:46
56136a9d8f165fe9ec74bb4928404206ce63610f...1d50eac6f00016a3366827df2e851531f8c56d3b,3,30,19,49,9,2014-04-04 19:03:56,2014-04-04 16:51:32
1d50eac6f00016a3366827df2e851531f8c56d3b...d35fef6dddf7bf0c7b0837ea802bb6e9ab679a83,2,57,58,115,16,2014-04-07 01:17:27,2014-02-05 21:08:31
d35fef6dddf7bf0c7b0837ea802bb6e9ab679a83...8853a39ad644a394c4d137bc132d54914b810c1d,1,2,2,4,2,2014-04-07 15:00:43,2014-03-31 20:45:49
8853a39ad644a394c4d137bc132d54914b810c1d...97bead396f78b168eae2774af5b784827d8341c6,6,78,40,118,23,2014-04-07 16:25:13,2014-04-06 19:07:21
97bead396f78b168eae2774af5b784827d8341c6...08b502f07be3b7ae701a75d753d3216d627d8d05,2,2,3,5,3,2014-04-07 16:38:23,2014-01-27 15:15:11
08b502f07be3b7ae701a75d753d3216d627d8d05...955351dc86f6084b5a71e18d81e8e7c8276c141b,2,13,9,22,6,2014-04-07 16:38:23,2014-01-29 16:05:15
955351dc86f6084b5a71e18d81e8e7c8276c141b...267f602d51fbc7672f9f0cec04fae43174f414d8,1,2,0,2,1,2014-04-07 16:38:23,2014-01-29 16:32:42
267f602d51fbc7672f9f0cec04fae43174f414d8...aea2a0e21cf80b205c09464697e1c5542e805895,5,302,23,325,28,2014-04-07 19:33:23,2014-04-07 14:27:29
aea2a0e21cf80b205c09464697e1c5542e805895...90e2cf22bfe2db9ad8430f4b0aeb6024c709613f,1,80,22,102,6,2014-04-07 19:38:31,2014-04-02 21:32:09
90e2cf22bfe2db9ad8430f4b0aeb6024c709613f...8784c38f824b9666dd3c68b80cd6069ef2970694,1,11,9,20,4,2014-04-07 17:20:17,2014-04-04 12:53:38
8784c38f824b9666dd3c68b80cd6069ef2970694...5f417e02075aa6c5ae80685927cd6fbca4ba6ca2,3,138,0,138,3,2014-04-07 23:05:45,2013-05-17 15:21:44
5f417e02075aa6c5ae80685927cd6fbca4ba6ca2...025a54c830e3315d89475db1ee93b5a99033d726,1,35,1,36,2,2014-04-07 23:09:31,2014-04-04 17:44:48
025a54c830e3315d89475db1ee93b5a99033d726...77d93e43de30b997145c9a8a91d9a47f86b46b56,1,2,0,2,1,2014-04-07 23:09:32,2014-01-27 17:55:30
77d93e43de30b997145c9a8a91d9a47f86b46b56...267065628351063a6738cdba7430ab4701a74325,1,1,3,4,1,2014-04-07 23:09:32,2014-01-27 18:57:14
267065628351063a6738cdba7430ab4701a74325...56f3a5f0f10377b8dc13a22d59b7f90bd173411f,2,4,3,7,3,2014-04-08 01:30:48,2014-04-07 22:39:44
56f3a5f0f10377b8dc13a22d59b7f90bd173411f...b4a2cc96b18cacdfece81215d9d8c7a3a84ba20a,1,20,11,31,5,2014-04-08 17:19:23,2014-04-04 14:17:44
b4a2cc96b18cacdfece81215d9d8c7a3a84ba20a...f35da2d63ff53c494e02ac727399763081f1fcfd,7,143,28,171,29,2014-04-08 18:27:01,2014-04-02 15:02:08
f35da2d63ff53c494e02ac727399763081f1fcfd...aa5a4870cc8ab47482ce04fd8491b4c99dc267db,1,29,18,47,8,2014-04-08 19:33:42,2014-04-06 20:04:10
aa5a4870cc8ab47482ce04fd8491b4c99dc267db...68d42de9a958688acbf659dfb651fb699e9d7394,1,6,1,7,4,2014-04-09 14:10:02,2014-04-09 14:10:02
68d42de9a958688acbf659dfb651fb699e9d7394...5f3174ac46b169a90e1e17a7327a21824609abbf,2,20,18,38,11,2014-04-09 17:20:24,2014-04-08 17:47:34
5f3174ac46b169a90e1e17a7327a21824609abbf...b5c283687ce6c4a753f6c4ddfc5b79c464b23c75,1,6,4,10,2,2014-04-09 17:29:26,2014-04-08 20:48:02
b5c283687ce6c4a753f6c4ddfc5b79c464b23c75...ae2dc0a937cd66c249d0d98802fe8229e1a32df8,3,15,4,19,4,2014-04-09 17:54:56,2014-04-09 17:34:35
ae2dc0a937cd66c249d0d98802fe8229e1a32df8...903047acae35e56863ceae4f1aa12afcf97d0f54,10,50,103,153,34,2014-04-09 20:27:12,2014-04-04 21:51:16
903047acae35e56863ceae4f1aa12afcf97d0f54...e5be760537665a25da2bc632a111859f1b8bbf79,2,27,3,30,3,2014-04-09 20:51:32,2014-04-08 23:55:32
e5be760537665a25da2bc632a111859f1b8bbf79...ef255438ebac75bb2058c12f32a926d46421c692,1,7,1,8,2,2014-04-09 20:53:28,2014-04-09 16:09:05
ef255438ebac75bb2058c12f32a926d46421c692...ba3823f2a7c08a022bebbe8accebba8893582e09,8,65,13,78,15,2014-04-09 16:36:13,2014-04-07 13:08:08
ba3823f2a7c08a022bebbe8accebba8893582e09...40e1398b837bb2a57ad8013391124b054ad4d15b,16,2757,84,2841,49,2014-04-10 18:35:56,2014-04-02 18:49:32
40e1398b837bb2a57ad8013391124b054ad4d15b...cafb450accf68f50dcd2dac70996e680e27f00ac,7,34,8,42,10,2014-04-10 18:47:36,2014-04-04 22:41:23
cafb450accf68f50dcd2dac70996e680e27f00ac...960921b3385b3c43ccf9b5a1872dfd3f51646419,5,123,149,272,7,2014-04-10 18:47:36,2014-04-04 22:49:32
960921b3385b3c43ccf9b5a1872dfd3f51646419...ab19203faf2c00da23b06e7461764aec7d96102c,14,421,458,879,50,2014-04-10 18:47:36,2014-04-09 20:13:46
ab19203faf2c00da23b06e7461764aec7d96102c...fcbc6d24f26f91dab380245ca556c0ebbe4960b2,5,58,26,84,5,2014-04-10 18:47:36,2014-04-09 21:33:03
fcbc6d24f26f91dab380245ca556c0ebbe4960b2...9adb4e12d032c94c77cffe6669456d29b7925b6d,1,2,11,13,7,2014-04-10 18:47:36,2014-04-09 21:40:08
9adb4e12d032c94c77cffe6669456d29b7925b6d...f3e81c695eef53e4fb9754ec4b12d55582e30f6a,13,90,61,151,59,2014-04-10 18:47:36,2014-04-09 22:21:47
f3e81c695eef53e4fb9754ec4b12d55582e30f6a...70d98163d1a90bc4b076f7cd647cfef2c7054be9,3,1,5,6,4,2014-04-10 18:47:36,2014-04-10 02:17:37
70d98163d1a90bc4b076f7cd647cfef2c7054be9...3712f0a20baec00ac2df34c11d450a599360813c,7,14,10,24,12,2014-04-10 18:47:36,2014-04-10 04:53:27
3712f0a20baec00ac2df34c11d450a599360813c...15f51c0a83b73cc42b7335089eb51ac014f08b62,26,315,224,539,79,2014-04-10 21:09:09,2014-04-10 21:09:09
15f51c0a83b73cc42b7335089eb51ac014f08b62...6357353cab44c0a70cca1cb55f28a14ebdf7470a,10,36,21,57,25,2014-04-11 15:23:07,2014-04-11 05:32:21
6357353cab44c0a70cca1cb55f28a14ebdf7470a...84022c1f5ac4023e56c52f5ca8e5a94eb59b4827,3,0,0,0,0,2014-04-11 15:34:40,2014-04-09 21:41:25
84022c1f5ac4023e56c52f5ca8e5a94eb59b4827...ae09128a78571a12d13715afd6c221b7f11d0c22,1,11,78,89,7,2014-04-11 15:37:54,2014-04-11 15:37:46
ae09128a78571a12d13715afd6c221b7f11d0c22...e664a766e564e74cb43386e0f46cd1c453a6bec0,1,10,2,12,3,2014-04-11 16:01:48,2014-04-09 19:24:28
e664a766e564e74cb43386e0f46cd1c453a6bec0...59cd758a960f78810d20fc2ede7355eda5a5164a,1,1,4,5,1,2014-04-11 16:01:48,2014-04-09 19:24:23
59cd758a960f78810d20fc2ede7355eda5a5164a...d53521c9534d579d44582bb06cb37d73ffeab931,2,19,0,19,3,2014-04-11 18:26:54,2014-04-10 00:07:16
d53521c9534d579d44582bb06cb37d73ffeab931...911bbc14a87ded7d53066d9e23ca9cd942107da4,1,51,19,70,7,2014-04-11 19:52:35,2013-12-22 15:30:25
911bbc14a87ded7d53066d9e23ca9cd942107da4...225d63787821ddf35a5c04b7f22ed17da7042210,1,25,77,102,6,2014-04-11 20:26:24,2014-04-11 19:28:03
225d63787821ddf35a5c04b7f22ed17da7042210...4b589d8aab1675e03dc7efafc32239bda660fe96,6,147,9,156,10,2014-04-11 21:01:15,2014-04-09 14:28:13
4b589d8aab1675e03dc7efafc32239bda660fe96...0b1994a25c85324ea413a95ace2470be3efb7db5,6,374,20,394,20,2014-04-11 21:01:15,2014-04-09 16:51:18
0b1994a25c85324ea413a95ace2470be3efb7db5...836b1d82810d4b7d98eed8c789f71ed45f473b85,1,5,1,6,3,2014-04-12 22:40:01,2014-04-12 22:40:01
836b1d82810d4b7d98eed8c789f71ed45f473b85...ef8a276ff82fabbee10de675830defe8de3956be,1,2,0,2,2,2014-04-13 17:04:01,2014-04-11 15:45:52
ef8a276ff82fabbee10de675830defe8de3956be...12a2947ebd5ebbf5282e2d5e2c673eeae840f578,12,29,15,44,19,2014-04-13 17:04:01,2014-04-11 16:50:07
12a2947ebd5ebbf5282e2d5e2c673eeae840f578...78acc64523fbc05cd9a8c2f8980bbe51a0d957e7,9,307,208,515,39,2014-04-14 04:23:08,2014-04-11 18:59:12
78acc64523fbc05cd9a8c2f8980bbe51a0d957e7...9ca0f4423561d2c615f4ae588068e6104794b7ee,1,2,1,3,2,2014-04-14 09:38:42,2014-04-09 16:00:44
9ca0f4423561d2c615f4ae588068e6104794b7ee...2c01237bc054bb4b32226545cba9782b5d87bcf2,13,65,72,137,54,2014-04-14 14:46:16,2014-04-12 13:00:41
2c01237bc054bb4b32226545cba9782b5d87bcf2...3e4b9474749fc3b4df182d813e09a26b0e02fcc6,7,36,12,48,11,2014-04-14 15:16:56,2014-04-11 16:24:37
3e4b9474749fc3b4df182d813e09a26b0e02fcc6...45cf39c95d0fdfcb15b483e2d50b392a95735043,2,12,2,14,3,2014-04-14 15:26:56,2014-04-11 18:12:21
45cf39c95d0fdfcb15b483e2d50b392a95735043...3f2cfa0cb7f9eb60062ca9b12b5a2620f2377d58,10,444,330,774,28,2014-04-14 16:20:47,2014-04-14 15:25:41
3f2cfa0cb7f9eb60062ca9b12b5a2620f2377d58...122aaea7105a99a343c4e2b2934bb1cb731047b2,1,3,3,6,3,2014-04-14 16:27:45,2014-04-09 22:31:55
122aaea7105a99a343c4e2b2934bb1cb731047b2...36498086c193c299a1fb299fbd6b5c6290d0fbac,5,1,79,80,8,2014-04-14 17:26:01,2014-03-24 19:04:40
36498086c193c299a1fb299fbd6b5c6290d0fbac...4ded21c8fa77bce8f2edb4f7d1a360d83c6052fc,1,15,20,35,6,2014-04-14 21:25:16,2014-04-14 19:31:00
4ded21c8fa77bce8f2edb4f7d1a360d83c6052fc...9c39dd9b7be4cb0929f96671c424530d7608ac24,1,3,3,6,3,2014-04-14 16:58:21,2014-04-14 10:26:47
9c39dd9b7be4cb0929f96671c424530d7608ac24...9d1f365bf8f0c3d6192284cffab4e3927722e17c,3,67,4,71,3,2014-04-15 02:36:49,2014-04-14 17:31:31
9d1f365bf8f0c3d6192284cffab4e3927722e17c...1490a4f30f7356c9b47cab77f17937f207f09551,2,3,2,5,2,2014-04-15 03:52:02,2014-04-14 15:41:49
1490a4f30f7356c9b47cab77f17937f207f09551...b3aaf2e5809e272367b0f60f66938d8bf712702c,2,5,10,15,4,2014-04-15 17:10:51,2014-04-14 18:52:07
b3aaf2e5809e272367b0f60f66938d8bf712702c...1249034444dc146eb6177fbe4845e593b807f84d,81,383,405,788,262,2014-04-15 17:26:14,2014-04-09 20:25:42
1249034444dc146eb6177fbe4845e593b807f84d...044e2d91a089efd7da2e044a29dc875c12e5a548,3,6,6,12,3,2014-04-15 18:57:40,2014-04-15 17:11:21
044e2d91a089efd7da2e044a29dc875c12e5a548...194676d5d68993abc3fa709d0661850e699dc154,1,2,2,4,1,2014-04-15 18:57:40,2014-04-15 17:22:56
194676d5d68993abc3fa709d0661850e699dc154...29d7dcd55a761cfa6a1a7e1586b80f9d1083b4f4,2,85,1,86,4,2014-04-15 21:53:47,2014-04-15 13:58:30
29d7dcd55a761cfa6a1a7e1586b80f9d1083b4f4...430cd62d0dfd6d29a9b4768422981c7cd9f1e334,1,5,4,9,2,2014-04-16 11:47:30,2014-04-16 11:40:35
430cd62d0dfd6d29a9b4768422981c7cd9f1e334...a475a70e90015e7db726343344c96446133ec9bf,3,2,13,15,7,2014-04-16 13:12:25,2014-04-14 16:31:20
a475a70e90015e7db726343344c96446133ec9bf...6cef43b78448981533b5fda0da2a553aad9c54f3,1,89,21,110,3,2014-04-16 13:12:25,2014-04-12 18:51:24
6cef43b78448981533b5fda0da2a553aad9c54f3...5aac10481a602c2ca3ce1d24a0c97e3602e33814,2,49,1,50,6,2014-04-16 13:46:32,2014-04-10 16:26:03
5aac10481a602c2ca3ce1d24a0c97e3602e33814...132a84108f529b075c3777e5bb55ac77c52df165,2,75,2,77,3,2014-04-16 14:02:51,2014-04-14 22:25:40
132a84108f529b075c3777e5bb55ac77c52df165...f683256c2d7506629e17e8a50ca9f8ec8d7d1524,1,1,0,1,1,2014-04-16 15:14:22,2014-04-16 15:14:22
f683256c2d7506629e17e8a50ca9f8ec8d7d1524...fad935606f3d7edc4bae30f8f15288a144b4785d,1,0,1,1,1,2014-04-16 15:15:56,2014-04-16 15:15:56
fad935606f3d7edc4bae30f8f15288a144b4785d...3f9e1b02bf10124dba4e264fe1485a39942db9aa,1,15,1,16,2,2014-04-16 12:37:01,2014-04-15 16:12:28
3f9e1b02bf10124dba4e264fe1485a39942db9aa...8bbe304cde912c0e2f96ff6b8f6e4badd90d60f0,2,24,13,37,12,2014-04-16 20:34:11,2014-04-13 10:44:48
8bbe304cde912c0e2f96ff6b8f6e4badd90d60f0...0fbd76d233e213e43f53b8882c4dd3c71897a7f3,4,13,12,25,10,2014-04-16 20:46:28,2014-04-16 20:46:09
0fbd76d233e213e43f53b8882c4dd3c71897a7f3...b1300e3f5656423eac55efaedf6440ab10c37125,1,2,1,3,1,2014-04-16 21:29:17,2014-04-16 20:46:22
b1300e3f5656423eac55efaedf6440ab10c37125...8cc8ec7cd412292a8a54d2765984e8fa1319ba61,1,30,2,32,3,2014-04-17 03:21:07,2014-04-14 16:33:13
8cc8ec7cd412292a8a54d2765984e8fa1319ba61...b34245c1ff87833a307b2eac76bb710ec5033d28,1,86,23,109,7,2014-04-17 03:48:32,2014-03-19 22:20:06
b34245c1ff87833a307b2eac76bb710ec5033d28...9ec25e399fc775361ed37fd5abb78960659a308b,2,47,10,57,5,2014-04-17 04:40:02,2014-04-17 04:40:02
9ec25e399fc775361ed37fd5abb78960659a308b...5e737823b0cd4e56e894fb504c406caa28d8fd34,2,13,5,18,2,2014-04-17 15:07:03,2014-04-15 17:58:21
5e737823b0cd4e56e894fb504c406caa28d8fd34...ce52f313ca52759d606886641f44541bd7baf5bd,2,42,1,43,2,2014-04-17 17:09:27,2014-04-17 14:19:46
ce52f313ca52759d606886641f44541bd7baf5bd...92748f2572fd6492bfccd56e339b7255017d15ee,64,317,265,582,205,2014-04-17 17:14:04,2014-04-17 06:42:34
92748f2572fd6492bfccd56e339b7255017d15ee...03a7be273f670f01f3c510e43464d7ecd1ce2173,55,207,212,419,168,2014-04-17 17:14:04,2014-04-17 16:13:59
03a7be273f670f01f3c510e43464d7ecd1ce2173...5c486649ce4f237db01942e48ea8683489bac8ca,1,12,0,12,1,2014-04-17 18:37:04,2014-04-17 18:18:42
5c486649ce4f237db01942e48ea8683489bac8ca...60bec3d3dd5de5ffe11b11e0177609c9d2406582,4,5,7,12,5,2014-04-17 20:43:28,2014-04-17 20:33:09
60bec3d3dd5de5ffe11b11e0177609c9d2406582...b54e00ff344823cab5133142e38ec1f100728e1c,1,5,0,5,2,2014-04-17 20:43:28,2014-04-17 20:42:45
b54e00ff344823cab5133142e38ec1f100728e1c...44da20890f6af02ba766ca14991bbb072395a7ef,2,50,4,54,4,2014-04-17 21:00:59,2014-04-17 18:52:00
44da20890f6af02ba766ca14991bbb072395a7ef...65213714da82cf43ba5f54d34d1c6a2923d4a0bf,2,4,50,54,4,2014-04-17 22:00:52,2014-04-17 22:00:52
65213714da82cf43ba5f54d34d1c6a2923d4a0bf...0e3d4410933999e94a5937b08491824138c654d6,3,8,12,20,5,2014-04-18 14:13:30,2014-04-18 14:11:47
0e3d4410933999e94a5937b08491824138c654d6...0dee46d4602e4ceefdb8de2697128a03dc13a13a,10,173,131,304,52,2014-04-18 14:24:55,2014-04-18 13:28:14
0dee46d4602e4ceefdb8de2697128a03dc13a13a...b16d3ec219dfe5af1b2f8d5bf435a32a6f47ee4f,1,2,2,4,2,2014-04-18 14:24:55,2014-04-17 20:53:21
b16d3ec219dfe5af1b2f8d5bf435a32a6f47ee4f...b1d30046c769ed625faf301c8b62186c4aeee86e,3,92,66,158,15,2014-04-18 16:01:59,2014-04-17 18:52:00
b1d30046c769ed625faf301c8b62186c4aeee86e...15d785a8f02858e75a6f88c6c5411c77ce4d27c5,1,1,1,2,1,2014-04-18 16:21:43,2014-04-18 16:21:43
15d785a8f02858e75a6f88c6c5411c77ce4d27c5...9dc581691ba4b7fbd84fbb985a4ab826c02abd4d,1,1,0,1,1,2014-04-18 17:37:43,2014-04-14 20:09:18
9dc581691ba4b7fbd84fbb985a4ab826c02abd4d...0c4a35a00126c691e18d9d8de5d2471211e0f57a,1,1,15,16,2,2014-04-18 12:39:40,2014-04-18 12:39:40
0c4a35a00126c691e18d9d8de5d2471211e0f57a...ac43ecd3c540ad5c191dec27d9fb5a7b0ac4e8f9,2,10,4,14,4,2014-04-18 17:42:48,2014-04-18 15:02:21
ac43ecd3c540ad5c191dec27d9fb5a7b0ac4e8f9...8a2d33b071b5c528a65bb921cc778cef31500425,1,20,11,31,3,2014-04-18 17:56:00,2014-04-16 20:54:34
8a2d33b071b5c528a65bb921cc778cef31500425...e6109dcddddb0e5b8b6fe92a026d0588fc3996be,5,656,558,1214,10,2014-04-18 13:00:31,2014-04-17 11:07:30
e6109dcddddb0e5b8b6fe92a026d0588fc3996be...a143e6938be7042e208e3dd0026933bae4b74b97,7,192,112,304,10,2014-04-18 13:00:31,2014-04-17 13:36:10
a143e6938be7042e208e3dd0026933bae4b74b97...ba631b9b40374bf50d14f8f219e1de5d7018623c,7,165,88,253,9,2014-04-18 13:00:31,2014-04-17 14:11:05
ba631b9b40374bf50d14f8f219e1de5d7018623c...82e2c23c71e34833f012435c6a77393ab077e922,14,739,591,1330,75,2014-04-18 19:52:32,2014-04-17 19:20:54
82e2c23c71e34833f012435c6a77393ab077e922...019c401589b34b46bf7bec801e23bd3dd7796151,2,26,14,40,24,2014-04-18 21:01:35,2014-04-18 19:44:57
019c401589b34b46bf7bec801e23bd3dd7796151...978567c61a4b3bd84729a7e2379694fb4fc0c483,5,206,4,210,9,2014-04-18 23:28:50,2014-02-17 22:51:34
978567c61a4b3bd84729a7e2379694fb4fc0c483...c0344ec333e6100c5cd6823aa0d6f5960d45d4aa,4,61,65,126,44,2014-04-19 03:53:14,2014-04-18 17:35:41
c0344ec333e6100c5cd6823aa0d6f5960d45d4aa...1442068ea37842032e170da777ffbbc21a013ddb,6,32,32,64,24,2014-04-19 03:53:14,2014-04-18 18:07:49
1442068ea37842032e170da777ffbbc21a013ddb...2fc9bb1a5d2bd519d3ab06ab6a27e840a436a94c,10,114,33,147,32,2014-04-19 03:53:14,2014-04-18 23:39:26
2fc9bb1a5d2bd519d3ab06ab6a27e840a436a94c...03f1bce19b65d210af089d4e9e052dbab0317bce,27,0,2478,2478,29,2014-04-19 19:02:10,2014-04-16 14:04:54
03f1bce19b65d210af089d4e9e052dbab0317bce...a4fc6b326793de8aaa1301c1c7f20ef71e2d03ea,3,36,43,79,5,2014-04-21 14:45:56,2014-04-21 14:45:56
a4fc6b326793de8aaa1301c1c7f20ef71e2d03ea...15bd7092e059a66ee74b65da9186c29300b70b2a,3,81,2,83,4,2014-04-21 14:58:17,2014-04-21 14:32:51
15bd7092e059a66ee74b65da9186c29300b70b2a...9be380c23afdad4ab7c4b09762f2f3d95caf674f,1,5,2,7,3,2014-04-21 15:17:37,2014-04-18 19:28:21
9be380c23afdad4ab7c4b09762f2f3d95caf674f...001b2c1ee301f814c4b9128b2f0ef1ee1354a4f1,2,123,35,158,21,2014-04-21 15:17:37,2014-04-18 19:28:50
001b2c1ee301f814c4b9128b2f0ef1ee1354a4f1...53cfe8bd7ce31f0e67efcb0fa41a019f110f2a22,4,37,5,42,6,2014-04-21 15:17:37,2014-04-18 21:31:29
53cfe8bd7ce31f0e67efcb0fa41a019f110f2a22...e3ee4aa4b7990921c3b736fd0e6d6339920a48f0,1,3,3,6,3,2014-04-21 10:21:33,2014-04-21 10:21:33
e3ee4aa4b7990921c3b736fd0e6d6339920a48f0...5ca1021ab61f3369378764577bbb2c48c4fdbe4a,6,125,72,197,39,2014-04-21 15:43:55,2014-03-28 21:26:42
5ca1021ab61f3369378764577bbb2c48c4fdbe4a...3286b208b30c43450354422e554070485f526e7b,2,10,0,10,2,2014-04-21 17:56:11,2014-04-21 15:17:47
3286b208b30c43450354422e554070485f526e7b...e87b42c4f13e48078f5c4aefba3caf18dcfba072,3,552,946,1498,5,2014-04-21 19:48:27,2014-04-18 20:54:21
e87b42c4f13e48078f5c4aefba3caf18dcfba072...7acafe85d9bdd63122c19ba1cca86a7f55174941,102,839,1663,2502,540,2014-04-21 20:53:25,2014-03-04 22:41:56
7acafe85d9bdd63122c19ba1cca86a7f55174941...eb4f0532950dece3e06dcb2b45533ecba1733a64,11,0,11,11,11,2014-04-21 21:49:12,2014-04-21 13:28:25
eb4f0532950dece3e06dcb2b45533ecba1733a64...c97c0505fa8436faf2954c07d929b5d761457bf8,8,40,39,79,33,2014-04-21 21:49:12,2014-04-21 13:47:45
c97c0505fa8436faf2954c07d929b5d761457bf8...10c5c1b93a224c45a3dea334978993fc2cbb5877,40,67,67,134,39,2014-04-21 21:49:12,2014-04-21 14:36:32
10c5c1b93a224c45a3dea334978993fc2cbb5877...25f774137afd11d56a6b6d4dcf4ec501d7e3d12b,5,68,46,114,32,2014-04-21 21:49:12,2014-04-21 16:24:08
25f774137afd11d56a6b6d4dcf4ec501d7e3d12b...403a5b620457acbc07526fdc31edb86591727944,40,67,67,134,39,2014-04-21 21:49:12,2014-04-21 17:12:08
403a5b620457acbc07526fdc31edb86591727944...177d92b10d8447eb09cca8c6bd8eed0d9f04bc54,1,3,1,4,1,2014-04-21 22:15:32,2014-04-17 18:18:19
177d92b10d8447eb09cca8c6bd8eed0d9f04bc54...fe4113f77ef77a79741ed557be866df0e4a5272b,13,203,25,228,30,2014-04-22 03:43:24,2014-04-21 21:33:59
fe4113f77ef77a79741ed557be866df0e4a5272b...91039e8d3771b7d30f6ed1a3efc337295b5c1b26,1,30,0,30,1,2014-04-22 04:02:02,2014-04-22 04:02:02
91039e8d3771b7d30f6ed1a3efc337295b5c1b26...3a613a84a4f9a22a70c387e67305dd1b486bae68,2,2,2,4,2,2014-04-22 16:07:03,2014-04-22 16:07:03
3a613a84a4f9a22a70c387e67305dd1b486bae68...54bdb39ba62c25ef59221fcab866501c02a06047,2,36,1,37,2,2014-04-22 18:34:03,2014-04-22 14:58:33
54bdb39ba62c25ef59221fcab866501c02a06047...1be16d8968c6bf39f01c4b3e98f854571a337823,1,9,0,9,1,2014-04-22 19:03:28,2014-04-17 21:58:05
1be16d8968c6bf39f01c4b3e98f854571a337823...f7d78f9511d3e4fa156d6f94322f5a690a21bc20,11,279,350,629,65,2014-04-22 19:15:59,2014-04-15 20:37:13
f7d78f9511d3e4fa156d6f94322f5a690a21bc20...1dd73db967963f6e59342eb4f8850af422ce6a4d,3,132,0,132,5,2014-04-23 12:47:27,2014-03-27 19:21:36
1dd73db967963f6e59342eb4f8850af422ce6a4d...577249db39b95c59e98237326a7bdcfbcdaf9760,4,86,46,132,5,2014-04-23 09:11:03,2014-04-18 11:53:36
577249db39b95c59e98237326a7bdcfbcdaf9760...ee8b798f1c80710b2aee74cc330e56c83ed77278,11,177,95,272,17,2014-04-23 09:11:03,2014-04-18 12:11:41
ee8b798f1c80710b2aee74cc330e56c83ed77278...48c9fd791e72092a72b03520ee55e2dfa94287dc,3,62,24,86,6,2014-04-23 09:11:03,2014-04-18 13:46:04
48c9fd791e72092a72b03520ee55e2dfa94287dc...6ea2f53642fd1fd540aff18447cfe71e0179c86a,9,289,199,488,13,2014-04-23 09:11:03,2014-04-18 14:35:07
6ea2f53642fd1fd540aff18447cfe71e0179c86a...5bee65a2416c4011058df0ba2b1afc0bcc330f7c,6,80,37,117,7,2014-04-23 09:11:03,2014-04-18 14:46:38
5bee65a2416c4011058df0ba2b1afc0bcc330f7c...1402351cdb5d3ff29ce5935e1febaa89343df5da,2,93,56,149,3,2014-04-23 09:11:03,2014-04-18 15:04:35
1402351cdb5d3ff29ce5935e1febaa89343df5da...a41e1361e1133aba2ff28f967e0479af290d399f,2,93,55,148,3,2014-04-23 09:11:03,2014-04-18 16:05:18
a41e1361e1133aba2ff28f967e0479af290d399f...3d8e6088159be99e9ddffe031ee79ae42fb43a4d,6,7,9,16,10,2014-04-23 09:11:03,2014-04-21 12:49:35
3d8e6088159be99e9ddffe031ee79ae42fb43a4d...fa3a365802e4cd79aac25205056b267b5977feae,7,8,9,17,8,2014-04-23 09:11:03,2014-04-21 13:17:05
fa3a365802e4cd79aac25205056b267b5977feae...6b6513333fda24fab92aa807e942a023094d703b,27,26,26,52,26,2014-04-23 09:11:03,2014-04-21 14:11:35
6b6513333fda24fab92aa807e942a023094d703b...e1637840b8e4260494628985c9e348c3d028e7c3,4,389,290,679,5,2014-04-23 09:11:03,2014-04-22 09:09:01
e1637840b8e4260494628985c9e348c3d028e7c3...c081c207dff0bf3eddc990325536240a9bba47ff,2,112,107,219,28,2014-04-23 15:20:17,2014-03-21 17:20:19
c081c207dff0bf3eddc990325536240a9bba47ff...bd1f40ab79656b14874bf3c496ad93fcffa89413,1,10,1,11,3,2014-04-23 17:01:43,2014-04-22 00:07:00
bd1f40ab79656b14874bf3c496ad93fcffa89413...8f8d5ba6a24e897ca55bf987696e0e90d22f9b19,8,322,83,405,25,2014-04-23 18:07:40,2014-04-21 17:52:59
8f8d5ba6a24e897ca55bf987696e0e90d22f9b19...d643a188be017db6e3807611f46758f5c969a02f,2,0,53,53,2,2014-04-23 18:19:16,2014-04-23 17:21:16
d643a188be017db6e3807611f46758f5c969a02f...df2dc878b401e77f7542f43614364b46906a1074,14,86,59,145,22,2014-04-23 18:19:17,2014-04-23 18:04:20
df2dc878b401e77f7542f43614364b46906a1074...09ecb7db7f0b09fd73205c24091c6cd67edf4b74,7,5,31,36,10,2014-04-23 18:46:10,2014-04-23 18:46:10
09ecb7db7f0b09fd73205c24091c6cd67edf4b74...d89481bc923bcbf2a43156c200a978be40a86984,2,10,4,14,4,2014-04-23 19:04:28,2014-04-23 19:04:28
d89481bc923bcbf2a43156c200a978be40a86984...9565dd19d144e44ee2aa993fefd23a234028f376,632,576138,0,576138,632,2014-04-23 19:33:02,2014-04-23 13:19:34
9565dd19d144e44ee2aa993fefd23a234028f376...a548ab727982381949f3817bc222cb8ae05576af,1,4,3,7,3,2014-04-23 19:41:50,2014-04-23 19:40:32
a548ab727982381949f3817bc222cb8ae05576af...6254a575a99d9eeda90b0712efd4486411591212,1,5,1,6,1,2014-04-23 19:43:59,2014-04-17 20:05:55
6254a575a99d9eeda90b0712efd4486411591212...6e962cc091213aaa41303f9fd1b11915047c6419,1,76,44,120,15,2014-04-23 14:45:18,2014-03-21 13:13:26
6e962cc091213aaa41303f9fd1b11915047c6419...f5348c1cece6af262d31ff5a90b912af2d4b3e5b,3,0,240,240,3,2014-04-23 14:45:18,2014-04-23 12:36:53
f5348c1cece6af262d31ff5a90b912af2d4b3e5b...5f762b9ec20ee6be588ac31599a1dde68b84c4e1,2,82,86,168,21,2014-04-23 20:17:17,2014-04-23 20:08:29
5f762b9ec20ee6be588ac31599a1dde68b84c4e1...95dcb5fc8b726263d86cb9ef590bf28d47b1617d,2,1,7,8,3,2014-04-23 21:13:14,2014-04-23 21:13:14
95dcb5fc8b726263d86cb9ef590bf28d47b1617d...daa7222fe86201e487f7b7d0c74bc97ecfd664cb,2,340,15,355,9,2014-04-23 23:16:01,2014-04-23 16:14:53
daa7222fe86201e487f7b7d0c74bc97ecfd664cb...6da81951c0b49c728267b1804f97613e1245aca1,13,226,175,401,52,2014-04-23 23:16:52,2014-04-21 19:12:20
6da81951c0b49c728267b1804f97613e1245aca1...7f8f4b7d140639b00b59047e600c9c793da3a3de,4,22,17,39,14,2014-04-23 23:33:18,2014-04-23 18:01:44
7f8f4b7d140639b00b59047e600c9c793da3a3de...8ef75e363a3ea17f6a5f7be55460c528c6bae32f,10,109,71,180,70,2014-04-24 13:09:00,2014-04-24 12:58:00
8ef75e363a3ea17f6a5f7be55460c528c6bae32f...e02aec12a1af456223482fa0e968440700f2e7cc,1,1,0,1,1,2014-04-24 15:47:28,2014-04-24 15:04:42
e02aec12a1af456223482fa0e968440700f2e7cc...c7f47206ec84013a595d764a3542a3e9ac0305fd,20,80,44,124,46,2014-04-24 16:26:24,2014-04-23 20:17:05
c7f47206ec84013a595d764a3542a3e9ac0305fd...1d6e368b1786a8402ca0f9da956bebdac7618d5c,1,1,1,2,1,2014-04-24 14:33:19,2014-04-24 11:11:37
1d6e368b1786a8402ca0f9da956bebdac7618d5c...38711ac013df44b1bc928f868ee45a9ac93b3ffb,3,78,10,88,13,2014-04-24 20:11:00,2014-04-24 19:27:18
38711ac013df44b1bc928f868ee45a9ac93b3ffb...c6d257962c8ca192f795a74fff8a73f36d28f7f9,3,3,3,6,3,2014-04-24 20:44:05,2014-04-24 20:44:00
c6d257962c8ca192f795a74fff8a73f36d28f7f9...5aa7a7f7025e417022310320044133adcc882343,4,414,361,775,7,2014-04-24 16:20:55,2014-04-23 17:23:50
5aa7a7f7025e417022310320044133adcc882343...f7797f6db6eaf0e3e6be0cdddca6fdf9b6c2d1dc,2,100,70,170,4,2014-04-24 16:20:55,2014-04-23 17:31:15
f7797f6db6eaf0e3e6be0cdddca6fdf9b6c2d1dc...f035a6f1a9b4068aef60173e2d310afa7e9375b2,1,5,5,10,5,2014-04-25 16:37:43,2014-03-27 13:42:02
f035a6f1a9b4068aef60173e2d310afa7e9375b2...1da847d294e83fafbc3ee32fbe8b53096a035396,1,1,1,2,1,2014-04-25 16:37:44,2014-04-07 17:26:12
1da847d294e83fafbc3ee32fbe8b53096a035396...db41e5a2dcbc38914046abadaa787658df523fc3,1,1,11,12,1,2014-04-25 16:37:44,2014-04-09 17:41:08
db41e5a2dcbc38914046abadaa787658df523fc3...84ea70be95e75eacddb05a8b85167741ec699556,1,0,73,73,4,2014-04-25 16:50:06,2014-04-25 16:01:23
84ea70be95e75eacddb05a8b85167741ec699556...00ffa832253b99f4678ae2d0afd561e13add0d94,9,43,250,293,10,2014-04-25 17:08:55,2014-04-25 15:07:44
00ffa832253b99f4678ae2d0afd561e13add0d94...a2a055107fb6818886f1aba4ecb9dd6203b26a7a,1,0,58,58,1,2014-04-25 17:13:46,2014-04-25 17:13:46
a2a055107fb6818886f1aba4ecb9dd6203b26a7a...ece2f2e2b997eb5c21328966ce2ccff9bdfe4db2,1,0,4,4,1,2014-04-25 17:15:53,2014-04-25 12:46:27
ece2f2e2b997eb5c21328966ce2ccff9bdfe4db2...892eb99b4469e2d35570bbfd07f57b87fc2376e0,21,696,647,1343,63,2014-04-25 18:27:37,2014-04-22 21:49:46
892eb99b4469e2d35570bbfd07f57b87fc2376e0...2f43128e39ac950421ed372135806f8ea63b7b08,4,166,0,166,4,2014-04-25 18:34:57,2014-04-25 17:54:44
2f43128e39ac950421ed372135806f8ea63b7b08...5eaa0ff5883a8ec0ff3036242788fdd9d48d76a2,1,3,5,8,1,2014-04-25 19:13:26,2014-04-25 19:05:40
5eaa0ff5883a8ec0ff3036242788fdd9d48d76a2...6fbc9d572a24ce45090dfabaf8f44c64a369900a,1,8,1,9,1,2014-04-25 19:28:39,2014-04-23 19:52:26
6fbc9d572a24ce45090dfabaf8f44c64a369900a...6112a08c4019e9f714dc4f4c4935adf8782829b5,7,25,12,37,16,2014-04-25 19:54:50,2014-04-25 18:13:11
6112a08c4019e9f714dc4f4c4935adf8782829b5...5fba87f7968359e9da16137a97439d9f458ba62a,1,3,0,3,2,2014-04-25 19:56:48,2014-04-25 19:56:48
5fba87f7968359e9da16137a97439d9f458ba62a...e05aaf726c17e9deef9f025f0ffda3cee119bca1,12,4,3132,3136,18,2014-04-25 20:23:19,2014-04-25 20:09:51
e05aaf726c17e9deef9f025f0ffda3cee119bca1...e77625d39452aa0ba5937773496ba3eded2e0b66,3,3,3,6,3,2014-04-26 00:34:05,2014-04-21 17:55:58
e77625d39452aa0ba5937773496ba3eded2e0b66...bced3d215a395fa2872b9931d971fef7138d3e94,1,2,0,2,2,2014-04-26 05:47:45,2014-04-26 05:47:45
bced3d215a395fa2872b9931d971fef7138d3e94...381a35be63129419516c77825c2a27e7fc447e63,36,191,108,299,114,2014-04-26 13:44:01,2014-04-24 21:44:20
381a35be63129419516c77825c2a27e7fc447e63...78c850d9c512596a3a8f7e937840d67f52a14baf,4,77,19,96,21,2014-04-28 14:38:12,2014-04-25 18:16:46
78c850d9c512596a3a8f7e937840d67f52a14baf...1f83b5f5e3ad400fe2de0e7427548cb21a05d751,2,30,0,30,3,2014-04-28 15:54:36,2014-04-28 15:43:49
1f83b5f5e3ad400fe2de0e7427548cb21a05d751...7f7103d7a4d4c22ce17630d46961003bb61cc862,1,5,3,8,4,2014-04-28 16:51:06,2014-04-25 18:42:28
7f7103d7a4d4c22ce17630d46961003bb61cc862...6b0e83f0cf1d4e777986b1fc64f0d3133315bf18,5,75,65,140,9,2014-04-28 12:09:36,2014-04-24 16:03:03
6b0e83f0cf1d4e777986b1fc64f0d3133315bf18...ff276366a823fdbd73be5594244b4bdb4e63e1a0,2,16,3,19,3,2014-04-28 12:14:43,2014-04-28 10:38:03
ff276366a823fdbd73be5594244b4bdb4e63e1a0...f7b71f977621c6e4d992174ef310e58bdeaa8513,6,6,6,12,6,2014-04-28 17:35:06,2014-04-28 13:55:49
f7b71f977621c6e4d992174ef310e58bdeaa8513...eaf1bfff5773147035a3cc21783db32863895824,1,191,1,192,40,2014-04-28 17:37:49,2014-04-28 15:10:06
eaf1bfff5773147035a3cc21783db32863895824...298255a705e81a22c2cd29fc3377b1d6df1c9382,5,35,10,45,14,2014-04-28 17:37:49,2014-04-28 15:27:34
298255a705e81a22c2cd29fc3377b1d6df1c9382...ad335a09ea3c9cc2ee32913b87712db779baf163,1,3,8,11,3,2014-04-28 17:47:21,2014-04-28 16:56:45
ad335a09ea3c9cc2ee32913b87712db779baf163...ffa775e2894f6fae7ff4e79e803d5415f0703c9f,16,53,86,139,52,2014-04-28 18:44:22,2014-04-28 16:51:16
ffa775e2894f6fae7ff4e79e803d5415f0703c9f...f8b37a48243adce8dc6105180b3f529d44fde4b4,3,3,83,86,6,2014-04-28 18:44:22,2014-04-28 18:34:36
f8b37a48243adce8dc6105180b3f529d44fde4b4...1d98478d9d529e886143415cbb5b507362ab45eb,2,4,0,4,2,2014-04-28 18:57:14,2014-04-28 18:57:14
1d98478d9d529e886143415cbb5b507362ab45eb...bdfeec7c13837e7ec120c1a3512ec43143f7d778,1,0,83,83,1,2014-04-28 19:46:26,2014-04-28 18:17:28
bdfeec7c13837e7ec120c1a3512ec43143f7d778...bd1a02385378ee50a33db7c255217c050cc74192,1,3,5,8,2,2014-04-28 20:00:05,2014-04-23 20:17:17
bd1a02385378ee50a33db7c255217c050cc74192...94ff38a9c47047f0f86fd1ae2bbfa1f3a201aa6e,1,18,0,18,2,2014-04-28 20:02:21,2014-04-28 17:58:58
94ff38a9c47047f0f86fd1ae2bbfa1f3a201aa6e...dae1a8b8f32c6fd3ad14e39e6b18085a372460fb,4,36,18,54,7,2014-04-28 20:53:47,2014-04-28 20:33:20
dae1a8b8f32c6fd3ad14e39e6b18085a372460fb...53c628063842c78f3c5d36f2ad8e9f5b32c4da95,11,14,24,38,20,2014-04-28 20:56:46,2014-04-28 18:31:43
53c628063842c78f3c5d36f2ad8e9f5b32c4da95...b01f5a4153638047b7cebb5c60abf32195836ce1,5,269,212,481,134,2014-04-28 20:56:46,2014-04-28 18:51:00
b01f5a4153638047b7cebb5c60abf32195836ce1...24aeb8515961f9dc493addee39ee2d2c78254d90,2,6,1,7,4,2014-04-28 21:01:28,2014-04-28 20:29:47
24aeb8515961f9dc493addee39ee2d2c78254d90...ac3c2c29726cc6f576ffa1343151072b9fae24f1,7,70,47,117,17,2014-04-28 21:51:33,2014-04-28 21:42:55
ac3c2c29726cc6f576ffa1343151072b9fae24f1...a3f67f410b333dde69330eeb138ccc65f2c21045,1,24,3,27,3,2014-04-28 22:44:55,2014-04-28 13:38:32
a3f67f410b333dde69330eeb138ccc65f2c21045...9443c5c229a77366c3593964bd837cb29c2a0524,1,1,1,2,1,2014-04-28 23:09:20,2014-04-28 23:08:26
9443c5c229a77366c3593964bd837cb29c2a0524...6ee00c6473d790afd1d1dd91b7c6991397aaec39,10,29,14,43,23,2014-04-29 13:06:25,2014-04-28 21:10:04
6ee00c6473d790afd1d1dd91b7c6991397aaec39...a16b3afd4f6760a8818da0888ebd330e92d381a2,17,352,233,585,226,2014-04-29 13:06:25,2014-04-28 20:05:38
a16b3afd4f6760a8818da0888ebd330e92d381a2...de5ea8fd8682d086de86636d9fff80720939790e,62,624,357,981,503,2014-04-29 13:14:59,2014-04-29 00:55:18
de5ea8fd8682d086de86636d9fff80720939790e...24cc069b7f2733a926d83727878d11584c439e3b,6,21,168,189,24,2014-04-29 09:43:03,2014-04-23 10:06:53
24cc069b7f2733a926d83727878d11584c439e3b...9938f4c65aba762590385825fcf837a0dfc68733,4,15,78,93,11,2014-04-29 09:43:03,2014-04-23 10:13:55
9938f4c65aba762590385825fcf837a0dfc68733...060ccc05a84d9c9ac142a03165da7af6f972428c,3,81,101,182,16,2014-04-29 09:43:03,2014-04-23 10:39:47
060ccc05a84d9c9ac142a03165da7af6f972428c...6d255ac0173267dca1131d9d1871ee52214bc93c,1,5,1,6,2,2014-04-29 15:11:16,2014-04-29 15:01:09
6d255ac0173267dca1131d9d1871ee52214bc93c...c151e0660b9736fe66b224f1129a16871165251b,1,8,4,12,3,2014-04-29 17:05:43,2014-04-29 17:04:51
c151e0660b9736fe66b224f1129a16871165251b...b64939f3ac16843525adf6f0e893a78409ddaf16,2,22,10,32,7,2014-04-29 17:40:59,2014-04-28 19:00:24
b64939f3ac16843525adf6f0e893a78409ddaf16...8e155fdfaeca8d77e19c0adcb570d3a1029cdccb,2,5,4,9,3,2014-04-29 17:49:32,2014-04-28 21:12:13
8e155fdfaeca8d77e19c0adcb570d3a1029cdccb...bfdfc52bd1dc255cabff83109460e13dd272389b,16,202,124,326,105,2014-04-29 18:10:28,2014-04-29 16:39:52
bfdfc52bd1dc255cabff83109460e13dd272389b...4891ecf3cc7e3a9a059d06c5cc4d88766566cd7f,1,5,0,5,2,2014-04-29 13:14:36,2014-04-29 12:37:43
4891ecf3cc7e3a9a059d06c5cc4d88766566cd7f...cf3d1dd725362dd098af038f99f7fb232e3210b3,3,8,4,12,7,2014-04-29 13:27:29,2014-04-28 18:58:16
cf3d1dd725362dd098af038f99f7fb232e3210b3...ca3f2b297817fc6f1a535bd0281df7ecc3ba6979,21,90,97,187,69,2014-04-29 19:09:57,2014-04-28 21:28:02
ca3f2b297817fc6f1a535bd0281df7ecc3ba6979...20263ce4e9c345a2d3748ef2071f6dc860a092f1,4,156,26,182,21,2014-04-29 19:14:59,2014-04-25 15:26:37
20263ce4e9c345a2d3748ef2071f6dc860a092f1...b36527b1863ed40e527bc80264075c8a09ad4a67,1,8,0,8,2,2014-04-29 19:40:44,2014-04-28 20:34:43
b36527b1863ed40e527bc80264075c8a09ad4a67...da81ef36996268f13b4b62153a766c7f1a1cf93a,10,53,13,66,20,2014-04-29 20:32:22,2014-04-29 20:12:35
da81ef36996268f13b4b62153a766c7f1a1cf93a...d1f3f35e11230d1ee2bf2b81b637427036d72a0a,8,25,39,64,17,2014-04-29 22:19:13,2014-04-29 22:14:09
d1f3f35e11230d1ee2bf2b81b637427036d72a0a...712e4f8063a0e329fd6d69d80d992e2214f97d6e,39,149,1910,2059,140,2014-04-29 22:27:53,2014-04-29 21:20:15
712e4f8063a0e329fd6d69d80d992e2214f97d6e...ed1c2d2db431766492892e68702564f5722f15b0,1,17,6,23,5,2014-04-30 04:16:07,2014-04-30 04:16:07
ed1c2d2db431766492892e68702564f5722f15b0...694c36dbe7de51db9396696c2b89944e1a7dd001,1,5,3,8,2,2014-04-30 12:41:21,2014-04-30 12:39:04
694c36dbe7de51db9396696c2b89944e1a7dd001...6d0f155cdd27b019b2f1ccc4b6b7e8e2c8271b54,22,121,70,191,78,2014-04-30 14:48:16,2014-04-29 15:58:58
6d0f155cdd27b019b2f1ccc4b6b7e8e2c8271b54...36370def1e19eed5fcabd468253c5be0d2b22366,26,61,179,240,83,2014-04-30 14:48:16,2014-04-29 19:23:45
36370def1e19eed5fcabd468253c5be0d2b22366...d747c572cbb9b6d39a64ccdc39dbb6de79c7c654,12,64,39,103,45,2014-04-30 14:49:28,2014-04-29 21:56:56
d747c572cbb9b6d39a64ccdc39dbb6de79c7c654...1c7040dc769b8a7e6c72211a721a33e156364a30,1,2,4,6,1,2014-04-30 10:57:54,2014-04-29 16:03:16
1c7040dc769b8a7e6c72211a721a33e156364a30...e762bdce1224dd40a6848864f072567979db6560,1,14,7,21,1,2014-04-30 18:39:17,2014-04-29 22:11:53
e762bdce1224dd40a6848864f072567979db6560...57e01bdc252cb06225edb0ac5fc712666236dbcf,6,107,53,160,42,2014-04-30 18:52:09,2014-04-30 18:14:30
57e01bdc252cb06225edb0ac5fc712666236dbcf...c7625872ea64c1846c6799966a700d57c6e2ad6e,27,170,137,307,131,2014-04-30 20:02:04,2014-04-30 19:32:46
c7625872ea64c1846c6799966a700d57c6e2ad6e...16c9c3ec7bcff067c7bccef307e2039a13048153,7,49,26,75,29,2014-04-30 20:11:50,2014-04-30 19:17:52
16c9c3ec7bcff067c7bccef307e2039a13048153...22ac42b23ca0f9dd80a62091098b4477944bafcb,2,37,35,72,32,2014-04-30 20:13:01,2014-04-30 19:30:45
22ac42b23ca0f9dd80a62091098b4477944bafcb...5fc98b83d4b68e87493bbe468f2da396b4576568,3,9,6,15,7,2014-04-30 20:26:38,2014-04-30 20:24:00
5fc98b83d4b68e87493bbe468f2da396b4576568...dcd667a21c353cf74a37e99e9645ca9323fc6fb9,11,129,103,232,20,2014-05-01 10:56:39,2014-04-30 14:04:15
dcd667a21c353cf74a37e99e9645ca9323fc6fb9...dd55f4c4b05f77ecd1f434fe0303effc41dc7d3c,2,0,3,3,3,2014-05-01 10:57:06,2014-04-30 14:06:52
dd55f4c4b05f77ecd1f434fe0303effc41dc7d3c...1c8606dd2388cb4cac55cd1f3b9161beb651ac4a,1,3,6,9,2,2014-05-01 10:57:12,2014-04-30 14:11:24
1c8606dd2388cb4cac55cd1f3b9161beb651ac4a...1c59d4244bcfaefaf9e8b15ad8283f8d26da82bb,3,19,10,29,4,2014-05-01 10:57:15,2014-04-30 14:35:17
1c59d4244bcfaefaf9e8b15ad8283f8d26da82bb...c27a52ccc277153e1893561b55c28d5e15c689f3,10,1,11,12,11,2014-05-01 10:57:18,2014-04-30 17:03:57
c27a52ccc277153e1893561b55c28d5e15c689f3...bab9758e5b5daa80d595ab7a0465803b912a8792,5,9,103,112,22,2014-05-01 10:57:21,2014-04-30 17:29:57
bab9758e5b5daa80d595ab7a0465803b912a8792...43d5822e356fe2edab9b3511edd9ccfbf83d776d,1,2,1,3,2,2014-05-01 10:57:24,2014-05-01 10:53:24
43d5822e356fe2edab9b3511edd9ccfbf83d776d...53fa83d5803ded836a032be70abfc57473c1cbaa,1,5,0,5,1,2014-05-01 10:57:27,2014-05-01 10:53:41
53fa83d5803ded836a032be70abfc57473c1cbaa...5b4ad3281493f6fcdccf96781237e79a13b59621,4,113,0,113,9,2014-05-01 13:13:46,2014-04-29 21:32:56
5b4ad3281493f6fcdccf96781237e79a13b59621...10d8b3d7984a4abf0d8f80562d426d2f5f0707c3,7,179,78,257,23,2014-05-01 13:17:40,2014-04-28 20:39:33
10d8b3d7984a4abf0d8f80562d426d2f5f0707c3...b7e3345e989b819b9b82707c49bcfa7188aae767,2,714,0,714,2,2014-05-01 13:35:46,2014-04-23 21:31:49
b7e3345e989b819b9b82707c49bcfa7188aae767...7e3f93197f73e5a2e0d1cff55c928dde102aa970,13,4741,12,4753,18,2014-05-01 13:35:46,2014-04-23 21:31:32
7e3f93197f73e5a2e0d1cff55c928dde102aa970...d3961a489a651d6e05d19fa20499a34a819a5088,13,33,73,106,27,2014-05-01 13:53:56,2014-04-30 19:20:51
d3961a489a651d6e05d19fa20499a34a819a5088...89b89dafcd0c34cd960c2d54de32caa9447151da,1,4,0,4,2,2014-05-01 16:34:12,2014-04-30 20:25:49
89b89dafcd0c34cd960c2d54de32caa9447151da...1f9286c1c7389f409aa94fafa68bf26e9a0c8313,12,18,127,145,22,2014-05-01 16:34:13,2014-04-30 21:07:11
1f9286c1c7389f409aa94fafa68bf26e9a0c8313...4ac7bff98e0c6ffea094afa4155e83e4ce375fd2,8,10,10,20,10,2014-05-01 16:34:13,2014-04-30 21:23:11
4ac7bff98e0c6ffea094afa4155e83e4ce375fd2...e3a0652d1e34b72a08315bc4a8a713bee07ea7a0,6,37,26,63,30,2014-05-01 16:36:50,2014-04-30 22:08:51
e3a0652d1e34b72a08315bc4a8a713bee07ea7a0...f3ce37598c85a56f3b3eb33d6c48196fc811cafb,20,181,108,289,103,2014-05-01 16:36:50,2014-04-30 22:46:24
f3ce37598c85a56f3b3eb33d6c48196fc811cafb...eda1e63580ec6594ad2a693ca8b992c240576f26,5,15,11,26,13,2014-05-01 16:36:50,2014-05-01 00:56:36
eda1e63580ec6594ad2a693ca8b992c240576f26...35562387e6d3e23245529589e264be3551f2dd0b,5,8,8,16,8,2014-05-01 17:00:19,2014-04-16 17:00:52
35562387e6d3e23245529589e264be3551f2dd0b...0ee4735ab8fb718b40e2049d014e17736035ba46,7,7,7,14,7,2014-05-01 17:00:19,2014-04-16 17:27:04
0ee4735ab8fb718b40e2049d014e17736035ba46...4eb9988846e1e7d49ec26facd9a2ff6b89f8cdde,4,534,80,614,43,2014-05-01 17:38:33,2014-04-24 17:13:25
4eb9988846e1e7d49ec26facd9a2ff6b89f8cdde...1d317f1794044fb640e7591a8b611b4374207772,9,932,41,973,21,2014-05-01 17:41:58,2014-04-14 23:05:49
1d317f1794044fb640e7591a8b611b4374207772...7996f704f3802b965841ec4701093bb658b8c900,1,2,2,4,2,2014-05-01 19:45:43,2014-05-01 19:20:50
7996f704f3802b965841ec4701093bb658b8c900...c9b2986a0bf7506b0a4b74b1a6e2eb4422f1f0b7,1,2,2,4,1,2014-05-01 15:01:26,2014-05-01 14:10:37
c9b2986a0bf7506b0a4b74b1a6e2eb4422f1f0b7...1b871f8951d26975625ffb9717dcb609821974d5,2,14,4,18,2,2014-05-01 20:22:05,2013-11-14 22:57:57
1b871f8951d26975625ffb9717dcb609821974d5...2c9c7efd9431419ed19013bf5d6019c8af690404,1,1,1,2,1,2014-05-01 20:35:46,2014-05-01 20:16:38
2c9c7efd9431419ed19013bf5d6019c8af690404...3fd39a9fe002c4bdd762d7434fb244a5b153b018,22,233,212,445,56,2014-05-01 20:45:31,2014-04-25 18:01:09
3fd39a9fe002c4bdd762d7434fb244a5b153b018...6c2cfda2d60f0fda51bb389449b7defff9704b73,1,2,0,2,2,2014-05-01 20:49:50,2014-05-01 19:08:31
6c2cfda2d60f0fda51bb389449b7defff9704b73...d202cb934339c297f1c096e62c6adbae14bcbf89,1,1,1,2,1,2014-05-01 21:03:07,2014-03-04 23:58:40
d202cb934339c297f1c096e62c6adbae14bcbf89...27c128d303d9d3bcdf471d4da69bd1b8940fd038,1,5,1,6,2,2014-05-01 21:27:36,2014-04-29 21:34:05
27c128d303d9d3bcdf471d4da69bd1b8940fd038...066ee29fd28a32b539d98737d2a20f8f9a0c5497,1,42,8,50,7,2014-05-01 21:32:11,2014-05-01 21:30:43
066ee29fd28a32b539d98737d2a20f8f9a0c5497...8d48e785906d31dda3107a4a5a74ef940b4f2c89,2,60,0,60,3,2014-05-01 21:32:12,2014-05-01 21:31:24
8d48e785906d31dda3107a4a5a74ef940b4f2c89...16169267c6ece79e25f2722a50a3f915728fdb09,1,5,1,6,1,2014-05-02 14:38:35,2014-05-01 22:25:05
16169267c6ece79e25f2722a50a3f915728fdb09...352eb1d4e79c4398a7c44f191bd1345f1f642f4d,1,6,1,7,3,2014-05-02 15:39:33,2014-05-02 15:39:33
352eb1d4e79c4398a7c44f191bd1345f1f642f4d...b32f849719c97dc9c73b22178329d4dda7ad1dd6,1,7,3,10,2,2014-05-02 12:51:59,2014-04-30 16:41:16
b32f849719c97dc9c73b22178329d4dda7ad1dd6...4357cef5c06a42ec17e0cf8b5ada46a46f05866c,7,7,7,14,7,2014-05-02 19:00:26,2014-05-02 19:00:26
4357cef5c06a42ec17e0cf8b5ada46a46f05866c...77560aae4f27785ed2005785c5d2310bdcee7129,7,7,7,14,7,2014-05-02 22:31:43,2014-05-02 22:31:43
77560aae4f27785ed2005785c5d2310bdcee7129...8fe31447b9d21521aa8022a24b4b1c27747c2ba5,4,12,12,24,12,2014-05-03 01:29:54,2014-05-02 15:18:51
8fe31447b9d21521aa8022a24b4b1c27747c2ba5...ef53c2435ea7b041fb06ed30ff3baf0ab8c30466,29,86,87,173,71,2014-05-04 21:54:10,2014-05-02 01:47:12
ef53c2435ea7b041fb06ed30ff3baf0ab8c30466...f0ac7d88bf725b11c0e1d55fe920ce7e7945afef,1,1,0,1,1,2014-05-05 08:08:17,2014-05-02 15:07:11
f0ac7d88bf725b11c0e1d55fe920ce7e7945afef...cffe3c8bcfc12852b1413775c4b202ffcecdc46d,10,6,300,306,21,2014-05-05 08:31:58,2014-05-01 16:49:04
cffe3c8bcfc12852b1413775c4b202ffcecdc46d...c1155169f13efd52013f56265878f8beb714fef8,2,11,11,22,8,2014-05-05 08:31:58,2014-05-02 15:06:09
c1155169f13efd52013f56265878f8beb714fef8...165f5e4a2f20f333b158db2ac7aa7bc31bfe904f,2,1,7,8,3,2014-05-05 08:31:58,2014-05-02 15:56:25
165f5e4a2f20f333b158db2ac7aa7bc31bfe904f...ac19e03a1c66037e17e6f057c0a0bb004b2a3977,2,16,2,18,6,2014-05-05 08:43:36,2014-05-01 17:33:47
ac19e03a1c66037e17e6f057c0a0bb004b2a3977...0c2cc0a476ef6f9a5130871bb396a3c4479b60fd,11,96,241,337,30,2014-05-05 17:47:39,2014-05-02 21:35:22
0c2cc0a476ef6f9a5130871bb396a3c4479b60fd...707154a65eab36361052a9ab587e848928f68c89,8,73,124,197,13,2014-05-05 17:47:39,2014-05-03 01:22:49
707154a65eab36361052a9ab587e848928f68c89...9fee47763b3526048d0bdcb512e867e1e440f7a4,8,10,8,18,9,2014-05-05 17:47:39,2014-05-03 01:31:45
9fee47763b3526048d0bdcb512e867e1e440f7a4...65d3507f55a29f6be75542e8f6076de9d0e075c8,8,8,39,47,14,2014-05-05 17:47:39,2014-05-04 16:06:05
65d3507f55a29f6be75542e8f6076de9d0e075c8...6a619d057b31647cf554e87be959297e52627174,2,3,6,9,5,2014-05-05 17:47:39,2014-05-04 21:22:00
6a619d057b31647cf554e87be959297e52627174...d5ac8798ac60c2264b719a3b7e7ee5b5e53e3cf1,15,826,613,1439,59,2014-05-05 17:47:40,2014-05-05 02:51:16
d5ac8798ac60c2264b719a3b7e7ee5b5e53e3cf1...c87abc3fd1bebfe8bb6ae0a640cd3e4a4bcd4a71,4,6,14,20,8,2014-05-05 17:47:40,2014-05-05 17:33:18
c87abc3fd1bebfe8bb6ae0a640cd3e4a4bcd4a71...0417b6581b906a2d8c05fbba41e3961c6beba490,1,1,1,2,1,2014-05-05 20:23:33,2014-05-05 20:23:23
0417b6581b906a2d8c05fbba41e3961c6beba490...9aeb3d4c5a70f8fb3616c5aea22c15db86b0d6e1,3,99,21,120,24,2014-05-05 21:53:02,2014-05-01 21:17:56
9aeb3d4c5a70f8fb3616c5aea22c15db86b0d6e1...9ba412717035fa34502c89e5886fa3a3ae3e05d5,14,29,5892,5921,21,2014-05-05 22:15:47,2014-05-01 20:19:01
9ba412717035fa34502c89e5886fa3a3ae3e05d5...db2cdad2764375b2411776c3aefaccf4fe2ead76,3,0,354,354,3,2014-05-06 02:54:04,2014-05-05 20:47:30
db2cdad2764375b2411776c3aefaccf4fe2ead76...0779e3a8ed27ee72d3a03290856bc189c919957f,1,13,17,30,3,2014-05-06 10:25:33,2014-05-05 13:33:06
0779e3a8ed27ee72d3a03290856bc189c919957f...df2324eb1d6a1ae443b86be704a454399092d64c,1,2,3,5,3,2014-05-06 10:25:33,2014-05-05 18:46:43
df2324eb1d6a1ae443b86be704a454399092d64c...3532d96162ad435ba51329e52adb21d8645d264c,5,59,13,72,13,2014-05-06 16:06:58,2014-05-05 21:31:52
3532d96162ad435ba51329e52adb21d8645d264c...efb6e34939db78e258d2fa18829b4cab3e0ea8bb,5,7,21,28,6,2014-05-06 16:06:58,2014-05-06 01:32:26
efb6e34939db78e258d2fa18829b4cab3e0ea8bb...aa170e9550ae7b88ae129e90d083d6f9373ce1da,10,115,129,244,40,2014-05-06 16:06:58,2014-05-06 02:58:16
aa170e9550ae7b88ae129e90d083d6f9373ce1da...e404acb525bb23a7f75c54e93f124a5141083503,21,317,136,453,24,2014-05-06 16:06:58,2014-05-06 03:36:42
e404acb525bb23a7f75c54e93f124a5141083503...d4ba8bf5b511e62079480f3a5fef7b46bb83691d,5,29,5,34,10,2014-05-06 16:06:58,2014-05-06 03:50:52
d4ba8bf5b511e62079480f3a5fef7b46bb83691d...f4b72de6762487caa997c4ea55cd554aed4f007e,2,120,7,127,2,2014-05-06 16:06:58,2014-05-06 03:53:26
f4b72de6762487caa997c4ea55cd554aed4f007e...5e28d5f23f66f5856d00acef3e23ed9b8bbaa272,6,488,7,495,7,2014-05-06 16:06:58,2014-05-06 06:32:21
5e28d5f23f66f5856d00acef3e23ed9b8bbaa272...8ad5c39a929ee887ba12bcf7f38f319b9908747a,1,1,1,2,1,2014-05-06 16:06:58,2014-05-06 16:04:54
8ad5c39a929ee887ba12bcf7f38f319b9908747a...298a2652a956c823b265cb742b56ce7dec86ef66,1,5,5,10,4,2014-05-06 16:06:58,2014-05-06 16:05:12
298a2652a956c823b265cb742b56ce7dec86ef66...9bfb22bb2a3467852cfa688b41b03267a81b7ef3,1,4,1,5,1,2014-05-06 16:06:59,2014-05-06 16:05:21
9bfb22bb2a3467852cfa688b41b03267a81b7ef3...688b0585cb2cc0cdeffb019f88643b2340c55d17,1,24,0,24,1,2014-05-06 17:03:17,2014-05-02 18:37:31
688b0585cb2cc0cdeffb019f88643b2340c55d17...482bf3dbfcd78372c5483c6d2fc5b026b5a51d55,1,10,4,14,5,2014-05-06 18:58:51,2014-05-05 18:41:59
482bf3dbfcd78372c5483c6d2fc5b026b5a51d55...b9e8c0fc3fb61f15fcd7516760ad4d49f32f5990,1,1,0,1,1,2014-05-06 18:58:51,2014-05-05 18:44:19
b9e8c0fc3fb61f15fcd7516760ad4d49f32f5990...eb97470c0507020e3c0f1cc47751feaa777b5d2e,3,131,9,140,8,2014-05-06 19:52:00,2014-04-30 17:02:47
eb97470c0507020e3c0f1cc47751feaa777b5d2e...6b945ec15c61f6bd4bfbaf382624d886ec8441d2,1,0,3,3,1,2014-05-06 14:59:18,2014-05-06 14:57:08
6b945ec15c61f6bd4bfbaf382624d886ec8441d2...87dc3ae516e1d12a632dc604710661e38ed7b3dd,118,1196,1359,2555,433,2014-05-06 20:32:44,2014-04-25 18:04:36
87dc3ae516e1d12a632dc604710661e38ed7b3dd...3061ab54eb2cc642a279becfca0b93f5e17db117,2,32,1,33,3,2014-05-06 22:43:02,2014-05-06 20:34:27
3061ab54eb2cc642a279becfca0b93f5e17db117...72380726608df663a85bee24d69a20ed2ca8287d,118,1359,1196,2555,433,2014-05-06 23:00:56,2014-05-06 23:00:56
72380726608df663a85bee24d69a20ed2ca8287d...b85d1a63d3d19e0fc07b8ec159214ee92ae3d097,15,56,15,71,20,2014-05-07 16:00:23,2014-04-29 00:06:17
b85d1a63d3d19e0fc07b8ec159214ee92ae3d097...e5657a821b9bbfe195f00da9fde502d7637fa1b5,1,3,3,6,1,2014-05-07 14:03:57,2014-05-06 15:18:46
e5657a821b9bbfe195f00da9fde502d7637fa1b5...167d8d0152a94cbc3a8370bcba23539bbdde930a,1,49,59,108,11,2014-05-07 14:03:57,2014-05-06 16:32:33
167d8d0152a94cbc3a8370bcba23539bbdde930a...8646695444b00a5965f0bd939c5c5c2bc8d4d252,1,2,1,3,2,2014-05-07 14:03:57,2014-05-06 16:58:44
8646695444b00a5965f0bd939c5c5c2bc8d4d252...3926d4db3aab1d65f381afcb39783da0edaa2b7e,1,5,1,6,1,2014-05-07 20:50:26,2014-05-05 15:26:17
3926d4db3aab1d65f381afcb39783da0edaa2b7e...a81767d4db70252fe9997d50a93ed3e7460202f1,1,5,5,10,4,2014-05-07 20:56:10,2014-05-07 18:44:34
a81767d4db70252fe9997d50a93ed3e7460202f1...d900470dc3fbe19539a8404b5216974b9688f90e,2,5,2,7,2,2014-05-07 21:14:55,2014-05-07 19:34:26
d900470dc3fbe19539a8404b5216974b9688f90e...8cd645a8fa0cce6313c4a15e4f3ec4fd8ac2787e,1,14,11,25,7,2014-05-08 02:19:57,2014-05-02 21:41:49
8cd645a8fa0cce6313c4a15e4f3ec4fd8ac2787e...ab47b0b217ab40971a928bbe3d98bd315bbba716,1,23,13,36,13,2014-05-08 02:19:57,2014-05-07 03:54:47
ab47b0b217ab40971a928bbe3d98bd315bbba716...630944421eebbbdbde600b6294e28ec992fc3fba,1,2,1,3,1,2014-05-08 04:33:42,2014-05-08 04:33:42
630944421eebbbdbde600b6294e28ec992fc3fba...0205239ecb579e20b05cee3a0df394eb11ba14ce,1,149,35,184,24,2014-05-08 13:47:31,2014-04-28 19:44:53
0205239ecb579e20b05cee3a0df394eb11ba14ce...c347cac1316fe2663ecc15508ad634ed386f1919,1,28,28,56,1,2014-05-08 18:10:51,2014-05-06 20:03:46
c347cac1316fe2663ecc15508ad634ed386f1919...de1cfe29c20681b4b57bd027e701c314e0635829,1,2,2,4,2,2014-05-08 19:32:38,2014-05-05 22:21:23
de1cfe29c20681b4b57bd027e701c314e0635829...2cc79a4a7fdea39c4b0506ea3adc58bda2a6ab6f,3,3,7,10,4,2014-05-08 19:36:30,2014-05-07 02:09:54
2cc79a4a7fdea39c4b0506ea3adc58bda2a6ab6f...4d03aaed71fae8ff07c48a5789da44f997264d29,3,287,327,614,19,2014-05-08 19:36:30,2014-05-07 22:09:50
4d03aaed71fae8ff07c48a5789da44f997264d29...193aba81f1c9c9c0c0a7e9ba857e7538dc6b6ed0,2,31,9,40,8,2014-05-09 14:12:20,2014-05-07 18:22:05
193aba81f1c9c9c0c0a7e9ba857e7538dc6b6ed0...bd223e14fe2fbbb9dd76a5410ff5ee8c47383758,1,1,1,2,1,2014-05-09 15:11:00,2014-05-09 15:11:00
bd223e14fe2fbbb9dd76a5410ff5ee8c47383758...61117c265fb839b11128fd20d0d2aa9cfe7068d2,1,5,5,10,1,2014-05-09 18:03:21,2014-05-08 20:01:47
61117c265fb839b11128fd20d0d2aa9cfe7068d2...e58b18a859c7d04421ded36a6c0da7c65214132c,2,11,8,19,2,2014-05-09 18:03:21,2014-05-09 16:41:00
e58b18a859c7d04421ded36a6c0da7c65214132c...677bd638dd2eb7f604fe09c61c5f7b9335510eee,9,145,39,184,48,2014-05-09 19:38:26,2014-05-09 18:11:08
677bd638dd2eb7f604fe09c61c5f7b9335510eee...19cceceb780ab13104d5a4e44c373472ac5f430d,2,28,2,30,3,2014-05-09 19:42:05,2013-12-13 15:52:07
19cceceb780ab13104d5a4e44c373472ac5f430d...dddf68d86a8c12b0e37d8b3ccfdb58623aaba4e3,59,529,501,1030,234,2014-05-09 19:53:49,2014-05-07 21:10:59
dddf68d86a8c12b0e37d8b3ccfdb58623aaba4e3...5e60ec670eb67680c08656367e207fa90a80e459,13,137,62,199,31,2014-05-09 20:40:07,2014-05-09 17:23:46
5e60ec670eb67680c08656367e207fa90a80e459...ec8a13b45afa4fb3e7b465f975480319700d77c9,9,52,12,64,16,2014-05-09 20:40:07,2014-05-09 18:18:50
ec8a13b45afa4fb3e7b465f975480319700d77c9...741910616f6b2ce01027d3fed3ac6a0fde604f38,4,98,1,99,6,2014-05-09 20:40:07,2014-05-09 18:47:26
741910616f6b2ce01027d3fed3ac6a0fde604f38...9574543e0519fd0b319378bb9d4e505f4bfaa9ef,1,5,0,5,2,2014-05-09 20:40:07,2014-05-09 19:54:32
9574543e0519fd0b319378bb9d4e505f4bfaa9ef...4fd34d5272e6b282f5b98b7b65c4ba2c092d93fb,2,134,23,157,17,2014-05-09 21:05:29,2014-05-07 15:13:26
4fd34d5272e6b282f5b98b7b65c4ba2c092d93fb...d19801d6209d6635e4fb9c42245723f1f1869bf0,3,38,1,39,4,2014-05-09 21:15:14,2014-05-09 17:55:49
d19801d6209d6635e4fb9c42245723f1f1869bf0...773e718f9bd3097faf695a5faebb24f70e3022de,2,8,1,9,2,2014-05-09 22:23:49,2014-05-09 22:23:29
773e718f9bd3097faf695a5faebb24f70e3022de...86cef383aa9b9918b67622ca090b7b8b6997f38a,7,23,16,39,17,2014-05-09 23:06:30,2014-05-09 21:53:04
86cef383aa9b9918b67622ca090b7b8b6997f38a...bf66780fece7c58d2c1f636764b54e01e55ce2bc,2,12,12,24,12,2014-05-09 23:10:37,2014-05-09 20:34:55
bf66780fece7c58d2c1f636764b54e01e55ce2bc...46b6caa074e7221a60f57e3800dacd09a27348fd,1,2,1,3,1,2014-05-10 01:55:17,2014-05-10 01:53:31
46b6caa074e7221a60f57e3800dacd09a27348fd...1f352f639b9def59f93d1be9200d86d7754f4184,1,2,2,4,2,2014-05-10 01:55:17,2014-05-10 01:55:00
1f352f639b9def59f93d1be9200d86d7754f4184...bde96204088d1ce7caec35de55610c5082d620ab,4,25,12,37,15,2014-05-10 06:03:03,2014-05-10 06:03:03
bde96204088d1ce7caec35de55610c5082d620ab...251d119e685a89d7c7b494d9c6c0f0e3323849ba,4,4,14,18,4,2014-05-12 15:43:14,2014-05-09 19:47:52
251d119e685a89d7c7b494d9c6c0f0e3323849ba...f0596feddd0ffb4ffcb379371d03d0f44e516d0e,1,1,1,2,1,2014-05-12 16:01:10,2014-01-22 22:30:29
f0596feddd0ffb4ffcb379371d03d0f44e516d0e...25d983f9f5e97fdb93525a9686501e66314aaafb,1,28,0,28,3,2014-05-12 16:04:10,2014-05-05 02:26:51
25d983f9f5e97fdb93525a9686501e66314aaafb...e0c924e7e5f174830f580d06d8f5aca4b7eb8c8f,3,588,0,588,3,2014-05-12 16:06:25,2014-05-06 23:32:43
e0c924e7e5f174830f580d06d8f5aca4b7eb8c8f...746576ae51166bb2a1a74ddb637b73679dee254e,3,354,3,357,11,2014-05-12 16:06:25,2014-05-08 23:23:19
746576ae51166bb2a1a74ddb637b73679dee254e...71c1f9ce39e6ba4af19a454febeb164a9b91fc1f,1,1,0,1,1,2014-05-12 16:06:25,2014-05-09 22:49:17
71c1f9ce39e6ba4af19a454febeb164a9b91fc1f...a2ca3a5dc694e17525717f0e78024cc5bb9e16ae,5,5,10,15,8,2014-05-12 17:10:16,2014-05-09 20:05:05
a2ca3a5dc694e17525717f0e78024cc5bb9e16ae...ef7543602423c597472e0d141cc0498b3ad0140c,22,251,210,461,177,2014-05-12 18:28:33,2014-05-11 11:44:43
ef7543602423c597472e0d141cc0498b3ad0140c...bce39f06716e25e8360642d2163af3400bc5e0fc,17,33,18,51,19,2014-05-12 18:38:23,2014-05-08 19:37:30
bce39f06716e25e8360642d2163af3400bc5e0fc...03f0d9c627136c6296de400467bbbbd73c9d7a72,6,1518,16,1534,23,2014-05-12 19:07:00,2014-04-28 20:53:10
03f0d9c627136c6296de400467bbbbd73c9d7a72...ce04ab3728edeff71f0c32590558cb980a07fdb3,6,16,1518,1534,23,2014-05-12 20:21:16,2014-05-12 20:20:00
ce04ab3728edeff71f0c32590558cb980a07fdb3...441b3c183c76399f248205989dec757708601394,6,487,177,664,51,2014-05-13 14:18:09,2014-04-22 19:47:44
441b3c183c76399f248205989dec757708601394...f8f57002f72e38d8595674937cd11df42b4ecba7,6,1518,16,1534,23,2014-05-13 15:07:46,2014-04-28 20:53:10
f8f57002f72e38d8595674937cd11df42b4ecba7...00a7ed1705b7dc6b10ce8f59c06a482ceeeff94a,1,20,5,25,5,2014-05-13 15:10:56,2014-05-12 17:15:19
00a7ed1705b7dc6b10ce8f59c06a482ceeeff94a...a6a0c243b6cd6a5d45c876ab100a21073c070a00,3,73,3,76,8,2014-05-13 18:41:01,2014-05-13 18:40:44
a6a0c243b6cd6a5d45c876ab100a21073c070a00...b3e8e45ea6f346f804161e1fe4043ba3e5850ba8,49,41,652,693,108,2014-05-13 20:07:58,2014-05-12 21:05:11
b3e8e45ea6f346f804161e1fe4043ba3e5850ba8...a503b4b57e57f81bebddd07ed75cf116f23de350,37,566,114,680,110,2014-05-13 21:08:50,2014-05-07 22:01:04
a503b4b57e57f81bebddd07ed75cf116f23de350...5368b375128302c1bb32ec7c5e6d5b7e6c5cd38b,1,3,2,5,1,2014-05-13 21:55:10,2014-05-09 20:29:57
5368b375128302c1bb32ec7c5e6d5b7e6c5cd38b...6ada135a2dfb937106736e37885efc08dadc23f9,23,1000,1168,2168,106,2014-05-13 22:01:22,2014-05-13 20:51:01
6ada135a2dfb937106736e37885efc08dadc23f9...b0c0f83c4ca843412c991db3b21262be8ea78970,2,7,0,7,2,2014-05-14 14:15:56,2014-05-13 19:01:35
b0c0f83c4ca843412c991db3b21262be8ea78970...06033e18fb1fe66d00f130227317d9ae531bb6f5,3,33,8,41,7,2014-05-14 15:21:30,2014-05-13 19:11:58
06033e18fb1fe66d00f130227317d9ae531bb6f5...a51c7bcac0b93ea0a0da73974bac6c469075864d,6,166,40,206,40,2014-05-14 15:21:30,2014-05-13 19:13:06
a51c7bcac0b93ea0a0da73974bac6c469075864d...db7e5996c7da7d3383ae2c211171bb21ae2b7e00,1,20,4,24,7,2014-05-14 15:43:20,2014-05-14 14:47:12
db7e5996c7da7d3383ae2c211171bb21ae2b7e00...b1e42ae09dbcf45e5b35b787743bb183930b20a9,2,86,40,126,17,2014-05-14 15:44:42,2014-05-08 21:27:23
b1e42ae09dbcf45e5b35b787743bb183930b20a9...29a700ada85ff1a11ca428bbf71d337ece2f2c5a,5,41,115,156,22,2014-05-14 16:37:46,2014-05-13 20:17:36
29a700ada85ff1a11ca428bbf71d337ece2f2c5a...088d5e901675e46a07d8f1e959168f6979c5aa5c,1,3,8,11,4,2014-05-14 17:48:45,2014-05-14 16:20:57
088d5e901675e46a07d8f1e959168f6979c5aa5c...304534f11a265d8c18d788623185340c001cc26e,2,40,14,54,6,2014-05-14 17:58:01,2014-05-12 18:39:15
304534f11a265d8c18d788623185340c001cc26e...6378da06b637dbf86f916274c8f0457d925af6a9,50,462,295,757,302,2014-05-14 17:58:01,2014-05-01 19:09:02
6378da06b637dbf86f916274c8f0457d925af6a9...e3885bae0383148dc36274b04662235f978de483,80,214,228,442,216,2014-05-14 18:14:44,2014-05-13 16:47:59
e3885bae0383148dc36274b04662235f978de483...3db68c10d8929a2b52c9ce184c690b1ebd6510ac,1,0,1,1,1,2014-05-14 13:23:08,2014-05-14 10:24:38
3db68c10d8929a2b52c9ce184c690b1ebd6510ac...f5ed485c97b08490f59234bc1ddef2c80c2c88b9,1,1,1,2,1,2014-05-14 20:54:54,2014-05-14 18:21:26
f5ed485c97b08490f59234bc1ddef2c80c2c88b9...d2e4b7d17a8b4a406f053e39f692f394d66e6b11,6,399,3,402,12,2014-05-14 22:07:55,2014-04-28 20:54:17
d2e4b7d17a8b4a406f053e39f692f394d66e6b11...c576cdd324f847e0f047dfa5d1bee429d659efb2,3,45,27,72,28,2014-05-15 13:30:25,2014-05-13 13:31:15
c576cdd324f847e0f047dfa5d1bee429d659efb2...10190dcbcda90ed4accb5a01a57823bf25bbd309,3,49,30,79,29,2014-05-15 13:30:25,2014-05-14 17:55:34
10190dcbcda90ed4accb5a01a57823bf25bbd309...d750344eebf1406abe40fee3948577fbefea8002,1,3,0,3,1,2014-05-15 13:30:25,2014-05-09 15:40:41
d750344eebf1406abe40fee3948577fbefea8002...1b218e1f1ca73f8d373d54b59f6137e167345997,7,277,86,363,20,2014-05-15 14:14:59,2014-05-14 19:48:32
1b218e1f1ca73f8d373d54b59f6137e167345997...94210925c7e7fa6ff5f7d0b1e668512edddc3d1e,2,35,20,55,11,2014-05-15 15:04:20,2014-05-15 15:04:20
94210925c7e7fa6ff5f7d0b1e668512edddc3d1e...2332856f030fb5cbea19ae2b146b3f21b21faa11,1,9,1,10,1,2014-05-15 12:13:42,2014-05-14 13:48:59
2332856f030fb5cbea19ae2b146b3f21b21faa11...71cbb04eb8262b0bdf255056f26101466c11b43d,1,1,1,2,1,2014-05-15 17:54:13,2014-04-30 21:37:07
71cbb04eb8262b0bdf255056f26101466c11b43d...4de88387eec6c0bb08b10d0ba1574a656f56232d,204,1093,1097,2190,1073,2014-05-15 17:56:05,2014-05-15 17:26:48
4de88387eec6c0bb08b10d0ba1574a656f56232d...0dabee8227d445a18fa5e8e49b2be60ba2a0beef,118,1196,1359,2555,433,2014-05-15 18:04:11,2014-05-14 18:11:11
0dabee8227d445a18fa5e8e49b2be60ba2a0beef...f2386b7f2941645d4d2a8538823961630bc8f15d,2,2,2,4,2,2014-05-15 18:04:11,2014-05-14 18:11:41
f2386b7f2941645d4d2a8538823961630bc8f15d...bc9db9c8183917ffbc743424fb97297e9fa75643,7,48,206,254,29,2014-05-15 18:13:29,2014-05-06 15:29:26
bc9db9c8183917ffbc743424fb97297e9fa75643...9628f0418502a97aff046e9ae28bebdab4d6b9cd,8,96,15,111,14,2014-05-15 19:45:20,2014-05-14 20:31:53
9628f0418502a97aff046e9ae28bebdab4d6b9cd...a26f0197137e43e130ee7a8c5e42399f6ccd2005,29,262,294,556,230,2014-05-15 19:51:32,2014-05-15 19:07:14
a26f0197137e43e130ee7a8c5e42399f6ccd2005...0417d9b6639fbcd6f09a6bf2f235668e6b57a809,5,363,74,437,13,2014-05-15 20:01:29,2014-04-03 15:41:41
0417d9b6639fbcd6f09a6bf2f235668e6b57a809...86d6043139f01b438281dc19381bf98f663763a3,4,73,2,75,6,2014-05-16 13:53:25,2014-05-15 16:20:23
86d6043139f01b438281dc19381bf98f663763a3...b8d9a168f7340b54e251310a1d43f5e6354e793b,1,5,5,10,5,2014-05-16 14:17:16,2014-05-15 21:50:49
b8d9a168f7340b54e251310a1d43f5e6354e793b...9bac8024b68ef97aaa0ffaa868ee783fe793f54a,4,23,62,85,12,2014-05-16 14:54:03,2014-05-15 21:47:12
9bac8024b68ef97aaa0ffaa868ee783fe793f54a...6a3d6d0affbff6249caa50897dcbe325eb45aea9,1,3,1,4,3,2014-05-16 15:45:46,2014-05-15 02:12:46
6a3d6d0affbff6249caa50897dcbe325eb45aea9...68c2f37993d8abb7d35a61eb79c7e0e16d021f68,2,35,13,48,5,2014-05-16 16:02:52,2014-05-01 20:05:39
68c2f37993d8abb7d35a61eb79c7e0e16d021f68...c9310a020780e9c226b5ef33ed65c88fce8523b4,1,2,2,4,2,2014-05-16 17:14:57,2014-05-16 15:47:58
c9310a020780e9c226b5ef33ed65c88fce8523b4...a7abb67db6946abfe83f9026758684c85c32720f,2,376,359,735,121,2014-05-16 13:19:20,2014-05-14 15:17:49
a7abb67db6946abfe83f9026758684c85c32720f...50045df21469d45216c5fb8899d68818fcc7f38a,1,1,1,2,1,2014-05-16 13:19:20,2014-05-15 16:59:54
50045df21469d45216c5fb8899d68818fcc7f38a...bf5f075b3b73c242042be8fd2c0b9b60af5f0089,6,49,3,52,8,2014-05-16 18:58:18,2014-05-13 21:01:04
bf5f075b3b73c242042be8fd2c0b9b60af5f0089...b823d270b570cf4da5629959ee6bfc7cdfd69413,414,8781,3769,12550,1259,2014-05-16 19:23:06,2014-05-16 12:57:12
b823d270b570cf4da5629959ee6bfc7cdfd69413...864d86ad02e3de2149b4f80949d66a03cff061d1,1,72,0,72,1,2014-05-16 20:01:50,2014-05-16 00:04:45
864d86ad02e3de2149b4f80949d66a03cff061d1...995c04a16090511692c67a3555bdb61b5a387fa1,63,239,213,452,190,2014-05-16 20:01:50,2014-05-15 23:28:57
995c04a16090511692c67a3555bdb61b5a387fa1...7aa378e7385501e33331be48d604f83460ab4bb3,3,0,279,279,4,2014-05-16 20:02:08,2014-05-16 18:06:34
7aa378e7385501e33331be48d604f83460ab4bb3...ab3997127bfe9d2f2b7ac4d63ace239f0fb51889,1,1,0,1,1,2014-05-16 20:10:30,2014-05-16 20:06:48
ab3997127bfe9d2f2b7ac4d63ace239f0fb51889...babe3e3aef00da003ba947c618c1ce00a4b6e4b7,1,0,1,1,1,2014-05-16 20:11:12,2014-05-16 18:33:18
babe3e3aef00da003ba947c618c1ce00a4b6e4b7...7b1fc98747bd70134da28c8991ddf6dd90d90c87,1,3,1,4,3,2014-05-16 20:43:38,2014-05-15 20:40:15
7b1fc98747bd70134da28c8991ddf6dd90d90c87...8304a6f7c0594704ffe73e513da6de55d828caba,1,105,86,191,13,2014-05-16 20:45:13,2014-05-13 22:08:07
8304a6f7c0594704ffe73e513da6de55d828caba...6bde1a8e10b5b11fa4097b689f38d2bbb2b0363f,2,35,23,58,18,2014-05-16 20:45:15,2014-05-13 23:13:06
6bde1a8e10b5b11fa4097b689f38d2bbb2b0363f...2917ad0fb30d8b682e6497645104eaf14b531b74,2,277,6,283,6,2014-05-16 20:48:24,2014-05-14 19:15:45
2917ad0fb30d8b682e6497645104eaf14b531b74...9cfae91efb4c62051d2d460f4cf7c4cb6d10950c,8,539,31,570,29,2014-05-16 20:48:54,2014-05-15 19:42:47
9cfae91efb4c62051d2d460f4cf7c4cb6d10950c...47de28a936dd9d8081089d3e761c2ce74c1ad19f,6,3,49,52,8,2014-05-16 21:14:10,2014-05-16 21:14:10
47de28a936dd9d8081089d3e761c2ce74c1ad19f...26ce741fb87fb9a9b784fa1e3ea88a713b802bc6,1,0,4,4,1,2014-05-16 21:16:27,2014-05-16 21:13:27
26ce741fb87fb9a9b784fa1e3ea88a713b802bc6...33e3abd0c81e2cb70f5b8159818dc1ec685d7b34,18,7,692,699,19,2014-05-16 21:18:07,2014-05-16 20:40:52
33e3abd0c81e2cb70f5b8159818dc1ec685d7b34...99bd567db407a89fda29bd83f46c0b72c6f775e3,33,266,342,608,113,2014-05-16 21:23:21,2014-05-16 18:59:16
99bd567db407a89fda29bd83f46c0b72c6f775e3...7bbc8d16db180835733c005d97064854c50f23a7,2,0,44,44,2,2014-05-16 22:37:09,2014-05-16 15:57:51
7bbc8d16db180835733c005d97064854c50f23a7...5a44bf386eaba7d18a142206868bdbab15432eea,8,1424,2,1426,9,2014-05-16 23:37:43,2014-04-14 20:41:39
5a44bf386eaba7d18a142206868bdbab15432eea...3f1255ba06d7ce45d0ad748d7f8a957cd7207d94,1,12,19,31,10,2014-05-17 01:00:43,2014-05-17 01:00:28
3f1255ba06d7ce45d0ad748d7f8a957cd7207d94...9df8f46db0152921264a6bd235cfd0fd655bf1bc,8,2,1424,1426,9,2014-05-17 15:38:34,2014-05-17 15:38:34
9df8f46db0152921264a6bd235cfd0fd655bf1bc...1134c0d1fc3dcbde6a457ecd55de1697d7a13f97,6,156,13,169,10,2014-05-17 19:46:27,2014-05-14 14:41:00
1134c0d1fc3dcbde6a457ecd55de1697d7a13f97...ed505aa5f1d386eb8f4109e3506345e98b798049,3,12,15,27,11,2014-05-17 19:46:27,2014-05-14 15:43:59
ed505aa5f1d386eb8f4109e3506345e98b798049...41d8623717159868eb952ae44cde8f8d3d1e6b52,1,4,4,8,3,2014-05-17 19:46:27,2014-05-14 17:36:18
41d8623717159868eb952ae44cde8f8d3d1e6b52...545d8d8420d7cf7f25514cf8b2ec1cabfbda6747,2,6,5,11,5,2014-05-17 19:46:27,2014-05-14 17:45:25
545d8d8420d7cf7f25514cf8b2ec1cabfbda6747...84cb300c5315a88782fe841c2e47e902190a36b9,2,5,5,10,5,2014-05-17 19:46:27,2014-05-14 17:46:16
84cb300c5315a88782fe841c2e47e902190a36b9...5b3f117641dee72eac36f2d86f16aef3ad6f33a7,1,4,4,8,4,2014-05-17 19:46:27,2014-05-14 17:53:43
5b3f117641dee72eac36f2d86f16aef3ad6f33a7...ab600c4056f13ee7dc49899bd76be4a8898b3360,3,5,7,12,5,2014-05-17 19:46:28,2014-05-14 19:43:35
ab600c4056f13ee7dc49899bd76be4a8898b3360...3c202ac893db05e2486efd4a384c6bb49f01831f,6,408,187,595,14,2014-05-17 19:46:28,2014-05-16 18:51:48
3c202ac893db05e2486efd4a384c6bb49f01831f...87b350a0eeafb6a7933e9be3ffc453b690741653,2,41,1,42,9,2014-05-17 19:46:28,2014-05-16 18:53:52
87b350a0eeafb6a7933e9be3ffc453b690741653...869e0a15066618c67cb06ba1869bd0532e258db7,6,20,10,30,7,2014-05-19 14:04:00,2014-03-19 19:32:32
869e0a15066618c67cb06ba1869bd0532e258db7...4ab25eac664ff6775bdb57a3689a3a2f4092e6b0,4,72,72,144,4,2014-05-19 09:12:26,2014-05-16 13:03:29
4ab25eac664ff6775bdb57a3689a3a2f4092e6b0...f9be10eccac4ce39ad64d84bd02916257f9a8ef6,1,19,11,30,3,2014-05-19 09:16:36,2014-03-25 15:14:59
f9be10eccac4ce39ad64d84bd02916257f9a8ef6...91ef92d905468dce07cd04cd11e8cd5369f23cb0,9,42,34,76,18,2014-05-19 15:59:06,2014-05-16 21:03:58
91ef92d905468dce07cd04cd11e8cd5369f23cb0...e84c75764bd1b1b1700cb30599c6dd2aee34eba2,1,4,0,4,1,2014-05-19 13:07:39,2014-05-19 09:11:37
e84c75764bd1b1b1700cb30599c6dd2aee34eba2...51e56e4c04ff28838ef5f670efe99128793f2d46,6,895,852,1747,17,2014-05-19 13:20:33,2014-05-19 09:32:01
51e56e4c04ff28838ef5f670efe99128793f2d46...d27c68bba7892266f7d84ba8785cb154fed601b9,1,168,135,303,97,2014-05-19 13:20:33,2014-05-19 09:47:50
d27c68bba7892266f7d84ba8785cb154fed601b9...c10e8282a7af38f8512e911a14889e14df8a2c6a,2,8,6,14,5,2014-05-19 18:36:20,2014-05-19 18:36:15
c10e8282a7af38f8512e911a14889e14df8a2c6a...f2bfd36a6f3eb7e7e2587268be3cc12636703d42,288,1792,1792,3584,1509,2014-05-19 18:43:05,2014-05-19 16:46:52
f2bfd36a6f3eb7e7e2587268be3cc12636703d42...db0e1a91fdce2fa43584408a87d637cfe4bcc2ec,71,1922,1204,3126,347,2014-05-19 20:05:41,2014-05-19 20:05:41
db0e1a91fdce2fa43584408a87d637cfe4bcc2ec...261babf25012d441809ffd97d18d50ee5b951e75,203,65229,0,65229,203,2014-05-19 20:27:10,2014-05-19 20:23:01
261babf25012d441809ffd97d18d50ee5b951e75...f89e280ef9946edf1904ffb91751461554be78b9,1,8,3,11,2,2014-05-19 21:00:21,2014-05-19 20:56:55
f89e280ef9946edf1904ffb91751461554be78b9...7fced83ca52d18991b2729e2e518248b9e7c7887,1,10,0,10,1,2014-05-19 21:00:21,2014-05-19 20:58:30
7fced83ca52d18991b2729e2e518248b9e7c7887...65ca787cfe1c287641cd859a8c7cae9e6cbde7f0,1,5,13,18,7,2014-05-19 21:07:12,2014-05-19 17:08:47
65ca787cfe1c287641cd859a8c7cae9e6cbde7f0...62d49d464c7f2a7181dec9b822e30b196107fa01,2,43,0,43,6,2014-05-19 21:41:21,2014-05-19 21:28:18
62d49d464c7f2a7181dec9b822e30b196107fa01...65b71020e3f51467a42b13784abb63d87225bd39,12,473,151,624,94,2014-05-19 22:46:06,2014-05-14 15:15:21
65b71020e3f51467a42b13784abb63d87225bd39...9a404af6d545d8e2352342bea6a78b5d675a6950,1,4,2,6,1,2014-05-19 22:59:23,2014-05-19 15:13:53
9a404af6d545d8e2352342bea6a78b5d675a6950...2bff086f3290a662736330a0c03c988a70411ebc,1,6,0,6,1,2014-05-19 23:50:53,2014-05-18 13:08:34
2bff086f3290a662736330a0c03c988a70411ebc...0dbe8f47a848e0a068eb3e85759c70ed4b647f29,11,2736,1896,4632,62,2014-05-20 00:44:00,2014-05-16 21:03:42
0dbe8f47a848e0a068eb3e85759c70ed4b647f29...7b21a4cc18e7bf6c5da8c7d0af059dbea3418285,2,1,8,9,5,2014-05-20 03:57:19,2014-05-20 03:57:19
7b21a4cc18e7bf6c5da8c7d0af059dbea3418285...2fdfb48d51a31dedb28d34bde6c3a02c22ced969,1,2,2,4,1,2014-05-20 13:44:09,2014-01-22 22:21:50
2fdfb48d51a31dedb28d34bde6c3a02c22ced969...b03877b9f4ee3384bcff72a7c06cf537d9a4c1a3,21,37,31,68,37,2014-05-20 14:10:57,2014-05-19 22:51:17
b03877b9f4ee3384bcff72a7c06cf537d9a4c1a3...24b08ff1d2b4688255675c91bc44b27fe21a23cb,1,12,8,20,8,2014-05-20 15:40:10,2014-05-20 15:34:01
24b08ff1d2b4688255675c91bc44b27fe21a23cb...9823bc1393f71baff06e6bb2d711c628eb7015bf,12,41,32,73,22,2014-05-20 17:03:25,2014-05-19 17:41:28
9823bc1393f71baff06e6bb2d711c628eb7015bf...2a0fd61c1b0b390b7365e900a0b3e53118515423,1,1,0,1,1,2014-05-20 17:55:11,2014-05-20 17:54:57
2a0fd61c1b0b390b7365e900a0b3e53118515423...3f1b15b8fa5e9a59030db37341163935b1df39ef,17,134,148,282,32,2014-05-20 18:05:57,2014-05-20 14:26:12
3f1b15b8fa5e9a59030db37341163935b1df39ef...650c98468737c2ae9aa7f278111e863276c79e55,4,91,2,93,8,2014-05-20 20:27:17,2014-05-13 17:48:04
650c98468737c2ae9aa7f278111e863276c79e55...8fb62e7324a21e1fac6405753735ddaa33587cb3,1,32,0,32,1,2014-05-20 21:21:14,2014-05-20 21:03:35
8fb62e7324a21e1fac6405753735ddaa33587cb3...e15c084245fcd1262c55b6c8bc7e0bc979d302ec,13,36,540,576,34,2014-05-20 23:02:25,2014-05-19 22:06:16
e15c084245fcd1262c55b6c8bc7e0bc979d302ec...dbe6f0a60f5cef69eb02ab3d97fc4db208aa6190,18,28,336,364,45,2014-05-20 23:02:25,2014-05-16 18:05:22
dbe6f0a60f5cef69eb02ab3d97fc4db208aa6190...91ac47a33ea88114cb9d2e32b4ac8a5ae72456a7,4,34,8,42,8,2014-05-20 23:02:25,2014-05-20 17:02:34
91ac47a33ea88114cb9d2e32b4ac8a5ae72456a7...6ab3105129a0e2d0192a8333bf23c2380c879bd1,1,2,5,7,5,2014-05-20 23:02:25,2014-05-20 17:24:12
6ab3105129a0e2d0192a8333bf23c2380c879bd1...06bf11f51421f40f8bfe9c9de9b5422673291c28,3,0,10,10,5,2014-05-20 23:02:25,2014-05-20 17:53:48
06bf11f51421f40f8bfe9c9de9b5422673291c28...e06a94e70c25ce97628dddbb551e5669f435922e,10,95,27,122,32,2014-05-20 23:28:17,2014-05-20 18:40:14
e06a94e70c25ce97628dddbb551e5669f435922e...219bcdbc9b4dd1be804cf5385624fdc1557b3467,6,829,4,833,7,2014-05-21 15:17:04,2014-05-19 17:36:16
219bcdbc9b4dd1be804cf5385624fdc1557b3467...da1f6615489142849764085f5fabfc41f69adbe7,3,4,4,8,4,2014-05-21 15:24:14,2014-05-19 15:51:06
da1f6615489142849764085f5fabfc41f69adbe7...024fb8af552171a22407594babb0f324d971b380,1,39,40,79,21,2014-05-21 16:37:27,2014-05-21 14:07:07
024fb8af552171a22407594babb0f324d971b380...3b97c0870427f676cf3ffbddabc5df8b1fa44fa5,6,50,3,53,9,2014-05-21 16:38:12,2014-05-13 21:01:04
3b97c0870427f676cf3ffbddabc5df8b1fa44fa5...b162d4c90ed069602ea2dbdac74771d2d97c14ee,6,3,50,53,9,2014-05-21 18:54:26,2014-05-21 18:54:26
b162d4c90ed069602ea2dbdac74771d2d97c14ee...a7526c96e9a584c646294d4414acbad1b452a6f4,1,2,2,4,2,2014-05-21 22:41:06,2014-05-21 22:39:37
a7526c96e9a584c646294d4414acbad1b452a6f4...eb8b368edb239a7a698d734dedcf4f6950bf64ec,10,296,177,473,16,2014-05-21 23:47:49,2014-05-21 23:45:10
eb8b368edb239a7a698d734dedcf4f6950bf64ec...0a0ba030626243e3482830f485a3ecd79da1b7c8,2,40,4,44,4,2014-05-21 23:47:49,2014-05-21 23:46:38
0a0ba030626243e3482830f485a3ecd79da1b7c8...072266f7f46af42a5030ef7920c42d863a5d5f74,1,2,1,3,1,2014-05-22 00:04:12,2014-05-14 21:34:03
072266f7f46af42a5030ef7920c42d863a5d5f74...885e11b64dae39b4a90304e754caa26254442180,2,16,16,32,8,2014-05-22 00:20:39,2014-05-21 13:03:11
885e11b64dae39b4a90304e754caa26254442180...0e224f9a0fe0a37ee2b22c0a0ba20ec2a1f48aeb,29,109,109,218,104,2014-05-22 13:17:09,2014-05-14 23:43:38
0e224f9a0fe0a37ee2b22c0a0ba20ec2a1f48aeb...1ec7a22e8b10833d250892e62d7e0942b1dbb9f2,9,1433,2,1435,10,2014-05-22 14:57:38,2014-04-14 20:41:39
1ec7a22e8b10833d250892e62d7e0942b1dbb9f2...4e5ff6074e560b44134b803e957effd1315b3122,4,7,38,45,18,2014-05-22 15:29:12,2014-05-21 15:45:24
4e5ff6074e560b44134b803e957effd1315b3122...4829bf7cd9eb34db1de853a87c70c6752cc6e775,8,656,322,978,10,2014-05-22 15:29:12,2014-05-21 17:19:35
4829bf7cd9eb34db1de853a87c70c6752cc6e775...9173c67fc584afa1bf53584275904d77e10228e8,2,0,1452,1452,2,2014-05-22 15:29:12,2014-05-22 15:29:06
9173c67fc584afa1bf53584275904d77e10228e8...81967a2dce1898d1f03938f0b5c27b8a37873877,2,39,11,50,6,2014-05-22 17:25:41,2014-05-20 20:34:25
81967a2dce1898d1f03938f0b5c27b8a37873877...9c3edc610c7f52a3d502fbc50e0acc55b5efa645,3,4,4,8,4,2014-05-22 18:06:39,2014-05-22 18:01:50
9c3edc610c7f52a3d502fbc50e0acc55b5efa645...d65955cce198e37c9d86e843c3f556bff8b32dff,1,52,0,52,1,2014-05-22 18:13:12,2014-05-22 17:23:14
d65955cce198e37c9d86e843c3f556bff8b32dff...ed644c962da4f418cb4bc78be35267444117f265,3,142,149,291,3,2014-05-22 19:18:15,2014-05-20 21:15:34
ed644c962da4f418cb4bc78be35267444117f265...0d088b82f1490aa7053fdf2748a55162b30970c4,2,82,6,88,7,2014-05-22 19:33:41,2014-05-22 18:03:57
0d088b82f1490aa7053fdf2748a55162b30970c4...3cb9955b05bdef78cb8f72f63e657d920c0fa0bb,102,442,291,733,314,2014-05-22 16:18:42,2014-05-19 17:28:28
3cb9955b05bdef78cb8f72f63e657d920c0fa0bb...cdea983b23a82419513157616ee73d8c344e0148,1,0,3,3,1,2014-05-22 16:18:42,2014-05-21 11:58:09
cdea983b23a82419513157616ee73d8c344e0148...3420a0121eaf0684b06a506d3758dd0d16af740f,2,1,8,9,7,2014-05-22 21:52:02,2014-05-22 21:23:58
3420a0121eaf0684b06a506d3758dd0d16af740f...7dcbdc440a56fef19a561f513d8eddd1c2a2b27f,10,499,502,1001,15,2014-05-22 22:04:51,2014-05-21 14:07:07
7dcbdc440a56fef19a561f513d8eddd1c2a2b27f...a0d921a14d099242cc0587d177dddf6fd0749cc1,2,14,2,16,3,2014-05-22 22:15:41,2014-05-22 21:05:43
a0d921a14d099242cc0587d177dddf6fd0749cc1...473028b020ee8288a14eca1454d9c08e507ef001,3,35,0,35,4,2014-05-22 22:33:11,2014-05-21 12:42:48
473028b020ee8288a14eca1454d9c08e507ef001...7a85cae38fba537980d6c9fc573ef077fd2df74e,1,12,0,12,1,2014-05-22 22:33:12,2014-05-21 12:44:38
7a85cae38fba537980d6c9fc573ef077fd2df74e...1b4b52a9d413e145478a303b63ab760894938c80,53,510,268,778,175,2014-05-23 00:29:39,2014-04-21 22:43:25
1b4b52a9d413e145478a303b63ab760894938c80...54845ac08d80b9556cbcbea711ad0529feb09c0f,1,9,4,13,2,2014-05-23 13:35:41,2013-05-01 17:21:36
54845ac08d80b9556cbcbea711ad0529feb09c0f...090ea9a5ad1ed52e40b5a66df5ee1eab283845cb,6,145,8,153,14,2014-05-23 13:53:26,2014-05-23 13:53:26
090ea9a5ad1ed52e40b5a66df5ee1eab283845cb...07af100f7ebc6b3a5213ce78259d560a9e99feea,6,578,5,583,7,2014-05-23 14:28:42,2014-05-13 15:43:48
07af100f7ebc6b3a5213ce78259d560a9e99feea...b74536cec6d91061f28f7432b98e6983332d4c60,1,3,0,3,2,2014-05-23 16:32:27,2014-05-23 16:32:27
b74536cec6d91061f28f7432b98e6983332d4c60...b804cb4dba4909e328611577bcd410712815aba8,1,1,1,2,1,2014-05-23 19:03:35,2014-05-23 19:03:35
b804cb4dba4909e328611577bcd410712815aba8...11f6d56e9800f1a580b2260af0f051f847dd4431,7,7,7,14,7,2014-05-23 19:48:43,2014-05-23 15:48:04
11f6d56e9800f1a580b2260af0f051f847dd4431...ed71c30430f538b9209d35278ca176696c5bb294,7,7,7,14,7,2014-05-23 20:00:31,2014-05-23 20:00:31
ed71c30430f538b9209d35278ca176696c5bb294...99fa4e6058a24d6c4d7fde19ce940719c5bbc210,7,101,8,109,12,2014-05-23 20:59:25,2014-05-13 21:01:04
99fa4e6058a24d6c4d7fde19ce940719c5bbc210...57d2c1fd5e7a43b33947b1c96aca2128cc41c5a7,1,31,1,32,5,2014-05-23 22:26:55,2014-03-12 15:36:23
57d2c1fd5e7a43b33947b1c96aca2128cc41c5a7...63f6ed53137372c8c056d730702278a36a636cd1,6,178,488,666,54,2014-05-24 16:34:50,2014-05-24 16:34:50
63f6ed53137372c8c056d730702278a36a636cd1...0431673ee0d814d84fe6e42d7c99b94fd24206f9,10,692,0,692,10,2014-05-27 09:32:04,2014-05-21 14:45:56
0431673ee0d814d84fe6e42d7c99b94fd24206f9...c27f26b7b49714649800a7d602fead7d57ca3805,1,1,1,2,1,2014-05-27 09:32:04,2014-05-23 09:23:13
c27f26b7b49714649800a7d602fead7d57ca3805...e4735eb2de26e12c8048fdd85340f086bd8ab447,108,361,361,722,322,2014-05-27 09:44:51,2014-05-23 13:31:48
e4735eb2de26e12c8048fdd85340f086bd8ab447...77d6ea60245080552132d942930180a61897d5de,1,48,0,48,1,2014-05-27 15:22:08,2014-05-23 19:36:09
77d6ea60245080552132d942930180a61897d5de...3ed5687c63dad092c22bf02112a58ff62ff92c00,1,1,1,2,1,2014-05-27 16:12:23,2014-05-26 10:50:48
3ed5687c63dad092c22bf02112a58ff62ff92c00...df4743bbf572a2b38f5e0fa7ec15b502b92d18da,1,1,1,2,1,2014-05-27 16:13:32,2014-05-27 14:09:31
df4743bbf572a2b38f5e0fa7ec15b502b92d18da...df9cb2c79f98f5ab5471a95b36e7689600d686d2,1,7,2,9,1,2014-05-27 17:25:32,2014-05-20 16:49:37
df9cb2c79f98f5ab5471a95b36e7689600d686d2...a97c9b1a30d60f8a9dca16969747f3f59400cb18,10,16,16,32,15,2014-05-27 13:13:26,2014-05-27 12:14:28
a97c9b1a30d60f8a9dca16969747f3f59400cb18...6fea6df0f8065bfa28fa17f94a5150482ed780da,1,11,0,11,2,2014-05-27 19:53:15,2014-05-22 22:50:54
6fea6df0f8065bfa28fa17f94a5150482ed780da...8b4103f6346e8bb4141925b53e397a6618dd8bad,1,1,1,2,2,2014-05-27 20:07:13,2014-05-27 18:19:48
8b4103f6346e8bb4141925b53e397a6618dd8bad...e4deee1ac2e4ad5bf485dfaa1c8745c3f0d1c724,3,39,35,74,27,2014-05-27 15:26:27,2014-05-27 13:55:56
e4deee1ac2e4ad5bf485dfaa1c8745c3f0d1c724...00b9a481e421ee720a6b4274012dc14e244aa5e2,15,47,46,93,37,2014-05-27 22:58:15,2014-05-13 19:00:52
00b9a481e421ee720a6b4274012dc14e244aa5e2...6511fae500f5d3c3205499d0b48c842c199222f4,5,0,1024,1024,5,2014-05-28 14:50:29,2014-05-27 22:22:39
6511fae500f5d3c3205499d0b48c842c199222f4...4acaf8a26e37986da49d51d14d26b7639699dde6,1,0,87,87,1,2014-05-28 18:06:41,2014-05-28 18:06:41
4acaf8a26e37986da49d51d14d26b7639699dde6...10143d873b81380a14fb2f2d5e9c299519930c51,1,83,75,158,4,2014-05-28 13:19:50,2014-05-27 16:16:24
10143d873b81380a14fb2f2d5e9c299519930c51...b27a764852873f5ecdc2dde6fffc317383c032c2,1,1,0,1,1,2014-05-28 19:06:52,2014-05-28 19:06:42
b27a764852873f5ecdc2dde6fffc317383c032c2...ee3fb776c7f36d59b593db7e4165b0611a7a503f,5,7,176,183,26,2014-05-28 20:13:47,2014-05-22 18:28:56
ee3fb776c7f36d59b593db7e4165b0611a7a503f...0672061deb58aac931912bed68d014247c581968,169,1446,1036,2482,1048,2014-05-28 20:13:48,2014-05-23 17:17:22
0672061deb58aac931912bed68d014247c581968...8bc2783d2e6e39c0910455b4eac9e0f93a482cfc,169,1036,1446,2482,1048,2014-05-28 22:40:59,2014-05-28 22:40:59
8bc2783d2e6e39c0910455b4eac9e0f93a482cfc...4bb1a6155bc7bfb7cb69ff6844d427f0159a888c,1,4,7,11,2,2014-05-29 12:44:09,2013-11-13 22:55:48
4bb1a6155bc7bfb7cb69ff6844d427f0159a888c...8f4148960e4107beb3314d7cd3214066f82c1d99,1,32,0,32,1,2014-05-29 12:44:16,2014-05-28 14:23:16
8f4148960e4107beb3314d7cd3214066f82c1d99...da2701673900d4a0e70aca04fb9a34f424469601,1,21,18,39,1,2014-05-29 12:46:18,2014-05-28 18:22:27
da2701673900d4a0e70aca04fb9a34f424469601...507a7d5e34d051ba3f30c3add50afa08b790f6d3,1,17,0,17,2,2014-05-29 12:50:07,2014-05-23 19:07:07
507a7d5e34d051ba3f30c3add50afa08b790f6d3...2de7dc34561667c1873f76f39300f9826c159c20,3,18,3,21,8,2014-05-29 12:54:34,2014-05-21 21:36:28
2de7dc34561667c1873f76f39300f9826c159c20...2e623309d5066e9505da758b0deac955cc10ac80,1,12,9,21,2,2014-05-29 15:28:49,2014-05-28 19:18:15
2e623309d5066e9505da758b0deac955cc10ac80...a7bae827a56cf2d80d65a1c26b135f957d0b64f0,2,53,1,54,2,2014-05-29 15:28:49,2014-05-28 19:36:17
a7bae827a56cf2d80d65a1c26b135f957d0b64f0...d4a54eddde371014a63c23a303b998880010d2bb,1,1,1,2,1,2014-05-29 20:15:47,2014-05-28 22:22:27
d4a54eddde371014a63c23a303b998880010d2bb...d5ceac1d556806be15d7653b92268354f52bbeda,2,61,0,61,4,2014-05-29 20:28:29,2014-05-28 20:11:57
d5ceac1d556806be15d7653b92268354f52bbeda...26211a7bfae928ded0ff30f6f974ff79f686f002,12,3,1572,1575,24,2014-05-29 22:17:17,2014-05-29 21:38:27
26211a7bfae928ded0ff30f6f974ff79f686f002...4055286cf8a6870f371f5dc476cd767bf50b75e9,1,5,4,9,1,2014-05-30 12:34:51,2014-05-28 23:05:21
4055286cf8a6870f371f5dc476cd767bf50b75e9...bee249ac8907cc9de6b19ba87c3fcb074d84b1a3,4,522,337,859,49,2014-05-30 15:11:55,2014-05-22 15:37:43
bee249ac8907cc9de6b19ba87c3fcb074d84b1a3...4edbe14669b7804180d8b58549e257ceb679bb1d,144,948,700,1648,688,2014-05-30 15:44:18,2014-05-30 13:56:36
4edbe14669b7804180d8b58549e257ceb679bb1d...a78d754b67040c19714bc4696dd7feb5ce10d412,93,441,422,863,361,2014-05-30 16:10:16,2014-05-29 19:36:28
a78d754b67040c19714bc4696dd7feb5ce10d412...2d8c11e9d43f6918e19b96219fe5cff6d1b3481e,10,46,34,80,36,2014-05-30 16:10:16,2014-05-29 22:52:13
2d8c11e9d43f6918e19b96219fe5cff6d1b3481e...79c5492d92e661e169d852c218ec393f31337db7,1,16,4,20,1,2014-05-30 12:13:54,2014-05-30 10:24:30
79c5492d92e661e169d852c218ec393f31337db7...07838d04bece908d12d7f0ded46a0a75ff77608f,1,1,0,1,1,2014-05-30 12:23:31,2014-05-29 14:07:52
07838d04bece908d12d7f0ded46a0a75ff77608f...01537e280a2f7bb50ea45ee1f9f34db3ec4c00e8,8,327,21,348,27,2014-05-30 18:14:41,2014-05-21 15:46:33
01537e280a2f7bb50ea45ee1f9f34db3ec4c00e8...b2a2935d63a7b8b2161acce8e1a7fbb178e0b717,1,2,2,4,1,2014-05-30 13:42:50,2014-05-30 12:48:51
b2a2935d63a7b8b2161acce8e1a7fbb178e0b717...38ff08a613439b254e66d2cc2a040270986445a8,20,101,59,160,48,2014-05-30 19:18:25,2014-05-30 14:37:57
38ff08a613439b254e66d2cc2a040270986445a8...1440087f1b43df9f46468ee259016d3e99d728af,1,9,1,10,3,2014-05-30 14:49:47,2014-05-29 17:31:09
1440087f1b43df9f46468ee259016d3e99d728af...3242afb803a5cc523f16c2c63c3ee1dfc10a5671,4,255,8,263,6,2014-05-30 20:59:32,2014-05-30 20:59:32
3242afb803a5cc523f16c2c63c3ee1dfc10a5671...66681e760ad6d5d361128cda94e08a4c9380a312,1,0,1,1,1,2014-05-30 16:41:59,2014-05-30 16:40:08
66681e760ad6d5d361128cda94e08a4c9380a312...67c56294c4e896cdf03c29c52cf77d48a7742dee,1,17,26,43,18,2014-05-31 00:43:38,2014-05-28 21:04:13
67c56294c4e896cdf03c29c52cf77d48a7742dee...c5258af03684414aa817fb87e51a962df48a3631,1,26,17,43,18,2014-06-01 01:46:50,2014-06-01 01:46:41
c5258af03684414aa817fb87e51a962df48a3631...f33e210cab1bde3deb5c62102e292fdf30a436ca,1,1,1,2,1,2014-06-01 15:12:06,2014-06-01 15:12:06
f33e210cab1bde3deb5c62102e292fdf30a436ca...174c677aec7671b4d7b7dfeda1f769b9a14cc7e1,1,2,1,3,1,2014-06-02 08:13:24,2014-05-30 16:06:26
174c677aec7671b4d7b7dfeda1f769b9a14cc7e1...b007d671ecda744635846279baf60357c70e3ee9,1,1,1,2,1,2014-06-02 09:20:07,2014-06-02 09:20:07
b007d671ecda744635846279baf60357c70e3ee9...09815011a48ce9753cd9bb5cd6fe48541897c576,7,755,5,760,13,2014-06-02 16:42:14,2014-05-16 18:18:04
09815011a48ce9753cd9bb5cd6fe48541897c576...7d8fce45e961525f08ac4ddcf82623ad66dc907d,2,155,1,156,3,2014-06-02 16:46:34,2014-06-02 14:54:04
7d8fce45e961525f08ac4ddcf82623ad66dc907d...d68aacd27b7abb5981d312e858bf5c5cc3b971b2,1,17,26,43,18,2014-06-02 18:16:13,2014-05-28 21:04:13
d68aacd27b7abb5981d312e858bf5c5cc3b971b2...4add46aa8dd05a5c6d8af2c798eef6e9b5e4164b,4,634,289,923,17,2014-06-03 00:51:22,2014-05-31 03:56:24
4add46aa8dd05a5c6d8af2c798eef6e9b5e4164b...8c9fcc939f9f1a2b593e606bd790cc87efd4064f,67,740,634,1374,512,2014-06-03 02:52:46,2014-05-28 17:49:34
8c9fcc939f9f1a2b593e606bd790cc87efd4064f...e5da18f2dfbd71fb997734b524e5e4306d0af550,16,36,41,77,26,2014-06-03 02:55:05,2014-06-02 20:32:25
e5da18f2dfbd71fb997734b524e5e4306d0af550...b0f62631b4513b3f10f0f0687d26cf5437f133a2,12,20,41,61,25,2014-06-03 13:24:33,2014-05-30 22:55:23
b0f62631b4513b3f10f0f0687d26cf5437f133a2...fa38294fbe72f565ebaeb27441c1600e2cd750ae,3,1,6,7,3,2014-06-03 13:26:38,2014-05-30 22:07:07
fa38294fbe72f565ebaeb27441c1600e2cd750ae...7f74dfc223f6aafac1c01ae12da8db52bbf25a59,2,13,11,24,10,2014-06-03 10:18:40,2014-05-29 14:07:52
7f74dfc223f6aafac1c01ae12da8db52bbf25a59...af057b64bad3fff652b98137e66dd138833d46c0,1,5,0,5,1,2014-06-03 10:18:40,2014-06-02 12:34:36
af057b64bad3fff652b98137e66dd138833d46c0...4857b8701526b07b1dedd508e768a980bf21c1dd,10,34,1,35,22,2014-06-03 17:05:03,2014-06-02 22:18:22
4857b8701526b07b1dedd508e768a980bf21c1dd...2ac0d96d7c855f05e5ec20dfad55da5c24ddb826,4,62,76,138,15,2014-06-03 18:57:32,2014-06-03 18:25:18
2ac0d96d7c855f05e5ec20dfad55da5c24ddb826...be7ed3e2c03951538554c115b4bbb2d201838118,1,1,1,2,1,2014-06-03 20:09:33,2014-06-03 20:09:33
be7ed3e2c03951538554c115b4bbb2d201838118...d2f3fd8487beca20866fb91716025915275b904a,1,2,2,4,2,2014-06-03 15:35:21,2014-06-03 15:35:21
d2f3fd8487beca20866fb91716025915275b904a...3d79294f421bd2869b472dd39d6146ab9a069e63,18,14,112,126,26,2014-06-03 21:01:33,2014-06-03 20:32:56
3d79294f421bd2869b472dd39d6146ab9a069e63...8c98fd5efa6c76d6b7b1d51862b599f2f93d5f85,1,27,6,33,7,2014-06-04 14:14:57,2014-06-03 21:32:37
8c98fd5efa6c76d6b7b1d51862b599f2f93d5f85...331046290f4eac18df209d90d772734b3bbd8e5c,1,0,11,11,2,2014-06-04 14:17:37,2014-06-04 14:17:37
331046290f4eac18df209d90d772734b3bbd8e5c...a1e9fe977303ef412d8d847141c64d2581a1b146,1,1,1,2,1,2014-06-04 15:26:08,2014-06-03 15:27:53
a1e9fe977303ef412d8d847141c64d2581a1b146...d09ffff4a379dcbafa687f67584c917d7a8e63b9,8,14,19,33,14,2014-06-04 15:26:22,2014-06-03 21:18:29
d09ffff4a379dcbafa687f67584c917d7a8e63b9...0ae43e5c66c119e2963e7a58fa9cb37b8c87ff06,4,7,10,17,5,2014-06-04 17:53:32,2014-06-04 14:33:24
0ae43e5c66c119e2963e7a58fa9cb37b8c87ff06...659d9ecb48f0bbddfac486962c1622737641ebc7,1,1,1,2,1,2014-06-04 17:53:32,2014-06-04 14:35:06
659d9ecb48f0bbddfac486962c1622737641ebc7...f40d275dc14d8fcecde23c077d36305232177d9a,217,76347,0,76347,216,2014-06-04 18:46:26,2014-06-03 22:27:14
f40d275dc14d8fcecde23c077d36305232177d9a...b0911563b1b996d366451b7d7af732c990274930,1,57,0,57,1,2014-06-04 18:46:26,2014-06-03 22:27:50
b0911563b1b996d366451b7d7af732c990274930...f49eeb2c20101ee06a0368ce08b56db39d372ac8,6,1411,0,1411,6,2014-06-04 18:46:26,2014-06-02 20:57:46
f49eeb2c20101ee06a0368ce08b56db39d372ac8...db53ec323146c5b2be95a209ecc166772772323a,3,141,0,141,3,2014-06-04 18:46:26,2014-06-02 20:58:27
db53ec323146c5b2be95a209ecc166772772323a...dd0469332e0777e366cb4d4d75dce2c52ab7164a,14,40,44,84,32,2014-06-04 18:50:40,2014-06-02 21:41:41
dd0469332e0777e366cb4d4d75dce2c52ab7164a...f43fd35390995c4aa6ef53477e95998c891eb6d2,1,102,12,114,6,2014-06-04 19:06:44,2014-05-19 19:18:02
f43fd35390995c4aa6ef53477e95998c891eb6d2...8b0d5c879339e16f06829ebb4265e54b1a356b2a,6,208,22,230,24,2014-06-04 20:34:42,2014-05-30 13:37:17
8b0d5c879339e16f06829ebb4265e54b1a356b2a...a0c8c69950bc0aeaf9d02c5e7f897ed501335746,1,3,1,4,2,2014-06-04 20:48:24,2014-06-04 19:23:44
a0c8c69950bc0aeaf9d02c5e7f897ed501335746...f0e050a5806cd4fe9a231374ad3d817408c726ea,1,35,5,40,5,2014-06-04 20:49:25,2014-05-30 18:38:37
f0e050a5806cd4fe9a231374ad3d817408c726ea...e727510b1a2f004446cdbe7b1b56ce2a935fdb63,3070,619518,0,619518,3070,2014-06-04 20:51:57,2014-06-04 01:36:03
e727510b1a2f004446cdbe7b1b56ce2a935fdb63...b0e11bb814f6554dfc791ba5a05e007f4d1efec9,1,1,1,2,1,2014-06-04 22:08:30,2014-06-04 22:08:30
b0e11bb814f6554dfc791ba5a05e007f4d1efec9...64e3b85a7c8a4a6ea7c68f25ae27780c702cdfb5,6,22,208,230,24,2014-06-04 22:17:42,2014-06-04 22:17:42
64e3b85a7c8a4a6ea7c68f25ae27780c702cdfb5...fff5d13830e44fbca742ad6c61239f439864ae29,23,61,63,124,41,2014-06-05 01:03:13,2014-06-03 18:37:01
fff5d13830e44fbca742ad6c61239f439864ae29...8da74f764b055cd610fa41d54c5283faf0986c88,1,1,7,8,2,2014-06-05 12:51:34,2014-06-03 17:47:57
8da74f764b055cd610fa41d54c5283faf0986c88...ddc13e7f24ae0a38f7d479c1e14089aeb2a183c7,3,4,4,8,4,2014-06-05 12:51:34,2014-05-22 19:33:09
ddc13e7f24ae0a38f7d479c1e14089aeb2a183c7...96a6b2e79f091bc20a54534c5ae9e3240d2aa3b9,6,208,22,230,24,2014-06-05 13:36:58,2014-06-05 13:18:20
96a6b2e79f091bc20a54534c5ae9e3240d2aa3b9...459b9e9d0f2f1ae1cbca07f8728a6ca253871d30,1,0,2,2,1,2014-06-05 14:36:18,2014-06-05 00:18:03
459b9e9d0f2f1ae1cbca07f8728a6ca253871d30...d1f92647d5c337ce8ec21a60d81adf8de3c140f7,1,4,3,7,1,2014-06-05 14:39:14,2014-06-02 17:08:02
d1f92647d5c337ce8ec21a60d81adf8de3c140f7...9e6d9d9b6322761df563d2c524a3ba5b7de32949,14,84,74,158,55,2014-06-05 14:39:15,2014-06-04 18:14:27
9e6d9d9b6322761df563d2c524a3ba5b7de32949...9e4519460d1db685a9494e36bff197703cdeb2c7,1,10,4,14,1,2014-06-05 14:39:16,2014-06-05 11:59:10
9e4519460d1db685a9494e36bff197703cdeb2c7...41465b6d3efb5563478bfa68fad874f4612ab135,1,1,1,2,2,2014-06-05 15:49:49,2014-06-05 14:24:37
41465b6d3efb5563478bfa68fad874f4612ab135...693b5368a978a9e05017cd7e40f56dfac1ba243c,1,2,1,3,2,2014-06-05 16:14:37,2014-06-05 16:14:37
693b5368a978a9e05017cd7e40f56dfac1ba243c...ec4f2ef38ccf83ac1e57d55bd00816f1db72df2f,10,13,48,61,20,2014-06-05 16:19:24,2014-05-16 17:52:14
ec4f2ef38ccf83ac1e57d55bd00816f1db72df2f...580141520aab378006d3c8d36daad42813886b88,2,8,6,14,3,2014-06-05 11:43:55,2014-05-30 13:13:17
580141520aab378006d3c8d36daad42813886b88...52c525dfb3b222a36e99986575e16725245389c5,16,379,48,427,46,2014-06-05 17:48:45,2014-06-04 18:18:22
52c525dfb3b222a36e99986575e16725245389c5...b377ac13c1df7108f6f01032d40f5d8818148b24,1,2,2,4,2,2014-06-05 17:50:11,2014-06-05 17:50:11
b377ac13c1df7108f6f01032d40f5d8818148b24...9ca367e8ef23be3f6e2a51f7d89411d8746fad56,13,204,216,420,65,2014-06-05 18:27:05,2014-06-04 15:08:13
9ca367e8ef23be3f6e2a51f7d89411d8746fad56...849a83f3649a7c3e7f31c0858804dbb354cad298,1,9,2,11,1,2014-06-05 14:46:26,2013-06-16 17:46:33
849a83f3649a7c3e7f31c0858804dbb354cad298...e5da7115afeee64fa24b467ab5ed22767bb040b8,1,6,9,15,1,2014-06-05 15:28:50,2014-06-05 14:50:54
e5da7115afeee64fa24b467ab5ed22767bb040b8...adcf6601f49b8afbe5b0c2b23d0f83ceeeca1fa1,1,9,1,10,6,2014-06-05 20:13:25,2014-06-04 20:50:32
adcf6601f49b8afbe5b0c2b23d0f83ceeeca1fa1...777de742ee578b62b12ded8381aadf98dfa9fa5f,9,423,44,467,21,2014-06-05 21:47:21,2014-06-03 17:57:13
777de742ee578b62b12ded8381aadf98dfa9fa5f...108ec7640743a97d2e02a081ef16d0c4da748c67,4,64,2,66,5,2014-06-05 21:53:00,2014-06-05 21:53:00
108ec7640743a97d2e02a081ef16d0c4da748c67...89383b224f061d306240d621745ba082a4ecb23b,3,98,11,109,4,2014-06-05 22:33:22,2014-06-05 15:47:08
89383b224f061d306240d621745ba082a4ecb23b...78c068e5d63d77648954252a785b3673d6e314b7,2,44,36,80,15,2014-06-05 22:57:10,2014-04-15 02:01:21
78c068e5d63d77648954252a785b3673d6e314b7...c4fa4dc85aec3b8dfd9ada7a58521d8f1bbf4fff,2,20,9,29,7,2014-06-05 22:57:10,2014-06-02 17:38:35
c4fa4dc85aec3b8dfd9ada7a58521d8f1bbf4fff...ffaa85ae89335efbef26338a12cc41b351fc8bda,7,97,236,333,20,2014-06-06 03:03:50,2014-06-03 20:52:03
ffaa85ae89335efbef26338a12cc41b351fc8bda...2453cec627bb8f6100980dea273ac9eb54ecd645,2,22,20,42,3,2014-06-06 13:38:53,2014-06-05 23:00:41
2453cec627bb8f6100980dea273ac9eb54ecd645...0d5acb0e3a6b0f1cdf7f252aa9a13afb1e884848,15,298,155,453,43,2014-06-06 14:31:49,2014-05-06 14:43:19
0d5acb0e3a6b0f1cdf7f252aa9a13afb1e884848...7915e212dc903f8d65b5c67d3c1bc501e0d3e610,11,58,37,95,30,2014-06-06 14:31:49,2014-06-02 21:59:40
7915e212dc903f8d65b5c67d3c1bc501e0d3e610...293993b4535d32464a87e15e4abd7ae3a2eee891,7,10,10,20,10,2014-06-06 14:31:49,2014-06-05 16:15:48
293993b4535d32464a87e15e4abd7ae3a2eee891...a156d9a1bd205367c5b4dd8d12e6246090fafbbd,15,648,7,655,24,2014-06-06 15:13:18,2014-05-28 22:40:07
a156d9a1bd205367c5b4dd8d12e6246090fafbbd...3be5d76cc11ee3e8412299b6f6d42c5f655bed06,17,94,37,131,43,2014-06-06 15:13:18,2014-06-03 21:46:49
3be5d76cc11ee3e8412299b6f6d42c5f655bed06...bf7eda1de3d01005ec61e1414428514b370f93cb,2,56,0,56,2,2014-06-06 15:44:34,2014-06-05 21:43:50
bf7eda1de3d01005ec61e1414428514b370f93cb...43d2ae25b1872273cb227ada251315cbaf817534,3,61,8,69,10,2014-06-06 15:48:26,2014-06-05 18:29:06
43d2ae25b1872273cb227ada251315cbaf817534...a71c42dabfce208709ef63a1c90aefcea15198e6,36,48,52,100,63,2014-06-06 17:31:47,2014-06-05 18:26:08
a71c42dabfce208709ef63a1c90aefcea15198e6...7e55849f500e040d5c21f1f6cd7aeb0878d11970,13,211,324,535,45,2014-06-06 17:31:47,2014-06-05 21:34:48
7e55849f500e040d5c21f1f6cd7aeb0878d11970...0cc8d91cb3f1a60d5a80f97ec13660b850b99bc3,5,33,3,36,11,2014-06-06 17:40:17,2014-02-18 15:01:14
0cc8d91cb3f1a60d5a80f97ec13660b850b99bc3...5bb8d17eacd7e6d5bb9ea5ef18167664b645eb3c,5,268,39,307,9,2014-06-06 18:12:06,2014-06-05 19:17:06
5bb8d17eacd7e6d5bb9ea5ef18167664b645eb3c...34a354ecca4b14cd6b3048f77a79e6b81bc7ddd3,199,0,57473,57473,199,2014-06-06 20:54:33,2014-05-21 17:56:48
34a354ecca4b14cd6b3048f77a79e6b81bc7ddd3...52bdc0125ac6ea0336f3da61bbfc8b0e92d9f6e5,1,3,0,3,2,2014-06-06 21:06:31,2014-06-06 21:06:31
52bdc0125ac6ea0336f3da61bbfc8b0e92d9f6e5...7a95cbf89f27abc0b2fb494da4c40efd59a3e1da,4,4,4,8,4,2014-06-06 21:24:22,2014-06-06 12:02:38
7a95cbf89f27abc0b2fb494da4c40efd59a3e1da...dae863af3f695fe98c16473ca07d79fb106121c0,3,65,8,73,8,2014-06-06 21:24:23,2014-06-06 12:03:24
dae863af3f695fe98c16473ca07d79fb106121c0...616461d294bd9f5054ca38b302b6fc5d70fde20c,11,68,29,97,21,2014-06-06 22:19:01,2014-06-05 18:55:52
616461d294bd9f5054ca38b302b6fc5d70fde20c...b13b6d94618848579855da4114025fabee85cb6d,4,130,53,183,7,2014-06-07 03:22:32,2014-06-04 16:00:36
b13b6d94618848579855da4114025fabee85cb6d...1eb659385f121af14b521690c4310259b4b0f733,1,78,21,99,9,2014-06-07 03:23:04,2014-03-26 16:39:46
1eb659385f121af14b521690c4310259b4b0f733...36d1beca1267a47cf4e9d79742caec8e5ad608fa,3,623,120,743,45,2014-06-09 15:54:39,2014-05-27 13:35:33
36d1beca1267a47cf4e9d79742caec8e5ad608fa...7650ab7a985e23098270c8893320c5b151d16d7e,8,102,77,179,54,2014-06-09 16:09:09,2014-06-05 02:32:33
7650ab7a985e23098270c8893320c5b151d16d7e...0974eb38fe72b31463d2e140013e89ac0eb45500,1,2,1,3,2,2014-06-09 16:09:09,2014-06-05 18:55:37
0974eb38fe72b31463d2e140013e89ac0eb45500...cd57c77fd4cf42173a5c9209032ef72504f4ecfa,2,77,2,79,3,2014-06-09 16:36:33,2014-06-04 17:45:19
cd57c77fd4cf42173a5c9209032ef72504f4ecfa...db085c742b1b97dc70a301c1d575ffd852d3ae1e,1,8,0,8,1,2014-06-09 17:08:33,2014-06-09 17:08:24
db085c742b1b97dc70a301c1d575ffd852d3ae1e...af4f086490d6ae51aa0c252df26751385683eaaa,1,14,5,19,8,2014-06-09 18:40:30,2014-06-09 17:23:03
af4f086490d6ae51aa0c252df26751385683eaaa...c1659f322c082f20c0256cd4779e2c38a2b56ecc,2,2,2,4,2,2014-06-09 19:03:18,2014-06-09 19:00:44
c1659f322c082f20c0256cd4779e2c38a2b56ecc...18ee068094776fad5e19cf841cdf4c16a3eb725f,7,10,41,51,13,2014-06-09 19:04:57,2014-06-06 18:47:42
18ee068094776fad5e19cf841cdf4c16a3eb725f...906cfb13a337fdbdf1b94b773390c4230b059fec,3,34,3,37,9,2014-06-09 19:58:55,2014-06-09 16:44:13
906cfb13a337fdbdf1b94b773390c4230b059fec...ebc62807f6ba7b1ba13a2c50efd6d0ec1598fc36,14,305,258,563,48,2014-06-09 20:19:30,2014-06-05 13:44:30
ebc62807f6ba7b1ba13a2c50efd6d0ec1598fc36...45e33c698933239d7f83a5f7fd0b21e140ac37ec,3,24,12,36,10,2014-06-09 20:19:30,2014-06-06 15:27:30
45e33c698933239d7f83a5f7fd0b21e140ac37ec...eb880114a9a54176c70774f993aa1ecfeda714da,2,10,13,23,2,2014-06-09 20:19:30,2014-06-06 21:35:34
eb880114a9a54176c70774f993aa1ecfeda714da...8fc8bc9a86711bb9ea41887d2f88362353dc3062,1,1,4,5,1,2014-06-09 20:19:30,2014-06-09 14:03:45
8fc8bc9a86711bb9ea41887d2f88362353dc3062...baf952e06f3288dc9bd1e5dd7b2fb683195feff2,8,169,111,280,17,2014-06-09 20:33:09,2014-06-09 19:07:59
baf952e06f3288dc9bd1e5dd7b2fb683195feff2...fceab66c30c64d5c9de1454c2c412445ef8b0362,5,408,10,418,12,2014-06-09 21:45:31,2014-05-30 22:28:25
fceab66c30c64d5c9de1454c2c412445ef8b0362...a98f839cf93baba5e424c427f4ed73395e7c3c1e,17,40,40,80,30,2014-06-10 03:43:00,2014-06-06 16:03:42
a98f839cf93baba5e424c427f4ed73395e7c3c1e...f0b3fdd218b03a6f38809987b66ff7dd0d0f224a,5,117,82,199,7,2014-06-10 11:45:43,2014-06-06 17:44:37
f0b3fdd218b03a6f38809987b66ff7dd0d0f224a...752c667ce442f28489fcecc5497a934e31eda007,7,10,12,22,10,2014-06-10 10:13:30,2014-06-05 14:58:40
752c667ce442f28489fcecc5497a934e31eda007...dbd592d44734ee39887ad3605937ec003dc60bfb,19,67,47,114,45,2014-06-10 10:13:31,2014-06-05 15:38:38
dbd592d44734ee39887ad3605937ec003dc60bfb...58488fbe0b8ef074eb02bc4c229da7f24fa560ad,6,34,39,73,9,2014-06-10 10:13:31,2014-06-06 10:46:48
58488fbe0b8ef074eb02bc4c229da7f24fa560ad...6dbb5ece65a84c220cf0a5ba1a08fd02f9a3d196,4,21,27,48,8,2014-06-10 10:13:31,2014-06-06 11:54:30
6dbb5ece65a84c220cf0a5ba1a08fd02f9a3d196...fb81d9912660a6c71ffbafda33156f8935e98f65,10,35,35,70,30,2014-06-10 10:13:31,2014-06-09 14:03:44
fb81d9912660a6c71ffbafda33156f8935e98f65...71d75ac4865665f4418a5f26200506f45a6d98d1,1,25,19,44,5,2014-06-10 15:50:06,2014-06-10 15:50:06
71d75ac4865665f4418a5f26200506f45a6d98d1...85461da82e7aca4285173ab7427cd468bd0f0fc2,1,18,0,18,2,2014-06-10 17:56:56,2014-06-09 23:11:23
85461da82e7aca4285173ab7427cd468bd0f0fc2...936a568c59f7f0ee80f8b50fabe241e54e80e9ae,3,35,42,77,8,2014-06-10 17:57:23,2014-06-05 18:44:39
936a568c59f7f0ee80f8b50fabe241e54e80e9ae...17f5a177bb88c57c740749d3ca87373f0c867b85,13,30,122,152,31,2014-06-10 17:57:24,2014-06-04 20:58:51
17f5a177bb88c57c740749d3ca87373f0c867b85...11034679871b5ad8afa0c18fccd8c19289f7e1c1,11,111,68,179,31,2014-06-10 20:45:21,2014-06-09 20:56:21
11034679871b5ad8afa0c18fccd8c19289f7e1c1...1690ee431e889f95fd3d7492cdea84598e1771dd,1,1,1,2,1,2014-06-10 15:51:57,2014-06-10 12:35:58
1690ee431e889f95fd3d7492cdea84598e1771dd...e191494d5092181e222c022fe44741951af91a2f,1,2,2,4,2,2014-06-10 15:51:57,2014-06-10 15:37:27
e191494d5092181e222c022fe44741951af91a2f...6537dc777512d093a489cb1db99e8db8cf50b914,41,465,802,1267,124,2014-06-10 21:06:53,2014-06-05 18:57:34
6537dc777512d093a489cb1db99e8db8cf50b914...d722cd36f36ec4b8e6c1d51d993c5fb1706747a8,3,0,13,13,5,2014-06-10 21:30:35,2014-06-10 13:30:11
d722cd36f36ec4b8e6c1d51d993c5fb1706747a8...9c0c4ff123f5248c5f4fc7119c181d9475ac4f1c,6,38,25,63,12,2014-06-10 21:30:35,2014-06-10 13:46:17
9c0c4ff123f5248c5f4fc7119c181d9475ac4f1c...e7055869bbd4051421edc349f33b0ae32daad3c4,6,47,26,73,12,2014-06-10 21:30:35,2014-06-10 19:13:05
e7055869bbd4051421edc349f33b0ae32daad3c4...73d7eff6f9d681c68c2288a46009d7742a4b3f95,1,1,1,2,1,2014-06-10 21:30:35,2014-06-10 19:57:34
73d7eff6f9d681c68c2288a46009d7742a4b3f95...c4db5777873c4973facc7ea5ba727565e7658d73,9,79,135,214,35,2014-06-11 04:23:31,2014-06-10 20:04:23
c4db5777873c4973facc7ea5ba727565e7658d73...3e39c96ebbd90ebeb91d46f9dace6988a0152763,67,1211,50,1261,173,2014-06-11 15:57:00,2014-06-03 15:04:28
3e39c96ebbd90ebeb91d46f9dace6988a0152763...9ce6d26279363cde5bb2dc0266415b0dd6f646a0,18,615,265,880,44,2014-06-11 17:49:20,2014-06-09 22:13:41
9ce6d26279363cde5bb2dc0266415b0dd6f646a0...96e18da735d531716a8d6e96bb1664b9d8ca6d17,2,2,2,4,2,2014-06-11 19:51:10,2014-06-11 19:51:10
96e18da735d531716a8d6e96bb1664b9d8ca6d17...f72c8e24a654bf0425287cc45c332178537fa508,1,1,1,2,1,2014-06-11 20:29:06,2014-06-11 20:28:20
f72c8e24a654bf0425287cc45c332178537fa508...9a5f41d211fe3679aacd4a5191252a5c749fbe96,1,110,110,220,23,2014-06-11 21:31:42,2014-05-15 03:40:08
9a5f41d211fe3679aacd4a5191252a5c749fbe96...2326733efda1097c284c8ba1cb82df3297aa8e1f,1,4,0,4,1,2014-06-11 22:12:22,2014-06-11 19:16:20
2326733efda1097c284c8ba1cb82df3297aa8e1f...b208bb85e809e73a2f3c28584d27f6966e32e276,5,383,173,556,8,2014-06-11 22:12:43,2014-05-12 18:48:29
b208bb85e809e73a2f3c28584d27f6966e32e276...ff814c1da71ccdaf76de4afadb1dc646985af4f9,2,133,43,176,33,2014-06-12 15:33:06,2014-06-12 13:58:50
ff814c1da71ccdaf76de4afadb1dc646985af4f9...7f9f47574be4100aa226b879c232c8da49ca1261,1,98,35,133,38,2014-06-12 15:50:58,2014-06-11 14:29:19
7f9f47574be4100aa226b879c232c8da49ca1261...5f9a4b0850954fb2c4f5775fbe84237bf0bf5168,4,169,87,256,36,2014-06-12 18:57:38,2014-06-12 18:57:10
5f9a4b0850954fb2c4f5775fbe84237bf0bf5168...4a97f4cff374897178798724a0a26172d0450828,4,143,89,232,21,2014-06-12 20:03:38,2014-06-12 20:02:41
4a97f4cff374897178798724a0a26172d0450828...9dd885f9b766ec41878c5adc7f1c5db1d5b2595d,20,0,34803,34803,20,2014-06-12 20:07:23,2014-06-12 20:03:59
9dd885f9b766ec41878c5adc7f1c5db1d5b2595d...87d09bc9cfe898f093c4d76ca5aad807c2e817e7,13,150,132,282,55,2014-06-12 20:10:21,2014-06-10 14:29:57
87d09bc9cfe898f093c4d76ca5aad807c2e817e7...a2d69514a4ebf111cab43953af45759e9f2a02b0,2,25,6,31,4,2014-06-12 20:51:14,2014-06-12 20:49:57
a2d69514a4ebf111cab43953af45759e9f2a02b0...c91b1561b38cbd9ac97fd60e84c004d930d16161,1,7,1,8,3,2014-06-12 21:55:11,2014-06-12 21:54:00
c91b1561b38cbd9ac97fd60e84c004d930d16161...435ff367fac3e02427aba5129e1f103ec603eb1e,1,32,27,59,21,2014-06-13 03:04:32,2014-06-12 20:57:57
435ff367fac3e02427aba5129e1f103ec603eb1e...a6793da36b0026c9b0ef50228f40472b31b5c76d,1,1,3,4,2,2014-06-13 03:04:40,2014-06-12 21:13:43
a6793da36b0026c9b0ef50228f40472b31b5c76d...969e42a89697d0cdfbb7e615f07d94745982b607,1,16,0,16,1,2014-06-13 04:26:43,2014-06-13 04:26:43
969e42a89697d0cdfbb7e615f07d94745982b607...d62e62464bd1bbe1b82c57240e27b1d1700472c4,17,83,83,166,72,2014-06-13 13:47:21,2014-06-11 04:33:03
d62e62464bd1bbe1b82c57240e27b1d1700472c4...15d292461279f3f5cfe077dd2b37a327d75d4c38,71,254,299,553,170,2014-06-13 13:47:22,2014-06-11 21:39:09
15d292461279f3f5cfe077dd2b37a327d75d4c38...0b9d98ce365d23321d1c6228add83b07acb5124f,1,1,1,2,1,2014-06-13 14:03:39,2014-06-13 14:03:39
0b9d98ce365d23321d1c6228add83b07acb5124f...c9b6f371a00112af31b5fc76297ab3605d47dd25,6,170,1,171,9,2014-06-13 14:59:30,2014-06-09 22:42:11
c9b6f371a00112af31b5fc76297ab3605d47dd25...176beefb27baf64dba1f071304450aef91ee953e,3,1,6,7,5,2014-06-13 15:10:18,2014-06-12 13:36:18
176beefb27baf64dba1f071304450aef91ee953e...ce326e3ed8ae7f74c8c70deb225da56f678bb345,7,7,7,14,7,2014-06-13 16:32:07,2014-06-13 16:32:07
ce326e3ed8ae7f74c8c70deb225da56f678bb345...5fb08ac952f9bef0ff783ac7d3eee96f962ce261,7,7,7,14,7,2014-06-13 19:24:29,2014-06-13 19:24:29
5fb08ac952f9bef0ff783ac7d3eee96f962ce261...3de51b256b34e5ccfcc3f6f2c8c0a11627b68dcc,3,23,43,66,13,2014-06-13 20:10:41,2014-06-13 17:31:25
3de51b256b34e5ccfcc3f6f2c8c0a11627b68dcc...8a47cfef3d41decde32b1a425229f1dc1c810f65,1,22,9,31,4,2014-06-13 20:29:08,2014-06-12 17:45:46
8a47cfef3d41decde32b1a425229f1dc1c810f65...83f2b119dfbd527c73ce0f63d3c6dcb586edb33f,4,174,28,202,24,2014-06-13 20:44:06,2014-06-09 20:08:42
83f2b119dfbd527c73ce0f63d3c6dcb586edb33f...2f0c61885405df346808365dfd2bae70769a9f7e,1,12,0,12,1,2014-06-13 22:31:08,2014-06-13 18:25:20
2f0c61885405df346808365dfd2bae70769a9f7e...0ee5538e5d03b678005ea8442d21cf18751c4afb,1,1,1,2,1,2014-06-14 02:15:42,2014-06-13 06:54:32
0ee5538e5d03b678005ea8442d21cf18751c4afb...82fadf310eeb947b18aa73e4283f272128c5f5ef,2,2,2,4,2,2014-06-14 04:03:26,2014-06-05 22:58:59
82fadf310eeb947b18aa73e4283f272128c5f5ef...c801fb985c55b21bdc29f0db3a9720aa71990ffc,3,74,60,134,15,2014-06-16 15:26:56,2014-06-16 15:25:15
c801fb985c55b21bdc29f0db3a9720aa71990ffc...36d49e00d13b0dd083db75cbc14404b3f823a5a7,9,129,112,241,68,2014-06-16 15:37:20,2014-06-13 20:28:09
36d49e00d13b0dd083db75cbc14404b3f823a5a7...0fd5d7a29ccc7c15c6e7fb2126d347f5996cf13f,14,450,682,1132,76,2014-06-16 17:27:23,2014-06-06 15:50:52
0fd5d7a29ccc7c15c6e7fb2126d347f5996cf13f...5b6e8778de15735391f5e5181961eee907c57a8d,3,0,196,196,3,2014-06-16 19:46:00,2014-06-09 15:02:02
5b6e8778de15735391f5e5181961eee907c57a8d...0a7accd28c89b91ca85b57a5b152dbbd8014c58c,6,0,542,542,7,2014-06-16 19:46:00,2014-06-09 15:02:31
0a7accd28c89b91ca85b57a5b152dbbd8014c58c...655f58f01b010a98256e9c2f0e34f7910570aa72,4,0,93,93,4,2014-06-16 19:46:00,2014-06-09 15:03:26
655f58f01b010a98256e9c2f0e34f7910570aa72...7699fa4df7043af48bb79f11a7f9cdeb58a1d6db,1,62,13,75,3,2014-06-16 23:05:11,2014-06-16 19:37:45
7699fa4df7043af48bb79f11a7f9cdeb58a1d6db...b21945fe74eda3579896d727cb88e68b0b508305,1,1,1,2,1,2014-06-17 13:39:46,2014-06-12 09:37:22
b21945fe74eda3579896d727cb88e68b0b508305...45a0e52f04b7c45072195d03bea50c7a170794d0,3,8,7,15,4,2014-06-17 13:41:10,2014-06-16 21:22:02
45a0e52f04b7c45072195d03bea50c7a170794d0...e0ebd3c20e5cc5a2c916c9726f231739b8bc37d9,1,7,0,7,1,2014-06-17 16:50:13,2014-06-17 15:14:09
e0ebd3c20e5cc5a2c916c9726f231739b8bc37d9...8f30b4b6ce40a9dd10aa15db65b787fec2d40786,1,15,0,15,1,2014-06-17 16:51:08,2014-06-17 15:25:09
8f30b4b6ce40a9dd10aa15db65b787fec2d40786...6032e7c6403e03d32d4b911e5bbe67c89088701f,4,63,7,70,8,2014-06-17 17:46:09,2014-06-16 13:02:26
6032e7c6403e03d32d4b911e5bbe67c89088701f...ff70eb640552c049538a03d174edbc2c0311c8bd,4,57,2,59,4,2014-06-17 18:29:51,2014-06-17 15:07:51
ff70eb640552c049538a03d174edbc2c0311c8bd...c53548186925995375052ceae68c609449ec987b,4,7,63,70,8,2014-06-17 19:41:58,2014-06-17 19:41:58
c53548186925995375052ceae68c609449ec987b...3947048e1f5fc567022af15c050d1b80160b25ce,4,63,7,70,8,2014-06-17 21:52:39,2014-06-16 13:02:26
3947048e1f5fc567022af15c050d1b80160b25ce...15446fb512f609bd3c080184b40943baa4e9a148,1,44,0,44,1,2014-06-18 01:35:25,2014-06-17 20:22:12
15446fb512f609bd3c080184b40943baa4e9a148...4f3cf19d951ce143c541c01cd4ec87d06f40556d,1,4,2,6,3,2014-06-18 14:25:18,2014-06-18 03:34:32
4f3cf19d951ce143c541c01cd4ec87d06f40556d...1881bea84dbf26aec2e6231231e24ae0fe48bb4e,4,40,9,49,9,2014-06-18 15:17:21,2014-06-11 22:57:16
1881bea84dbf26aec2e6231231e24ae0fe48bb4e...b6fe6121a9942ba4d0b41a9f4d7d5f023bbb4ff1,11,196,71,267,21,2014-06-18 15:17:21,2014-06-12 23:43:11
b6fe6121a9942ba4d0b41a9f4d7d5f023bbb4ff1...07a28c5089142100c15ca403eabdfc535e03a229,6,680,0,680,6,2014-06-18 17:54:54,2014-06-13 15:10:51
07a28c5089142100c15ca403eabdfc535e03a229...e4ee0d91184e8531fecb7e6b7e1887767dd3c4b1,8,34,22,56,20,2014-06-18 17:54:54,2014-06-13 22:05:17
e4ee0d91184e8531fecb7e6b7e1887767dd3c4b1...de66097d7f3ed2c50188e46333364c64155ffd67,9,769,699,1468,12,2014-06-18 17:54:54,2014-06-16 15:58:41
de66097d7f3ed2c50188e46333364c64155ffd67...180d9baa6954128318d9f9a550cc8f8596ca2055,6,30,30,60,30,2014-06-18 17:54:54,2014-06-16 16:01:35
180d9baa6954128318d9f9a550cc8f8596ca2055...cce92a4d63103eb924a81088ad686bf4052a08b2,3,1,15,16,5,2014-06-18 17:54:54,2014-06-16 17:02:04
cce92a4d63103eb924a81088ad686bf4052a08b2...e11156fe20421c0f09758cfc6355964159640616,26,100,35,135,44,2014-06-18 17:54:54,2014-06-16 21:39:45
e11156fe20421c0f09758cfc6355964159640616...4e13ac7a63b747fc0b990d65193c737215bb9e4f,38,203,216,419,144,2014-06-18 18:43:30,2014-06-18 03:21:25
4e13ac7a63b747fc0b990d65193c737215bb9e4f...aee6fcc2358819d13a89fc05793306037f092dcf,1,5,7,12,2,2014-06-18 22:06:43,2014-06-18 16:23:20
aee6fcc2358819d13a89fc05793306037f092dcf...23b998ebaf42560281ca93a67d5cb90f53b533a1,1,1782,1216,2998,257,2014-06-19 03:49:12,2014-06-19 03:49:12
23b998ebaf42560281ca93a67d5cb90f53b533a1...153f2302cac190167dd1c039ad2c68c4aa520fcc,1,268,130,398,22,2014-06-19 03:56:23,2013-07-26 20:09:07
153f2302cac190167dd1c039ad2c68c4aa520fcc...1c4485591f5511564bd85bd314fdd9af03429a6e,1,473,468,941,236,2014-06-19 03:58:56,2014-06-19 03:58:56
1c4485591f5511564bd85bd314fdd9af03429a6e...7ce2ffdbbaac003fb608e81ae03090adef960237,4,22,8,30,8,2014-06-19 05:49:58,2014-06-18 20:03:46
7ce2ffdbbaac003fb608e81ae03090adef960237...b4cafb46595d6e889f8effdca16e98c3f505078e,35,344,152,496,129,2014-06-19 05:49:58,2014-06-18 22:15:03
b4cafb46595d6e889f8effdca16e98c3f505078e...5eae3ef25468bba0a85640ddd578326c7381d596,1,16,3,19,4,2014-06-19 13:26:31,2014-06-19 13:26:31
5eae3ef25468bba0a85640ddd578326c7381d596...77472f85d6cadf99cece2019063dd35067ff682f,1,8,8,16,1,2014-06-19 14:47:42,2014-06-19 14:47:42
77472f85d6cadf99cece2019063dd35067ff682f...69771e18ff4ff572924a4242f807cdbeccb60a87,15,206,236,442,50,2014-06-19 16:37:05,2014-06-18 21:55:18
69771e18ff4ff572924a4242f807cdbeccb60a87...f4766f8b629857efd82535d02c3402a8b214dd41,1,4,1,5,2,2014-06-19 17:39:22,2014-06-19 15:49:38
f4766f8b629857efd82535d02c3402a8b214dd41...6fe6dee814326ac41f8d626c26bf32763ce73d71,3,80,39,119,16,2014-06-19 18:55:28,2014-06-19 10:07:15
6fe6dee814326ac41f8d626c26bf32763ce73d71...3cc05710297fd3e62b6a8398a1f217ffced75420,21,116,103,219,40,2014-06-19 16:59:28,2014-06-11 15:45:22
3cc05710297fd3e62b6a8398a1f217ffced75420...017fc448ba39e0ee731b84b21991c7a3646a8724,19,270,187,457,74,2014-06-19 16:59:28,2014-06-10 17:51:57
017fc448ba39e0ee731b84b21991c7a3646a8724...191940508ab4b41b117ec82b5c321d1a04024e8c,11,95,88,183,19,2014-06-19 16:59:29,2014-06-12 15:32:26
191940508ab4b41b117ec82b5c321d1a04024e8c...629f77c7b5979216f36840153d67eaa8a60082bc,1,11,1,12,2,2014-06-19 16:59:29,2014-06-17 16:23:31
629f77c7b5979216f36840153d67eaa8a60082bc...4fc19b1e98165ee1518c568a6ab9d5a1fece8db4,1,0,124,124,1,2014-06-19 16:59:29,2014-06-19 09:57:52
4fc19b1e98165ee1518c568a6ab9d5a1fece8db4...527ee3561d90aad6a66c7c656d2950eef6f1331b,8,27,2,29,9,2014-06-19 16:59:29,2014-06-18 17:34:04
527ee3561d90aad6a66c7c656d2950eef6f1331b...98a0c6f7c2a91d28a1f48c8fb0805e6745f0e8f9,21,88,58,146,38,2014-06-19 23:35:15,2014-06-19 17:38:24
98a0c6f7c2a91d28a1f48c8fb0805e6745f0e8f9...7ec0d1c33d9b904fad8c6221dff6f140fe51ff70,21,58,88,146,38,2014-06-20 01:31:53,2014-06-20 01:31:53
7ec0d1c33d9b904fad8c6221dff6f140fe51ff70...6245259aca8f9bf85af7c896eb36be4ca3ba0a5b,21,90,58,148,38,2014-06-20 03:49:43,2014-06-19 17:38:24
6245259aca8f9bf85af7c896eb36be4ca3ba0a5b...152dd4f70ec3c627b7ceec6ff52855ab6c3cb341,1,50,7,57,7,2014-06-20 16:44:14,2014-06-20 16:44:14
152dd4f70ec3c627b7ceec6ff52855ab6c3cb341...02f49375ac58f2ae343c18d622a1f02eb3e2e0e5,2,1,2,3,2,2014-06-20 16:44:53,2014-06-20 16:44:53
02f49375ac58f2ae343c18d622a1f02eb3e2e0e5...74fd0881fe4bb171577ad6f10b6ed5c5f7032150,5,265,85,350,48,2014-06-20 16:45:20,2014-06-20 16:45:20
74fd0881fe4bb171577ad6f10b6ed5c5f7032150...d7b4f787b0c2885ba80f76a54a4961a32ee1debf,1,1,0,1,1,2014-06-20 15:21:02,2014-06-20 09:48:41
d7b4f787b0c2885ba80f76a54a4961a32ee1debf...87739d45b9c974da88ca37d740c71b441249d45b,14,2687,21,2708,31,2014-06-20 21:32:30,2014-06-20 15:20:12
87739d45b9c974da88ca37d740c71b441249d45b...5bd73a2f5ae33168cb554bcb002c91433fafc047,22,152,69,221,58,2014-06-20 21:33:08,2014-06-19 16:18:26
5bd73a2f5ae33168cb554bcb002c91433fafc047...1018dbb7775981e9a21e7338e03509f1e812c762,8,620,23,643,16,2014-06-20 21:33:59,2014-06-19 23:26:41
1018dbb7775981e9a21e7338e03509f1e812c762...c8b2c1c15937b4911ce35c7eabc266330b0f0a1a,3,3,4,7,4,2014-06-20 22:55:59,2014-06-20 22:55:59
c8b2c1c15937b4911ce35c7eabc266330b0f0a1a...9176cf37e325074cbf6d76f7d6b0f47ac7c35f4e,9,81,58,139,27,2014-06-20 23:18:00,2014-06-20 22:58:29
9176cf37e325074cbf6d76f7d6b0f47ac7c35f4e...a324117b7f95666d15701212d31b6966b1309a48,6,40,5,45,9,2014-06-20 23:27:22,2014-06-20 23:27:22
a324117b7f95666d15701212d31b6966b1309a48...6c8a8a275bd12282c64ef6d60dc9d3d27975bd9b,7,912,497,1409,193,2014-06-23 13:22:42,2014-06-20 22:50:45
6c8a8a275bd12282c64ef6d60dc9d3d27975bd9b...b760878741a94e6dd5a26ba771c2512b66adae30,1,8,6,14,1,2014-06-23 14:28:00,2014-06-23 14:27:20
b760878741a94e6dd5a26ba771c2512b66adae30...4c208580ad4f2e7e33ab77bae52e45b99fba1f4c,48,106,287,393,49,2014-06-24 00:25:23,2014-06-23 15:39:58
4d06e27876697d67348a397955b46dabb8443827...e10d2a68be8e471b789d8f74452716153bebb299,7,7,7,14,7,2014-06-19 15:26:11,2014-06-19 15:26:11
e10d2a68be8e471b789d8f74452716153bebb299...3d19c459fe80fb7aa3244174b61994f13f71c21f,4,115,62,177,18,2014-06-19 19:10:44,2014-06-19 10:42:41
3d19c459fe80fb7aa3244174b61994f13f71c21f...255f67a66f9603c59380b2a389e386910bbb52cb,7,7,7,14,7,2014-06-19 20:19:09,2014-06-19 20:19:09
4d06e27876697d67348a397955b46dabb8443827...3a3922cefcbf746f85789c86f108c84d9bf26d9e,1,3,1,4,1,2014-06-16 20:33:18,2014-06-16 19:32:22
3a3922cefcbf746f85789c86f108c84d9bf26d9e...505b3feffbbb1ab1da27cae77cd76296df13b9d1,1,16,0,16,1,2014-06-16 20:34:30,2014-06-13 04:26:43
505b3feffbbb1ab1da27cae77cd76296df13b9d1...eed2eeacd17559b5d708920483b6c00dcc1ec21d,1,32,27,59,21,2014-06-16 20:36:48,2014-06-12 20:57:57
eed2eeacd17559b5d708920483b6c00dcc1ec21d...6a193b142b32d954d97f16a63308815e551ed885,1,1,3,4,2,2014-06-16 20:37:13,2014-06-12 21:13:43
6a193b142b32d954d97f16a63308815e551ed885...854863bfcf9bed1b3ccbbf430f02e266ff6ff7cc,1,3,1,4,2,2014-06-16 20:48:58,2014-06-16 20:48:58
854863bfcf9bed1b3ccbbf430f02e266ff6ff7cc...91025943ace37749d176bb3c66ae256a229236b7,1,27,32,59,21,2014-06-16 20:49:00,2014-06-16 20:49:00
91025943ace37749d176bb3c66ae256a229236b7...2ad6b4aa43ad052ae28502e7be7112eab7de5638,1,0,16,16,1,2014-06-16 20:49:01,2014-06-16 20:49:01
2ad6b4aa43ad052ae28502e7be7112eab7de5638...9d5cfbd40af043095ea7c4787a224aeff1df728c,1,1,3,4,1,2014-06-16 20:49:02,2014-06-16 20:49:02
9d5cfbd40af043095ea7c4787a224aeff1df728c...fe986ecfc328e2bc715414a077df661a3fa1fe10,7,7,7,14,7,2014-06-16 20:49:55,2014-06-16 20:49:55
fe986ecfc328e2bc715414a077df661a3fa1fe10...7db999a868c925f86c06a15b3f47a45e892287ed,1,3,1,4,1,2014-06-16 20:51:56,2014-06-16 19:32:22
7db999a868c925f86c06a15b3f47a45e892287ed...cd5850a2e9776922cf3d94b4e15bcb54737ed58a,1,16,0,16,1,2014-06-16 20:51:56,2014-06-13 04:26:43
cd5850a2e9776922cf3d94b4e15bcb54737ed58a...9e74eeb7c3598dc50f42d605163cd2366c2b3dab,1,32,27,59,21,2014-06-16 20:51:56,2014-06-12 20:57:57
9e74eeb7c3598dc50f42d605163cd2366c2b3dab...75da8d92f3d4ba4d72b3c05c06fd933721fb1230,1,1,3,4,2,2014-06-16 20:51:56,2014-06-12 21:13:43
75da8d92f3d4ba4d72b3c05c06fd933721fb1230...4a990e69f02498e707059aff4359fb95c605814a,2,44,36,80,15,2014-06-16 21:18:52,2014-04-15 02:01:21
4a990e69f02498e707059aff4359fb95c605814a...c98867bc6805da23c35c5c827c96f27a6a349006,2,20,9,29,7,2014-06-16 21:19:01,2014-06-02 17:38:35
c98867bc6805da23c35c5c827c96f27a6a349006...fa5b6b290aedc35492c20fa4cb549f9cf660eb62,1,14,5,19,8,2014-06-16 21:19:06,2014-06-09 17:23:03
fa5b6b290aedc35492c20fa4cb549f9cf660eb62...e13d2104950b971a9050d82bf1a1a7a26ad539ba,4,107,98,205,22,2014-06-17 14:01:02,2014-06-16 19:16:57
e13d2104950b971a9050d82bf1a1a7a26ad539ba...179ef63cbb9df2b55f46f9c893ebbf0afad58b52,5,155,0,155,5,2014-06-17 14:01:32,2014-06-02 19:55:41
179ef63cbb9df2b55f46f9c893ebbf0afad58b52...61f2f525ea3c8e5fea19a58b97e339f0d39f98cc,1,18,0,18,2,2014-06-17 14:30:01,2014-06-09 23:11:23
61f2f525ea3c8e5fea19a58b97e339f0d39f98cc...b7eb6ec466ea86a58f396aacdb8438281e7eb637,1,1819,1223,3042,248,2014-06-19 03:35:53,2014-06-19 03:35:53
b7eb6ec466ea86a58f396aacdb8438281e7eb637...ce54b89a5a015bb5c563f7f3cfb26f6af281cde2,4,115,62,177,18,2014-06-19 19:11:05,2014-06-19 10:42:41
ce54b89a5a015bb5c563f7f3cfb26f6af281cde2...a5e21e5be226719200f1bfb24dd483daa8d05ddc,7,7,7,14,7,2014-06-19 20:28:12,2014-06-19 20:28:12
a5e21e5be226719200f1bfb24dd483daa8d05ddc...906883dae03ac022b22ab99d322d3817135b0404,3,48,43,91,9,2014-07-02 07:10:37,2014-06-12 19:45:57
906883dae03ac022b22ab99d322d3817135b0404...8be2bd74167f69fbca94a02c069fde12fb803722,1,14,7,21,4,2014-07-10 15:33:12,2014-07-09 14:10:18
8be2bd74167f69fbca94a02c069fde12fb803722...9965572e13e395240def08cbef56f997931d61eb,2,8,5,13,4,2014-07-14 18:31:14,2014-05-19 18:36:15
9965572e13e395240def08cbef56f997931d61eb...6c64f236204a14b3c4dd3157bc9202acfbdbf363,5,48,9,57,6,2014-07-15 21:08:04,2014-06-30 19:29:42
6c64f236204a14b3c4dd3157bc9202acfbdbf363...5f2e923d4a6561fb012dc9fd635ac2d59abe8db3,2,54,2,56,4,2014-07-16 15:03:03,2014-06-30 18:07:35
5f2e923d4a6561fb012dc9fd635ac2d59abe8db3...ec9f7c4a453d4243324127a02ae12ebc5431ce3b,1,83,7,90,9,2014-07-16 18:08:38,2014-07-01 19:49:16
ec9f7c4a453d4243324127a02ae12ebc5431ce3b...d66794ceb55fe8c2aaefb29246f907a82069a676,4,64,2,66,5,2014-07-16 18:32:58,2014-06-05 21:53:00
d66794ceb55fe8c2aaefb29246f907a82069a676...5bd773e65e130fc46d6969356a94400d5a37b1f6,1,9,4,13,2,2014-07-16 18:41:32,2013-05-01 17:21:36
5bd773e65e130fc46d6969356a94400d5a37b1f6...dabdc411bb95e6619eb2a54888177c8ce46272e3,1,20,11,31,3,2014-07-16 19:06:02,2014-04-16 20:54:34
dabdc411bb95e6619eb2a54888177c8ce46272e3...fb31f55cb3c8a80db7ee139c66a60884df046046,2,41,1,42,3,2014-07-17 16:31:26,2014-07-17 16:31:26
fb31f55cb3c8a80db7ee139c66a60884df046046...e764b354c2e4a9cfbb3c7d27116b45014fee0592,1,0,4,4,1,2014-07-17 20:25:52,2014-04-25 12:46:27
e764b354c2e4a9cfbb3c7d27116b45014fee0592...f71b3b73424bfa5e8746829c43e472100e413bcb,4,7,10,17,5,2014-07-17 20:25:52,2014-06-04 14:33:24
f71b3b73424bfa5e8746829c43e472100e413bcb...4723061180216589d7c4fae94988a97724310660,1,1,1,2,1,2014-07-17 20:25:52,2014-06-04 14:35:06
4723061180216589d7c4fae94988a97724310660...6a8c3c8631e0d9850eaff83985731e47d7016185,1,4,7,11,2,2014-07-17 20:25:52,2013-11-13 22:55:48
6a8c3c8631e0d9850eaff83985731e47d7016185...34c561dbe12b0e6ea5b4f3ebe61aebee0021d6d2,1,32,0,32,1,2014-07-17 20:25:52,2014-05-28 14:23:16
34c561dbe12b0e6ea5b4f3ebe61aebee0021d6d2...aa09de7fd38af00ec9f7a4b689392809adaa2072,1,21,18,39,1,2014-07-17 20:25:52,2014-05-28 18:22:27
aa09de7fd38af00ec9f7a4b689392809adaa2072...7e51683298ef8f9f58bb1ef879b6df1182e279a4,3,18,12,30,11,2014-07-17 21:40:28,2014-07-02 17:19:42
7e51683298ef8f9f58bb1ef879b6df1182e279a4...32ae9aa4f46eb95b4d70b7f69a1e84bc95a1a5d1,3,69,9,78,9,2014-07-17 21:59:33,2014-07-17 21:20:33
32ae9aa4f46eb95b4d70b7f69a1e84bc95a1a5d1...fa0ca23e0d48269f08d677bb4b1102b9bada6adc,1,32,14,46,8,2014-07-21 14:57:20,2014-07-18 19:33:06
fa0ca23e0d48269f08d677bb4b1102b9bada6adc...c4bfb68647de2835aec1888b55a47ab2813c6e20,1,10,0,10,3,2014-07-21 14:58:59,2014-07-18 19:19:45
c4bfb68647de2835aec1888b55a47ab2813c6e20...270880374ec6a117235eefbcfc9ccdbd505acfe2,4,76,6,82,11,2014-07-21 19:36:31,2014-07-02 17:13:54
270880374ec6a117235eefbcfc9ccdbd505acfe2...f46bbf5de280cd9a184fc837e887895ac1aa0057,1,0,8,8,4,2014-07-21 22:29:15,2014-07-01 19:45:21
f46bbf5de280cd9a184fc837e887895ac1aa0057...49eb8f24b3e2ba1a7253b0d7a0022c45f78ca3b6,2,42,8,50,3,2014-07-21 22:31:22,2014-06-26 17:30:54
49eb8f24b3e2ba1a7253b0d7a0022c45f78ca3b6...7b2f7c76ca239ea0d6865b34c77700a622148f01,6,185,78,263,58,2014-07-21 23:04:55,2014-07-21 22:56:53
7b2f7c76ca239ea0d6865b34c77700a622148f01...a7940a354d61f58979c8987e593e3c7139a3c0dc,2,13,1,14,5,2014-07-21 23:04:55,2014-07-03 19:53:17
a7940a354d61f58979c8987e593e3c7139a3c0dc...4c4c600896004041f161de97d497114ca16c736e,1,3,0,3,3,2014-07-22 15:01:57,2014-07-18 20:51:45
4c4c600896004041f161de97d497114ca16c736e...10f5eb6b0d3eee62fbd7492a2ab4745306e0f54e,3,47,4,51,10,2014-07-22 15:29:03,2014-07-17 22:41:12
10f5eb6b0d3eee62fbd7492a2ab4745306e0f54e...468ef06587e6d2cf2be4ea845ebb3ce22d523141,11,209,52,261,44,2014-07-22 15:40:02,2014-07-22 15:38:29
468ef06587e6d2cf2be4ea845ebb3ce22d523141...2d157304846c8f211a43e37a1290f50132901a8c,2,35,13,48,5,2014-07-22 16:06:09,2014-05-01 20:05:39
2d157304846c8f211a43e37a1290f50132901a8c...01c029084ca7866d40fc649022c54d06dddbdd82,3,20,11,31,6,2014-07-22 19:31:05,2014-07-15 20:28:27
01c029084ca7866d40fc649022c54d06dddbdd82...1969f2661326eeee4d771778bb0e77a64757cddb,1,4,4,8,2,2014-07-22 20:23:11,2014-06-13 22:18:20
1969f2661326eeee4d771778bb0e77a64757cddb...1bc6f5dce536cc0e90d3d33850a119720d7edb1f,1,1,2,3,1,2014-07-22 23:16:28,2014-07-22 20:31:43
1bc6f5dce536cc0e90d3d33850a119720d7edb1f...b89d01e649241f932fafb0bb3777bea455ead397,3,34,3,37,9,2014-07-23 17:54:36,2014-06-09 16:44:13
b89d01e649241f932fafb0bb3777bea455ead397...7ca4834319f8a950560e1bcb5f76366d39d9db0c,4,51,10,61,16,2014-07-23 19:10:56,2014-07-21 18:29:26
7ca4834319f8a950560e1bcb5f76366d39d9db0c...84597954fac5ef20ff6ea47f3f6375b21b656299,2,294,9,303,9,2014-07-24 13:02:06,2014-07-22 17:24:09
84597954fac5ef20ff6ea47f3f6375b21b656299...15bef02ea778836c06d15e485a6a85a92c88bb80,1,28,32,60,30,2014-07-24 15:00:33,2014-07-24 15:00:33
15bef02ea778836c06d15e485a6a85a92c88bb80...d42d01afece8782738aa342a7ade891cee003c64,7,75,6,81,11,2014-07-24 15:40:49,2014-07-07 20:04:56
d42d01afece8782738aa342a7ade891cee003c64...4f284938fea696e1d1c5cf6c48642ee227c51fbb,2,65,1,66,3,2014-07-24 19:28:42,2014-07-23 19:33:53
4f284938fea696e1d1c5cf6c48642ee227c51fbb...ed8f4e3d5d321a825fd300be3e03976e625cb74e,2,23,0,23,2,2014-07-24 20:26:41,2014-07-24 19:14:34
ed8f4e3d5d321a825fd300be3e03976e625cb74e...d2ca93b7a52be546df68ec6a5343ccbffd4ca8b3,2,33,39,72,12,2014-07-24 22:28:21,2014-07-23 22:41:31
d2ca93b7a52be546df68ec6a5343ccbffd4ca8b3...729d76e8a0ea32b153734131f5076724556a6360,2,4,0,4,2,2014-07-24 23:12:35,2014-07-23 21:03:07
729d76e8a0ea32b153734131f5076724556a6360...3a38fc173f1ebd74ce5ed5b28e1459ac1154adba,1,0,53,53,1,2014-07-25 17:48:03,2014-07-25 17:35:11
3a38fc173f1ebd74ce5ed5b28e1459ac1154adba...db89b93c34f68abf2aad60a3b6f1af66e6388c06,2,4,4,8,2,2014-07-25 18:43:30,2014-07-23 15:58:51
db89b93c34f68abf2aad60a3b6f1af66e6388c06...0c23fbf3d2b595669b8d7380a7e17d63454b6876,2,3,1,4,2,2014-07-25 19:43:27,2014-07-23 19:11:28
0c23fbf3d2b595669b8d7380a7e17d63454b6876...4048b0a710cc1fa7fd542e860b1782c3ed4cc27b,2,33,2,35,4,2014-07-28 18:32:10,2014-07-28 18:30:25
4048b0a710cc1fa7fd542e860b1782c3ed4cc27b...da64fd05d2b25aac183c30538fe19a8b0eb1b2ad,1,32,6,38,4,2014-07-28 21:21:06,2014-06-03 21:32:37
da64fd05d2b25aac183c30538fe19a8b0eb1b2ad...05388f837f15f2cef1dfcee6521c83b3296c387a,1,3,3,6,3,2014-07-28 21:21:44,2014-06-19 21:29:55
05388f837f15f2cef1dfcee6521c83b3296c387a...b0a65d1f8756bdb933e91a79fd0639a6e42ea52e,2,31,8,39,8,2014-07-28 21:52:10,2014-07-28 20:25:27
b0a65d1f8756bdb933e91a79fd0639a6e42ea52e...2ec547c158e1bd7e0339288e0b7ed33ba46e58f6,2,0,10,10,4,2014-07-29 17:51:38,2014-07-25 18:35:12
2ec547c158e1bd7e0339288e0b7ed33ba46e58f6...bde74aaee9c11bc238f998373ecc27f19d6f8318,2,10,5,15,6,2014-07-29 20:47:37,2014-07-29 20:45:23
bde74aaee9c11bc238f998373ecc27f19d6f8318...e7ac34dcf82d8794edc646a2d65fd28c095f0d8c,3,45,27,72,28,2014-07-30 17:10:55,2014-05-13 13:31:15
e7ac34dcf82d8794edc646a2d65fd28c095f0d8c...1a0a49598d036c68c111cd04ac48655437dd6f83,12,362,150,512,48,2014-07-30 20:56:47,2014-07-30 14:45:36
1a0a49598d036c68c111cd04ac48655437dd6f83...0716e2c0158306dbf75408d980c35cb23b829017,1,36,4,40,6,2014-07-31 03:26:27,2014-07-30 14:05:06
0716e2c0158306dbf75408d980c35cb23b829017...baeb1573b5f763b73851214436e03c3087b1299b,7,7,7,14,7,2014-07-31 14:47:21,2014-07-31 14:47:21
baeb1573b5f763b73851214436e03c3087b1299b...ec363d6c098e67abf22f51779b7e9649764ee604,7,7,7,14,7,2014-07-31 14:51:43,2014-07-31 14:51:43
ec363d6c098e67abf22f51779b7e9649764ee604...7679e3e99f4f5153df219a0802f87e16cc47e3a1,7,7,7,14,7,2014-07-31 14:54:28,2014-07-31 14:54:28
7679e3e99f4f5153df219a0802f87e16cc47e3a1...675063a05e18d6d0ab7d280c794d3b61e5e71b70,1,3,0,3,1,2014-07-31 22:06:37,2014-07-31 22:02:43
675063a05e18d6d0ab7d280c794d3b61e5e71b70...b0221913173ed2b3d85c9a77e71dc648606a0e3d,16,279,52,331,48,2014-08-01 19:48:42,2014-08-01 07:44:36
b0221913173ed2b3d85c9a77e71dc648606a0e3d...c8f0e9e79f1aecab709937087475acd41e6be717,7,7,7,14,7,2014-08-01 22:37:22,2014-08-01 22:37:22
c8f0e9e79f1aecab709937087475acd41e6be717...c53e54e54f0833f32e53f5c1b071f3a0da6f71f3,7,7,7,14,7,2014-08-04 14:25:37,2014-08-04 14:25:37
c53e54e54f0833f32e53f5c1b071f3a0da6f71f3...3a830be0eb92d772aa855ebb711ac91d658ee910,7,7,7,14,7,2014-08-08 20:13:51,2014-08-08 20:13:51
3a830be0eb92d772aa855ebb711ac91d658ee910...ce9625989007384b90ec1c728ebcf865c6cb27cf,7,7,7,14,7,2014-08-10 23:41:53,2014-08-10 23:41:53
ce9625989007384b90ec1c728ebcf865c6cb27cf...f22b3d5470d3734937bf069a3ef884f4b6064497,1,0,87,87,1,2014-08-11 18:55:30,2014-05-28 18:06:41
f22b3d5470d3734937bf069a3ef884f4b6064497...0eeb8d6c75395398384160c6031b90bdf252c4a9,2,19,0,19,6,2014-08-11 21:45:33,2014-08-04 20:35:58
0eeb8d6c75395398384160c6031b90bdf252c4a9...b48cc723f1019669b42b1837b09da886970dc668,1,34,0,34,1,2014-08-11 21:48:43,2014-08-11 21:42:58
b48cc723f1019669b42b1837b09da886970dc668...1c79f141e8baf1802b93c3ee3ba858373c0594eb,2,3,0,3,2,2014-08-19 20:34:02,2014-07-14 19:35:42
1c79f141e8baf1802b93c3ee3ba858373c0594eb...f6983e73cba4eedae7970c96f62de3a6fd2f5978,1,7,1,8,1,2014-08-19 20:35:43,2014-07-14 19:36:45
f6983e73cba4eedae7970c96f62de3a6fd2f5978...10d7462387bc17670af44534c9e0e04844e920f4,7,95,22,117,20,2014-08-19 22:01:52,2014-08-19 18:15:12
10d7462387bc17670af44534c9e0e04844e920f4...1921d143fed7ac144933edbb17724e96a6ab7bd6,1,4,4,8,2,2014-08-19 22:02:35,2014-08-19 21:18:35
1921d143fed7ac144933edbb17724e96a6ab7bd6...2b23514f91c1ab0cc6b8f7e928138fbf513ce34e,1,6,5,11,3,2014-08-20 18:16:13,2014-08-19 20:14:46
2b23514f91c1ab0cc6b8f7e928138fbf513ce34e...c8844c031b7d2bd7bed5920fc869cedd14a9460f,2,34,2,36,6,2014-08-22 18:37:55,2014-08-21 18:53:12
c8844c031b7d2bd7bed5920fc869cedd14a9460f...06e03e2201b0b2a46a277e52a674fd5d6f861c9e,3,47,14,61,6,2014-08-25 00:57:05,2014-08-22 00:23:38
06e03e2201b0b2a46a277e52a674fd5d6f861c9e...08883b2312a524722d37dc28ce91c6abf801bb2e,2,41,13,54,4,2014-08-25 01:11:16,2014-08-21 02:16:00
08883b2312a524722d37dc28ce91c6abf801bb2e...099ed9309ff37161ef7574d5b506db97f95a575d,1,7,0,7,2,2014-08-28 16:06:45,2014-08-28 16:06:45
099ed9309ff37161ef7574d5b506db97f95a575d...726a75d8decbbdb513bb3e0d860d64f88cdd349a,1,3,1,4,1,2014-09-02 13:34:54,2014-09-02 13:34:54
726a75d8decbbdb513bb3e0d860d64f88cdd349a...8f8e59a78107a079c5367abdc31580d20428d9cc,2,19,1,20,3,2014-09-03 13:21:37,2014-09-03 13:21:17
8f8e59a78107a079c5367abdc31580d20428d9cc...dbf18450b53d4ee1df99c701120567219608adc0,7,325,187,512,64,2014-09-04 16:09:21,2014-09-03 15:40:47
dbf18450b53d4ee1df99c701120567219608adc0...94411d9551465cd215e20960f99825d0a34e0ea8,1,2,2,4,2,2014-09-05 21:38:29,2014-09-05 21:38:29
94411d9551465cd215e20960f99825d0a34e0ea8...7c0a72f1bab791e2f07ef1e86ab63d9eaf0d021d,2,3,3,6,2,2014-09-08 15:52:12,2014-08-27 19:00:43
7c0a72f1bab791e2f07ef1e86ab63d9eaf0d021d...d49ca8030322d39d9b02b9dea3b944ff5b34c170,1,1,6,7,1,2014-09-08 15:52:29,2014-08-29 17:18:36
d49ca8030322d39d9b02b9dea3b944ff5b34c170...c0bc7efa03c71b3929846bad059af5beda5ab231,1,2,2,4,1,2014-09-09 20:02:26,2014-08-14 20:51:13
c0bc7efa03c71b3929846bad059af5beda5ab231...4d33f84dda05fa9b72e1b1b50d1cfcae13e36470,2,127,0,127,2,2014-09-09 21:09:25,2014-09-09 20:20:31
4d33f84dda05fa9b72e1b1b50d1cfcae13e36470...7f085a7cd723ca6045e430d367e592879d92d994,2,44,4,48,8,2014-09-10 12:14:26,2014-09-08 17:25:47
7f085a7cd723ca6045e430d367e592879d92d994...976747c1224362120f8ee5079f542cb4f5082d32,2,11,1,12,3,2014-09-10 18:41:30,2014-07-30 19:06:53
976747c1224362120f8ee5079f542cb4f5082d32...f02059e077337bc769ad0a3c8cc6b6f28ac2f189,3,204,21,225,8,2014-09-11 14:08:17,2014-08-26 16:46:57
f02059e077337bc769ad0a3c8cc6b6f28ac2f189...930050ad3229d242a16467cd4812de3c44766726,1,10,11,21,5,2014-09-15 17:35:45,2014-08-01 22:41:52
930050ad3229d242a16467cd4812de3c44766726...c785f1a4cc02c5ba157b7482b3df82fced65104d,1,1,4,5,1,2014-09-15 18:55:47,2014-06-09 14:03:45
c785f1a4cc02c5ba157b7482b3df82fced65104d...c4ee7f76da25672cba1fd4191d29796fd2414565,1,150,0,150,1,2014-09-15 20:10:41,2014-08-20 21:38:21
c4ee7f76da25672cba1fd4191d29796fd2414565...2e9a9a607bae5763092a6f0ec42fda44e5aacb74,4,45,22,67,24,2014-09-15 20:14:05,2014-08-20 21:17:06
2e9a9a607bae5763092a6f0ec42fda44e5aacb74...fc95eb210f68f0c009a92177b302495bd8a17437,5,20,20,40,10,2014-09-15 20:14:53,2014-08-21 20:57:35
fc95eb210f68f0c009a92177b302495bd8a17437...5664ebd1766e13456bd6d333ed8f81ddae1c8161,1,1,1,2,1,2014-09-15 20:15:44,2014-08-22 19:44:25
5664ebd1766e13456bd6d333ed8f81ddae1c8161...f46ea38b7f63987e7041a4c07ce8eea3b7b46f71,4,57,2,59,4,2014-09-15 20:39:44,2014-06-17 15:07:51
f46ea38b7f63987e7041a4c07ce8eea3b7b46f71...6b1bbcefe2592f5c1e8ce2ae81ad40fca68c54a0,1,18,0,18,2,2014-09-16 15:57:18,2014-04-28 17:58:58
6b1bbcefe2592f5c1e8ce2ae81ad40fca68c54a0...ddce701ed775996f2a49fc949e26c5bcbc38fe84,1,7,0,7,2,2014-09-17 11:38:44,2014-07-25 10:09:58
ddce701ed775996f2a49fc949e26c5bcbc38fe84...775777b99c575edff05262140fbd529316aee939,5,64,3,67,12,2014-09-17 13:37:26,2014-09-09 19:33:23
775777b99c575edff05262140fbd529316aee939...d024587b174d1328361d78b3220794c4b941258b,1,6,3,9,2,2014-09-17 18:14:32,2014-09-02 17:04:43
d024587b174d1328361d78b3220794c4b941258b...299b86caf30bae2c88cd51ae189a37bd9cdeea73,2,15,12,27,6,2014-09-17 18:14:32,2014-09-02 23:07:42
299b86caf30bae2c88cd51ae189a37bd9cdeea73...722777370bef11db921efff5b0a50242c881afd8,1,1,0,1,1,2014-09-17 18:14:32,2014-09-03 16:20:07
722777370bef11db921efff5b0a50242c881afd8...7bca29e784b536e90387974bfa5a451ce15161a5,7,139,138,277,16,2014-09-17 18:14:32,2014-09-16 22:29:29
7bca29e784b536e90387974bfa5a451ce15161a5...0cf60aa0af55a673786d4950c4b5524c1d671e6e,2,67,5,72,3,2014-09-17 18:25:00,2014-04-23 20:17:17
0cf60aa0af55a673786d4950c4b5524c1d671e6e...aff4ae5f1da121fb94f01cb4e278a4596ec7856a,1,0,8,8,1,2014-09-18 20:11:13,2014-09-18 15:59:01
aff4ae5f1da121fb94f01cb4e278a4596ec7856a...fcd31bd4dcf1debcef9e8edc5643378757174d10,2,27,0,27,2,2014-09-18 20:58:22,2014-09-18 15:37:06
fcd31bd4dcf1debcef9e8edc5643378757174d10...c7ee53ba9bf48dd958baa4cbc45ec5d6f3683072,2,126,138,264,32,2014-09-18 21:03:31,2014-09-05 16:07:34
c7ee53ba9bf48dd958baa4cbc45ec5d6f3683072...1eaf5a41ba94c5787e72fe92ef4a91ac63f6a744,2,21,16,37,8,2014-09-18 21:33:39,2014-08-21 21:19:57
1eaf5a41ba94c5787e72fe92ef4a91ac63f6a744...28f15d30094b01c7e699a1ea9dd3185de96a89b5,2,32,11,43,13,2014-09-18 21:45:40,2014-06-13 23:11:56
28f15d30094b01c7e699a1ea9dd3185de96a89b5...fe9de6e07e646b9844cb241d4e202cc2b0275225,1,2,2,4,2,2014-09-18 21:47:04,2014-09-02 15:45:36
fe9de6e07e646b9844cb241d4e202cc2b0275225...f27db81a93a11e6191c24738a92d6873860731c8,1,7,2,9,4,2014-09-18 21:48:11,2014-09-02 15:49:07
f27db81a93a11e6191c24738a92d6873860731c8...e0fd81f00395ae2fde5c4e5f170590913d98cbf0,2,9,6,15,4,2014-09-22 15:12:08,2014-09-22 15:12:08
e0fd81f00395ae2fde5c4e5f170590913d98cbf0...16c35896492c55c129b07caa38c695301e77ade6,10,233,106,339,20,2014-09-22 17:45:41,2014-09-19 20:12:05
16c35896492c55c129b07caa38c695301e77ade6...32327199dfee2f94112e4aea6d2a49070d06f55f,7,7,7,14,7,2014-09-22 19:00:37,2014-09-22 19:00:37
32327199dfee2f94112e4aea6d2a49070d06f55f...4dcdc66318f9fc8665c0bad68dab24ee86f5c4ae,7,7,7,14,7,2014-09-22 21:08:11,2014-09-22 21:08:11
4dcdc66318f9fc8665c0bad68dab24ee86f5c4ae...7f3e27009faafa5b3f8913f05c1be3d49e36ff08,1,3,0,3,1,2014-09-22 21:08:59,2014-09-22 20:14:51
7f3e27009faafa5b3f8913f05c1be3d49e36ff08...e35fac47ce862eb15bb68fe5e290008c9edd0414,7,7,7,14,7,2014-09-22 21:10:26,2014-09-22 21:10:26
e35fac47ce862eb15bb68fe5e290008c9edd0414...34ec0d9eb7dcfbab15aa60823e5c869cc6177cba,7,7,7,14,7,2014-09-22 22:01:28,2014-09-22 22:01:28
34ec0d9eb7dcfbab15aa60823e5c869cc6177cba...a093502b6c97731a964aff8b499ec0378c3c53e5,1,8,8,16,5,2014-09-22 22:09:36,2014-09-22 21:47:57
a093502b6c97731a964aff8b499ec0378c3c53e5...eed6fc90e26f7606a4cd14705ca8c873f34fed83,2,66,0,66,2,2014-09-22 22:27:02,2014-08-27 14:09:04
eed6fc90e26f7606a4cd14705ca8c873f34fed83...e9cc37d2b51cc63e907be8d76be5feff08113b35,1,5,0,5,1,2014-09-23 21:11:48,2014-09-23 18:51:33
e9cc37d2b51cc63e907be8d76be5feff08113b35...d80e60ba69909ff6131da82674c6c9e788b28e4d,5,29,13,42,10,2014-09-24 20:13:59,2014-09-23 21:11:05
d80e60ba69909ff6131da82674c6c9e788b28e4d...b39f5ccc3e5c74918c8f2cd46d33c5b6316f4b06,1,18,0,18,2,2014-09-25 21:06:59,2014-09-25 20:20:43
b39f5ccc3e5c74918c8f2cd46d33c5b6316f4b06...d556b5b4c320a20ec7e3914b8378b21fe715c333,7,7,7,14,7,2014-09-25 21:25:21,2014-09-25 21:25:21
d556b5b4c320a20ec7e3914b8378b21fe715c333...c8574cb96bfb98e34483fc5fb4a8a89bb2b88cbd,7,7,7,14,7,2014-09-26 12:49:35,2014-09-26 12:49:35
c8574cb96bfb98e34483fc5fb4a8a89bb2b88cbd...243f11cd82d7925c77df0b04fad58b18f70cf031,2,28,4,32,5,2014-09-29 14:37:48,2014-09-28 00:14:09
243f11cd82d7925c77df0b04fad58b18f70cf031...e5de9146a0bcdd160661766cb168cb7530759444,2,40,7,47,9,2014-09-29 18:55:05,2014-09-29 12:25:36
e5de9146a0bcdd160661766cb168cb7530759444...db7a1fdca577fa56982b72f3b773194e12752b72,7,7,7,14,7,2014-09-29 19:06:08,2014-09-29 19:06:08
db7a1fdca577fa56982b72f3b773194e12752b72...622f348a0624989d2fa22df753307b9f170d261d,7,7,7,14,7,2014-09-29 20:13:30,2014-09-29 20:13:30
622f348a0624989d2fa22df753307b9f170d261d...0e6d61d465bbe8679f29339eee20b7ad9aec295e,1,0,9,9,1,2014-09-30 17:54:42,2014-09-30 17:54:42
0e6d61d465bbe8679f29339eee20b7ad9aec295e...88b9ac4ff69031ec95600cc0d570086715c60304,7,7,7,14,7,2014-09-30 19:06:21,2014-09-30 19:06:21
88b9ac4ff69031ec95600cc0d570086715c60304...e4854d288a7bbb39518cfb8e3fa8e82d23b16f00,7,7,7,14,7,2014-09-30 19:07:39,2014-09-30 19:07:39
e4854d288a7bbb39518cfb8e3fa8e82d23b16f00...0a98d654a7054d252dd921d27a5649f7177c8723,1,129,0,129,1,2014-10-06 15:34:27,2014-10-03 18:26:07
0a98d654a7054d252dd921d27a5649f7177c8723...9e58312f0363b8164b59dc2541b733d7417a9986,1,90,0,90,1,2014-10-06 15:36:41,2014-10-02 19:24:03
9e58312f0363b8164b59dc2541b733d7417a9986...375b413afc6423e2c9b648c51d63ae14080c9316,1,0,90,90,1,2014-10-07 16:06:54,2014-10-07 16:06:54
375b413afc6423e2c9b648c51d63ae14080c9316...a6cc9b3018bae5bc8eb305474a93afff9ad22158,1,0,129,129,1,2014-10-07 16:06:58,2014-10-07 16:06:58
a6cc9b3018bae5bc8eb305474a93afff9ad22158...e99d4fcb4279c0279796f237aa92fe3b64560bf6,7,7,7,14,7,2014-10-07 16:07:51,2014-10-07 16:07:51
e99d4fcb4279c0279796f237aa92fe3b64560bf6...8b399df575c07765ac60c004ca3cdca95bb1d3a5,7,7,7,14,7,2014-10-07 16:09:20,2014-10-07 16:09:20
8b399df575c07765ac60c004ca3cdca95bb1d3a5...79d2919a280497884017daf9f211a3d3e39af00b,2,222,0,222,2,2014-10-13 15:50:58,2014-10-02 19:24:03
79d2919a280497884017daf9f211a3d3e39af00b...209fa3c094b3068e122c6bd188ff772cf33e28de,1,10,3,13,2,2014-10-13 19:06:09,2014-10-02 12:14:14
209fa3c094b3068e122c6bd188ff772cf33e28de...638f6b7c9b02c30b53ac9e54a47466cb8dee194f,2,109,70,179,18,2014-10-15 04:11:06,2014-10-15 04:11:06
638f6b7c9b02c30b53ac9e54a47466cb8dee194f...392617ce3977b95b582238d7b7a77631ff22d206,1,1,1,2,1,2014-10-15 13:04:16,2014-10-15 13:04:09
392617ce3977b95b582238d7b7a77631ff22d206...8ffd49eda26de47acb766b4094f7aba4ddb7a25d,1,2,2,4,2,2014-10-27 14:21:03,2014-09-18 21:34:42
8ffd49eda26de47acb766b4094f7aba4ddb7a25d...035b5a90f56d653e930fcbe20c89f4dda7e48a30,1,3,2,5,1,2014-10-28 02:40:29,2014-10-15 19:25:07
035b5a90f56d653e930fcbe20c89f4dda7e48a30...3898bb1e160e1118a84114620bec62e63254ed77,3,82,5,87,8,2014-10-31 05:44:52,2014-10-30 20:52:01
3898bb1e160e1118a84114620bec62e63254ed77...3812167c6d2941108077dc2580ca231915fc48c3,2,6,6,12,6,2014-11-18 20:36:42,2014-11-10 17:32:47
3812167c6d2941108077dc2580ca231915fc48c3...81edd55c80fa66056bb7137e4770f761cfdfb9d6,2,8,8,16,8,2014-11-18 20:39:34,2014-10-10 19:26:09
81edd55c80fa66056bb7137e4770f761cfdfb9d6...19bcb1fadddfc72b21329809c9964ac279c5e194,1,2,2,4,1,2014-11-18 20:44:38,2014-05-09 20:29:57
19bcb1fadddfc72b21329809c9964ac279c5e194...f420349563f0a4aff5f0ec1fcb6854e5e20f0a0a,4,80,2,82,6,2014-11-18 23:07:05,2014-09-25 16:35:38
f420349563f0a4aff5f0ec1fcb6854e5e20f0a0a...cdcda1cd39528c6f2c732ccb7972f7726596c834,2,10,1,11,2,2014-11-18 23:21:14,2014-09-29 20:58:16
cdcda1cd39528c6f2c732ccb7972f7726596c834...ffab5c390b697d0c6e94d9ec160dade57aa07246,2,25,0,25,2,2014-11-18 23:24:41,2014-11-03 23:23:00
ffab5c390b697d0c6e94d9ec160dade57aa07246...afc1007c3f96f4bdcf890a779469bab44e5c333f,4,168,13,181,12,2014-11-19 00:03:55,2014-07-02 16:03:26
afc1007c3f96f4bdcf890a779469bab44e5c333f...2fcb960cdaeda3e6f6d4295936926712d04c6dd4,3,113,1,114,4,2014-11-20 14:19:12,2014-11-19 22:56:32
2fcb960cdaeda3e6f6d4295936926712d04c6dd4...671e340cf5a6676fb4008103d3f0e2684354be8f,2,133,9,142,4,2014-11-20 17:56:09,2014-11-05 21:09:58
671e340cf5a6676fb4008103d3f0e2684354be8f...903b0e905c80b4a2864cb5e05c11c5565b1f19f9,2,16,3,19,2,2014-11-20 19:06:40,2014-11-20 19:06:40
903b0e905c80b4a2864cb5e05c11c5565b1f19f9...b389ee1eedcc84dc9bc08d90145d88c837fa27b7,1,1,1,2,1,2014-11-21 16:00:21,2014-11-21 15:46:54
b389ee1eedcc84dc9bc08d90145d88c837fa27b7...a29c80455a16c46ae3ad7bd1e58d5299334123ca,1,55,24,79,2,2014-11-21 22:23:49,2014-08-04 18:11:45
a29c80455a16c46ae3ad7bd1e58d5299334123ca...0fdeb92b472e92b45937d2180bf20b2a8e44e489,1,12,0,12,1,2014-11-21 22:34:16,2014-06-13 18:25:20
0fdeb92b472e92b45937d2180bf20b2a8e44e489...2610caceffbf43ab65f85406f77fbcb8728ead25,1,4,4,8,1,2014-11-24 01:57:33,2014-10-14 00:05:29
2610caceffbf43ab65f85406f77fbcb8728ead25...d5c4eef6c9a6c82f7c84845f63a8d19fa12382c0,1,23,9,32,4,2014-11-24 03:05:20,2014-06-12 17:45:46
d5c4eef6c9a6c82f7c84845f63a8d19fa12382c0...7d13ae72f087e66085c33d61493efc2cc92063bc,3,3,3,6,3,2014-11-24 03:18:44,2014-04-24 20:44:00
7d13ae72f087e66085c33d61493efc2cc92063bc...fff8f3297645b6923d881d67a6d1008fe905543a,2,15,2,17,3,2014-11-24 03:36:43,2014-10-15 21:48:10
fff8f3297645b6923d881d67a6d1008fe905543a...230cdd386334f0f3e1e5d05be39ab57ccdd79772,2,16,16,32,8,2014-11-24 04:23:01,2014-05-21 13:03:11
230cdd386334f0f3e1e5d05be39ab57ccdd79772...4f91149f8e106993f4e8c93c557a74570f7f0938,1,9,6,15,5,2014-11-24 04:38:23,2014-05-15 21:50:49
4f91149f8e106993f4e8c93c557a74570f7f0938...360be90a97b62e2a0801e99275c91a1a80221ef6,2,8,2,10,2,2014-11-24 12:38:03,2014-11-12 10:53:33
360be90a97b62e2a0801e99275c91a1a80221ef6...c7fa0c9cec91f0b9bef31c00ae5a0df6cb7a1cf8,1,37,13,50,6,2014-11-24 18:30:43,2014-08-08 13:52:10
c7fa0c9cec91f0b9bef31c00ae5a0df6cb7a1cf8...17074f4f3e0e3c2572f248dee804cfbe66cebf1d,1,1,1,2,1,2014-11-24 18:30:43,2014-08-08 13:54:19
17074f4f3e0e3c2572f248dee804cfbe66cebf1d...b564e26b734f1a66323a4879674e96cf7c3d624f,4,47,1,48,6,2014-11-24 19:03:57,2014-11-24 16:26:19
b564e26b734f1a66323a4879674e96cf7c3d624f...ae7be5f2fa3ffb4efb51b564bcb5ad00b0033937,3,623,0,623,3,2014-11-24 19:29:02,2014-11-14 22:25:54
ae7be5f2fa3ffb4efb51b564bcb5ad00b0033937...741abbe02d6d0b6eb1334cc66458393363f30833,3,93,22,115,12,2014-11-24 19:29:23,2014-11-24 16:16:04
741abbe02d6d0b6eb1334cc66458393363f30833...4de3bd6c93195d0ccc23df67859b9c6441ec24d4,1,6,9,15,5,2014-11-24 20:46:46,2014-11-24 20:46:34
4de3bd6c93195d0ccc23df67859b9c6441ec24d4...f81009f1d2604d153cdeda9fb106dc86247e12f4,1,1,1,2,1,2014-11-24 20:58:00,2014-11-24 20:58:00
f81009f1d2604d153cdeda9fb106dc86247e12f4...a2d10e198453df287bc0af064e1d641194620e93,1,12,12,24,4,2014-11-24 21:39:19,2014-06-27 16:08:03
a2d10e198453df287bc0af064e1d641194620e93...10b781ea1d18d8ee487d0e1fc8bef537baabf4fe,1,18,0,18,1,2014-11-24 21:39:19,2014-11-20 02:42:14
10b781ea1d18d8ee487d0e1fc8bef537baabf4fe...24037e138350ca04e2484468978f58355bf1bb96,2,6,0,6,3,2014-11-24 21:40:03,2014-11-20 02:42:36
24037e138350ca04e2484468978f58355bf1bb96...a724bbb7eb6c046887c1a61516f273cef652f29c,1,10,2,12,4,2014-11-24 22:01:58,2014-10-15 14:17:21
a724bbb7eb6c046887c1a61516f273cef652f29c...bc21c23cbe79344034081bb8e4910fb0711b4ecc,1,1,1,2,1,2014-11-24 22:01:58,2014-10-15 17:29:21
bc21c23cbe79344034081bb8e4910fb0711b4ecc...a3ab21753b0dbf20cc98a6085a9c5af4e8af856d,1,1,1,2,1,2014-11-24 22:01:58,2014-10-15 19:41:11
a3ab21753b0dbf20cc98a6085a9c5af4e8af856d...0f7dbe98cd6a4f15eb7a112fbae62383fb3805c6,2,50,0,50,2,2014-11-24 23:01:05,2014-11-24 22:37:11
0f7dbe98cd6a4f15eb7a112fbae62383fb3805c6...1fca6e2b2679bb14f71a6e27d691297bc2fe46f2,1,268,130,398,22,2014-11-24 23:09:21,2013-07-26 20:09:07
1fca6e2b2679bb14f71a6e27d691297bc2fe46f2...a0d1aa6229be3dab2bf9616402d6b6a860376f60,2,684,666,1350,253,2014-11-24 23:53:41,2014-11-24 23:53:41
a0d1aa6229be3dab2bf9616402d6b6a860376f60...ca4a498ce711e307fb350e42be197d58d340c1cc,3,90,25,115,27,2014-11-25 07:48:35,2014-11-18 20:31:21
ca4a498ce711e307fb350e42be197d58d340c1cc...28afa1465ca07a6d6a34bf2c09affa120f64c835,1,5,4,9,5,2014-11-25 07:48:35,2014-10-01 15:41:52
28afa1465ca07a6d6a34bf2c09affa120f64c835...fa4f0277a788e78db3639eaa82d46bac1dfa9e34,1,7,6,13,3,2014-11-25 16:09:11,2014-11-24 22:25:10
fa4f0277a788e78db3639eaa82d46bac1dfa9e34...c8256d5ea1adf9c70c5f7fc5f03f017fa8c68ec8,1,0,15,15,1,2014-11-25 16:40:55,2014-11-25 16:24:49
c8256d5ea1adf9c70c5f7fc5f03f017fa8c68ec8...e34a30fbf39b50ed86d5c9de6a97fc28ad19a466,101,837,1660,2497,538,2014-11-25 18:29:09,2014-11-24 19:08:01
e34a30fbf39b50ed86d5c9de6a97fc28ad19a466...d1152d4bc387f53d2fda7ef5ce640f9a55d0c1d8,115,1185,1342,2527,424,2014-11-25 18:29:09,2014-11-24 19:08:40
d1152d4bc387f53d2fda7ef5ce640f9a55d0c1d8...242357a978d73724119fef759f9f30598a1420cc,1,5,5,10,5,2014-11-25 18:29:09,2014-05-15 21:50:49
242357a978d73724119fef759f9f30598a1420cc...cb7bad4830a2fef9ef0d3fec423371216ffcfe22,2,2,2,4,2,2014-11-25 18:29:10,2014-05-14 18:11:41
cb7bad4830a2fef9ef0d3fec423371216ffcfe22...9b520aab07f8f098561061603efba1b0351d9a35,3,5,1,6,5,2014-11-25 18:29:10,2014-11-24 16:31:57
9b520aab07f8f098561061603efba1b0351d9a35...8cbb64b0bc8180079e2247143ae16f8d83bb3a00,6,84,16,100,6,2014-11-25 18:57:30,2014-11-21 21:35:21
8cbb64b0bc8180079e2247143ae16f8d83bb3a00...b7fe5a5d72a4d7005852f8b211cd89ac6fab89df,1,2,22,24,2,2014-11-25 19:43:06,2014-11-21 18:29:56
b7fe5a5d72a4d7005852f8b211cd89ac6fab89df...32fb2dc80747aaf2de1bf315493d8d8a5d3fc99b,2,340,15,355,9,2014-11-25 22:24:31,2014-04-23 16:14:53
32fb2dc80747aaf2de1bf315493d8d8a5d3fc99b...a12f25486ecd7888e90950423e249a273d36aed8,5,260,163,423,82,2014-11-25 22:24:31,2014-07-28 15:35:11
a12f25486ecd7888e90950423e249a273d36aed8...fd8a2779971d095b2d13fb4c2dd06a11118908a4,8,331,108,439,41,2014-11-25 22:24:31,2014-08-01 15:57:03
fd8a2779971d095b2d13fb4c2dd06a11118908a4...d0cd0e0b62a85fb47b8be39e945715438410efec,1,1,1,2,1,2014-11-25 22:24:31,2014-09-11 18:33:34
d0cd0e0b62a85fb47b8be39e945715438410efec...2fb5b67d280b5aa1f196d9f0afe802120bc22a56,1,3,5,8,4,2014-11-25 22:36:26,2014-11-25 18:30:03
2fb5b67d280b5aa1f196d9f0afe802120bc22a56...dfe24c01783660cd923ca2a07e61dbb16ac8c736,1,1,2,3,1,2014-11-25 22:45:20,2014-11-25 22:31:45
dfe24c01783660cd923ca2a07e61dbb16ac8c736...4762a4c64a6d8cf89c4ca0e4a8030d6b41119cd9,1,13,0,13,2,2014-11-25 23:07:27,2014-11-25 21:46:22
4762a4c64a6d8cf89c4ca0e4a8030d6b41119cd9...06d1ad73640c6bc5787d62602ed2f5960e13487b,3,1,5,6,5,2014-11-25 23:10:18,2014-11-25 23:10:18
06d1ad73640c6bc5787d62602ed2f5960e13487b...afcb321a7d8aadabab127c84430f794feec2654d,2,2,2,4,2,2014-11-25 23:10:30,2014-11-25 23:10:30
afcb321a7d8aadabab127c84430f794feec2654d...958359a8d6d97011151142f7061aa9c2f742d0c8,1,5,5,10,5,2014-11-25 23:10:44,2014-11-25 23:10:44
958359a8d6d97011151142f7061aa9c2f742d0c8...e064261829d913ef223b6710e79c966a8bb4e364,115,1342,1185,2527,424,2014-11-25 23:10:58,2014-11-25 23:10:58
e064261829d913ef223b6710e79c966a8bb4e364...0f07af1389edc601d00bd556fc4a06d8e5754448,101,1660,837,2497,538,2014-11-25 23:11:33,2014-11-25 23:11:33
0f07af1389edc601d00bd556fc4a06d8e5754448...b85c4e1ab64c7b99f8c6f3cb70ba2e73004dea96,1,3,2,5,2,2014-11-26 16:32:14,2014-11-26 16:31:06
b85c4e1ab64c7b99f8c6f3cb70ba2e73004dea96...1bcd0d97e3f48bd1713f6e3905ac4fd603f09684,1,19,28,47,19,2014-11-28 15:02:33,2014-05-28 21:04:13
1bcd0d97e3f48bd1713f6e3905ac4fd603f09684...175d6ecb8bef59745a73fc7769c8a281aa70c7ad,1,2,2,4,2,2014-11-28 15:11:11,2014-11-28 15:11:11
175d6ecb8bef59745a73fc7769c8a281aa70c7ad...effc9042bdca26e40230399aac85e4a94a6fd01f,1,23,4,27,4,2014-12-01 09:21:50,2014-11-25 16:50:14
effc9042bdca26e40230399aac85e4a94a6fd01f...80afbf31aee7585814079cfdb1dc6281bd96a1e7,1,53,0,53,1,2014-12-01 09:21:50,2014-11-25 14:11:46
80afbf31aee7585814079cfdb1dc6281bd96a1e7...d331763a98ba86dcbfceb155c77fb3cb65deac5d,4,87,8,95,11,2014-12-01 16:04:50,2014-12-01 08:21:02
d331763a98ba86dcbfceb155c77fb3cb65deac5d...583191c572680b710f155b49bb2eb6ea20fbcc6b,1,4,1,5,2,2014-12-01 13:00:39,2014-12-01 11:48:50
583191c572680b710f155b49bb2eb6ea20fbcc6b...0a45db060988af7477098dcbe58609bf59f41962,7,7,7,14,7,2014-12-01 21:50:16,2014-12-01 21:50:16
0a45db060988af7477098dcbe58609bf59f41962...c8ccbc75df44e6fa192e256c4e52207c6ce93064,7,7,7,14,7,2014-12-02 12:06:50,2014-12-02 12:06:50
c8ccbc75df44e6fa192e256c4e52207c6ce93064...608e8bc319627693b04cc7da29ecc300a5f45a1f,7,7,7,14,7,2014-12-08 23:27:13,2014-12-08 23:27:13
608e8bc319627693b04cc7da29ecc300a5f45a1f...a8fb1429cb3099e0dbbfdbd930693810bbf291b1,7,7,7,14,7,2014-12-09 16:51:28,2014-12-09 16:51:28
a8fb1429cb3099e0dbbfdbd930693810bbf291b1...4a1a4010830fdf3b2d737164ce09c669fd9ed738,4,68,0,68,5,2014-12-18 20:25:42,2014-12-17 17:50:17
4a1a4010830fdf3b2d737164ce09c669fd9ed738...7983497cd7fdec7029f1638ab7d4309760dfba82,1,4,2,6,1,2014-12-18 23:07:57,2014-12-03 16:58:42
7983497cd7fdec7029f1638ab7d4309760dfba82...1156ec9b1ed8f85a15923e865b2f26c4f67ddf7e,1,1,0,1,1,2015-01-06 15:15:55,2014-12-03 20:17:08
1156ec9b1ed8f85a15923e865b2f26c4f67ddf7e...844d4b6bf595394e18f39921fc1c9e51f1c45379,1,1,1,2,1,2015-01-06 20:29:34,2014-12-23 21:33:38
844d4b6bf595394e18f39921fc1c9e51f1c45379...4b7a350224eef7676b4c49e2616bc2bee347420f,1,1,1,2,1,2015-01-06 17:28:54,2015-01-06 17:07:00
4b7a350224eef7676b4c49e2616bc2bee347420f...293bf1caf51df5b9cf7c882f2e6312769e1716a2,7,137,51,188,23,2015-01-06 22:42:48,2015-01-06 19:22:58
293bf1caf51df5b9cf7c882f2e6312769e1716a2...357cf5e9029db85ce36cd6c7ef181edcc142f493,4,34,1,35,6,2015-01-06 23:02:00,2014-12-19 20:16:02
357cf5e9029db85ce36cd6c7ef181edcc142f493...ac6013014ad51321c484f3505f9a3a088aa07d3f,7,7,7,14,7,2015-01-07 00:59:06,2015-01-07 00:59:06
ac6013014ad51321c484f3505f9a3a088aa07d3f...1c38ddd92395ec177c22a037d15867f8fccd8a7f,7,7,7,14,7,2015-01-07 19:06:21,2015-01-07 19:06:21
1c38ddd92395ec177c22a037d15867f8fccd8a7f...f5573139e64ada164711b2408dd913dce3e3dbe0,1,0,1,1,1,2015-01-12 14:50:58,2014-08-13 21:51:43
f5573139e64ada164711b2408dd913dce3e3dbe0...ec77ad006183c54154ecd30e14144577afbec3b8,1,1,0,1,1,2015-01-13 15:41:37,2015-01-13 15:41:37
ec77ad006183c54154ecd30e14144577afbec3b8...a7d57ad27c382de82e9cb93bf983a80fd9ac9899,7,7,7,14,7,2015-01-13 17:12:06,2015-01-13 17:12:06
a7d57ad27c382de82e9cb93bf983a80fd9ac9899...21a49b672559fc6d818b920d52ec5b2035f559f3,1,6,0,6,1,2015-01-14 20:06:28,2014-11-24 22:57:45
21a49b672559fc6d818b920d52ec5b2035f559f3...3e3b196f2353b6a0db8ec22f398dfa5327bd6cbd,1,0,1,1,1,2015-01-14 20:09:46,2014-08-13 21:51:43
3e3b196f2353b6a0db8ec22f398dfa5327bd6cbd...58f97ebadc1a510da1ebf8cb7606f96d55edbf43,1,0,6,6,1,2015-01-14 21:51:55,2015-01-14 21:51:55
58f97ebadc1a510da1ebf8cb7606f96d55edbf43...e93388bddcd6ed5b4c2a29565e02bc2cfb907b34,1,1,0,1,1,2015-01-14 21:52:10,2015-01-14 21:52:10
e93388bddcd6ed5b4c2a29565e02bc2cfb907b34...2d45919192d71bbb25af7436f5d4318943ac6053,7,7,7,14,7,2015-01-14 22:17:39,2015-01-14 22:17:39
2d45919192d71bbb25af7436f5d4318943ac6053...54be3ccc4f66b7a22ca1104cd02b43fc41dcbce4,1,6,0,6,1,2015-01-14 22:22:13,2014-11-24 22:57:45
54be3ccc4f66b7a22ca1104cd02b43fc41dcbce4...66f65bbd4db75bd88ff20df5991b1698cfcd10bf,1,0,1,1,1,2015-01-14 22:22:14,2014-08-13 21:51:43
66f65bbd4db75bd88ff20df5991b1698cfcd10bf...e367a48c7ff9eca187712fcfba1322c37af69780,1,1,1,2,1,2015-01-16 02:18:12,2014-12-04 21:15:49
e367a48c7ff9eca187712fcfba1322c37af69780...28b9b81eba5b79f1f83404d2220668fcbacd1aec,2,36,1,37,2,2015-01-22 16:27:09,2015-01-16 21:52:50
28b9b81eba5b79f1f83404d2220668fcbacd1aec...37ea3acc57d117ea6414c108b9c888083dbf2144,6,67,20,87,16,2015-01-23 20:30:24,2015-01-13 22:26:54
37ea3acc57d117ea6414c108b9c888083dbf2144...db71320ea9a3b9636a85fb96c4c16cee9c2dc409,3,18,3,21,6,2015-02-04 20:48:24,2014-09-24 14:36:02
db71320ea9a3b9636a85fb96c4c16cee9c2dc409...d148fd1b0cbaf6d19b91658598d0b7d4c2eb0a97,10,243,6,249,24,2015-02-06 19:41:41,2015-01-09 19:20:37
d148fd1b0cbaf6d19b91658598d0b7d4c2eb0a97...1b64aa84b80913a38928ac3aad9673fe7f570880,8,203,76,279,37,2015-02-06 21:55:08,2015-02-05 19:33:05
1b64aa84b80913a38928ac3aad9673fe7f570880...8321909044353580b66947c73f264a8575b90c66,3,42,0,42,7,2015-02-06 21:55:08,2015-02-06 18:21:40
8321909044353580b66947c73f264a8575b90c66...78d52ff64110f5590e60554c4ba58a68772e61df,1,8,3,11,1,2015-02-09 16:27:50,2015-02-05 22:32:09
78d52ff64110f5590e60554c4ba58a68772e61df...0de9b597c0dba9401fbcd2dfbe8f51bb55ce3241,1,4,2,6,3,2015-02-09 18:56:40,2014-06-18 03:34:32
0de9b597c0dba9401fbcd2dfbe8f51bb55ce3241...af299df741f0b0102fd9005cdfd066693aec6f16,1,6,0,6,3,2015-02-09 19:15:17,2014-07-24 21:04:47
af299df741f0b0102fd9005cdfd066693aec6f16...a1a1b60582d4dd7557c7fa40628342e1e030d1ce,1,2,1,3,1,2015-02-09 19:17:45,2014-08-08 18:15:14
a1a1b60582d4dd7557c7fa40628342e1e030d1ce...2bdd030e14b304d970a0e0cc614344f80400c6e6,1,2,1,3,2,2015-02-09 21:33:33,2015-01-23 22:30:27
2bdd030e14b304d970a0e0cc614344f80400c6e6...fba5adfea43de38102eb0cf7abc5cbd0523398ba,2,147,1,148,2,2015-02-09 21:33:33,2015-01-27 21:09:24
fba5adfea43de38102eb0cf7abc5cbd0523398ba...1dd33f490c47f8e4bc01f11931b62a463fe4fbca,1,1,1,2,1,2015-02-09 21:53:25,2015-02-09 21:38:56
1dd33f490c47f8e4bc01f11931b62a463fe4fbca...c9756fd528cc009cfd83c5bcfe9e309344f5e781,2,16,3,19,5,2015-02-09 22:40:29,2015-02-09 21:43:27
c9756fd528cc009cfd83c5bcfe9e309344f5e781...6d981db23d9ec7cdbfc3cbce8d6323ec0b6be816,1,2,1,3,1,2015-02-09 23:39:49,2015-02-09 21:24:56
6d981db23d9ec7cdbfc3cbce8d6323ec0b6be816...224067d03b7631d4c984fe99cccda3a0d2f6874c,1,6,0,6,1,2015-02-10 20:23:52,2015-02-09 21:45:18
224067d03b7631d4c984fe99cccda3a0d2f6874c...f2ddb7c3c2cf63faaa4eef796ee76e7342d1e82f,2,2,2,4,2,2015-02-11 13:46:39,2015-02-10 14:54:04
f2ddb7c3c2cf63faaa4eef796ee76e7342d1e82f...acf726499561a6ed34486bd4efcbf615405f93f8,1,17,0,17,3,2015-02-11 19:43:27,2015-02-11 18:30:37
acf726499561a6ed34486bd4efcbf615405f93f8...4d9728816460fcd7579071c0f64d0c97032a246d,1,26,0,26,5,2015-02-11 20:40:28,2015-02-11 14:56:01
4d9728816460fcd7579071c0f64d0c97032a246d...8f1c734c7f1862180f607c241fb167640889efba,2,21,0,21,2,2015-02-12 18:59:43,2015-02-12 03:12:37
8f1c734c7f1862180f607c241fb167640889efba...91ab64a4c0b8032120d319bb8c193b6d844a9583,1,3,2,5,2,2015-02-12 22:50:10,2014-08-06 16:06:56
91ab64a4c0b8032120d319bb8c193b6d844a9583...a5408edceb0e6b571bdd634afcf9bc5ee94e29c3,1,3,0,3,2,2015-02-13 22:11:51,2015-02-13 16:49:49
a5408edceb0e6b571bdd634afcf9bc5ee94e29c3...738e366c87c705de55d034835a5897cc136c8e0c,7,7,7,14,7,2015-02-17 16:53:16,2015-02-17 16:53:16
738e366c87c705de55d034835a5897cc136c8e0c...5b0ff618892c7c13f9c210b1f7feb0b44247a4af,7,7,7,14,7,2015-02-17 22:27:50,2015-02-17 22:27:19
5b0ff618892c7c13f9c210b1f7feb0b44247a4af...3abc04d6d4f71de00b57378e3277def8fd7a6700,7,7,7,14,7,2015-02-24 16:07:59,2015-02-24 16:07:59
3abc04d6d4f71de00b57378e3277def8fd7a6700...a34e139154df1d75093c900fef9cae7d9c61b97e,7,7,7,14,7,2015-02-25 16:44:34,2015-02-25 16:44:34
a34e139154df1d75093c900fef9cae7d9c61b97e...7e6ff30639d758104ce64ffac5b6ac588ae3d976,1,1,1,2,1,2015-03-02 11:31:22,2015-03-02 11:23:50
7e6ff30639d758104ce64ffac5b6ac588ae3d976...221e9a82b87e4f3297b4b057820c90820bf0d009,1,15,8,23,4,2015-03-02 20:24:21,2015-03-02 20:24:21
221e9a82b87e4f3297b4b057820c90820bf0d009...66032f9ec00a0f16cbb2ad0565548c6b1a564099,1,8,15,23,4,2015-03-02 22:03:39,2015-03-02 22:03:39
66032f9ec00a0f16cbb2ad0565548c6b1a564099...ff64c70f6994520827dceeaf4c82c7061ff10b8c,1,24,5,29,2,2015-03-03 20:31:48,2015-01-28 22:54:11
ff64c70f6994520827dceeaf4c82c7061ff10b8c...5f889dfec4c625af3413348cdc9b409998d33238,3,29,5,34,7,2015-03-05 17:31:06,2015-03-03 20:07:06
5f889dfec4c625af3413348cdc9b409998d33238...77fb852fb232c846b9a22a9a72c262639df9c47c,3,161,27,188,27,2015-03-05 18:31:17,2015-02-12 05:56:59
77fb852fb232c846b9a22a9a72c262639df9c47c...551728cbb5134f83859b90dc13bfe0174c1e6493,141,124610,0,124610,141,2015-03-05 20:09:12,2015-02-19 16:43:25
551728cbb5134f83859b90dc13bfe0174c1e6493...060ec05e9af5530830781da7e69510b8a7474f80,1,5,2,7,1,2015-03-05 20:09:12,2015-02-19 23:14:52
060ec05e9af5530830781da7e69510b8a7474f80...4eb56a194b5d1f4123f1b66b6cef7bba54e3d352,5,825,1,826,6,2015-03-05 20:09:13,2015-02-20 15:56:24
4eb56a194b5d1f4123f1b66b6cef7bba54e3d352...525f13d490317e235fe7bbe193d23ed9362dd16a,1,7,7,14,7,2015-03-05 20:09:13,2015-03-05 05:27:27
525f13d490317e235fe7bbe193d23ed9362dd16a...62c7c349095713d14e6035f356981398a16c55a6,2,4,4,8,4,2015-03-05 20:09:13,2015-03-05 15:33:01
62c7c349095713d14e6035f356981398a16c55a6...b6a66a0c3494687c8b059d5f39de072a22e650a4,3,72,4,76,17,2015-03-06 00:42:58,2015-02-17 17:40:39
b6a66a0c3494687c8b059d5f39de072a22e650a4...9af0d09d28ec052740e80706e4b8844a564e93a0,1,7,1,8,2,2015-03-06 16:18:41,2015-03-03 21:03:30
9af0d09d28ec052740e80706e4b8844a564e93a0...e5584c81d94a67ce7a77cf9ecdf4c4d5bcfffd1a,1,2179,0,2179,1,2015-03-06 19:36:30,2015-03-06 19:36:30
e5584c81d94a67ce7a77cf9ecdf4c4d5bcfffd1a...6b06804ca2a2d0bb292eb58510eb0f2808e879a4,2,30,23,53,9,2015-03-10 20:56:10,2015-03-10 17:24:16
6b06804ca2a2d0bb292eb58510eb0f2808e879a4...f6debcc8c2884c60a1d694e35089c2950cccb946,1,4,1,5,2,2015-03-12 21:56:06,2014-10-30 20:45:36
f6debcc8c2884c60a1d694e35089c2950cccb946...a5a48528b5349cc9af56b784f4fd583dcfb11e32,3,24,1,25,9,2015-03-13 20:02:07,2015-03-11 18:09:55
a5a48528b5349cc9af56b784f4fd583dcfb11e32...e9e813d4680b6894b0d3b84859da94b5b9fe95af,1,2,0,2,1,2015-03-13 21:28:18,2015-03-13 16:53:53
e9e813d4680b6894b0d3b84859da94b5b9fe95af...e3a769273df9e1217a9c85d067db058e4293952f,3,17,2,19,6,2015-03-13 22:01:59,2015-03-13 12:48:48
e3a769273df9e1217a9c85d067db058e4293952f...3133d042c0969aaa8be62effa1a74b4ac5996607,7,7,7,14,7,2015-03-16 18:46:39,2015-03-16 18:46:39
3133d042c0969aaa8be62effa1a74b4ac5996607...2dee1ade7cc682fbfe942d691b01be6fb33d4d17,7,7,7,14,7,2015-03-16 21:21:28,2015-03-16 21:21:28
4c208580ad4f2e7e33ab77bae52e45b99fba1f4c...26de46b57b2819b002e1061c59a32282f3c45ac6,4,783,792,1575,348,2014-06-24 20:29:51,2014-06-24 20:29:51
4c208580ad4f2e7e33ab77bae52e45b99fba1f4c...82feb98aae3d44b7c6e9a6843ea60d3b49d92692,2,33,12,45,14,2014-06-24 15:44:55,2014-06-13 23:11:56
a5ca7362447e45e0418ee4b50feae29e35009fe6...7b5ab9a90dac5f33024bd124bbae2262a15fe2ce,1,2,2,4,2,2014-06-25 11:53:33,2014-06-25 11:53:33
7b5ab9a90dac5f33024bd124bbae2262a15fe2ce...2c33560630b7529d3e939d804915e54e99dfbb6d,1,0,1,1,1,2014-06-25 13:52:35,2014-06-25 03:10:37
2c33560630b7529d3e939d804915e54e99dfbb6d...f6f3527b476a0cc40ed62f1f15e95385d3aa32c4,1,5,1,6,2,2014-06-25 13:52:35,2014-06-25 03:10:57
f6f3527b476a0cc40ed62f1f15e95385d3aa32c4...1c9a75094b829795c2b99aa9f180c3ed2f5a3405,21,3144,3,3147,25,2014-06-25 13:52:35,2014-06-25 03:11:40
1c9a75094b829795c2b99aa9f180c3ed2f5a3405...1dd3a245f90c6d33ec1d1274964ec3dfcd2ac74d,2,2,10,12,3,2014-06-25 16:09:59,2014-06-25 16:09:59
1dd3a245f90c6d33ec1d1274964ec3dfcd2ac74d...11ea31ab1ac1109af219f7a36fb21dcf7dbbe5da,2,6,15,21,6,2014-06-25 18:45:14,2011-10-09 07:17:03
11ea31ab1ac1109af219f7a36fb21dcf7dbbe5da...cdd1172ad392b8c2321e4e140b020edf8c97b7c9,5,121,19,140,22,2014-06-25 19:01:59,2014-06-19 18:38:00
cdd1172ad392b8c2321e4e140b020edf8c97b7c9...600ec8db2b83ae5e2fd21d3da266af7d65b2d0c1,1,3,3,6,3,2014-06-25 19:32:45,2014-06-19 21:29:55
600ec8db2b83ae5e2fd21d3da266af7d65b2d0c1...cdfdc8ee6bbe09cc76724a2f559fe0dc98faa220,1,1,1,2,1,2014-06-25 19:50:29,2014-06-19 21:55:58
cdfdc8ee6bbe09cc76724a2f559fe0dc98faa220...caa0432e6e3f3f5355dcedbc2352625b07453435,4,127,0,127,7,2014-06-25 20:04:47,2014-06-19 20:02:15
caa0432e6e3f3f5355dcedbc2352625b07453435...2e68421c8f524fb5b4c983e9042e56a828a77e84,1,3,0,3,1,2014-06-25 20:18:53,2014-05-31 18:03:25
2e68421c8f524fb5b4c983e9042e56a828a77e84...c3da6483fcc530b174bc7b50b1aa91d3554e8ade,1,3,1,4,1,2014-06-25 20:18:53,2014-06-19 02:55:55
c3da6483fcc530b174bc7b50b1aa91d3554e8ade...0250c948105ffaa643cf56dba74fe54dab947304,1,1,1,2,1,2014-06-25 20:18:53,2014-06-19 03:04:40
0250c948105ffaa643cf56dba74fe54dab947304...5632cbd52558daeecaf42270a7e919418cb53ab0,2,2,2,4,2,2014-06-26 01:20:00,2014-06-14 02:27:17
5632cbd52558daeecaf42270a7e919418cb53ab0...d9c3bebb6b5b48dea69d5548b2d75db009812ee5,1,8,9,17,2,2014-06-26 14:57:57,2014-06-18 19:29:43
d9c3bebb6b5b48dea69d5548b2d75db009812ee5...c0fcdc06f1b1af2fdb88fbef0cd85546a848be50,14,194,72,266,23,2014-06-26 14:57:57,2014-06-18 23:11:55
c0fcdc06f1b1af2fdb88fbef0cd85546a848be50...072d42fd7f374de0e4ce59b5ce711df4f5bff744,8,167,112,279,12,2014-06-26 14:57:57,2014-06-18 23:49:50
072d42fd7f374de0e4ce59b5ce711df4f5bff744...31dd0e70b3e3d84d2f048b6dcd522c6b409f913f,9,66,22,88,18,2014-06-26 14:57:57,2014-06-19 21:31:19
31dd0e70b3e3d84d2f048b6dcd522c6b409f913f...d432d2e50be1974bff5c30b9911e5a6ddf27a725,8,148,81,229,11,2014-06-26 14:57:58,2014-06-19 22:36:52
d432d2e50be1974bff5c30b9911e5a6ddf27a725...eec11bb2f9e7f428afcfe4036a79dbc231e1d6a0,10,91,14,105,14,2014-06-26 14:57:58,2014-06-20 21:47:35
eec11bb2f9e7f428afcfe4036a79dbc231e1d6a0...341ae84ab27b2676121051422643e9e7039757d0,6,88,25,113,12,2014-06-26 19:47:01,2014-06-26 13:31:15
341ae84ab27b2676121051422643e9e7039757d0...7cf2a7c7a025257bab5d86d79f350301ba1a36e4,8,43,9,52,9,2014-06-26 14:58:51,2014-06-19 14:39:13
7cf2a7c7a025257bab5d86d79f350301ba1a36e4...80788f57c289fdf5f02418bc46dee6c802e966b9,10,81,17,98,12,2014-06-26 14:58:51,2014-06-19 14:54:37
80788f57c289fdf5f02418bc46dee6c802e966b9...c456786eb2e812440fa6854e2f730b161e6e70ea,11,68,35,103,27,2014-06-26 14:58:51,2014-06-19 15:18:20
c456786eb2e812440fa6854e2f730b161e6e70ea...a99774c9f332bf8b2eab51f42a6f2a6692c22fba,8,114,25,139,10,2014-06-26 14:58:51,2014-06-20 16:51:49
a99774c9f332bf8b2eab51f42a6f2a6692c22fba...d079a819ec6a3c5c50f4498720e5034bc1ded268,1,1,1,2,1,2014-06-26 14:58:51,2014-06-23 14:03:48
d079a819ec6a3c5c50f4498720e5034bc1ded268...6dea111420582f580ff8caab2e783b228f4e0f61,1,2,2,4,2,2014-06-26 14:58:51,2014-06-23 15:05:08
6dea111420582f580ff8caab2e783b228f4e0f61...6937b273a7a9db13279161ba3e74259eb89b0d15,2,42,8,50,3,2014-06-26 20:13:29,2014-06-26 17:30:54
6937b273a7a9db13279161ba3e74259eb89b0d15...9e93c8d95e7b7fb56f8746fd691b514d7957045f,42,353,232,585,123,2014-06-26 20:15:50,2014-06-26 14:38:26
9e93c8d95e7b7fb56f8746fd691b514d7957045f...e1dca2cdeed7cf5549a85d487def752d600af244,1,5,3,8,3,2014-06-26 20:15:51,2014-06-26 15:26:24
e1dca2cdeed7cf5549a85d487def752d600af244...4d00dd9723f84f197afffd901101276916d1ee6c,13,821,26,847,26,2014-06-26 23:41:32,2014-06-10 22:50:40
4d00dd9723f84f197afffd901101276916d1ee6c...b08b3ae8320d747f25da30f3fca939051707677c,2,124,0,124,5,2014-06-27 13:42:53,2014-06-27 12:39:47
b08b3ae8320d747f25da30f3fca939051707677c...a67bddc57c9b8a8d9d13ac30ebe74f9914b0c6d0,15,57,11,68,39,2014-06-27 13:42:54,2014-06-26 22:08:46
a67bddc57c9b8a8d9d13ac30ebe74f9914b0c6d0...1cc6be662ccd83b0341ef1f31f8f4ad30dc69451,79,3337,694,4031,220,2014-06-27 13:56:04,2014-06-11 18:24:20
1cc6be662ccd83b0341ef1f31f8f4ad30dc69451...8ec5d664cbc47578d01ffb07aa31f32544b1a345,1,3,5,8,3,2014-06-27 14:29:12,2014-06-27 14:29:12
8ec5d664cbc47578d01ffb07aa31f32544b1a345...d21efec1d8a3554792ca72a666fc61cd09f85ec9,20,43,47,90,37,2014-06-27 15:40:47,2014-06-26 17:29:05
d21efec1d8a3554792ca72a666fc61cd09f85ec9...8a6991a71d05272b6fce1b229e005d5711df9b35,22,31,34,65,29,2014-06-27 18:16:25,2014-06-26 18:02:31
8a6991a71d05272b6fce1b229e005d5711df9b35...3dd06b892e68b7af018b8d4c7ea65aa0d9e31b1b,4,10,57,67,6,2014-06-27 18:33:18,2014-06-27 15:49:34
3dd06b892e68b7af018b8d4c7ea65aa0d9e31b1b...94ff35ae69bed75b1d367e1b0bf154d236850fc7,2,0,72,72,2,2014-06-27 18:33:18,2014-06-27 15:52:23
94ff35ae69bed75b1d367e1b0bf154d236850fc7...8c2f7ee6a02d327c7d49025132983a0fe962745b,3,0,55,55,4,2014-06-27 18:33:18,2014-06-27 15:54:05
8c2f7ee6a02d327c7d49025132983a0fe962745b...3704fa06bee441dca68521b4be71edc21d00420b,1,12,12,24,4,2014-06-27 18:33:18,2014-06-27 16:08:03
3704fa06bee441dca68521b4be71edc21d00420b...08571fb7fdaef4f611f11d4456fc2c78e10d9705,10,9,23,32,13,2014-06-27 18:33:19,2014-06-27 16:09:42
08571fb7fdaef4f611f11d4456fc2c78e10d9705...818302f1f1d9728e9a0688def022b8ea62f65544,2,63,0,63,2,2014-06-27 18:37:27,2014-06-26 20:58:09
818302f1f1d9728e9a0688def022b8ea62f65544...207c8850f59a5f3ad113211167ad6844761ea264,1,1,1,2,1,2014-06-27 19:11:45,2014-06-27 19:11:45
207c8850f59a5f3ad113211167ad6844761ea264...cf9d8c3ff9733686326fa2a96cd654cd8be3818a,16,40,21,61,29,2014-06-27 19:15:27,2014-06-27 18:31:29
cf9d8c3ff9733686326fa2a96cd654cd8be3818a...0fe44a581bcf3028ed5ddb31256ce5ce07d1f452,3,4,1,5,4,2014-06-27 19:15:27,2014-06-27 19:06:03
0fe44a581bcf3028ed5ddb31256ce5ce07d1f452...3de470bbddb4cd228161f90a7034dc1deb8b12fd,12,78,30,108,39,2014-06-27 15:52:34,2014-06-26 14:58:21
3de470bbddb4cd228161f90a7034dc1deb8b12fd...b9a211782b7ca536ccb6c23b2017434317ca3da3,3,39,51,90,14,2014-06-27 22:19:50,2014-06-26 15:26:46
b9a211782b7ca536ccb6c23b2017434317ca3da3...ecfc44d7bce08660804fa4475b45f9a09d203f09,1,11,5,16,5,2014-06-27 22:19:51,2014-06-27 15:49:33
ecfc44d7bce08660804fa4475b45f9a09d203f09...52edab726185cbba1401cb46de221fb3d1cb0408,73,1029,908,1937,642,2014-06-28 02:54:43,2014-06-13 19:35:51
52edab726185cbba1401cb46de221fb3d1cb0408...89fcbab94c7103105e8c72f654a5774a066bdb90,73,908,1029,1937,642,2014-06-28 16:21:39,2014-06-28 16:21:39
89fcbab94c7103105e8c72f654a5774a066bdb90...e1f5a39b1b625d04752be13f39c774e579b64cd8,72,1010,898,1908,634,2014-06-28 18:12:40,2014-06-28 18:12:40
e1f5a39b1b625d04752be13f39c774e579b64cd8...44b0e3591839525a0c951319540488814e5c25fd,1,1,1,2,1,2014-06-30 14:34:16,2014-06-20 08:40:08
44b0e3591839525a0c951319540488814e5c25fd...4350bfad7cea746d081190063a6f5a2b00531132,1,3,1,4,1,2014-06-30 15:29:24,2014-06-30 15:29:16
4350bfad7cea746d081190063a6f5a2b00531132...5d4b3fe40cfe91857850d89a7a99a07d41b1d48d,1,5,0,5,3,2014-06-30 15:46:37,2013-07-11 17:30:54
5d4b3fe40cfe91857850d89a7a99a07d41b1d48d...09d2bf2a43cbf6e7ac10d4dc89934528001d0b69,10,225,43,268,44,2014-06-30 17:21:53,2014-06-19 22:12:10
09d2bf2a43cbf6e7ac10d4dc89934528001d0b69...e9a6e9365cf4d6d13b4a3f94aec1f433dab9f704,2,23,0,23,3,2014-06-30 18:24:10,2014-06-27 17:15:59
e9a6e9365cf4d6d13b4a3f94aec1f433dab9f704...a353e16805d573af3d5ab4d32fbda87ec98d5c40,72,898,1010,1908,634,2014-06-30 19:08:13,2014-06-30 19:08:13
a353e16805d573af3d5ab4d32fbda87ec98d5c40...30ac4291346859a24fbd5f17b8b99ca598bcab69,14,451,426,877,139,2014-06-30 20:07:45,2014-06-27 23:18:09
30ac4291346859a24fbd5f17b8b99ca598bcab69...619bc69cea6b8b6b543c26b6b0246af704916fd6,13,13,13,26,13,2014-06-30 20:07:45,2014-06-28 01:37:23
619bc69cea6b8b6b543c26b6b0246af704916fd6...95ad239c59e91b295b16a9a3e61c606a1e5be26e,2,0,9,9,3,2014-06-30 20:07:45,2014-06-28 01:39:36
95ad239c59e91b295b16a9a3e61c606a1e5be26e...7a0d83d88d18d5c28fe13bd5dc0b13d1c6c2ef22,5,48,9,57,6,2014-06-30 22:17:22,2014-06-30 19:29:42
7a0d83d88d18d5c28fe13bd5dc0b13d1c6c2ef22...1a49d864f34812f73c10b8e0b30c15150cb6ca69,24,53,45,98,44,2014-06-30 23:02:35,2014-06-27 17:49:24
1a49d864f34812f73c10b8e0b30c15150cb6ca69...12599c2b6797d1b7ec60f3a79fe12d67bc22c4e3,4,185,135,320,22,2014-06-30 23:02:35,2014-06-27 15:45:48
12599c2b6797d1b7ec60f3a79fe12d67bc22c4e3...d211a326cd98d8b97c80e2a9945220c543c77d03,11,79,52,131,21,2014-07-01 01:45:54,2014-06-28 15:44:17
d211a326cd98d8b97c80e2a9945220c543c77d03...8aa51c901f184564cb0fe44f2f5b9125f69849ee,3,121,78,199,3,2014-07-01 01:45:54,2014-06-30 17:37:36
8aa51c901f184564cb0fe44f2f5b9125f69849ee...8b2cee4dd2e71187f69c23f1b265c01377ebd69f,10,152,6,158,11,2014-07-01 01:45:54,2014-07-01 01:43:13
8b2cee4dd2e71187f69c23f1b265c01377ebd69f...904af6bcdfda4d1ae0bf97b9748525b366cae912,1,6,1,7,1,2014-07-01 01:45:54,2014-07-01 01:43:37
904af6bcdfda4d1ae0bf97b9748525b366cae912...1bf271c35ea47cfd63820173b70ee016e2935e23,1,1,1,2,1,2014-07-01 02:31:34,2014-07-01 02:31:34
1bf271c35ea47cfd63820173b70ee016e2935e23...e7e24a657b64fa59c30b063c72ff4cbee9674b7e,7,13,54,67,11,2014-07-01 12:57:49,2014-07-01 12:57:49
e7e24a657b64fa59c30b063c72ff4cbee9674b7e...f64357e485c8d46bd6fd393f7416df6117672de1,72,1016,912,1928,640,2014-07-01 13:04:58,2014-07-01 07:56:39
f64357e485c8d46bd6fd393f7416df6117672de1...ef3e85d4f5b67c039668cef805459e29711aa636,64,352,37,389,287,2014-07-01 14:27:12,2014-06-30 20:12:03
ef3e85d4f5b67c039668cef805459e29711aa636...77f636c4606e01f28c1d8c6bb6606487ede2ffc8,2,158,0,158,2,2014-07-01 15:43:45,2014-06-28 04:54:54
77f636c4606e01f28c1d8c6bb6606487ede2ffc8...255d39c611877420112c3c2857cb11db49dc33a3,2,50,11,61,9,2014-07-01 15:43:45,2012-03-23 12:19:21
255d39c611877420112c3c2857cb11db49dc33a3...2d9368486aef3aee029ed46b7bd320e53c1ac3f4,2,16,37,53,2,2014-07-01 15:43:46,2014-06-28 05:09:42
2d9368486aef3aee029ed46b7bd320e53c1ac3f4...676af72da3eb3dc0b5b9581e3254a0ed385e1dbb,2,62,56,118,28,2014-07-01 16:00:29,2014-06-30 18:02:04
676af72da3eb3dc0b5b9581e3254a0ed385e1dbb...db747740cc1edc0b9d789ecad961069fa9183cfe,3,21,8,29,8,2014-07-01 11:11:02,2014-06-26 12:22:00
db747740cc1edc0b9d789ecad961069fa9183cfe...fa3935335b547fc0d1a177b39047d41caa0651d8,12,45,130,175,17,2014-07-01 11:11:02,2014-06-26 14:05:23
fa3935335b547fc0d1a177b39047d41caa0651d8...b79cde3c3211ca7882a5582a933b923e89bbc026,3,5,8,13,4,2014-07-01 11:11:02,2014-06-26 16:50:54
b79cde3c3211ca7882a5582a933b923e89bbc026...8407b0ebabc5d11feeae22d4ed6d4d709d13a493,1,6,3,9,3,2014-07-01 17:02:35,2014-06-03 20:02:47
8407b0ebabc5d11feeae22d4ed6d4d709d13a493...44c3347251e39b1a04717e02cec4a7ff626baf4e,3,44,45,89,20,2014-07-01 17:38:52,2014-05-09 18:54:09
44c3347251e39b1a04717e02cec4a7ff626baf4e...f8c98bee1208e04259814e0818f405081132d42c,107,486,55,541,306,2014-07-01 19:32:29,2014-06-27 14:15:15
f8c98bee1208e04259814e0818f405081132d42c...f1a3238f53ed4d0d071edc5d9db51c90ffa78f78,22,147,150,297,93,2014-07-02 01:28:05,2014-07-01 15:51:00
f1a3238f53ed4d0d071edc5d9db51c90ffa78f78...8ad0bf94e69d09ab3bbb02e5493e69e7e392b0c3,2,31,26,57,10,2014-07-02 18:18:19,2014-07-01 20:37:40
8ad0bf94e69d09ab3bbb02e5493e69e7e392b0c3...f28cc1add7a765364364f25490f57a623615f297,5,432,18,450,23,2014-07-02 18:35:25,2014-06-27 20:27:29
f28cc1add7a765364364f25490f57a623615f297...eb379a2c8c2ae9e6ba580020631f9b7efce7026e,1,10,4,14,2,2014-07-02 18:38:36,2014-07-02 15:37:24
eb379a2c8c2ae9e6ba580020631f9b7efce7026e...4adee3fa86664d37c778bb0293e709629711478d,1,6,0,6,1,2014-07-02 18:54:28,2014-07-01 19:31:17
4adee3fa86664d37c778bb0293e709629711478d...962dae30460ca6c2a9115b2d950cc8f2f6120d54,2,37,18,55,16,2014-07-02 20:56:27,2012-04-09 09:43:52
962dae30460ca6c2a9115b2d950cc8f2f6120d54...8ada5660746aa5aa351cc36e8d793cbc353c4fad,3,37,17,54,18,2014-07-02 20:56:45,2014-07-02 13:47:24
8ada5660746aa5aa351cc36e8d793cbc353c4fad...e8b6969143e1d218a105c64716203fd7b74137d4,1,22,7,29,5,2014-07-02 23:17:55,2014-07-02 17:00:15
e8b6969143e1d218a105c64716203fd7b74137d4...484a5bb3542a73f4a10bc962e2b1b0f05a402659,4,96,2,98,8,2014-07-02 23:18:23,2014-06-30 21:06:55
484a5bb3542a73f4a10bc962e2b1b0f05a402659...13693a083ef299c2de0759ed34c53b9370c850f6,3,67,23,90,16,2014-07-02 23:18:37,2014-07-01 20:42:50
13693a083ef299c2de0759ed34c53b9370c850f6...aa733b699fa1b60c0a6f895e5f0eb0a0654089a8,7,27,26,53,19,2014-07-02 23:34:08,2014-07-02 19:50:42
aa733b699fa1b60c0a6f895e5f0eb0a0654089a8...3bd610b70b7b779384fe042f36d25c55ce15b0d3,9,97,115,212,41,2014-07-02 23:34:08,2014-06-25 21:00:45
3bd610b70b7b779384fe042f36d25c55ce15b0d3...e48abc5beeec5c8b79a6a6a42f9d374ccd323fd2,1,4,4,8,2,2014-07-03 00:47:04,2014-06-13 22:18:20
e48abc5beeec5c8b79a6a6a42f9d374ccd323fd2...9353eeba86181872722385f95c013b5b5b98f367,1,6,4,10,3,2014-07-03 00:47:04,2014-06-13 22:22:52
9353eeba86181872722385f95c013b5b5b98f367...e9fc46ab7d8cfe96454067036f0d272b61c7ab0a,1,28,0,28,1,2014-07-03 00:47:05,2014-06-13 22:17:32
e9fc46ab7d8cfe96454067036f0d272b61c7ab0a...d4f9243fe8657876ffca838467f696aadad98414,7,7,7,14,7,2014-07-03 15:27:45,2014-07-03 15:25:38
d4f9243fe8657876ffca838467f696aadad98414...1edad42278a0708590f7a695f0dc66134256a6e8,7,7,7,14,7,2014-07-03 15:49:33,2014-07-03 15:49:33
1edad42278a0708590f7a695f0dc66134256a6e8...176e32c2d21da5e3f9f2c3f51a23572974111131,15,99,73,172,48,2014-07-03 12:07:42,2014-06-30 15:16:41
176e32c2d21da5e3f9f2c3f51a23572974111131...78e3773f602cc2bb248e895d7877ab12e9dade8f,10,34,9,43,13,2014-07-03 12:07:43,2014-07-01 16:14:48
78e3773f602cc2bb248e895d7877ab12e9dade8f...7fc706b46ffd226e735e865cc379ea66ed8e8119,10,31,10,41,13,2014-07-03 12:07:43,2014-07-01 16:51:13
7fc706b46ffd226e735e865cc379ea66ed8e8119...668f02b7761e8a29c44cc05aa03f2c59840106bc,2,5,5,10,2,2014-07-03 12:07:43,2014-07-01 17:36:10
668f02b7761e8a29c44cc05aa03f2c59840106bc...0747f835337bfd757cf7fe9c50d441a994fbb979,8,25,1,26,8,2014-07-03 12:07:43,2014-07-02 14:08:16
0747f835337bfd757cf7fe9c50d441a994fbb979...8988ae6803766c61c0a134c33986e252333bdeed,8,29,1,30,8,2014-07-03 12:07:43,2014-07-02 14:24:17
8988ae6803766c61c0a134c33986e252333bdeed...7fb52123c945b85866258fdb491c683c5aa54651,1,1,6,7,2,2014-07-03 13:17:34,2014-07-01 17:37:38
7fb52123c945b85866258fdb491c683c5aa54651...15b29e47fc909680de31c77513d3ab9a49738be0,6,12,0,12,6,2014-07-07 08:26:54,2014-07-01 08:24:24
15b29e47fc909680de31c77513d3ab9a49738be0...e307a5f6a8d1aeb5d6b7e32c5c0df1887301ec1c,1,1,1,2,1,2014-07-07 12:43:50,2014-07-07 12:43:50
e307a5f6a8d1aeb5d6b7e32c5c0df1887301ec1c...3545063aa9bf2c01cbd455cae6b20ec783e15d92,2,0,25,25,2,2014-07-07 17:55:21,2014-07-03 22:36:04
3545063aa9bf2c01cbd455cae6b20ec783e15d92...d00eec87e625938e08d298f2a3b312979107e941,1,69,66,135,2,2014-07-07 20:10:34,2014-07-03 20:12:57
d00eec87e625938e08d298f2a3b312979107e941...ce0a498360ed1b178b300d1b817ca33a14dc6d9a,3,167,0,167,3,2014-07-07 20:49:26,2014-07-03 19:50:27
ce0a498360ed1b178b300d1b817ca33a14dc6d9a...8b8a118fc965231293ad56c53a837ffacb17132f,4,164,13,177,12,2014-07-07 21:07:57,2014-07-02 16:03:26
8b8a118fc965231293ad56c53a837ffacb17132f...b1048dc6f42e184c08853fe98c21a90ecfb40d6b,1,1,1,2,1,2014-07-07 23:07:19,2014-07-07 23:06:56
b1048dc6f42e184c08853fe98c21a90ecfb40d6b...0450a0f25d4509f6515e939a5ef3a671f744cc2a,146,1398,1012,2410,935,2014-07-08 14:53:53,2014-06-25 21:06:03
0450a0f25d4509f6515e939a5ef3a671f744cc2a...1fb34007c07dcb93f6a5f7f85dc189afd18825a5,1,27,28,55,12,2014-07-08 14:58:47,2014-07-08 01:52:26
1fb34007c07dcb93f6a5f7f85dc189afd18825a5...1e4a71eb26808a828fff29ada663a7c43e0bdd9f,1,0,596,596,1,2014-07-08 11:39:33,2014-07-07 17:34:32
1e4a71eb26808a828fff29ada663a7c43e0bdd9f...7562ef733c81d20d4a6a7849ad6a7c70713c117e,9,30,25,55,20,2014-07-08 11:39:33,2014-07-03 13:12:47
7562ef733c81d20d4a6a7849ad6a7c70713c117e...3a957f6e61d8cacacf0cfe4bdceb5dbc2f3ef628,4,2,20,22,7,2014-07-08 11:39:33,2014-07-07 09:54:28
3a957f6e61d8cacacf0cfe4bdceb5dbc2f3ef628...7914bdbe81fc601bd28de69ae9e9c1ee8c4f1ce1,1,4,0,4,2,2014-07-08 17:43:38,2014-07-03 19:51:30
7914bdbe81fc601bd28de69ae9e9c1ee8c4f1ce1...e4b98296f8062d2f522a9cd129de795dd4616745,7,781,1,782,8,2014-07-08 17:43:41,2014-07-03 22:07:14
e4b98296f8062d2f522a9cd129de795dd4616745...fac0cf1fbf1e7f357d0787e989090a203f687d1a,1,20,22,42,21,2014-07-08 18:07:40,2014-07-08 18:04:50
fac0cf1fbf1e7f357d0787e989090a203f687d1a...01ec4f8ccf23d772523649051778b5a3f8c91c27,2,14,1,15,4,2014-07-08 20:22:19,2014-07-07 22:02:41
01ec4f8ccf23d772523649051778b5a3f8c91c27...a76bfecf5bb7a173d2c79f4877fe07a6b0bf1f80,60,734,249,983,139,2014-07-08 20:58:56,2014-07-03 16:04:53
a76bfecf5bb7a173d2c79f4877fe07a6b0bf1f80...3c5246b1fb2ec2f9c34ba1cb5083b2745d7bdf89,51,2532,2884,5416,151,2014-07-09 11:36:48,2014-06-17 23:22:05
3c5246b1fb2ec2f9c34ba1cb5083b2745d7bdf89...0239597c2a2f1689a2969acd9b776dad3582ac7e,1,2,2,4,1,2014-07-09 14:59:37,2014-07-09 14:59:37
0239597c2a2f1689a2969acd9b776dad3582ac7e...80f039c34373228fd7720ab3782cf1755397116d,36,297,201,498,156,2014-07-09 15:54:38,2014-07-08 20:56:30
80f039c34373228fd7720ab3782cf1755397116d...7e8217417b3af161512169b5c32453401c1e7b96,1,9,10,19,9,2014-07-09 16:48:53,2014-07-08 21:07:45
7e8217417b3af161512169b5c32453401c1e7b96...d7fae0c479c634f3f7ce924a0f0a9b84cc4e9549,1,8,8,16,8,2014-07-09 16:56:18,2014-07-07 23:13:10
d7fae0c479c634f3f7ce924a0f0a9b84cc4e9549...4939ccc6ebb0f7a61121e77ceeebd75d8841606a,4,14,13,27,14,2014-07-09 16:56:18,2014-07-01 16:33:35
4939ccc6ebb0f7a61121e77ceeebd75d8841606a...46a25fdd1470fb08876c229e77be4986fd12082b,13,359,331,690,60,2014-07-09 16:57:12,2014-07-01 17:31:17
46a25fdd1470fb08876c229e77be4986fd12082b...a61874a2de78a6f3b928b73c16f2b46f60ba2c57,3,29,29,58,6,2014-07-09 12:35:23,2014-07-08 13:13:58
a61874a2de78a6f3b928b73c16f2b46f60ba2c57...98fb05b9cc74318984574478cc7eadc1167a97e8,2,52,2,54,4,2014-07-09 19:17:34,2014-06-30 18:07:35
98fb05b9cc74318984574478cc7eadc1167a97e8...fbefd671108328bffd9ca71415ac03a7f521700b,2,51,0,51,3,2014-07-09 19:52:23,2014-07-07 17:07:07
fbefd671108328bffd9ca71415ac03a7f521700b...ac6619a626d96de740b196340e3aaeb99c6caadd,4,4,7,11,6,2014-07-09 20:08:12,2014-07-09 19:49:16
ac6619a626d96de740b196340e3aaeb99c6caadd...af60b4d2d5c1547c6724a2f6437f4c29a74e1470,6,11,19,30,10,2014-07-10 09:41:08,2014-07-08 08:48:23
af60b4d2d5c1547c6724a2f6437f4c29a74e1470...1f5be1314218e5dc33c1107b29f41092f7a00082,11,207,118,325,87,2014-07-10 12:19:07,2014-07-10 01:56:43
1f5be1314218e5dc33c1107b29f41092f7a00082...7e90a89afa78e4ca5833149e4426c9193c107700,3,65,23,88,16,2014-07-10 12:19:07,2014-07-10 01:58:15
7e90a89afa78e4ca5833149e4426c9193c107700...81ed23939d7b94a14371241db247a76e85f050fe,1,1,1,2,1,2014-07-10 15:22:34,2014-07-10 15:22:34
81ed23939d7b94a14371241db247a76e85f050fe...ef85749d9a217d8293b2e03b1067d2bcea54b694,1,2,0,2,2,2014-07-10 20:44:24,2014-07-10 20:44:24
ef85749d9a217d8293b2e03b1067d2bcea54b694...9dbdefb125b07db9d9801b80d525f9a954bec5f2,3,28,35,63,4,2014-07-11 15:41:00,2014-07-11 00:12:30
9dbdefb125b07db9d9801b80d525f9a954bec5f2...f3ba3590ce1ca1bf8f7fbb13ad8311a52df9c176,4,67,3,70,9,2014-07-11 17:22:16,2014-07-02 17:13:54
f3ba3590ce1ca1bf8f7fbb13ad8311a52df9c176...de724781deb23468c909acc73d98961b9c8e53c5,105,510,502,1012,205,2014-07-11 18:11:10,2014-06-27 20:59:27
de724781deb23468c909acc73d98961b9c8e53c5...f6a6dec8f14ef75980d1512bb6d5e30fab6b73db,1,9,8,17,4,2014-07-11 21:19:01,2014-07-11 20:54:17
f6a6dec8f14ef75980d1512bb6d5e30fab6b73db...ef4f60e3951929a7b16cf8920216310ecc58cc49,25,298,175,473,73,2014-07-12 20:50:51,2014-04-23 16:08:55
ef4f60e3951929a7b16cf8920216310ecc58cc49...a1b737a2146ba380ae9a51acfb1138982745d996,1,14,7,21,4,2014-07-14 13:54:22,2014-07-10 15:32:54
a1b737a2146ba380ae9a51acfb1138982745d996...d13602b96458b2d6c2ccf0be5b968d45e0a5402a,14,1661,1510,3171,17,2014-07-14 13:56:50,2014-07-10 19:44:30
d13602b96458b2d6c2ccf0be5b968d45e0a5402a...eebd60e8f6a531fa974f93a396b73dbfdbe695cd,2,46,9,55,5,2014-07-14 14:39:08,2014-07-10 22:52:48
eebd60e8f6a531fa974f93a396b73dbfdbe695cd...4a81cb9824987b0e4e534091d3f3dd4a01149d98,1,3,6,9,3,2014-07-14 14:39:09,2014-07-10 22:54:14
4a81cb9824987b0e4e534091d3f3dd4a01149d98...d7d72deffcbe47d486715e56df72fa470738bc69,2,8,5,13,5,2014-07-14 14:39:09,2014-07-10 20:17:37
d7d72deffcbe47d486715e56df72fa470738bc69...1d2bba92453e709ed62cfb21bb084edf4f754dd3,1,0,6,6,6,2014-07-14 14:39:09,2014-07-10 20:40:24
1d2bba92453e709ed62cfb21bb084edf4f754dd3...f177ab123607fc490bf4296fa88d605c8be6a01c,2,10,9,19,6,2014-07-14 14:39:09,2014-07-11 00:03:05
f177ab123607fc490bf4296fa88d605c8be6a01c...6100641c26da87cfcc8a2655feec10a42f1eb753,1,1,1,2,1,2014-07-14 18:19:47,2014-07-14 18:08:34
6100641c26da87cfcc8a2655feec10a42f1eb753...a6cd9b2827c40069c95abf9434d2e958afa72ffd,3,8,4,12,6,2014-07-14 18:31:51,2014-07-14 18:22:06
a6cd9b2827c40069c95abf9434d2e958afa72ffd...645a67482a480183e2e9b780c9e84f776d40f8f8,2,4,0,4,2,2014-07-14 19:38:26,2014-07-14 19:35:42
645a67482a480183e2e9b780c9e84f776d40f8f8...01c0cd66410dd1009080fc79e1eb398f29036039,1,7,1,8,1,2014-07-14 19:38:26,2014-07-14 19:36:45
01c0cd66410dd1009080fc79e1eb398f29036039...ba71ad619c49f84ee8179227d16ecc79a65ab535,7,749,65,814,88,2014-07-14 22:02:23,2014-07-09 17:15:52
ba71ad619c49f84ee8179227d16ecc79a65ab535...6d1570d1001a57fcac0f6412c8f22059609029c4,2,2,73,75,4,2014-07-14 22:43:24,2014-07-14 20:22:10
6d1570d1001a57fcac0f6412c8f22059609029c4...a6a55dfeb3ce0edebc7d58a119b41fe590b61e07,2,48,29,77,20,2014-07-14 22:54:26,2014-06-20 16:56:35
a6a55dfeb3ce0edebc7d58a119b41fe590b61e07...3982b2f3accac0a441f6a8eb71190ed49fcdbb06,1,4,3,7,3,2014-07-14 22:54:27,2014-07-12 21:43:03
3982b2f3accac0a441f6a8eb71190ed49fcdbb06...df27bbcf24db28fa68bfd264f0d3883c0e33320e,1,19,2,21,3,2014-07-14 23:22:19,2014-07-11 17:58:13
df27bbcf24db28fa68bfd264f0d3883c0e33320e...f8b4e1287bd3b246f6a80f4308b44cb094b76aa6,2,2,1,3,2,2014-07-15 01:19:16,2014-07-10 16:06:12
f8b4e1287bd3b246f6a80f4308b44cb094b76aa6...a7d1cd78b7d56bc610d8c7f5baa8a329fb272e11,5,122,0,122,5,2014-07-15 01:19:16,2014-07-14 13:53:42
a7d1cd78b7d56bc610d8c7f5baa8a329fb272e11...f32ba54f971c045fb589fe4c3a37da77dc486cee,3,48,2,50,6,2014-07-15 03:48:44,2014-07-14 22:08:08
f32ba54f971c045fb589fe4c3a37da77dc486cee...f936451125d644ecdafcce64628835d64b0e5a22,1,23,0,23,1,2014-07-15 03:48:54,2014-07-15 03:48:54
f936451125d644ecdafcce64628835d64b0e5a22...249c0a50179067c856b4bdf178446449617dab63,4,428,15,443,7,2014-07-15 10:47:53,2014-07-08 15:30:01
249c0a50179067c856b4bdf178446449617dab63...a78c439ba94e08ab6079e5575f1959c39c9beb87,2,3,3,6,2,2014-07-15 10:47:53,2014-07-14 14:34:52
a78c439ba94e08ab6079e5575f1959c39c9beb87...fa1233fbe4a48ef0675820f381987f1df4f42f75,35,845,228,1073,169,2014-07-15 17:33:25,2014-06-17 21:45:53
fa1233fbe4a48ef0675820f381987f1df4f42f75...d85f99a8a150a1932d72bd393511be2b85a409c7,1,2,2,4,2,2014-07-15 19:37:35,2014-07-15 19:37:35
d85f99a8a150a1932d72bd393511be2b85a409c7...54b5ee0c06ffc98c6b908ea3a908cf637ce4e15b,1,6,2,8,4,2014-07-15 19:48:15,2014-07-15 19:43:21
54b5ee0c06ffc98c6b908ea3a908cf637ce4e15b...8f071ee21b4763f0c88832a422865ec078940631,2,13,1,14,5,2014-07-15 19:52:31,2014-07-03 19:53:17
8f071ee21b4763f0c88832a422865ec078940631...d60fd22dec1c0bd104622eab463cdbba18bf11a9,1,2,2,4,2,2014-07-15 20:13:50,2014-07-15 20:13:21
d60fd22dec1c0bd104622eab463cdbba18bf11a9...37f2a1e3b724dbd9e1f8eafd4ac87c5bf613c048,35,228,845,1073,170,2014-07-15 20:13:50,2014-07-15 20:13:31
37f2a1e3b724dbd9e1f8eafd4ac87c5bf613c048...9ff4ff4ca1807464999c751115f42b527ff252e5,4,15,428,443,7,2014-07-15 15:59:19,2014-07-15 15:59:19
9ff4ff4ca1807464999c751115f42b527ff252e5...2c6a5148e1b93c2393c3e78bfab0cb109bd19527,1,0,2,2,1,2014-07-16 03:06:41,2014-07-15 20:50:01
2c6a5148e1b93c2393c3e78bfab0cb109bd19527...758d86f85a26578a5c99c2f1f128bbe86752bb32,4,146,22,168,15,2014-07-16 03:07:24,2014-07-04 01:34:13
758d86f85a26578a5c99c2f1f128bbe86752bb32...6f8e975b7a7ef18baf25281b206288a74deb5972,4,164,0,164,9,2014-07-16 03:07:24,2014-07-09 16:48:14
6f8e975b7a7ef18baf25281b206288a74deb5972...124b5aeda31a25a97e7f93fc1edb1565b7a2454a,2,173,1,174,5,2014-07-16 03:07:24,2014-07-09 11:06:17
124b5aeda31a25a97e7f93fc1edb1565b7a2454a...269682556e6195d69099baa53ef50b5b70a11739,2,0,122,122,4,2014-07-16 03:07:24,2014-07-09 14:28:07
269682556e6195d69099baa53ef50b5b70a11739...3716b4ab4b738f87933c3ea848c6caebc7c6e952,2,34,11,45,8,2014-07-16 09:49:59,2014-07-09 18:44:14
3716b4ab4b738f87933c3ea848c6caebc7c6e952...804423e1b6436096576e9476c42e4f68c77e0535,1,72,22,94,3,2014-07-16 15:07:21,2014-07-09 13:22:38
804423e1b6436096576e9476c42e4f68c77e0535...d134ba27aa7f2c4eb8fc4b1331c8331f5914bfc6,3,56,99,155,16,2014-07-16 15:21:22,2014-07-14 15:57:29
d134ba27aa7f2c4eb8fc4b1331c8331f5914bfc6...2fd2eebb2656ae65bd6eb63b39f8faeb84e0db4e,33,870,233,1103,174,2014-07-16 17:41:37,2014-07-15 20:48:59
2fd2eebb2656ae65bd6eb63b39f8faeb84e0db4e...a26a3ac92e2a340f211439891babec3cc54614e8,1,4,0,4,1,2014-07-16 18:40:32,2014-07-16 16:53:39
a26a3ac92e2a340f211439891babec3cc54614e8...dec6e49bd1d30e64233c5a7cf58d4274191ada20,1,2,2,4,2,2014-07-16 18:52:38,2014-07-16 18:52:38
dec6e49bd1d30e64233c5a7cf58d4274191ada20...08d89a0054efcb3a5dbc17f6717ff742f06c5b9a,1,7,0,7,3,2014-07-16 19:47:59,2014-06-06 19:39:33
08d89a0054efcb3a5dbc17f6717ff742f06c5b9a...deeb8bc5d608cc42300ff4407f3c4dac69e73d17,4,926,1,927,6,2014-07-16 21:16:05,2014-07-09 17:27:45
deeb8bc5d608cc42300ff4407f3c4dac69e73d17...086412f640b38be6e77d0fc1034f2d420e186b9b,2,208,276,484,7,2014-07-16 21:19:21,2014-07-16 17:48:46
086412f640b38be6e77d0fc1034f2d420e186b9b...2b55561913f26870b0d4b1c8ec180139819eeba6,1,15,0,15,1,2014-07-16 23:24:37,2014-07-16 22:46:17
2b55561913f26870b0d4b1c8ec180139819eeba6...980bcad5c1789ea470417c5eae4619f39288685f,35,992,1074,2066,50,2014-07-17 15:54:45,2014-07-11 11:55:21
980bcad5c1789ea470417c5eae4619f39288685f...168833af89bbb9fc025a3c4777ae975b534bf913,2,41,1,42,3,2014-07-17 16:04:01,2014-07-17 16:04:01
168833af89bbb9fc025a3c4777ae975b534bf913...4da16b54347c0503d96d95eab3d0952e59062825,2,11,5,16,3,2014-07-17 11:19:01,2014-07-16 15:12:32
4da16b54347c0503d96d95eab3d0952e59062825...b7a18a30b27b900cbfc6c71b033c85023296a2fd,4,438,15,453,7,2014-07-17 11:19:01,2014-07-16 14:59:01
b7a18a30b27b900cbfc6c71b033c85023296a2fd...782258785ff78679c18646bd86de7cb9cb780618,1,0,5,5,1,2014-07-17 11:19:01,2014-07-15 14:35:33
782258785ff78679c18646bd86de7cb9cb780618...f9a5d666e40d462cfd13fb31e590b0aa25db3133,3,18,3,21,5,2014-07-17 16:53:56,2014-07-16 21:42:56
f9a5d666e40d462cfd13fb31e590b0aa25db3133...bc780e2e72f6862ac126f4eb5617cc58ef2657b4,5,241,22,263,22,2014-07-17 18:02:19,2014-07-16 18:48:12
bc780e2e72f6862ac126f4eb5617cc58ef2657b4...a0bad0a3f1b6562cd39fe66774db6ee486064045,3,18,14,32,11,2014-07-17 20:09:01,2014-07-02 17:19:42
a0bad0a3f1b6562cd39fe66774db6ee486064045...b6b40f6a7160477ca540ebf64158999d2bb4a1ba,3,99,15,114,10,2014-07-17 20:09:01,2014-06-11 19:59:18
b6b40f6a7160477ca540ebf64158999d2bb4a1ba...4f43fb151ca3f51f76f928760128d25406c36c00,2,83,0,83,3,2014-07-17 20:09:01,2014-06-12 13:07:14
4f43fb151ca3f51f76f928760128d25406c36c00...e8747193ba81ef246a806843912a553a6d79e149,5,178,1,179,7,2014-07-17 20:09:01,2014-06-26 19:26:01
e8747193ba81ef246a806843912a553a6d79e149...48e603792832e6d4914fdb1285c16ea745390c46,2,10,7,17,5,2014-07-17 20:09:01,2014-07-01 13:47:26
48e603792832e6d4914fdb1285c16ea745390c46...ae0d61700c0e7f0d6c236743b9605ea97a1fb55d,6,109,4,113,16,2014-07-17 20:09:01,2014-07-02 19:46:35
ae0d61700c0e7f0d6c236743b9605ea97a1fb55d...14ec31cfa6c98e5020e4c58346b55843b53254df,7,112,17,129,33,2014-07-17 20:09:02,2014-07-17 20:08:47
14ec31cfa6c98e5020e4c58346b55843b53254df...7797c0ed4fc2ce61979ae5d8b0931d73e08855bc,3,33,13,46,8,2014-07-17 21:45:14,2014-07-15 20:28:27
7797c0ed4fc2ce61979ae5d8b0931d73e08855bc...f6cc85d06aaa39cea2baaf8771932bb8c5672cf7,2,59,4,63,6,2014-07-18 10:58:08,2014-07-18 10:58:08
f6cc85d06aaa39cea2baaf8771932bb8c5672cf7...7c9e21b95804fde5a4837c5aab47ab9c2e57a267,15,186,73,259,37,2014-07-18 18:47:11,2014-07-16 18:30:35
7c9e21b95804fde5a4837c5aab47ab9c2e57a267...4b12168d5c14f0177586eeda8b22fba433d6df1f,3,10,81,91,21,2014-07-18 18:47:12,2014-07-16 23:20:59
4b12168d5c14f0177586eeda8b22fba433d6df1f...7dbc49a56d010ceaf6d9b57f373863763fe10280,6,121,43,164,39,2014-07-18 18:54:20,2014-07-17 21:44:23
7dbc49a56d010ceaf6d9b57f373863763fe10280...848999f1527e8390d4d76f9fad0860218b73be4d,1,5,16,21,6,2014-07-18 19:00:39,2014-07-17 17:39:21
848999f1527e8390d4d76f9fad0860218b73be4d...3c3d656668e26645492ee3dafb241631352426d4,39,315,309,624,272,2014-07-18 19:16:14,2014-07-17 21:03:15
3c3d656668e26645492ee3dafb241631352426d4...9066a06214f115c182c2b83ed40e939e05b9c1f8,39,276,181,457,177,2014-07-18 19:16:15,2014-07-09 08:15:56
9066a06214f115c182c2b83ed40e939e05b9c1f8...e1d0d5cb71ed1788fc9085cf19e7b0470c4c66d5,1,3,0,3,3,2014-07-18 20:51:45,2014-07-18 20:51:45
e1d0d5cb71ed1788fc9085cf19e7b0470c4c66d5...63bca554b175f27451876df5a975f43dc79f55ee,1,7,1,8,2,2014-07-19 13:53:56,2014-07-18 19:40:19
63bca554b175f27451876df5a975f43dc79f55ee...d66dd1a020e5e0890ab17f2e58be38be312591e4,21,128,51,179,57,2014-07-21 15:43:02,2014-07-16 19:53:29
d66dd1a020e5e0890ab17f2e58be38be312591e4...6870e3e7494a8209070cf952cde5a6d5748b5381,16,505,400,905,148,2014-07-21 17:01:40,2014-07-18 13:38:02
6870e3e7494a8209070cf952cde5a6d5748b5381...b3712d70b80c2b5ba936a4d74c6def5ca150682d,6,242,0,242,6,2014-07-21 12:05:07,2014-07-17 14:34:50
b3712d70b80c2b5ba936a4d74c6def5ca150682d...ed6f52811fe7d3f5bc9b49d4c4a8701cd7c0fae0,1,1,1,2,1,2014-07-21 17:27:39,2014-07-21 17:27:32
ed6f52811fe7d3f5bc9b49d4c4a8701cd7c0fae0...33bfa479a3ec71230aad30ccc1ab9ac55794ca20,1,10,0,10,2,2014-07-21 17:40:54,2014-07-21 15:40:58
33bfa479a3ec71230aad30ccc1ab9ac55794ca20...fcab456c204a1c5eccfc3d700337cb5bff0621fc,2,23,10,33,9,2014-07-21 17:41:21,2014-07-21 15:52:34
fcab456c204a1c5eccfc3d700337cb5bff0621fc...f2d47ee02a94f56b29e1874aebf8ae4dca222d2e,12,206,53,259,45,2014-07-21 17:48:43,2014-07-21 17:48:43
f2d47ee02a94f56b29e1874aebf8ae4dca222d2e...bc5315c9d61b6507c261b6c57b3d79969f6b3f50,18,371,32,403,49,2014-07-21 18:07:30,2014-07-18 20:47:23
bc5315c9d61b6507c261b6c57b3d79969f6b3f50...17a35699a9d760965e22e1d3f7ffc813e4edb658,2,126,16,142,23,2014-07-21 18:47:59,2014-07-21 14:03:19
17a35699a9d760965e22e1d3f7ffc813e4edb658...d8f96453ea6e86c9fbe020766edda85b44823201,5,122,20,142,16,2014-07-21 19:39:45,2014-07-18 19:52:17
d8f96453ea6e86c9fbe020766edda85b44823201...fb270d89cbcfdb98c3cee3e631c76ca035c7b4f0,5,144,17,161,20,2014-07-22 13:08:23,2014-07-21 15:15:20
fb270d89cbcfdb98c3cee3e631c76ca035c7b4f0...7ffac7f351b80f84589349e44693a94d5cc5e14c,120,1127,1115,2242,581,2014-07-22 13:24:11,2014-07-15 21:30:02
7ffac7f351b80f84589349e44693a94d5cc5e14c...138d78bd6d3b28db332f263bd808ccb4f1ac6979,4,51,10,61,16,2014-07-22 17:23:24,2014-07-21 18:29:26
7ffac7f351b80f84589349e44693a94d5cc5e14c...9c4d4cd84a82ba7ca782b69e0bdc821e8c3ff997,1,4,1,5,1,2014-07-22 15:05:39,2014-07-21 21:23:50
9c4d4cd84a82ba7ca782b69e0bdc821e8c3ff997...6c9e9a907352ca91a72c2818637506e9f7a42421,10,33,33,66,33,2014-07-22 15:31:06,2014-07-22 15:22:34
6c9e9a907352ca91a72c2818637506e9f7a42421...5c48155b2fee4b9fddb2f19e01b9f7fc05c3e9b0,8,297,151,448,83,2014-07-22 15:38:15,2014-07-21 20:24:34
5c48155b2fee4b9fddb2f19e01b9f7fc05c3e9b0...e6c13ebd16684b22b3916ccbbca4a72de9f72277,1,2,0,2,1,2014-07-22 15:38:32,2014-07-21 20:45:22
e6c13ebd16684b22b3916ccbbca4a72de9f72277...5f756d65b25704facdc3b98a7ddd93d7df0be846,18,137,90,227,88,2014-07-22 15:38:33,2014-07-22 02:55:51
5f756d65b25704facdc3b98a7ddd93d7df0be846...9130687a561a3020ba3f1c408fb2f6d47af46a71,11,631,1,632,19,2014-07-22 15:40:42,2014-07-21 17:39:18
9130687a561a3020ba3f1c408fb2f6d47af46a71...e6b3d2e012cee172066677af1ab936811282bfbb,2,169,0,169,5,2014-07-22 15:42:41,2014-07-21 21:41:57
e6b3d2e012cee172066677af1ab936811282bfbb...d30aac993ecc88052f11946e4486050ff57ba89c,1,2,2,4,2,2014-07-22 17:02:02,2014-07-22 17:02:02
d30aac993ecc88052f11946e4486050ff57ba89c...d477da53e119b207de45880434ccef1e47084652,2,3,1,4,2,2014-07-22 17:02:27,2014-07-22 17:02:27
0fd210a4df819253df7add4dee0a5463b1f01a4d...325aa2766225a27a46ab30bba8c8aa3c0a5c9f3a,21,28,2318,2346,39,2014-07-22 18:09:28,2014-07-22 18:06:24
325aa2766225a27a46ab30bba8c8aa3c0a5c9f3a...f2e7e52e80b4f755f49981a7b87c7870401b4cd1,2,8,10,18,6,2014-07-22 21:07:47,2014-07-22 17:31:15
f2e7e52e80b4f755f49981a7b87c7870401b4cd1...f4e485e9d323496beaaa420d59a460dc9755f9bf,5,41,26,67,23,2014-07-22 21:07:47,2014-07-22 20:25:04
f4e485e9d323496beaaa420d59a460dc9755f9bf...bd82779747f79f3a634df748a09bfa40c557b1bf,3,99,37,136,15,2014-07-22 23:01:08,2014-07-09 14:56:07
bd82779747f79f3a634df748a09bfa40c557b1bf...3038384e3cbbb0e413d9e2be2db37fda5849fdd2,6,88,13,101,11,2014-07-23 13:04:01,2014-07-18 13:27:28
3038384e3cbbb0e413d9e2be2db37fda5849fdd2...21fe1dde94c1aa73c280e2a96e6d301cd5125b51,1,42,0,42,1,2014-07-23 15:23:01,2014-07-23 14:51:36
21fe1dde94c1aa73c280e2a96e6d301cd5125b51...296c18571dd7decd33fdf62f0a23869129682264,1,8,1,9,1,2014-07-23 15:42:25,2014-07-22 22:24:53
296c18571dd7decd33fdf62f0a23869129682264...26aff1dcc9a45e72a91a206119c12cc280148175,16,53,27,80,36,2014-07-23 15:54:10,2014-07-22 19:54:48
26aff1dcc9a45e72a91a206119c12cc280148175...5e4f3fef24ca76b6a6516e7379b72ae3310029fd,47,213,346,559,146,2014-07-23 16:40:20,2014-07-22 19:50:23
5e4f3fef24ca76b6a6516e7379b72ae3310029fd...d004a865ed9f12d5968233fcc77ea588f38702d1,2,4,4,8,2,2014-07-23 18:24:25,2014-07-23 15:58:51
d004a865ed9f12d5968233fcc77ea588f38702d1...c8f3b90326a4a958ccd1ca90a2b4e03c33476e7f,1,0,1,1,1,2014-07-23 18:24:27,2014-07-23 04:56:17
c8f3b90326a4a958ccd1ca90a2b4e03c33476e7f...6f70a23e5c475b037f2edb8bd5031c5cebdb1c0b,14,49,59,108,19,2014-07-23 13:38:16,2014-07-22 16:32:21
6f70a23e5c475b037f2edb8bd5031c5cebdb1c0b...b6bd23b1b3f9274e1516feb05ee7172430943396,2,3,1,4,2,2014-07-23 19:16:59,2014-07-23 19:11:28
b6bd23b1b3f9274e1516feb05ee7172430943396...6cd0e5006cd979a4e91ac8d4d2adb3af6b4ce877,3,14,30,44,7,2014-07-23 19:42:59,2014-07-21 20:16:44
6cd0e5006cd979a4e91ac8d4d2adb3af6b4ce877...3778e48286d35a59cc0cb52bdadcf4090ac8af94,13,96,71,167,23,2014-07-23 19:43:00,2014-07-22 18:08:58
3778e48286d35a59cc0cb52bdadcf4090ac8af94...eda239c6d3caeb6f68189672cf331e80bbc7faae,11,52,24,76,26,2014-07-23 19:43:00,2014-07-21 21:32:31
eda239c6d3caeb6f68189672cf331e80bbc7faae...0e8a436fdedc9a56ddd4e773d45d7963a8f358a6,5,71,4,75,9,2014-07-23 20:25:23,2014-07-07 20:04:56
0e8a436fdedc9a56ddd4e773d45d7963a8f358a6...7174d92cc1ad3dd24430769b72c05b1ee6fbcd74,1,1,1,2,1,2014-07-23 20:45:18,2014-07-23 20:45:18
7174d92cc1ad3dd24430769b72c05b1ee6fbcd74...2cbd9f1d77ce6b25e9957d3121fccb521caf848f,29,987,708,1695,99,2014-07-23 20:52:36,2014-07-18 19:28:37
2cbd9f1d77ce6b25e9957d3121fccb521caf848f...3f6f0879b9cadcdc7763427a578151136c256e1f,7,10,620,630,13,2014-07-23 21:23:15,2014-07-23 17:05:30
3f6f0879b9cadcdc7763427a578151136c256e1f...4bce57b6acd498a1471104932725fdea7ff87217,1,1,0,1,1,2014-07-23 22:00:11,2014-07-23 20:42:15
4bce57b6acd498a1471104932725fdea7ff87217...4f01ffd9cbbb0dcb4ee2f9167ad2337178259ba9,2,2,2,4,2,2014-07-23 22:45:52,2014-07-23 22:08:54
4f01ffd9cbbb0dcb4ee2f9167ad2337178259ba9...7acc48b74c6c0755e63a0358521055aae9792cd4,2,294,9,303,9,2014-07-24 12:58:31,2014-07-22 17:24:09
7acc48b74c6c0755e63a0358521055aae9792cd4...a3c8b1c2eee598ba9fe740a118bab31e03647bdb,1,1,1,2,1,2014-07-24 13:51:41,2014-07-22 20:17:47
a3c8b1c2eee598ba9fe740a118bab31e03647bdb...8b5133c1e2146b3dd015b5f7d2431b586888b07a,22,132,99,231,106,2014-07-24 13:51:42,2014-07-23 15:45:41
8b5133c1e2146b3dd015b5f7d2431b586888b07a...f92174540acb6713eacee71877cbc124fc86f296,1,1,1,2,1,2014-07-24 14:50:27,2014-07-24 14:50:24
f92174540acb6713eacee71877cbc124fc86f296...308af33f76d1e15c105f04ea762f8951b47c5168,4,391,37,428,42,2014-07-24 16:04:22,2014-07-24 15:31:15
308af33f76d1e15c105f04ea762f8951b47c5168...23007a0af84a44080336bc02d17e8cf4b009b1e2,1,3,3,6,3,2014-07-24 16:41:26,2014-07-24 16:41:26
23007a0af84a44080336bc02d17e8cf4b009b1e2...095c394834930b3986a1fb8fdde3dd4f15965cf1,1,8,5,13,5,2014-07-24 16:50:31,2014-07-24 16:08:11
095c394834930b3986a1fb8fdde3dd4f15965cf1...b92932d2c00795932014dcc500d7ec45181c7c82,1,3,3,6,3,2014-07-24 18:02:19,2014-07-24 17:54:50
b92932d2c00795932014dcc500d7ec45181c7c82...ffc53f46956eb52a86efd51620dede98e1b48444,2,65,1,66,3,2014-07-24 19:21:15,2014-07-23 19:33:53
ffc53f46956eb52a86efd51620dede98e1b48444...65f474026c3430383aaad27bc0386c213122f90b,1,5,8,13,5,2014-07-24 19:53:29,2014-07-24 19:53:29
65f474026c3430383aaad27bc0386c213122f90b...3a35b4992f31d6102e38bd6a18965570b0ddf985,2,74,13,87,10,2014-07-24 19:57:41,2014-07-23 21:31:27
3a35b4992f31d6102e38bd6a18965570b0ddf985...62b83d55984e91e8fa46614f2f37465baf8978aa,1,2,0,2,1,2014-07-24 20:01:05,2014-07-23 21:28:19
62b83d55984e91e8fa46614f2f37465baf8978aa...36841f1ebc321efbcccc9a55713948eb3fa7590a,3,35,6,41,9,2014-07-24 20:11:11,2014-07-23 21:29:47
36841f1ebc321efbcccc9a55713948eb3fa7590a...42034d4c3713461658f00f952e13943770eb4620,2,23,0,23,2,2014-07-24 20:20:05,2014-07-24 19:14:34
42034d4c3713461658f00f952e13943770eb4620...231262fda82a3245b8690fdc6421ea1fa3a8a2dd,2,33,39,72,12,2014-07-24 20:24:19,2014-07-23 22:41:31
231262fda82a3245b8690fdc6421ea1fa3a8a2dd...3bb266f9c6dfb35e7eae73731f2cad2794e39417,1,376,0,376,1,2014-07-25 04:30:48,2014-07-16 18:42:08
3bb266f9c6dfb35e7eae73731f2cad2794e39417...d5522fbaa3aa3fb9eef81fa20d74f3689c0088ef,5,273,15,288,36,2014-07-25 04:43:55,2014-07-24 17:22:27
d5522fbaa3aa3fb9eef81fa20d74f3689c0088ef...e622765f1105b849c746acfce0c2ccc2eaed92e7,1,0,376,376,1,2014-07-25 05:49:48,2014-07-25 05:49:48
e622765f1105b849c746acfce0c2ccc2eaed92e7...4dd1c9e70cc4a17d233c32180933da24b4c57ef5,1,0,53,53,1,2014-07-25 17:35:11,2014-07-25 17:35:11
4dd1c9e70cc4a17d233c32180933da24b4c57ef5...43298cf9b3a6239334676c4b7098b01dd1e32c99,1,227,0,227,1,2014-07-25 20:05:03,2014-07-25 02:11:55
43298cf9b3a6239334676c4b7098b01dd1e32c99...aa7a01f3f9cd8b7d018ac572bb7fae60544dd146,2,11,35,46,7,2014-07-25 20:16:17,2014-07-25 15:40:07
aa7a01f3f9cd8b7d018ac572bb7fae60544dd146...a09163ade822ce97e9bbf570bccea9781c37603d,1,6,0,6,1,2014-07-25 15:21:24,2014-07-25 11:46:30
a09163ade822ce97e9bbf570bccea9781c37603d...76c04d500f1364a3a9ec0d56877044c378d938ea,1,48,48,96,9,2014-07-25 20:23:34,2014-07-24 16:08:11
76c04d500f1364a3a9ec0d56877044c378d938ea...65c028b69b6fcff927209ca57ba2b7e73c0b2e24,1,3,7,10,3,2014-07-25 20:23:34,2014-07-25 17:43:28
65c028b69b6fcff927209ca57ba2b7e73c0b2e24...00b5c825ebd1f4060595a191b903ad8639f0922a,1,384,3,387,4,2014-07-26 00:15:23,2014-06-30 19:26:36
00b5c825ebd1f4060595a191b903ad8639f0922a...74daefb6f2330ee42ff035cc593472f41f3f8ed8,7,7,7,14,7,2014-07-26 02:58:30,2014-07-26 02:58:30
74daefb6f2330ee42ff035cc593472f41f3f8ed8...580ca36cdbf205a86400479ad0219e0cccd01a6d,7,7,7,14,7,2014-07-26 03:00:12,2014-07-26 03:00:12
580ca36cdbf205a86400479ad0219e0cccd01a6d...170f1937cbdffff7465a3956acbed3a313d6b296,1,379,0,379,1,2014-07-26 17:06:04,2014-07-16 18:42:08
170f1937cbdffff7465a3956acbed3a313d6b296...03048e3ab4989342876e265eb3bde5d18aacb2a5,23,661,623,1284,43,2014-07-26 17:22:04,2014-07-25 22:31:38
03048e3ab4989342876e265eb3bde5d18aacb2a5...6d2e9273bbb3127a00063fbee6cf089b8fc1687a,2,12,4,16,10,2014-07-28 12:43:19,2014-07-24 19:19:02
6d2e9273bbb3127a00063fbee6cf089b8fc1687a...0777e69dbc961d16e7d74daeb6b49fc82718c313,1,1,14,15,1,2014-07-28 12:43:19,2014-07-24 19:19:31
0777e69dbc961d16e7d74daeb6b49fc82718c313...e28e721d7e9a4f08126f4e1b983bbf73cbe7aec7,4,98,59,157,34,2014-07-28 12:43:19,2014-07-24 19:19:57
e28e721d7e9a4f08126f4e1b983bbf73cbe7aec7...e1212f504d8d7f72582c060eac67a158ccd099c5,5,212,119,331,27,2014-07-28 12:43:19,2014-07-24 22:42:21
e1212f504d8d7f72582c060eac67a158ccd099c5...cbfea748c0e377cbb4b4805a3d5b66775cfe3126,1,9,6,15,3,2014-07-28 12:43:19,2014-07-25 22:08:36
cbfea748c0e377cbb4b4805a3d5b66775cfe3126...18d159e139ce8651b8f7d3c99f94ebc31f84c135,2,11,7,18,6,2014-07-28 13:48:01,2014-07-28 13:48:01
18d159e139ce8651b8f7d3c99f94ebc31f84c135...cdcce7b8a9599d59c76c4255bd1aa62821b9b17d,1,4,2,6,2,2014-07-28 13:48:30,2014-07-28 13:48:30
cdcce7b8a9599d59c76c4255bd1aa62821b9b17d...a8aa8d7c04c54c7883f4abdcff00512c73984cd4,14,234,110,344,78,2014-07-28 13:52:15,2014-07-24 13:15:34
a8aa8d7c04c54c7883f4abdcff00512c73984cd4...306355162c240f96e949f2a504df6cddfec47e42,3,1,200,201,3,2014-07-28 14:26:49,2014-07-28 14:26:49
306355162c240f96e949f2a504df6cddfec47e42...553266111d7295aff03868cdfbf22e08985764db,10,318,56,374,50,2014-07-28 14:42:00,2014-07-28 14:20:56
553266111d7295aff03868cdfbf22e08985764db...58c5d273a4365eec7b6055d6372edda937003760,2,4,3,7,4,2014-07-28 14:58:46,2014-07-28 14:54:58
58c5d273a4365eec7b6055d6372edda937003760...ebeec9f43baf6f0292f1d3641440227a28531081,1,0,4,4,1,2014-07-28 15:25:46,2014-07-28 15:25:46
ebeec9f43baf6f0292f1d3641440227a28531081...e3b915cec0233b4fcb5c1cd558cc57790b7b7386,1,2,2,4,2,2014-07-28 15:29:31,2014-07-28 15:28:29
e3b915cec0233b4fcb5c1cd558cc57790b7b7386...ece23f5a892d74360038f4f11f54c11e43f432cd,5,24,21,45,22,2014-07-28 15:59:20,2014-07-15 15:45:46
ece23f5a892d74360038f4f11f54c11e43f432cd...9b5f950603376b36eb2659ae5b8fdae2ee8714cf,5,101,240,341,20,2014-07-28 15:59:20,2014-07-16 15:17:34
9b5f950603376b36eb2659ae5b8fdae2ee8714cf...94880490ed1d138be2a6547726ef598511f8311a,3,27,26,53,15,2014-07-28 15:59:21,2014-07-24 20:29:05
94880490ed1d138be2a6547726ef598511f8311a...c75a777a2c438139b88e7d92eacd29e48735e7c2,4,19,17,36,19,2014-07-28 15:59:21,2014-07-14 21:52:21
c75a777a2c438139b88e7d92eacd29e48735e7c2...172d4f6f8bd09d0b2b77d9fb3bf280d01cfb72a1,14,89,4,93,15,2014-07-28 17:48:14,2014-07-25 18:30:38
172d4f6f8bd09d0b2b77d9fb3bf280d01cfb72a1...9b93692f665a506dcc00ed989eb1f31741dea53c,2,33,2,35,4,2014-07-28 18:07:15,2014-07-24 20:11:50
9b93692f665a506dcc00ed989eb1f31741dea53c...ef9cebb5112b44c90abde54b67badf536503127d,14,4,89,93,15,2014-07-28 19:24:50,2014-07-28 19:24:50
ef9cebb5112b44c90abde54b67badf536503127d...5e515de16fe1eac1f7079a2a95aa9e4f716ee3ec,2,31,8,39,8,2014-07-28 20:41:26,2014-07-28 20:25:27
5e515de16fe1eac1f7079a2a95aa9e4f716ee3ec...78d2f38aa445ef1658300e66e1db14b9f1eceba8,23,122,91,213,79,2014-07-28 21:14:17,2014-07-24 18:44:23
78d2f38aa445ef1658300e66e1db14b9f1eceba8...2573c47e17062849b428487d308d4e5155bd6d7b,14,92,3,95,16,2014-07-28 21:40:45,2014-07-28 21:40:40
2573c47e17062849b428487d308d4e5155bd6d7b...747176e1ff9943118eb88d102fe7f8f513f001d9,4,6,11,17,11,2014-07-29 11:09:26,2014-07-08 07:58:57
747176e1ff9943118eb88d102fe7f8f513f001d9...a5daad51e05745c88515c3efb802bff716999194,17,152,64,216,39,2014-07-29 15:46:42,2014-07-21 22:13:42
a5daad51e05745c88515c3efb802bff716999194...24caa4a745f061b4872d87cfd7862754ac88c3b2,4,216,7,223,10,2014-07-29 15:46:43,2014-07-22 22:42:21
24caa4a745f061b4872d87cfd7862754ac88c3b2...1135d0604c05367fe99ebf6fc0a23ac21e26a558,1,10,5,15,5,2014-07-29 15:46:43,2014-07-28 20:51:11
1135d0604c05367fe99ebf6fc0a23ac21e26a558...d7637a71f401f2457db3caca8c8a03d9b46d1ed0,2,0,10,10,4,2014-07-29 17:58:49,2014-07-29 17:58:49
d7637a71f401f2457db3caca8c8a03d9b46d1ed0...c7590ac4ec54f52af224248f83a4f722b0abf319,2,15,3,18,2,2014-07-29 20:05:58,2014-07-28 20:06:55
c7590ac4ec54f52af224248f83a4f722b0abf319...81676bfa36c68b1247f0e08b666e33c3e3875755,2,10,5,15,6,2014-07-29 20:45:26,2014-07-29 20:45:23
81676bfa36c68b1247f0e08b666e33c3e3875755...1488bc89c42c6a39c5fdbd2b0c2b15e3abbb4108,72,221,225,446,193,2014-07-29 21:16:37,2014-07-29 17:58:50
1488bc89c42c6a39c5fdbd2b0c2b15e3abbb4108...cf61cc08aa5c2d4aa94a59d1e7e94c15507953f8,16,257,39,296,43,2014-07-29 16:34:23,2014-07-18 15:14:47
cf61cc08aa5c2d4aa94a59d1e7e94c15507953f8...236956b2be2a15c2f03a211ad9dbc7afaf0c9b5e,12,84,86,170,36,2014-07-29 16:34:24,2014-07-23 14:31:56
236956b2be2a15c2f03a211ad9dbc7afaf0c9b5e...106da3988dfc4aef48b5644c5fa939d90ceb3e74,9,0,35,35,9,2014-07-29 16:34:24,2014-07-24 13:51:11
106da3988dfc4aef48b5644c5fa939d90ceb3e74...39cdae3edd30cd14e2c7e4a3ee6b75c9bd6fc6d3,17,324,103,427,56,2014-07-29 16:34:24,2014-07-21 09:41:30
39cdae3edd30cd14e2c7e4a3ee6b75c9bd6fc6d3...a0dcb4026b3f1171b4124e2666cf71460d023bb1,2,112,0,112,11,2014-07-29 16:34:24,2014-07-23 17:19:13
a0dcb4026b3f1171b4124e2666cf71460d023bb1...c91a2c3392fc95be3ed07ba98a4d98b4db754b58,10,279,39,318,47,2014-07-29 21:42:21,2014-07-16 16:35:13
c91a2c3392fc95be3ed07ba98a4d98b4db754b58...f58fbec3e4418adc6a266f41ad2872451fab760a,2,38,4,42,6,2014-07-30 02:31:30,2014-07-22 12:49:28
f58fbec3e4418adc6a266f41ad2872451fab760a...7b3a7003634778690cf3114d30b16b0f49a01711,1,4,2,6,2,2014-07-30 03:46:48,2014-07-28 14:33:02
7b3a7003634778690cf3114d30b16b0f49a01711...4b121077d64a062b33575ac355e6c13fe1b0828f,2,0,0,0,0,2014-07-30 03:46:48,2014-07-28 14:34:44
4b121077d64a062b33575ac355e6c13fe1b0828f...d242afcbfe5dcd9db91cc28d32d4c0f4bc077772,1,1,2,3,2,2014-07-30 03:46:48,2014-07-28 15:35:56
d242afcbfe5dcd9db91cc28d32d4c0f4bc077772...83a289681a8d95569e59513ddc9fed3fef7801e9,1,0,0,0,0,2014-07-30 03:46:48,2014-07-28 15:36:30
83a289681a8d95569e59513ddc9fed3fef7801e9...edf8464711c12cfe0c0fef4db12fa53c822ae161,1,6,1,7,2,2014-07-30 03:46:48,2014-07-29 17:54:26
edf8464711c12cfe0c0fef4db12fa53c822ae161...03828d45d39e385cd28667372de7b9b57f23758d,1,16,1,17,2,2014-07-30 03:46:48,2014-07-29 17:54:51
03828d45d39e385cd28667372de7b9b57f23758d...953e40865250a4630a42ba54a5c0017f4e01f719,4,37,25,62,17,2014-07-30 03:46:48,2014-07-29 17:55:19
953e40865250a4630a42ba54a5c0017f4e01f719...6640690f85b8f043dbb83ac4510c8b153d6651e8,11,81,21,102,24,2014-07-30 03:46:48,2014-07-29 17:55:46
6640690f85b8f043dbb83ac4510c8b153d6651e8...5eba41b4540c2bef454784c4b5516691c397604b,1,0,0,0,0,2014-07-30 03:46:48,2014-07-29 17:59:22
5eba41b4540c2bef454784c4b5516691c397604b...6d66597265e158ec16dd31f823f0d474194519e7,2,9,14,23,7,2014-07-30 03:46:48,2014-07-29 21:36:32
6d66597265e158ec16dd31f823f0d474194519e7...dac9ac4a46348a67296b8b3ff11c58e522bd1b0b,12,362,148,510,49,2014-07-30 14:46:16,2014-07-30 14:45:36
dac9ac4a46348a67296b8b3ff11c58e522bd1b0b...7b56f68f2b81c46231335b52921ad65ec01aebe8,1,1,1,2,1,2014-07-30 16:03:37,2014-07-30 16:03:34
7b56f68f2b81c46231335b52921ad65ec01aebe8...791e2e00806449a01e7dec4d9b969392e183f393,1,36,4,40,6,2014-07-30 17:27:46,2014-07-30 14:05:06
791e2e00806449a01e7dec4d9b969392e183f393...9e72a5b850f7bc31453828db522f4e0ecbfdb691,1,2,2,4,2,2014-07-30 17:51:21,2014-07-30 15:58:50
9e72a5b850f7bc31453828db522f4e0ecbfdb691...c9ac1d84e13e9cd045ce1ad4385a6f55f54c755c,1,26,8,34,9,2014-07-30 19:39:47,2014-07-30 19:39:47
c9ac1d84e13e9cd045ce1ad4385a6f55f54c755c...76be742def16b4081e559374d66ede6a00cf3ff0,3,242,277,519,50,2014-07-30 20:12:02,2014-07-30 19:01:58
76be742def16b4081e559374d66ede6a00cf3ff0...13fe3b061fa3c5970c40973d6f36f69fa06130a5,12,656,80,736,28,2014-07-30 20:12:02,2014-07-30 19:12:11
13fe3b061fa3c5970c40973d6f36f69fa06130a5...d5003b700d437d5653ac0828215690e214773424,2,12,1,13,2,2014-07-30 21:07:32,2014-07-28 21:24:15
d5003b700d437d5653ac0828215690e214773424...28c53c610415e68e63c5757563f0d676c26e5a8c,13,149,28,177,42,2014-07-30 21:07:32,2014-07-28 23:03:52
28c53c610415e68e63c5757563f0d676c26e5a8c...f7df4c7dcfabbadb4fde07018f85d00bc8ba47a0,1,1,1,2,1,2014-07-30 21:16:22,2014-07-30 17:30:12
f7df4c7dcfabbadb4fde07018f85d00bc8ba47a0...6bfddeb720b51b88533c7ae453dc5c702fdc58a5,2,11,1,12,3,2014-07-31 14:17:39,2014-07-30 19:06:53
6bfddeb720b51b88533c7ae453dc5c702fdc58a5...0028a339876b352575758910a158973852ce4cfe,4,13,9,22,12,2014-07-31 14:52:01,2014-07-31 03:11:03
0028a339876b352575758910a158973852ce4cfe...b494ade9a9461d16ab3812640ca72ee9c9e4345c,14,266,437,703,71,2014-07-31 14:59:29,2014-07-23 17:52:36
b494ade9a9461d16ab3812640ca72ee9c9e4345c...50ca596ace0b1390482408f1b19ffb1f9170cab6,1,6,0,6,2,2014-07-31 15:54:33,2014-07-25 10:09:58
50ca596ace0b1390482408f1b19ffb1f9170cab6...a689566c22eb935bd3004b1506243c028a29bd19,14,59,32,91,20,2014-07-31 15:55:35,2014-07-30 21:12:29
a689566c22eb935bd3004b1506243c028a29bd19...ce38e09ca894cd66e22f0c7d3be2ece78ba2834d,5,40,15,55,9,2014-07-31 15:55:35,2014-07-30 22:12:29
ce38e09ca894cd66e22f0c7d3be2ece78ba2834d...6cc8c43a1c7256434663734aac071dcdf657c24f,8,116,10,126,23,2014-07-31 12:42:44,2014-07-24 13:59:45
6cc8c43a1c7256434663734aac071dcdf657c24f...89c7ad5908ac27657a95588e0cbf5752d9e4a1cb,21,125,30,155,30,2014-07-31 12:52:56,2014-07-24 15:31:45
89c7ad5908ac27657a95588e0cbf5752d9e4a1cb...5dd5518738671355e157750d9a6e01ea55140560,1,21,1,22,1,2014-07-31 12:53:36,2014-07-25 13:38:08
5dd5518738671355e157750d9a6e01ea55140560...2ea074937c82239d7ae187af879f0352131b119b,2,6,3,9,2,2014-07-31 12:53:36,2014-07-25 13:49:59
2ea074937c82239d7ae187af879f0352131b119b...396380291e600f9d72d2e405f7b7cb4e8b7d4811,1,6,0,6,3,2014-07-31 18:37:29,2014-07-24 21:04:47
396380291e600f9d72d2e405f7b7cb4e8b7d4811...6b4fd623b85b22367b919fcf16580be412b1eebe,2,23,13,36,8,2014-07-31 19:00:40,2014-07-31 18:48:24
6b4fd623b85b22367b919fcf16580be412b1eebe...2431388bad083d427e36c554e77050d9a8854e23,1,1,1,2,2,2014-07-31 19:27:29,2014-07-31 19:27:29
2431388bad083d427e36c554e77050d9a8854e23...6c936d46e3c2fa43034d47162c31e98534ae5d27,1,1,1,2,1,2014-07-31 14:38:39,2014-07-31 14:38:39
6c936d46e3c2fa43034d47162c31e98534ae5d27...7e6b8c83f87bfb8306b3ab3fe15dd3fa451fc1e9,2,46,0,46,2,2014-07-31 19:46:10,2014-07-31 13:16:18
7e6b8c83f87bfb8306b3ab3fe15dd3fa451fc1e9...9ec7d68a97dc54f534e95959e62cafcab38bd440,7,12,12,24,12,2014-07-31 16:52:42,2014-07-31 15:40:56
9ec7d68a97dc54f534e95959e62cafcab38bd440...0f45edb3e83bef553ae70c4cbab4c08319f2fd61,1,3,0,3,1,2014-07-31 22:02:43,2014-07-31 22:02:43
0f45edb3e83bef553ae70c4cbab4c08319f2fd61...540f9ecd934c61a695aa26ff0c2dc31881e0ad31,2,9,8,17,5,2014-08-01 14:44:29,2014-07-30 12:55:12
540f9ecd934c61a695aa26ff0c2dc31881e0ad31...93625eb6a773f0ecdd0324afba4926f35c9abe43,1,1,1,2,1,2014-08-01 14:44:29,2014-07-30 13:06:19
93625eb6a773f0ecdd0324afba4926f35c9abe43...d7a94e259c94a46feab8fabebbd8c4dc0eebce8f,1,12,1,13,2,2014-08-01 14:44:29,2014-07-30 13:22:26
d7a94e259c94a46feab8fabebbd8c4dc0eebce8f...ebec63d57182db2d21bdcd3b7a95636c06991190,5,6,8,14,6,2014-08-01 14:44:29,2014-07-30 13:23:00
ebec63d57182db2d21bdcd3b7a95636c06991190...77281ef19fd778813c7b87d22dd51f3da7292e64,1,12,2,14,4,2014-08-01 14:44:29,2014-07-30 14:30:34
77281ef19fd778813c7b87d22dd51f3da7292e64...02948ba65855df43bfbdee5c4e0f834c678532b7,1,2,2,4,2,2014-08-01 14:44:29,2014-07-30 16:53:14
02948ba65855df43bfbdee5c4e0f834c678532b7...661ae0ba0831eff124a456275a53e9f761a3940a,11,24,25,49,18,2014-08-01 14:44:29,2014-07-30 20:31:41
661ae0ba0831eff124a456275a53e9f761a3940a...fb8f09c9c5b4a203c13538126bd58255be25c8d7,1,13,20,33,6,2014-08-01 14:44:29,2014-07-30 22:20:39
fb8f09c9c5b4a203c13538126bd58255be25c8d7...c869fa7ca774be7178d540ba023dad42be2a169a,1,16,7,23,11,2014-08-01 14:44:29,2014-07-30 22:21:22
c869fa7ca774be7178d540ba023dad42be2a169a...642f633d9d012d7d4491b7e9cd8ef6fdd2d0886d,1,1,1,2,1,2014-08-01 14:44:29,2014-07-31 02:47:58
642f633d9d012d7d4491b7e9cd8ef6fdd2d0886d...76f11f2ef7db7a2db79f92ff5786331369bf0f52,1,10,4,14,2,2014-08-01 14:44:29,2014-07-31 02:48:08
76f11f2ef7db7a2db79f92ff5786331369bf0f52...280ecb86ea855a5a24e769e345feb132f83e29c9,1,3,1,4,1,2014-08-01 14:44:29,2014-08-01 11:34:02
280ecb86ea855a5a24e769e345feb132f83e29c9...3dd2fb57175f60f8321044bc416ee7bba4c19334,2,13,1,14,5,2014-08-01 14:44:29,2014-08-01 13:43:45
3dd2fb57175f60f8321044bc416ee7bba4c19334...5d870c10dcc796ef3fcbf9d65414988c44a767b6,1,6,7,13,3,2014-08-01 14:56:46,2014-08-01 14:56:46
5d870c10dcc796ef3fcbf9d65414988c44a767b6...243e7efa12db0a92129199388d03197b3415b6cf,7,12,12,24,12,2014-08-01 15:31:32,2014-08-01 15:31:32
243e7efa12db0a92129199388d03197b3415b6cf...88e52bc19f879af45715bd8cadb8df905773dea5,1,2,11,13,4,2014-08-01 15:54:07,2014-08-01 15:54:07
88e52bc19f879af45715bd8cadb8df905773dea5...e9971be526dd4c4e30c1acaae798e5a82aaac929,1,10,3,13,2,2014-08-01 17:53:01,2014-08-01 16:58:20
e9971be526dd4c4e30c1acaae798e5a82aaac929...f76e04154f73286fc1ce4a023116faa4170bcfdf,3,25,13,38,10,2014-08-01 19:00:24,2014-07-31 19:09:54
f76e04154f73286fc1ce4a023116faa4170bcfdf...1f00ffcd22e671f5adeece53c68b5e462ba01ec0,15,279,52,331,49,2014-08-01 19:37:21,2014-08-01 07:44:36
1f00ffcd22e671f5adeece53c68b5e462ba01ec0...e88cbe0c83833601f688d8e6b7eb165c8583a4aa,3,4,3,7,4,2014-08-01 19:41:57,2014-07-25 20:53:04
e88cbe0c83833601f688d8e6b7eb165c8583a4aa...6ea1e0b3b1bd20205e16877c43d75a0767de5f21,3,14,3,17,4,2014-08-01 20:16:00,2014-08-01 18:33:34
6ea1e0b3b1bd20205e16877c43d75a0767de5f21...a654322bd0e7a6d5336a44a09637da8b78b53f49,3,70,3,73,11,2014-08-01 20:16:01,2014-08-01 18:38:57
a654322bd0e7a6d5336a44a09637da8b78b53f49...c7bed7bbd3a4e121a115e9b59c12a1f89420a53b,2,57,3,60,6,2014-08-01 20:48:07,2014-07-30 20:54:30
c7bed7bbd3a4e121a115e9b59c12a1f89420a53b...d6d5e94ad9c50af53ab2294d0d4b4a1d38d7410e,1,18,0,18,2,2014-08-01 20:53:39,2014-08-01 15:02:41
d6d5e94ad9c50af53ab2294d0d4b4a1d38d7410e...2b17cf09a524f3f99ce811019543b9bb89b16c78,2,6,10,16,5,2014-08-01 20:53:39,2014-08-01 15:03:11
2b17cf09a524f3f99ce811019543b9bb89b16c78...bb887b35b38f73de05ed96dd39d97841a501029a,2,31,6,37,7,2014-08-01 20:53:39,2014-08-01 15:14:43
bb887b35b38f73de05ed96dd39d97841a501029a...a3e39c37f750fe3b933a970a470a96780b71e54b,3,107,27,134,6,2014-08-01 20:53:39,2014-08-01 15:36:58
a3e39c37f750fe3b933a970a470a96780b71e54b...daf68ad0c8a23459d490da94403ad97712f8991b,3,0,0,0,0,2014-08-01 20:53:39,2014-08-01 17:15:25
daf68ad0c8a23459d490da94403ad97712f8991b...383282d628b1738ab801f57f20dbab3648104073,2,17,37,54,8,2014-08-01 21:28:16,2014-07-31 17:55:15
383282d628b1738ab801f57f20dbab3648104073...6e2f3346f21f8e5de68aa5099317512ef51eb023,7,424,227,651,10,2014-08-01 21:40:33,2014-07-30 19:56:38
6e2f3346f21f8e5de68aa5099317512ef51eb023...d7133440dc8f05f0514d2b056d8605513b6e4d1b,2,19,0,19,6,2014-08-04 20:35:58,2014-08-04 20:35:58
d7133440dc8f05f0514d2b056d8605513b6e4d1b...e42f601194d67cfbde44bfcfb33af8284e68ecc3,14,22,18,40,15,2014-08-04 21:52:28,2014-08-04 18:56:39
e42f601194d67cfbde44bfcfb33af8284e68ecc3...c13eefdea68c0d493892014d42d8c4bbe687d4c3,1,55,24,79,2,2014-08-05 00:51:17,2014-08-04 18:11:45
c13eefdea68c0d493892014d42d8c4bbe687d4c3...931f48190b276dd783d76ae4071228d6ab1f0bfd,29,121,293,414,101,2014-08-05 11:06:36,2014-08-04 21:54:34
931f48190b276dd783d76ae4071228d6ab1f0bfd...f8003b264fe6c7a73fdfefd969983a885ef52958,7,50,45,95,19,2014-08-05 12:51:41,2014-08-04 13:11:12
f8003b264fe6c7a73fdfefd969983a885ef52958...568f6de65c6e9a88a26aa2e10b12cb68ae0f1b06,9,73,27,100,25,2014-08-05 12:51:41,2014-08-04 13:35:48
568f6de65c6e9a88a26aa2e10b12cb68ae0f1b06...e44e8071067865b7eebc6c6827fdcc7c051a60c5,8,34,6,40,11,2014-08-05 12:51:41,2014-08-04 14:04:47
e44e8071067865b7eebc6c6827fdcc7c051a60c5...670e6a31600dceddfd7dc356a639a3251a94a6ca,2,7,5,12,2,2014-08-05 12:51:41,2014-08-04 14:16:04
670e6a31600dceddfd7dc356a639a3251a94a6ca...c6572b24bd0dfaaf926a2027131fab283f6df701,3,11,20,31,5,2014-08-05 12:51:41,2014-08-04 14:16:23
c6572b24bd0dfaaf926a2027131fab283f6df701...aa86da1011b6fc9559f0ccc94639335de8b37301,3,0,0,0,0,2014-08-05 12:51:41,2014-08-04 14:25:38
aa86da1011b6fc9559f0ccc94639335de8b37301...5d311d9f0583e3d74ce1aa47c66965cd0b39276f,3,20,0,20,2,2014-08-05 12:51:41,2014-08-04 14:37:51
5d311d9f0583e3d74ce1aa47c66965cd0b39276f...addfc302ecf617dfe46e4ce09d629e6bf8367f85,6,36,2,38,4,2014-08-05 12:51:41,2014-08-04 16:33:52
addfc302ecf617dfe46e4ce09d629e6bf8367f85...19df2e7d6a25345f0f751212e5fab190b4e016ee,1,6,3,9,1,2014-08-05 12:51:41,2014-08-04 16:34:11
19df2e7d6a25345f0f751212e5fab190b4e016ee...6b534d4275b913eb8eaa31ffdacc7e25b5494afa,1,2,0,2,1,2014-08-05 12:51:41,2014-08-04 16:34:28
6b534d4275b913eb8eaa31ffdacc7e25b5494afa...87fbf90ba0096550a32f6f9967f5daa44398e8c6,16,299,170,469,45,2014-08-05 08:54:29,2014-07-30 13:30:21
87fbf90ba0096550a32f6f9967f5daa44398e8c6...796797ddf9bb6355bc7e2ffef52c7baaf9398c4c,15,299,45,344,24,2014-08-05 08:54:29,2014-08-04 10:13:43
796797ddf9bb6355bc7e2ffef52c7baaf9398c4c...50789ae076281da32412ef6bdf3145fc4b070f16,5,1086,0,1086,6,2014-08-05 14:21:05,2014-07-23 21:32:17
50789ae076281da32412ef6bdf3145fc4b070f16...6499f50b1fb6333096b8c358deededb920738f7e,5,164,133,297,17,2014-08-05 16:54:15,2014-08-05 13:16:07
6499f50b1fb6333096b8c358deededb920738f7e...602639ffa6d8fbbbcfa6cfec4ff2a5a37158d88f,1,0,2,2,1,2014-08-05 16:54:15,2014-08-05 16:53:24
602639ffa6d8fbbbcfa6cfec4ff2a5a37158d88f...9b0b7f0eeb9eec34b3d6ba48c3a7ccf7d6f32503,5,0,1086,1086,6,2014-08-05 17:57:42,2014-08-05 17:57:42
9b0b7f0eeb9eec34b3d6ba48c3a7ccf7d6f32503...35f827aef4ddfcf9acb9e4b90cb200ff29183b7c,2,63,3,66,12,2014-08-05 17:58:33,2014-08-04 18:42:58
35f827aef4ddfcf9acb9e4b90cb200ff29183b7c...8130d43a0dbc51413fd460efc4bb27108c1ea315,3,150,16,166,19,2014-08-06 15:49:20,2014-07-30 15:59:05
8130d43a0dbc51413fd460efc4bb27108c1ea315...6a81ce76079c72b7f7c78170ac33f7a7c2772922,7,23,17,40,18,2014-08-06 15:49:20,2014-08-05 13:43:54
6a81ce76079c72b7f7c78170ac33f7a7c2772922...9593c2ee9546f2d9ea2d24ff56743a70b4af2a01,1,0,5,5,1,2014-08-06 17:27:06,2014-08-06 17:27:06
9593c2ee9546f2d9ea2d24ff56743a70b4af2a01...b6f7a03697f160c965b467e8962f7f29934935c4,2,26,2,28,5,2014-08-06 17:53:08,2014-07-21 18:05:24
b6f7a03697f160c965b467e8962f7f29934935c4...5aa26641648876ee10dcfc8ff7256dd46efc8b9c,5,1088,0,1088,6,2014-08-06 17:54:59,2014-08-06 17:54:00
5aa26641648876ee10dcfc8ff7256dd46efc8b9c...0909916a337366eb316386ced7ee6c2ade86a89c,12,20,114,134,31,2014-08-06 18:09:00,2014-07-30 23:04:52
0909916a337366eb316386ced7ee6c2ade86a89c...94d9e73102a3e7b623d57635573066fcb5b0be97,6,82,46,128,18,2014-08-06 18:11:06,2014-07-24 21:04:15
94d9e73102a3e7b623d57635573066fcb5b0be97...d1ea3910fc9acd03a4964a66ff9b27ef1112a5c5,1,1,0,1,1,2014-08-06 18:46:12,2014-08-06 18:46:12
d1ea3910fc9acd03a4964a66ff9b27ef1112a5c5...82dfdf0e635bd096e5f12180b550f9899b272692,12,5,352,357,16,2014-08-06 18:50:50,2014-07-31 18:23:06
82dfdf0e635bd096e5f12180b550f9899b272692...c55d103b02fabe2e7b00d950bef5f8c4b8012fab,1,2,0,2,1,2014-08-06 19:06:24,2014-08-06 17:53:01
c55d103b02fabe2e7b00d950bef5f8c4b8012fab...0abad88721986ade3933ef5dfa07e0b371266d6c,5,44,25,69,33,2014-08-06 20:12:04,2014-08-01 22:34:53
0abad88721986ade3933ef5dfa07e0b371266d6c...f7620276e1d7b97d73cad27bc67af6967c5edc91,5,173,45,218,19,2014-08-06 20:20:58,2014-08-01 22:38:19
f7620276e1d7b97d73cad27bc67af6967c5edc91...e4dc978189d4022e3f5e81b4de4d4eee061a8314,4,28,5,33,6,2014-08-06 20:20:59,2014-08-04 21:28:37
e4dc978189d4022e3f5e81b4de4d4eee061a8314...eaac0152f37484f7e581be6fc1d838eb6001ddfb,6,298,176,474,17,2014-08-06 21:52:33,2014-08-05 21:25:35
eaac0152f37484f7e581be6fc1d838eb6001ddfb...e5659ef4dde0724a4c4eace6f1ca8d54bb17e04f,6,9,9,18,9,2014-08-06 23:49:13,2014-08-03 15:08:46
e5659ef4dde0724a4c4eace6f1ca8d54bb17e04f...559d29efb349606850cd195b0af4cda28035806b,2,8,5,13,5,2014-08-07 12:20:28,2014-08-06 17:47:32
559d29efb349606850cd195b0af4cda28035806b...17a8a00da6e9ac5fe09a658499c071a3879d45a8,1,20,20,40,20,2014-08-07 12:50:59,2014-08-07 12:50:59
17a8a00da6e9ac5fe09a658499c071a3879d45a8...38572a2535ad1174d26af539d710068204ab3bc4,6,15,18,33,13,2014-08-07 14:53:00,2014-08-06 16:12:22
38572a2535ad1174d26af539d710068204ab3bc4...7f42946e254d525697e58840d057c2bf3a0d93e2,1,7,3,10,3,2014-08-07 14:53:00,2014-08-06 19:05:04
7f42946e254d525697e58840d057c2bf3a0d93e2...7d3048502184e1b89d502302c12da4dcbde2e221,3,14,0,14,3,2014-08-07 15:02:43,2014-08-01 20:02:29
7d3048502184e1b89d502302c12da4dcbde2e221...48acc2079926e7bafabef9a69a6b5a4f8e1fae1e,1,1,1,2,1,2014-08-07 15:57:21,2014-08-07 15:10:11
48acc2079926e7bafabef9a69a6b5a4f8e1fae1e...4b03f988e91c4991ab60f5f8edc933cee5640796,1,1,1,2,1,2014-08-07 16:23:22,2014-08-07 11:51:53
4b03f988e91c4991ab60f5f8edc933cee5640796...8e986f6e55be93a3ba8b3ceee7fc7519b2ed5334,2,1,12,13,5,2014-08-07 16:33:03,2014-08-04 15:35:09
8e986f6e55be93a3ba8b3ceee7fc7519b2ed5334...e931498da5d7b96babf2a72df413a5b8666cb228,3,243,240,483,61,2014-08-07 16:33:04,2014-08-04 15:42:10
e931498da5d7b96babf2a72df413a5b8666cb228...fd9306a5955b04a19dbeb5d8eddceb21d0beb79f,1,68,16,84,9,2014-08-07 16:51:47,2014-08-01 19:17:26
fd9306a5955b04a19dbeb5d8eddceb21d0beb79f...488e855b797f1a61d6a5e08f812f85fcb2f03a51,4,132,80,212,69,2014-08-07 17:36:43,2014-03-07 20:24:32
488e855b797f1a61d6a5e08f812f85fcb2f03a51...b3787777795434829a3b512c06b5a0a508d81467,1,37,13,50,6,2014-08-07 17:57:34,2014-08-05 18:35:14
b3787777795434829a3b512c06b5a0a508d81467...bdd3bc57d295d72e42af81ae6c9f3a8549fa44c1,1,1,1,2,1,2014-08-07 18:43:51,2014-08-07 18:16:34
bdd3bc57d295d72e42af81ae6c9f3a8549fa44c1...1cef2222eab85ec6b2c494116f4a576736516f7f,1,7,2,9,3,2014-08-07 19:43:12,2014-08-07 19:43:12
1cef2222eab85ec6b2c494116f4a576736516f7f...d261864e9156af7ecc3d0491111dffa0161e9d0d,1,13,37,50,6,2014-08-07 21:27:07,2014-08-07 21:27:07
d261864e9156af7ecc3d0491111dffa0161e9d0d...a88395dff3cc8bc3beec8356b8b25869d9c6cfe4,2,70,2,72,6,2014-08-07 22:36:05,2014-08-07 20:26:51
a88395dff3cc8bc3beec8356b8b25869d9c6cfe4...48b0eb5b87ed6037541a0db3dac32b09b79c0bc2,6,22,21,43,12,2014-08-07 22:41:48,2014-08-07 20:30:54
48b0eb5b87ed6037541a0db3dac32b09b79c0bc2...88cc54431e112cd2edaa9042b3b20ba1b10fce82,1,20,21,41,7,2014-08-07 23:07:58,2014-08-07 18:28:02
88cc54431e112cd2edaa9042b3b20ba1b10fce82...c30b981260e26dfeff315b766e2887d4f7404f89,5,259,162,421,82,2014-08-07 23:52:15,2014-07-28 15:35:11
c30b981260e26dfeff315b766e2887d4f7404f89...9d1e5f95a2739a7672b697deb7d1da04ca8c4117,8,305,119,424,50,2014-08-07 23:52:15,2014-08-01 15:57:03
9d1e5f95a2739a7672b697deb7d1da04ca8c4117...adc36ff6450b1ee493b9acd26d3e79bd4facf953,1,4,4,8,4,2014-08-08 02:13:48,2014-08-04 23:39:08
adc36ff6450b1ee493b9acd26d3e79bd4facf953...fe950f19e616a86fdea70da66eda658d64489a5e,3,5,1,6,5,2014-08-08 02:13:48,2014-08-04 23:40:54
fe950f19e616a86fdea70da66eda658d64489a5e...1b1842be9b0b4500eb00b110841eaed41003b742,1,23,0,23,1,2014-08-08 09:56:35,2014-07-28 19:22:08
1b1842be9b0b4500eb00b110841eaed41003b742...50601136fc8b9399a1832b84396e74e7bc9011c5,1,37,13,50,6,2014-08-08 13:52:10,2014-08-08 13:52:10
50601136fc8b9399a1832b84396e74e7bc9011c5...e97e4f04874a10a3d427a23eb3de4f97234b8c89,1,1,1,2,1,2014-08-08 13:54:19,2014-08-08 13:54:19
e97e4f04874a10a3d427a23eb3de4f97234b8c89...efd7c52925f0d2030fa7462b358d7b8faffe5b4c,1,7,7,14,2,2014-08-08 15:57:23,2014-08-07 14:50:12
efd7c52925f0d2030fa7462b358d7b8faffe5b4c...ec23ec25b5b6aaae4611a87eee246c646df0361c,2,37,26,63,9,2014-08-08 15:58:30,2014-08-08 15:44:53
ec23ec25b5b6aaae4611a87eee246c646df0361c...4df93459d69b1536340047f9693f66763e001343,2,27,27,54,6,2014-08-08 16:20:43,2014-08-08 16:11:28
4df93459d69b1536340047f9693f66763e001343...e42a4603f7812286bea6b1e2df704d9781f75679,5,36,12,48,15,2014-08-08 16:30:01,2014-08-07 15:08:05
e42a4603f7812286bea6b1e2df704d9781f75679...920a4a18b00f5831f644934671e64174186b164f,1,9,29,38,8,2014-08-08 17:18:06,2014-08-07 15:24:57
920a4a18b00f5831f644934671e64174186b164f...972264abaf49c46b0726841e4fa2444cd3f3d737,4,30,6,36,10,2014-08-08 18:12:01,2014-08-07 22:28:32
972264abaf49c46b0726841e4fa2444cd3f3d737...1232c89874a8763375b65c438680e8441f65f021,11,68,64,132,42,2014-08-08 18:17:59,2014-08-07 22:31:16
1232c89874a8763375b65c438680e8441f65f021...0adbb451f7393c633686d65fd77b77ddc1161fe4,1,2,1,3,1,2014-08-08 19:06:11,2014-08-08 18:15:14
0adbb451f7393c633686d65fd77b77ddc1161fe4...daab6fae496e1aca6b8f7c709bd18307745df1dd,7,496,235,731,18,2014-08-08 20:25:52,2014-07-31 20:42:21
daab6fae496e1aca6b8f7c709bd18307745df1dd...ff1c6fd66530866cd04e2a8e40e368b9f565ee34,3,45,6,51,12,2014-08-08 20:27:20,2014-07-28 21:47:45
ff1c6fd66530866cd04e2a8e40e368b9f565ee34...4f5703ae45f05576fac5261dc985aabd142a0a78,5,136,24,160,9,2014-08-09 03:46:36,2014-07-31 22:05:06
4f5703ae45f05576fac5261dc985aabd142a0a78...cf2917a1e94959a696642407425f89fe14ccb1b4,4,468,0,468,10,2014-08-11 14:30:06,2014-08-05 00:13:49
cf2917a1e94959a696642407425f89fe14ccb1b4...08873e79890885f83d0a9ae1de7ea9f4769cd83d,2,6,6,12,6,2014-08-11 17:50:43,2014-08-11 17:45:16
08873e79890885f83d0a9ae1de7ea9f4769cd83d...4064ced405a51bedcb9da9d90f0320023e23728c,19,398,149,547,83,2014-08-11 19:17:52,2014-08-11 17:44:49
4064ced405a51bedcb9da9d90f0320023e23728c...1663f45b4e33e058a0203a81f50574a870882c34,1,12,0,12,1,2014-08-11 20:12:44,2014-08-11 14:12:52
1663f45b4e33e058a0203a81f50574a870882c34...2a90d1e20230800f8dc5a01ea066873354fcd938,1,13,7,20,3,2014-08-11 15:37:35,2014-08-11 14:26:28
2a90d1e20230800f8dc5a01ea066873354fcd938...c184143fa4d8a4fdf4fdc684404d4aad3e55794b,9,1556,694,2250,27,2014-08-11 20:51:47,2014-08-01 17:15:36
c184143fa4d8a4fdf4fdc684404d4aad3e55794b...2779fc44168384bf5c87790ae7e2a1653c57e87c,5,298,92,390,52,2014-08-12 14:03:18,2014-08-07 18:59:31
2779fc44168384bf5c87790ae7e2a1653c57e87c...c328d06c22c9b693e66dcdf020b3642fb147b8ac,3,124,116,240,37,2014-08-12 14:20:50,2014-08-11 16:15:34
c328d06c22c9b693e66dcdf020b3642fb147b8ac...0d3349ce115b14a9e5cd2b7438f1e796067043e0,29,3289,1012,4301,288,2014-08-12 14:35:39,2014-08-07 16:43:42
0d3349ce115b14a9e5cd2b7438f1e796067043e0...d07bd48ce773907d04a63bcedcc9e69283391a09,1,1,1,2,1,2014-08-12 14:37:51,2014-08-06 20:20:19
d07bd48ce773907d04a63bcedcc9e69283391a09...6e7a8ef675dd9a6f43dc191bfa35c550ddee7368,1,34,0,34,1,2014-08-12 14:39:42,2014-08-11 21:42:58
6e7a8ef675dd9a6f43dc191bfa35c550ddee7368...ba26e58774f11d1ca8ef234af461f601f75d4c0a,3,27,2,29,5,2014-08-12 09:57:07,2014-08-04 15:55:04
ba26e58774f11d1ca8ef234af461f601f75d4c0a...f8097fb0f8c4c52bbf117e5d5aaa16f9008937c1,2,63,1,64,2,2014-08-12 10:07:42,2014-08-04 17:22:58
f8097fb0f8c4c52bbf117e5d5aaa16f9008937c1...f3bcadd173c368efbfdbe8900bf4bdb31bb5ac9c,2,0,66,66,2,2014-08-12 17:27:21,2014-08-11 19:12:00
f3bcadd173c368efbfdbe8900bf4bdb31bb5ac9c...99e76fcc67198289d2913d667df6cf9e274bd427,8,4,292,296,17,2014-08-12 17:29:19,2014-08-11 18:13:27
99e76fcc67198289d2913d667df6cf9e274bd427...fae7c52d21cacdc97c898d17b95e4322f8a9bb87,7,0,158,158,14,2014-08-12 17:32:49,2014-08-11 18:40:10
fae7c52d21cacdc97c898d17b95e4322f8a9bb87...e2a58d5fd4e3f0d64bb5ba10de87ca48365617fc,1,11,0,11,3,2014-08-12 18:00:33,2014-08-06 02:06:44
e2a58d5fd4e3f0d64bb5ba10de87ca48365617fc...8d0bf7dfbfafd09b9465feec3651cdd31aeb0dcc,11,1718,0,1718,12,2014-08-12 14:07:27,2014-08-11 14:03:42
8d0bf7dfbfafd09b9465feec3651cdd31aeb0dcc...dc9e090dba1f17467520eca13571512c621d503f,24,564,330,894,154,2014-08-12 14:18:42,2014-08-11 14:36:30
dc9e090dba1f17467520eca13571512c621d503f...8fab360707f1a88efd821a7b7981ca972a9cad35,1,3,3,6,3,2014-08-12 20:08:20,2014-08-12 15:27:11
8fab360707f1a88efd821a7b7981ca972a9cad35...712768556e72d1756995c6a7b020b875fb9d6ea9,4,954,0,954,5,2014-08-12 21:04:08,2014-07-17 18:04:17
712768556e72d1756995c6a7b020b875fb9d6ea9...cd5c001c43b295ad601b0004f9c31f9d454f5d04,12,302,59,361,59,2014-08-12 21:04:40,2014-07-21 18:36:17
cd5c001c43b295ad601b0004f9c31f9d454f5d04...0ea8cf462b48a1aeefb10fd4bba0b1e93b0e661e,3,2,2,4,3,2014-08-12 21:11:57,2014-08-12 15:38:09
0ea8cf462b48a1aeefb10fd4bba0b1e93b0e661e...a3845092f26955e6cbfca868fd136b7d5eefed9b,220,1009,478,1487,281,2014-08-12 22:56:41,2014-08-05 18:32:45
a3845092f26955e6cbfca868fd136b7d5eefed9b...850d2d0912e519e544f0c896583a6fbd5cceabce,5,348,66,414,14,2014-08-12 22:56:41,2014-08-07 21:13:30
850d2d0912e519e544f0c896583a6fbd5cceabce...8a523f3bfd6e32cb6882d38e4eeff6adb6ea27c1,128,289,244,533,264,2014-08-12 22:56:41,2014-08-08 15:08:17
8a523f3bfd6e32cb6882d38e4eeff6adb6ea27c1...2644f32bc3e8aa2f0c68ad19b93ebb0b681471c1,4,27,158,185,22,2014-08-12 22:56:41,2014-08-08 20:06:34
2644f32bc3e8aa2f0c68ad19b93ebb0b681471c1...7fb648f261973a7002d88e8405fc1e4661d0fbdd,1,16,1,17,2,2014-08-12 22:56:41,2014-08-07 16:13:20
7fb648f261973a7002d88e8405fc1e4661d0fbdd...6042e906fdd907d53b8231749422f786f19114d8,1,10,11,21,5,2014-08-12 23:35:21,2014-08-01 22:41:52
6042e906fdd907d53b8231749422f786f19114d8...82e53c90774707a51e3f1b82c5b672a3e3700640,1,12,13,25,5,2014-08-12 23:35:21,2014-08-01 23:00:32
82e53c90774707a51e3f1b82c5b672a3e3700640...ce36d23ba2fe7962353668934c777c2f6263d078,1,5,0,5,2,2014-08-12 23:35:21,2014-08-01 21:13:06
ce36d23ba2fe7962353668934c777c2f6263d078...2fd6a449d0e56a99125949c0a317acd0655827c4,3,208,153,361,4,2014-08-13 14:49:13,2014-08-11 14:54:56
2fd6a449d0e56a99125949c0a317acd0655827c4...c610cfe5c58d1f4301f5535d3e166d5d4332bc87,35,41,48,89,45,2014-08-13 19:01:12,2014-08-13 16:18:53
c610cfe5c58d1f4301f5535d3e166d5d4332bc87...00913e47de5aced5267e44e82ac9e976bbaac089,49,1201,1371,2572,329,2014-08-13 21:30:25,2014-07-30 21:34:46
00913e47de5aced5267e44e82ac9e976bbaac089...e33a6c57607871f1b204bd5e1d8ea4a14ad06452,50,166,162,328,153,2014-08-13 21:30:25,2014-08-11 18:12:42
e33a6c57607871f1b204bd5e1d8ea4a14ad06452...1f5428d02542074a49e054172f4dac46b06fd97b,2,3,3,6,3,2014-08-14 14:36:05,2014-08-14 04:21:04
1f5428d02542074a49e054172f4dac46b06fd97b...10827279fbc6380d4d7774837022b65b3204a988,12,39,3,42,14,2014-08-14 15:43:33,2014-08-13 15:08:46
10827279fbc6380d4d7774837022b65b3204a988...998ed782161c493ceb766e17deb2b0550dca2c7c,1,7,1,8,2,2014-08-14 19:57:37,2014-08-07 21:27:37
998ed782161c493ceb766e17deb2b0550dca2c7c...2c56cc550c8f3894e8631fd9862220352b255ab5,1,0,1,1,1,2014-08-14 21:02:30,2014-08-13 21:51:43
2c56cc550c8f3894e8631fd9862220352b255ab5...ced73c084c0d391ca49b9b6aa271b6cea6636de0,1,2,2,4,1,2014-08-14 21:04:15,2014-08-14 20:51:13
ced73c084c0d391ca49b9b6aa271b6cea6636de0...256d9b8323080d84807b7f951134b61cb55169eb,1,1,0,1,1,2014-08-14 21:10:21,2014-08-14 21:10:08
256d9b8323080d84807b7f951134b61cb55169eb...f60c7f9003ec815c5e4c37decb6ae48a80bf84ec,1,0,1,1,1,2014-08-14 21:16:49,2014-08-13 21:51:43
f60c7f9003ec815c5e4c37decb6ae48a80bf84ec...7a1a0ce4ca6bbdf047adc7528310078ef7ca08f8,2,2,1,3,3,2014-08-14 22:04:04,2014-08-14 21:58:22
7a1a0ce4ca6bbdf047adc7528310078ef7ca08f8...be05259d36ec5f44c821c8f2d103a4ee83ebaf53,21,123,116,239,58,2014-08-15 05:44:41,2014-08-13 20:02:17
be05259d36ec5f44c821c8f2d103a4ee83ebaf53...a1042b421b4a1f046a0228ef316c95f001a4781b,3,53,7,60,6,2014-08-15 14:50:15,2014-08-14 18:25:48
a1042b421b4a1f046a0228ef316c95f001a4781b...93ba91bdf9ce4721a5467e5d35118b16f04c2577,1,7,6,13,3,2014-08-15 15:18:18,2014-08-15 15:18:18
93ba91bdf9ce4721a5467e5d35118b16f04c2577...2966c35b20416d55c3d481e5f254a9befb1b2338,7,7,7,14,7,2014-08-15 18:16:30,2014-08-15 18:16:30
2966c35b20416d55c3d481e5f254a9befb1b2338...e4c72a04f7dab7ab747f59306cabd36cff3f3e16,7,7,7,14,7,2014-08-15 18:19:04,2014-08-15 18:19:04
e4c72a04f7dab7ab747f59306cabd36cff3f3e16...39d5795eab4da921e2c813b3c99ae52a0d913f6b,2,57,0,57,2,2014-08-15 19:26:07,2014-08-13 21:48:31
39d5795eab4da921e2c813b3c99ae52a0d913f6b...8aa630d79699ff72fcb47e381c4caf318161f01e,10,238,210,448,73,2014-08-15 19:31:49,2014-08-11 21:23:25
8aa630d79699ff72fcb47e381c4caf318161f01e...0f5849fd4d4bf9f398c14e21fc4c9f9be123f0aa,4,269,4,273,7,2014-08-15 20:13:22,2014-08-13 18:43:26
0f5849fd4d4bf9f398c14e21fc4c9f9be123f0aa...df064a77f5bbf80396ce71c70f68eecc062d1b42,9,88,71,159,30,2014-08-15 20:19:43,2014-07-30 17:15:55
df064a77f5bbf80396ce71c70f68eecc062d1b42...95e93e471d6a7852e4daa41214501474d4bd4866,7,140,133,273,15,2014-08-15 20:41:49,2014-08-14 23:26:40
95e93e471d6a7852e4daa41214501474d4bd4866...492d97468b1121228f208489a645759b390f023e,1,3,1,4,1,2014-08-15 15:53:54,2014-08-15 15:07:53
492d97468b1121228f208489a645759b390f023e...0d1d5016b57c59817fa0619e5cf4c6df046b28c3,4089,768999,0,768999,4089,2014-08-15 21:20:20,2014-08-15 21:06:16
0d1d5016b57c59817fa0619e5cf4c6df046b28c3...ca9435b38321914ed154b6d6293d0f411d4db131,6,235,89,324,54,2014-08-15 22:01:58,2014-08-15 22:01:58
ca9435b38321914ed154b6d6293d0f411d4db131...2b711b7f65b5fc0faea088ae7040029afbec22dc,7,133,140,273,15,2014-08-15 22:23:58,2014-08-15 22:23:58
2b711b7f65b5fc0faea088ae7040029afbec22dc...e970e918c5300a13360edb57a88871b02dbe5982,10,275,165,440,119,2014-08-16 00:08:52,2014-07-31 17:50:58
e970e918c5300a13360edb57a88871b02dbe5982...945a11a2a07c2b5c6c1479880a415fb48a99836f,8,141,134,275,16,2014-08-18 15:46:57,2014-08-14 23:26:40
945a11a2a07c2b5c6c1479880a415fb48a99836f...d8612542111d9af6b99c5f6ad3cd8e0c4b43cea1,4,450,2,452,5,2014-08-18 18:29:40,2014-08-18 15:10:05
d8612542111d9af6b99c5f6ad3cd8e0c4b43cea1...e1f14a9387f4a0e96039eb7cd1cb1273bac3e86a,4,2,450,452,5,2014-08-18 20:00:52,2014-08-18 20:00:52
e1f14a9387f4a0e96039eb7cd1cb1273bac3e86a...1c5ba979202d53a35242c941e40bfc2b4f171bf3,2,35,37,72,16,2014-08-18 21:32:46,2014-08-18 18:01:53
1c5ba979202d53a35242c941e40bfc2b4f171bf3...fe11098d32f0e002349fd2513834f6c8928fe550,9,55,26,81,21,2014-08-19 14:14:48,2014-08-12 20:18:57
fe11098d32f0e002349fd2513834f6c8928fe550...0b190a580c13ff8b96a10fd9c9e6b18e01e44631,25,124,19,143,31,2014-08-19 16:10:46,2014-08-18 23:16:59
0b190a580c13ff8b96a10fd9c9e6b18e01e44631...018b95b10a10cef1b2d1dc047a7b53282752a099,8,271,4,275,12,2014-08-19 16:56:55,2014-08-19 00:19:17
018b95b10a10cef1b2d1dc047a7b53282752a099...aa811c391648b83a338b7d86a961d1a72e70e86f,6,24,11,35,6,2014-08-19 17:17:29,2014-08-19 17:17:29
aa811c391648b83a338b7d86a961d1a72e70e86f...caa6c9411ba9e3b2b0e9056a0e194009298e4ed8,7,95,22,117,20,2014-08-19 18:15:12,2014-08-19 18:15:12
caa6c9411ba9e3b2b0e9056a0e194009298e4ed8...144aa2a423424ba2da0b0c16ca91dcbbf6dfbf70,8,29,42,71,27,2014-08-19 18:41:17,2014-08-14 20:35:49
144aa2a423424ba2da0b0c16ca91dcbbf6dfbf70...84110130c0de9aa17c5a26ecf21ee75828838b0a,2,18,18,36,2,2014-08-19 19:44:17,2014-08-15 18:50:38
84110130c0de9aa17c5a26ecf21ee75828838b0a...6354bcfdd21c632c7578745bd4b794aaf16b491a,4,133,93,226,34,2014-08-19 19:44:17,2014-08-14 21:09:48
6354bcfdd21c632c7578745bd4b794aaf16b491a...cc54386515d70ac012910b969fc893aa3282e16b,1,16,0,16,1,2014-08-19 19:44:17,2014-08-18 14:06:44
cc54386515d70ac012910b969fc893aa3282e16b...f585b865685f4c29619a7a7ea61463b8e25c67cc,3,5,3,8,4,2014-08-19 19:44:17,2014-08-14 20:56:47
f585b865685f4c29619a7a7ea61463b8e25c67cc...0029e2fb4d83c2fcacb6c4f190579f25f8652e8b,1,2,2,4,2,2014-08-19 20:56:21,2014-08-19 20:56:21
0029e2fb4d83c2fcacb6c4f190579f25f8652e8b...b3b6a1a9da2417ce61b2654f9ac5cc2685bc87ad,1,4,4,8,2,2014-08-19 21:46:05,2014-08-19 21:18:35
b3b6a1a9da2417ce61b2654f9ac5cc2685bc87ad...37ce554db0dacb275db937572d17b37acc10adf0,2,7,1,8,3,2014-08-19 23:30:06,2014-08-18 15:58:02
37ce554db0dacb275db937572d17b37acc10adf0...c18aa8e2560b266bf5806310d67a7f2bed2d43d3,4,452,2,454,5,2014-08-19 23:58:15,2014-08-18 15:10:05
c18aa8e2560b266bf5806310d67a7f2bed2d43d3...8f9c2e19ae3131e1aebb64d8ab46ac9bb4a5eae3,1,1,1,2,1,2014-08-20 13:08:38,2014-08-20 04:01:56
8f9c2e19ae3131e1aebb64d8ab46ac9bb4a5eae3...fb1e82a243bc7c2b96ea1cfa78370f08a4c59bc6,1,32,1,33,2,2014-08-20 16:06:34,2013-04-03 21:01:28
fb1e82a243bc7c2b96ea1cfa78370f08a4c59bc6...88e30849b29c0e2050bba768545daefa170be927,4,218,255,473,86,2014-08-20 17:44:01,2014-05-29 19:11:56
88e30849b29c0e2050bba768545daefa170be927...4f379f1c6689481b74d3672effdc7cd81a5f5d9a,6,25,48,73,15,2014-08-20 17:57:04,2014-08-14 18:54:51
4f379f1c6689481b74d3672effdc7cd81a5f5d9a...4cec893ff09f7688c934c5b9a5792bf1c370974d,13,36,21,57,18,2014-08-20 17:57:04,2014-08-15 22:11:36
4cec893ff09f7688c934c5b9a5792bf1c370974d...081f11c248433f74806b7508555b212bc4ff0164,6,36,9,45,8,2014-08-20 17:57:04,2014-08-18 17:58:41
081f11c248433f74806b7508555b212bc4ff0164...562c8cb3faff5e9fc0acdc45db8dc2d498eb2000,24,105,83,188,72,2014-08-20 17:57:04,2014-08-13 19:15:02
562c8cb3faff5e9fc0acdc45db8dc2d498eb2000...71277e8a5d072fbfa956a74f3c0295f69ead120f,1,6,5,11,3,2014-08-20 18:16:47,2014-08-19 20:14:46
71277e8a5d072fbfa956a74f3c0295f69ead120f...a8d7c7b8559e8a4fe85e13de459a961099e8a04d,1,5,4,9,4,2014-08-20 19:09:46,2014-08-20 19:09:46
a8d7c7b8559e8a4fe85e13de459a961099e8a04d...090f23992082e349e65c6bd3e2f7c5264fa1d1b3,5,40,7,47,14,2014-08-20 19:31:47,2014-08-20 17:31:35
090f23992082e349e65c6bd3e2f7c5264fa1d1b3...f9a0f6380d1858bb8c8feeb008276c680d68d7ba,2,39,22,61,7,2014-08-20 19:33:26,2014-08-19 16:51:12
f9a0f6380d1858bb8c8feeb008276c680d68d7ba...f6490541d0bb400aec87064ead946dfc52309274,5,251,76,327,28,2014-08-20 21:09:24,2014-08-19 22:26:21
f6490541d0bb400aec87064ead946dfc52309274...09a639ccacd8ead858beb34dad32b4348cf2d030,1,4,2,6,1,2014-08-20 21:13:44,2014-08-19 01:36:00
09a639ccacd8ead858beb34dad32b4348cf2d030...351523db3169a6c5e2df96f83eacea31978bea3d,2,46,2,48,3,2014-08-20 21:43:19,2014-08-19 19:06:31
351523db3169a6c5e2df96f83eacea31978bea3d...2d5d662a834fab72ee1431e3bb0a5ed5a0826177,6,32,25,57,12,2014-08-20 21:43:20,2014-08-19 19:07:11
2d5d662a834fab72ee1431e3bb0a5ed5a0826177...9998efd1b20de152ae098f69714e1578ae92a5ca,1,4,3,7,4,2014-08-20 21:43:22,2014-08-19 19:28:21
9998efd1b20de152ae098f69714e1578ae92a5ca...d35c9ee22833c2965ad5391d657dc38e96de20f4,1,1,1,2,1,2014-08-20 22:10:32,2014-08-20 22:10:32
d35c9ee22833c2965ad5391d657dc38e96de20f4...6cd4941a088d9fd378012dfdd7269788b57e58eb,2,50,50,100,7,2014-08-21 14:18:04,2014-08-21 14:18:04
6cd4941a088d9fd378012dfdd7269788b57e58eb...0dcc9c14f5d8f0f26c174676fa770b18f4aa122c,3071,0,619562,619562,3071,2014-08-21 15:47:14,2014-08-21 15:47:14
0dcc9c14f5d8f0f26c174676fa770b18f4aa122c...038b606d16d20055154697eca3e81caa6a2f229d,15,191,182,373,38,2014-08-21 18:06:59,2014-08-20 22:17:07
038b606d16d20055154697eca3e81caa6a2f229d...ec9576707a7c54abc53dfb75bea3c7c502b6a2d3,2,75,79,154,19,2014-08-21 18:11:01,2014-08-14 16:55:13
ec9576707a7c54abc53dfb75bea3c7c502b6a2d3...4cdeada1cc17bdf3fec7b39b2ec66faf8b84054d,2,75,46,121,5,2014-08-21 20:12:46,2014-08-07 16:30:47
4cdeada1cc17bdf3fec7b39b2ec66faf8b84054d...528ddd163be6d93f839d57cd068bd17ab55440cd,26,453,604,1057,81,2014-08-21 20:21:49,2014-08-12 18:29:11
528ddd163be6d93f839d57cd068bd17ab55440cd...11abe6693bf9cd070ae8ac050396212f73397956,10,84,18,102,22,2014-08-21 21:04:20,2014-08-20 20:09:14
11abe6693bf9cd070ae8ac050396212f73397956...c2288ce0733566fc3717479beed2ace68d6111a1,2,2,2,4,2,2014-08-21 21:04:20,2014-08-21 16:15:25
c2288ce0733566fc3717479beed2ace68d6111a1...660e7a020ed7d497efbc6d8ef81089efdc4fce09,6,233,46,279,28,2014-08-21 21:36:04,2014-08-13 14:50:16
660e7a020ed7d497efbc6d8ef81089efdc4fce09...540fabf4d093044f1df23b21740059e2b6e00bb6,7,74,39,113,34,2014-08-21 21:36:04,2014-08-18 13:29:27
540fabf4d093044f1df23b21740059e2b6e00bb6...60130db1dd4bf08138200041fa0403b2e2d90b9c,5,21,1,22,9,2014-08-21 21:36:56,2014-08-18 15:52:18
60130db1dd4bf08138200041fa0403b2e2d90b9c...2bf24b1bd81ee6739acbe088455db26a2cdb0cb5,2,27,32,59,11,2014-08-21 23:51:39,2014-08-21 19:33:10
2bf24b1bd81ee6739acbe088455db26a2cdb0cb5...20689033eb7f0350902b191d432ed9ae6a8e2677,2,61,59,120,9,2014-08-22 15:28:47,2014-08-21 23:29:06
20689033eb7f0350902b191d432ed9ae6a8e2677...a31db51d525fab001ac9b213cfc4a96b23ae7c16,8,151,39,190,42,2014-08-22 15:57:44,2014-08-21 19:46:16
a31db51d525fab001ac9b213cfc4a96b23ae7c16...4752092258fd5868147b8cece636d2fd41c79305,1,8,1,9,2,2014-08-22 17:45:20,2014-08-19 21:54:49
4752092258fd5868147b8cece636d2fd41c79305...f7d36a2f36f0239806b173f02f2ce8c5d4c453df,1,7,2,9,2,2014-08-22 18:07:08,2014-08-22 18:07:08
f7d36a2f36f0239806b173f02f2ce8c5d4c453df...6792a5035e18f23ebb4d2eb958a84953fcdb9ee1,1,1,1,2,1,2014-08-22 18:09:10,2014-08-22 17:42:21
6792a5035e18f23ebb4d2eb958a84953fcdb9ee1...8dd902ab53e340aac9cf570f4b3c42f139694707,2,34,2,36,6,2014-08-22 18:27:06,2014-08-21 18:53:12
8dd902ab53e340aac9cf570f4b3c42f139694707...f59224f64a5d48e7abf69cf681c33319a162b82f,23,37,2698,2735,35,2014-08-23 03:07:34,2014-08-22 17:42:27
f59224f64a5d48e7abf69cf681c33319a162b82f...c40a73d76c1c27a74b9cbf44db49a93008bb6624,1,35,13,48,3,2014-08-23 14:47:07,2014-08-22 19:37:54
c40a73d76c1c27a74b9cbf44db49a93008bb6624...2c510c5c06b4e557efb680d57694d24f1c028464,3,47,14,61,6,2014-08-25 00:55:41,2014-08-25 00:54:54
2c510c5c06b4e557efb680d57694d24f1c028464...13742a5b310a238fc1bf639b130202d5262ec443,3,197,174,371,38,2014-08-25 12:22:02,2014-08-21 22:01:13
13742a5b310a238fc1bf639b130202d5262ec443...d720d0f759aa3183e5f5677abfbd009e578d31b8,8,151,63,214,32,2014-08-25 12:22:02,2014-08-21 22:59:37
d720d0f759aa3183e5f5677abfbd009e578d31b8...3913d118f4cb0296dda50b8ba52e4c9f21583be9,6,368,51,419,38,2014-08-25 14:31:02,2014-08-22 00:11:44
3913d118f4cb0296dda50b8ba52e4c9f21583be9...735b528437eb4042dcc92f2d8f2a55c30176b5d0,1,16,3,19,2,2014-08-25 16:06:53,2014-08-22 21:07:38
735b528437eb4042dcc92f2d8f2a55c30176b5d0...1243bf4edfa8c3b184b8fca1b7feb863c45e96dd,2,21,2,23,4,2014-08-25 17:35:39,2014-08-22 20:44:01
1243bf4edfa8c3b184b8fca1b7feb863c45e96dd...15a025f43ff3b038c17fce40b7d0802a58ab4e3b,2,41,13,54,4,2014-08-25 18:10:38,2014-08-21 02:16:00
15a025f43ff3b038c17fce40b7d0802a58ab4e3b...7cc768b403b9bec0c26afe9ad3c56034b6638961,1,6,1,7,2,2014-08-25 13:26:27,2014-08-25 10:24:43
7cc768b403b9bec0c26afe9ad3c56034b6638961...8e0a7c273bf6ef02425fd406e6ac182bb716cc79,1,4,2,6,1,2014-08-25 18:44:56,2014-08-25 18:44:56
8e0a7c273bf6ef02425fd406e6ac182bb716cc79...d1767c999d4371fc1aa1eb85f5f8b58c0b5f4848,2,38,6,44,7,2014-08-25 19:08:22,2014-08-22 14:13:25
d1767c999d4371fc1aa1eb85f5f8b58c0b5f4848...4f5580004184c576f7ad5c1ea738c73681cd4e48,2,6,38,44,7,2014-08-25 19:25:37,2014-08-25 19:25:37
4f5580004184c576f7ad5c1ea738c73681cd4e48...a9f9040c76e2927aa801728578b86541336c2fa2,2,42,6,48,6,2014-08-25 19:31:44,2014-08-25 19:27:43
a9f9040c76e2927aa801728578b86541336c2fa2...eacc825ccae11f81a3d06513ceced054b9562ef6,7,1853,9,1862,18,2014-08-25 20:58:57,2014-08-22 14:14:24
eacc825ccae11f81a3d06513ceced054b9562ef6...052175eb9e0b793de19575fea37a7fdd95126a50,11,393,603,996,119,2014-08-25 20:58:58,2014-08-13 18:53:12
052175eb9e0b793de19575fea37a7fdd95126a50...4e2b90f5d94b2b7194a67f6e7ca766f42c96eddd,9,162,16,178,30,2014-08-25 21:14:59,2014-08-21 23:16:47
4e2b90f5d94b2b7194a67f6e7ca766f42c96eddd...4dbd43172c39e13bae5a301c4cdfbeaf4c77b0e8,4,255,72,327,20,2014-08-25 21:14:59,2014-08-22 19:12:16
4dbd43172c39e13bae5a301c4cdfbeaf4c77b0e8...cb3f5cfa43d9565675d2f36c4b0f7cecbad47a49,2,68,51,119,19,2014-08-25 21:14:59,2014-08-22 19:57:17
cb3f5cfa43d9565675d2f36c4b0f7cecbad47a49...f0bb5123f50bb617eb9499539f01779c6e9f5e95,143,1274,975,2249,766,2014-08-25 22:08:37,2014-08-25 21:25:39
f0bb5123f50bb617eb9499539f01779c6e9f5e95...4a31c97cd94f3767e206345b14f1bf7e1a661125,1,2,1,3,1,2014-08-26 01:36:18,2014-08-26 01:36:18
4a31c97cd94f3767e206345b14f1bf7e1a661125...c1901441f0e9c73d5457d3169145fb55a65c7307,1,11,52,63,7,2014-08-26 12:20:27,2014-08-11 18:29:32
c1901441f0e9c73d5457d3169145fb55a65c7307...a28db8f1c7d86ebb0eed1680ec3e2b4db7a57c4e,6,0,60,60,11,2014-08-26 15:01:49,2014-08-22 18:29:59
a28db8f1c7d86ebb0eed1680ec3e2b4db7a57c4e...ab45fd3e0c3ea06a5c093e826862618ae3b6205a,1,4,0,4,2,2014-08-26 15:08:10,2014-08-26 13:06:55
ab45fd3e0c3ea06a5c093e826862618ae3b6205a...7b1fb9c442e6c97df18d0ecba47a21adaaf1d65b,7,1152,0,1152,8,2014-08-26 15:42:16,2014-08-25 17:47:50
7b1fb9c442e6c97df18d0ecba47a21adaaf1d65b...2c403aab664bb25704d984c48583d80701a5267b,18,247,101,348,45,2014-08-26 16:03:27,2014-08-22 18:31:33
2c403aab664bb25704d984c48583d80701a5267b...7fd6a30edd7c3406de3712d14ad395784c478a45,4,19,5,24,8,2014-08-26 16:14:14,2014-08-26 15:53:44
7fd6a30edd7c3406de3712d14ad395784c478a45...dcd1540dd9149702dee70f5f9536f03ed49685eb,1,1,1,2,1,2014-08-26 17:15:14,2014-08-26 17:15:14
dcd1540dd9149702dee70f5f9536f03ed49685eb...3a0cd3faae366127d1a8f2099bdcd902bc18d0a1,12,147,152,299,40,2014-08-26 17:55:14,2014-08-13 23:17:42
3a0cd3faae366127d1a8f2099bdcd902bc18d0a1...f055e0f661c44b4f73d0b901cbf1dc0de0d303db,3,36,45,81,28,2014-08-26 18:01:43,2014-08-21 15:35:43
f055e0f661c44b4f73d0b901cbf1dc0de0d303db...90d025ab9387d08cbb6b2bf369358653ae8977be,1,6,0,6,2,2014-08-26 18:01:51,2014-08-22 00:40:23
90d025ab9387d08cbb6b2bf369358653ae8977be...0f0e24f5dce718bd1d54f7ca3762d3f4cb13db2f,5,241,34,275,19,2014-08-26 19:46:26,2014-08-25 15:32:27
0f0e24f5dce718bd1d54f7ca3762d3f4cb13db2f...522347375e6859b9dbafdc4f0bbdd462f98321fa,2,3,1,4,3,2014-08-26 20:46:17,2014-08-26 20:36:50
522347375e6859b9dbafdc4f0bbdd462f98321fa...afbdd2b7f5944b57d5fd1f597f67aa32883043ba,2,1,3,4,3,2014-08-26 22:56:01,2014-08-26 22:56:01
afbdd2b7f5944b57d5fd1f597f67aa32883043ba...c1cfdabdf0ed0fd2abfa24faa243b9d4a00a987c,2,120,0,120,2,2014-08-27 12:44:12,2014-08-26 19:37:08
c1cfdabdf0ed0fd2abfa24faa243b9d4a00a987c...ec34e244f6e12780eba72fe83b3d21b08c1355aa,1,1,1,2,1,2014-08-27 08:47:41,2014-08-26 09:25:05
ec34e244f6e12780eba72fe83b3d21b08c1355aa...32643343be6e0100a887dae4a44d33f710dfd086,1,9,1,10,1,2014-08-27 08:47:42,2014-08-26 09:35:16
32643343be6e0100a887dae4a44d33f710dfd086...c069fc13a91204940c82a90f7c2c2f09b80c3428,7,30,124,154,11,2014-08-27 14:49:14,2014-08-26 21:58:00
c069fc13a91204940c82a90f7c2c2f09b80c3428...155d994c632e4f0498bd592e9b18e09eeda6a030,2,2,2,4,2,2014-08-27 14:59:33,2014-08-27 14:56:27
155d994c632e4f0498bd592e9b18e09eeda6a030...a9cd3f0964e4cec1efd3360d2fbaffae495737c0,1,1,1,2,1,2014-08-27 15:47:23,2014-08-27 15:47:12
a9cd3f0964e4cec1efd3360d2fbaffae495737c0...ee60916e5f79471304e8fd15d6c5e9faa2e1a149,3,36,0,36,4,2014-08-27 15:58:06,2014-08-21 22:04:33
ee60916e5f79471304e8fd15d6c5e9faa2e1a149...312aa1b308c775e3bafec3ac1570f5c195956dbd,4,117,23,140,6,2014-08-27 22:26:24,2014-08-27 21:59:09
312aa1b308c775e3bafec3ac1570f5c195956dbd...4b3e0275c35e53505542c675bd2ef4a5e8a5a4da,3,29,4,33,10,2014-08-28 03:06:29,2014-08-27 00:31:31
4b3e0275c35e53505542c675bd2ef4a5e8a5a4da...18dba6ed5bbe0d0177a81cbe660dcd93fcf18109,2,3,3,6,2,2014-08-28 13:49:12,2014-08-27 19:00:43
18dba6ed5bbe0d0177a81cbe660dcd93fcf18109...6e90ddf91fdbbc578e499fcb736365498e47f55a,2,22,17,39,7,2014-08-28 14:28:14,2014-08-21 21:19:57
6e90ddf91fdbbc578e499fcb736365498e47f55a...caf2557cbefcf3d129d9a6c3a1a9b649dfdef82f,3,9,3,12,5,2014-08-28 15:24:49,2014-08-27 16:20:56
caf2557cbefcf3d129d9a6c3a1a9b649dfdef82f...1d46ac81bb65d8065f7667103d25abcef6fbf897,1,1,1,2,1,2014-08-28 16:02:22,2014-08-28 14:09:46
1d46ac81bb65d8065f7667103d25abcef6fbf897...1760e651f2c4ed5b26e37a54de8b0d42f6cf8616,2,23,0,23,2,2014-08-28 16:10:13,2014-08-25 18:31:31
1760e651f2c4ed5b26e37a54de8b0d42f6cf8616...ab5de8df2d7a9aa220fc138ce8fa16fbc519af7e,6,22,51,73,28,2014-08-28 16:10:43,2014-08-26 22:41:14
ab5de8df2d7a9aa220fc138ce8fa16fbc519af7e...3e5da05ed36c38eb9b13b5d6c81bb390273abf25,6,31,16,47,19,2014-08-28 16:11:21,2014-08-27 20:56:16
3e5da05ed36c38eb9b13b5d6c81bb390273abf25...ca6a26760c2150736562f49201fcb7b4de5e53f1,5,310,66,376,29,2014-08-28 16:46:17,2014-08-25 15:33:33
ca6a26760c2150736562f49201fcb7b4de5e53f1...e6a8e256ca73e7596d9f8b7b3a3b00d8c08f6554,16,1797,45,1842,27,2014-08-28 17:20:25,2014-08-13 16:10:38
e6a8e256ca73e7596d9f8b7b3a3b00d8c08f6554...6250f6da8b0713759a402caef66c110822361390,1,1,1,2,1,2014-08-28 17:42:44,2014-08-28 17:42:44
6250f6da8b0713759a402caef66c110822361390...ac6b4eac9d1fc33d357ee9264e4508f8a564d89d,2,37,4,41,4,2014-08-28 17:44:47,2014-08-27 18:43:25
ac6b4eac9d1fc33d357ee9264e4508f8a564d89d...86be883456bddff9ce3c283c9d740e70d62eb22f,5,276,36,312,41,2014-08-28 18:22:56,2014-08-27 22:34:27
86be883456bddff9ce3c283c9d740e70d62eb22f...b76ab679c9fa567f1b26638c9f0415dc94917393,1,3,1,4,1,2014-08-28 18:48:40,2014-08-28 15:39:48
b76ab679c9fa567f1b26638c9f0415dc94917393...6f2e6b46bf9c0b8b6042c821a56edf8968c24f4b,21,61,44,105,34,2014-08-28 19:15:29,2014-08-27 15:20:59
6f2e6b46bf9c0b8b6042c821a56edf8968c24f4b...3af53b365e5fd67df35134f4190202b4f0c4c6a0,7,24,15,39,13,2014-08-28 19:15:30,2014-08-28 18:00:43
3af53b365e5fd67df35134f4190202b4f0c4c6a0...8b96732280e4a4ea445d564e051318e2a6dafca5,14,99,546,645,65,2014-08-28 19:26:46,2014-07-31 18:56:54
8b96732280e4a4ea445d564e051318e2a6dafca5...2d9013370b27c86a253cefd1f99f828d18484fc5,29,87,144,231,32,2014-08-28 19:26:46,2014-08-27 17:04:29
2d9013370b27c86a253cefd1f99f828d18484fc5...4ae7190ecc4a24f271e6be134c951335500b4f6f,6,319,123,442,10,2014-08-28 19:38:18,2014-08-28 19:28:26
4ae7190ecc4a24f271e6be134c951335500b4f6f...a464e00424995fcc696750d84b931f466b656911,8,30,22,52,20,2014-08-28 19:42:42,2014-08-27 22:42:46
a464e00424995fcc696750d84b931f466b656911...d2a83bba7da59ec601ec37617ce0d7ea7e2b79ac,2,9,5,14,5,2014-08-28 19:42:42,2014-08-28 17:34:24
d2a83bba7da59ec601ec37617ce0d7ea7e2b79ac...807f8b61127670c57ed65ffa5bc9ccafed4f26d3,1,2,1,3,1,2014-08-28 19:48:17,2014-08-28 19:47:50
807f8b61127670c57ed65ffa5bc9ccafed4f26d3...68f84244953ed2ade6a00d61baf3f70d51f0d890,2,2,0,2,2,2014-08-28 19:50:53,2014-08-28 19:50:53
68f84244953ed2ade6a00d61baf3f70d51f0d890...60d77fd541a1748f16ced5b790fa979633c325df,3,1,34,35,5,2014-08-28 20:01:48,2014-08-27 16:51:53
60d77fd541a1748f16ced5b790fa979633c325df...bd50249db427f9dd5a0dcaa3b3fc0b139e108173,2,9,1,10,5,2014-08-28 20:19:35,2014-08-28 19:33:27
bd50249db427f9dd5a0dcaa3b3fc0b139e108173...b6a90b9ac8045665e5ba9024842493b1dce10fc7,3,47,25,72,9,2014-08-28 20:44:15,2014-08-25 19:34:54
b6a90b9ac8045665e5ba9024842493b1dce10fc7...a4bb7f82119a113eba450d82be7b7aad89886562,1,10,1,11,6,2014-08-28 20:44:15,2014-08-25 20:06:46
a4bb7f82119a113eba450d82be7b7aad89886562...87702f82174828817ce7128abd0a5df65ec6abd5,2,32,29,61,15,2014-08-28 20:44:15,2014-08-25 21:58:44
87702f82174828817ce7128abd0a5df65ec6abd5...5486963a3549b69190a2e3adc584db312111abaf,1,9,0,9,4,2014-08-28 20:44:15,2014-08-20 18:24:35
5486963a3549b69190a2e3adc584db312111abaf...b365799cde89ffcb255d1950057298f6f724d0c8,3,204,21,225,8,2014-08-29 12:59:36,2014-08-26 16:46:57
b365799cde89ffcb255d1950057298f6f724d0c8...6e98f5003ff06369aec221c9c9dda264d4dee013,1,2,2,4,2,2014-08-29 13:10:33,2014-08-28 21:42:48
6e98f5003ff06369aec221c9c9dda264d4dee013...9144f84e621f5e1ffde55579851180be5f8653ab,3,52,17,69,17,2014-08-29 14:49:54,2014-08-29 14:31:12
9144f84e621f5e1ffde55579851180be5f8653ab...69397200432a6cf33890e00f7e50039f3b82b6df,3,17,52,69,17,2014-08-29 15:19:23,2014-08-29 15:17:47
69397200432a6cf33890e00f7e50039f3b82b6df...9046897f16454fe70da150ef222443e7aa3482c4,13,31,43,74,26,2014-08-29 15:57:36,2014-08-27 21:33:49
9046897f16454fe70da150ef222443e7aa3482c4...3029d69baa13c229b85f3f18a161f892d15c69b5,2,18,14,32,7,2014-08-29 15:57:36,2014-08-27 22:22:26
3029d69baa13c229b85f3f18a161f892d15c69b5...eca928dd6fdbca3b5a4e773af8f48333fee39409,11,86,39,125,21,2014-08-29 15:57:36,2014-08-27 19:21:16
eca928dd6fdbca3b5a4e773af8f48333fee39409...b983d2b0858507009c1ef1589853cf9aec8dba33,3,56,4,60,9,2014-08-29 17:49:08,2014-08-12 15:16:25
b983d2b0858507009c1ef1589853cf9aec8dba33...29184d73866ba86a3893ae559a12da0d10de51fe,1,34,42,76,19,2014-08-29 14:24:54,2014-08-25 13:19:11
29184d73866ba86a3893ae559a12da0d10de51fe...966a1078a716694fd7e58892441546e7b1f5ce6b,3,343,40,383,38,2014-08-29 14:24:54,2014-08-26 09:23:35
966a1078a716694fd7e58892441546e7b1f5ce6b...4763ed8e758149413b214f3788cb053589ab76c5,15,586,146,732,71,2014-08-29 19:34:34,2014-08-26 18:04:52
4763ed8e758149413b214f3788cb053589ab76c5...746e8835b0b841235b767628d6ae0382a85bdab0,1,2,2,4,2,2014-08-29 20:30:53,2014-08-29 20:30:34
746e8835b0b841235b767628d6ae0382a85bdab0...0fbd416c565ec4af11990e64cab887af12fbf76f,7,21,19,40,19,2014-08-29 21:17:00,2014-08-29 20:34:24
0fbd416c565ec4af11990e64cab887af12fbf76f...9a770ca1ce8d5c7fcad7efffe562abaa8dd4b138,5,8,25,33,9,2014-08-29 21:17:00,2014-08-29 21:16:55
9a770ca1ce8d5c7fcad7efffe562abaa8dd4b138...166b061a60bd3399e60009934e1898e6006f4004,1,5,1,6,1,2014-08-30 12:13:13,2014-08-29 20:52:58
166b061a60bd3399e60009934e1898e6006f4004...79626bc249484368fe4d9369ec52f7df70e6a726,1,1,1,2,1,2014-08-30 12:13:13,2014-08-29 20:55:03
79626bc249484368fe4d9369ec52f7df70e6a726...c5b1069297319a2eec066d56976edb698bec1e47,1,81,1,82,2,2014-09-02 08:39:57,2014-08-26 15:17:16
c5b1069297319a2eec066d56976edb698bec1e47...f8f07097e3e09891dd443baa94660b84b3991b76,1,5,1,6,2,2014-09-02 08:39:57,2014-08-26 16:54:18
f8f07097e3e09891dd443baa94660b84b3991b76...2f8c54f26c50bb65a0361b9b858e800eab020de0,1,88,0,88,1,2014-09-02 08:39:57,2014-08-26 16:55:09
2f8c54f26c50bb65a0361b9b858e800eab020de0...da2b649e755ba903e8b38ffb9cf24f3769bcb319,1,3,2,5,2,2014-09-02 15:19:43,2014-09-02 13:53:17
da2b649e755ba903e8b38ffb9cf24f3769bcb319...5181c39ebe970ef8053c70e7c283510d8ed2f41a,1,2,2,4,2,2014-09-02 15:45:36,2014-09-02 15:45:36
5181c39ebe970ef8053c70e7c283510d8ed2f41a...097039445a16436ee0e992b1613c7b0b6b269a2d,1,7,2,9,4,2014-09-02 15:49:07,2014-09-02 15:49:07
097039445a16436ee0e992b1613c7b0b6b269a2d...2f7fce0df9e48b804ff560bccd469e2fcad2325f,17,481,40,521,38,2014-09-02 19:38:51,2014-08-27 17:35:30
2f7fce0df9e48b804ff560bccd469e2fcad2325f...65be70d436feaff4de13f3508e5115eccc14056f,1,0,3,3,1,2014-09-02 20:40:03,2014-09-02 20:40:03
65be70d436feaff4de13f3508e5115eccc14056f...d17d9ed8cddedca193504729d6c7729a0bfa27bc,7,763,138,901,73,2014-09-02 21:15:16,2014-09-02 16:01:30
d17d9ed8cddedca193504729d6c7729a0bfa27bc...e109345e7e900355b553a898381772bb7b1bd1e0,2,50,46,96,30,2014-09-02 21:18:56,2014-09-02 19:51:19
e109345e7e900355b553a898381772bb7b1bd1e0...6bf17f12e3fde9bee14d2bb9c90001080546f867,1,3,4,7,2,2014-09-02 22:19:06,2014-08-29 19:18:38
6bf17f12e3fde9bee14d2bb9c90001080546f867...391b1121e36fd85d7e85c4442dccf8367e6da770,137,1161,3426,4587,438,2014-09-03 13:46:33,2014-08-27 19:36:08
391b1121e36fd85d7e85c4442dccf8367e6da770...0353f6b389b4cdae93bc34f8c5933431fb46f250,2,19,1,20,3,2014-09-03 14:08:39,2014-09-03 13:21:17
0353f6b389b4cdae93bc34f8c5933431fb46f250...aac8ba84d8fac7dc531a03c63224fdfc8cd3baa3,2,66,0,66,2,2014-09-03 14:10:21,2014-08-27 14:09:04
aac8ba84d8fac7dc531a03c63224fdfc8cd3baa3...477429055ed16135cb38b236a21f2460acff9979,2,2,4,6,4,2014-09-03 14:24:23,2014-09-03 01:00:39
477429055ed16135cb38b236a21f2460acff9979...5d05a2b0767f2f6122ee509678e0df3fa36f94a7,1,1,1,2,1,2014-09-03 15:25:20,2014-08-29 19:53:49
5d05a2b0767f2f6122ee509678e0df3fa36f94a7...a39b938918e09bda67ea9e516101f43b9ef25a51,9,26,427,453,35,2014-09-03 16:13:12,2014-08-29 16:59:13
a39b938918e09bda67ea9e516101f43b9ef25a51...e53157779c08fc5f851bd17440d65cf596ba1f14,1,4,0,4,1,2014-09-03 19:26:03,2014-09-02 22:11:54
e53157779c08fc5f851bd17440d65cf596ba1f14...7dfafabcca497df8e460fb19acd6d06c0de634e3,1,0,23,23,1,2014-09-03 19:36:36,2014-09-03 19:36:36
7dfafabcca497df8e460fb19acd6d06c0de634e3...5c7bc01c21eca31946f476c22e83714f74e4c375,1,15,13,28,1,2014-09-04 02:30:03,2014-09-03 01:07:09
5c7bc01c21eca31946f476c22e83714f74e4c375...fe54163535b0a2ba47f9dfdc6caf6575be9cd899,1,150,0,150,1,2014-09-03 15:44:43,2014-08-20 21:38:21
fe54163535b0a2ba47f9dfdc6caf6575be9cd899...d70194786886cea722d316d07122c71e3403a801,4,45,21,66,24,2014-09-03 15:44:43,2014-08-20 21:17:06
d70194786886cea722d316d07122c71e3403a801...1618aca99b214b96aa71be433876cb90ef5bba8b,5,20,20,40,10,2014-09-03 15:44:43,2014-08-21 20:57:35
1618aca99b214b96aa71be433876cb90ef5bba8b...033b09c3123669081f980e73f0ea7c24dc6a2aa3,1,1,1,2,1,2014-09-03 15:44:43,2014-08-22 19:44:25
033b09c3123669081f980e73f0ea7c24dc6a2aa3...6a6b3550c9a5c40f8a522b7e1a0bc175990fd076,1,18,12,30,12,2014-09-04 12:42:32,2014-09-04 12:42:00
6a6b3550c9a5c40f8a522b7e1a0bc175990fd076...64a8b31e49f9a9889aca84790a75a3c452f2353d,2,722,0,722,2,2014-09-04 12:42:32,2014-09-04 12:42:20
64a8b31e49f9a9889aca84790a75a3c452f2353d...10314282f5a097745f2b6dcf672833606e3a8911,10,38,30,68,30,2014-09-04 12:54:37,2014-09-02 17:03:31
10314282f5a097745f2b6dcf672833606e3a8911...86f017917aac53e1adfe991fc21a08416c84d990,2,33,23,56,6,2014-09-04 18:17:27,2014-09-04 01:38:38
86f017917aac53e1adfe991fc21a08416c84d990...c14c1f113d56da4e32ac13a123028c916f0c8cff,11,567,326,893,36,2014-09-04 18:54:11,2014-08-29 17:10:29
c14c1f113d56da4e32ac13a123028c916f0c8cff...722b37791dc3adececd74894ccb61e3da64ea94e,20,65,99,164,75,2014-09-04 19:31:53,2014-08-26 20:55:17
722b37791dc3adececd74894ccb61e3da64ea94e...521a6fffc689322ed2e5a0356d39da4301c93259,1,2,4,6,2,2014-09-04 22:10:24,2014-09-04 22:10:24
521a6fffc689322ed2e5a0356d39da4301c93259...f258721ea54fcd9746f7070ca1f467a8f92b8b83,5,88,38,126,20,2014-09-05 01:52:14,2014-08-25 22:17:22
f258721ea54fcd9746f7070ca1f467a8f92b8b83...a6b9d6deea3cebc29603f22d29a2e79807ca4dc0,13,14,71,85,20,2014-09-05 12:17:31,2014-09-03 21:14:22
a6b9d6deea3cebc29603f22d29a2e79807ca4dc0...c175aede88469969320d4935f3b2afb5a07cd4fc,15,182,86,268,26,2014-09-05 15:25:05,2014-08-26 22:10:05
c175aede88469969320d4935f3b2afb5a07cd4fc...51fbe5568f0b76fda292a9864f65299df77b61fa,3,76,5,81,9,2014-09-05 16:54:30,2014-09-05 15:04:55
51fbe5568f0b76fda292a9864f65299df77b61fa...a8828ca2f6d50eb9f183e3bc5d317a7e356083c7,7,7,7,14,7,2014-09-05 19:23:33,2014-09-05 19:23:33
a8828ca2f6d50eb9f183e3bc5d317a7e356083c7...f7c4d34ddb4a88480a1091d1c39e9db450c2d244,7,7,7,14,7,2014-09-05 19:24:17,2014-09-05 19:24:17
f7c4d34ddb4a88480a1091d1c39e9db450c2d244...4ce061a127e9f1fb1d31fbaeb64d1179a319316c,9,59,123,182,26,2014-09-05 19:39:25,2014-09-05 17:50:07
4ce061a127e9f1fb1d31fbaeb64d1179a319316c...d8ceb704b519a0dbd006d0b16bac93e258ce0526,1,177,5,182,4,2014-09-05 14:39:31,2014-09-03 14:14:31
d8ceb704b519a0dbd006d0b16bac93e258ce0526...795b908290794af543f838cd08a04c4871a54c83,1,792,0,792,3,2014-09-05 14:39:31,2014-09-03 14:14:38
795b908290794af543f838cd08a04c4871a54c83...9e4b2e503b907836f099fb3ee239e00317e0a01b,7,99,37,136,7,2014-09-05 14:39:31,2014-09-04 13:58:51
9e4b2e503b907836f099fb3ee239e00317e0a01b...4f7344088e603ae9e09c4edeabaa7930a3722dc4,1,4,3,7,1,2014-09-05 19:52:41,2014-09-02 18:08:29
4f7344088e603ae9e09c4edeabaa7930a3722dc4...3e3732abb5306c881fd6d210e0e7d3c55bdb9c1d,4,96,20,116,17,2014-09-05 20:12:41,2014-08-28 00:10:43
3e3732abb5306c881fd6d210e0e7d3c55bdb9c1d...22b33f7f67cbe1cbfe0c2eda7f0f42c91e690141,7,396,205,601,78,2014-09-05 20:33:19,2014-09-04 20:11:05
22b33f7f67cbe1cbfe0c2eda7f0f42c91e690141...823486e53a8160d20de06403228bb2c71fb127e1,9,330,196,526,75,2014-09-05 20:56:49,2014-09-05 19:26:17
823486e53a8160d20de06403228bb2c71fb127e1...70fe0aa5dcd4058cb4d4bcff224e853ea92bf74a,1,2,2,4,2,2014-09-05 21:24:28,2014-09-05 21:24:28
70fe0aa5dcd4058cb4d4bcff224e853ea92bf74a...4e8a57ccaba7e2635e0b553a8d96566f5d0f18a6,11,101,121,222,31,2014-09-05 21:31:09,2014-09-04 21:42:48
4e8a57ccaba7e2635e0b553a8d96566f5d0f18a6...5e97d1e186374cc0d9fc9de605eec39796d885cf,3,53,17,70,17,2014-09-05 22:27:10,2014-09-05 22:27:10
5e97d1e186374cc0d9fc9de605eec39796d885cf...ce65b2c6197b87b6cfb2e32b4285d0114fff7101,1,1,1,2,1,2014-09-08 13:42:08,2014-09-06 00:15:46
ce65b2c6197b87b6cfb2e32b4285d0114fff7101...87fa4e16af935e1c9c870878898ce46eacdea4e4,1,1,6,7,1,2014-09-08 15:27:55,2014-08-29 17:18:36
87fa4e16af935e1c9c870878898ce46eacdea4e4...de8ad641914eeb56367d06fd465c17ad5e6a3e26,1,5,1,6,2,2014-09-08 17:26:56,2014-09-08 16:54:45
de8ad641914eeb56367d06fd465c17ad5e6a3e26...09878cb3cb2ec6224824b5ebcf8747413e3802e8,7,153,67,220,42,2014-09-08 21:44:20,2014-08-22 16:41:06
09878cb3cb2ec6224824b5ebcf8747413e3802e8...3c23add3707d5b0b08c4cf058c2e4963244eff4f,10,747,242,989,45,2014-09-09 00:30:18,2014-09-05 22:26:02
3c23add3707d5b0b08c4cf058c2e4963244eff4f...266b75ca868a95fd2a4e30e3cf4898de1e13698d,4,36,2,38,4,2014-09-09 00:30:18,2014-09-05 22:44:18
266b75ca868a95fd2a4e30e3cf4898de1e13698d...02f67073a00fe436ccadcf08438883423160ba3e,2,1,1,2,1,2014-09-09 13:46:07,2014-09-09 13:46:07
02f67073a00fe436ccadcf08438883423160ba3e...ab9b20d7dab355f16109a00e65934662f8fb1c78,1,3,0,3,1,2014-09-09 13:47:32,2014-09-09 13:47:32
ab9b20d7dab355f16109a00e65934662f8fb1c78...3a90e2c3e464b3d130a18f5c53d5d49dc1a9d48a,1,10,8,18,2,2014-09-09 13:47:53,2014-09-09 13:47:53
3a90e2c3e464b3d130a18f5c53d5d49dc1a9d48a...5e0edd481d158003b12bafb73db48221a2ade9c4,2,67,57,124,14,2014-09-09 13:48:17,2014-09-09 13:48:17
5e0edd481d158003b12bafb73db48221a2ade9c4...0288d14d9db98039202f7ce642f6d2d48f31db0d,1,44,0,44,2,2014-09-09 13:48:37,2014-09-09 13:48:37
0288d14d9db98039202f7ce642f6d2d48f31db0d...5395a12bf56f059f36a6216f3e33f557229df996,2,28,2,30,6,2014-09-09 13:48:49,2014-09-09 13:48:49
5395a12bf56f059f36a6216f3e33f557229df996...4da87914c4ad2b3ca34cd0008a57faa2c068db85,2,44,4,48,8,2014-09-09 09:24:25,2014-09-08 17:25:47
4da87914c4ad2b3ca34cd0008a57faa2c068db85...42d3aad3c7965204c571de91d0730c2cc36d1c37,2,605,671,1276,116,2014-09-09 11:41:27,2014-09-05 14:54:25
42d3aad3c7965204c571de91d0730c2cc36d1c37...fe1c74d2656b3609f529842a7c810034671ddea1,3,1,32,33,6,2014-09-09 11:41:27,2014-09-08 15:31:57
fe1c74d2656b3609f529842a7c810034671ddea1...da86d5ed4f14dbd05fa713b530759a11ab9b149c,25,246,126,372,162,2014-09-09 16:54:42,2014-08-29 16:49:19
da86d5ed4f14dbd05fa713b530759a11ab9b149c...618d0abe400d0e377691e2df5f1da77c7abf642a,3,4,4,8,4,2014-09-09 17:36:52,2014-09-09 16:58:14
618d0abe400d0e377691e2df5f1da77c7abf642a...69f202039823933c34ad444dd9d0cac5a66095b0,2,19,30,49,15,2014-09-09 19:18:18,2014-09-04 21:45:00
69f202039823933c34ad444dd9d0cac5a66095b0...13a652f0186d8aad3db620bd2e381d646e5c79a8,1,3,3,6,2,2014-09-09 19:33:04,2014-09-08 22:24:51
13a652f0186d8aad3db620bd2e381d646e5c79a8...795a9b5cfa69d414ccffce4e4835eff0aa6974f2,3,69,34,103,18,2014-09-09 19:50:58,2014-09-05 21:59:30
795a9b5cfa69d414ccffce4e4835eff0aa6974f2...e37df80e25f5f2cffa98c3b36b63974011096daa,13,99,60,159,40,2014-09-09 20:05:50,2014-09-09 14:07:05
e37df80e25f5f2cffa98c3b36b63974011096daa...c713597e919c39fe2b13cf0ea7aefb53f1291568,1,22,0,22,1,2014-09-09 21:05:43,2014-09-09 19:41:47
c713597e919c39fe2b13cf0ea7aefb53f1291568...69e509c06de65ae0cd49805841e3d6018ac6e6bc,1,10,3,13,2,2014-09-09 21:57:56,2014-09-02 17:04:43
69e509c06de65ae0cd49805841e3d6018ac6e6bc...77b11e686c873ea44e14e6f7419adb24d5f40106,1,40,24,64,9,2014-09-09 21:57:56,2014-09-02 21:19:33
77b11e686c873ea44e14e6f7419adb24d5f40106...aa5c0a136c9ab37023d89908c8b02d6d687ed070,2,16,14,30,8,2014-09-09 21:59:18,2014-09-02 23:07:42
aa5c0a136c9ab37023d89908c8b02d6d687ed070...92bf7260c3dda79abf9f6b2bdf9e7fb827f6743a,1,1,0,1,1,2014-09-09 21:59:25,2014-09-03 16:20:07
92bf7260c3dda79abf9f6b2bdf9e7fb827f6743a...621766db5fcc26cf4955ffd8d3733e99a41bb17f,1,23,0,23,3,2014-09-10 12:56:45,2014-09-04 17:54:16
621766db5fcc26cf4955ffd8d3733e99a41bb17f...05df4fe1e691fcc03369ce64ac6d177d50b7778d,18,726,325,1051,113,2014-09-10 13:31:59,2014-09-05 21:21:44
05df4fe1e691fcc03369ce64ac6d177d50b7778d...adfc53c325d95826940a60891b11a2199aca4735,7,261,197,458,29,2014-09-10 13:32:47,2014-09-09 21:54:39
adfc53c325d95826940a60891b11a2199aca4735...ee28d3ffccd790b16675c3a09644661863965a0c,1,1,1,2,1,2014-09-10 13:34:11,2014-09-10 13:34:11
ee28d3ffccd790b16675c3a09644661863965a0c...353dcccd714fdb3ce872853b0600a0b667267ae6,1,24,40,64,9,2014-09-10 15:12:27,2014-09-10 15:12:27
353dcccd714fdb3ce872853b0600a0b667267ae6...d71566a55ebbe76ee7f40fd3f2a2a8cd486b0d16,18,925,457,1382,142,2014-09-10 19:21:13,2014-09-04 19:57:47
d71566a55ebbe76ee7f40fd3f2a2a8cd486b0d16...2bae1279afcab72bd20967d65c8e350f8c2cffb9,4,331,190,521,77,2014-09-10 20:19:11,2014-09-08 18:31:23
2bae1279afcab72bd20967d65c8e350f8c2cffb9...ac611b47d4f9edc7a576e52735a0edf0bde9f989,20,826,100,926,83,2014-09-10 20:45:02,2014-09-09 20:28:26
ac611b47d4f9edc7a576e52735a0edf0bde9f989...e1c24123e023b47d8b279f77ba00cbf61e5a1347,1,5,1,6,1,2014-09-10 21:29:00,2014-09-10 21:29:00
e1c24123e023b47d8b279f77ba00cbf61e5a1347...e27b158000b01fe4c505961fefe5a77efbfe8a3e,2,14,2,16,2,2014-09-11 14:19:42,2014-09-10 19:47:51
e27b158000b01fe4c505961fefe5a77efbfe8a3e...ce1b3133897aa1f396a1630413d39a3ce8b026de,2,3,3,6,3,2014-09-11 16:51:33,2014-09-11 16:51:33
ce1b3133897aa1f396a1630413d39a3ce8b026de...3e5710a29505883143feb0b0883321830c989820,3,91,94,185,46,2014-09-11 17:10:12,2014-09-09 17:43:55
3e5710a29505883143feb0b0883321830c989820...f5f42d6c684b8e779aef6889b800235d7417afcb,14,494,163,657,45,2014-09-11 19:18:48,2014-09-03 20:39:56
f5f42d6c684b8e779aef6889b800235d7417afcb...4c429ebe0a44521a293103c8e3b2fb90f14f056e,2,12,4,16,5,2014-09-11 20:02:49,2014-09-08 19:18:34
4c429ebe0a44521a293103c8e3b2fb90f14f056e...b47b91801021f5125fbcee07bf827b237ad1b4ee,30,412,285,697,167,2014-09-11 20:10:27,2014-09-11 15:12:52
b47b91801021f5125fbcee07bf827b237ad1b4ee...b6e5d1e2af49ebb2edfb6522ba744d344b73c4f6,1,3,2,5,1,2014-09-11 20:19:34,2014-09-11 20:19:34
b6e5d1e2af49ebb2edfb6522ba744d344b73c4f6...1a90996313ec83f0913bf2aef322193b0884f499,56,375,211,586,93,2014-09-11 20:21:29,2014-09-11 19:31:21
1a90996313ec83f0913bf2aef322193b0884f499...1c49822f7733bb67d33acb7f7675687a2e2248ba,1,1,1,2,1,2014-09-11 20:42:29,2014-09-11 20:42:02
1c49822f7733bb67d33acb7f7675687a2e2248ba...c082c215f671a7b8475d8407ed8f3c37e176e7ad,1,3,2,5,3,2014-09-11 21:00:34,2014-09-11 18:02:56
c082c215f671a7b8475d8407ed8f3c37e176e7ad...a47da32cea1c07e2e1c23fa16499017fc665a38d,7,137,38,175,16,2014-09-11 21:28:26,2014-09-10 19:18:25
a47da32cea1c07e2e1c23fa16499017fc665a38d...36a6b94c4d6e44b192da3059f6efe42fe4d82f50,1,2,0,2,1,2014-09-11 21:58:58,2014-09-11 21:48:01
36a6b94c4d6e44b192da3059f6efe42fe4d82f50...c9eab15c54d135dcf3357802402b1d8d2855b212,4,12,6,18,6,2014-09-11 23:19:53,2014-09-11 16:16:53
c9eab15c54d135dcf3357802402b1d8d2855b212...41fcb70192d773987cc9635d4f125b6afbf54e1f,4,94,239,333,10,2014-09-12 12:35:39,2014-09-09 12:01:12
41fcb70192d773987cc9635d4f125b6afbf54e1f...87252bb93d3ebd5bf4b456d3fc06b4bae763a958,1,1,1,2,1,2014-09-12 12:38:17,2014-09-12 12:38:17
87252bb93d3ebd5bf4b456d3fc06b4bae763a958...ce737ebed71bc4485180b86832e907d820858664,1,9,1,10,2,2014-09-12 14:00:51,2014-09-11 19:55:40
ce737ebed71bc4485180b86832e907d820858664...ff1ee391747092e2d03765402c6ab25ba7e1d538,15,336,74,410,65,2014-09-12 14:39:11,2014-09-08 15:37:42
ff1ee391747092e2d03765402c6ab25ba7e1d538...34d01ffe20704eb5504dc526c372d945555dd0e7,2,0,164,164,4,2014-09-12 16:06:48,2014-09-09 22:36:31
34d01ffe20704eb5504dc526c372d945555dd0e7...8e1f5beabfad09c790e46826e8b3c7dcc5070d8d,7,139,131,270,16,2014-09-12 16:06:48,2014-09-10 23:38:21
8e1f5beabfad09c790e46826e8b3c7dcc5070d8d...89ddd9477913e437a563faec872a397af801575d,1,6,0,6,2,2014-09-12 16:06:48,2014-09-09 20:24:15
89ddd9477913e437a563faec872a397af801575d...a2aff0106af5f8d5832b30bed5f761602ab169a9,2,15,1,16,7,2014-09-12 16:06:48,2014-09-09 19:42:23
a2aff0106af5f8d5832b30bed5f761602ab169a9...de87f1d96d26cb16a4e9044b7b1d35b09028ed5d,1,2,2,4,2,2014-09-12 16:35:02,2014-09-12 16:35:02
de87f1d96d26cb16a4e9044b7b1d35b09028ed5d...6e93b33179e71abce820e534b3d32f1e593f71ca,1,1,1,2,1,2014-09-12 16:53:44,2014-09-12 16:53:44
6e93b33179e71abce820e534b3d32f1e593f71ca...e079496c239748c95136458c85c23478ee609fdb,3,11,2,13,5,2014-09-12 17:33:05,2014-09-12 13:55:15
e079496c239748c95136458c85c23478ee609fdb...f7a403b6ef67f6870adde252cf2dd794e8c1604b,18,271,239,510,107,2014-09-12 20:48:33,2014-09-12 16:27:19
f7a403b6ef67f6870adde252cf2dd794e8c1604b...2d8603ecc535b0ff980fe537a7fe16c06d687bb6,1,2,6,8,2,2014-09-14 14:05:23,2014-09-14 14:05:23
2d8603ecc535b0ff980fe537a7fe16c06d687bb6...93f961084fa9c9969b0a04445d364ea7056d8efc,15,145,25,170,19,2014-09-14 22:29:05,2014-09-12 19:27:36
93f961084fa9c9969b0a04445d364ea7056d8efc...fdfcb2b6922bcd64982659f82f1a47cc31de7929,8,135,16,151,12,2014-09-14 22:29:20,2014-09-11 18:10:18
fdfcb2b6922bcd64982659f82f1a47cc31de7929...528d27f3a1999b4edc98582e0bc69a179512ae2f,11,35,63,98,27,2014-09-14 22:30:18,2014-09-12 18:23:36
528d27f3a1999b4edc98582e0bc69a179512ae2f...2791e15547ab4bd9adf64bdfb0c51b8aed637d38,5,395,1,396,5,2014-09-15 14:29:51,2014-09-12 22:24:24
2791e15547ab4bd9adf64bdfb0c51b8aed637d38...b24911bcf66214075d9ca4ed5d202f8205e394c3,12,719,21,740,24,2014-09-15 14:40:21,2014-09-09 21:38:46
b24911bcf66214075d9ca4ed5d202f8205e394c3...30a5dbc6afacecda309816839aa98ac2756dad40,3,4,4,8,3,2014-09-15 16:54:13,2014-09-15 16:54:13
30a5dbc6afacecda309816839aa98ac2756dad40...c4e41a1a67c53af7b271c1ebef47fc9364980920,14,469,8,477,25,2014-09-15 17:01:31,2014-09-08 21:22:47
c4e41a1a67c53af7b271c1ebef47fc9364980920...8ffb9fae4fc1dbc6519bf4b04ac9316616c2efdf,10,31,31,62,12,2014-09-15 12:03:36,2014-09-15 10:12:56
8ffb9fae4fc1dbc6519bf4b04ac9316616c2efdf...13617e4a80f2d1be45f2b6f237e0f13b1d1c68a0,12,864,896,1760,204,2014-09-15 19:37:28,2014-08-27 22:31:04
13617e4a80f2d1be45f2b6f237e0f13b1d1c68a0...27000b67341e508294e37082bc05a0705e4f6b69,1,5,5,10,3,2014-09-15 20:49:40,2014-09-15 17:55:14
27000b67341e508294e37082bc05a0705e4f6b69...f526e7e49b63644456b3bc29a4a4e33406ce4b88,1,1,1,2,1,2014-09-15 22:33:11,2014-09-15 22:33:11
f526e7e49b63644456b3bc29a4a4e33406ce4b88...fac5571f67e23a1339e20e0621bab0ba2a6b7163,43,3120,1,3121,49,2014-09-15 23:05:15,2014-09-12 17:41:12
fac5571f67e23a1339e20e0621bab0ba2a6b7163...f082e861661501755b27eee6abf3a4e61e61fdc4,3,119,223,342,56,2014-09-15 23:08:14,2014-09-12 22:27:38
f082e861661501755b27eee6abf3a4e61e61fdc4...f8a3f964eda2be32154dd8afbfad9bdf6283e82e,5,178,204,382,68,2014-09-15 23:08:15,2014-09-12 23:35:22
f8a3f964eda2be32154dd8afbfad9bdf6283e82e...d427859985fffb76278a104d46a1a913528dbc4a,7,239,465,704,111,2014-09-15 23:18:21,2014-09-14 02:43:51
d427859985fffb76278a104d46a1a913528dbc4a...4677734e7a065141012c1b63140fd64c8ea3170b,43,1,3120,3121,49,2014-09-15 23:42:10,2014-09-15 23:41:53
4677734e7a065141012c1b63140fd64c8ea3170b...c7b0fc8e6a9147f8c66ec212afe314e8b68f5341,1,17,6,23,2,2014-09-16 14:14:23,2014-09-15 22:07:50
c7b0fc8e6a9147f8c66ec212afe314e8b68f5341...90202295ec60271830464d0f9829a41dfc2a45b1,4,112,6,118,14,2014-09-16 15:40:17,2014-07-21 19:58:33
90202295ec60271830464d0f9829a41dfc2a45b1...0b167545b6e6a0f8c193d1aab8e094256fc8fa16,24,36,30,66,29,2014-09-16 16:09:50,2014-09-15 18:44:15
0b167545b6e6a0f8c193d1aab8e094256fc8fa16...7233460d3b975b4804f7721ce81a92e91033219d,1,9,11,20,9,2014-09-16 16:20:35,2014-09-15 18:36:49
7233460d3b975b4804f7721ce81a92e91033219d...6f413c78ad12d5d054e529e1ef1b6f24a11a63f8,18,939,936,1875,203,2014-09-16 16:31:36,2014-09-08 21:17:34
6f413c78ad12d5d054e529e1ef1b6f24a11a63f8...1145e75b01f16d8a2d6a576bca75f520d758149a,1,11,9,20,9,2014-09-16 17:48:17,2014-09-16 17:48:17
1145e75b01f16d8a2d6a576bca75f520d758149a...26f7a7f1d5d5a0b88e2b71a1c68b8c8600db7029,1,1,1,2,2,2014-09-16 19:34:53,2014-09-16 00:53:32
26f7a7f1d5d5a0b88e2b71a1c68b8c8600db7029...47260bcc495c093e5a2542a3d2ccdd43e796a369,1,3,3,6,2,2014-09-16 22:11:30,2014-09-16 22:05:18
47260bcc495c093e5a2542a3d2ccdd43e796a369...8baf068f5c7bcb52c7cc19bd6343fc2569cd92fc,5,61,2,63,13,2014-09-17 13:38:54,2014-09-17 13:38:54
8baf068f5c7bcb52c7cc19bd6343fc2569cd92fc...688273daf84ed4d856726a80a9c40aa3c41f5b04,1,2,2,4,2,2014-09-17 14:17:16,2014-09-16 20:33:21
688273daf84ed4d856726a80a9c40aa3c41f5b04...a16933234c892ec4e82d0f8d9e305ba4bd9c32f4,2,2,2,4,2,2014-09-17 14:36:13,2014-09-16 20:27:17
a16933234c892ec4e82d0f8d9e305ba4bd9c32f4...cce6a04bcb073699a9e16a6ce9eca587060f8c3f,6,198,19,217,18,2014-09-17 14:49:29,2014-09-16 15:59:00
cce6a04bcb073699a9e16a6ce9eca587060f8c3f...bb0a34d80b4b1e555fab5dda4ddac8ae48e99152,5,501,0,501,5,2014-09-17 14:49:29,2014-09-16 17:01:46
bb0a34d80b4b1e555fab5dda4ddac8ae48e99152...bd0eed0a669ec9f77cb207d698c6bed002acdd0e,13,336,117,453,86,2014-09-17 14:49:29,2014-09-16 21:16:32
bd0eed0a669ec9f77cb207d698c6bed002acdd0e...8d57e37ff1808f82504081539f49db1e5cf84a19,7,71,40,111,44,2014-09-17 16:02:42,2014-08-14 21:23:14
8d57e37ff1808f82504081539f49db1e5cf84a19...c776c66917b2698442093e65394051bbac81fafb,7,85,24,109,34,2014-09-17 16:02:42,2014-09-17 03:14:36
c776c66917b2698442093e65394051bbac81fafb...ce9d66b6338187acb14a2509b8d435e7a915e570,2,3,2,5,2,2014-09-17 16:33:11,2014-09-17 16:32:50
ce9d66b6338187acb14a2509b8d435e7a915e570...c470db609c0ae232973e7b7cd5c3f98701964a2e,12,39,87,126,34,2014-09-17 16:54:17,2014-09-16 18:38:00
c470db609c0ae232973e7b7cd5c3f98701964a2e...85e785fdce07dbb23b49220f4798f4627cf6af79,5,60,2,62,8,2014-09-17 16:56:47,2014-09-16 18:25:55
85e785fdce07dbb23b49220f4798f4627cf6af79...ba726b4ee22efc2ea9b86b52724e0a4081c16c53,1,1,1,2,1,2014-09-17 17:15:18,2014-09-10 18:37:36
ba726b4ee22efc2ea9b86b52724e0a4081c16c53...545c26b58fdcf5a725bdda6391937465cb1fd13a,1,4,20,24,8,2014-09-17 18:11:32,2014-09-17 18:11:30
545c26b58fdcf5a725bdda6391937465cb1fd13a...e986b037f1301fae63938dc9bd933ff8ac25b7d6,1,64,0,64,1,2014-09-17 18:22:03,2014-09-15 22:58:57
e986b037f1301fae63938dc9bd933ff8ac25b7d6...8da54bf660d2a5095e0e20c94734f784d49f0aeb,1,6,3,9,3,2014-09-17 20:08:40,2014-09-12 21:01:24
8da54bf660d2a5095e0e20c94734f784d49f0aeb...b66a9da4ec5f345f35ed637a8df34f9fe7be9f11,4,58,14,72,16,2014-09-17 22:34:09,2014-09-17 19:49:17
b66a9da4ec5f345f35ed637a8df34f9fe7be9f11...859876746f3abcf7a97e150e1179cc70325ea274,1,5,0,5,1,2014-09-17 22:35:56,2014-09-16 18:23:38
859876746f3abcf7a97e150e1179cc70325ea274...dedf038860746ad0bed3a6f37ae702587933b5f8,8,243,90,333,22,2014-09-17 22:44:49,2014-09-12 15:29:50
dedf038860746ad0bed3a6f37ae702587933b5f8...8e3ce6437f5ddf13eab8b256ee5ff98e5e64d410,4,25,5,30,7,2014-09-17 22:44:49,2014-09-17 17:41:25
8e3ce6437f5ddf13eab8b256ee5ff98e5e64d410...6b20b7dca19f3597978031fb7dc301380b29bf09,20,158,158,316,142,2014-09-17 22:50:45,2014-09-17 22:44:12
6b20b7dca19f3597978031fb7dc301380b29bf09...5b5decd541a6449ec4641992ae0ecb89207a0dc0,2,14,14,28,14,2014-09-17 23:14:09,2014-09-17 15:21:08
5b5decd541a6449ec4641992ae0ecb89207a0dc0...ebae193cfdc69cc0da9b5e417a97215747a6248a,2,26,3,29,10,2014-09-18 00:21:53,2014-09-18 00:21:34
ebae193cfdc69cc0da9b5e417a97215747a6248a...b05a745cd74c4879a08f804b2582900a33786a57,18,1438,164,1602,65,2014-09-18 11:42:31,2014-09-12 14:15:41
b05a745cd74c4879a08f804b2582900a33786a57...97c7dc7fd949d77c13e5a9a70559376adf36df2e,1,13,6,19,4,2014-09-18 15:13:46,2014-09-18 14:34:58
97c7dc7fd949d77c13e5a9a70559376adf36df2e...48b2da7c1c40d4c85e6f82ea041386bd0ee8b4ef,1,3,1,4,3,2014-09-18 17:43:16,2014-09-18 16:57:34
48b2da7c1c40d4c85e6f82ea041386bd0ee8b4ef...55415503b722848d51fe45fc2de2d47cee4db952,2,27,0,27,2,2014-09-18 18:07:25,2014-09-18 15:37:06
55415503b722848d51fe45fc2de2d47cee4db952...ccacca83853931e2d03c8670c1745dfac515e119,19,19,0,19,19,2014-09-18 18:09:35,2014-09-15 19:17:38
ccacca83853931e2d03c8670c1745dfac515e119...9ad364efb8bfd01d5653a8d085e23c70a0dcfb29,1,0,8,8,1,2014-09-18 18:34:04,2014-09-18 15:59:01
9ad364efb8bfd01d5653a8d085e23c70a0dcfb29...e88273ac940cdef9e12c94a6bdbd2694b706a635,43,3120,1,3121,49,2014-09-18 18:37:45,2014-09-12 17:41:12
e88273ac940cdef9e12c94a6bdbd2694b706a635...035b928655398f6884a1404d7876b6cc1bd47e54,2,11,0,11,2,2014-09-18 18:40:28,2014-09-17 21:16:05
035b928655398f6884a1404d7876b6cc1bd47e54...f679b4e9b73ab0a6baf9ab9504f66b06863243f1,6,32,3,35,13,2014-09-18 18:55:15,2014-09-17 20:47:20
f679b4e9b73ab0a6baf9ab9504f66b06863243f1...b94e1e4a6a4c4a583dff33e5147e1091d144b3f1,3,11,5,16,8,2014-09-18 19:39:47,2014-09-17 18:27:26
b94e1e4a6a4c4a583dff33e5147e1091d144b3f1...10f6f87c696ad742fa8f68d382531141104083f1,13,210,21,231,39,2014-09-18 20:40:26,2014-09-16 20:23:08
10f6f87c696ad742fa8f68d382531141104083f1...a7cdcee52937fec949eea4050973bde5c1d825be,2,125,134,259,35,2014-09-18 20:50:34,2014-09-18 14:52:28
a7cdcee52937fec949eea4050973bde5c1d825be...3a0420f1a74cbeefadc7909dbf2e1768200708eb,1,2,1,3,2,2014-09-18 21:48:13,2014-09-18 19:57:17
3a0420f1a74cbeefadc7909dbf2e1768200708eb...8218e483ed31b5d8392a62cb1bc8c402e8ed0e97,7,20,87,107,8,2014-09-19 00:25:53,2014-09-18 17:57:44
8218e483ed31b5d8392a62cb1bc8c402e8ed0e97...986d4a410e55a317da3ed99fe1f4fc21354400ce,2,19,1,20,2,2014-09-19 01:47:29,2014-09-18 20:23:14
986d4a410e55a317da3ed99fe1f4fc21354400ce...7f9d45b4ec116acf04333da7ba1e8affffdcfe36,1,3,1,4,1,2014-09-19 13:34:32,2014-09-19 13:17:59
7f9d45b4ec116acf04333da7ba1e8affffdcfe36...db59c175c736609970b52f91e30fc2277e22b25b,2,1,4,5,2,2014-09-19 13:34:32,2014-09-19 13:19:45
db59c175c736609970b52f91e30fc2277e22b25b...d0afb7a6c1fdfeefbed93bb3a5d3947fdb712ed4,1,1,2,3,1,2014-09-19 13:34:32,2014-09-19 13:23:33
d0afb7a6c1fdfeefbed93bb3a5d3947fdb712ed4...1c7e562f611f92cc4b6aec07eed4aacbee070155,1,7,0,7,2,2014-09-19 13:34:32,2014-09-19 13:25:46
1c7e562f611f92cc4b6aec07eed4aacbee070155...3fe2d4fb37cce8259991f7af8b58d67b357af84e,2,16,0,16,4,2014-09-19 13:34:32,2014-09-19 13:26:41
3fe2d4fb37cce8259991f7af8b58d67b357af84e...28331b4bedcfe300612d38ef2699eee25097c7ac,2,15,0,15,4,2014-09-19 13:34:32,2014-09-19 13:28:58
28331b4bedcfe300612d38ef2699eee25097c7ac...062e96af5a21d9a4d5f728d903a5e45d52fe8bb5,1,8,0,8,2,2014-09-19 13:34:32,2014-09-19 13:29:11
062e96af5a21d9a4d5f728d903a5e45d52fe8bb5...a3c4c0047c58a0d820f4775b5eb230a393ae7bcc,18,20,30,50,31,2014-09-19 13:51:01,2014-09-18 19:40:20
a3c4c0047c58a0d820f4775b5eb230a393ae7bcc...759b6e8cabfb745b712b5ffd0748561129c3b421,1,2,2,4,2,2014-09-19 14:34:10,2014-09-18 21:34:42
759b6e8cabfb745b712b5ffd0748561129c3b421...6572c75e85cd7ec0a3269a13a5290c9a46416a3e,11,261,70,331,42,2014-09-19 14:46:17,2014-09-18 18:06:54
6572c75e85cd7ec0a3269a13a5290c9a46416a3e...1b5faf24beead22310235aae29dd4f879a1e0c3b,1,16,0,16,3,2014-09-19 09:54:21,2014-09-09 17:01:15
1b5faf24beead22310235aae29dd4f879a1e0c3b...7b48813f82f51f99a0d99d8ca73230757b66b82a,1,57,0,57,8,2014-09-19 09:54:21,2014-09-10 10:46:31
7b48813f82f51f99a0d99d8ca73230757b66b82a...62ff89407231923edd1d14f833a4be8443d3dd44,1,49,0,49,1,2014-09-19 09:54:21,2014-09-10 13:08:58
62ff89407231923edd1d14f833a4be8443d3dd44...76712b2f264d657341a4000bfcc089c3f6099555,1,1,1,2,1,2014-09-19 09:54:21,2014-09-10 15:18:33
76712b2f264d657341a4000bfcc089c3f6099555...ceac886bedd13ed50ed925bf7ad1b95211d073cd,5,75,43,118,48,2014-09-19 09:54:21,2014-09-11 10:30:41
ceac886bedd13ed50ed925bf7ad1b95211d073cd...c17717babc4f04828779039e0c1091da6b6a33de,1,5,0,5,1,2014-09-19 09:54:21,2014-09-11 13:09:52
c17717babc4f04828779039e0c1091da6b6a33de...e0c96975d1e1385b80311468ca493e8424455588,1,60,47,107,19,2014-09-19 09:54:21,2014-09-15 12:50:11
e0c96975d1e1385b80311468ca493e8424455588...fde9b90a89cc867ee624b6e21ef375bdcb626891,1,1,1,2,1,2014-09-19 09:54:21,2014-09-15 12:51:07
fde9b90a89cc867ee624b6e21ef375bdcb626891...1f8841bb7b7d7c2f1b4a5f927f9aa864cb15ff2b,1,21,0,21,21,2014-09-19 09:54:21,2014-09-15 13:10:58
1f8841bb7b7d7c2f1b4a5f927f9aa864cb15ff2b...0b1b335bb81965ee7413e4b67fe959ab3e2ae925,1,8,8,16,8,2014-09-19 09:54:21,2014-09-15 13:24:12
0b1b335bb81965ee7413e4b67fe959ab3e2ae925...fdea33944c645abbee30477fe7ea9cc6ee4dee1c,1,10,0,10,6,2014-09-19 09:54:21,2014-09-15 13:42:38
fdea33944c645abbee30477fe7ea9cc6ee4dee1c...5ec8c6a695f9a9493669030c38b354ab46061175,1,83,11,94,5,2014-09-19 09:54:21,2014-09-15 15:15:40
5ec8c6a695f9a9493669030c38b354ab46061175...fed9947456d614a1df00673f6eacb622e836ab6d,1,22,0,22,1,2014-09-19 09:54:21,2014-09-15 15:31:34
fed9947456d614a1df00673f6eacb622e836ab6d...c39097add669b8dbd9ec5f6d97bba259aeeac3c8,3,63,2,65,55,2014-09-19 09:54:22,2014-09-15 16:01:18
c39097add669b8dbd9ec5f6d97bba259aeeac3c8...a6b0f47462f059726d6c3c06e67c4509e9a1be19,1,3,0,3,3,2014-09-19 09:54:22,2014-09-15 18:00:31
a6b0f47462f059726d6c3c06e67c4509e9a1be19...90ba3df43b62cda410004a9f386f05fb76887d8b,4,226,6,232,7,2014-09-19 09:54:22,2014-09-16 15:04:43
90ba3df43b62cda410004a9f386f05fb76887d8b...fa1b332411047150fcf706b3a60398c491b44d84,6,53,2,55,11,2014-09-19 15:17:11,2014-09-17 20:11:56
fa1b332411047150fcf706b3a60398c491b44d84...b20a717ed0884b665fbdfbde5ee386e58a498113,5,80,3,83,14,2014-09-19 15:42:55,2014-09-11 20:02:51
b20a717ed0884b665fbdfbde5ee386e58a498113...5734054edbd36adedb719f8c614fcb81e5b893ac,2,24,7,31,9,2014-09-19 15:42:55,2014-09-11 20:16:38
5734054edbd36adedb719f8c614fcb81e5b893ac...96f8616e7c078040af55a58859e5a1d563b42120,16,114,40,154,36,2014-09-19 15:50:30,2014-09-15 18:18:41
96f8616e7c078040af55a58859e5a1d563b42120...3900c740dc53c3de9fbb5a7168378f5b58699265,10,37,34,71,25,2014-09-19 15:50:30,2014-09-15 20:28:04
3900c740dc53c3de9fbb5a7168378f5b58699265...d4939de9c4ee3f3fd2d6b3bc55d4414b6d850c66,10,213,41,254,26,2014-09-19 15:50:30,2014-09-18 19:21:31
d4939de9c4ee3f3fd2d6b3bc55d4414b6d850c66...7e121c042020285789730da5e9ec9c70800585a8,7,28,84,112,21,2014-09-19 15:50:30,2014-09-18 21:08:40
7e121c042020285789730da5e9ec9c70800585a8...f69fefd9b7d9b2e19af32ab0337650a0fca3344a,8,7,53,60,14,2014-09-19 15:50:31,2014-09-18 21:36:23
f69fefd9b7d9b2e19af32ab0337650a0fca3344a...00e6fb5092a34702fbc4518ef616dd936089f935,3,4,11,15,4,2014-09-19 16:28:28,2014-07-02 00:00:43
00e6fb5092a34702fbc4518ef616dd936089f935...6a6bc5198a694c327901e4685302be20e1b04345,2,0,17,17,2,2014-09-19 16:54:06,2014-09-19 14:20:29
6a6bc5198a694c327901e4685302be20e1b04345...72f186db7490152b7b2fcf8df924982fc9083270,9,76,1,77,12,2014-09-19 16:56:25,2014-09-17 20:40:51
72f186db7490152b7b2fcf8df924982fc9083270...6b3ea60ba07c98d6aa69645b398aeade3e165cc4,1,0,12,12,1,2014-09-19 18:29:37,2014-09-19 18:29:28
6b3ea60ba07c98d6aa69645b398aeade3e165cc4...29e0cbf47cf1b6b0eb62515985bac56e59e1f982,1,0,9,9,5,2014-09-19 18:42:21,2014-09-19 18:40:58
29e0cbf47cf1b6b0eb62515985bac56e59e1f982...1c6debf5f5f434f2198cef6e4141a0505ca1c928,2,12,2,14,3,2014-09-19 19:53:55,2014-09-18 15:49:23
1c6debf5f5f434f2198cef6e4141a0505ca1c928...8173a9e16ddb9fc43a2e16de24fcddbf407d6ca1,1,0,41,41,1,2014-09-19 20:06:37,2014-09-19 19:30:38
8173a9e16ddb9fc43a2e16de24fcddbf407d6ca1...151dd9ff5f6f4acb99c030dbc533a632412108f9,1,2,3,5,1,2014-09-19 20:14:32,2014-09-19 20:03:29
151dd9ff5f6f4acb99c030dbc533a632412108f9...590801147ad7cb7edd5269fe7a219890acc3ee6b,1,5,0,5,1,2014-09-19 20:24:12,2014-09-18 21:28:51
590801147ad7cb7edd5269fe7a219890acc3ee6b...63dd64abac9002e71348b7550234131cd01a87f5,1,73,73,146,73,2014-09-19 20:47:56,2014-09-19 18:57:15
63dd64abac9002e71348b7550234131cd01a87f5...78c5f9dd5ac65eae251df3e87175a0af076d90d9,26,432,283,715,106,2014-09-19 20:50:23,2014-09-19 20:43:33
78c5f9dd5ac65eae251df3e87175a0af076d90d9...6246d74016340261493d6606a6f0a708c39395cc,2,16,0,16,2,2014-09-19 20:53:54,2014-09-17 12:18:54
6246d74016340261493d6606a6f0a708c39395cc...881b3a97fb5080b4e5d5ce11ad016da73ea23931,4,240,79,319,46,2014-09-20 13:00:51,2014-09-20 04:17:31
881b3a97fb5080b4e5d5ce11ad016da73ea23931...5376c8ad356acc9e43e0b5e1c6cda995ea209ddf,9,41,37,78,34,2014-09-22 16:26:14,2014-09-19 20:38:30
5376c8ad356acc9e43e0b5e1c6cda995ea209ddf...ad1dafb013342faae7e998586a0c35b70ba75636,10,236,112,348,23,2014-09-22 17:38:51,2014-09-19 20:12:05
ad1dafb013342faae7e998586a0c35b70ba75636...d16ed5e1c2f73d4d529221045385e16e3bec7e44,3,27,12,39,7,2014-09-22 17:44:55,2014-09-15 19:10:03
d16ed5e1c2f73d4d529221045385e16e3bec7e44...9bd9a631a1bfdcb1eb6f8aecd345a225a8e07ec1,4,142,110,252,32,2014-09-22 17:46:16,2014-09-19 15:54:03
9bd9a631a1bfdcb1eb6f8aecd345a225a8e07ec1...71d4f11c1e15ad22a4691b3ff519afc8e8a604b1,2,28,15,43,12,2014-09-22 18:07:48,2014-09-22 18:07:48
71d4f11c1e15ad22a4691b3ff519afc8e8a604b1...b5574b7ea9346f89262735b2aafb51680b2d40f6,1,3,1,4,1,2014-09-22 18:37:41,2014-09-22 17:42:16
b5574b7ea9346f89262735b2aafb51680b2d40f6...532b1595c96eb492f7a9813b855d28919a20dd78,1,7,4,11,2,2014-09-22 18:38:26,2014-09-19 20:33:21
532b1595c96eb492f7a9813b855d28919a20dd78...92daab5896113b963f89b93c424e605180002178,2,25,2,27,6,2014-09-22 18:46:15,2014-09-19 19:06:56
92daab5896113b963f89b93c424e605180002178...a4c1edab3d82ec25bd28f919d2c89c9d2472d9ff,13,223,113,336,98,2014-09-22 18:49:13,2014-08-22 21:20:44
a4c1edab3d82ec25bd28f919d2c89c9d2472d9ff...8954a165aa5d0f5da1be734f46341bffd9df31ce,1,23,16,39,9,2014-09-22 19:40:18,2014-09-16 19:39:02
8954a165aa5d0f5da1be734f46341bffd9df31ce...01c372ddd6c4e441a5e347e1e450d441b86bcfbf,2,60,1,61,4,2014-09-22 19:40:18,2014-09-22 17:58:40
01c372ddd6c4e441a5e347e1e450d441b86bcfbf...61c7055f1f0a01957b54429211e177545a062bc7,1,2,0,2,1,2014-09-22 19:45:49,2014-09-22 18:54:36
61c7055f1f0a01957b54429211e177545a062bc7...2a37d7e5df2e31023e86f4f1ef3b9e9e3d6285fe,3,17,83,100,13,2014-09-22 19:49:27,2014-09-22 19:48:47
2a37d7e5df2e31023e86f4f1ef3b9e9e3d6285fe...848117f221ad2830d440abacff47c6cbe72b7540,2,44,0,44,5,2014-09-22 21:24:44,2014-09-22 18:05:18
848117f221ad2830d440abacff47c6cbe72b7540...0a75de580ac71fee5e558aca491d7d3c0f6af313,5,6,81,87,9,2014-09-22 21:28:34,2014-09-22 20:39:49
0a75de580ac71fee5e558aca491d7d3c0f6af313...7babda888912d6e0bc667540577dcc6e14d405df,7,422,1,423,7,2014-09-22 21:56:44,2014-09-02 20:08:25
7babda888912d6e0bc667540577dcc6e14d405df...7a188f499b3411c1a4f590bdee8a18f84495af11,3,3,4,7,5,2014-09-22 21:56:44,2014-09-22 16:03:05
7a188f499b3411c1a4f590bdee8a18f84495af11...ed9896eb2b9fc49e005019fbb0dbc411851b1d40,1,8,8,16,5,2014-09-22 22:09:27,2014-09-22 21:47:57
ed9896eb2b9fc49e005019fbb0dbc411851b1d40...556ef3433ea0dc8b43e67cfd178755a8034f2e14,1,3,9,12,1,2014-09-22 22:12:33,2014-09-19 18:38:18
556ef3433ea0dc8b43e67cfd178755a8034f2e14...0b6d40412f44f5ecd0ebf92e5da4212c266a2e98,1,2,11,13,3,2014-09-22 22:14:16,2014-09-22 22:09:28
0b6d40412f44f5ecd0ebf92e5da4212c266a2e98...7c6fa28264300aa9f8691d4ff21ff40cd56aa605,2,1,264,265,2,2014-09-23 14:32:28,2014-09-22 22:02:16
7c6fa28264300aa9f8691d4ff21ff40cd56aa605...5c3cc4179790190d66a43f8a265b218001704d5e,11,92,23,115,13,2014-09-23 15:26:03,2014-09-22 22:55:18
5c3cc4179790190d66a43f8a265b218001704d5e...e20de4f8efaa1d052068c7e0163245f403ade216,5,227,18,245,22,2014-09-23 15:56:25,2014-09-22 19:19:05
e20de4f8efaa1d052068c7e0163245f403ade216...2cc743d006a03e4da933168d1e70d9c1799df9f4,1,5,5,10,5,2014-09-23 16:49:20,2014-09-23 16:49:20
2cc743d006a03e4da933168d1e70d9c1799df9f4...348bacb3695d439ace201c66cdd8c7a467aead58,1,10,0,10,2,2014-09-23 18:02:41,2014-09-23 18:01:03
348bacb3695d439ace201c66cdd8c7a467aead58...a20269dfb7d287260cd30f10fd2dfeb01a48528f,1,118,123,241,23,2014-09-23 19:48:04,2014-09-22 23:08:18
a20269dfb7d287260cd30f10fd2dfeb01a48528f...812916f5335f54b1b3944889fedc28b78997ebf3,3,5,2,7,4,2014-09-23 19:49:25,2014-09-23 18:49:39
812916f5335f54b1b3944889fedc28b78997ebf3...a0aed05f92ea5a179534ff4b6d491abd759ed108,3,4,29,33,4,2014-09-23 20:06:13,2014-09-23 19:04:16
a0aed05f92ea5a179534ff4b6d491abd759ed108...7236ee33103597ccd46f0ba55aae575c2f25dd8b,3,2,5,7,4,2014-09-23 21:30:42,2014-09-23 21:30:42
7236ee33103597ccd46f0ba55aae575c2f25dd8b...6db1ea0ab3961cfaa994c49036187656b7338adc,1,6,3,9,2,2014-09-23 23:22:34,2014-09-19 15:44:22
6db1ea0ab3961cfaa994c49036187656b7338adc...5af296c80a6eed635cde12a1611e357429e201d4,1,1,1,2,1,2014-09-23 23:37:11,2014-09-23 21:41:34
5af296c80a6eed635cde12a1611e357429e201d4...e7f18a7e54ea66d0326fb62b9b477a8e9cd23d1c,3,8,2,10,5,2014-09-24 00:09:13,2014-09-23 23:20:04
e7f18a7e54ea66d0326fb62b9b477a8e9cd23d1c...2ce51c8e0d4bf84589bffa87e59f2401578c2572,3,2,8,10,5,2014-09-24 02:58:25,2014-09-24 02:58:25
2ce51c8e0d4bf84589bffa87e59f2401578c2572...2a342fcbbddbf13bc18e5cf36dee2bd35711b8bb,1,4,0,4,1,2014-09-24 13:45:44,2014-09-23 14:46:49
2a342fcbbddbf13bc18e5cf36dee2bd35711b8bb...dafc21d92cc58991cc3539e3085e20b9ce50cc71,1,8,8,16,2,2014-09-24 15:38:27,2014-09-23 19:32:07
dafc21d92cc58991cc3539e3085e20b9ce50cc71...774fbccb99565df3fd30c20325f4f54d667d6477,3,41,3,44,7,2014-09-24 15:49:05,2014-09-24 01:31:07
774fbccb99565df3fd30c20325f4f54d667d6477...37acdec21b4f8ab951293a0de317bc52b1a9fd65,3,17,0,17,4,2014-09-24 15:54:52,2014-09-23 20:56:34
37acdec21b4f8ab951293a0de317bc52b1a9fd65...551329f05738f5f5c99df68b0598625ea16db4c6,3,0,85,85,3,2014-09-24 15:59:40,2014-09-23 21:05:01
551329f05738f5f5c99df68b0598625ea16db4c6...0647e59fb9cbd74b22a841be777badd3b6b6adfa,3,40,1,41,6,2014-09-24 16:09:13,2014-09-24 00:36:25
0647e59fb9cbd74b22a841be777badd3b6b6adfa...5d580ba3135bc42fa9b3ab9a26243560bf59776e,3,74,16,90,12,2014-09-24 17:01:11,2014-09-23 15:24:45
5d580ba3135bc42fa9b3ab9a26243560bf59776e...ae200202f572851c22a82372b871f7981c8cea86,4,77,43,120,25,2014-09-24 17:20:54,2014-09-23 20:49:36
ae200202f572851c22a82372b871f7981c8cea86...03d22b14a74564e686fad7b75c093eaf8371321b,3,47,0,47,3,2014-09-24 17:39:30,2014-09-23 18:45:08
03d22b14a74564e686fad7b75c093eaf8371321b...f1418a12b5edaa3f056a92c0d4e0a38ea5dde171,3,11,10,21,8,2014-09-24 18:22:48,2014-09-23 19:21:55
f1418a12b5edaa3f056a92c0d4e0a38ea5dde171...6fd2fe648071c2c55d8977b72e9e92907a933958,5,81,47,128,21,2014-09-24 19:11:19,2014-09-12 18:58:38
6fd2fe648071c2c55d8977b72e9e92907a933958...5dba44d45efad5baec9bc1e5ea6f8ad0700b6059,19,868,17,885,28,2014-09-24 20:19:46,2014-09-18 22:33:55
5dba44d45efad5baec9bc1e5ea6f8ad0700b6059...0c46836a9befaff86825a8238027c8b4223ca14c,5,34,0,34,5,2014-09-24 21:08:34,2014-09-22 21:36:47
0c46836a9befaff86825a8238027c8b4223ca14c...a553643b019b0f2901a8e6a109482acb5cb0a18f,6,19,19,38,16,2014-09-24 21:19:28,2014-09-22 18:11:54
a553643b019b0f2901a8e6a109482acb5cb0a18f...fb147e35ef002f9f96a738f76fe12aebb48186d7,1,4,1,5,1,2014-09-24 21:52:28,2014-09-24 20:32:56
fb147e35ef002f9f96a738f76fe12aebb48186d7...09fd21a206f959f6742e92d38b783a3e04e1948b,2,3,2,5,3,2014-09-25 02:37:57,2014-09-24 21:10:14
09fd21a206f959f6742e92d38b783a3e04e1948b...b2ea63e14f6e382c42409c8bf6326115fca94888,7,116,45,161,29,2014-09-25 02:51:58,2014-08-07 04:53:10
b2ea63e14f6e382c42409c8bf6326115fca94888...a83553d6bff77a16f797a32c293a6832d4b72743,5,0,34,34,5,2014-09-25 12:56:26,2014-09-25 12:56:26
a83553d6bff77a16f797a32c293a6832d4b72743...a658204bcdac48548821db4bb4638511bffaa670,1,6,1,7,1,2014-09-25 13:41:27,2014-09-23 15:47:48
a658204bcdac48548821db4bb4638511bffaa670...f23e92530e7356fa1959aac0f15cac526e46109f,10,10,10,20,10,2014-09-25 14:39:30,2014-09-24 21:51:12
f23e92530e7356fa1959aac0f15cac526e46109f...05c6ae595922a89b96eb05db229cf02efae2ff89,2,102,5,107,4,2014-09-25 15:15:45,2014-09-24 19:08:54
05c6ae595922a89b96eb05db229cf02efae2ff89...3a5ea7b224b97b77cc5e21d89a41ebb762cc177c,8,41,6,47,11,2014-09-25 15:27:14,2014-09-25 14:40:22
3a5ea7b224b97b77cc5e21d89a41ebb762cc177c...757c4773742ee8597a0e62dd224b40d82d244de6,7,43,46,89,35,2014-09-25 15:58:53,2014-09-24 19:08:31
757c4773742ee8597a0e62dd224b40d82d244de6...1645e89e81ef8446601ce637c5dd3a9b0f124367,4,24,2,26,7,2014-09-25 12:29:29,2014-09-19 10:20:40
1645e89e81ef8446601ce637c5dd3a9b0f124367...0aea353a653082f400a1eece7c8a861038f7aa90,1,345,165,510,18,2014-09-25 12:37:39,2014-09-25 12:16:37
0aea353a653082f400a1eece7c8a861038f7aa90...fd9c0fd66edec990bd028948db08b62f05fe5bc3,1,132,34,166,2,2014-09-25 12:42:34,2014-09-25 12:20:05
fd9c0fd66edec990bd028948db08b62f05fe5bc3...d8ca40925a75114e3c1b51a1e22c2426935f92a0,1,84,0,84,3,2014-09-25 12:42:36,2014-09-18 12:41:34
d8ca40925a75114e3c1b51a1e22c2426935f92a0...bf6bb101f374c3fe01daeeef7f761bf1d5063f13,1,289,0,289,1,2014-09-25 12:43:51,2014-09-19 14:24:15
bf6bb101f374c3fe01daeeef7f761bf1d5063f13...663ac29492288b5d05ea72ac5dbfb885d89c4fe5,1,13,4,17,4,2014-09-25 12:43:57,2014-09-22 13:24:17
663ac29492288b5d05ea72ac5dbfb885d89c4fe5...0331a4b573409272919aa0bccf4f341455e19985,1,1,14,15,2,2014-09-25 12:43:57,2014-09-22 15:46:52
0331a4b573409272919aa0bccf4f341455e19985...5377321f964fdd98782b61943d90e828192d1b85,3,182,1,183,3,2014-09-25 12:43:57,2014-09-24 13:36:06
5377321f964fdd98782b61943d90e828192d1b85...3cda046b1d3910114eeb593c8e4705eec95393b3,1,2,2,4,1,2014-09-25 17:55:21,2014-09-25 17:33:41
3cda046b1d3910114eeb593c8e4705eec95393b3...e671a2c31f6b555254e4ad8265f66578f8c805aa,5,33,38,71,6,2014-09-25 18:32:37,2014-09-24 20:07:38
e671a2c31f6b555254e4ad8265f66578f8c805aa...c9b18a3824573e503d99c6b0f14a1a7d2049b50e,3,18,3,21,6,2014-09-25 19:11:35,2014-09-24 14:36:02
c9b18a3824573e503d99c6b0f14a1a7d2049b50e...a0f55108e49a4cb3982a5636c2ecdc4ccfe6cf83,1,14,1,15,2,2014-09-25 14:54:45,2014-09-25 14:54:45
a0f55108e49a4cb3982a5636c2ecdc4ccfe6cf83...5886a56330c3775bf5c8bea2a69ec6627822d387,3,87,0,87,9,2014-09-25 20:23:53,2014-09-25 19:35:28
5886a56330c3775bf5c8bea2a69ec6627822d387...0adbbde35e8ca1696145f21bde5c311b3da6d4e5,3,21,1,22,7,2014-09-25 20:25:16,2014-08-08 13:38:15
0adbbde35e8ca1696145f21bde5c311b3da6d4e5...68881762f612542372f8f55d61db0bf7856da762,2,2,5,7,3,2014-09-25 20:25:28,2014-09-19 21:34:19
68881762f612542372f8f55d61db0bf7856da762...bcea622441dc2f689c4651981f9d7929a1dd75b3,3,3,3,6,3,2014-09-25 20:38:59,2014-09-25 20:36:44
bcea622441dc2f689c4651981f9d7929a1dd75b3...60d379f9e0c3eaf85850e768328d94c49170a7d7,1,18,0,18,2,2014-09-25 20:48:17,2014-09-25 20:20:43
60d379f9e0c3eaf85850e768328d94c49170a7d7...5da5d98e114e4a024be242b0baea4115bea9e56c,2,32,21,53,12,2014-09-25 21:07:38,2014-09-24 22:43:15
5da5d98e114e4a024be242b0baea4115bea9e56c...f12b81dd15143d62768a4082f11ccc26692d6625,5,39,34,73,7,2014-09-25 21:46:19,2014-09-25 21:43:06
f12b81dd15143d62768a4082f11ccc26692d6625...77b00970997d13d0758c745e5a94fc79982d4401,4,80,2,82,6,2014-09-25 22:08:57,2014-09-25 16:35:38
77b00970997d13d0758c745e5a94fc79982d4401...962f959a09b63aa0482d7e0c9bad89363d1e1194,38,123,126,249,92,2014-09-25 22:12:34,2014-09-25 18:41:01
962f959a09b63aa0482d7e0c9bad89363d1e1194...e402881e004283d292dd3e483a9df1dbd2b066e2,3,5,1,6,4,2014-09-26 01:53:11,2014-09-26 01:53:11
e402881e004283d292dd3e483a9df1dbd2b066e2...a1f9188b4d58daa4e80a344116dbd85b636962da,11,34,23,57,18,2014-09-26 02:13:39,2014-09-25 18:08:28
a1f9188b4d58daa4e80a344116dbd85b636962da...f905b0617dd1ed35acb9291edeab95b557388019,5,33,38,71,6,2014-09-26 02:13:40,2014-09-25 21:49:59
f905b0617dd1ed35acb9291edeab95b557388019...dd758da252c078baa6c7cd078c20740a9df3a27a,1,3,3,6,2,2014-09-26 12:30:27,2014-09-26 00:23:39
dd758da252c078baa6c7cd078c20740a9df3a27a...33e5137da184729d0ce8604908c71eb96195a805,4,338,9,347,22,2014-09-26 14:54:20,2014-09-25 00:11:28
33e5137da184729d0ce8604908c71eb96195a805...128ef4c4bcf312fbe6339181e377d12744165cf9,3,3,3,6,3,2014-09-26 15:21:53,2014-09-26 14:50:42
128ef4c4bcf312fbe6339181e377d12744165cf9...e86e08deff7293b5778fad27df9031c013595b12,36,824,787,1611,220,2014-09-26 15:27:06,2014-09-23 18:46:55
e86e08deff7293b5778fad27df9031c013595b12...bbbc331ac4e263171c4fda427a2649ed69732175,2,2,8,10,2,2014-09-26 15:27:06,2014-09-26 13:37:25
bbbc331ac4e263171c4fda427a2649ed69732175...bb2fa86ebe66f7b13857e4c5bb07583628741eb1,1,2,1,3,1,2014-09-26 15:27:06,2014-09-26 13:42:26
bb2fa86ebe66f7b13857e4c5bb07583628741eb1...1ba04a9b86b08a31bd6b59a0fb7895034051df9a,5,33,28,61,22,2014-09-26 15:27:06,2014-09-26 14:58:35
1ba04a9b86b08a31bd6b59a0fb7895034051df9a...ae333bc94a7d89d3220dcae9579fcaf68aa2e290,1,1,1,2,1,2014-09-26 15:27:06,2014-09-26 15:23:30
ae333bc94a7d89d3220dcae9579fcaf68aa2e290...2c7d34a2fd4c481c2b41b20403ed844a01d83f43,2,28,3,31,4,2014-09-26 15:45:53,2014-09-26 15:30:41
2c7d34a2fd4c481c2b41b20403ed844a01d83f43...e869a82e520793a1368ffb15dd0dc6ac38677bb9,15,68,3,71,18,2014-09-26 17:44:39,2014-09-24 21:42:13
e869a82e520793a1368ffb15dd0dc6ac38677bb9...aeb26b131e973c5215eeff56b0d0e90e7c46a928,3,12,18,30,7,2014-09-26 17:53:28,2014-09-24 22:07:43
aeb26b131e973c5215eeff56b0d0e90e7c46a928...aa656086587c2c5513d884614ae55a38ec838df3,2,6,6,12,5,2014-09-26 20:32:41,2014-09-26 20:32:32
aa656086587c2c5513d884614ae55a38ec838df3...96b64712666312fe9103b8f9a5c28e3479ed1d18,2,9,9,18,6,2014-09-27 18:17:29,2014-09-26 17:03:11
96b64712666312fe9103b8f9a5c28e3479ed1d18...52948ec0597a4726021049c9dae6635c5a41d1a4,5,27,42,69,17,2014-09-29 11:52:22,2014-09-29 11:52:22
52948ec0597a4726021049c9dae6635c5a41d1a4...689c0faf75e0cc3f1663b962c3db55360e0ef3b5,2,28,4,32,5,2014-09-29 14:25:56,2014-09-28 00:14:09
689c0faf75e0cc3f1663b962c3db55360e0ef3b5...070596dd59e3af7bd0ac23071a97ebcfcecc62d7,1,17,12,29,5,2014-09-29 14:44:02,2014-09-29 14:43:58
070596dd59e3af7bd0ac23071a97ebcfcecc62d7...195113534141890f15b1db931c7dfa5162dc6049,1,23,28,51,6,2014-09-29 16:29:38,2014-09-29 16:11:18
195113534141890f15b1db931c7dfa5162dc6049...4d0e951ae7831638936948b2cfb702842b24f260,2,21,25,46,10,2014-09-29 16:46:48,2014-09-29 15:01:13
4d0e951ae7831638936948b2cfb702842b24f260...481467e24fe3f42672d8bbdac7e6f46ffcd0089f,1,0,1,1,1,2014-09-29 11:45:28,2014-09-29 10:22:27
481467e24fe3f42672d8bbdac7e6f46ffcd0089f...85901e7c7601e6b969d1e553fd2ef92696683c55,1,3,2,5,3,2014-09-29 18:06:14,2014-09-29 16:36:26
85901e7c7601e6b969d1e553fd2ef92696683c55...a1fac26d5efd26c9b4cb03729400d3dcfd052560,1,1,1,2,1,2014-09-29 18:46:43,2014-09-29 18:42:17
a1fac26d5efd26c9b4cb03729400d3dcfd052560...57af98451c500c5d8112cfc5e75917a0e561069f,9,273,51,324,31,2014-09-29 19:21:41,2014-09-29 16:15:02
57af98451c500c5d8112cfc5e75917a0e561069f...8e83e72512fcb8eb8f06987927766c0b77cea23e,38,127,124,251,93,2014-09-29 21:54:36,2014-09-29 21:53:20
8e83e72512fcb8eb8f06987927766c0b77cea23e...78a778b23bed9018e56b8573b052ee2117beac46,3,7,1,8,4,2014-09-29 22:31:31,2014-09-28 21:12:26
78a778b23bed9018e56b8573b052ee2117beac46...d5c421f3bd041a78617e3b482807435faf4ca85f,1,3,14,17,2,2014-09-30 12:08:41,2014-09-22 15:46:52
d5c421f3bd041a78617e3b482807435faf4ca85f...bbee0b72f01f23c5dbd61bfbc87b1c662883e157,3,394,0,394,3,2014-09-30 12:08:41,2014-09-18 09:52:42
bbee0b72f01f23c5dbd61bfbc87b1c662883e157...e569a1e07766cf1cefaf20cae17718465ebb1b66,1,202,0,202,1,2014-09-30 12:08:41,2014-09-25 15:53:25
e569a1e07766cf1cefaf20cae17718465ebb1b66...3d18f1de1d12f6093ff807e1178f82fa91b9a53e,1,136,0,136,1,2014-09-30 12:08:41,2014-09-26 12:12:03
3d18f1de1d12f6093ff807e1178f82fa91b9a53e...6354dbac2ec295d31fc72bb5d09258dd83011782,1,3,1,4,1,2014-09-30 18:03:05,2014-09-30 18:03:05
6354dbac2ec295d31fc72bb5d09258dd83011782...068b1d23bb513bfc819de61514262a12cb75bcbb,2,15,9,24,12,2014-09-30 22:03:29,2014-09-30 22:03:29
068b1d23bb513bfc819de61514262a12cb75bcbb...da599844c97ef6d290c03e073a9bafe41c1a914e,38,124,127,251,93,2014-10-01 02:02:04,2014-09-30 13:56:21
da599844c97ef6d290c03e073a9bafe41c1a914e...55097afd011278c9274b778a2bce45b170ba2bab,1,5,1,6,2,2014-10-01 02:40:28,2014-10-01 00:18:39
55097afd011278c9274b778a2bce45b170ba2bab...f9ead899683b5baa7822b448defd0fbdd88c4e1b,1,5,0,5,2,2014-10-01 18:32:38,2014-10-01 18:32:38
f9ead899683b5baa7822b448defd0fbdd88c4e1b...afae7c082b1b4eff8401f660124e161137fe1d2b,7,7,7,14,7,2014-10-01 18:41:55,2014-09-29 21:26:08
afae7c082b1b4eff8401f660124e161137fe1d2b...91ba5436c2681a194bd92fff852b4afca61bdde7,7,7,7,14,7,2014-10-01 18:44:11,2014-10-01 18:44:11
91ba5436c2681a194bd92fff852b4afca61bdde7...a8d2bfcc9b76cef2d133bdd786361efb3fb20e59,9,24,19,43,17,2014-10-01 18:48:12,2014-09-30 13:12:26
a8d2bfcc9b76cef2d133bdd786361efb3fb20e59...937c50950882d1277fd2cd26085a85610cb11702,6,16,20,36,9,2014-10-01 18:54:32,2014-09-29 22:16:19
937c50950882d1277fd2cd26085a85610cb11702...50f15282ae1eefe1ff3bfeb93074e66372235c91,1,6,3,9,2,2014-10-01 18:58:07,2014-09-29 23:03:45
50f15282ae1eefe1ff3bfeb93074e66372235c91...4502654e2ad8d0a9706cd66555c4f97a19507197,4,41,46,87,8,2014-10-01 18:58:07,2014-09-30 17:45:33
4502654e2ad8d0a9706cd66555c4f97a19507197...45044c56a9e459b240f801a84f366acc8c72d004,8,4,726,730,10,2014-10-01 18:58:07,2014-09-29 19:00:15
45044c56a9e459b240f801a84f366acc8c72d004...034525fa60dba5191b6183bb47a5403dcac1e7ef,3,18,17,35,3,2014-10-01 19:18:11,2014-09-26 19:39:24
034525fa60dba5191b6183bb47a5403dcac1e7ef...26ae74c6e9e5ec7c1a9d4715158593d2127e7dad,5,193,110,303,13,2014-10-01 19:18:13,2014-09-30 13:56:10
26ae74c6e9e5ec7c1a9d4715158593d2127e7dad...ab4c908febe7c3b59263522949ee6a33aa40c0ab,5,207,316,523,38,2014-10-01 19:18:14,2014-09-30 13:25:13
ab4c908febe7c3b59263522949ee6a33aa40c0ab...8de392055e1ba38621c695c3d379d87fd74b84a7,10,106,122,228,25,2014-10-01 19:18:16,2014-09-26 16:58:41
8de392055e1ba38621c695c3d379d87fd74b84a7...daddb39d4c445578bf87829785bdbe003edb23f0,2,6,6,12,6,2014-10-01 19:45:47,2014-10-01 19:45:47
8de392055e1ba38621c695c3d379d87fd74b84a7...2481ccd2e79008bece816a585a9748a6f359784c,32,1440,115,1555,82,2014-10-01 19:29:23,2014-09-25 12:56:22
2481ccd2e79008bece816a585a9748a6f359784c...1444aa92f73b878a33f0362819c6c2b780539803,2,128,18,146,25,2014-10-01 19:49:42,2014-09-18 20:43:21
1444aa92f73b878a33f0362819c6c2b780539803...88e79e1b476996bab2582009f4ab5ff7c9fad9f4,2,10,1,11,2,2014-10-01 20:06:13,2014-09-29 20:58:16
88e79e1b476996bab2582009f4ab5ff7c9fad9f4...7960d28a32a2baf3e1305f662a0f26ee4d1a4ef1,1,78,21,99,18,2014-10-01 20:09:59,2014-09-29 22:06:10
7960d28a32a2baf3e1305f662a0f26ee4d1a4ef1...6150677b5cc6d933fd9e26d2efadafb3686033fa,1,4,4,8,4,2014-10-01 20:13:11,2014-09-26 21:04:01
6150677b5cc6d933fd9e26d2efadafb3686033fa...3fac355cd7107d2463404f3a23f5e9519f23c239,1,1,1,2,1,2014-10-01 20:17:44,2014-09-26 18:16:51
fda2309715e556335cfbec7bc27a68d963f2cd2a...f4514b50d9c4d8509c6108b2c17d021c2aee7d82,1,2,7,9,1,2014-10-01 20:22:39,2014-09-30 15:09:53
f4514b50d9c4d8509c6108b2c17d021c2aee7d82...d41c5f3514e41310545dc7ff1cd2d056248f5f75,1,1,1,2,2,2014-10-01 20:24:44,2014-09-30 15:40:52
d41c5f3514e41310545dc7ff1cd2d056248f5f75...ceb9f833b8809bc292c89bc37e42f9abb2e15d3f,3,7,50,57,8,2014-10-01 20:51:15,2014-09-30 15:25:40
ceb9f833b8809bc292c89bc37e42f9abb2e15d3f...017d360814e366b7c2a91b2320b45db49d158358,1,15,10,25,3,2014-10-01 20:51:15,2014-09-30 17:40:43
017d360814e366b7c2a91b2320b45db49d158358...9f4ebf0e4f61a6b64a20f7d400eb34d71fb8ea64,2,9,0,9,3,2014-10-01 20:51:15,2014-09-30 20:18:16
9f4ebf0e4f61a6b64a20f7d400eb34d71fb8ea64...969bdb73f9712bebb44fe56959101914c5e12631,3,54,55,109,10,2014-10-01 20:51:15,2014-09-30 22:36:07
969bdb73f9712bebb44fe56959101914c5e12631...e385b55e0f334bc1639ce9c2b5764cab4ec8de1d,1,6,6,12,6,2014-10-01 20:51:15,2014-09-30 22:38:53
e385b55e0f334bc1639ce9c2b5764cab4ec8de1d...d4d32caffb9135545811769a38c246dab67df917,4,40,34,74,35,2014-10-01 20:54:54,2014-09-30 22:41:53
d4d32caffb9135545811769a38c246dab67df917...222a18ede0fdaf940fc4e018aeca126861d32ea1,1,3,1,4,1,2014-10-01 21:14:44,2014-10-01 19:54:54
222a18ede0fdaf940fc4e018aeca126861d32ea1...78919da3438c114bf14d7a08f0710043910829be,1,1,1,2,1,2014-10-01 21:42:06,2014-10-01 21:42:06
78919da3438c114bf14d7a08f0710043910829be...b1c3d803d97c455c00ffb034296128434f5c7616,2,32,22,54,11,2014-10-01 22:00:30,2014-09-27 07:15:29
b1c3d803d97c455c00ffb034296128434f5c7616...904f6c7ea8bb01b3fbdd87c88c9b8f18bf2490d7,1,2,2,4,2,2014-10-02 00:58:28,2014-10-01 20:26:18
904f6c7ea8bb01b3fbdd87c88c9b8f18bf2490d7...44bb4a871a8e491280019e071e8ef141bcafe955,9,43,19,62,19,2014-10-02 14:29:42,2014-09-24 16:11:37
44bb4a871a8e491280019e071e8ef141bcafe955...a73db159bd39f65e47d405da20da0677696c300b,3,43,17,60,19,2014-10-02 14:45:07,2014-09-29 22:29:55
a73db159bd39f65e47d405da20da0677696c300b...95c3ccb36529db9841abd3a7e876ea66aac69420,15,167,53,220,65,2014-10-02 14:54:37,2014-10-01 14:42:32
95c3ccb36529db9841abd3a7e876ea66aac69420...354c86d3467e6c6eaec1e91a76bc18b21a510637,1,1,1,2,1,2014-10-02 15:32:14,2014-09-29 14:21:16
354c86d3467e6c6eaec1e91a76bc18b21a510637...706110ef69e9700536fca375b6c746037e2172a5,4,147,109,256,9,2014-10-02 15:55:42,2014-10-02 13:22:21
706110ef69e9700536fca375b6c746037e2172a5...49bc350c5a32280480f186c53c7ee759ce3446b8,3,169,148,317,46,2014-10-02 15:55:43,2014-09-30 19:15:27
49bc350c5a32280480f186c53c7ee759ce3446b8...cecd33c23d3a47b936aa1d50ecfe9b02abea8a31,11,109,79,188,56,2014-10-02 16:57:09,2014-09-26 19:03:51
cecd33c23d3a47b936aa1d50ecfe9b02abea8a31...8f349cc6f6c3904aeaede2d0779a476b8c6df448,1,1,0,1,1,2014-10-02 17:20:10,2014-10-02 17:20:05
8f349cc6f6c3904aeaede2d0779a476b8c6df448...84220a31cdcda093347dea33fce56bcfdc4fe9ed,1,1,0,1,1,2014-10-02 17:20:34,2014-10-02 17:14:39
84220a31cdcda093347dea33fce56bcfdc4fe9ed...cfddfb4b976a38a23f319abae6021c5864fa16d9,8,131,136,267,58,2014-10-02 17:29:46,2014-09-29 18:26:40
cfddfb4b976a38a23f319abae6021c5864fa16d9...4485b41323100ade5e1f1ac2a8b2f4c8b6f4597b,5,47,48,95,16,2014-10-02 18:13:19,2014-09-29 22:01:24
4485b41323100ade5e1f1ac2a8b2f4c8b6f4597b...cd8e0f0f67aa6d05d769d692df614fa00fadf2e9,8,42,9,51,15,2014-10-02 18:13:19,2014-10-01 22:23:45
cd8e0f0f67aa6d05d769d692df614fa00fadf2e9...1063946b2e1da20323f7094fc6b20341265a1d36,10,39,26,65,19,2014-10-02 18:13:19,2014-09-29 19:23:35
1063946b2e1da20323f7094fc6b20341265a1d36...27285ea794c278f056b59c02b04455c273d329a6,4,10,10,20,7,2014-10-02 18:44:36,2014-09-24 23:01:09
27285ea794c278f056b59c02b04455c273d329a6...d06de8e3e1846385c181b326dc57cb7d2efc3f7b,1,0,9,9,1,2014-10-02 18:44:36,2014-10-02 16:48:11
d06de8e3e1846385c181b326dc57cb7d2efc3f7b...76bdc368ab62f4341fd9c24928ab8af80f7130d3,1,10,10,20,8,2014-10-02 18:45:07,2014-10-01 22:56:12
76bdc368ab62f4341fd9c24928ab8af80f7130d3...ff2e3734f1dd4f3e9b3bd6b6349fb9d56801debc,3,29,4,33,7,2014-10-02 19:16:01,2014-10-01 00:26:32
ff2e3734f1dd4f3e9b3bd6b6349fb9d56801debc...795462cb686806b662d3171bd34a00a5813a73a8,16,3972,2,3974,19,2014-10-02 19:57:23,2014-10-02 17:23:02
795462cb686806b662d3171bd34a00a5813a73a8...2aac310f11bacb54d3339700171e08d73200a456,29,145,31,176,34,2014-10-02 20:08:47,2014-10-02 16:47:38
2aac310f11bacb54d3339700171e08d73200a456...cdaaee889078443b0363afe4e78780b059926c4a,1,2,2,4,1,2014-10-02 20:14:19,2014-09-26 17:48:19
cdaaee889078443b0363afe4e78780b059926c4a...3658d018951b99b010b5b1086bd40a872dc2d1ba,2,0,2,2,2,2014-10-02 20:16:57,2014-10-02 17:19:43
3658d018951b99b010b5b1086bd40a872dc2d1ba...9d4c1fcfcf44890d9150a64cd2d7e106d4857780,2,11,3,14,5,2014-10-02 20:16:57,2014-10-02 17:23:02
9d4c1fcfcf44890d9150a64cd2d7e106d4857780...111621fed826b9ef5e18f511198104a6a872f964,1,13,8,21,1,2014-10-02 20:16:57,2014-10-02 17:25:02
111621fed826b9ef5e18f511198104a6a872f964...0a4f71b28243627ed868139e9bf4286fcc661fd4,3,13,25,38,8,2014-10-02 20:16:57,2014-10-02 17:55:38
0a4f71b28243627ed868139e9bf4286fcc661fd4...979ecb0f952117e3453409d8a889b77e342ed1c3,1,3,0,3,1,2014-10-02 20:16:57,2014-10-02 18:01:47
979ecb0f952117e3453409d8a889b77e342ed1c3...30b1d49b30fb3b4892fcec836cd221fe52fd5f38,1,9,8,17,7,2014-10-02 22:01:58,2014-10-02 19:25:53
30b1d49b30fb3b4892fcec836cd221fe52fd5f38...c9ae1354004e5767c45160b4efa7ad77d0185c0d,8,131,21,152,11,2014-10-02 22:02:46,2014-10-01 22:51:09
c9ae1354004e5767c45160b4efa7ad77d0185c0d...53155bb8e0df7b3ef0742eae6edea0d91a046361,6,83,2,85,10,2014-10-02 23:36:18,2014-09-30 14:57:02
53155bb8e0df7b3ef0742eae6edea0d91a046361...b7ee010b720d6176b7fba888594660402c9fb3f9,1,0,8,8,2,2014-10-03 04:42:23,2014-10-03 01:08:48
b7ee010b720d6176b7fba888594660402c9fb3f9...83a9b2f590ca17de90c7020ab2fc4020ff0954b9,41,244,114,358,155,2014-10-03 11:11:10,2014-10-02 15:23:23
83a9b2f590ca17de90c7020ab2fc4020ff0954b9...68bdc94707b4541cf20a92d5460c08301c54fa45,1,13,0,13,2,2014-10-03 11:11:10,2014-10-02 18:04:09
68bdc94707b4541cf20a92d5460c08301c54fa45...486862465517d1bf25e07dbb2c3cfc990fb08c80,13,10,134,144,22,2014-10-03 12:30:19,2014-09-29 17:33:28
486862465517d1bf25e07dbb2c3cfc990fb08c80...69b34ef4b9fb1d7c3da37d62badc8b19b5757253,1,2,2,4,2,2014-10-03 13:07:41,2014-10-03 13:07:41
69b34ef4b9fb1d7c3da37d62badc8b19b5757253...d7a1df26287a4f0e0cfbf842a7c6257bc44e4567,32,4163,124,4287,69,2014-10-03 14:53:17,2014-09-23 00:10:24
d7a1df26287a4f0e0cfbf842a7c6257bc44e4567...f2d504cd0fcbcff26e74415978696d8218cccb6a,2,78,79,157,5,2014-10-03 09:52:03,2014-09-26 17:18:30
f2d504cd0fcbcff26e74415978696d8218cccb6a...3753203ee8f30b0fff306da8f48ce7783911d858,1,229,0,229,1,2014-10-03 09:52:03,2014-09-29 16:06:12
3753203ee8f30b0fff306da8f48ce7783911d858...f0c5c92945f4f41258e706ce16f8fd194c807fa0,1,125,0,125,1,2014-10-03 09:52:03,2014-09-25 13:25:31
f0c5c92945f4f41258e706ce16f8fd194c807fa0...71684103d19a121b03b6ef3e1e9a8564f013039d,1,165,0,165,1,2014-10-03 09:52:03,2014-10-01 14:21:31
71684103d19a121b03b6ef3e1e9a8564f013039d...815a90e21644f1655b1efd012581dac19babe575,1,244,4,248,3,2014-10-03 09:52:04,2014-10-02 11:56:22
815a90e21644f1655b1efd012581dac19babe575...f24551951e5513274a7875ebc799d41de838f6ac,2,10,2,12,3,2014-10-03 15:24:49,2014-07-30 21:34:46
f24551951e5513274a7875ebc799d41de838f6ac...fd1cbaccc7d4f3ff99e3518dfe57fe426e0c11c5,1,1,2,3,1,2014-10-03 13:29:33,2014-10-03 13:14:43
fd1cbaccc7d4f3ff99e3518dfe57fe426e0c11c5...d32dc5f88567b11eb503a8343cb8b4b3d8c68c76,9,803,668,1471,162,2014-10-03 19:20:30,2014-10-03 19:16:29
d32dc5f88567b11eb503a8343cb8b4b3d8c68c76...e0509e511bdbac2329d32a7238b51cd6b5ddd591,9,233,230,463,34,2014-10-03 19:39:19,2014-10-02 20:17:25
e0509e511bdbac2329d32a7238b51cd6b5ddd591...cb3fa9c396f63c58dcb26873ce58631e981c3f74,1,16,3,19,3,2014-10-03 19:43:59,2014-10-03 14:09:13
cb3fa9c396f63c58dcb26873ce58631e981c3f74...90768c7a1129bb08d8bfca4840f53d33c96a0183,4,113,97,210,57,2014-10-03 19:47:52,2014-10-01 15:50:00
90768c7a1129bb08d8bfca4840f53d33c96a0183...524c7648150bf03ae37fa65d91684856a4d1e683,5,218,134,352,5,2014-10-03 19:47:53,2014-10-03 17:28:48
524c7648150bf03ae37fa65d91684856a4d1e683...42319125ecc29f0741bedbf5d55ac50babb13fc0,1,1,1,2,1,2014-10-03 20:24:01,2014-10-03 20:23:35
42319125ecc29f0741bedbf5d55ac50babb13fc0...9638e648cef939532fc883d01af8864538a3c1c4,20,326,66,392,71,2014-10-03 20:54:15,2014-09-30 20:47:45
9638e648cef939532fc883d01af8864538a3c1c4...6d8ef4551dfb1e76b480602e8f1d6224656e5841,1,1,1,2,1,2014-10-03 21:18:41,2014-10-03 21:18:41
6d8ef4551dfb1e76b480602e8f1d6224656e5841...f2daf8addd4ef391c135a3da2a1472777405ba06,37,122,119,241,88,2014-10-03 21:25:41,2014-10-03 21:25:41
f2daf8addd4ef391c135a3da2a1472777405ba06...17f2ca21417a866e03c405196f03e9e1faceb0fb,16,1678,7,1685,23,2014-10-06 13:32:22,2014-10-06 13:32:22
17f2ca21417a866e03c405196f03e9e1faceb0fb...30e83ae549e944453afe3c68eccf89ae865c0559,2,11,0,11,4,2014-10-06 13:58:13,2014-09-25 15:36:23
30e83ae549e944453afe3c68eccf89ae865c0559...f21946189b0e0bde8cdf5c2a4f2224e88a95ae75,11,236,141,377,124,2014-10-06 13:58:13,2014-09-29 22:26:18
f21946189b0e0bde8cdf5c2a4f2224e88a95ae75...7f8634d97d39615970bc1b31c37c31e7f3e25f27,1,12,4,16,2,2014-10-06 14:55:50,2014-10-03 01:59:26
7f8634d97d39615970bc1b31c37c31e7f3e25f27...5363f0b64b80735f1e17154f21835650fe6ae887,5,21,3,24,5,2014-10-06 15:42:59,2014-10-03 20:46:48
5363f0b64b80735f1e17154f21835650fe6ae887...33c65901a5814298482d58005c5f83f013c28319,11,613,292,905,74,2014-10-06 16:14:11,2014-09-30 22:40:08
33c65901a5814298482d58005c5f83f013c28319...53bf1072c4aaf1537c05afe82d48fb5e8e072395,2,33,1,34,2,2014-10-06 16:38:16,2014-09-26 18:02:08
53bf1072c4aaf1537c05afe82d48fb5e8e072395...434f8fc1cfc364d40e2bb7df742412a58c5907ae,2,6,5,11,5,2014-10-06 16:38:16,2014-09-26 18:37:08
434f8fc1cfc364d40e2bb7df742412a58c5907ae...72ec4fc892e07a4c3543ffeb43f85c718ec18a45,1,81,83,164,14,2014-10-06 17:37:27,2014-10-02 17:30:51
72ec4fc892e07a4c3543ffeb43f85c718ec18a45...203a02ca8f8581379c4cde74a06e4a81daaccc96,5,96,74,170,20,2014-10-06 17:48:30,2014-10-03 18:15:01
203a02ca8f8581379c4cde74a06e4a81daaccc96...97243d61a12e8147de7824ae91c620a49716ccd1,2,31,16,47,7,2014-10-06 18:12:23,2014-10-06 17:54:41
97243d61a12e8147de7824ae91c620a49716ccd1...ab4b43b75c42ce894b01043b8f82a5a9d070419c,16,2119,1572,3691,311,2014-10-06 18:15:09,2014-09-29 21:45:58
ab4b43b75c42ce894b01043b8f82a5a9d070419c...af7bd821ac444f7b733545ad9d26e860c7f6b978,3,22,7,29,9,2014-10-06 18:15:09,2014-09-29 22:35:00
af7bd821ac444f7b733545ad9d26e860c7f6b978...8403d2fc99e3d050466b1f188fba87392ccaa063,6,75,76,151,23,2014-10-06 18:15:09,2014-09-29 22:41:54
8403d2fc99e3d050466b1f188fba87392ccaa063...5f0918f1e83eb48f5855df806f7b911029a6aa5c,20,1168,558,1726,177,2014-10-06 18:19:18,2014-09-30 14:54:01
5f0918f1e83eb48f5855df806f7b911029a6aa5c...16e60add532618efe9f24d2325864e43ed629c8d,3,261,3,264,23,2014-10-06 19:13:53,2014-10-03 23:12:57
16e60add532618efe9f24d2325864e43ed629c8d...7ede29f22efe1558d75dce5a3cfec9eb1274f380,2,130,1,131,3,2014-10-06 19:13:53,2014-09-30 14:54:21
7ede29f22efe1558d75dce5a3cfec9eb1274f380...01541f27ca75a12899a7d5123678ba59214fb24e,3,4,5,9,3,2014-10-06 19:13:53,2014-10-06 18:56:49
01541f27ca75a12899a7d5123678ba59214fb24e...68c3943b92a121441f59bc093d26a08b48658acc,1,1,1,2,1,2014-10-06 19:25:24,2014-10-06 19:25:24
68c3943b92a121441f59bc093d26a08b48658acc...6e798143930d153398e5062d41069fe472474d2f,1,33,26,59,17,2014-10-06 20:34:12,2014-10-06 20:34:00
6e798143930d153398e5062d41069fe472474d2f...377fa406a1c3cadbf37dc58369ff19de74e1cfc5,1,2,2,4,1,2014-10-06 16:11:46,2014-10-06 16:07:42
377fa406a1c3cadbf37dc58369ff19de74e1cfc5...10c86dc6cad9853514148e0ab59894a0d29353b9,1,6,3,9,3,2014-10-06 21:29:53,2014-10-06 13:58:14
10c86dc6cad9853514148e0ab59894a0d29353b9...101e026f45dea5e9e68520238495c89a476e6172,87,738,657,1395,348,2014-10-06 21:30:12,2014-09-26 18:02:49
101e026f45dea5e9e68520238495c89a476e6172...39bdeb3268493f9a56ad688d64d9d0273ba31ad7,2,54,12,66,15,2014-10-06 23:18:12,2014-10-06 22:20:05
39bdeb3268493f9a56ad688d64d9d0273ba31ad7...47e6a29b3b1dc119afb15d1597d506031ba760ab,2,35,17,52,10,2014-10-07 02:07:39,2014-10-07 01:04:23
47e6a29b3b1dc119afb15d1597d506031ba760ab...eb1c412bf2a5dfe922edd6d719112e8f8da542a5,2,16,2,18,2,2014-10-07 02:56:10,2014-10-07 02:56:10
eb1c412bf2a5dfe922edd6d719112e8f8da542a5...2cb1691a38fcb83f7740b80eedfa2fe61c13d404,3,299,6,305,6,2014-10-07 03:08:57,2014-10-07 01:11:18
2cb1691a38fcb83f7740b80eedfa2fe61c13d404...d569947ba69e19c90880d59924c3feef6a60d29e,1,12,85,97,13,2014-10-07 12:47:06,2014-10-07 12:47:06
d569947ba69e19c90880d59924c3feef6a60d29e...603fe8a3bae0d7db1af1ff639c1e3998c08e32de,1,0,12,12,12,2014-10-07 13:49:22,2014-10-07 13:49:22
603fe8a3bae0d7db1af1ff639c1e3998c08e32de...80baa49b5dff32bc0eebdfb2ab07d057126dea8d,1,5,4,9,5,2014-10-07 13:55:29,2014-10-01 15:41:52
80baa49b5dff32bc0eebdfb2ab07d057126dea8d...30bca9250f6a02a6579b002c61178b36929fb4f1,1,6,1,7,1,2014-10-07 09:04:47,2014-10-06 09:29:47
30bca9250f6a02a6579b002c61178b36929fb4f1...798d3672d24767f9b91adad9afa3d252f8221086,1,2,3,5,1,2014-10-07 09:04:47,2014-10-06 09:12:14
798d3672d24767f9b91adad9afa3d252f8221086...64f8c8c82fc0bb109abf561301360d9a61b9825d,11,41,67,108,17,2014-10-07 14:35:54,2014-10-03 14:40:07
64f8c8c82fc0bb109abf561301360d9a61b9825d...f632c399481ec6e2eb5e794a63b7c6cf1b429281,1,10,3,13,2,2014-10-07 14:36:27,2014-10-06 22:12:25
f632c399481ec6e2eb5e794a63b7c6cf1b429281...92c176145ba3b8d204d5a35c98017df48969977c,1,34,2,36,2,2014-10-07 14:38:20,2014-10-07 01:07:12
92c176145ba3b8d204d5a35c98017df48969977c...eca7242b055a618ae44835d59a4f75b2d3ae6cba,3,11,8,19,8,2014-10-07 14:42:02,2014-10-02 18:16:41
eca7242b055a618ae44835d59a4f75b2d3ae6cba...4650dc8ef7c078c82e9d7f63a79e2d63eb27c0df,1,1,3,4,2,2014-10-07 15:09:02,2014-10-07 14:41:39
4650dc8ef7c078c82e9d7f63a79e2d63eb27c0df...f522d0cbcb59d6f5d27c100ac20518aef0bbf98e,7,199,214,413,129,2014-10-07 15:46:26,2014-10-06 23:17:59
f522d0cbcb59d6f5d27c100ac20518aef0bbf98e...c4f1421ec0e64832f7d79c5bcd624a8cf93452d9,1,1,0,1,1,2014-10-07 16:01:02,2014-10-07 14:46:51
c4f1421ec0e64832f7d79c5bcd624a8cf93452d9...2b7b105b3c26bc779d30d3c7ec4b93a0115569a8,8,40,27,67,17,2014-10-07 16:01:03,2014-10-07 16:00:20
2b7b105b3c26bc779d30d3c7ec4b93a0115569a8...59deabf9a55140fa502e637058983d67118e3722,1,64,0,64,4,2014-10-07 17:11:30,2014-10-06 20:19:33
59deabf9a55140fa502e637058983d67118e3722...c5264241a860d588edbeb352f64507e688126a12,2,5,4,9,3,2014-10-07 18:22:14,2014-10-06 20:03:16
c5264241a860d588edbeb352f64507e688126a12...863423d8cfa45a0420d8139a808cb61536a77d8b,3,16,0,16,4,2014-10-07 18:22:15,2014-10-06 21:51:35
863423d8cfa45a0420d8139a808cb61536a77d8b...32336789f167dc537091e6a44e90854dc2b39c9b,1,1,1,2,2,2014-10-07 19:35:52,2014-10-07 13:23:44
32336789f167dc537091e6a44e90854dc2b39c9b...d4d7067f56562d093da48fa42230ca62caf3e6a8,1,4,0,4,1,2014-10-07 19:50:24,2014-10-07 15:32:04
d4d7067f56562d093da48fa42230ca62caf3e6a8...19142324b23e417093ae05a622babae3d31140b4,1,1,2,3,1,2014-10-07 19:51:56,2014-10-07 19:49:23
19142324b23e417093ae05a622babae3d31140b4...74d2eb735f8516a027f37470c654e37aac6b438c,1,12,2,14,5,2014-10-07 21:25:20,2014-10-07 20:27:42
74d2eb735f8516a027f37470c654e37aac6b438c...137dfce686e37bdefe337027a8710d58e8ca25d3,1,5,4,9,4,2014-10-07 21:25:34,2014-10-07 20:30:51
137dfce686e37bdefe337027a8710d58e8ca25d3...fadb421441f411f9e3e9c7de6a0716140c35a606,1,12,2,14,2,2014-10-07 21:27:17,2014-10-07 21:18:40
fadb421441f411f9e3e9c7de6a0716140c35a606...3dc01f82dd8b49377fbedfbceb3ae2f92f1e39e7,7,0,58,58,7,2014-10-07 21:45:34,2014-10-07 18:17:30
3dc01f82dd8b49377fbedfbceb3ae2f92f1e39e7...cbaa407af054f9e3de3e82ea0225069a43a6c462,1,10,10,20,5,2014-10-07 21:47:04,2014-10-07 20:14:32
cbaa407af054f9e3de3e82ea0225069a43a6c462...6ee32c70ab5029e43d502a3203362b82fb8d7732,1,6,3,9,3,2014-10-07 17:11:58,2014-10-07 17:11:58
6ee32c70ab5029e43d502a3203362b82fb8d7732...49e0c8c825fc54f69cf0eca3215a3abd9a860671,5,158,137,295,105,2014-10-07 22:52:36,2014-10-07 21:21:20
49e0c8c825fc54f69cf0eca3215a3abd9a860671...b95adf31a0dd25dd2fcc6a13b841415dbdfdbd9b,9,199,621,820,11,2014-10-07 23:49:27,2014-10-07 18:21:49
b95adf31a0dd25dd2fcc6a13b841415dbdfdbd9b...157d2fd21277e0fc3f0259d08da5e15541a1ffb2,3,175,24,199,15,2014-10-08 00:04:40,2014-09-29 19:03:57
157d2fd21277e0fc3f0259d08da5e15541a1ffb2...01b08ba307425fa3a02d029439a0599e1ecd4a70,2,7,77,84,7,2014-10-08 00:50:53,2014-10-07 23:55:02
01b08ba307425fa3a02d029439a0599e1ecd4a70...5e46ce21ff9f5b8034f6f7828c2b817cdaee9bad,3,5,5,10,4,2014-10-08 01:47:01,2014-10-07 20:31:25
5e46ce21ff9f5b8034f6f7828c2b817cdaee9bad...6282f86e966b58cce4eab9403ff428118ae0ad0a,21,2667,2,2669,23,2014-10-08 02:18:50,2014-10-08 02:18:50
29916fe84d118c752ab876eccff2d3fc3a7f6c4a...d55cb345073d1a5954ca28c92cf1acbdf9c03a67,1,14,17,31,6,2014-10-08 03:50:03,2014-10-07 22:06:11
d55cb345073d1a5954ca28c92cf1acbdf9c03a67...ef1e44bc44a0a0f25bb68e8b2f5da5b1217e0da3,2,4,3,7,4,2014-10-08 03:50:03,2014-10-07 22:06:23
ef1e44bc44a0a0f25bb68e8b2f5da5b1217e0da3...341ba88e426eb41685c0599fad91af4d73992f16,1,1,0,1,1,2014-10-08 06:00:45,2014-10-08 06:00:45
341ba88e426eb41685c0599fad91af4d73992f16...c46e86610205985ae9744685e62fe269e03835e1,1,2,27,29,2,2014-10-08 12:17:03,2014-10-07 18:17:02
c46e86610205985ae9744685e62fe269e03835e1...4b033ae930afded6677c19022341241935992b33,52,10,8704,8714,59,2014-10-08 12:29:27,2014-10-07 23:48:14
4b033ae930afded6677c19022341241935992b33...f3bc8b409dd6253a2aac2a768a86606ec7b8019d,6,218,79,297,19,2014-10-08 14:04:53,2014-10-07 15:21:28
f3bc8b409dd6253a2aac2a768a86606ec7b8019d...686dd80d07ea82dc2b62a6149e14ca6139e296c1,1,5,3,8,3,2014-10-08 15:09:30,2014-10-08 14:57:45
686dd80d07ea82dc2b62a6149e14ca6139e296c1...8b8e90fbe6bf97990f6997a576acfa2828867bec,1,2,1,3,2,2014-10-08 15:14:20,2014-10-08 14:32:48
8b8e90fbe6bf97990f6997a576acfa2828867bec...ada278dd2f72981789d1151a6e419f1cce4872e6,2,31,10,41,3,2014-10-08 15:18:22,2014-10-07 22:40:52
ada278dd2f72981789d1151a6e419f1cce4872e6...38e7e25e2852323e4ce50c3d6d5ac5cdeb3df2a6,1,0,73,73,1,2014-10-08 15:28:21,2014-10-08 15:28:21
38e7e25e2852323e4ce50c3d6d5ac5cdeb3df2a6...542636dc794e160a6c4ac5d9a6a6bddaac21266c,1,2,0,2,2,2014-10-08 16:08:48,2014-10-08 12:24:03
542636dc794e160a6c4ac5d9a6a6bddaac21266c...498ab43ec9f0e2ec27375d669346cedb0c133419,1,1,1,2,1,2014-10-08 16:19:16,2014-10-08 03:26:49
498ab43ec9f0e2ec27375d669346cedb0c133419...b6c8a43ab9e29443d175e8e22d94936b6205dba8,1,1,0,1,1,2014-10-08 17:19:55,2014-10-08 14:00:00
b6c8a43ab9e29443d175e8e22d94936b6205dba8...d49e557e17539db01c4f6475d431dea0be7e6702,1,1,0,1,1,2014-10-08 17:19:55,2014-10-08 14:04:15
d49e557e17539db01c4f6475d431dea0be7e6702...f852fd7474b44de5c33e0a7324c107fc1456da74,3,14,17,31,14,2014-10-08 17:19:55,2014-10-08 14:10:25
f852fd7474b44de5c33e0a7324c107fc1456da74...4346c2eda534e7fc7a47ce201c2a3c1a76448e51,2,10,1,11,3,2014-10-08 17:19:55,2014-10-08 16:45:59
4346c2eda534e7fc7a47ce201c2a3c1a76448e51...51aebc9b94c272eb251ff94d28be0c6fdd180de8,1,6,0,6,1,2014-10-08 17:26:27,2014-10-08 17:26:27
51aebc9b94c272eb251ff94d28be0c6fdd180de8...80cc8ba4a5b78d65a6366e209b5e694de6d654a0,5,116,6,122,7,2014-10-08 18:33:57,2014-10-07 22:27:33
80cc8ba4a5b78d65a6366e209b5e694de6d654a0...314c8b8f6b2d92c25175a2450ce02215d1f02d78,7,131,11,142,9,2014-10-08 18:33:57,2014-09-16 16:35:41
314c8b8f6b2d92c25175a2450ce02215d1f02d78...0ea1e3ebd933d85322463af5f55873b14bff0fd6,1,2,1,3,1,2014-10-08 19:15:04,2014-10-08 17:31:01
0ea1e3ebd933d85322463af5f55873b14bff0fd6...f3d6d0307abf979d0e54624e8797d9f5e7c16c89,3,29,13,42,17,2014-10-08 19:17:01,2014-10-08 16:26:03
f3d6d0307abf979d0e54624e8797d9f5e7c16c89...2eb2944b39fc9812b9e6279bd2a924917e6c57d4,2,7,3,10,4,2014-10-08 19:22:39,2014-10-08 18:04:18
2eb2944b39fc9812b9e6279bd2a924917e6c57d4...91a81ef954f3a04b0d4dd9f5df9f6a2c38049938,13,365,176,541,113,2014-10-08 19:44:36,2014-09-17 20:02:23
91a81ef954f3a04b0d4dd9f5df9f6a2c38049938...7e910c8c2f6b24715e40a222f5c0c77be13ebf89,1,115,9,124,7,2014-10-08 19:49:37,2014-09-10 19:13:47
7e910c8c2f6b24715e40a222f5c0c77be13ebf89...28e2d57f58dd87e6943a8a3a7d88ff2fb9025f1d,2,5,8,13,4,2014-10-08 20:34:01,2014-10-08 20:34:01
28e2d57f58dd87e6943a8a3a7d88ff2fb9025f1d...8909ec848e81b67a2a53913cdb0c0e20cb61a383,1,1,1,2,1,2014-10-08 21:13:43,2014-10-08 21:13:43
8909ec848e81b67a2a53913cdb0c0e20cb61a383...b8b905ba5369df65a752b47408327367737d4bde,1,8,5,13,4,2014-10-08 21:18:53,2014-10-08 20:50:56
b8b905ba5369df65a752b47408327367737d4bde...738c83f6671178e663cef0c3f548f5a046039cc9,13,6,3020,3026,18,2014-10-08 21:38:06,2014-10-06 21:40:01
738c83f6671178e663cef0c3f548f5a046039cc9...0a7a02fda732db87515cd90a7c8689a1344fe311,4,145,101,246,22,2014-10-08 21:38:07,2014-10-07 22:03:15
0a7a02fda732db87515cd90a7c8689a1344fe311...04632cdca53264454d367190b49530068bdf8d1f,3,19,17,36,4,2014-10-08 22:14:53,2014-10-08 19:39:18
04632cdca53264454d367190b49530068bdf8d1f...bc8c4b81164c17f95d01262e6aeb22f934e5ed8f,2,3,3,6,3,2014-10-08 22:16:16,2014-10-08 21:15:26
bc8c4b81164c17f95d01262e6aeb22f934e5ed8f...2eaa2d50def6702f5df83ec5ab97e92c3dc8b476,6,22,2,24,9,2014-10-09 13:29:08,2014-10-09 13:09:39
2eaa2d50def6702f5df83ec5ab97e92c3dc8b476...1c9d735cc6d439eb1b5e0b8f92c81d0b88b53a53,9,134,177,311,44,2014-10-09 14:28:20,2014-10-09 14:28:20
1c9d735cc6d439eb1b5e0b8f92c81d0b88b53a53...6eb296a66e1f71f12d5483b7144f96d506b055a3,3,57,49,106,30,2014-10-09 15:51:52,2014-10-08 18:28:16
6eb296a66e1f71f12d5483b7144f96d506b055a3...55d441c951d4f31b2c9b21262897090e6f06c444,1,1,0,1,1,2014-10-09 17:10:10,2014-10-09 17:10:10
55d441c951d4f31b2c9b21262897090e6f06c444...847a58e019c109db357c95c78e17ae9aca1c81b7,1,0,6,6,2,2014-10-09 17:50:12,2014-10-08 17:33:48
847a58e019c109db357c95c78e17ae9aca1c81b7...aa7c6f168bb33ce2be2b00591a7030f3fcece9d0,1,8,6,14,6,2014-10-09 17:53:31,2014-10-08 19:43:17
aa7c6f168bb33ce2be2b00591a7030f3fcece9d0...1fd34b27cb18ed90996910058a85ec2d303d4259,4,78,19,97,22,2014-10-09 18:02:52,2014-10-09 15:14:19
1fd34b27cb18ed90996910058a85ec2d303d4259...8ab453860b9e4f5dda820bf0c87e51f18db2b467,2,4,17,21,3,2014-10-09 13:03:27,2014-10-08 13:58:27
8ab453860b9e4f5dda820bf0c87e51f18db2b467...2e8ffa26dcc7918f45dd7a3dd17e588aba2d87c0,3,57,2,59,6,2014-10-09 13:03:27,2014-10-03 14:40:00
2e8ffa26dcc7918f45dd7a3dd17e588aba2d87c0...1ab6fa5f261fb5233d1592ed5b40a7eefd3bd10a,1,5,0,5,1,2014-10-09 18:47:40,2014-10-09 18:40:41
1ab6fa5f261fb5233d1592ed5b40a7eefd3bd10a...ff94c06cbdbfb6e0c1cd290a0ffa3989a6f68306,1,0,0,0,0,2014-10-09 19:12:23,2014-10-08 19:24:28
ff94c06cbdbfb6e0c1cd290a0ffa3989a6f68306...8ef589d359bcb57db83c5d53f1608afbf5b79a01,1,1,0,1,1,2014-10-09 19:16:41,2014-10-09 19:16:41
8ef589d359bcb57db83c5d53f1608afbf5b79a01...3a2d8919f1ddafc5804553bfbff0e2df7ddd8010,1,0,45,45,1,2014-10-09 20:44:17,2014-10-09 14:49:42
3a2d8919f1ddafc5804553bfbff0e2df7ddd8010...93829e370a5542115188edbae105dd7a946e285f,1,98,52,150,31,2014-10-09 20:44:22,2014-10-09 19:15:20
93829e370a5542115188edbae105dd7a946e285f...ff10cf8c748997338f51de2de61520e17518758c,2,5,1,6,2,2014-10-09 20:50:18,2014-10-09 20:44:11
ff10cf8c748997338f51de2de61520e17518758c...5ea4221f81e7af9272e4e687d516bb439ef29498,55,324,279,603,185,2014-10-09 22:21:06,2014-10-07 16:13:21
5ea4221f81e7af9272e4e687d516bb439ef29498...30bfed3cdffacdea94b15eb60b83cbb77ea338cd,2,46,5,51,10,2014-10-09 23:06:35,2014-10-09 23:01:11
30bfed3cdffacdea94b15eb60b83cbb77ea338cd...96a93a971680c9bff6c2febaf11fd5a58f3c775f,5,332,0,332,6,2014-10-10 03:18:09,2014-10-08 20:24:11
96a93a971680c9bff6c2febaf11fd5a58f3c775f...8264ef20b0d542ae441d17349c6e5f0829489649,3,67,28,95,16,2014-10-10 12:44:00,2014-10-08 14:31:09
8264ef20b0d542ae441d17349c6e5f0829489649...a91d9aa82a29fea32c89cf15713bd6bc5a51fe19,3,0,16,16,3,2014-10-10 13:11:42,2014-10-10 13:08:45
a91d9aa82a29fea32c89cf15713bd6bc5a51fe19...b585cefc1450e773fb8e3134685a63793ccae4be,2,23,1,24,2,2014-10-10 13:20:27,2014-10-09 18:23:06
b585cefc1450e773fb8e3134685a63793ccae4be...9743c371dbe1cf62176c8a16e86d86391b0e590b,1,1,1,2,1,2014-10-10 13:24:41,2014-10-10 04:32:49
9743c371dbe1cf62176c8a16e86d86391b0e590b...3e4e3d5eaf33924019a9d4407e2e213e026d7fde,2,33,3,36,2,2014-10-10 13:27:24,2014-10-09 21:04:47
3e4e3d5eaf33924019a9d4407e2e213e026d7fde...176ca19bb50b8d4446dce812b8587e9df7e7a598,1,42,28,70,7,2014-10-10 13:38:34,2014-10-10 01:59:59
176ca19bb50b8d4446dce812b8587e9df7e7a598...7257da6cabc3da92623031a9c37752ea7ab75da8,6,101,129,230,30,2014-10-10 13:40:21,2014-10-09 18:17:15
7257da6cabc3da92623031a9c37752ea7ab75da8...b179fa1eab1bc79be8562349ca6f43283f16ecc7,3,6,1,7,3,2014-10-10 13:47:38,2014-10-10 13:46:45
b179fa1eab1bc79be8562349ca6f43283f16ecc7...eb3435c25eabc90e2c4ff7c331c94c4c222d0b7e,11,84,33,117,29,2014-10-10 13:55:13,2014-10-07 20:59:05
eb3435c25eabc90e2c4ff7c331c94c4c222d0b7e...42df1b57c337917be42afca60319afec198114bb,1,9,9,18,9,2014-10-10 10:21:55,2014-10-09 17:37:07
42df1b57c337917be42afca60319afec198114bb...9d0f6650eff7c1e467a55d01ceb9e425eb86e7c6,8,328,274,602,105,2014-10-10 15:38:33,2014-10-07 18:09:12
9d0f6650eff7c1e467a55d01ceb9e425eb86e7c6...fd09fb0f37c24c99d6c6b605702d580ace6a4250,1,113,114,227,28,2014-10-10 15:49:19,2014-10-08 23:16:33
fd09fb0f37c24c99d6c6b605702d580ace6a4250...c868a14dfa6d1a926f38795a1273a7146cef6e77,59,203,220,423,164,2014-10-10 15:49:21,2014-10-10 12:54:46
c868a14dfa6d1a926f38795a1273a7146cef6e77...2633025a73d8793d91d0049f4b5fafb26e22feb3,8,52,61,113,52,2014-10-10 15:49:21,2014-10-10 13:03:23
2633025a73d8793d91d0049f4b5fafb26e22feb3...391a0e1860b1c85ace0f049478ae44cdb9d60000,1,0,52,52,1,2014-10-10 15:54:39,2014-10-10 13:16:54
391a0e1860b1c85ace0f049478ae44cdb9d60000...07a1b1927817560e891546618747d9c143116b6e,1,2,1,3,1,2014-10-10 15:54:39,2014-10-10 13:26:50
07a1b1927817560e891546618747d9c143116b6e...20fcd6843576b9f9fea40f978898687495478963,1,2,1,3,2,2014-10-10 15:54:39,2014-10-10 13:33:01
20fcd6843576b9f9fea40f978898687495478963...6e26c772ad50ae07d4143ee4e5b182ac4cf57bb1,1,2,2,4,2,2014-10-10 15:54:39,2014-10-10 15:27:02
6e26c772ad50ae07d4143ee4e5b182ac4cf57bb1...a601b18a069775ac38bb42ff3a0f1446b83eb99a,2,21,14,35,12,2014-10-10 16:55:06,2014-10-08 22:08:48
a601b18a069775ac38bb42ff3a0f1446b83eb99a...538bc36bfb6fde34d50e5c196c5c30d2e8ccaf71,3,16,32,48,6,2014-10-10 17:17:31,2014-10-09 21:38:45
538bc36bfb6fde34d50e5c196c5c30d2e8ccaf71...544a83df1b8330f7ae1aa9165a3e1b2e8c9d8ef1,3,12,15,27,10,2014-10-10 17:17:31,2014-10-09 22:11:55
544a83df1b8330f7ae1aa9165a3e1b2e8c9d8ef1...a87c28be9b7c6f5c6f2bc9425a53c732fca3a0fa,3,12,4,16,3,2014-10-10 17:27:22,2014-10-09 23:15:57
a87c28be9b7c6f5c6f2bc9425a53c732fca3a0fa...3cc39237e2e9d7f978ce33f82a61d13e4941c0fd,1,11,4,15,4,2014-10-10 18:01:50,2014-10-10 17:58:25
3cc39237e2e9d7f978ce33f82a61d13e4941c0fd...8239bdb62f317260ac993665a4a681d95124a91e,3,31,21,52,12,2014-10-10 19:02:24,2014-10-10 15:47:35
8239bdb62f317260ac993665a4a681d95124a91e...bf48f38d12d8f9c28e91f78c9830371a50650f43,7,54,9,63,18,2014-10-10 19:07:27,2014-10-03 18:10:58
bf48f38d12d8f9c28e91f78c9830371a50650f43...894ef1bb9d8bff0e4cdaa81d17d113af868a4398,2,4,1,5,2,2014-10-10 19:08:38,2014-10-10 18:07:49
894ef1bb9d8bff0e4cdaa81d17d113af868a4398...c9e26cf4786b1c31c2ef83e21371ae5b227e5cc1,1,0,77,77,1,2014-10-10 19:34:04,2014-10-10 18:11:20
c9e26cf4786b1c31c2ef83e21371ae5b227e5cc1...57e21a173c849f8d14c82b17405ca5d65af37923,1,3,1,4,2,2014-10-10 19:43:18,2014-10-10 19:39:53
57e21a173c849f8d14c82b17405ca5d65af37923...3021308c97db12d76b02463fdada6eae326677e2,5,89,39,128,20,2014-10-10 19:52:53,2014-10-09 21:45:22
3021308c97db12d76b02463fdada6eae326677e2...2531e19e954ef525e9124b0c48d27da9ac54c89d,2,6,2,8,3,2014-10-10 19:52:53,2014-10-09 22:28:28
2531e19e954ef525e9124b0c48d27da9ac54c89d...c5d0f59611271d698a2417ce284d643ce07afc57,10,31,12,43,14,2014-10-10 19:52:54,2014-10-09 22:48:58
c5d0f59611271d698a2417ce284d643ce07afc57...b77054789b59c9284df70928c1d0d76770fd5c25,1,1,1,2,1,2014-10-10 20:34:00,2014-10-10 19:15:32
b77054789b59c9284df70928c1d0d76770fd5c25...8dff7bcaa38a52180eba26793446ee7e2855a1e4,8,10,57,67,20,2014-10-10 21:13:23,2014-10-10 21:13:23
8dff7bcaa38a52180eba26793446ee7e2855a1e4...ae49bd1b06e70d50b1daf28c199a736d99c12769,2,16,4,20,3,2014-10-10 21:20:54,2014-10-10 20:24:26
ae49bd1b06e70d50b1daf28c199a736d99c12769...050c963ea58b4fb02dde7ddc70d4cdc6afc3d501,2,24,18,42,4,2014-10-10 23:31:59,2014-10-03 23:22:44
050c963ea58b4fb02dde7ddc70d4cdc6afc3d501...31a2bc4a955e5ba7751c56652ed3c85dc6991b24,1,1,0,1,1,2014-10-11 04:13:46,2014-10-11 04:13:46
31a2bc4a955e5ba7751c56652ed3c85dc6991b24...59b2e9e90bd6ae25e69bb980df418b9ed614e943,20,753,3631,4384,232,2014-10-11 04:14:30,2014-10-11 04:14:30
59b2e9e90bd6ae25e69bb980df418b9ed614e943...6bfee24ed89aaa073f1bb21d2101827f3f56f09f,1,1,1,2,1,2014-10-11 04:15:20,2014-10-11 04:15:20
6bfee24ed89aaa073f1bb21d2101827f3f56f09f...8a25ec1eafc85c680c87b3b68262482beafbb57a,1,9,2,11,1,2014-10-11 04:15:39,2014-10-11 04:15:39
8a25ec1eafc85c680c87b3b68262482beafbb57a...8aad8474a447b4447d08dc4587c5422c74f94695,14,103,78,181,28,2014-10-11 04:20:10,2014-10-11 04:20:10
8aad8474a447b4447d08dc4587c5422c74f94695...1a6ceed6c0286d87f35782ce38b6bac3c13045b6,1,2,2,4,2,2014-10-11 04:22:57,2014-10-11 04:22:57
1a6ceed6c0286d87f35782ce38b6bac3c13045b6...666086390440aac3b13f28bac233a58cd4dd968b,1,1,0,1,1,2014-10-11 04:36:59,2014-10-11 04:36:59
666086390440aac3b13f28bac233a58cd4dd968b...8124910091c4962c946e9834eebc542fe93991a7,3,5,4,9,4,2014-10-11 19:47:24,2014-10-11 19:47:24
8124910091c4962c946e9834eebc542fe93991a7...7e93e7dee9e5a12724740c942aba031861dd54fe,3,92,121,213,26,2014-10-11 21:15:33,2014-10-10 17:37:49
7e93e7dee9e5a12724740c942aba031861dd54fe...22b368a74b36896de6b164c55cd4b3b9ca562bb2,3,42,30,72,16,2014-10-11 21:15:34,2014-10-10 18:45:05
22b368a74b36896de6b164c55cd4b3b9ca562bb2...7aa132c8087193f3efa23867b8783a0b7ad5a267,8,186,145,331,108,2014-10-11 21:15:35,2014-10-10 21:38:54
7aa132c8087193f3efa23867b8783a0b7ad5a267...35440470067af3bacff34f21e6065b5a25c7f932,1,7,0,7,2,2014-10-11 22:48:31,2014-10-11 22:17:09
35440470067af3bacff34f21e6065b5a25c7f932...6fe83c5318b7eaae9f0aa5904e063dcd068cd5a1,1,1,1,2,1,2014-10-11 22:48:31,2014-10-11 22:44:34
6fe83c5318b7eaae9f0aa5904e063dcd068cd5a1...a8aead0ac6e2fdcdb77cf8de738e6f5ed00b0545,1,6,1,7,1,2014-10-11 22:56:23,2014-10-11 22:56:23
a8aead0ac6e2fdcdb77cf8de738e6f5ed00b0545...1054dbae605af77f2344b2dda027c711d74b05a9,2,3,3,6,3,2014-10-12 03:16:26,2014-10-12 03:16:26
1054dbae605af77f2344b2dda027c711d74b05a9...00e695acb824bcf047b671c6649678056873804b,13,50,54,104,16,2014-10-12 03:26:50,2014-10-11 23:46:08
00e695acb824bcf047b671c6649678056873804b...81c227fe23f5487bd8c54bbb918e82c4aa3ac147,2,42,2,44,6,2014-10-12 03:26:50,2014-10-12 01:23:32
81c227fe23f5487bd8c54bbb918e82c4aa3ac147...7ed9b83a6a1d2cdae4a8d5218c2a30e140554294,1,0,0,0,0,2014-10-12 03:26:50,2014-10-12 02:36:33
7ed9b83a6a1d2cdae4a8d5218c2a30e140554294...fc00132dd762f1ba12dd462e780ffd4e232c96e4,7,22,23,45,20,2014-10-12 16:49:42,2014-10-12 16:49:42
fc00132dd762f1ba12dd462e780ffd4e232c96e4...b186710fdc197117c7bbc2df2492868e1ff5aa92,2,33,18,51,7,2014-10-12 16:55:42,2014-10-12 16:25:39
b186710fdc197117c7bbc2df2492868e1ff5aa92...724d64af4ed81df534b187940308da1530341390,1,4,3,7,1,2014-10-12 16:55:42,2014-10-12 16:25:48
724d64af4ed81df534b187940308da1530341390...faf3e8f416519fc2d0a32a504913bab9c35e4358,3,160,4,164,7,2014-10-13 03:03:29,2014-08-14 04:22:28
faf3e8f416519fc2d0a32a504913bab9c35e4358...a14adbe5793af16b70fb1895ab0a7f65c753bfb8,3,3,36,39,10,2014-10-13 14:05:08,2014-10-13 13:48:20
a14adbe5793af16b70fb1895ab0a7f65c753bfb8...42d276dace045fe888cdb45f00dc0bf97fa13bd5,6,95,158,253,35,2014-10-13 14:11:51,2014-10-02 14:10:48
42d276dace045fe888cdb45f00dc0bf97fa13bd5...04881187a924504df7e0de339c5adeeffae9371d,11,179,5,184,21,2014-10-13 14:32:26,2014-10-10 17:17:15
04881187a924504df7e0de339c5adeeffae9371d...3cda8c7f885a9a543b5fc08fd7dcd1b7fa0a0b5a,15,93,4,97,17,2014-10-13 15:20:19,2014-10-13 15:19:49
3cda8c7f885a9a543b5fc08fd7dcd1b7fa0a0b5a...f69bf9401f2c83fab3d4525db4626f2ee9e8b7ce,1,13,9,22,2,2014-10-13 15:18:08,2014-10-13 15:16:19
f69bf9401f2c83fab3d4525db4626f2ee9e8b7ce...0bf559b47987c3fc4e4c5ce1b67b402a105422bd,2,7,14,21,9,2014-10-13 15:30:23,2014-10-13 14:52:22
0bf559b47987c3fc4e4c5ce1b67b402a105422bd...c6c5d0b5a30630cfb4e63ee809c562adf6173e1c,5,147,12,159,20,2014-10-13 17:57:31,2014-10-10 21:37:44
c6c5d0b5a30630cfb4e63ee809c562adf6173e1c...4bea2a90b75ffeabb1e249f62998f1f8e8f46a05,5,90,5,95,11,2014-10-13 17:57:31,2014-10-13 12:47:33
4bea2a90b75ffeabb1e249f62998f1f8e8f46a05...ef985802f928f83e1f058647a2f7520b8f6ad9f2,1,6,0,6,1,2014-10-13 18:39:32,2014-10-13 15:58:19
ef985802f928f83e1f058647a2f7520b8f6ad9f2...2d3bac6ff51ab34a7f7158b238c31137b1ebd6fd,2,33,5,38,6,2014-10-13 18:41:35,2014-10-13 17:34:58
2d3bac6ff51ab34a7f7158b238c31137b1ebd6fd...f7bcf16b2f87423d520c9b3013d11917c5d0ca78,1,3,4,7,2,2014-10-13 18:41:44,2014-10-13 17:36:37
f7bcf16b2f87423d520c9b3013d11917c5d0ca78...d5625da51a529303702ef834f18d3c94ad70aa5f,1,2,2,4,2,2014-10-13 18:51:10,2014-10-13 18:35:06
d5625da51a529303702ef834f18d3c94ad70aa5f...85b7323b98697c5885062e3a1cfca99d0b764545,3,77,1,78,4,2014-10-13 19:06:33,2014-10-10 22:09:13
85b7323b98697c5885062e3a1cfca99d0b764545...93f6710d86c038f1fd3815d9212abff9a47049ea,8,138,24,162,34,2014-10-13 19:11:03,2014-10-13 15:24:21
93f6710d86c038f1fd3815d9212abff9a47049ea...e9c91c4ae2206f3292ebef86c973c400b2a5911f,1,2,0,2,1,2014-10-13 19:27:33,2014-10-13 19:27:21
e9c91c4ae2206f3292ebef86c973c400b2a5911f...2917253b7cd11d2a856c99552bb8fc41899c4ae0,1,0,0,0,0,2014-10-13 20:21:50,2014-10-13 20:21:50
2917253b7cd11d2a856c99552bb8fc41899c4ae0...ad6a4c35c952478f1a868ed09cf5a0d5e7f4672c,6,158,95,253,34,2014-10-13 20:22:22,2014-10-13 20:21:43
ad6a4c35c952478f1a868ed09cf5a0d5e7f4672c...3400b0ef037c1b0a244740e95e0fa0dedd36c95e,2,7,8,15,3,2014-10-13 20:43:35,2014-10-13 20:38:34
3400b0ef037c1b0a244740e95e0fa0dedd36c95e...dca807002b77347f9001ffc583ed25de659ce60f,1,8,6,14,2,2014-10-13 20:55:55,2014-10-09 23:17:04
dca807002b77347f9001ffc583ed25de659ce60f...964020ba2d85ffe955fbae16833e70fbb0cdb41c,1,50,121,171,16,2014-10-13 21:03:32,2014-10-13 19:33:16
964020ba2d85ffe955fbae16833e70fbb0cdb41c...5b519399556b16f0b5e3220ed90c62f539e32440,1,0,247,247,1,2014-10-13 21:03:33,2014-10-13 21:03:08
5b519399556b16f0b5e3220ed90c62f539e32440...c04da66ea2248026c5f33fffe7177863e93bf2bf,5,10,10,20,6,2014-10-13 21:28:58,2014-10-13 20:36:28
c04da66ea2248026c5f33fffe7177863e93bf2bf...c3e0857d3ed8d7402257901cb7bc903180b366a9,1,1,0,1,1,2014-10-13 21:28:58,2014-10-13 20:37:11
c3e0857d3ed8d7402257901cb7bc903180b366a9...5b78d86f52437f1972aec51ce53a5be9b749fab4,1,10,10,20,2,2014-10-13 21:28:58,2014-10-13 21:25:55
5b78d86f52437f1972aec51ce53a5be9b749fab4...e7a49e50e5a858b02c9c242c943d7559238bb2b6,2,8,5,13,3,2014-10-13 22:57:50,2014-10-13 22:06:52
e7a49e50e5a858b02c9c242c943d7559238bb2b6...d601b91b6b16be3f93bac2f10952c1e5d273f91f,62,1320,268,1588,187,2014-10-13 23:59:21,2014-10-07 22:23:21
d601b91b6b16be3f93bac2f10952c1e5d273f91f...aa31cae71bc5390fc02d48fc793eebb1991d0ff3,3,86,2,88,5,2014-10-14 01:37:26,2014-09-26 21:50:52
aa31cae71bc5390fc02d48fc793eebb1991d0ff3...1a44dc6a150524de75dd46c8dc464c7182a37389,3,131,109,240,22,2014-10-14 02:16:18,2014-10-13 15:26:11
1a44dc6a150524de75dd46c8dc464c7182a37389...16dae4398a09ab2cdb3aee0414bc5094551d7ed7,1,3622,839,4461,251,2014-10-14 02:27:03,2014-10-13 14:21:14
16dae4398a09ab2cdb3aee0414bc5094551d7ed7...7fb64deba5ccdda9c9375dd91cde75a05e7c62a0,1,1,1,2,1,2014-10-14 02:28:20,2014-10-13 14:29:24
7fb64deba5ccdda9c9375dd91cde75a05e7c62a0...564a8b6fbec35a030024df75b791cecf71ab5059,1,0,1,1,1,2014-10-14 02:28:55,2014-10-13 14:17:47
564a8b6fbec35a030024df75b791cecf71ab5059...2372b1866ae66be9c78272030e7d356e7cb9b755,1,10,4,14,9,2014-10-14 02:28:55,2014-10-13 15:50:18
2372b1866ae66be9c78272030e7d356e7cb9b755...87be645d9a952bc7890807895a433dff65182b40,7,61,41,102,29,2014-10-14 13:44:43,2014-10-14 13:08:22
87be645d9a952bc7890807895a433dff65182b40...282cf4fee1cc3a7660360466c923f4cfaee87499,1,0,9,9,2,2014-10-14 14:22:19,2014-10-13 18:19:35
282cf4fee1cc3a7660360466c923f4cfaee87499...eba8e42b691f704c523fcec1ab5acb9aee8666c3,22,200,112,312,70,2014-10-14 14:30:51,2014-10-08 21:18:30
eba8e42b691f704c523fcec1ab5acb9aee8666c3...0548f4764e876c71677be3735636857d194b7f44,3,224,490,714,45,2014-10-14 10:14:55,2014-10-13 15:48:32
0548f4764e876c71677be3735636857d194b7f44...12c105532853cee31b8e7824207d3757a4ddab69,1,130,102,232,22,2014-10-14 17:06:01,2014-10-10 21:54:17
12c105532853cee31b8e7824207d3757a4ddab69...d443c8c1bd7ad9755c29214bdb094ad6a12bc7f5,1,35,53,88,10,2014-10-14 17:06:01,2014-10-13 21:08:39
d443c8c1bd7ad9755c29214bdb094ad6a12bc7f5...b51d7e60c5eecc22f72727610459c009ffaac2b0,1,3,4,7,2,2014-10-14 17:08:38,2014-10-14 17:08:38
b51d7e60c5eecc22f72727610459c009ffaac2b0...a3d8e9a0c447c40aff9eb7fcbd94119737dc971c,181,359,1,360,182,2014-10-14 17:42:51,2014-10-14 04:06:21
a3d8e9a0c447c40aff9eb7fcbd94119737dc971c...5fc306543cd3ba2637e5cb0662cc375f36868b28,1,2,2,4,1,2014-10-14 17:42:51,2014-10-09 20:25:48
5fc306543cd3ba2637e5cb0662cc375f36868b28...5e6c71dd4a9c2f0304fb88d3901b1c6889f1b3f6,2,34,1,35,2,2014-10-14 17:47:05,2014-10-13 17:57:15
5e6c71dd4a9c2f0304fb88d3901b1c6889f1b3f6...036865b9bf58cbf9c58f4afa0f729433b35f81bd,1,3,1,4,2,2014-10-14 18:14:42,2014-10-14 18:14:42
036865b9bf58cbf9c58f4afa0f729433b35f81bd...af711b98a00caaf24cb6e15e7bfe28eb334e9a88,1,1,1,2,1,2014-10-14 14:26:34,2014-10-14 14:21:40
af711b98a00caaf24cb6e15e7bfe28eb334e9a88...d93af7c5a85f9d2e0a81837d61f7751f0d74c20f,2,18,0,18,3,2014-10-14 14:42:44,2014-10-06 16:06:01
d93af7c5a85f9d2e0a81837d61f7751f0d74c20f...bf196647fae10577a2cb6518f7e3f19fb28c0b20,1,8,0,8,1,2014-10-14 14:43:10,2014-10-07 11:47:21
bf196647fae10577a2cb6518f7e3f19fb28c0b20...f919a33b0d8ca3767e40c0cf9588f1a8d25b7cee,6,553,4,557,13,2014-10-14 14:43:34,2014-10-07 16:44:47
f919a33b0d8ca3767e40c0cf9588f1a8d25b7cee...a0b44fd4cfdbd2b40f99317b4aceb8b58ab5e3ce,5,63,105,168,36,2014-10-14 19:56:55,2014-10-13 20:01:05
a0b44fd4cfdbd2b40f99317b4aceb8b58ab5e3ce...c514770f6a3d6d63b6a226f370f9c53e8a4707ff,1,0,3,3,2,2014-10-14 15:44:53,2014-10-14 15:44:21
c514770f6a3d6d63b6a226f370f9c53e8a4707ff...492095028328557ab0ff918fb6733ec68dcc1ed9,5,14,10,24,12,2014-10-14 22:49:39,2014-10-14 22:10:31
492095028328557ab0ff918fb6733ec68dcc1ed9...da196cea52b12142494847d61fe00a17108e09ad,1,1,1,2,1,2014-10-14 22:58:10,2014-10-14 22:58:10
da196cea52b12142494847d61fe00a17108e09ad...94408cad4a342c65043556342bc05059735c0ebc,4,12,41,53,18,2014-10-14 22:58:41,2014-10-14 22:23:37
94408cad4a342c65043556342bc05059735c0ebc...395aa1dbb0dae57151622c8f9fa06143559639d8,1,65,65,130,1,2014-10-14 17:58:41,2014-10-14 17:58:41
395aa1dbb0dae57151622c8f9fa06143559639d8...8c5f135f65bdd64248832b89383bd78129ddec65,6,58,60,118,21,2014-10-14 23:06:50,2014-10-14 21:02:55
8c5f135f65bdd64248832b89383bd78129ddec65...75c14f5e311d0476705e5e0e10dd0b16d78d050d,7,19,0,19,9,2014-10-14 23:06:50,2014-10-14 21:14:10
75c14f5e311d0476705e5e0e10dd0b16d78d050d...37bd6f5f6886ca07d798f199a856db7894434a4c,1,0,0,0,0,2014-10-14 23:06:50,2014-10-14 21:18:12
37bd6f5f6886ca07d798f199a856db7894434a4c...f69a60127aabfd4791257ce99462e4f12f3a539b,5,57,1,58,8,2014-10-14 23:06:51,2014-10-14 22:13:53
f69a60127aabfd4791257ce99462e4f12f3a539b...c1b86b0b2f50863dbbe714bdc781326231f43bdd,8,10,13,23,10,2014-10-14 23:32:19,2014-10-14 23:21:51
c1b86b0b2f50863dbbe714bdc781326231f43bdd...e0f47214d06738f14d0d0d731235a9f665a6b81f,3,110,71,181,19,2014-10-15 04:03:14,2014-10-15 04:03:14
e0f47214d06738f14d0d0d731235a9f665a6b81f...8cbf581a2694c496681b8fd12e2cc03747358869,10,107,17,124,24,2014-10-15 14:02:32,2014-10-13 15:23:15
8cbf581a2694c496681b8fd12e2cc03747358869...126069374744c62c65fac86a492531d658961f40,14,178,154,332,58,2014-10-15 15:03:20,2014-10-06 21:36:18
126069374744c62c65fac86a492531d658961f40...713d728abb5f748c17b81388d29c47f661e7e244,1,176,191,367,1,2014-10-15 10:20:18,2014-10-14 12:02:09
713d728abb5f748c17b81388d29c47f661e7e244...ccfbf1c8599c72e222aba6257e5a74ceaba80771,6,0,64,64,10,2014-10-15 10:20:18,2014-10-14 13:39:45
ccfbf1c8599c72e222aba6257e5a74ceaba80771...6b0985b8ed6cdddde6631545a5d40975f22622dd,9,67,78,145,10,2014-10-15 15:33:51,2014-10-13 22:45:02
6b0985b8ed6cdddde6631545a5d40975f22622dd...81681d4e12a581525667b956921e25f2ea0f4f14,1,2,1,3,2,2014-10-15 15:39:47,2014-10-15 14:11:17
81681d4e12a581525667b956921e25f2ea0f4f14...58d0b00cec1a3c86097ab9759916b1bdd191e3b0,1,30,1,31,4,2014-10-15 15:40:06,2014-10-14 22:37:31
58d0b00cec1a3c86097ab9759916b1bdd191e3b0...3d7564c44a2117c72b9c6830c5a14ab467f8ffa3,1,30,34,64,12,2014-10-15 15:41:12,2014-10-08 15:02:52
3d7564c44a2117c72b9c6830c5a14ab467f8ffa3...658f0bce4379fc0334a53c4381d57b8b7c7d53b7,2,67,17,84,10,2014-10-15 15:55:42,2014-10-10 18:11:52
658f0bce4379fc0334a53c4381d57b8b7c7d53b7...b31157d9261ebaa524b88ea1343f11183d644e73,3,67,33,100,12,2014-10-15 17:25:47,2014-10-14 20:54:00
b31157d9261ebaa524b88ea1343f11183d644e73...0d9f5a4738dc850ce23af0cbeb8959ac4adcbf08,1,6,6,12,3,2014-10-15 17:25:47,2014-10-15 12:01:50
0d9f5a4738dc850ce23af0cbeb8959ac4adcbf08...b980e86cea1816ba391a9a52f05253009fb32567,4,30,35,65,14,2014-10-15 17:25:47,2014-10-14 15:23:33
b980e86cea1816ba391a9a52f05253009fb32567...6556243ff038a3f9cdc52e6a97684203c8c9ec54,1,10,2,12,4,2014-10-15 17:25:47,2014-10-15 14:17:21
6556243ff038a3f9cdc52e6a97684203c8c9ec54...525b5ef94f72c376c4d831539be3988b8ff0a0ec,1,1,1,2,1,2014-10-15 17:29:21,2014-10-15 17:29:21
525b5ef94f72c376c4d831539be3988b8ff0a0ec...95e3d7fd80de1cd478059773b5b813e4ac713e82,1,1,1,2,1,2014-10-15 18:29:00,2014-10-15 18:29:00
95e3d7fd80de1cd478059773b5b813e4ac713e82...1e1681fcb438a9c9512b4b78901eff96fa05a490,1,2,1,3,2,2014-10-15 18:51:34,2014-10-15 18:51:34
1e1681fcb438a9c9512b4b78901eff96fa05a490...a2adff8b30574ed685443c164e35317418f5c8e4,1,26,33,59,17,2014-10-15 19:11:31,2014-10-15 19:10:01
a2adff8b30574ed685443c164e35317418f5c8e4...786945e1a1fea1eb0f7863879e87d264af7a4293,14,135,25,160,25,2014-10-15 20:00:01,2014-10-14 13:37:03
786945e1a1fea1eb0f7863879e87d264af7a4293...eec58e7c8c86c4d44c3ab1763c7e5ce66adbb557,5,50,9,59,12,2014-10-15 20:08:23,2014-10-15 20:08:09
eec58e7c8c86c4d44c3ab1763c7e5ce66adbb557...bdee10aed8691579d17300a1235edce8742ef6dd,1,3,2,5,1,2014-10-15 21:01:57,2014-10-15 19:25:07
bdee10aed8691579d17300a1235edce8742ef6dd...da69c8212a753f6311e170ec584c869e2d53c9d1,1,0,3,3,1,2014-10-15 21:18:37,2014-10-15 14:40:37
da69c8212a753f6311e170ec584c869e2d53c9d1...b1c0b85c0857d3ceb945d061ea20ae7dc9740ffc,1,53,51,104,1,2014-10-15 16:20:33,2014-10-15 16:07:17
b1c0b85c0857d3ceb945d061ea20ae7dc9740ffc...5a74508369bfb820b18746623708688a76ae3419,1,1,1,2,1,2014-10-15 21:37:23,2014-10-15 19:41:11
5a74508369bfb820b18746623708688a76ae3419...53698194b24a5c889fa9215dae4fa6cd372e9e44,3,8,12,20,9,2014-10-15 21:37:23,2014-10-15 21:33:38
53698194b24a5c889fa9215dae4fa6cd372e9e44...4b88d369d2489d1c6fac593ffeb1733d7bfc9c7b,1,8,2,10,2,2014-10-15 21:54:15,2014-10-14 22:23:47
4b88d369d2489d1c6fac593ffeb1733d7bfc9c7b...27147aaf26aef235f8a65223e876adeea016886a,1,2,2,4,4,2014-10-16 00:51:30,2014-10-14 00:02:53
27147aaf26aef235f8a65223e876adeea016886a...8180c686e9fb3fab8a96aececeeb83ffa96435c3,1,7,0,7,1,2014-10-16 00:51:30,2014-10-14 00:03:51
8180c686e9fb3fab8a96aececeeb83ffa96435c3...8fb060ec43976f440eb378fff573a4a46d425334,1,2,0,2,2,2014-10-16 00:51:30,2014-10-14 00:04:23
8fb060ec43976f440eb378fff573a4a46d425334...7a7febfe1acd236ea11677638c0a8d5ddc6ceba6,1,4,4,8,1,2014-10-16 00:51:31,2014-10-14 00:05:29
7a7febfe1acd236ea11677638c0a8d5ddc6ceba6...d5a7c0a1d7dfda7a67072dfe449ca1ace54d8380,1,1,0,1,1,2014-10-16 00:51:31,2014-10-14 00:06:52
d5a7c0a1d7dfda7a67072dfe449ca1ace54d8380...cea7003c9124435452b2d1f9828907e857bcd26b,1,2,0,2,1,2014-10-16 00:51:31,2014-10-14 12:23:20
cea7003c9124435452b2d1f9828907e857bcd26b...82c79ceed40f66b4e4c260d4b7d5cef5061893ac,24,352,136,488,227,2014-10-16 00:51:31,2014-10-14 12:23:38
82c79ceed40f66b4e4c260d4b7d5cef5061893ac...eb5f7e613c80ae00f2d9a92fbbf4c7548ffc216c,10,66,29,95,45,2014-10-16 00:51:31,2014-10-15 19:47:06
eb5f7e613c80ae00f2d9a92fbbf4c7548ffc216c...58ba874afce49711be39f19352f9b6c35bb33de6,3,441,7,448,5,2014-10-16 01:57:36,2014-10-13 21:46:32
58ba874afce49711be39f19352f9b6c35bb33de6...56947bfb0ef94a523c636833a6f76dc3c6880821,3,75,99,174,36,2014-10-16 01:57:37,2014-10-15 23:52:07
56947bfb0ef94a523c636833a6f76dc3c6880821...a2d6ac2d6cd8f15bcb9ac31535f114e028f0dd54,8,96,103,199,23,2014-10-16 01:59:22,2014-10-15 03:27:19
a2d6ac2d6cd8f15bcb9ac31535f114e028f0dd54...5aa159eb06d1db9c5870977f32fc1c9271845c2b,3,105,0,105,6,2014-10-16 03:04:17,2014-10-15 22:02:14
5aa159eb06d1db9c5870977f32fc1c9271845c2b...1b3bc30c035aef041fec0b9cccf64e9f5640cf21,1,1,1,2,1,2014-10-16 03:55:05,2014-10-16 03:55:05
1b3bc30c035aef041fec0b9cccf64e9f5640cf21...870afbb1868f36abbf57ca43c2e292c0df86a8e3,9,0,364,364,9,2014-10-16 04:36:31,2014-10-16 04:35:56
870afbb1868f36abbf57ca43c2e292c0df86a8e3...f67afb4ff33bd803e93e2a52c0249cb872af680b,7,193,153,346,54,2014-10-16 12:26:58,2014-10-02 14:10:48
f67afb4ff33bd803e93e2a52c0249cb872af680b...b6a2b0a9c98e29f77ce5cc314ed6906aec154885,1,3,2,5,3,2014-10-16 12:51:38,2014-10-15 15:02:36
b6a2b0a9c98e29f77ce5cc314ed6906aec154885...cacbfa2f82ee3ffe5513e727542d513d3f98ac1c,1,2,4,6,2,2014-10-16 14:14:43,2014-10-16 14:09:49
cacbfa2f82ee3ffe5513e727542d513d3f98ac1c...e462f31e016212183da68f444e6db1c8474742c4,6,113,20,133,15,2014-10-16 14:26:36,2014-09-16 17:37:36
e462f31e016212183da68f444e6db1c8474742c4...5f74509348939336562ab0db34afdf1b69e63c90,3,57,15,72,15,2014-10-16 14:26:37,2014-09-18 22:19:12
5f74509348939336562ab0db34afdf1b69e63c90...1579d801925ce9b92de088ca766483540cf6e741,2,15,2,17,3,2014-10-16 15:01:18,2014-10-15 21:48:10
1579d801925ce9b92de088ca766483540cf6e741...4590de9cbd7005a9603daa371c70e0eca9f671e9,1,46,41,87,7,2014-10-16 16:03:35,2014-10-16 16:03:35
4590de9cbd7005a9603daa371c70e0eca9f671e9...9e1902c141f5852e78a96e395030eed1fe79c0df,1,6,2,8,2,2014-10-16 17:13:58,2014-10-16 14:17:11
9e1902c141f5852e78a96e395030eed1fe79c0df...f479d62dd895a18dedc4ab2415a35aef24baecb0,1,8,3,11,2,2014-10-16 17:22:27,2014-10-16 17:14:08
f479d62dd895a18dedc4ab2415a35aef24baecb0...9ccfb17324b76539401e3eeb7cbb8f3f0e2140d5,1,1,14,15,1,2014-10-16 17:59:44,2014-10-16 17:26:32
9ccfb17324b76539401e3eeb7cbb8f3f0e2140d5...ca1a8d5bb453a645b61a8ebcee8b40b7a51bdfdf,2,39,0,39,3,2014-10-16 17:59:44,2014-10-16 17:26:54
ca1a8d5bb453a645b61a8ebcee8b40b7a51bdfdf...6bc93c0a8730511e021645b711079dd0ec4e9f61,10,176,82,258,48,2014-10-16 18:12:50,2014-10-15 16:37:26
6bc93c0a8730511e021645b711079dd0ec4e9f61...18390f9767fe11aba47a7ba1b91cf3038e89fcbb,2,34,10,44,12,2014-10-16 18:35:23,2014-09-29 21:34:32
18390f9767fe11aba47a7ba1b91cf3038e89fcbb...6d38c74515757bfe5bdea99c00b1b86541cca677,3,199,189,388,48,2014-10-16 18:45:31,2014-10-13 21:04:56
6d38c74515757bfe5bdea99c00b1b86541cca677...80760f72bb9a23f256e540adfd70b33eb6c08fd2,2,9,7,16,6,2014-10-16 19:38:55,2014-10-16 18:38:22
80760f72bb9a23f256e540adfd70b33eb6c08fd2...51874d0d307104df6c857aa395284193bb48028e,1,9,1,10,3,2014-10-16 19:43:09,2014-10-16 18:49:03
51874d0d307104df6c857aa395284193bb48028e...c980fb8972bc30abad6b72105ca82227ac3bc3b3,1,10,9,19,6,2014-10-16 19:43:09,2014-10-16 19:35:43
c980fb8972bc30abad6b72105ca82227ac3bc3b3...a7ad32c3fe56d5e6244487d1093b76e280e3522e,1,2,1,3,2,2014-10-16 20:12:17,2014-10-16 20:12:17
a7ad32c3fe56d5e6244487d1093b76e280e3522e...ca6ab0db384f3b397c6abe1f61053db06e2658ac,2,16,144,160,3,2014-10-16 21:20:55,2014-10-16 21:15:41
ca6ab0db384f3b397c6abe1f61053db06e2658ac...5af2cac9e0de1bf20eba4790ecc3547c679dfd13,1,6,0,6,1,2014-10-16 21:36:07,2014-10-16 21:30:19
5af2cac9e0de1bf20eba4790ecc3547c679dfd13...34cfe32ab4c0751ceb55b607c05dc593c3dd901c,25,236,221,457,181,2014-10-16 21:56:42,2014-10-16 13:08:28
34cfe32ab4c0751ceb55b607c05dc593c3dd901c...398270f3dff1fac5b7f2d853dc31af64bc8ce3a7,5,36,14,50,13,2014-10-16 21:56:42,2014-10-16 14:36:42
398270f3dff1fac5b7f2d853dc31af64bc8ce3a7...a93beee92a74be918a1e861070f39bb9549c0134,5,75,22,97,20,2014-10-16 21:56:42,2014-10-16 14:37:39
a93beee92a74be918a1e861070f39bb9549c0134...9d96a02741ae0d51d51fbc4d08b35fd6245c7471,1,21,6,27,2,2014-10-16 21:56:42,2014-10-16 21:20:49
9d96a02741ae0d51d51fbc4d08b35fd6245c7471...be0dcdd2fdf944d0bb8cb26baab86c67c657ef65,1,1,0,1,1,2014-10-16 21:56:42,2014-10-16 21:23:09
be0dcdd2fdf944d0bb8cb26baab86c67c657ef65...80d9852c431084e4b6e4fd1b9a5b968b937b96ac,1,2,1,3,2,2014-10-16 21:56:42,2014-10-16 21:24:55
80d9852c431084e4b6e4fd1b9a5b968b937b96ac...02c1c52514c7d6b54ff2d6dd6a3c564c3543f0a5,2,5,0,5,3,2014-10-16 21:56:42,2014-10-16 21:25:07
02c1c52514c7d6b54ff2d6dd6a3c564c3543f0a5...22f8b6259602a76f8d22cba8b1098f9e3c90a36f,59,3335,1429,4764,285,2014-10-16 22:38:12,2014-09-19 17:30:00
22f8b6259602a76f8d22cba8b1098f9e3c90a36f...69600d691341bfd2fbf58e15d8727fbc2fd1ccf1,2,32,0,32,3,2014-10-17 00:55:01,2014-10-16 20:52:41
69600d691341bfd2fbf58e15d8727fbc2fd1ccf1...024c9130eb1f9b819ac16aae5a38ba5d7b9614f1,1,81,31,112,4,2014-10-17 02:06:04,2014-10-02 13:37:27
024c9130eb1f9b819ac16aae5a38ba5d7b9614f1...0eb6558191d0408262163ae22f80b786a305eaef,5,377,0,377,6,2014-10-17 02:06:04,2014-10-08 20:17:35
0eb6558191d0408262163ae22f80b786a305eaef...82d2859df68f897896f9ec34f285cccf0055839c,1,80,54,134,15,2014-10-17 02:06:04,2014-10-02 21:21:22
82d2859df68f897896f9ec34f285cccf0055839c...28adefebaddfaabe11db7bdf73a974477bc44484,1,4,2,6,2,2014-10-17 02:08:47,2014-10-17 01:30:39
28adefebaddfaabe11db7bdf73a974477bc44484...1b375062c82496e0d077ab84cb43c66d69a01738,1,3,1,4,2,2014-10-17 04:44:23,2014-10-17 04:43:52
1b375062c82496e0d077ab84cb43c66d69a01738...00408e596d6c5f299381d2c4ae7b0fc7835fa349,1,10,7,17,2,2014-10-17 04:44:24,2014-10-17 04:44:09
00408e596d6c5f299381d2c4ae7b0fc7835fa349...0b336ddb1e0ede7a9a381b510b4de344daadc307,1,4,2,6,2,2014-10-17 12:42:14,2014-10-17 12:42:14
0b336ddb1e0ede7a9a381b510b4de344daadc307...751767c6e782cc12ddd1262797c7728457527b9f,3,5,3,8,3,2014-10-17 13:36:39,2014-10-17 13:36:39
751767c6e782cc12ddd1262797c7728457527b9f...a868d509e98c217edeb51e42623725272e114eea,4,100,6,106,5,2014-10-17 13:39:26,2014-10-10 20:05:37
a868d509e98c217edeb51e42623725272e114eea...a1b5c0925eedec72e402878433da4890630ef533,9,43,38,81,25,2014-10-17 14:17:12,2014-10-17 00:02:03
a1b5c0925eedec72e402878433da4890630ef533...7253b35c65c15c50272a1750ecc82f1eb8e1285b,14,44,28,72,30,2014-10-17 14:20:27,2014-10-17 01:54:44
7253b35c65c15c50272a1750ecc82f1eb8e1285b...c3e58867a942565309cae3c04c642437d36edb2c,1,1,1,2,1,2014-10-17 14:22:28,2014-10-17 05:09:53
c3e58867a942565309cae3c04c642437d36edb2c...9dac9ae4ae4e1d12e88d9ffacbeb5384307b1d2e,1,3,3,6,3,2014-10-17 14:24:54,2014-10-17 12:57:47
9dac9ae4ae4e1d12e88d9ffacbeb5384307b1d2e...75734d035f53fe4cb8744f893b7edd999c973c27,1,60,57,117,12,2014-10-17 14:36:02,2014-10-17 14:25:17
75734d035f53fe4cb8744f893b7edd999c973c27...4f4a7004289c7b2adbea8364495e96c2855b78cd,1,1,1,2,1,2014-10-17 15:18:23,2014-10-17 15:18:23
4f4a7004289c7b2adbea8364495e96c2855b78cd...1ee210fa58c2c9eb547095c1d26f8f080c6ec34f,4,5,4,9,6,2014-10-17 15:29:00,2014-10-17 15:28:23
1ee210fa58c2c9eb547095c1d26f8f080c6ec34f...8e4cff01187584f65e3439c0c2a0a2e0d63d594d,3,70,74,144,22,2014-10-17 15:31:49,2014-10-14 13:50:46
8e4cff01187584f65e3439c0c2a0a2e0d63d594d...aaf740d1748b5ed1ce890d88c489bd6f9399aeac,3,67,1,68,4,2014-10-17 15:31:49,2014-10-15 14:45:45
aaf740d1748b5ed1ce890d88c489bd6f9399aeac...39c48e85f8563119caa769f34e2b6f22c4790430,2,11,1,12,4,2014-10-17 15:31:49,2014-10-16 13:51:26
39c48e85f8563119caa769f34e2b6f22c4790430...06b3468eacb9afa4a9ae3086958114044ab5eac1,1,1,1,2,1,2014-10-17 15:43:56,2014-10-17 12:44:29
06b3468eacb9afa4a9ae3086958114044ab5eac1...cd82c0d6739550c04b75e41742433bf65ff7826a,1,2,2,4,2,2014-10-17 15:43:57,2014-10-17 15:43:40
cd82c0d6739550c04b75e41742433bf65ff7826a...4e10def7b1ea9da02a5218d592073ff2587544cd,7,360,44,404,29,2014-10-17 18:23:34,2014-10-14 23:41:33
4e10def7b1ea9da02a5218d592073ff2587544cd...934abb75e0cd552b504689785f9f9eb51e63b184,1,1,1,2,1,2014-10-17 19:33:00,2014-10-17 19:33:00
934abb75e0cd552b504689785f9f9eb51e63b184...898643d46da8916f77933c9e1de2de16e5efe46f,9,122,60,182,45,2014-10-17 20:20:32,2014-10-17 20:20:09
898643d46da8916f77933c9e1de2de16e5efe46f...5ff535f134b9fd5b97dfeacd2f6063f22f9d958d,3,62,78,140,42,2014-10-17 20:23:51,2014-10-17 20:23:51
5ff535f134b9fd5b97dfeacd2f6063f22f9d958d...d6bce9d4935b967546cd2cf028f5cc9e7801f967,3,59,79,138,30,2014-10-17 20:23:51,2014-10-17 20:23:51
d6bce9d4935b967546cd2cf028f5cc9e7801f967...35fb6b94298f97171337f521ecd19de2385386d0,3,13,1,14,4,2014-10-17 20:29:45,2014-10-17 16:07:55
35fb6b94298f97171337f521ecd19de2385386d0...c667aebfe867373053cbee2d053af13a81771912,3,25,25,50,5,2014-10-17 21:22:49,2014-10-17 21:22:40
c667aebfe867373053cbee2d053af13a81771912...d62da3295a35725e7552638b55b09d802881d110,1,23,19,42,4,2014-10-17 21:23:45,2014-10-17 20:44:20
d62da3295a35725e7552638b55b09d802881d110...7aadbc29c07ee73c62ccfa3696fbd6262fb3d70e,4,21,17,38,13,2014-10-17 21:33:48,2014-10-06 18:37:07
7aadbc29c07ee73c62ccfa3696fbd6262fb3d70e...08319d688517af8ac88fe7054ea10f1f08c5bf2d,20,169,902,1071,119,2014-10-18 00:33:13,2014-09-17 22:41:18
08319d688517af8ac88fe7054ea10f1f08c5bf2d...4d34532dbf749fe2c9df9ed7421db196eaf93632,13,370,84,454,83,2014-10-18 00:33:55,2014-09-19 21:21:06
4d34532dbf749fe2c9df9ed7421db196eaf93632...7e7439bab78da9c993fcf566e4ea8d5c0570ad8d,8,97,98,195,27,2014-10-18 00:34:36,2014-09-23 21:09:50
7e7439bab78da9c993fcf566e4ea8d5c0570ad8d...20de6ea8c790348b589acd737308eb853f230aa5,7,89,15,104,15,2014-10-18 00:34:41,2014-10-08 21:07:28
20de6ea8c790348b589acd737308eb853f230aa5...3c54ca1f58084845b7f778bde2f8a0f2138f727e,1,57,0,57,1,2014-10-18 00:34:41,2014-10-08 23:05:09
3c54ca1f58084845b7f778bde2f8a0f2138f727e...5496425827e4a2fd883c6c429ea09fa410632fcb,29,100,95,195,61,2014-10-18 00:34:41,2014-10-16 20:13:21
5496425827e4a2fd883c6c429ea09fa410632fcb...631deeb23eb0f0a0d4aecb04345dc874a31a6add,1,1,1,2,1,2014-10-18 04:18:32,2014-10-18 04:18:32
631deeb23eb0f0a0d4aecb04345dc874a31a6add...3ac1ed9bf1ba845a2b5a9eaf1f8ebbf9a314c1a0,1,2,0,2,2,2014-10-18 04:55:26,2014-10-18 04:55:26
3ac1ed9bf1ba845a2b5a9eaf1f8ebbf9a314c1a0...d62a1f4e030f9e50afededd8f2b2167649c40696,1,1,1,2,1,2014-10-19 18:27:15,2014-10-19 18:13:20
d62a1f4e030f9e50afededd8f2b2167649c40696...64b7bc99aee07bf04f189c1f06e1756645f04b71,7,17,8,25,10,2014-10-19 19:12:22,2014-10-19 19:02:59
64b7bc99aee07bf04f189c1f06e1756645f04b71...74835f660d9315024994877de3c40cd542625fa1,5,137,41,178,13,2014-10-19 19:15:46,2014-10-19 19:05:43
74835f660d9315024994877de3c40cd542625fa1...80dbf7994401f178f382e5ae57edb7ce96533a0c,1,7,2,9,2,2014-10-19 19:15:46,2014-10-19 19:06:40
80dbf7994401f178f382e5ae57edb7ce96533a0c...edfd13d04532e3e2d86677ce8d1fb5f0fc588904,1,1,1,2,1,2014-10-19 19:15:46,2014-10-19 19:06:47
edfd13d04532e3e2d86677ce8d1fb5f0fc588904...5f6b886405ed19ed5c779709c7f1581c1ed3eaed,1,9,8,17,4,2014-10-20 14:36:07,2014-10-17 17:37:40
5f6b886405ed19ed5c779709c7f1581c1ed3eaed...443d0ec836e6083cd59cc031213fe9c238337dc6,1,2,1,3,2,2014-10-20 14:36:07,2014-10-20 14:30:38
443d0ec836e6083cd59cc031213fe9c238337dc6...c00ab2830e245e72cf11bbce4dbda017e42276f0,4,104,39,143,16,2014-10-20 15:11:19,2014-10-20 14:31:33
c00ab2830e245e72cf11bbce4dbda017e42276f0...a5cc0c52ce3b52f5b9a23009a74fa848b4b308e1,1,1,1,2,1,2014-10-20 15:20:56,2014-10-20 14:03:04
a5cc0c52ce3b52f5b9a23009a74fa848b4b308e1...d119c7e78dd03714c4d8973d068a48e320eade18,4,101,59,160,11,2014-10-20 15:26:17,2014-10-16 17:51:02
d119c7e78dd03714c4d8973d068a48e320eade18...44e7b7fe3e545fc05699e864451ad85e7daa196b,1,1,1,2,1,2014-10-20 15:53:21,2014-10-20 15:35:08
44e7b7fe3e545fc05699e864451ad85e7daa196b...a7d8f02dea8b538d3f723c70f1c2d436db2a59a3,1,28,0,28,1,2014-10-20 16:16:46,2014-10-20 16:14:51
a7d8f02dea8b538d3f723c70f1c2d436db2a59a3...405882053351bcdb602ddac44f8ead8404ff9345,1,1,1,2,1,2014-10-20 16:49:29,2014-10-20 16:49:29
405882053351bcdb602ddac44f8ead8404ff9345...dea49e01a983036be793efa22874b2e600b735e0,2,22,23,45,12,2014-10-20 17:36:55,2014-10-20 17:07:06
dea49e01a983036be793efa22874b2e600b735e0...9206ed3dc94c7691f7e6ba40e3a0bfb78e1b1733,8,313,115,428,64,2014-10-20 17:36:56,2014-10-20 17:07:06
9206ed3dc94c7691f7e6ba40e3a0bfb78e1b1733...0916af4d9e45fcbe95fe5f43dc6f8902292467cd,4,0,158,158,4,2014-10-20 17:39:26,2014-10-20 17:39:04
0916af4d9e45fcbe95fe5f43dc6f8902292467cd...a621851eada5b2477ca6aa5e6e9455149af9cf56,1,2,2,4,2,2014-10-20 12:45:20,2014-10-20 10:50:41
a621851eada5b2477ca6aa5e6e9455149af9cf56...80ea7a136358ae0c9533feda29a2758ba063ef81,1,8,0,8,8,2014-10-20 17:51:59,2014-10-20 14:45:51
80ea7a136358ae0c9533feda29a2758ba063ef81...71e37fcefb2f7755f56859b90f8e6b8433b4c75e,1,2,2,4,2,2014-10-20 17:51:59,2014-10-20 15:22:15
71e37fcefb2f7755f56859b90f8e6b8433b4c75e...3683225e1184bd8119b4651d4ec10ea17a25e730,1,1,1,2,1,2014-10-20 13:13:41,2014-10-20 13:12:40
3683225e1184bd8119b4651d4ec10ea17a25e730...b39003c0b966ff882157c2bc1a4be4a5d1da5960,1,2,2,4,2,2014-10-20 18:45:38,2014-10-20 18:26:29
b39003c0b966ff882157c2bc1a4be4a5d1da5960...73c254c9ec183b11707d2cd78195711e6b32d13f,1,0,8,8,8,2014-10-20 19:02:28,2014-10-20 19:02:28
73c254c9ec183b11707d2cd78195711e6b32d13f...122d57ae22b8bc3544fce3e83c55f9eea1cbf7ab,2,57,2,59,9,2014-10-20 19:26:02,2014-10-17 21:52:08
122d57ae22b8bc3544fce3e83c55f9eea1cbf7ab...2722078c4092c311ca4d6387be37543c8a662c99,2,2,2,4,2,2014-10-20 19:31:30,2014-10-20 19:26:51
2722078c4092c311ca4d6387be37543c8a662c99...4b7eba4a0a4bbc4732c86c46f5c9d2f0b142b276,2,11,15,26,9,2014-10-20 19:57:47,2014-10-20 14:53:00
4b7eba4a0a4bbc4732c86c46f5c9d2f0b142b276...44b4e84fbfe462679fcce6f3d5540ff85b3c8104,5,44,30,74,12,2014-10-20 15:21:34,2014-10-15 14:47:56
44b4e84fbfe462679fcce6f3d5540ff85b3c8104...71ab802243a24aa6d173773d9bf0cb1a5f8b1f87,4,8,34,42,5,2014-10-20 15:21:34,2014-10-13 13:12:55
71ab802243a24aa6d173773d9bf0cb1a5f8b1f87...411206cce7076a018e3515e0aab4d498338b7e30,1,0,43,43,1,2014-10-20 15:21:34,2014-10-15 17:21:47
411206cce7076a018e3515e0aab4d498338b7e30...cc2a4db557b4107500a704ed09a7078767907a3d,1,160,188,348,5,2014-10-20 15:21:35,2014-10-15 18:17:12
cc2a4db557b4107500a704ed09a7078767907a3d...e9593e6deef8aa0c3c5ee304a8610dcf6d76bc07,1,73,0,73,1,2014-10-20 15:21:35,2014-10-16 11:24:06
e9593e6deef8aa0c3c5ee304a8610dcf6d76bc07...a3bc3a7d8199e52209c2cde08a97839f8e887bfb,3,187,1,188,3,2014-10-20 15:21:35,2014-10-20 13:06:42
a3bc3a7d8199e52209c2cde08a97839f8e887bfb...3683bb578d9d489655f72420463401283c9ac3da,1,4,0,4,1,2014-10-20 20:52:09,2014-10-20 20:52:09
3683bb578d9d489655f72420463401283c9ac3da...fec499ae311f1055bf12e0ec54342b9818d330be,1,8,1,9,2,2014-10-20 21:06:37,2014-10-20 19:24:43
fec499ae311f1055bf12e0ec54342b9818d330be...fe319d846b722e4b84ff1afa1b228f939b4324ce,1,17,5,22,3,2014-10-20 21:06:37,2014-10-20 19:43:10
fe319d846b722e4b84ff1afa1b228f939b4324ce...185bd3650d4b6326b42f3b756d90b0e78099b980,1,5,3,8,4,2014-10-20 22:17:54,2014-10-20 19:01:12
185bd3650d4b6326b42f3b756d90b0e78099b980...d3d87a2e21861668c4feed6e9bcd01c4840229aa,2,10,10,20,6,2014-10-20 22:34:03,2014-10-20 17:41:02
d3d87a2e21861668c4feed6e9bcd01c4840229aa...25a2dee43f03140c197df7e9e5e4a4e8e57a97cb,2,7,2,9,4,2014-10-21 13:09:36,2014-10-21 13:09:36
25a2dee43f03140c197df7e9e5e4a4e8e57a97cb...0bee61d26e44e26c2678d550990a57ce488f222d,9,26,1,27,10,2014-10-21 14:25:48,2014-10-21 14:23:50
0bee61d26e44e26c2678d550990a57ce488f222d...011dde7e6eac3b73cb1d2a7f004feee9bed99c46,61,1054,606,1660,463,2014-10-21 14:32:59,2014-10-21 14:24:24
011dde7e6eac3b73cb1d2a7f004feee9bed99c46...18ea1d512ea2d4b2cebf6cfd2e1340c876e70dd5,1,8,0,8,1,2014-10-21 14:42:13,2014-10-21 14:41:53
18ea1d512ea2d4b2cebf6cfd2e1340c876e70dd5...46052c147654f229df903bf4f37410b159cfe11e,1,0,59,59,1,2014-10-21 14:44:05,2014-10-21 14:44:05
46052c147654f229df903bf4f37410b159cfe11e...40f72b78059fc21f60638ac7467a0d03b369c400,1,1,1,2,1,2014-10-21 14:55:10,2014-10-21 14:52:32
40f72b78059fc21f60638ac7467a0d03b369c400...80a4c4c9c5e1d88ce688c582c31237a7a2ef4141,1,6,0,6,2,2014-10-21 15:32:03,2014-10-21 14:59:32
80a4c4c9c5e1d88ce688c582c31237a7a2ef4141...57f036a36923b3d6bef6219768f6c65f18bd133a,1,1,4,5,2,2014-10-21 15:41:19,2014-10-21 15:41:06
57f036a36923b3d6bef6219768f6c65f18bd133a...6358990a2481ac63944e4758a96a383126895087,3,6,362,368,9,2014-10-21 15:54:16,2014-10-21 15:41:09
6358990a2481ac63944e4758a96a383126895087...da9927d08b550c4bec17ffc1b1d93ca3519285f6,2,19,11,30,8,2014-10-21 17:01:50,2014-10-20 22:28:02
da9927d08b550c4bec17ffc1b1d93ca3519285f6...91c8c4425c16639176033596e7e88788e8992075,2,19,1,20,3,2014-10-21 17:56:18,2014-10-21 15:19:58
91c8c4425c16639176033596e7e88788e8992075...a1a355671eb9edbc36673616e1590fcd4c24d7ef,1,11,1,12,1,2014-10-21 18:59:10,2014-10-21 18:59:10
a1a355671eb9edbc36673616e1590fcd4c24d7ef...ab2cd3816b4a7e8608896d2ccb4f35ee235326f8,15,213,100,313,23,2014-10-21 18:58:15,2014-10-21 01:04:56
ab2cd3816b4a7e8608896d2ccb4f35ee235326f8...f83c447aba7cd5dca5bd20c4925d93eb30eccfb4,1,20,4,24,4,2014-10-21 19:01:30,2014-10-21 14:58:23
f83c447aba7cd5dca5bd20c4925d93eb30eccfb4...cadfa581eed203a2d728153945a800a204ccf3bd,1,2,1,3,1,2014-10-21 19:33:13,2014-10-21 19:32:22
cadfa581eed203a2d728153945a800a204ccf3bd...3604c4f47cc7e433e780041388e65802729b06bb,1,7,6,13,2,2014-10-21 19:55:54,2014-10-21 15:55:06
3604c4f47cc7e433e780041388e65802729b06bb...dccc3783225ed670bf838ea61f02f3641685afd5,1,1,1,2,1,2014-10-21 15:20:23,2014-10-21 14:56:31
dccc3783225ed670bf838ea61f02f3641685afd5...29a0043a32be33533ea6dba6d8d73b97d582d311,1,1,0,1,1,2014-10-21 20:54:49,2014-10-21 20:54:49
29a0043a32be33533ea6dba6d8d73b97d582d311...a1a2e24b34d818cfed86b3ad5eb01d62bc375eaa,1,1,1,2,1,2014-10-21 20:56:41,2014-10-21 20:56:41
a1a2e24b34d818cfed86b3ad5eb01d62bc375eaa...11ad1edebfafea650ff00912bdf7a3a48dede144,15,55,8,63,26,2014-10-21 21:43:50,2014-10-21 19:37:06
11ad1edebfafea650ff00912bdf7a3a48dede144...ede05b3fc832e015241702fa19a92d63f2f00481,3,27,1,28,7,2014-10-21 22:28:56,2014-10-21 20:04:12
ede05b3fc832e015241702fa19a92d63f2f00481...9fbc9684ce381f5ef49709696ad0eb69f521d93c,3,152,95,247,38,2014-10-21 22:31:56,2014-10-21 21:44:23
9fbc9684ce381f5ef49709696ad0eb69f521d93c...3340ca09d383bcdf257402bc9b264529429ea97a,1,2,1,3,1,2014-10-22 12:43:25,2014-10-22 12:43:25
3340ca09d383bcdf257402bc9b264529429ea97a...0da60795c42f4e93cc0d8913c0fdd93dd670da41,4,9,39,48,8,2014-10-22 14:16:49,2014-10-22 14:14:46
0da60795c42f4e93cc0d8913c0fdd93dd670da41...0e9cb3b20498b9f167afaff7a5c4a4d1da7e06a2,7,7,7,14,7,2014-10-22 18:11:24,2014-10-22 18:10:37
0e9cb3b20498b9f167afaff7a5c4a4d1da7e06a2...c98f21a43c7884f0ca850eb0871ce219c2029630,7,7,7,14,7,2014-10-23 01:42:30,2014-10-23 01:42:30
c98f21a43c7884f0ca850eb0871ce219c2029630...bba0eef629a4b51718c85a50637d580bf9feca02,8,21,10,31,10,2014-10-23 02:03:57,2014-10-21 16:00:36
bba0eef629a4b51718c85a50637d580bf9feca02...d0637b4b49cda65dc812badd74c3a68b0a5b579f,5,25,6,31,13,2014-10-23 02:03:57,2014-10-21 17:40:58
d0637b4b49cda65dc812badd74c3a68b0a5b579f...4b14f63178f5d1e50e847e7269ffb59294f19b4c,4,4,4,8,4,2014-10-23 15:55:12,2014-10-20 22:53:06
4b14f63178f5d1e50e847e7269ffb59294f19b4c...c76d80bce0212fe9770ddb6876878eb16014769b,1,1,1,2,1,2014-10-23 15:55:43,2014-10-23 15:16:21
c76d80bce0212fe9770ddb6876878eb16014769b...602fa05f61b61835b92c8efed2e3354d92ebbe66,2,15,1,16,5,2014-10-23 16:06:37,2014-10-21 21:19:30
602fa05f61b61835b92c8efed2e3354d92ebbe66...ae7861b3333b6b4b940b2a1ab6267a0140294ee9,1,1,1,2,1,2014-10-23 17:42:57,2014-10-23 16:08:00
ae7861b3333b6b4b940b2a1ab6267a0140294ee9...629243d3ec1e0834754574d0dffb59c43d35e85e,12,210,135,345,85,2014-10-23 18:02:08,2014-10-20 21:50:18
629243d3ec1e0834754574d0dffb59c43d35e85e...5f4cc63e737af5a4fa19d2f0cf33599c231ef1e4,3,9,58,67,13,2014-10-23 18:02:09,2014-10-22 00:34:06
5f4cc63e737af5a4fa19d2f0cf33599c231ef1e4...f9b55402aa1155d9a3f2130110d25f9f0322c5a9,3,58,9,67,13,2014-10-23 19:11:20,2014-10-23 19:11:20
f9b55402aa1155d9a3f2130110d25f9f0322c5a9...c86905bd4d22f14656b3b058ab0bf4880f3c7258,12,135,210,345,83,2014-10-23 19:11:41,2014-10-23 19:11:41
c86905bd4d22f14656b3b058ab0bf4880f3c7258...a0782a32be8aad87df56c4dc8bb1fe8b3694c1d6,3,9,58,67,13,2014-10-24 19:28:14,2014-10-24 19:27:56
a0782a32be8aad87df56c4dc8bb1fe8b3694c1d6...6af18473e8e15aa58040396482fff3cb937f1959,13,226,149,375,100,2014-10-24 19:39:40,2014-10-24 19:28:40
6af18473e8e15aa58040396482fff3cb937f1959...4adf252b7e579c154a785ab0f8726be592cf7895,1,2,0,2,1,2014-10-25 00:28:09,2014-10-21 13:45:01
4adf252b7e579c154a785ab0f8726be592cf7895...cfa687f1d9cb4d81046775852710c5883d6136a2,2,1,1,2,1,2014-10-25 00:28:09,2014-10-21 13:45:18
cfa687f1d9cb4d81046775852710c5883d6136a2...f863b0bf23bd2a0c573f0a3cfbf603a492f1741d,1,2,2,4,1,2014-10-25 00:28:09,2014-10-21 16:03:13
f863b0bf23bd2a0c573f0a3cfbf603a492f1741d...1efcb9b092f218178bbc78ca4bf5f7c1a720ffb8,1,29,4,33,8,2014-10-27 12:41:54,2014-10-27 12:41:54
1efcb9b092f218178bbc78ca4bf5f7c1a720ffb8...8713e23181b9c702681bf4667475078bdaf39c46,2,3,3,6,3,2014-10-27 12:45:44,2014-10-27 12:45:44
8713e23181b9c702681bf4667475078bdaf39c46...30c251f3ea803729b7240c784cf6d897cc7a313e,1,3,3,6,2,2014-10-27 12:51:52,2014-10-27 12:51:52
30c251f3ea803729b7240c784cf6d897cc7a313e...ee2303939ee8cd88a5ff2ba78c0a67b69282891e,1,4,0,4,1,2014-10-27 12:57:22,2014-10-27 12:57:22
ee2303939ee8cd88a5ff2ba78c0a67b69282891e...52bef37842c1b78e3378a5a931ba8c428aad8e6a,1,9,2,11,2,2014-10-27 13:17:54,2014-10-20 18:05:02
52bef37842c1b78e3378a5a931ba8c428aad8e6a...5d803f7e889841f864056f5251f89663e331eb15,4,28,13,41,11,2014-10-27 14:19:02,2014-10-20 20:11:21
5d803f7e889841f864056f5251f89663e331eb15...0fde30ad2f873e7f835aa224e83a97ae6d4a171e,1,101,94,195,16,2014-10-27 15:03:25,2014-10-10 20:34:02
0fde30ad2f873e7f835aa224e83a97ae6d4a171e...c1c1116c488351e0cdbd7626dcc8ce1f5dc828af,50,210,72,282,65,2014-10-27 15:07:37,2014-10-23 19:57:12
c1c1116c488351e0cdbd7626dcc8ce1f5dc828af...c2368fb8257275942ff4a6b2020663d57bc08bf1,2,6,9,15,6,2014-10-27 15:07:37,2014-10-17 17:26:57
c2368fb8257275942ff4a6b2020663d57bc08bf1...3ab3cefd696253cc81b5f891c2ea7d60384f596b,3,9,7,16,8,2014-10-27 15:46:37,2014-09-26 17:55:13
3ab3cefd696253cc81b5f891c2ea7d60384f596b...f8e17bdbf4393784b0ecf7da8e9b549be2d8a6ba,1,0,7,7,6,2014-10-27 16:18:41,2014-10-24 20:43:04
f8e17bdbf4393784b0ecf7da8e9b549be2d8a6ba...197358e4cf4cdb99d94ea668243a4cd4791bd523,1,0,2,2,2,2014-10-27 16:18:42,2014-10-24 13:41:18
197358e4cf4cdb99d94ea668243a4cd4791bd523...2b8e7ed5681abccd9aa6c53943322979b079dda1,1,2,1,3,1,2014-10-27 16:37:33,2014-10-27 16:37:33
2b8e7ed5681abccd9aa6c53943322979b079dda1...ca29cc4f4f9b7de04dc507c0428da898cbd1c9cd,1,5,2,7,3,2014-10-27 17:07:15,2014-10-27 16:22:10
ca29cc4f4f9b7de04dc507c0428da898cbd1c9cd...9c6ec970c5e7c7c8058008d30951430d149b3968,5,12,104,116,12,2014-10-27 17:07:20,2014-08-18 20:32:08
9c6ec970c5e7c7c8058008d30951430d149b3968...8bfdb8c34ea2c786ca140bc0e9f9e7a3d52c3f63,5,18,2,20,6,2014-10-27 17:07:20,2014-10-16 22:58:20
8bfdb8c34ea2c786ca140bc0e9f9e7a3d52c3f63...1ccde1e095c8b18280417fd2ef638db7e956423a,4,51,92,143,21,2014-10-27 17:07:20,2014-10-17 17:30:42
1ccde1e095c8b18280417fd2ef638db7e956423a...72abd814bb6e2b8d51774b6e19d9ae47255471c8,2,122,66,188,39,2014-10-27 17:07:20,2014-10-17 19:27:51
72abd814bb6e2b8d51774b6e19d9ae47255471c8...49837594e7c52e2426d6b08dfa8131b4b3590e40,3,48,12,60,18,2014-10-27 17:07:21,2014-10-17 22:35:22
49837594e7c52e2426d6b08dfa8131b4b3590e40...6d7f968a9495b504bea981e392f5ec60a947123e,13,155,905,1060,76,2014-10-27 17:07:21,2014-10-17 22:37:20
6d7f968a9495b504bea981e392f5ec60a947123e...5e002ec6062113568a6575f64b0d2d4de27210b3,5,12,3,15,7,2014-10-27 17:07:21,2014-10-20 21:18:44
5e002ec6062113568a6575f64b0d2d4de27210b3...4619c719ff9e3470e44eed28b17f5359445c6539,9,242,37,279,38,2014-10-27 17:07:21,2014-10-21 22:52:42
4619c719ff9e3470e44eed28b17f5359445c6539...147f75df6b0d7826f5851023755b7341f467989a,1,115,12,127,19,2014-10-27 17:11:13,2014-10-27 17:06:01
147f75df6b0d7826f5851023755b7341f467989a...a3dd680c584ff19272a6e3b70fd4a308c6e8238a,1,65,65,130,1,2014-10-27 17:38:38,2014-10-27 16:19:18
a3dd680c584ff19272a6e3b70fd4a308c6e8238a...eb4df26203fb5f242d36751a67c318313d36e121,2,111,26,137,8,2014-10-27 17:38:43,2014-10-27 16:25:12
eb4df26203fb5f242d36751a67c318313d36e121...2509427be884a0a127b230bf4c2f98ac007aa05a,2,4,3,7,4,2014-10-27 17:59:21,2014-10-27 17:50:48
2509427be884a0a127b230bf4c2f98ac007aa05a...28373a8a57c5caec25c02efb8b365f20d05387c6,33,40,37,77,40,2014-10-27 18:00:14,2014-10-10 20:59:23
28373a8a57c5caec25c02efb8b365f20d05387c6...9c1573b696246268f7b24b62391164451233283d,1,65,65,130,1,2014-10-27 18:52:40,2014-10-27 18:52:40
9c1573b696246268f7b24b62391164451233283d...f786bf15bd9dc5100c53c7f8a5b2080a3a8cf476,6,29,72,101,7,2014-10-27 19:14:27,2014-10-27 16:37:50
f786bf15bd9dc5100c53c7f8a5b2080a3a8cf476...9f303d49df1530abb6caaf52864d2dddd0390234,7,17,15,32,14,2014-10-27 19:30:31,2014-10-27 13:15:16
9f303d49df1530abb6caaf52864d2dddd0390234...5298705477bf30ebb1cc2b95732651750f6f27f0,2,36,0,36,2,2014-10-27 20:46:52,2014-10-27 20:12:22
5298705477bf30ebb1cc2b95732651750f6f27f0...5734a6acf5f9bb8a0816c537d232530deda247c8,1,9,0,9,2,2014-10-27 20:47:13,2014-10-27 20:03:54
5734a6acf5f9bb8a0816c537d232530deda247c8...984094c42a0dc60673699682494fe7731b245188,14,189,138,327,80,2014-10-27 20:49:36,2014-10-15 19:40:02
984094c42a0dc60673699682494fe7731b245188...b913e5c3a9f07e99b230fb13f19782295e43d28b,3,32,37,69,19,2014-10-27 20:49:36,2014-10-15 20:17:59
b913e5c3a9f07e99b230fb13f19782295e43d28b...9d1dfccfb6b50a0eb5f7e7a48126560348f22b58,5,338,186,524,67,2014-10-27 20:49:37,2014-10-16 22:31:04
9d1dfccfb6b50a0eb5f7e7a48126560348f22b58...f2d64af58205b77e4b9e4c7f3af9d3457d1bf0db,3,51,44,95,21,2014-10-27 20:49:37,2014-10-17 19:03:37
f2d64af58205b77e4b9e4c7f3af9d3457d1bf0db...07c0c80e190206b8e6f037a885bc5971a78cae3e,5,22,13,35,13,2014-10-27 20:52:06,2014-10-27 17:31:30
07c0c80e190206b8e6f037a885bc5971a78cae3e...3c6d2341f54e272990a5b233e7b7eda39bf7d682,3,15,6,21,5,2014-10-27 20:53:29,2014-10-14 20:38:46
3c6d2341f54e272990a5b233e7b7eda39bf7d682...840d1f413dd3340cfa66fcd3cf95f3fd2d15e5ce,1,1,0,1,1,2014-10-27 21:03:39,2014-10-27 21:03:39
840d1f413dd3340cfa66fcd3cf95f3fd2d15e5ce...a36b3548ae1cddd17ed46c6c27e7ef4277af8479,1,28,0,28,1,2014-10-27 21:34:09,2014-10-27 21:34:09
a36b3548ae1cddd17ed46c6c27e7ef4277af8479...23bd6572e3affc2b2fbe97fc1fef87e191c6a5b9,2,12,1,13,3,2014-10-27 21:40:54,2014-10-23 19:47:51
23bd6572e3affc2b2fbe97fc1fef87e191c6a5b9...ac6f014e13471ae8a6a7d9379de671377c99f7f9,1,1,1,2,1,2014-10-27 21:53:39,2014-10-27 21:01:11
ac6f014e13471ae8a6a7d9379de671377c99f7f9...98b886ba693c69b4f9fa25e55a03b65c45f317cb,2,15,8,23,6,2014-10-27 21:56:04,2014-10-27 20:47:28
98b886ba693c69b4f9fa25e55a03b65c45f317cb...f6a2b20d8b49a0cd2065e16dfeb87de6c14bb5d0,8,58,0,58,9,2014-10-27 22:00:37,2014-10-15 21:23:43
f6a2b20d8b49a0cd2065e16dfeb87de6c14bb5d0...29c7fa3624b3e5402299aea6be39fb514d6e88da,1,1,0,1,1,2014-10-27 22:00:37,2014-10-27 21:12:33
29c7fa3624b3e5402299aea6be39fb514d6e88da...aef79c02617cf8a1e78dff726e891817e00c35a8,1,4,0,4,1,2014-10-27 22:00:37,2014-10-27 21:31:30
aef79c02617cf8a1e78dff726e891817e00c35a8...cb7ac23702a553ce43950451587b5788de50e5a5,1,3,5,8,3,2014-10-27 22:04:33,2014-10-27 20:25:00
cb7ac23702a553ce43950451587b5788de50e5a5...3b97bc5529659f5d5f241dd6347f5701223c36ec,1,0,6,6,6,2014-10-27 22:44:22,2014-10-27 22:36:54
3b97bc5529659f5d5f241dd6347f5701223c36ec...47c80ebc62f3e59e13a05b3301316e088cf278e7,1,1,1,2,1,2014-10-28 01:22:58,2014-10-28 01:22:30
47c80ebc62f3e59e13a05b3301316e088cf278e7...5a9cd759519f5831efffa7015996526270f7e5ef,3,43,3,46,6,2014-10-28 02:01:27,2014-10-28 02:01:27
5a9cd759519f5831efffa7015996526270f7e5ef...1e5ccf29c485109c22338fda2c8c46bf1c600f87,8,30,17,47,16,2014-10-28 03:29:19,2014-10-27 21:04:23
1e5ccf29c485109c22338fda2c8c46bf1c600f87...b0e565aed756c31f682d486a7874f14a8a563e61,16,6,39,45,29,2014-10-28 13:06:20,2014-10-28 03:04:19
b0e565aed756c31f682d486a7874f14a8a563e61...589a52d8e966cd11b568038fadb4a27c3ffbe835,4,33,33,66,33,2014-10-28 13:22:01,2014-10-27 22:54:52
589a52d8e966cd11b568038fadb4a27c3ffbe835...364b03260ef5e06a58568c57a1e44fd2fcd7cb8e,1,62,12,74,3,2014-10-28 13:57:11,2014-10-28 13:57:11
364b03260ef5e06a58568c57a1e44fd2fcd7cb8e...820ddf307a075ecfb5e122ab4d3e46f518843cc1,1,7,5,12,3,2014-10-28 14:19:15,2014-10-27 18:52:20
820ddf307a075ecfb5e122ab4d3e46f518843cc1...1eaf471255d03d7f14642292c3e50abca542e64c,1,39,26,65,5,2014-10-28 14:19:15,2014-10-27 19:29:55
1eaf471255d03d7f14642292c3e50abca542e64c...f6af4485d9727143cb433fd0ccf919d1e56e063b,1,146,0,146,1,2014-10-28 14:52:31,2014-10-16 20:03:54
f6af4485d9727143cb433fd0ccf919d1e56e063b...a712924ae72fee04f1a06f91fda9dc98d6781a65,2,4,35,39,3,2014-10-28 15:27:25,2014-10-28 15:27:25
a712924ae72fee04f1a06f91fda9dc98d6781a65...5cd7a28c3f2009d5e5024b6074284e99e3203ce7,3,26,44,70,4,2014-10-28 15:27:25,2014-10-28 15:27:25
5cd7a28c3f2009d5e5024b6074284e99e3203ce7...17917954b999b689cac37695e2885b2d35be9014,3,21,19,40,10,2014-10-28 15:27:25,2014-10-28 15:27:25
17917954b999b689cac37695e2885b2d35be9014...a0e5fbf5e64bd98be827cd11a1d77ade9b5b3128,7,116,81,197,43,2014-10-28 15:49:33,2014-10-15 14:50:05
a0e5fbf5e64bd98be827cd11a1d77ade9b5b3128...8297b403170178d8d2b58b62753e597695745fa5,1,15,6,21,2,2014-10-28 15:52:16,2014-10-16 17:14:07
8297b403170178d8d2b58b62753e597695745fa5...06497db54ab5645d91d6ebfb5d17ebf55d572126,38,44515,0,44515,32,2014-10-28 15:53:40,2014-10-28 15:52:17
06497db54ab5645d91d6ebfb5d17ebf55d572126...1d869c4f9b4727d1420901b0bf4c3f467591e377,2,2,10,12,4,2014-10-28 15:55:48,2014-10-28 15:52:54
1d869c4f9b4727d1420901b0bf4c3f467591e377...ca1338ccef5375923da9938e84dc0f7fe393af2c,6,59,25,84,26,2014-10-28 16:02:48,2014-10-27 19:51:58
ca1338ccef5375923da9938e84dc0f7fe393af2c...b9ebf15a7afa4f8db780b6ba06fc796c1ee2816e,15,22,75,97,20,2014-10-28 16:02:49,2014-10-27 20:25:02
b9ebf15a7afa4f8db780b6ba06fc796c1ee2816e...86bfedc570002dae7d0d15d62e02001d0ed7fd04,2,113,0,113,2,2014-10-28 17:25:30,2014-10-28 16:05:11
86bfedc570002dae7d0d15d62e02001d0ed7fd04...87d6149c5316e0d8121c8045cbac7ad0161701b9,1,4,4,8,3,2014-10-28 17:33:45,2014-10-27 22:29:32
87d6149c5316e0d8121c8045cbac7ad0161701b9...e94496a28a0789a863d2fae9947d1e2dde8d0a6c,2,40,12,52,8,2014-10-28 17:46:35,2014-10-28 16:26:29
e94496a28a0789a863d2fae9947d1e2dde8d0a6c...ad23cca4ee1f4757ba62574ba6c07a01320935ed,1,14,0,14,1,2014-10-28 17:51:17,2014-10-28 16:00:46
ad23cca4ee1f4757ba62574ba6c07a01320935ed...be1e4cda692e6b852ed944aabcb50a23b6260262,1,5,3,8,4,2014-10-28 17:56:50,2014-10-28 16:08:02
be1e4cda692e6b852ed944aabcb50a23b6260262...4d8aa08ef8b45a9d62dff13b96b210d30099fa7d,1,40,0,40,1,2014-10-28 13:09:05,2014-10-20 17:26:12
4d8aa08ef8b45a9d62dff13b96b210d30099fa7d...fa5739c7f089f371b3a0f17c8b1eba709b5eb0a7,1,227,14,241,17,2014-10-28 13:44:28,2014-10-16 17:33:18
fa5739c7f089f371b3a0f17c8b1eba709b5eb0a7...300e01c849bc20de82f32a00e5c44fe0f1d26752,1,1,1,2,1,2014-10-28 18:54:26,2014-10-21 18:02:50
300e01c849bc20de82f32a00e5c44fe0f1d26752...80c750e543dbd2afa1b806fd9b617605a136706c,1,6,3,9,3,2014-10-28 19:24:35,2014-10-28 18:16:12
80c750e543dbd2afa1b806fd9b617605a136706c...18e5b98a603def84221460745f5f3e1566a7e775,1,2,4,6,1,2014-10-28 14:32:40,2014-10-27 18:51:07
18e5b98a603def84221460745f5f3e1566a7e775...4752c4631525b7d26599fb89a0ae18784ebbcc73,9,59,12,71,19,2014-10-28 14:38:35,2014-10-27 09:24:02
4752c4631525b7d26599fb89a0ae18784ebbcc73...9b06f0011e53cba1be7c5f123d2a9f9dd79ed4e6,1,6,1,7,2,2014-10-28 19:51:21,2014-10-28 17:58:21
9b06f0011e53cba1be7c5f123d2a9f9dd79ed4e6...7e8bb0c194f08db2cce0e1256557ae71eb0a1538,4,12,87,99,12,2014-10-28 19:55:42,2014-10-27 15:03:43
7e8bb0c194f08db2cce0e1256557ae71eb0a1538...a8a61f944ce53467f61a17a27de7031b280c4958,2,0,17,17,2,2014-10-28 19:55:42,2014-10-27 18:05:24
a8a61f944ce53467f61a17a27de7031b280c4958...913cb4dd7df0d9210f48efe07da27cebe24e8836,3,1,41,42,7,2014-10-28 19:55:42,2014-10-27 18:46:35
913cb4dd7df0d9210f48efe07da27cebe24e8836...bd4479561c02e049ccac63f753b1d28f406583df,4,53,10,63,11,2014-10-28 19:59:51,2014-10-28 15:34:04
bd4479561c02e049ccac63f753b1d28f406583df...437c43cd63a2ffe52e2f524c6fd90a5d9a9856bd,1,1,1,2,1,2014-10-28 15:03:38,2014-10-28 15:01:28
437c43cd63a2ffe52e2f524c6fd90a5d9a9856bd...ec9aa9e453442c7b536b54587637ac25a77586f5,1,1,1,2,1,2014-10-28 15:15:58,2014-10-28 15:15:58
ec9aa9e453442c7b536b54587637ac25a77586f5...f8232abbc3b742f00764a82059b5f8d18539bf1b,1,5,2,7,1,2014-10-28 20:36:58,2014-10-28 13:28:36
f8232abbc3b742f00764a82059b5f8d18539bf1b...083474cc37be86d9cb6302b8fe899293eb692429,3,72,53,125,16,2014-10-28 20:40:18,2014-10-28 18:01:01
083474cc37be86d9cb6302b8fe899293eb692429...6fbc49d08f65b7687eb843dd3757f41a273ea855,2,13,13,26,3,2014-10-28 20:42:17,2014-10-28 19:53:23
6fbc49d08f65b7687eb843dd3757f41a273ea855...05bb8e47cabe6ebe025b4cc94027124816f25c3a,4,20,6,26,8,2014-10-28 20:48:20,2014-10-28 20:43:04
05bb8e47cabe6ebe025b4cc94027124816f25c3a...370dd5521a9c218cd687e13eb833aa85a6d32f7c,1,1,1,2,1,2014-10-28 20:50:56,2014-10-28 20:04:31
370dd5521a9c218cd687e13eb833aa85a6d32f7c...4f4a5103f190dd7d1b01391546f1c7cb5b2adf5b,1,1,1,2,1,2014-10-28 21:26:48,2014-10-28 21:26:48
4f4a5103f190dd7d1b01391546f1c7cb5b2adf5b...33d59e5d8cded2e0eab2b9e370727eac5e4d020c,1,19,8,27,2,2014-10-28 21:54:02,2014-10-27 18:25:47
33d59e5d8cded2e0eab2b9e370727eac5e4d020c...385f03dc7205ef60bbb9cb8b475afd9c802bc67d,7,385,50,435,43,2014-10-28 22:19:32,2014-10-07 19:59:32
385f03dc7205ef60bbb9cb8b475afd9c802bc67d...df128f1328ce12ac098aecafa43cb5e0eda6d3e0,2,57,26,83,16,2014-10-28 22:32:59,2014-10-28 18:28:13
df128f1328ce12ac098aecafa43cb5e0eda6d3e0...73f4e5dceae76e4513128b186982f108a5ffea6c,1,8,19,27,2,2014-10-29 00:34:31,2014-10-29 00:34:31
73f4e5dceae76e4513128b186982f108a5ffea6c...981b06c8c664c17fb13cf50bc3b7dde2d05b016b,6,53,7,60,9,2014-10-29 14:37:24,2014-10-28 20:25:02
981b06c8c664c17fb13cf50bc3b7dde2d05b016b...6d7db77a9c39e96faa7f3b2a9077b8307ab9d8dc,1,29,29,58,19,2014-10-29 15:16:27,2014-10-28 18:40:05
6d7db77a9c39e96faa7f3b2a9077b8307ab9d8dc...611c9709df6895880e609e53e5eeaf612972367f,2,344,1,345,2,2014-10-29 15:16:27,2014-10-28 18:40:49
611c9709df6895880e609e53e5eeaf612972367f...f04e9c870fc841e403e49401c9827c4bd2c3e602,3,12,6,18,7,2014-10-29 15:48:18,2014-10-28 19:50:50
f04e9c870fc841e403e49401c9827c4bd2c3e602...9f821e0faab68987f9e2b818ff861528363c4d72,4,222,9,231,9,2014-10-29 11:26:00,2014-10-16 14:35:07
9f821e0faab68987f9e2b818ff861528363c4d72...27c5131ff96d66ecc7ac8f7eee0ba72a7aa3c890,1,2,2,4,1,2014-10-29 17:00:30,2014-10-29 16:57:35
27c5131ff96d66ecc7ac8f7eee0ba72a7aa3c890...fbbb0d2a1d845728cd714272199a652573e2f27d,5,54,13,67,13,2014-10-29 17:03:38,2014-10-27 18:53:04
fbbb0d2a1d845728cd714272199a652573e2f27d...9ee6312856015289fae7c85999f4bbd13fae4fb2,1,3,11,14,3,2014-10-29 17:05:59,2014-10-29 01:23:48
9ee6312856015289fae7c85999f4bbd13fae4fb2...46126da010f8d7803814e21b7de04d512e92b8ee,1,102,122,224,17,2014-10-29 17:06:00,2014-10-29 13:21:37
46126da010f8d7803814e21b7de04d512e92b8ee...205756215a42aa6abf8caca6577e4148833b50c5,5,189,9,198,19,2014-10-29 17:22:47,2014-10-27 17:42:29
205756215a42aa6abf8caca6577e4148833b50c5...32a5c787a2545f27f0d1aeeb43764c40ae48e32b,11,203,35,238,19,2014-10-29 18:07:47,2014-10-16 14:49:36
32a5c787a2545f27f0d1aeeb43764c40ae48e32b...9630dcbf6e50c32df0d048c5e0d5ad9b3663def8,2,9,0,9,3,2014-10-29 19:04:13,2014-10-29 14:33:05
9630dcbf6e50c32df0d048c5e0d5ad9b3663def8...0612489d1cbfe85a153280611c53d1814e852ab4,1,32,2,34,3,2014-10-29 19:24:15,2014-10-28 20:52:14
0612489d1cbfe85a153280611c53d1814e852ab4...1b2806490da6c3972d9524e2600fdb0c0c7d3c1a,2,19,16,35,3,2014-10-29 19:26:32,2014-10-27 18:25:47
1b2806490da6c3972d9524e2600fdb0c0c7d3c1a...ce6a6a4f55c29286860ac1993d5929da0205ff8c,1,298,63,361,25,2014-10-29 19:33:11,2014-10-29 19:23:47
ce6a6a4f55c29286860ac1993d5929da0205ff8c...200a82d4ecc77a4219d7cfcfb1f879e383a5e7bf,2,5,0,5,3,2014-10-29 19:38:53,2014-10-29 15:01:23
200a82d4ecc77a4219d7cfcfb1f879e383a5e7bf...f40b2d965148e1b47a91312ae54602237ddaabe0,3,185,122,307,31,2014-10-29 19:45:07,2014-10-29 19:44:37
f40b2d965148e1b47a91312ae54602237ddaabe0...ed0947b4ca2c71f4c16fa38cc18a858249910b87,8,579,36,615,40,2014-10-29 20:35:10,2014-10-20 22:36:39
ed0947b4ca2c71f4c16fa38cc18a858249910b87...e192dc12571f5388a5005c3e71f6c1f497efa6ad,6,109,96,205,32,2014-10-29 20:35:12,2014-10-27 20:35:27
e192dc12571f5388a5005c3e71f6c1f497efa6ad...4abd12a3c899f9c06bf0ca26877ca536635b1ebf,1,3,8,11,2,2014-10-29 20:40:32,2014-10-29 20:20:21
4abd12a3c899f9c06bf0ca26877ca536635b1ebf...b54f6d47985d09884ee6ec17bed1b952e713eabe,2,0,9,9,3,2014-10-29 15:48:33,2014-10-29 11:19:38
b54f6d47985d09884ee6ec17bed1b952e713eabe...6cd43a9a5bc9d491b4daf5dea1c3cf21bb138f5a,2,18,2,20,2,2014-10-29 21:22:52,2014-10-29 17:42:07
6cd43a9a5bc9d491b4daf5dea1c3cf21bb138f5a...482feea030569a59ff3ab55e301c1173d859c219,5,61,10,71,13,2014-10-29 21:24:59,2014-10-29 20:13:54
482feea030569a59ff3ab55e301c1173d859c219...bee3c90e41683047cbacd63e4a4e0e8b94501fe4,12,728,1,729,18,2014-10-29 21:42:13,2014-10-28 14:04:38
bee3c90e41683047cbacd63e4a4e0e8b94501fe4...873f985afc5d4ad88f8be57f19fde6a3814ad5d6,1,8,2,10,2,2014-10-29 21:56:55,2014-10-29 20:15:28
873f985afc5d4ad88f8be57f19fde6a3814ad5d6...1a7b6ac57e41600ae781a28ca68c244e3d65acb8,2,26,22,48,11,2014-10-29 22:41:27,2014-10-28 13:03:47
1a7b6ac57e41600ae781a28ca68c244e3d65acb8...afac6e80494b1804634d28f1e49f43674dc42254,4,36,27,63,7,2014-10-29 22:41:27,2014-10-28 16:25:03
afac6e80494b1804634d28f1e49f43674dc42254...05695e9f4705a8a2309cf8adbbb01019a8c01fdd,1,7,1,8,3,2014-10-29 22:41:28,2014-10-29 15:21:03
05695e9f4705a8a2309cf8adbbb01019a8c01fdd...ce7e562c4c139279f81b855748cf0e73daef5783,1,0,16,16,1,2014-10-29 22:41:28,2014-10-29 15:21:22
ce7e562c4c139279f81b855748cf0e73daef5783...0c965c5ee9b9eb9b2d53ae29a9af6b2f7921f4dc,2,19,1,20,6,2014-10-29 22:41:28,2014-10-29 17:00:23
0c965c5ee9b9eb9b2d53ae29a9af6b2f7921f4dc...1b9f7d763c75fb5c6f13a2c619381494edd81898,2,4,2,6,2,2014-10-29 22:41:28,2014-10-29 22:40:05
1b9f7d763c75fb5c6f13a2c619381494edd81898...1b9d93acfaee902dacafc5ca35ac12f0219a170d,2,101,14,115,7,2014-10-29 22:56:11,2014-10-29 22:53:02
1b9d93acfaee902dacafc5ca35ac12f0219a170d...52b86fc2793042fe50dda8bf47844b71b3eb6e8d,8,160,88,248,28,2014-10-29 23:46:10,2014-10-29 16:52:45
52b86fc2793042fe50dda8bf47844b71b3eb6e8d...2f67e702915e1a7f400875ab28d10a10873581a3,1,9,1,10,2,2014-10-30 03:18:07,2014-10-28 20:25:35
2f67e702915e1a7f400875ab28d10a10873581a3...f3715ef1516ce423231cfd654b2c2ac546c2e0bb,3,2,9,11,8,2014-10-30 13:36:09,2014-10-30 01:16:16
f3715ef1516ce423231cfd654b2c2ac546c2e0bb...f5e67009ead674efb7cf16da2c1c462cc99424db,2,7,7,14,7,2014-10-30 15:00:15,2014-10-29 17:05:51
f5e67009ead674efb7cf16da2c1c462cc99424db...9cd693c414ce483c02211fe01f41540bcf4ba8bc,1,12,7,19,4,2014-10-30 17:10:49,2014-10-30 14:24:27
9cd693c414ce483c02211fe01f41540bcf4ba8bc...684d2015023008f07232036a8bf54cbb6edb122d,1,15,0,15,1,2014-10-30 17:31:56,2014-10-30 17:27:26
684d2015023008f07232036a8bf54cbb6edb122d...8c3db8a30473348ec3cf1aed77bded1a5ef1dfa8,1,1,0,1,1,2014-10-30 17:50:07,2014-10-30 14:34:50
8c3db8a30473348ec3cf1aed77bded1a5ef1dfa8...4f95fb4b9131e2bea07be0cf8257c2059a063c3e,1,8,8,16,1,2014-10-30 17:55:36,2014-10-30 14:24:53
4f95fb4b9131e2bea07be0cf8257c2059a063c3e...f5090f81588b684fc3cd27200ae6a822f16c37ae,5,225,62,287,26,2014-10-30 19:37:47,2014-10-29 19:33:55
f5090f81588b684fc3cd27200ae6a822f16c37ae...65187924dc8921594424918cd3fc64181e695cda,4,0,54,54,4,2014-10-30 20:03:31,2014-10-30 15:18:34
65187924dc8921594424918cd3fc64181e695cda...ce37440b32dcd61744e3767208d8bf5a174217e4,2,25,8,33,4,2014-10-30 20:17:27,2014-10-29 18:03:13
ce37440b32dcd61744e3767208d8bf5a174217e4...1d1bcb0f6e8dc92adc0cd6d1b0bbd65018dbe31a,14,73,48,121,27,2014-10-30 20:25:06,2014-10-29 21:51:56
1d1bcb0f6e8dc92adc0cd6d1b0bbd65018dbe31a...247223b04d3809272eef45270e2ce0a1d67ff7ba,2,3,0,3,3,2014-10-30 20:25:06,2014-10-30 15:15:54
247223b04d3809272eef45270e2ce0a1d67ff7ba...c32714fbbb8f818ad01abb2cf84530dff3dbc94c,2,5,3,8,2,2014-10-30 20:25:06,2014-10-30 18:25:22
c32714fbbb8f818ad01abb2cf84530dff3dbc94c...2008dfd2239f342e0766b60ba7ec65cefdd83cce,2,12,25,37,10,2014-10-30 20:40:53,2014-10-30 17:54:49
2008dfd2239f342e0766b60ba7ec65cefdd83cce...a24843c49eee8cf18c11015cb7411ea1f06aeb10,4,18,13,31,7,2014-10-30 20:40:54,2014-10-30 18:16:49
a24843c49eee8cf18c11015cb7411ea1f06aeb10...43890ae6172d427909cfe62d83377afd7c62a15f,2,11,0,11,2,2014-10-30 21:03:19,2014-10-28 01:12:27
43890ae6172d427909cfe62d83377afd7c62a15f...f30ddd8d162ead9c696195d7bc6aef02d3acecc7,4,62,25,87,21,2014-10-30 21:29:20,2014-10-29 22:11:48
f30ddd8d162ead9c696195d7bc6aef02d3acecc7...b7f7ad839bf7a08ff2f73fcba367632c5192c84d,3,40,6,46,6,2014-10-30 21:29:26,2014-10-30 18:07:51
b7f7ad839bf7a08ff2f73fcba367632c5192c84d...a28c5fad93a81c3475f884c690aa9f83a873dac0,1,11,5,16,6,2014-10-30 21:29:26,2014-10-30 19:33:49
a28c5fad93a81c3475f884c690aa9f83a873dac0...d7f348fd60cc09c230d783bb8757b7b10f965811,11,486,589,1075,21,2014-10-30 22:26:05,2014-10-30 20:46:18
d7f348fd60cc09c230d783bb8757b7b10f965811...ff475aa6c4eede38e7cf56853e3e11052e2e6511,1,1,1,2,1,2014-10-30 22:27:06,2014-10-30 18:55:39
ff475aa6c4eede38e7cf56853e3e11052e2e6511...bc51c5e5b20a24fcfa3e0ecb5595f563abb7086a,15,174,75,249,21,2014-10-30 22:42:54,2014-10-16 18:36:28
bc51c5e5b20a24fcfa3e0ecb5595f563abb7086a...6a54dd5708f5996bd66c00b48386c95ca95f249f,1,2,1,3,1,2014-10-30 22:42:55,2014-10-30 21:32:36
6a54dd5708f5996bd66c00b48386c95ca95f249f...8111434d26a94794d4db3605fb004d0036cba990,1,1,1,2,1,2014-10-31 00:43:58,2014-10-29 10:13:48
8111434d26a94794d4db3605fb004d0036cba990...e1ef3e6371f59c6a6396e78b2a4c4d9a975e9396,3,84,5,89,8,2014-10-31 05:44:30,2014-10-30 20:52:01
e1ef3e6371f59c6a6396e78b2a4c4d9a975e9396...c3bcf7a2b57627403e2ce68a5e1fb033e68de40a,6,28,19,47,19,2014-10-31 11:22:48,2014-10-30 22:00:58
c3bcf7a2b57627403e2ce68a5e1fb033e68de40a...b55f988fcee0ba567e2f9981e3683d4500874ff5,1,63,298,361,24,2014-10-31 11:22:49,2014-10-31 02:27:51
b55f988fcee0ba567e2f9981e3683d4500874ff5...fd316bf9977f0109c288e3d8b298b9c6ac62bc70,6,63,17,80,16,2014-10-31 11:22:49,2014-10-31 02:28:38
fd316bf9977f0109c288e3d8b298b9c6ac62bc70...1b516e4defb1dc7115d96e6936684610246eb470,4,133,0,133,4,2014-10-31 13:46:53,2014-10-13 19:56:51
1b516e4defb1dc7115d96e6936684610246eb470...0bb7d05719e7364cbeac27a78a9817e3b0ebd149,5,55,24,79,11,2014-10-31 15:24:58,2014-10-30 17:37:58
0bb7d05719e7364cbeac27a78a9817e3b0ebd149...dfbb85ddbb405d790a0641f25a80720544ba25de,1,1,1,2,1,2014-10-31 15:31:42,2014-10-31 15:31:42
dfbb85ddbb405d790a0641f25a80720544ba25de...51249a458e99d43871efd95624c9c880bc17f27b,2,14,11,25,6,2014-10-31 15:52:20,2014-10-31 14:58:31
51249a458e99d43871efd95624c9c880bc17f27b...5f9005429372a719c762a58ba1b729ef83025f7e,1,2,2,4,2,2014-10-31 17:05:47,2014-10-31 15:42:41
5f9005429372a719c762a58ba1b729ef83025f7e...0f2eefec0bffac9682be5628449c676d22a08462,1,1,1,2,1,2014-10-31 19:58:28,2014-10-31 19:58:28
0f2eefec0bffac9682be5628449c676d22a08462...a2c27b34b811d73a42ddecab20e9f8cb6348a1a3,1,4,1,5,2,2014-10-31 20:13:52,2014-10-30 20:45:36
a2c27b34b811d73a42ddecab20e9f8cb6348a1a3...76d2b35f91a9296f135393da02ac7486d802eac6,7,235,6,241,18,2014-10-31 20:19:13,2014-10-30 22:09:50
76d2b35f91a9296f135393da02ac7486d802eac6...f8dc6acb9bdd43a83e0762a4007c72af64cfae1e,1,5,2,7,4,2014-10-31 20:41:44,2014-10-31 17:49:30
f8dc6acb9bdd43a83e0762a4007c72af64cfae1e...2ae2aee89b687e6e4e847133808367571508a5a6,2,8,8,16,8,2014-10-31 20:51:18,2014-10-10 19:26:09
2ae2aee89b687e6e4e847133808367571508a5a6...2441d8f786137d3a58252dc979b963a0a58d6603,1,0,11,11,3,2014-10-31 21:10:06,2014-10-31 21:10:06
2441d8f786137d3a58252dc979b963a0a58d6603...57232ccd7c7a326ee7f72f06d2ec61bb8065b7ce,1,178,20,198,9,2014-10-31 21:24:47,2014-10-31 15:28:37
57232ccd7c7a326ee7f72f06d2ec61bb8065b7ce...6d9669ff5eb235381c27f465b67aa83cd900c000,11,43,5,48,14,2014-10-31 21:24:47,2014-10-31 15:30:05
6d9669ff5eb235381c27f465b67aa83cd900c000...bfcf5cc618e478697b272cae1ae642d4c38039e4,1,15,0,15,2,2014-10-31 21:24:47,2014-10-31 21:24:22
bfcf5cc618e478697b272cae1ae642d4c38039e4...d46f3e0d3542cfdd671c0edf71e5483633c13f1c,1,30,1,31,2,2014-10-31 22:05:12,2014-10-30 05:04:29
d46f3e0d3542cfdd671c0edf71e5483633c13f1c...58dcbec57fef3ef373a183aadac64a164adfc84c,8,72,4,76,11,2014-10-31 23:18:55,2014-10-31 22:39:19
58dcbec57fef3ef373a183aadac64a164adfc84c...3e31d5fab0a5ab48378a04b01ae045997af1d41a,1,1,30,31,2,2014-11-01 00:34:19,2014-11-01 00:34:19
3e31d5fab0a5ab48378a04b01ae045997af1d41a...d1ca324125e215237fd05e19507d83e5dfe4303d,1,30,1,31,2,2014-11-01 18:04:29,2014-11-01 18:04:29
d1ca324125e215237fd05e19507d83e5dfe4303d...1e31585822ec9066b43a0709cdb58fcfb49ca308,3,6,6,12,6,2014-11-01 18:04:56,2014-11-01 18:04:56
1e31585822ec9066b43a0709cdb58fcfb49ca308...87480a2a2c12a75745ecc890aa7e01ff639b4c82,1,1,1,2,1,2014-11-02 16:02:44,2014-10-30 21:09:38
87480a2a2c12a75745ecc890aa7e01ff639b4c82...9eb7ba71ac9f3d056b7b1f41e384a9bb732078c0,2,32,0,32,2,2014-11-02 16:09:35,2014-10-31 20:39:04
9eb7ba71ac9f3d056b7b1f41e384a9bb732078c0...0f3ef4550c44a21aa7658586789c97505adf51a6,9,247,93,340,35,2014-11-02 20:56:38,2014-10-31 21:39:07
0f3ef4550c44a21aa7658586789c97505adf51a6...8951f434615f7444cac1630cc628269a839a6118,1,4,3,7,3,2014-11-03 04:00:59,2014-11-02 19:13:07
8951f434615f7444cac1630cc628269a839a6118...a779afc93c71d77da15ef6f2399904f4bc592481,1,55,0,55,1,2014-11-03 17:01:52,2014-10-31 20:51:38
a779afc93c71d77da15ef6f2399904f4bc592481...df567c92f07eeb2c2dc92580121703274ac6fc88,11,151,84,235,72,2014-11-03 17:17:00,2014-10-28 13:44:18
df567c92f07eeb2c2dc92580121703274ac6fc88...afce8c3ca626f8fddcd24c7c86de93fd081227cd,7,125,40,165,22,2014-11-03 17:17:01,2014-10-29 17:42:26
afce8c3ca626f8fddcd24c7c86de93fd081227cd...b259bbfca77d2ef3453288a80b82dddb16750c64,7,59,44,103,18,2014-11-03 17:17:01,2014-10-30 20:22:36
b259bbfca77d2ef3453288a80b82dddb16750c64...23b96d4da3444d260eee24d7217a8054f3aacfa3,1,4,1,5,1,2014-11-03 17:17:01,2014-10-31 14:01:02
23b96d4da3444d260eee24d7217a8054f3aacfa3...1bb29da08f761b4ed79c8bb1cacb74aaec702530,1,4,1,5,2,2014-11-03 17:52:28,2014-11-03 16:45:03
1bb29da08f761b4ed79c8bb1cacb74aaec702530...4026a60ee751a5190efb893539f65381bf173bc7,2,3,2,5,2,2014-11-03 17:58:11,2014-11-03 17:56:39
4026a60ee751a5190efb893539f65381bf173bc7...0e0441723f325469f7ed582a9ba90cb9b3a002b1,3,11,6,17,5,2014-11-03 19:01:16,2014-11-03 16:40:39
0e0441723f325469f7ed582a9ba90cb9b3a002b1...1537472fc8ce3068671f826fde6ca6c934165d15,1,48,25,73,7,2014-11-03 19:01:16,2014-11-03 16:41:00
1537472fc8ce3068671f826fde6ca6c934165d15...ab7a1d27f130d0f920651181eafe19316c247b13,1,1,0,1,1,2014-11-03 19:01:16,2014-11-03 16:41:31
ab7a1d27f130d0f920651181eafe19316c247b13...9b96c72ec4b8adb65480f33f752fd43b333414f0,4,27,1,28,5,2014-11-03 19:01:16,2014-11-03 16:42:15
9b96c72ec4b8adb65480f33f752fd43b333414f0...998c4fd5faad88eea7cd24a81945c2d8d91ad5ae,1,11,1,12,3,2014-11-03 19:01:16,2014-11-03 16:42:49
998c4fd5faad88eea7cd24a81945c2d8d91ad5ae...ac3c439b9605bf01776c84ad8ed57a1dc60cae54,2,12,8,20,6,2014-11-03 19:01:16,2014-11-03 18:09:17
ac3c439b9605bf01776c84ad8ed57a1dc60cae54...1c8267751f86ff74e350dad67cec018f4f9a7851,2,17,8,25,6,2014-11-03 19:17:12,2014-11-03 15:44:06
1c8267751f86ff74e350dad67cec018f4f9a7851...da18489108f7c94f67533bb52b600ed1efbf6dc9,24,356,176,532,99,2014-11-03 20:07:06,2014-10-30 13:59:57
da18489108f7c94f67533bb52b600ed1efbf6dc9...0212412257d8c9118a44a8fba5776a9841c1f8e5,6,291,23,314,24,2014-11-03 20:07:06,2014-10-31 03:39:28
0212412257d8c9118a44a8fba5776a9841c1f8e5...72975ae9051ff89ce1ac34c6f58f67a3afd7cb5c,4,86,61,147,46,2014-11-03 20:07:06,2014-10-31 06:01:37
72975ae9051ff89ce1ac34c6f58f67a3afd7cb5c...cf1c4bb5a9da98ec831ff0a30ae78abe81e1d1b0,7,64,0,64,7,2014-11-03 20:07:06,2014-11-03 18:07:04
cf1c4bb5a9da98ec831ff0a30ae78abe81e1d1b0...b33b57af7f95ebf9e2d2400d1ef2866035e37d05,1,16,11,27,2,2014-11-03 20:43:47,2014-10-31 16:36:35
b33b57af7f95ebf9e2d2400d1ef2866035e37d05...961cf3c785ba630694c9a95da4dd8e41158badf8,1,15,9,24,2,2014-11-03 20:43:53,2014-10-31 16:39:30
961cf3c785ba630694c9a95da4dd8e41158badf8...9a1d9a2ccea25f8d221408e136bae96906b5c7f0,2,24,9,33,3,2014-11-03 21:10:23,2014-10-30 16:56:43
9a1d9a2ccea25f8d221408e136bae96906b5c7f0...023ed947f498f7b09fd4134bd1fe3152d381eed8,3,4,6,10,4,2014-11-03 21:10:23,2014-11-03 18:59:36
023ed947f498f7b09fd4134bd1fe3152d381eed8...319b9319fed8dfbafe6d3f23512f12a17fb0ed9a,6,17,50,67,15,2014-11-03 21:10:24,2014-10-31 14:52:40
319b9319fed8dfbafe6d3f23512f12a17fb0ed9a...8240b32d3d274ab30ced457de542d6c7457d5850,1,3,2,5,2,2014-11-03 21:35:31,2014-08-06 16:06:56
8240b32d3d274ab30ced457de542d6c7457d5850...aa67a4e69eeb73fedc64f9a9588c2fa24cf8c6ab,5,24,19,43,19,2014-11-03 21:54:59,2014-11-03 21:34:25
aa67a4e69eeb73fedc64f9a9588c2fa24cf8c6ab...a69c4001dd891bf5d9b2862455d743d5d438cc96,1,4,0,4,1,2014-11-03 22:31:25,2014-11-03 22:31:25
a69c4001dd891bf5d9b2862455d743d5d438cc96...d7e6e0be8f54cfa0b57a6515306c56a38dcdf0d1,3,38,3,41,9,2014-11-03 23:10:01,2014-11-03 20:17:22
d7e6e0be8f54cfa0b57a6515306c56a38dcdf0d1...fc9c035d91ccbe16bd0d4412742d5d3352f3eeec,1,4,0,4,1,2014-11-03 23:11:58,2014-11-01 21:13:58
fc9c035d91ccbe16bd0d4412742d5d3352f3eeec...d204985463cd731d16190fd79621e227850d9c84,3,7,12,19,9,2014-11-03 23:20:45,2014-10-31 21:19:46
d204985463cd731d16190fd79621e227850d9c84...06a641278afd58caad4a8ecb368aaefb17a0eec1,7,0,64,64,7,2014-11-04 00:57:06,2014-11-04 00:57:06
06a641278afd58caad4a8ecb368aaefb17a0eec1...a1cc3274956e0bc1a0fc7b7fb98724eb04423a03,4,6,8,14,8,2014-11-04 01:13:56,2014-11-03 19:36:30
a1cc3274956e0bc1a0fc7b7fb98724eb04423a03...1ae3facefbfdb05d3369576611eb96fb1a303815,13,245,274,519,48,2014-11-04 01:13:57,2014-11-03 19:53:09
1ae3facefbfdb05d3369576611eb96fb1a303815...21286be1a1d0d4c4c8e41567c185819144dd91b5,1,3,2,5,2,2014-11-04 03:28:59,2014-11-03 23:28:05
21286be1a1d0d4c4c8e41567c185819144dd91b5...34bf558b24911143d3615f0af1a2f76d0ce238d0,13,274,245,519,47,2014-11-04 04:19:15,2014-11-04 04:19:15
34bf558b24911143d3615f0af1a2f76d0ce238d0...e6b62717c8f36c1a12829b21ee6d03d8193098a7,13,245,274,519,48,2014-11-04 04:25:31,2014-11-04 04:20:01
e6b62717c8f36c1a12829b21ee6d03d8193098a7...28dc332e17c20a045785b8ed9abbb9509d5c0815,1,13,0,13,1,2014-11-04 15:59:45,2014-11-04 02:30:55
28dc332e17c20a045785b8ed9abbb9509d5c0815...159c1ed111216d2aa0ccc7fca4bba07f2058997b,1,53,0,53,1,2014-11-04 16:03:38,2014-10-07 23:52:57
159c1ed111216d2aa0ccc7fca4bba07f2058997b...dcb68b25fe7351888385cc435f339ada8e8b5e9e,2,25,0,25,2,2014-11-04 16:21:02,2014-11-03 23:23:00
dcb68b25fe7351888385cc435f339ada8e8b5e9e...072190514e64dca8e6fd36ecbb636d16b4b41263,1,5,5,10,3,2014-11-04 16:24:00,2014-11-04 16:03:25
072190514e64dca8e6fd36ecbb636d16b4b41263...f91d3efd69a154d46a73caf2e6b5a5f632b56061,2,33,15,48,14,2014-11-04 16:25:12,2014-11-04 16:19:36
f91d3efd69a154d46a73caf2e6b5a5f632b56061...7849434abe5c8c24c7dd6dc7e664ebf1069c2557,15,127,126,253,81,2014-11-04 16:47:33,2014-11-04 16:44:52
7849434abe5c8c24c7dd6dc7e664ebf1069c2557...6eccc037b1e6d22d60d0e7aec39dcc183a756790,4,258,0,258,4,2014-11-04 17:31:42,2014-10-15 03:23:12
6eccc037b1e6d22d60d0e7aec39dcc183a756790...666d7d2af4c480bb5691eebde2b04a01e9366ea8,4,92,112,204,30,2014-11-04 17:39:01,2014-10-31 21:24:20
666d7d2af4c480bb5691eebde2b04a01e9366ea8...8f1f165734da24f5b44ae468a59b0cb9746dfec7,1,5,5,10,5,2014-11-04 17:58:36,2014-11-03 17:00:00
8f1f165734da24f5b44ae468a59b0cb9746dfec7...38de3485ec850c8e21fcfab94e9c378ac73d6346,8,43,52,95,30,2014-11-04 18:06:25,2014-11-03 19:40:09
38de3485ec850c8e21fcfab94e9c378ac73d6346...2a6de7b46d008d76e3cbc5485d15638e133d27b9,6,65,4,69,15,2014-11-04 18:06:26,2014-11-04 18:02:03
2a6de7b46d008d76e3cbc5485d15638e133d27b9...7113774b5bb3d421afcc94a89534d81785a77018,1,1,2,3,1,2014-11-04 18:59:02,2014-11-04 18:58:58
7113774b5bb3d421afcc94a89534d81785a77018...e189cb6dbb04b0f01f6024bcd9593ade1cd50e1f,1,3,1,4,1,2014-11-04 19:04:53,2014-11-04 15:50:15
e189cb6dbb04b0f01f6024bcd9593ade1cd50e1f...64461753cda653080e101bab2264ed7c1bd9657e,4,23,1,24,9,2014-11-04 19:04:53,2014-11-04 15:53:03
64461753cda653080e101bab2264ed7c1bd9657e...b8a215b51246448c2a2cafd715466e4a90319a9a,1,35,20,55,3,2014-11-04 19:04:53,2014-11-04 17:44:33
b8a215b51246448c2a2cafd715466e4a90319a9a...f0bafc7c171217b7541d337723c6390a793be359,5,5,0,5,5,2014-11-04 19:13:14,2014-11-04 17:57:32
f0bafc7c171217b7541d337723c6390a793be359...d5f6eb21a94a39bd39c3c7a7b0ac107aca33a7e4,14,210,83,293,34,2014-11-04 19:13:14,2014-11-04 18:13:38
d5f6eb21a94a39bd39c3c7a7b0ac107aca33a7e4...c8012ebc991cd4db85e63c4c61883aef3b793498,55,707,120,827,143,2014-11-04 19:24:14,2014-10-29 22:56:51
c8012ebc991cd4db85e63c4c61883aef3b793498...4731939510292ac460decd503e7b0e984c09a569,2,132,0,132,2,2014-11-04 19:38:10,2014-11-04 19:37:29
4731939510292ac460decd503e7b0e984c09a569...c1dc2b6ec7c72bcabf97ea4033b6877c09ebe8c8,7,11,8,19,8,2014-11-04 19:40:50,2014-11-04 19:30:46
c1dc2b6ec7c72bcabf97ea4033b6877c09ebe8c8...ba0068e794ab281fdcb347467f23070879ecf8cb,3,12,7,19,9,2014-11-04 19:48:53,2014-11-04 19:48:34
ba0068e794ab281fdcb347467f23070879ecf8cb...39032e1e57c9426f057147ffb785ab8822ec5530,1,2,2,4,2,2014-11-04 20:03:38,2014-11-04 19:56:24
39032e1e57c9426f057147ffb785ab8822ec5530...11235f26f7a6063860f8252766f2e28042fad1a9,2,50,0,50,2,2014-11-04 20:44:03,2014-11-04 20:44:03
11235f26f7a6063860f8252766f2e28042fad1a9...7511e515211e64612c666b1bcebe358e98f9259c,6,37,0,37,6,2014-11-04 21:56:16,2014-11-04 16:24:17
7511e515211e64612c666b1bcebe358e98f9259c...100be46dd67ca36e90c281952295ec044929ff18,1,1,0,1,1,2014-11-04 22:05:46,2014-11-04 22:05:46
100be46dd67ca36e90c281952295ec044929ff18...8de98e198650d1e3eb261c3526b5e5df93527c97,8,280,30,310,24,2014-11-04 17:19:08,2014-10-27 12:34:53
8de98e198650d1e3eb261c3526b5e5df93527c97...2a741dfecb4fa1ee894ddbfc81b21f42687bc46f,1,5,6,11,2,2014-11-04 22:39:12,2014-11-04 22:38:45
2a741dfecb4fa1ee894ddbfc81b21f42687bc46f...ff61cb160b2be922f8e91675d1f8135b71233ad3,1,1,1,2,1,2014-11-04 22:45:53,2014-11-04 22:07:31
ff61cb160b2be922f8e91675d1f8135b71233ad3...96352b10e79c6fee04cd666756889cffcda86113,1,2,2,4,3,2014-11-04 22:45:53,2014-11-04 22:22:29
96352b10e79c6fee04cd666756889cffcda86113...a07b925d350b125daf6bfc0e3c514c55a493a1fb,1,3,1,4,1,2014-11-04 22:45:53,2014-11-04 22:29:52
a07b925d350b125daf6bfc0e3c514c55a493a1fb...e35ccbf0d56ae9ced083c558faa9359ca53e9bc0,1,2,1,3,1,2014-11-04 23:19:42,2014-11-04 23:19:13
e35ccbf0d56ae9ced083c558faa9359ca53e9bc0...6d0405b1d94e1dd05ffba500f0c3a071202fd1d4,4,0,258,258,4,2014-11-04 23:32:20,2014-11-04 23:32:20
6d0405b1d94e1dd05ffba500f0c3a071202fd1d4...cc00f648f2cc51994d91dc6c24df9d93a7c3c4ba,1,0,23,23,14,2014-11-04 23:33:46,2014-11-04 23:08:37
cc00f648f2cc51994d91dc6c24df9d93a7c3c4ba...1a98399b8c518e2d2f346bfae58ceee5ff808579,1,2,3,5,2,2014-11-04 23:33:46,2014-11-04 23:10:24
1a98399b8c518e2d2f346bfae58ceee5ff808579...5266e7f0f23b8cf305280719d3d0e34df800b9f5,7,0,142,142,7,2014-11-05 00:55:46,2014-11-03 21:23:36
5266e7f0f23b8cf305280719d3d0e34df800b9f5...852dc8839cebeb425fb668d2e043f23d7de67e54,5,5,1288,1293,10,2014-11-05 01:32:14,2014-11-04 16:02:07
852dc8839cebeb425fb668d2e043f23d7de67e54...3af62b6af0bcca2adc67c2367debf43e6d99688f,1,3,14,17,3,2014-11-05 02:43:06,2014-11-04 22:39:01
3af62b6af0bcca2adc67c2367debf43e6d99688f...ee9a858adb7e399085975072f60a3f2d63cdda7a,1,2,2,4,3,2014-11-05 14:25:41,2014-11-05 14:25:41
ee9a858adb7e399085975072f60a3f2d63cdda7a...d01714904e04ef12cfb7d98caefc6f487e37efad,1,59,0,59,1,2014-11-05 10:50:17,2014-11-03 18:37:58
d01714904e04ef12cfb7d98caefc6f487e37efad...017704acdfc7517efadb3fab167bba06c025c01a,2,70,59,129,2,2014-11-05 10:50:24,2014-11-03 13:41:21
017704acdfc7517efadb3fab167bba06c025c01a...5ca2daf551a2c631a5f573cb054406f5d49fbef5,540,130811,0,130811,539,2014-11-05 16:21:19,2014-11-04 20:46:40
5ca2daf551a2c631a5f573cb054406f5d49fbef5...b0d74105634a3a2040743061c53b0e5b4eff919d,28,5138,22,5160,41,2014-11-05 16:21:19,2014-11-04 20:47:12
b0d74105634a3a2040743061c53b0e5b4eff919d...918663879caa0e6345d2e37d25bbe27bab1cc504,3,13,3,16,3,2014-11-05 17:09:50,2014-11-04 22:34:34
918663879caa0e6345d2e37d25bbe27bab1cc504...3f02fd962b26014f9fcb21e0ab91462d9fc690b6,1,1,1,2,1,2014-11-05 18:05:33,2014-11-05 16:53:26
3f02fd962b26014f9fcb21e0ab91462d9fc690b6...d2ab711c0e57271f9584602329c50dd84e32c4bb,1,2,1,3,1,2014-11-05 18:05:33,2014-11-05 17:07:44
d2ab711c0e57271f9584602329c50dd84e32c4bb...93c0e9db34e32c708527886ea923bda98ef3236b,1,1,1,2,1,2014-11-05 18:23:13,2014-10-31 23:18:11
93c0e9db34e32c708527886ea923bda98ef3236b...a186f6756c4e80fef5d0c3dd2a458a1af3e0d226,2,3,3,6,3,2014-11-05 18:27:38,2014-11-05 18:27:38
a186f6756c4e80fef5d0c3dd2a458a1af3e0d226...ecd562289fa27fcd50fb63c3d1cfb0925c5ae2f9,1,2,2,4,2,2014-11-05 18:31:03,2014-11-05 18:30:57
ecd562289fa27fcd50fb63c3d1cfb0925c5ae2f9...379d94936e80ff006dd4d1e150b4524a5bf3a0a4,1,0,1,1,1,2014-11-05 18:53:55,2014-11-05 18:53:55
379d94936e80ff006dd4d1e150b4524a5bf3a0a4...c1374695b9fef835b40b16461be659feb8d9b604,2,0,14,14,4,2014-11-05 19:45:57,2014-11-05 19:32:22
c1374695b9fef835b40b16461be659feb8d9b604...10c497c51f5738c1ebe42903f8d6bfd0f018240a,1,1,1,2,1,2014-11-05 19:55:55,2014-11-05 19:55:55
10c497c51f5738c1ebe42903f8d6bfd0f018240a...ca0d6d5d907ebe39437b4032ccb4795946573183,1,20,18,38,1,2014-11-05 20:20:47,2014-11-05 20:19:08
ca0d6d5d907ebe39437b4032ccb4795946573183...d324cff2fccfd7f2f1397093e01a1eb4af9a3e52,23,229,191,420,77,2014-11-05 20:38:53,2014-11-04 21:17:48
d324cff2fccfd7f2f1397093e01a1eb4af9a3e52...f95d813fba8b9a159ba10ffe5238a158caf29074,4,137,88,225,18,2014-11-05 20:41:15,2014-10-30 21:11:24
f95d813fba8b9a159ba10ffe5238a158caf29074...8ee12731c9f31add89a08d8a391e9d88299aaa55,5,14,13,27,14,2014-11-05 20:51:00,2014-11-05 20:09:07
8ee12731c9f31add89a08d8a391e9d88299aaa55...0bb84c4860d39833a2f65c94ece29d3bc7655add,1,0,2,2,2,2014-11-05 21:26:05,2014-11-05 20:18:39
0bb84c4860d39833a2f65c94ece29d3bc7655add...75b1c0c1c0a27a3c73e52425526521ddd65e4b60,1,50,0,50,1,2014-11-05 21:36:40,2014-11-05 21:36:40
75b1c0c1c0a27a3c73e52425526521ddd65e4b60...4519206ce6ecf4aa54c62ce38b6035cf7df46595,2,261,232,493,72,2014-11-05 21:45:55,2014-11-05 20:53:15
4519206ce6ecf4aa54c62ce38b6035cf7df46595...fc3154713b4e7127a0fa9a32930f29423576b037,1,217,216,433,23,2014-11-05 22:13:09,2014-11-05 21:52:06
fc3154713b4e7127a0fa9a32930f29423576b037...068eca37eb5b42671a651d24309b052edb1e0473,1,1,1,2,1,2014-11-05 22:13:10,2014-11-05 21:03:38
068eca37eb5b42671a651d24309b052edb1e0473...0b4bc21e287c5e3dcdce38fc31714dd335f7a107,28,11067,2,11069,33,2014-11-05 22:21:12,2014-11-03 22:15:00
0b4bc21e287c5e3dcdce38fc31714dd335f7a107...7c3cfac300cfcca4f73f1c3b18457f0f8fae3f69,1,4,2,6,2,2014-11-05 22:44:24,2014-11-05 22:44:10
7c3cfac300cfcca4f73f1c3b18457f0f8fae3f69...30668a6d4e2f0b264acf45d3bf6ca92b76fbe1c7,45,0,7962,7962,45,2014-11-05 23:05:56,2014-11-05 22:56:29
30668a6d4e2f0b264acf45d3bf6ca92b76fbe1c7...a2512e3b7e78fb26ce4369584f66fee9f2486de7,6,38,28,66,29,2014-11-06 00:16:58,2014-11-05 22:13:33
a2512e3b7e78fb26ce4369584f66fee9f2486de7...6821e25b266d0c861b8dc8acceccf86a0f93c0ac,1,2,0,2,2,2014-11-06 00:24:22,2014-11-06 00:19:10
6821e25b266d0c861b8dc8acceccf86a0f93c0ac...abf39b71c7217adf9380f93c596dd433b0471f68,2,261,254,515,33,2014-11-06 00:28:06,2014-11-06 00:27:26
abf39b71c7217adf9380f93c596dd433b0471f68...386a8f28bb8cc830b8ff9a311f56fab06677e209,1,2,0,2,2,2014-11-06 01:02:32,2014-11-06 01:02:32
386a8f28bb8cc830b8ff9a311f56fab06677e209...4da5ebab3d27b20508fb73179cd2f3799b6ee607,1,1,1,2,1,2014-11-06 05:17:47,2014-11-06 05:16:39
4da5ebab3d27b20508fb73179cd2f3799b6ee607...1f741358bc48543349619d9e5d86d6c46b57abd7,59,1678,1012,2690,423,2014-11-06 15:51:20,2014-11-05 23:18:45
1f741358bc48543349619d9e5d86d6c46b57abd7...f1655ad69b11abdde521d4bc2e7cfcd40e41eab3,1,1,1,2,1,2014-11-06 17:13:29,2014-11-05 19:09:32
f1655ad69b11abdde521d4bc2e7cfcd40e41eab3...62dd588ef3d22480feaa4ae8339785e94f199bcf,1,1,1,2,1,2014-11-06 17:16:44,2014-11-06 00:10:52
62dd588ef3d22480feaa4ae8339785e94f199bcf...b144964acc83e3223900b09560edd8d8e025a625,1,1,1,2,1,2014-11-06 17:19:46,2014-11-06 02:59:46
b144964acc83e3223900b09560edd8d8e025a625...cf1280d2547eb95bd7020a885ce458ce26d968ba,1,2,1,3,1,2014-11-06 17:21:01,2014-11-06 16:29:51
cf1280d2547eb95bd7020a885ce458ce26d968ba...e5f1fc03628815e3449a72e784e00d41dbb1d9ac,2,12,8,20,8,2014-11-06 17:22:31,2014-11-06 16:08:53
e5f1fc03628815e3449a72e784e00d41dbb1d9ac...dbc8bd10eefc7ceb6791d9179935f0a4c184d009,1,0,6,6,1,2014-11-06 18:31:33,2014-11-04 02:09:01
dbc8bd10eefc7ceb6791d9179935f0a4c184d009...9458c394cf6daa30608544526f94fb856663941b,1,79,0,79,2,2014-11-06 18:51:29,2014-11-06 15:25:49
9458c394cf6daa30608544526f94fb856663941b...2e0e00ee5606d1ea36f96b7ab2015b6db7e3d05f,1,5,5,10,2,2014-11-06 18:55:53,2014-11-04 20:28:28
2e0e00ee5606d1ea36f96b7ab2015b6db7e3d05f...88ef4861b03af893e59e7339297eea4b9a14bea5,2,33,15,48,11,2014-11-06 19:04:19,2014-11-06 14:06:16
88ef4861b03af893e59e7339297eea4b9a14bea5...491a9728d381328ad2e0604eb31cec1590418755,1,20,10,30,5,2014-11-06 19:11:24,2014-11-06 18:54:02
491a9728d381328ad2e0604eb31cec1590418755...1bbfd09914ac6b9095224162470271211cf56343,2,25,0,25,6,2014-11-06 22:12:23,2014-11-06 00:42:53
1bbfd09914ac6b9095224162470271211cf56343...a1fc18243a20cc8c5fd4ef7ee3e9f2078b4139d7,4,121,59,180,26,2014-11-06 22:13:33,2014-11-05 20:14:48
a1fc18243a20cc8c5fd4ef7ee3e9f2078b4139d7...e1fa60e4d8b3f525575b4602b208f2a1ef353735,3,709,2,711,4,2014-11-07 00:18:16,2014-11-05 16:42:40
e1fa60e4d8b3f525575b4602b208f2a1ef353735...be3bb1821242a7704ca1c6f6621bdd6abc4acfb4,2,15,9,24,5,2014-11-07 12:16:57,2014-11-06 21:49:55
be3bb1821242a7704ca1c6f6621bdd6abc4acfb4...dc4aee38f7aa8a3aa27f5fbc7d00fdb25c5f35f4,1,2,4,6,2,2014-11-07 15:00:34,2014-11-07 14:58:46
dc4aee38f7aa8a3aa27f5fbc7d00fdb25c5f35f4...716cfde34adf0e1c4a92c4e8fc1960a50d3cbc50,1,10,2,12,4,2014-11-07 15:39:31,2014-11-06 20:36:10
716cfde34adf0e1c4a92c4e8fc1960a50d3cbc50...39ded947b914652032fb5a9b3ee991c00e173664,3,14,5,19,7,2014-11-07 16:16:00,2014-11-07 00:00:29
39ded947b914652032fb5a9b3ee991c00e173664...496c16aa50b8f4d6ef21cfc5fee55c6ffa80bc86,1,2,2,4,1,2014-11-07 17:28:20,2014-11-06 22:42:32
496c16aa50b8f4d6ef21cfc5fee55c6ffa80bc86...001d34a6a7bc13c3d6d159d7149417f5e6571359,1,8,1,9,2,2014-11-07 21:09:02,2014-11-07 21:09:02
001d34a6a7bc13c3d6d159d7149417f5e6571359...29ccb93a6709d52371464a2a2bfa179c7cc370bc,4,26,14,40,10,2014-11-07 21:38:22,2014-11-07 20:04:50
29ccb93a6709d52371464a2a2bfa179c7cc370bc...7490a1cb8affe30edc89f42cb7720099eb195c70,1,8,1,9,1,2014-11-07 21:38:45,2014-11-07 21:38:09
7490a1cb8affe30edc89f42cb7720099eb195c70...af31dc7ba520145df053e72232647556e467dd00,5,106,13,119,29,2014-11-07 22:06:48,2014-11-05 23:36:33
af31dc7ba520145df053e72232647556e467dd00...869bb778dd79d3cc199523bda40671be7cb92aae,1,1,1,2,1,2014-11-07 17:59:32,2014-11-07 17:52:36
869bb778dd79d3cc199523bda40671be7cb92aae...e0f8376cf7e3496af394df5ce6132f9b0cfb3af3,1,1,1,2,1,2014-11-07 23:29:44,2014-11-07 23:29:06
e0f8376cf7e3496af394df5ce6132f9b0cfb3af3...18c94ba44d37ef8e430f1e04633c0ae32efddae4,3,6,6,12,3,2014-11-08 06:53:02,2014-11-08 06:53:02
18c94ba44d37ef8e430f1e04633c0ae32efddae4...ec899cc692d4edfe128130fa5fc7d778e494dee7,1,4,10,14,1,2014-11-09 22:53:23,2014-11-09 16:41:02
ec899cc692d4edfe128130fa5fc7d778e494dee7...4d7a2c7dd8c29059a2f8b7f6c74aec9817e02de7,38,345,183,528,123,2014-11-10 02:46:51,2014-11-10 02:46:51
4d7a2c7dd8c29059a2f8b7f6c74aec9817e02de7...1b446f240856cf93b32fcc62e1980d9cc2f42f87,1,1,1,2,1,2014-11-10 04:37:10,2014-11-10 04:35:53
1b446f240856cf93b32fcc62e1980d9cc2f42f87...4ab029e3e68ea5f7aa89b90a47fd814d17b142bf,2,3,0,3,2,2014-11-10 05:13:22,2014-11-10 04:59:58
4ab029e3e68ea5f7aa89b90a47fd814d17b142bf...20ad93b09352b317302f6b713bacaedab757c93b,1,1,1,2,1,2014-11-10 13:51:45,2014-11-10 13:51:45
20ad93b09352b317302f6b713bacaedab757c93b...aed9203f383619406705119cdf62c6f28c33c4e0,14,108,60,168,31,2014-11-10 13:52:26,2014-11-10 13:52:26
aed9203f383619406705119cdf62c6f28c33c4e0...0549652e913b4c39dc00ec10bd1895c085b27bf3,1,1,1,2,1,2014-11-10 14:11:32,2014-11-10 14:11:32
0549652e913b4c39dc00ec10bd1895c085b27bf3...4294049c9f414cca43825cd7e60ec2462f944bed,5,29,15,44,9,2014-11-10 16:56:12,2014-11-06 20:50:19
4294049c9f414cca43825cd7e60ec2462f944bed...5b5445d78f8f0cf83c3aaf90b645310bafae3da0,1,1,1,2,1,2014-11-10 17:08:23,2014-11-10 17:08:23
5b5445d78f8f0cf83c3aaf90b645310bafae3da0...7e2937e75e84c8cb27a22488a202cf4411977c6a,10,91,61,152,49,2014-11-10 17:18:33,2014-11-06 23:37:57
7e2937e75e84c8cb27a22488a202cf4411977c6a...a29dc744d4259897a37a8cf71f531c7cd045041e,10,59,10,69,21,2014-11-10 17:18:33,2014-11-07 22:56:24
a29dc744d4259897a37a8cf71f531c7cd045041e...c686f5a1949339ba9390e6efc01ef8421867c692,3,64,47,111,15,2014-11-10 18:31:43,2014-11-10 18:31:43
c686f5a1949339ba9390e6efc01ef8421867c692...0c1c8e9e31bfe24aaf4ad77090dd835eae125265,3,3,49,52,6,2014-11-10 18:43:52,2014-11-10 17:23:12
0c1c8e9e31bfe24aaf4ad77090dd835eae125265...7fa44159b371c106cd9742174ff13a22aab5ce21,8,168,74,242,32,2014-11-10 18:57:10,2014-11-08 00:42:38
7fa44159b371c106cd9742174ff13a22aab5ce21...cb82efb115f2bca1cc5d7274d1f7e67b2326846e,1,2,3,5,1,2014-11-10 19:14:48,2014-11-10 18:58:32
cb82efb115f2bca1cc5d7274d1f7e67b2326846e...483f69dbd4a8af17c09f21484c2f66f754f418fb,6,26,15,41,16,2014-11-10 19:18:20,2014-11-10 19:02:12
483f69dbd4a8af17c09f21484c2f66f754f418fb...04869a65202864514e6066ef77798a39c7c4920d,1,1,1,2,1,2014-11-10 19:48:24,2014-11-10 19:47:28
04869a65202864514e6066ef77798a39c7c4920d...af18d6ce5f2a2325a4f25a507c3080fc353fd690,2,81,0,81,3,2014-11-10 20:56:09,2014-11-06 23:09:19
af18d6ce5f2a2325a4f25a507c3080fc353fd690...cdb864a8276b3e0f6c8b99fe68fc17989fbb15a4,1,3,33,36,3,2014-11-10 21:11:45,2014-11-06 00:00:01
cdb864a8276b3e0f6c8b99fe68fc17989fbb15a4...dd5b2d7f5cd96b4ca8acd01d15c5ac369c4f50f2,7,416,133,549,61,2014-11-10 21:11:45,2014-11-10 18:05:22
dd5b2d7f5cd96b4ca8acd01d15c5ac369c4f50f2...bcd704764ef9b7cfe8ae86c50dd34410df314e7b,2,6,0,6,2,2014-11-10 21:11:45,2014-11-10 21:11:24
bcd704764ef9b7cfe8ae86c50dd34410df314e7b...c6e8e3d868660dc66b3bbd438cdc135df6356c5a,1,1,1,2,1,2014-11-10 21:34:53,2014-11-10 21:34:53
c6e8e3d868660dc66b3bbd438cdc135df6356c5a...e765b6a3544b325b52c270c3743827fa963b0d10,3,66,1,67,7,2014-11-10 22:12:48,2014-11-10 19:52:32
e765b6a3544b325b52c270c3743827fa963b0d10...1a81817c9e82d421c52ea575a29dd16168902800,2,10,7,17,6,2014-11-10 22:29:17,2014-11-10 22:13:55
1a81817c9e82d421c52ea575a29dd16168902800...92d967e8cd4d32f3b3348c89320f238df47a1454,1,3,0,3,2,2014-11-11 00:11:14,2014-11-11 00:09:38
92d967e8cd4d32f3b3348c89320f238df47a1454...93aaab7e2ca64e330959c403b36d50fdb609e86e,1,0,3,3,2,2014-11-11 12:44:30,2014-11-11 12:43:30
93aaab7e2ca64e330959c403b36d50fdb609e86e...9e05a9fb1b2b89244ec5eace0b4ac8a9a6bf3819,1,4,2,6,1,2014-11-11 14:22:30,2014-11-11 14:22:30
9e05a9fb1b2b89244ec5eace0b4ac8a9a6bf3819...a03b727e8432985db011ec029442212a9e1e1950,1,1,3,4,1,2014-11-11 14:54:19,2014-11-11 14:26:55
a03b727e8432985db011ec029442212a9e1e1950...cab2c1533f495e0760e871b0229bfb762aa2979e,1,4,1,5,3,2014-11-11 14:54:19,2014-11-11 14:27:42
cab2c1533f495e0760e871b0229bfb762aa2979e...ceb4722aea73de640c12d2d25b96cf330190e0f3,1,8,1,9,2,2014-11-11 14:54:19,2014-11-11 14:53:10
ceb4722aea73de640c12d2d25b96cf330190e0f3...cbd81db53096bbffb9c1d74df75cc227626f81ad,2,7,10,17,6,2014-11-11 15:26:59,2014-11-11 15:26:59
cbd81db53096bbffb9c1d74df75cc227626f81ad...57d2b478a3e6f58538bf0a0c5a8d5a0134b4bf13,1,1,1,2,1,2014-11-11 15:27:07,2014-11-11 15:27:07
57d2b478a3e6f58538bf0a0c5a8d5a0134b4bf13...bc00750755e46d278f2702810738adbda3a45d64,10,61,91,152,49,2014-11-11 15:27:22,2014-11-11 15:27:22
bc00750755e46d278f2702810738adbda3a45d64...d1cf07e73bc127c9214a902cbf2f6a0cf173e5ad,2,6,6,12,6,2014-11-11 16:26:16,2014-11-10 17:32:47
d1cf07e73bc127c9214a902cbf2f6a0cf173e5ad...6b73c5c63de972ebd39ab85c93f81e7040fe6950,3,18,8,26,4,2014-11-11 17:14:06,2014-11-11 16:53:15
6b73c5c63de972ebd39ab85c93f81e7040fe6950...2b320ff2801f6a124b157e7e9edf46df2d18992c,1,1,1,2,1,2014-11-11 15:28:11,2014-11-11 14:03:43
2b320ff2801f6a124b157e7e9edf46df2d18992c...6c0c1df12e3c6366f410f4b3137de7b16854bda1,1,17,20,37,11,2014-11-11 15:30:37,2014-11-11 14:45:55
6c0c1df12e3c6366f410f4b3137de7b16854bda1...188694e853873f0ab564e5b49f53e7b7e7bbcd42,1,19,36,55,15,2014-11-11 15:47:40,2014-11-11 15:47:40
188694e853873f0ab564e5b49f53e7b7e7bbcd42...eb0141484346be4f2831c15cabcc8204724f8bd8,6,103,4,107,11,2014-11-11 21:40:16,2014-11-11 21:27:34
eb0141484346be4f2831c15cabcc8204724f8bd8...b6c4e2491c1442b05a160acda0d78001f56a2ade,7,7,7,14,7,2014-11-11 21:44:18,2014-11-11 21:44:18
b6c4e2491c1442b05a160acda0d78001f56a2ade...6950e9ffe4823e65403bd118f44688bc25caaf7c,7,7,7,14,7,2014-11-12 15:43:54,2014-11-12 15:43:54
6950e9ffe4823e65403bd118f44688bc25caaf7c...d104ebb0fda8c75dc519f6f07078e9a884de59e2,1,4,1,5,1,2014-11-12 15:45:05,2014-11-12 13:11:21
d104ebb0fda8c75dc519f6f07078e9a884de59e2...d80aba43b2abf97944e149c78af2799c498a83b0,2,11,11,22,11,2014-11-12 15:45:05,2014-11-12 13:45:13
d80aba43b2abf97944e149c78af2799c498a83b0...5e06026b4b72cc252a7168569ffd78f8e9811d23,1,3,3,6,2,2014-11-12 15:45:05,2014-11-12 15:07:29
5e06026b4b72cc252a7168569ffd78f8e9811d23...7c8b3c68da9dd93641c59e6cff7a47a264fd68b4,2,22,0,22,4,2014-11-12 15:54:00,2014-11-11 20:18:38
7c8b3c68da9dd93641c59e6cff7a47a264fd68b4...fbb583f7025d6a04ee9d1b499cbe18f6b06ab4df,7,15,59,74,26,2014-11-12 17:31:45,2014-11-12 17:31:45
fbb583f7025d6a04ee9d1b499cbe18f6b06ab4df...1a3746fa510000d147650036dabfdf60430378bb,2,64,41,105,14,2014-11-12 17:37:46,2014-11-11 19:05:50
1a3746fa510000d147650036dabfdf60430378bb...a0e10fe111f69881da9fc153a722bcced9ef79d1,1,1,1,2,2,2014-11-12 17:37:46,2014-11-12 15:57:13
a0e10fe111f69881da9fc153a722bcced9ef79d1...187df06762cb2154bde8b9ff154f3ea611154192,2,7,7,14,7,2014-11-12 17:37:47,2014-11-12 17:32:30
187df06762cb2154bde8b9ff154f3ea611154192...9bfb7c3a805fb6151254389992548d22d08eed8c,2,46,6,52,9,2014-11-12 17:34:29,2014-11-07 16:20:55
9bfb7c3a805fb6151254389992548d22d08eed8c...e1c58c47536d0eb430878ddefc47ccdb332ddd23,10,39,42,81,19,2014-11-12 18:29:17,2014-11-12 16:18:32
e1c58c47536d0eb430878ddefc47ccdb332ddd23...4949daa51bbd5104d666082e968e6dd81c22f2bd,3,24,12,36,8,2014-11-12 18:45:34,2014-11-11 19:12:37
4949daa51bbd5104d666082e968e6dd81c22f2bd...fe58da2ed6a48493399d1d336162e6574e3cc712,6,287,54,341,16,2014-11-12 19:02:11,2014-11-04 14:32:08
fe58da2ed6a48493399d1d336162e6574e3cc712...525c5407c270b2e9050be9dd78b14dc7cab69eae,1,4,2,6,2,2014-11-12 19:04:45,2014-11-12 16:39:30
525c5407c270b2e9050be9dd78b14dc7cab69eae...e7091e53396d7c9ea0b9a74af253a68ac0c0d234,3,26,5,31,7,2014-11-12 19:24:22,2014-11-10 19:34:17
e7091e53396d7c9ea0b9a74af253a68ac0c0d234...546bf9a6d7b2c53e81d6a31b652cef15ec103570,5,77,15,92,18,2014-11-12 19:36:03,2014-11-11 22:39:13
546bf9a6d7b2c53e81d6a31b652cef15ec103570...3ebd970fb88d0fb9494f894e3d78d66930ad71e2,4,258,0,258,4,2014-11-12 19:38:27,2014-11-05 20:37:32
3ebd970fb88d0fb9494f894e3d78d66930ad71e2...d6184ee7b6a365852adeb7d2ad084f288418f717,2,125,138,263,34,2014-11-12 19:58:57,2014-11-10 17:23:16
d6184ee7b6a365852adeb7d2ad084f288418f717...df09ff06181a690bc504356a8a82c71163022127,5,84,12,96,14,2014-11-12 19:58:58,2014-11-10 20:11:07
df09ff06181a690bc504356a8a82c71163022127...8c8d039ad7db78593f5e96e1deddf52bcb01bbd1,1,14,1,15,4,2014-11-12 20:05:38,2014-10-30 21:08:52
8c8d039ad7db78593f5e96e1deddf52bcb01bbd1...866d3851fcb7a6b230cb2fde7b2a6253ba32eeb5,2,44,4,48,6,2014-11-12 20:37:37,2014-11-05 20:25:09
866d3851fcb7a6b230cb2fde7b2a6253ba32eeb5...578c5c5bdbf43378da11f706be0d9a54daba0929,2,9,13,22,6,2014-11-12 20:37:37,2014-11-10 18:03:56
578c5c5bdbf43378da11f706be0d9a54daba0929...fdc16e8d1d2346ca152528b71538942efb3ce4db,9,174,42,216,31,2014-11-12 20:37:37,2014-11-07 22:19:18
fdc16e8d1d2346ca152528b71538942efb3ce4db...52db1600fcde4a5b6bd25ed83802d02bde64538c,2,128,5,133,4,2014-11-12 20:37:37,2014-11-05 21:09:58
52db1600fcde4a5b6bd25ed83802d02bde64538c...af66bbba9dc6fdfce07168e0b3cd02d160c29e09,1,5,4,9,4,2014-11-12 20:37:37,2014-11-06 14:39:13
af66bbba9dc6fdfce07168e0b3cd02d160c29e09...8f6c27d5200352d3e26cbefeac627c0b77654aa5,1,26,5,31,5,2014-11-12 20:37:37,2014-11-11 16:51:47
8f6c27d5200352d3e26cbefeac627c0b77654aa5...f91a45e1c0144b0795cd41f6d360cb6a6bded510,1,20,0,20,1,2014-11-12 21:04:59,2014-11-12 21:04:13
f91a45e1c0144b0795cd41f6d360cb6a6bded510...b53c39c05d6f0ed60ce64e6e3c385095989ed347,1,16,17,33,2,2014-11-12 22:26:19,2014-11-12 01:23:06
b53c39c05d6f0ed60ce64e6e3c385095989ed347...9fa536a4134e55359b13b3f6975f5fe497505777,1,3,1,4,1,2014-11-12 22:27:03,2014-11-05 00:10:09
9fa536a4134e55359b13b3f6975f5fe497505777...abb646af87f18ff222eb9684bd4e04ccf61987b8,2,60,27,87,9,2014-11-12 22:28:05,2014-11-04 23:33:43
abb646af87f18ff222eb9684bd4e04ccf61987b8...be5c5eb936844926384c53ca0b5be0cd83438dc9,3,18,2,20,13,2014-11-12 22:29:19,2014-11-11 20:00:23
be5c5eb936844926384c53ca0b5be0cd83438dc9...6e7f0bd5b2b36f292fc2e3ee72f4b4b0ee504a06,3,52,15,67,11,2014-11-12 22:44:15,2014-11-11 19:52:58
6e7f0bd5b2b36f292fc2e3ee72f4b4b0ee504a06...b2ffa0b51be6e75fdd2eed15b2d79c3e5010f0af,3,14,28,42,7,2014-11-12 22:44:15,2014-11-06 18:32:47
b2ffa0b51be6e75fdd2eed15b2d79c3e5010f0af...5016268d94a5fef8a229911c45e6fd6679a7d2f9,2,4,3,7,3,2014-11-12 22:44:15,2014-11-06 22:15:04
5016268d94a5fef8a229911c45e6fd6679a7d2f9...622bb23dca571100644c8dd927bd844a3ceae19e,14,48,35,83,27,2014-11-12 22:44:15,2014-11-04 23:04:58
622bb23dca571100644c8dd927bd844a3ceae19e...7bdca162807d6436d469a352a129226252cb451d,1,5,5,10,3,2014-11-13 05:53:18,2014-11-13 05:53:18
7bdca162807d6436d469a352a129226252cb451d...dce1d2f0baca3d261a55c162f4c6539e3bdce968,1,1,0,1,1,2014-11-13 15:42:39,2014-11-13 15:42:39
dce1d2f0baca3d261a55c162f4c6539e3bdce968...44461e50ac7124b76564a400948ed7b9173504b4,7,33,1,34,8,2014-11-13 15:52:25,2014-11-07 01:34:10
44461e50ac7124b76564a400948ed7b9173504b4...7dc63fa1a8d6937e9dd2c029da002a7a99372b57,3,18,17,35,11,2014-11-13 15:52:25,2014-11-07 13:22:44
7dc63fa1a8d6937e9dd2c029da002a7a99372b57...43b83d0a3885b919efe3fe13631c39ed7c1f88e7,1,1,1,2,1,2014-11-13 16:18:34,2014-11-13 16:16:18
43b83d0a3885b919efe3fe13631c39ed7c1f88e7...a6be8c0d9cee8c3a87a26f3d5e0fb6f58632bf43,1,2,1,3,1,2014-11-13 16:20:29,2014-11-13 02:35:12
a6be8c0d9cee8c3a87a26f3d5e0fb6f58632bf43...f31a38be3ce39267382e59b4fe74be1129b96679,78,305,8145,8450,128,2014-11-13 16:20:38,2014-11-13 14:02:02
f31a38be3ce39267382e59b4fe74be1129b96679...0b2aa4d52ed162d35a414afa215aea708f0cfd6a,1,6,2,8,2,2014-11-13 16:27:36,2014-11-13 15:51:20
0b2aa4d52ed162d35a414afa215aea708f0cfd6a...d1cba25b72f41a2374eae4f74e12299196149580,14,35,48,83,27,2014-11-13 16:31:23,2014-11-13 16:31:13
d1cba25b72f41a2374eae4f74e12299196149580...2882b7b7e6606f8d45941fd83d9707bb8a4b3f7d,3,30,31,61,10,2014-11-13 16:55:50,2014-11-13 16:52:34
2882b7b7e6606f8d45941fd83d9707bb8a4b3f7d...08e15d0ea10a9445cb356b14c29c1a0499b35337,2,7,3,10,4,2014-11-13 17:05:20,2014-11-11 21:47:32
08e15d0ea10a9445cb356b14c29c1a0499b35337...a227b9ef0ed691a85786f9d2ca3862aadc4e9369,1,3,0,3,1,2014-11-13 17:05:39,2014-11-07 21:17:44
a227b9ef0ed691a85786f9d2ca3862aadc4e9369...f49039888f598207b315592da43a266fbf9f179d,7,1,33,34,8,2014-11-13 17:07:22,2014-11-13 17:06:31
f49039888f598207b315592da43a266fbf9f179d...c93641756a1d8444876b9b79c3aa9a9635626891,3,28,26,54,11,2014-11-13 17:10:02,2014-11-12 23:10:42
c93641756a1d8444876b9b79c3aa9a9635626891...cc9365f57436d53360238d2353b05f6dc06d1dcc,2,7,1,8,2,2014-11-13 17:21:11,2014-11-12 16:53:18
cc9365f57436d53360238d2353b05f6dc06d1dcc...a38dbb08df9b4bafc94a54da07746950048a4e41,1,9,17,26,9,2014-11-13 12:23:38,2014-11-06 14:05:05
a38dbb08df9b4bafc94a54da07746950048a4e41...9a9b844828cdba0689484a6c18d9f04e8b5f950c,1,4,1,5,1,2014-11-13 12:23:38,2014-11-06 11:30:44
9a9b844828cdba0689484a6c18d9f04e8b5f950c...be6b276f8367b2165133599d631cec0c9813afab,1,62,0,62,9,2014-11-13 12:23:38,2014-10-29 14:06:16
be6b276f8367b2165133599d631cec0c9813afab...f10ba2d36f36c01a8cc463d84b7c2f3a5d8af879,4,153,10,163,11,2014-11-13 12:23:39,2014-10-29 17:55:01
f10ba2d36f36c01a8cc463d84b7c2f3a5d8af879...056b9a0e411e83e19577ff814ac65eb677b05ae0,1,3,3,6,1,2014-11-13 18:40:45,2014-11-13 18:40:45
056b9a0e411e83e19577ff814ac65eb677b05ae0...1722a1f3ec981d2e6c3478685e527a34f9863f2e,1,4,5,9,3,2014-11-13 19:26:54,2014-11-13 15:29:01
1722a1f3ec981d2e6c3478685e527a34f9863f2e...284f942a45b877f0baecd19cbf17fc2a4e246a79,19,120,141,261,65,2014-11-13 19:30:10,2014-11-07 03:18:15
284f942a45b877f0baecd19cbf17fc2a4e246a79...b5ec9f42599386a348a5d6b6ae1b17156380050c,5,123,39,162,27,2014-11-13 23:07:51,2014-11-13 23:07:51
b5ec9f42599386a348a5d6b6ae1b17156380050c...0822fa2908d02d7154c9a1378526dbca97238608,4,33,7,40,7,2014-11-13 23:11:45,2014-11-12 22:20:00
0822fa2908d02d7154c9a1378526dbca97238608...43e606715e80d43696eeb7048b33017f14a49eb3,15,291,270,561,186,2014-11-13 23:27:02,2014-11-10 13:44:31
43e606715e80d43696eeb7048b33017f14a49eb3...a5148c29d3c47f11afc6d28cd3430b13b162d949,1,0,1,1,1,2014-11-13 23:55:23,2014-11-13 23:53:32
a5148c29d3c47f11afc6d28cd3430b13b162d949...81bb3e94b06d85f9aac2b014040b81ca7fc5c5bb,1,7,6,13,4,2014-11-14 01:30:09,2014-11-14 01:30:09
81bb3e94b06d85f9aac2b014040b81ca7fc5c5bb...60bde0565d251463b50cee23b49a025d78e2278d,5,229,14,243,22,2014-11-14 02:26:24,2014-11-12 15:29:21
60bde0565d251463b50cee23b49a025d78e2278d...0962abcb99b52b6a9d4d03e7980569a7933394b3,5,161,201,362,80,2014-11-14 02:26:24,2014-11-13 17:12:01
0962abcb99b52b6a9d4d03e7980569a7933394b3...085feab6152583399cdf885f245e631d7a2a9ef6,2,9,1,10,3,2014-11-14 14:39:14,2014-11-14 14:38:56
085feab6152583399cdf885f245e631d7a2a9ef6...80102d2ba97e5c35587bbba618e9501debb0d268,1,1,1,2,1,2014-11-14 15:45:13,2014-11-14 03:57:37
80102d2ba97e5c35587bbba618e9501debb0d268...3a8c58f22a02fca264932802596a223b4e49efcb,9,13,14,27,12,2014-11-14 16:23:17,2014-11-13 21:11:15
3a8c58f22a02fca264932802596a223b4e49efcb...cac6d5db1b98a5a1bdd54a3ac75c3c859ceb5d30,1,103,55,158,5,2014-11-14 16:27:11,2014-11-04 19:20:38
cac6d5db1b98a5a1bdd54a3ac75c3c859ceb5d30...7d108f46694302f962c0efb60106e703fb8cceff,1,4,2,6,1,2014-11-14 16:30:52,2014-11-14 15:41:53
7d108f46694302f962c0efb60106e703fb8cceff...7ad98f86d290ffc00849f701b93e7a0aaa0c5be9,1,41,29,70,8,2014-11-14 11:42:27,2014-11-14 11:27:02
7ad98f86d290ffc00849f701b93e7a0aaa0c5be9...2de05fd1e465a2889c0f1035709710da8b0ad041,3,214,18,232,6,2014-11-14 17:02:29,2014-11-13 19:15:22
2de05fd1e465a2889c0f1035709710da8b0ad041...47d13ec4b8f19973cd7242ea2cba2ec882073a5e,1,28,19,47,16,2014-11-14 17:26:32,2014-11-14 14:02:27
47d13ec4b8f19973cd7242ea2cba2ec882073a5e...d56a2b6bc566489899033275fd9dbb3ab5d4eb02,2,5,1,6,2,2014-11-14 13:55:30,2014-11-13 16:57:19
d56a2b6bc566489899033275fd9dbb3ab5d4eb02...12a5ee7a57884bd227aa2a6b41bf56fd9f92eeb2,1,4,7,11,3,2014-11-14 19:00:46,2014-11-14 02:21:34
12a5ee7a57884bd227aa2a6b41bf56fd9f92eeb2...4169b355bcfa6c57f0dd8f5fbb8db4d823cb3c86,2,5,0,5,3,2014-11-14 20:16:16,2014-11-14 19:57:33
4169b355bcfa6c57f0dd8f5fbb8db4d823cb3c86...7556a05d67e1cb53503e7087e2a8c3b49a1a1503,2,5,1,6,2,2014-11-14 20:34:35,2014-11-14 19:28:28
7556a05d67e1cb53503e7087e2a8c3b49a1a1503...a57241b5823968515be18614b1358e4bd7db5acc,2,63,27,90,6,2014-11-14 20:35:14,2014-09-18 13:40:55
a57241b5823968515be18614b1358e4bd7db5acc...6334d8898369773c99be56ec1a4363ae5ee0e54d,5,72,55,127,46,2014-11-14 20:38:36,2014-11-12 21:36:10
6334d8898369773c99be56ec1a4363ae5ee0e54d...3d754a25fb3a14c4ddd47b5257b86e775fb17091,1,62,1,63,4,2014-11-14 20:42:49,2014-11-13 20:23:36
3d754a25fb3a14c4ddd47b5257b86e775fb17091...78923a5dd969e9b9f46d3fe9bdd969ab0d0a3ca2,8,78,72,150,49,2014-11-14 20:42:49,2014-11-13 22:23:19
78923a5dd969e9b9f46d3fe9bdd969ab0d0a3ca2...6604c0aca8c0ca8eb289c53ebf1e890c7321bae5,2,7,5,12,4,2014-11-14 20:44:51,2014-11-05 18:44:36
6604c0aca8c0ca8eb289c53ebf1e890c7321bae5...de6b53385a04dba79572254e1231bd274000323a,1,4,4,8,2,2014-11-14 21:08:50,2014-11-10 21:21:28
de6b53385a04dba79572254e1231bd274000323a...9a0cb0d0ba72bc499c1761487422b72904e951a7,2,3,3,6,4,2014-11-14 21:36:40,2014-11-14 21:26:56
9a0cb0d0ba72bc499c1761487422b72904e951a7...3660339e223ce36e864e983ef3e4b419738e54c4,1,17,7,24,2,2014-11-14 21:45:18,2014-11-14 20:59:07
3660339e223ce36e864e983ef3e4b419738e54c4...d12f3728b725615cb62b89396efbd3c8c059524f,2,67,38,105,23,2014-11-14 22:36:42,2014-11-14 17:02:57
d12f3728b725615cb62b89396efbd3c8c059524f...224b7bf55bbe8faf80a089298b5a4dc51b396423,1,0,4,4,2,2014-11-17 14:54:37,2014-11-14 16:09:03
224b7bf55bbe8faf80a089298b5a4dc51b396423...2783e323051eb5eeaedee4a607934974177f74c2,2,16,22,38,16,2014-11-17 16:17:09,2014-11-11 19:28:44
2783e323051eb5eeaedee4a607934974177f74c2...e8437d34eee926e5c6bb3eac4a74f8a1fdf19448,1,21,15,36,9,2014-11-17 16:17:09,2014-11-14 21:01:10
e8437d34eee926e5c6bb3eac4a74f8a1fdf19448...bec3fc4b1374fb9eff9e4cc82ada7b8d5f43de45,1,15,12,27,9,2014-11-17 16:17:09,2014-11-14 21:03:24
bec3fc4b1374fb9eff9e4cc82ada7b8d5f43de45...b73c76f266a5427bfbab913e437ecda9aba34fda,2,39,20,59,21,2014-11-17 14:13:47,2014-11-17 12:19:30
b73c76f266a5427bfbab913e437ecda9aba34fda...b46eacd87939064307695e681211fa874f82d3df,1,1,1,2,1,2014-11-17 19:35:19,2014-11-17 14:17:34
b46eacd87939064307695e681211fa874f82d3df...e98a99d0a51b14dab253ec84eec9aa41f163c517,1,2,1,3,1,2014-11-17 19:35:19,2014-11-17 14:42:21
e98a99d0a51b14dab253ec84eec9aa41f163c517...764b53c3432c0b01f8d44fe3cea1a5f6d07d805b,6,31,4,35,14,2014-11-17 19:40:41,2014-11-17 14:23:16
764b53c3432c0b01f8d44fe3cea1a5f6d07d805b...279587c470f1571b518f7a4b7fba923cf0909a09,2,36,9,45,9,2014-11-17 20:05:59,2014-11-17 14:49:17
279587c470f1571b518f7a4b7fba923cf0909a09...984bd847c0459d729e86d176ff6839e8801e7864,12,0,2440,2440,12,2014-11-17 20:19:34,2014-11-17 20:19:18
984bd847c0459d729e86d176ff6839e8801e7864...ba895ea2965bf99a14f16f2d94657417bf7c6ab1,1,47,0,47,1,2014-11-17 20:42:49,2014-11-07 18:48:38
ba895ea2965bf99a14f16f2d94657417bf7c6ab1...002c8f028ac27701a530db139a72cbc504c94f35,4,62,29,91,17,2014-11-17 20:58:56,2014-11-14 15:15:58
002c8f028ac27701a530db139a72cbc504c94f35...4f740ca4fcfee9f0ec1c0a502e138ff749d5248d,1,31,9,40,7,2014-11-17 21:07:54,2014-11-04 16:35:00
4f740ca4fcfee9f0ec1c0a502e138ff749d5248d...5b032a9c80e483b6e28a2d6727cbc990de203cd4,1,13,11,24,9,2014-11-17 21:16:06,2014-11-14 16:29:41
5b032a9c80e483b6e28a2d6727cbc990de203cd4...09d04e84e71651a5af7fa738c4614a6dd4dfb848,1,23,2,25,9,2014-11-17 21:39:48,2014-11-14 23:00:52
09d04e84e71651a5af7fa738c4614a6dd4dfb848...d41f98bd0fdc3d392fc19aadfdc62a020d17fede,8,52,17,69,14,2014-11-17 22:16:06,2014-11-11 16:21:41
d41f98bd0fdc3d392fc19aadfdc62a020d17fede...05a80c840a7389ee182e82d3724032ac874b3c74,13,181,85,266,34,2014-11-17 22:20:32,2014-11-17 15:01:10
05a80c840a7389ee182e82d3724032ac874b3c74...d6ac44b4ac2f20c9a3145f575e72ebe2528db3c6,3,35,2,37,3,2014-11-17 22:20:32,2014-11-17 19:07:21
d6ac44b4ac2f20c9a3145f575e72ebe2528db3c6...bddcc15df9736883f8b94e18a8718b24079b1c94,6,86,15,101,9,2014-11-17 22:20:32,2014-11-12 20:02:31
bddcc15df9736883f8b94e18a8718b24079b1c94...7f96d80fa8fcad7fb59bebae7e83db1a9f0120ad,1,1,1,2,1,2014-11-17 23:58:53,2014-11-17 23:58:53
7f96d80fa8fcad7fb59bebae7e83db1a9f0120ad...086893fa1ae5d561992be80ab4e85e34d37572c3,2,6,2,8,2,2014-11-18 00:12:31,2014-11-18 00:04:45
086893fa1ae5d561992be80ab4e85e34d37572c3...d0cd11123e114ea8cea33e37d06d1cf43c41727b,6,23,7,30,8,2014-11-18 00:23:06,2014-11-12 10:53:33
d0cd11123e114ea8cea33e37d06d1cf43c41727b...b32c91b8cb3a6bd214f31a962a6ef4556225bfc4,5,32,6,38,11,2014-11-18 03:16:15,2014-11-18 03:16:15
b32c91b8cb3a6bd214f31a962a6ef4556225bfc4...447520acdac717d88037019d46e2d1c4eb997272,1,5,2,7,2,2014-11-18 04:48:46,2014-11-18 04:48:46
447520acdac717d88037019d46e2d1c4eb997272...aa435e0f1303cd618b1df78ab086d5e06a52b1d3,1,1,0,1,1,2014-11-18 06:55:09,2014-11-18 06:54:15
aa435e0f1303cd618b1df78ab086d5e06a52b1d3...adb1e5f25f3f5eacbbed382426542623b67632e5,1,7,12,19,6,2014-11-18 17:13:01,2014-11-17 20:20:59
adb1e5f25f3f5eacbbed382426542623b67632e5...87360c5dec1916fa033dfaaf4c369ed7912f331d,1,2,2,4,3,2014-11-18 17:13:01,2014-11-17 20:21:36
87360c5dec1916fa033dfaaf4c369ed7912f331d...c3b92185d0a2f30e819aff44022e92230fb55b03,3,4,4,8,4,2014-11-18 17:13:01,2014-11-09 18:03:44
c3b92185d0a2f30e819aff44022e92230fb55b03...14ca6bfd67d5efb10fc21778246442c2f223dc1e,1,1,1,2,1,2014-11-18 17:14:53,2014-11-18 16:03:28
14ca6bfd67d5efb10fc21778246442c2f223dc1e...eedc5e87ff9d33a6976de1fd1f606ab7435069d5,7,71,1055,1126,39,2014-11-18 17:15:34,2014-11-14 17:11:06
eedc5e87ff9d33a6976de1fd1f606ab7435069d5...eb1dc0918fc0a964ed7dbff31a0b815d0081e14c,1,1,0,1,1,2014-11-18 17:57:17,2014-11-18 15:45:28
eb1dc0918fc0a964ed7dbff31a0b815d0081e14c...5cd68e1a6846ebdd07e5a75753108baab2e4af11,1,1,0,1,1,2014-11-18 17:57:17,2014-11-18 15:45:48
5cd68e1a6846ebdd07e5a75753108baab2e4af11...cf00df557a4ba4e313458838766c649edcba3258,1,7,2,9,1,2014-11-18 19:18:45,2014-11-18 19:06:34
cf00df557a4ba4e313458838766c649edcba3258...3336204de27b1fdfc7554cc60597dd0e10d738af,1,10,9,19,5,2014-11-18 19:31:45,2014-11-10 23:15:09
3336204de27b1fdfc7554cc60597dd0e10d738af...debe7c741f6f21587003fc3be4ccda5147b7e27b,2,1,11,12,3,2014-11-18 19:31:45,2014-11-11 00:10:24
debe7c741f6f21587003fc3be4ccda5147b7e27b...a6bba2cd699581aa610c636cd25042f2b45c8093,5,23,13,36,13,2014-11-18 19:32:09,2014-11-12 16:27:07
a6bba2cd699581aa610c636cd25042f2b45c8093...ec3eecbf43af93e63a86f4ccda539328aa967fef,5,80,73,153,30,2014-11-18 19:32:17,2014-11-14 21:04:18
ec3eecbf43af93e63a86f4ccda539328aa967fef...4b8502bd7b6b4bc675be98768644de5c25f5f94a,1,34,14,48,2,2014-11-18 19:32:17,2014-11-17 17:46:01
4b8502bd7b6b4bc675be98768644de5c25f5f94a...cf589f12e49136cfaa694a3f0eb61bca6fe987e7,2,174,23,197,12,2014-11-18 19:32:17,2014-11-17 23:56:24
cf589f12e49136cfaa694a3f0eb61bca6fe987e7...813a2908ed3f35e1e395179983e0f09b0fee8fe5,2,28,11,39,9,2014-11-18 20:30:58,2014-11-18 17:54:36
813a2908ed3f35e1e395179983e0f09b0fee8fe5...20c218d3d3df17c820b9cd3e6399a2dec6755d94,3,93,28,121,30,2014-11-18 20:32:08,2014-11-18 20:31:21
20c218d3d3df17c820b9cd3e6399a2dec6755d94...7ec1120f79778344a57a6c65fa57cdf6480857ef,7,186,0,186,8,2014-11-18 20:33:10,2014-11-11 21:46:36
7ec1120f79778344a57a6c65fa57cdf6480857ef...cf132ed1034fb7db8280f1d6d72b0799c4152d5d,1,0,56,56,1,2014-11-18 20:34:45,2014-11-18 20:30:14
cf132ed1034fb7db8280f1d6d72b0799c4152d5d...5aedc94e6539773606c8276d192d5342665b7a59,3,5,5,10,5,2014-11-18 21:47:28,2014-11-18 21:47:28
5aedc94e6539773606c8276d192d5342665b7a59...27e1526d49b169f5086ad88c15903143cb1906b7,1,9,9,18,7,2014-11-18 22:03:01,2014-11-18 15:34:24
27e1526d49b169f5086ad88c15903143cb1906b7...f88237b9afdf56989adb5113890646d931d520cc,33,34,34,68,34,2014-11-18 22:03:01,2014-11-18 15:45:45
f88237b9afdf56989adb5113890646d931d520cc...6704a4548ae6b5c310991e4d5d82509999cef306,17,18,18,36,18,2014-11-18 22:03:01,2014-11-18 16:01:32
6704a4548ae6b5c310991e4d5d82509999cef306...af8fdf9102f60fc731ef64c8ad5cb2b19745dc4e,20,23,23,46,23,2014-11-18 22:03:02,2014-11-18 16:03:06
af8fdf9102f60fc731ef64c8ad5cb2b19745dc4e...9efe8f1e1d37239cf77e8b5de57bce42dc43e8e1,9,12,12,24,12,2014-11-18 22:03:02,2014-11-18 16:49:39
9efe8f1e1d37239cf77e8b5de57bce42dc43e8e1...107a8a87e50f4e625c6a4f0c533db0f75f037093,11,13,13,26,13,2014-11-18 22:03:02,2014-11-18 16:50:57
107a8a87e50f4e625c6a4f0c533db0f75f037093...d6427045827b5ae5dc1fea9917cba3c1dcf0d341,1,1,1,2,1,2014-11-18 22:46:12,2014-11-18 16:38:06
d6427045827b5ae5dc1fea9917cba3c1dcf0d341...2bf87c388c8c2d2956cd8e1b81cdd84ca285fa50,3,120,92,212,23,2014-11-18 22:46:13,2014-11-18 15:21:23
2bf87c388c8c2d2956cd8e1b81cdd84ca285fa50...45f21d67bb9cf17d1804f04e1e98cf171ae1b6e7,2,20,11,31,5,2014-11-18 23:16:44,2014-11-18 01:53:51
45f21d67bb9cf17d1804f04e1e98cf171ae1b6e7...8987c8005e54430c0934c02b2cb62d8545028e89,1,4,4,8,4,2014-11-19 01:58:13,2014-11-19 01:58:13
8987c8005e54430c0934c02b2cb62d8545028e89...2c7b356511a70c8e822a526f39a2ca9ad649e180,1,1,1,2,1,2014-11-19 02:51:42,2014-11-19 02:51:42
2c7b356511a70c8e822a526f39a2ca9ad649e180...c0a623cf2bba01c4fbb78bda4a7b2e67c1c8d2d8,4,16,16,32,13,2014-11-19 04:02:54,2014-11-19 03:56:27
c0a623cf2bba01c4fbb78bda4a7b2e67c1c8d2d8...42d25fc0fd25d59fb2b2f29f79f09cb4f7f623c6,1,1,1,2,1,2014-11-19 13:34:21,2014-11-19 04:16:47
42d25fc0fd25d59fb2b2f29f79f09cb4f7f623c6...b1be46d80c999a4a583dd55dff5da42b28480f15,48,1032,552,1584,266,2014-11-19 13:34:34,2014-11-19 04:17:10
b1be46d80c999a4a583dd55dff5da42b28480f15...c6653bd908a98c3b98ca14a6769cb52da1ff0d19,2,27,14,41,9,2014-11-19 15:33:39,2014-11-19 15:33:39
c6653bd908a98c3b98ca14a6769cb52da1ff0d19...f4c67e1f3e5c0a63567539a5b97c32b22cb693f7,1,9,1,10,2,2014-11-19 15:45:07,2014-11-19 13:44:35
f4c67e1f3e5c0a63567539a5b97c32b22cb693f7...2e2091d502d959f52640de209470ecd3180d7269,6,34,0,34,6,2014-11-19 15:45:07,2014-11-18 19:41:06
2e2091d502d959f52640de209470ecd3180d7269...217151b66aefddca0a62e92aa095bb4f27dba574,2,23,174,197,12,2014-11-19 17:14:09,2014-11-19 17:14:09
217151b66aefddca0a62e92aa095bb4f27dba574...365cca0c47566d192ca847f0b077cedef4b3430e,36,1797,0,1797,38,2014-11-19 18:05:24,2014-11-19 16:54:45
365cca0c47566d192ca847f0b077cedef4b3430e...489690cfbccc24cf69b6ae7848581303ec8f4b0e,3,45,13,58,14,2014-11-19 20:15:41,2014-11-17 21:27:35
489690cfbccc24cf69b6ae7848581303ec8f4b0e...2304904687c5d29e228d86da95244682dc62caa1,4,174,141,315,41,2014-11-19 20:28:20,2014-11-18 16:35:22
2304904687c5d29e228d86da95244682dc62caa1...fe6cc50395b76494cae644c98cbc9ec265cf78b1,6,0,34,34,6,2014-11-19 20:59:38,2014-11-19 20:59:28
fe6cc50395b76494cae644c98cbc9ec265cf78b1...f27fba8fddbb50d0e7ad2522a0a3b766b456b29d,1,23,22,45,5,2014-11-19 21:25:21,2014-11-17 18:54:08
f27fba8fddbb50d0e7ad2522a0a3b766b456b29d...0f8898e95d6096b306fe655ef7141a01f1e71100,2,20,30,50,9,2014-11-19 21:25:21,2014-11-18 16:45:45
0f8898e95d6096b306fe655ef7141a01f1e71100...65ab6bcc319d1d4a1fe2f19615e646cac6dd3f7e,3,44,27,71,12,2014-11-19 21:25:21,2014-11-19 20:41:41
65ab6bcc319d1d4a1fe2f19615e646cac6dd3f7e...eac11632002de066d03936b5246d1d6162e7d240,1,0,1,1,1,2014-11-19 21:25:21,2014-11-19 21:19:35
eac11632002de066d03936b5246d1d6162e7d240...74cd9523a6b9d81dc60bdf6af05f6fa2e8739159,3,32,13,45,10,2014-11-19 22:09:23,2014-11-18 19:33:52
74cd9523a6b9d81dc60bdf6af05f6fa2e8739159...e6ff142766cf8cbfa04a9c6acc5cb8ced3ea9fb3,2,27,3,30,8,2014-11-19 22:29:33,2014-11-17 21:53:35
e6ff142766cf8cbfa04a9c6acc5cb8ced3ea9fb3...442d1dc06fd8d04e27a2838995f1eef8bf87d27a,3,13,32,45,10,2014-11-20 00:21:21,2014-11-20 00:21:21
442d1dc06fd8d04e27a2838995f1eef8bf87d27a...acc09c2ec26b27c6d201f5f98a2a9c7b4215b1ae,3,113,1,114,4,2014-11-20 14:18:54,2014-11-19 22:56:32
acc09c2ec26b27c6d201f5f98a2a9c7b4215b1ae...def8f54bf6162317cc8b345e81c6e698d618ad96,14,316,228,544,102,2014-11-20 15:58:22,2014-11-20 13:31:42
def8f54bf6162317cc8b345e81c6e698d618ad96...42d802af32f99663bc1c66456b2d57749010bed5,7,14,28,42,16,2014-11-20 16:35:25,2014-11-07 23:28:29
42d802af32f99663bc1c66456b2d57749010bed5...13577a48b51202aabd2e55ef95404439aaa4a0c3,8,195,105,300,59,2014-11-20 16:38:11,2014-11-19 00:10:13
13577a48b51202aabd2e55ef95404439aaa4a0c3...10cf936a3635a72ee61714631050cf54466410eb,52,46,7133,7179,78,2014-11-20 16:38:11,2014-11-07 23:19:27
10cf936a3635a72ee61714631050cf54466410eb...2ac3b5b8c79726c73e08bdac732f8f09d846d72f,8,17,148,165,21,2014-11-20 16:41:48,2014-11-19 19:45:41
2ac3b5b8c79726c73e08bdac732f8f09d846d72f...1b204eba0dc80f4007cb88b995b761a8bc0987fc,1,13,8,21,2,2014-11-20 16:41:48,2014-11-19 21:56:10
1b204eba0dc80f4007cb88b995b761a8bc0987fc...429dc5819eb37e21d9e5c4573aae8421efd50ed7,21,108,106,214,93,2014-11-20 17:52:25,2014-10-20 21:08:55
429dc5819eb37e21d9e5c4573aae8421efd50ed7...4c221b5ce50c3eaabc0348432b6df6c41aeabee5,79,210,209,419,186,2014-11-20 17:52:25,2014-10-20 22:38:32
4c221b5ce50c3eaabc0348432b6df6c41aeabee5...5c9b4a636753e98de0ba7d9d518bfb6516f843d7,18,44,4,48,39,2014-11-20 17:52:25,2014-10-20 21:09:18
5c9b4a636753e98de0ba7d9d518bfb6516f843d7...9ae1dd37b3fa0a0325d65dc1b6c8101902c1c2a3,2,45,7,52,4,2014-11-20 19:40:20,2014-11-05 14:30:28
9ae1dd37b3fa0a0325d65dc1b6c8101902c1c2a3...e8c4f9b33b1b1b8b500e94da331a8eb9e0b9ad05,1,82,0,82,1,2014-11-20 19:40:20,2014-11-05 16:49:27
e8c4f9b33b1b1b8b500e94da331a8eb9e0b9ad05...d10ee8adc8265451d9fcbaae9669709618751311,1,5,1,6,1,2014-11-20 20:26:00,2014-11-18 20:54:40
d10ee8adc8265451d9fcbaae9669709618751311...4dda322fdb688a53c243fe7c0df778f5b3f0a0cd,5,156,7,163,15,2014-11-20 20:40:13,2014-11-06 18:45:16
4dda322fdb688a53c243fe7c0df778f5b3f0a0cd...a932b12ac03366e9336ffc92e7710ddb5c3b3a39,3,623,0,623,3,2014-11-20 20:43:02,2014-11-14 22:25:54
a932b12ac03366e9336ffc92e7710ddb5c3b3a39...b2122dd20ae8cd761312301e90e0e7ca429ec8db,5,43,2,45,10,2014-11-20 20:43:02,2014-11-19 21:31:17
b2122dd20ae8cd761312301e90e0e7ca429ec8db...5d53a26ce33320b5b91ff5a8fcd2b69be1367367,2,5,5,10,5,2014-11-20 21:34:30,2014-11-20 21:34:30
5d53a26ce33320b5b91ff5a8fcd2b69be1367367...5d1f0d27992da53eb1c546f413e5b34e78d8c439,1,4,2,6,2,2014-11-20 22:01:05,2014-11-20 21:43:57
5d1f0d27992da53eb1c546f413e5b34e78d8c439...59487e24591a505acb8eb03d5c5d0652098e0841,6,10,12,22,6,2014-11-20 23:31:06,2014-11-20 00:09:33
59487e24591a505acb8eb03d5c5d0652098e0841...534263f1d83cdeb142c27f0ea5a1ecffc5b7526a,1,8,0,8,2,2014-11-21 13:08:55,2014-11-21 13:08:55
534263f1d83cdeb142c27f0ea5a1ecffc5b7526a...e5644e2ca12a60df677cb8e8dfc70f19a9423b0a,10,52,33,85,19,2014-11-21 18:04:38,2014-11-20 23:21:44
e5644e2ca12a60df677cb8e8dfc70f19a9423b0a...e7f6c56327afa51847a95d9d5bc6399209856c10,53,167,1,168,136,2014-11-21 18:18:53,2014-11-20 19:26:43
e7f6c56327afa51847a95d9d5bc6399209856c10...f56ea73672e1eebde4d2e9cef2f8fca0d84f0956,1,9,25,34,11,2014-11-21 18:37:02,2014-11-21 14:17:57
f56ea73672e1eebde4d2e9cef2f8fca0d84f0956...8e0e873320a0962460c7a8e821495a325efe176b,5,32,8,40,9,2014-11-21 19:11:43,2014-11-20 19:22:05
8e0e873320a0962460c7a8e821495a325efe176b...41024fa4a63255a8502732257ba1642b8d445087,4,199,37,236,21,2014-11-21 19:11:43,2014-11-17 23:56:24
41024fa4a63255a8502732257ba1642b8d445087...ba6a6919605104afac5153279f7c3a7ef80d66b0,1,20,28,48,10,2014-11-21 22:11:26,2014-11-21 22:11:26
ba6a6919605104afac5153279f7c3a7ef80d66b0...8bfae19e291e6ee6e963d2ccc8aa2535ff7c86c4,14,75,27,102,38,2014-11-21 22:24:21,2014-11-21 14:28:06
8bfae19e291e6ee6e963d2ccc8aa2535ff7c86c4...0a02891e3f155e5a187ee14c774d42cbdb290652,7,7,7,14,7,2014-11-21 23:04:57,2014-11-21 20:19:24
0a02891e3f155e5a187ee14c774d42cbdb290652...609a1492d2895ea55a9202815590636d1934a9ca,5,13,13,26,13,2014-11-22 01:52:32,2014-11-22 01:47:55
609a1492d2895ea55a9202815590636d1934a9ca...dec3111d8bf4d6661be5b08f75d30a9fbe0c18ff,7,7,7,14,7,2014-11-22 14:44:57,2014-11-22 14:44:57
dec3111d8bf4d6661be5b08f75d30a9fbe0c18ff...1b8545eb64b7aa260cc281ea2624504c1ee86d23,1,1,1,2,1,2014-11-23 01:24:22,2014-11-23 01:24:22
1b8545eb64b7aa260cc281ea2624504c1ee86d23...c8171e7f969519af8b87a43425ae291ee69a0191,7,7,7,14,7,2014-11-23 01:24:53,2014-11-23 01:24:53
c8171e7f969519af8b87a43425ae291ee69a0191...e4329ae5e7bfb56ef9b63a8388285b70b7ec9634,7,7,7,14,7,2014-11-23 18:26:54,2014-11-23 18:26:54
e4329ae5e7bfb56ef9b63a8388285b70b7ec9634...4a5d53cc94bc5ddb72ecfc5dd038b0ede12b27aa,4,36,17,53,13,2014-11-24 14:01:51,2014-11-18 19:33:52
4a5d53cc94bc5ddb72ecfc5dd038b0ede12b27aa...d6d10d0c21ad2118dce9e3d6c5efcc6bef965d58,12,95,115,210,79,2014-11-24 14:01:51,2014-11-13 18:47:30
d6d10d0c21ad2118dce9e3d6c5efcc6bef965d58...5bcaa163b3fb6054cbedca1c20bd4ce98ddf1eed,4,237,207,444,9,2014-11-24 14:46:41,2014-11-19 20:59:02
5bcaa163b3fb6054cbedca1c20bd4ce98ddf1eed...b452b55fd032a4e63d9ed25c60ecc5781e0a2b27,1,74,97,171,17,2014-11-24 14:46:42,2014-11-20 16:00:25
b452b55fd032a4e63d9ed25c60ecc5781e0a2b27...5f54b41eb7ab23f1594610aa6950d07b666f0deb,6,60,41,101,27,2014-11-24 14:46:43,2014-11-21 15:58:50
5f54b41eb7ab23f1594610aa6950d07b666f0deb...58e49b2726807b7e7c2f0309607ffa454befbff6,3,20,29,49,11,2014-11-24 14:46:44,2014-11-21 16:38:36
58e49b2726807b7e7c2f0309607ffa454befbff6...792f66beb03f0c0293b56e9aad16f94ad718357a,13,261,187,448,71,2014-11-24 15:57:10,2014-11-24 14:36:11
792f66beb03f0c0293b56e9aad16f94ad718357a...35079a95ebc591dee47ecca5e0f22eb7a7381fd0,1,14,6,20,6,2014-11-24 16:20:58,2014-11-19 23:39:54
35079a95ebc591dee47ecca5e0f22eb7a7381fd0...22871dbd76bfab1a7cb8d63d944f8f2c449e26a2,4,47,1,48,6,2014-11-24 16:52:08,2014-11-24 16:26:19
22871dbd76bfab1a7cb8d63d944f8f2c449e26a2...725c657adc955aed8f832641553861162b448d18,13,36,25,61,28,2014-11-24 18:34:40,2014-11-13 16:31:45
725c657adc955aed8f832641553861162b448d18...bb8e5e6b28f31a0b4e9eefc5df52581073bf332d,3,93,22,115,12,2014-11-24 19:25:13,2014-11-24 16:16:04
bb8e5e6b28f31a0b4e9eefc5df52581073bf332d...8971aede7a00d0918645cb4fb0e579f153d737df,1,1,1,2,1,2014-11-24 19:25:25,2014-11-24 16:16:41
8971aede7a00d0918645cb4fb0e579f153d737df...c281a315cea3f6c5b54d9d6e4b8755d3fce55fd3,1,2,22,24,2,2014-11-24 21:08:45,2014-11-21 18:29:56
c281a315cea3f6c5b54d9d6e4b8755d3fce55fd3...3abc8d35f91605641b3e694c10ad987f64a84d31,9,227,21,248,16,2014-11-24 21:20:22,2014-11-24 21:20:22
3abc8d35f91605641b3e694c10ad987f64a84d31...02077a6e7d7215af65cfd88beda865672d45a442,1,2,1,3,2,2014-11-24 21:28:26,2014-11-24 21:28:26
02077a6e7d7215af65cfd88beda865672d45a442...0ad070c47135f205c638b47e217d46d7da9fd329,3,29,20,49,12,2014-11-24 22:11:14,2014-11-24 22:11:14
0ad070c47135f205c638b47e217d46d7da9fd329...fdb0c2b3b6d42da84acc2748662246e18ae8ecde,1,20,52,72,5,2014-11-24 22:15:41,2014-11-24 22:12:40
fdb0c2b3b6d42da84acc2748662246e18ae8ecde...2ad89b01762d57ee562dacb636f6eebed541581c,2,15,7,22,4,2014-11-25 16:17:38,2014-11-24 22:57:13
2ad89b01762d57ee562dacb636f6eebed541581c...601e10a7a3a7c86a9b44455f0358f199176db2a4,1,1,1,2,1,2014-11-25 16:39:19,2014-11-20 21:40:26
601e10a7a3a7c86a9b44455f0358f199176db2a4...20f830b37613ca1804775d85303074d5c4eb1bd4,1,4,3,7,3,2014-11-25 16:56:54,2014-11-24 21:56:25
20f830b37613ca1804775d85303074d5c4eb1bd4...4429df3a6c2e03f9b406fe27aa98caa660506d73,14,79,39,118,39,2014-11-25 16:57:21,2014-11-24 20:32:35
4429df3a6c2e03f9b406fe27aa98caa660506d73...8deddb065c6124f31346d5f96efe8734da98d125,6,85,16,101,6,2014-11-25 17:01:25,2014-11-21 21:35:21
8deddb065c6124f31346d5f96efe8734da98d125...ff4e5d39940f15f5fcc65e356ad3308859f68693,2,6,16,22,6,2014-11-25 17:58:44,2014-11-18 20:53:22
ff4e5d39940f15f5fcc65e356ad3308859f68693...239e712c955c862565a559ae607e0fdaeee52075,1,3,2,5,1,2014-11-25 20:49:59,2014-11-25 20:49:59
239e712c955c862565a559ae607e0fdaeee52075...a4d077c775d8322c9e59313c3618fe73ac85e925,1,3,5,8,4,2014-11-25 22:34:48,2014-11-25 18:30:03
a4d077c775d8322c9e59313c3618fe73ac85e925...68f1a779e1a3063ef04f07be460d370e7fd82a93,7,25,18,43,12,2014-11-25 22:38:26,2014-11-25 22:14:23
68f1a779e1a3063ef04f07be460d370e7fd82a93...8f0d423946be1873d0af5c6db488d2bee9629899,1,1,2,3,1,2014-11-25 22:44:50,2014-11-25 22:31:45
8f0d423946be1873d0af5c6db488d2bee9629899...cf8bb50e5a8a22205e344e0536646f1ca6bc81e4,5,115,225,340,23,2014-11-25 22:49:07,2014-10-03 23:36:28
cf8bb50e5a8a22205e344e0536646f1ca6bc81e4...113fb30b65cded6ece1160c962d64fa232440b7d,3,9,12,21,3,2014-11-26 00:52:00,2014-11-25 17:25:03
113fb30b65cded6ece1160c962d64fa232440b7d...45790039049d7375beafe122622363d35ce990c2,3,50,43,93,18,2014-11-26 12:20:12,2014-11-25 21:53:19
45790039049d7375beafe122622363d35ce990c2...36435059ccc4b9c49316cd93510d1cdb6f0ab7f1,1,4,2,6,4,2014-11-26 15:01:04,2014-11-25 22:57:05
36435059ccc4b9c49316cd93510d1cdb6f0ab7f1...1ca93ea38fe42f885c5c198d9f46335ff1294136,1,0,0,0,0,2014-11-26 15:03:42,2014-11-25 22:58:58
1ca93ea38fe42f885c5c198d9f46335ff1294136...4df4b1066735e3806fa2efb4ff6d6c6b277ab6b1,4,15,3,18,4,2014-11-26 15:45:48,2014-11-24 19:04:06
4df4b1066735e3806fa2efb4ff6d6c6b277ab6b1...48ae7bda6e2d063d1ec195e54a46c9628eca2103,1,1,1,2,1,2014-11-26 15:47:40,2014-11-24 20:00:12
48ae7bda6e2d063d1ec195e54a46c9628eca2103...04cfca149d3fcfac9c74cf13287be70942ca1ada,7,50,23,73,16,2014-11-26 17:24:22,2014-11-24 14:14:18
04cfca149d3fcfac9c74cf13287be70942ca1ada...cb5cab88761d9aca75e064665cce89f579c69e36,86,129,97,226,146,2014-11-26 20:14:41,2014-11-26 18:58:14
cb5cab88761d9aca75e064665cce89f579c69e36...16a8ef7ad60d498b69bdc0ad5cbca44757d16fd8,192,1383,1379,2762,1256,2014-11-26 20:15:59,2014-11-26 20:04:26
16a8ef7ad60d498b69bdc0ad5cbca44757d16fd8...4e53ba220a73a28a9bd50347c66c347ae97e8b11,5,0,47,47,12,2014-11-27 17:48:39,2014-11-27 17:48:39
4e53ba220a73a28a9bd50347c66c347ae97e8b11...d36eac67be457c8a4e11373b0332e2d8d54975e1,2,39,39,78,20,2014-11-27 17:51:34,2014-11-27 17:51:34
d36eac67be457c8a4e11373b0332e2d8d54975e1...fe363010e4b2b953c9876608861c02df4c8662ec,4,30,28,58,18,2014-11-27 21:40:34,2014-11-26 22:07:11
fe363010e4b2b953c9876608861c02df4c8662ec...3f21939b70236eb5af9e0561357d74c0f65329ea,3,57,1,58,6,2014-11-28 00:52:29,2014-11-28 00:52:29
3f21939b70236eb5af9e0561357d74c0f65329ea...9abf77b84056003cf64ea9c69ae5e85bbd135ce0,1,1,0,1,1,2014-11-28 20:13:45,2014-11-28 20:13:45
9abf77b84056003cf64ea9c69ae5e85bbd135ce0...edb2a9a1a5d13c3d11381a4f4370584d00bad883,4,25,22,47,18,2014-11-30 04:09:32,2014-11-30 04:09:32
edb2a9a1a5d13c3d11381a4f4370584d00bad883...ed023a2b488a74807334e8c0d3db57cf9552cf2c,1,3,1,4,1,2014-11-30 16:05:22,2014-11-30 16:05:22
ed023a2b488a74807334e8c0d3db57cf9552cf2c...977abaaba51aeda3b4c6f0774aeb66b41aaa2274,1,53,0,53,1,2014-12-01 09:25:29,2014-11-25 14:11:46
977abaaba51aeda3b4c6f0774aeb66b41aaa2274...2684c73fc835681b00f9822009a5621fb12d26bc,2,12,13,25,11,2014-12-01 16:49:31,2014-11-25 23:10:33
2684c73fc835681b00f9822009a5621fb12d26bc...430f62da7380a6864058c2f75a64c5d662a95176,13,156,280,436,56,2014-12-01 19:15:08,2014-11-21 16:40:19
430f62da7380a6864058c2f75a64c5d662a95176...080fb4ec9e610402aeee0db4d37cf291812a3c58,1,14,17,31,4,2014-12-01 21:10:31,2014-12-01 16:11:09
080fb4ec9e610402aeee0db4d37cf291812a3c58...06928da7d219ac9085d666274af4a82d81e99d4c,16,88,134,222,75,2014-12-01 21:31:10,2014-11-21 19:37:09
06928da7d219ac9085d666274af4a82d81e99d4c...038ddab4c9144daed30d4c2982d5b3319d551e61,14,155,26,181,20,2014-12-01 21:32:32,2014-11-20 22:52:17
038ddab4c9144daed30d4c2982d5b3319d551e61...c1c8778a5b7a1fa9f5cd5625fb3fd9dc7d667d37,4,123,8,131,12,2014-12-01 22:04:00,2014-12-01 08:21:02
c1c8778a5b7a1fa9f5cd5625fb3fd9dc7d667d37...564e34cb9da16b13d7ee9eaf6ee3e7a57b7aad69,7,10,27,37,13,2014-12-01 22:30:58,2014-12-01 21:45:02
564e34cb9da16b13d7ee9eaf6ee3e7a57b7aad69...63357acda4cd7d1d77a238cc9fd39c6f9f8f9133,1,0,98,98,1,2014-12-01 22:30:58,2014-12-01 21:53:11
63357acda4cd7d1d77a238cc9fd39c6f9f8f9133...10f463fcf5c57b16b8d6f0d2e007efd46f4d2e70,15,177,50,227,39,2014-12-01 22:33:01,2014-11-20 19:59:16
10f463fcf5c57b16b8d6f0d2e007efd46f4d2e70...3967899bf5d0712e456d0549e1ad17acf8d0bebe,3,141,139,280,45,2014-12-01 22:33:01,2014-12-01 21:05:14
3967899bf5d0712e456d0549e1ad17acf8d0bebe...566ac19af63ceb95bfdf7743502fe45005d5f2b7,1,4,0,4,1,2014-12-01 22:33:01,2014-12-01 21:55:46
566ac19af63ceb95bfdf7743502fe45005d5f2b7...2fe551d8710595e973a34e40abb21ef9693193fc,4,21,15,36,16,2014-12-01 22:33:02,2014-12-01 21:56:40
2fe551d8710595e973a34e40abb21ef9693193fc...b743d7158f7642f4da6b7eac8320374b3b88dc2e,1,2,8,10,5,2014-12-01 22:33:02,2014-12-01 22:10:46
b743d7158f7642f4da6b7eac8320374b3b88dc2e...7b3fcee16ec18fd9c734526347e4919c8b80b0db,4,13,0,13,9,2014-12-01 22:41:33,2014-12-01 15:53:19
7b3fcee16ec18fd9c734526347e4919c8b80b0db...23fad5ee3e26b8d107401e4bfad86f9ada7b7d1f,16,253,38,291,41,2014-12-01 22:41:33,2014-12-01 17:39:21
23fad5ee3e26b8d107401e4bfad86f9ada7b7d1f...7e4de6184d876b7963946708d6e83ee57335211f,10,83,13,96,28,2014-12-01 22:41:33,2014-12-01 20:19:01
7e4de6184d876b7963946708d6e83ee57335211f...e7baa714a95e0cb43ad54f4497eec512e774fbec,9,21,25,46,18,2014-12-01 22:46:58,2014-11-26 19:35:22
e7baa714a95e0cb43ad54f4497eec512e774fbec...a4bb064660fe9d6db93085f7be9564f90afa9b0c,3,270,185,455,61,2014-12-02 01:11:17,2014-11-13 16:22:24
a4bb064660fe9d6db93085f7be9564f90afa9b0c...9872c67dafc6d1d5be312b97a74ee0d0d6640c3e,1,1,1,2,1,2014-12-02 13:25:28,2014-12-02 13:25:23
9872c67dafc6d1d5be312b97a74ee0d0d6640c3e...11b2d7b6051766674c2d66c86d9f23d0befdee09,7,444,1,445,7,2014-12-02 15:35:23,2014-12-02 00:45:51
11b2d7b6051766674c2d66c86d9f23d0befdee09...efb33fd38bd0e8733d14f657e7fa634880ec8f1d,13,455,96,551,74,2014-12-02 15:44:56,2014-11-24 22:28:10
efb33fd38bd0e8733d14f657e7fa634880ec8f1d...6c22ffb8d92dd795ff22e887b13797c36e86dc72,1,2,2,4,2,2014-12-02 15:53:12,2014-12-02 15:53:00
6c22ffb8d92dd795ff22e887b13797c36e86dc72...f51e0f461f903b1ecb014c7ad796374933e12c60,1,11,2,13,2,2014-12-02 16:42:28,2014-11-21 22:15:38
f51e0f461f903b1ecb014c7ad796374933e12c60...6aaca22c7726376e073d3ff93b071210443727bd,2,52,4,56,2,2014-12-02 18:00:35,2014-12-02 17:59:57
6aaca22c7726376e073d3ff93b071210443727bd...5c33c7c5b538bc01094127ba6e9c6531a79886d1,1,2,0,2,1,2014-12-02 18:46:47,2014-12-02 18:46:47
5c33c7c5b538bc01094127ba6e9c6531a79886d1...4923623142d9a014fc8ee3d6f72f4f974e20e728,1,14,3,17,6,2014-12-02 19:42:08,2014-12-02 15:39:42
4923623142d9a014fc8ee3d6f72f4f974e20e728...15a2b7ca39ce472e43d8d37c6127eb4c3958456c,10,17,21,38,18,2014-12-02 19:42:10,2014-12-02 18:47:07
15a2b7ca39ce472e43d8d37c6127eb4c3958456c...e2a08e2cd6fb0ebd226c22cae6ba73425613e477,34,1148,498,1646,371,2014-12-02 19:44:03,2014-12-02 14:02:22
e2a08e2cd6fb0ebd226c22cae6ba73425613e477...389b5b48218f5ee73e4164afb84ea5fa2ba7646e,4,202,8,210,10,2014-12-02 19:51:14,2014-11-25 00:11:39
389b5b48218f5ee73e4164afb84ea5fa2ba7646e...d698427a79eed6538b16733463f34e70bcea6a1d,10,21,17,38,18,2014-12-02 20:17:19,2014-12-02 20:17:19
d698427a79eed6538b16733463f34e70bcea6a1d...a6a420f7f68dea6ee86f8dfbf91cdf6e07916eb8,7,1,444,445,7,2014-12-02 20:42:26,2014-12-02 20:42:26
a6a420f7f68dea6ee86f8dfbf91cdf6e07916eb8...9db6b7d7ad6e585f9bc9b0779db10d53535b4b68,3,12,9,21,3,2014-12-02 21:12:51,2014-12-02 21:02:37
9db6b7d7ad6e585f9bc9b0779db10d53535b4b68...1e8657eaeef19a9a875093944e0075c58aa2a98a,1,40,40,80,27,2014-12-02 22:34:45,2014-12-02 22:33:24
1e8657eaeef19a9a875093944e0075c58aa2a98a...43e478efd441bde1f45a716c3da2d39e37566e55,4,28,30,58,18,2014-12-02 22:36:57,2014-12-02 22:35:07
43e478efd441bde1f45a716c3da2d39e37566e55...6cab2a29c7dcb56ce132c200321bd1424f977f55,3,321,82,403,54,2014-12-02 23:24:02,2014-12-02 19:11:17
6cab2a29c7dcb56ce132c200321bd1424f977f55...6c93bae163d0cbd4acf8e127c902844353b72c6b,6,9,55,64,11,2014-12-03 00:06:05,2014-12-02 00:14:28
6c93bae163d0cbd4acf8e127c902844353b72c6b...f423ad99311088658c7aabb1d94ee29137896b90,2,28,9,37,7,2014-12-03 14:36:10,2014-11-25 22:28:02
f423ad99311088658c7aabb1d94ee29137896b90...994021fc1284b71c9cd81ef074d74cf140013f8d,5,24,26,50,7,2014-12-03 14:37:51,2014-12-03 06:22:03
994021fc1284b71c9cd81ef074d74cf140013f8d...acbf47c498888ea3df5a203b47e8678f26f55ca6,2,1,46,47,7,2014-12-03 15:31:09,2014-12-03 15:31:09
acbf47c498888ea3df5a203b47e8678f26f55ca6...198fa91703d6f95bca81fca26c92e801b77a6607,1,13,14,27,2,2014-12-03 15:39:41,2014-12-03 00:20:59
198fa91703d6f95bca81fca26c92e801b77a6607...3742b75049abfdb29fe5e5fe37df0f0d7ecb2873,2,6,22,28,8,2014-12-03 15:40:12,2014-12-02 22:54:59
3742b75049abfdb29fe5e5fe37df0f0d7ecb2873...9a143e7fbaf3c031775a7f8d563d9badce5c97da,5,22,14,36,13,2014-12-03 15:59:05,2014-12-03 15:08:39
9a143e7fbaf3c031775a7f8d563d9badce5c97da...63ffe70aec1309ff679d6ba6c0272524e767ad69,4,153,13,166,15,2014-12-03 16:55:06,2014-11-25 17:49:35
63ffe70aec1309ff679d6ba6c0272524e767ad69...5ebf0f69ee53cde7c5d2a1289609ee1692705c97,6,28,0,28,8,2014-12-03 16:55:06,2014-11-26 00:30:02
5ebf0f69ee53cde7c5d2a1289609ee1692705c97...67ed2dc89414df8dcd951fae9964fc3c5b5d0b46,3,54,41,95,7,2014-12-03 16:55:06,2014-12-03 00:51:44
67ed2dc89414df8dcd951fae9964fc3c5b5d0b46...225aa52bd22a54d06cc090e7cd4b0fd4312213b2,2,68,0,68,4,2014-12-03 16:55:07,2014-12-02 20:31:58
225aa52bd22a54d06cc090e7cd4b0fd4312213b2...5598c216ca28234735999ca25b3f6f9a030f51e6,32,143,133,276,65,2014-12-03 17:58:24,2014-12-02 20:43:13
5598c216ca28234735999ca25b3f6f9a030f51e6...66fb08ef754d957fdb7b2326f1597f85b1c42347,3,7,5,12,5,2014-12-03 19:08:29,2014-12-02 20:31:07
66fb08ef754d957fdb7b2326f1597f85b1c42347...9268fd6df4027a79a19030f5f377eb88117a2025,1,24,20,44,12,2014-12-03 20:01:29,2014-12-03 19:27:24
9268fd6df4027a79a19030f5f377eb88117a2025...293c0ca515eb30cc8f4c74eb82c4e7b5f16d95c5,17,47,38,85,32,2014-12-03 20:24:39,2014-12-02 20:18:28
293c0ca515eb30cc8f4c74eb82c4e7b5f16d95c5...03c5bd928dfe1bda04ab56511746b5af3b6e3ee1,1,4,0,4,1,2014-12-03 21:18:44,2014-12-03 21:18:38
03c5bd928dfe1bda04ab56511746b5af3b6e3ee1...f2d61538efd324782ba32dbcd90d4b8506c06a38,13,55,55,110,21,2014-12-03 21:30:24,2014-12-03 21:09:32
f2d61538efd324782ba32dbcd90d4b8506c06a38...6751cc2c645cd1976ecc729af881a5bc3b672c0e,1,1,0,1,1,2014-12-03 22:00:28,2014-12-03 22:00:28
6751cc2c645cd1976ecc729af881a5bc3b672c0e...a4a0d47858e822028dab80f142e9b5f7b5be9520,1,2,1,3,1,2014-12-03 23:11:55,2014-12-03 18:18:49
a4a0d47858e822028dab80f142e9b5f7b5be9520...7f7c8fa39db6ca075ba51497aa3e4ddd1254ace4,5,44,44,88,39,2014-12-03 23:11:57,2014-12-03 18:26:32
7f7c8fa39db6ca075ba51497aa3e4ddd1254ace4...4b3cae88318ada78ccb6e195e8aa85b61069cbb8,2,8,8,16,5,2014-12-03 23:12:00,2014-12-03 18:54:39
4b3cae88318ada78ccb6e195e8aa85b61069cbb8...3b1d97d430a229bf57c46bc7bc4977801b5bb553,1,1,1,2,1,2014-12-03 23:12:03,2014-12-03 19:06:09
3b1d97d430a229bf57c46bc7bc4977801b5bb553...a07f232ff52244a70244afe0b0ba00f77fe044ae,12,264,354,618,68,2014-12-04 00:48:31,2014-12-03 15:17:12
a07f232ff52244a70244afe0b0ba00f77fe044ae...f77869e01a6ed235695a46fad441c0dff15202f6,7,7,7,14,7,2014-12-04 01:05:17,2014-12-04 01:05:17
f77869e01a6ed235695a46fad441c0dff15202f6...e66eecff9487add89506add70a6bb6a23735763f,7,7,7,14,7,2014-12-04 07:30:08,2014-12-04 07:30:08
e66eecff9487add89506add70a6bb6a23735763f...7a135d1c39374a3600ff6009ac8cfac816b4ff2b,2,0,20,20,6,2014-12-04 16:38:51,2014-12-04 16:38:51
7a135d1c39374a3600ff6009ac8cfac816b4ff2b...921f0ba4727b226e02e2c316b2108c6bc3bf79d3,2,26,88,114,8,2014-12-04 16:42:31,2014-12-04 14:12:44
921f0ba4727b226e02e2c316b2108c6bc3bf79d3...0cdee7c87ef4098bd1b7c483e8dd80257c53e515,1,5,1,6,1,2014-12-04 13:34:44,2014-12-03 17:24:35
0cdee7c87ef4098bd1b7c483e8dd80257c53e515...172b2ccc4023c2839bbc941ea5a9fcde618d53b9,1,0,2,2,2,2014-12-04 19:26:16,2014-12-04 19:18:37
172b2ccc4023c2839bbc941ea5a9fcde618d53b9...e1baf8419c0df083322e6f989b95770d8e0c0816,1,1,0,1,1,2014-12-04 19:39:15,2014-12-03 20:17:08
e1baf8419c0df083322e6f989b95770d8e0c0816...2058d2d261629e89aa30b3198e8287a20b336439,1,69,79,148,6,2014-12-04 20:48:46,2014-12-04 20:48:46
2058d2d261629e89aa30b3198e8287a20b336439...fb08da6fcb2387e69608cca53fb24c12e97b9a32,1,3,2,5,3,2014-12-04 21:22:22,2014-12-04 21:22:22
fb08da6fcb2387e69608cca53fb24c12e97b9a32...86267891206b54c35d8cd8cbe2608157feca2f3e,2,282,0,282,2,2014-12-04 16:24:37,2014-12-02 15:44:23
86267891206b54c35d8cd8cbe2608157feca2f3e...ceae537f11dd33b5cdf0ae1fbda618d8d8272795,1,1,1,2,1,2014-12-04 21:38:18,2014-12-04 21:15:49
ceae537f11dd33b5cdf0ae1fbda618d8d8272795...4062e8f9493d4a8f9c32aba70fb19217241850c9,1,5,4,9,2,2014-12-04 22:39:12,2014-12-04 22:38:27
4062e8f9493d4a8f9c32aba70fb19217241850c9...5080932a79ce0152535169ec3b42edde2951bdcd,14,541,591,1132,58,2014-12-04 22:41:11,2014-12-04 16:40:04
5080932a79ce0152535169ec3b42edde2951bdcd...367810995073e01ee58159deb1bb5b878882632f,13,385,468,853,42,2014-12-04 22:41:11,2014-12-03 01:10:01
367810995073e01ee58159deb1bb5b878882632f...f46025d68785e44c783abafd19411fc76c231fd9,13,123,82,205,78,2014-12-04 22:47:12,2014-11-17 16:50:42
f46025d68785e44c783abafd19411fc76c231fd9...1b830759eaefc56f5b9f93afa8016db07d950196,1,7,8,15,5,2014-12-05 00:21:40,2014-12-04 21:14:04
1b830759eaefc56f5b9f93afa8016db07d950196...b766e395167dc27ba4fb3f9c0e4af3b4ad1cdace,1,4,2,6,2,2014-12-05 00:21:40,2014-12-04 21:20:06
b766e395167dc27ba4fb3f9c0e4af3b4ad1cdace...169b372f87441b6b0757c3c24bbc18f4f2b30f81,1,1,1,2,1,2014-12-05 15:21:06,2014-12-02 23:53:32
169b372f87441b6b0757c3c24bbc18f4f2b30f81...5a0d148ffd2db70901eb0cdbeaf159b77bc1fc91,5,89,58,147,31,2014-12-05 15:21:07,2014-12-02 23:54:18
5a0d148ffd2db70901eb0cdbeaf159b77bc1fc91...2dc85453cee5fdc0312c44a2f0633be9f23e7ca0,10,14,20,34,17,2014-12-05 15:29:32,2014-12-04 21:27:31
2dc85453cee5fdc0312c44a2f0633be9f23e7ca0...19ad2749f3cba8c074f50b29400af897eb4df3ab,1,8,2,10,2,2014-12-05 16:26:51,2014-12-05 16:26:09
19ad2749f3cba8c074f50b29400af897eb4df3ab...dfbe7eb6f1c92e063f92c4588a334c708b2a8b63,6,339,47,386,27,2014-12-05 16:52:38,2014-12-03 22:42:38
dfbe7eb6f1c92e063f92c4588a334c708b2a8b63...f6255b4bc16c6b1f3eee1bcadddb62648b33818b,6,18,0,18,13,2014-12-05 18:28:24,2014-12-04 21:36:16
f6255b4bc16c6b1f3eee1bcadddb62648b33818b...09abd0fe8e9dcce0980fff598b16e676e08abde2,7,444,1,445,7,2014-12-05 19:06:06,2014-12-04 22:29:17
09abd0fe8e9dcce0980fff598b16e676e08abde2...efe02e71561d2ca9ebd4419734f235603c94a9da,8,123,71,194,28,2014-12-05 19:38:12,2014-11-26 21:30:15
efe02e71561d2ca9ebd4419734f235603c94a9da...383c185480fe8c1140e4a4c9671c642470ad429c,1,2,5,7,2,2014-12-05 20:04:50,2014-12-05 01:09:41
383c185480fe8c1140e4a4c9671c642470ad429c...ce90736c0199e50aab82901c50383981c6292408,1,49,51,100,24,2014-12-05 20:28:58,2014-12-05 18:17:57
ce90736c0199e50aab82901c50383981c6292408...6793360d470f8f71bd0218af9cd3a32ff11c4496,1,10,1,11,1,2014-12-05 20:28:58,2014-12-05 19:30:07
6793360d470f8f71bd0218af9cd3a32ff11c4496...3b3fe4973d16903f2817ce87f605b3bbe54d5a99,1,8,0,8,2,2014-12-05 20:28:58,2014-12-05 20:08:38
3b3fe4973d16903f2817ce87f605b3bbe54d5a99...ac13fc6ab3ea3a3800ac494596acf2eb40beec72,1,96,207,303,24,2014-12-05 21:02:52,2014-12-03 20:16:00
ac13fc6ab3ea3a3800ac494596acf2eb40beec72...db123c1f4f7f971d4410f735b78d0fd332984477,10,89,207,296,62,2014-12-05 21:02:53,2014-11-20 19:25:35
db123c1f4f7f971d4410f735b78d0fd332984477...36778ab33fbbbfc155ed607cb2039efc51400dad,2,145,1,146,2,2014-12-05 16:07:52,2014-12-03 17:56:46
36778ab33fbbbfc155ed607cb2039efc51400dad...c86ef5ad3af94413e7702bd8f294a7ee89c38f80,2,155,2,157,3,2014-12-05 16:07:52,2014-12-04 15:43:28
c86ef5ad3af94413e7702bd8f294a7ee89c38f80...0a3ff55d57b75f75515d44f73d2f8712e24101fc,3,1,17,18,7,2014-12-05 21:49:10,2014-11-20 20:40:54
0a3ff55d57b75f75515d44f73d2f8712e24101fc...b5d97eeeea4ef66731eb273bc484884452991acf,1,5,2,7,2,2014-12-05 22:18:21,2014-12-05 22:18:21
b5d97eeeea4ef66731eb273bc484884452991acf...ee6fa9cf4870f81de1a4005cce2be6a91ac551ac,1,14,7,21,7,2014-12-06 12:46:53,2014-12-06 12:46:53
ee6fa9cf4870f81de1a4005cce2be6a91ac551ac...a6788ec72a9dabb38bd92a8ab653e32034e9e02e,1,3,3,6,2,2014-12-06 18:03:46,2014-12-05 21:45:07
a6788ec72a9dabb38bd92a8ab653e32034e9e02e...9b71a6b87626c0966ef0c0e1ffdde35acab74b89,1,2,1,3,1,2014-12-08 15:21:15,2014-12-08 15:16:48
9b71a6b87626c0966ef0c0e1ffdde35acab74b89...909bb8ed24c3c2448fc10532f59c54fb42033190,7,250,150,400,37,2014-12-08 16:17:18,2014-11-25 21:58:34
909bb8ed24c3c2448fc10532f59c54fb42033190...d8dc1d99e730ae829f978f471c8da5f88ffc7f17,4,10,27,37,14,2014-12-08 16:35:38,2014-12-05 22:31:33
d8dc1d99e730ae829f978f471c8da5f88ffc7f17...4bc54acaa78773dcf2fea55d4690e37b6e84aa0a,22,388,58,446,40,2014-12-08 16:35:38,2014-12-04 23:24:21
4bc54acaa78773dcf2fea55d4690e37b6e84aa0a...816e8ad94d2c2e6b6b26bbd9de513d9f42404647,1,53,9,62,5,2014-12-08 16:35:38,2014-12-02 22:35:24
816e8ad94d2c2e6b6b26bbd9de513d9f42404647...e3c1cef4840192e33c38510bb188a23879b0425c,58,627,471,1098,338,2014-12-08 16:35:38,2014-12-01 20:08:35
e3c1cef4840192e33c38510bb188a23879b0425c...403626141dde63d673db50417d484746079d027b,1,1,1,2,1,2014-12-08 16:35:38,2014-12-02 16:19:12
403626141dde63d673db50417d484746079d027b...860f2856604b236d6048255a1bc308c9582cc7db,8,13,68,81,13,2014-12-08 16:35:38,2014-11-24 22:37:29
860f2856604b236d6048255a1bc308c9582cc7db...05200c44711b020ebb5a516c74e4c4d3f9555bc0,2,13,12,25,8,2014-12-08 16:35:38,2014-11-25 00:25:41
05200c44711b020ebb5a516c74e4c4d3f9555bc0...545b4f727d2b74f1a50034cf63f22911a2dd0962,3,71,18,89,9,2014-12-08 16:35:38,2014-11-25 16:46:32
545b4f727d2b74f1a50034cf63f22911a2dd0962...a9c88df25d39e97109b2054abf2fcbf17bd51ba9,3,11,60,71,9,2014-12-08 16:35:38,2014-12-08 16:01:21
a9c88df25d39e97109b2054abf2fcbf17bd51ba9...2d79068ff6c0a7059fc39e72db88fc6a4f674e33,1,91,57,148,43,2014-12-08 17:41:20,2014-12-01 23:08:13
2d79068ff6c0a7059fc39e72db88fc6a4f674e33...14f5a9d135f6618e323fe052569945241200b6c5,1,10,1,11,2,2014-12-08 19:08:46,2014-12-08 18:49:18
14f5a9d135f6618e323fe052569945241200b6c5...4c8eab7305bddbf544c6c9c62fe871486d012af3,2,134,17,151,19,2014-12-08 21:18:56,2014-12-05 21:21:20
4c8eab7305bddbf544c6c9c62fe871486d012af3...87468e812ea2669a462144391bd5aa6d9e782775,1,40,25,65,11,2014-12-08 21:21:23,2014-12-08 15:58:39
87468e812ea2669a462144391bd5aa6d9e782775...12cd5164e8bcade6b6a12098a9519724ff627ff1,3,68,17,85,6,2014-12-08 21:40:50,2014-12-05 21:24:54
12cd5164e8bcade6b6a12098a9519724ff627ff1...a6a13028bf89d6783fc4c451de7f7c5324affcbc,1,1,1,2,1,2014-12-08 21:40:50,2014-12-08 15:30:04
a6a13028bf89d6783fc4c451de7f7c5324affcbc...c902b92a9685d5be5490c701858378850ccb499f,14,245,214,459,106,2014-12-08 22:28:16,2014-12-01 16:43:03
c902b92a9685d5be5490c701858378850ccb499f...0e06610b0477fabc1c22f8219d567bf743c606b0,1,1,1,2,1,2014-12-08 22:42:43,2014-12-08 22:41:31
0e06610b0477fabc1c22f8219d567bf743c606b0...2b9f564ee6afd85735df398aea44dfea72062ddc,2,38,8,46,7,2014-12-08 23:17:36,2014-12-05 22:29:25
2b9f564ee6afd85735df398aea44dfea72062ddc...1091bdc3858b58f2a88355c59963f7117cfadc04,14,118,151,269,125,2014-12-08 23:48:32,2014-12-03 23:01:58
1091bdc3858b58f2a88355c59963f7117cfadc04...ad97a4e46f7f904cf8e71067df6261de0db01fc0,1,48,1,49,2,2014-12-09 00:30:10,2014-11-12 17:44:46
ad97a4e46f7f904cf8e71067df6261de0db01fc0...e5aca11f94b723606c62d5070bce386a14dc671e,2,63,0,63,3,2014-12-09 17:17:04,2014-12-03 19:25:57
e5aca11f94b723606c62d5070bce386a14dc671e...1be586d431da882e276cc8c05b43881cd706e88a,1,5,25,30,7,2014-12-09 18:36:27,2014-12-08 22:50:20
1be586d431da882e276cc8c05b43881cd706e88a...bc38b5af5637edc8a9aaa9708fcec106b4bc4325,1,2,2,4,1,2014-12-09 18:43:19,2014-12-09 18:20:31
bc38b5af5637edc8a9aaa9708fcec106b4bc4325...c26b358aede3e974da05d403cdbcd72d8eac3c60,4,0,179,179,6,2014-12-09 18:52:50,2014-12-09 16:37:13
c26b358aede3e974da05d403cdbcd72d8eac3c60...d9a8ba5b88c0814ce4723355cdcb863927c54762,1,3,5,8,2,2014-12-09 19:35:40,2014-12-09 19:21:52
d9a8ba5b88c0814ce4723355cdcb863927c54762...801f3737ec62993e78a671359f11a1b1b7947a3a,1,7,5,12,2,2014-12-09 19:45:10,2014-11-28 01:19:00
801f3737ec62993e78a671359f11a1b1b7947a3a...23fb35b7a52d0d50829a6bb9a47954374ab2b61f,2,59,0,59,3,2014-12-09 23:08:35,2014-12-09 22:06:58
23fb35b7a52d0d50829a6bb9a47954374ab2b61f...efe368fa7a6b4c1ca6077fdb2560a33dfdc82337,1,17,1,18,3,2014-12-09 23:17:09,2014-12-09 21:13:17
efe368fa7a6b4c1ca6077fdb2560a33dfdc82337...604fc8c629b4cd90a3fbd84e53eb4c892878a318,2,51,1,52,3,2014-12-09 23:17:10,2014-12-09 21:16:50
604fc8c629b4cd90a3fbd84e53eb4c892878a318...5b44e4b489ef6a8eca4e48d3124665f404cc2c92,1,20,2,22,3,2014-12-10 01:22:58,2014-12-09 20:37:09
5b44e4b489ef6a8eca4e48d3124665f404cc2c92...326d27c5fb249f9d372cb46fd8b97d725b31553a,3,8,5,13,8,2014-12-10 01:22:59,2014-12-09 18:16:54
326d27c5fb249f9d372cb46fd8b97d725b31553a...2f1f5af37b460c45e399ee734f4c24134b4ac352,4,161,105,266,53,2014-12-10 16:13:10,2014-12-03 18:14:22
2f1f5af37b460c45e399ee734f4c24134b4ac352...80423349cfa33e8501199f4b4bcdd3fa1fa71972,1,0,1,1,1,2014-12-10 18:16:54,2014-12-10 14:35:39
80423349cfa33e8501199f4b4bcdd3fa1fa71972...344df1a62e8efc748f7feded04ab2a20fdc3619f,3,11,10,21,5,2014-12-10 18:16:54,2014-12-10 14:36:29
344df1a62e8efc748f7feded04ab2a20fdc3619f...bf834456c3e5a02fbe6fed340563a3c5fa548e4c,6,164,73,237,45,2014-12-10 21:18:57,2014-12-10 20:23:12
bf834456c3e5a02fbe6fed340563a3c5fa548e4c...314f6a94d1c4993da47b00427ad2e9694653dc18,22,165,108,273,93,2014-12-10 21:34:53,2014-12-09 18:45:33
314f6a94d1c4993da47b00427ad2e9694653dc18...77f3100bc8753055224abb0c6439fc506eeb02de,17,66,81,147,47,2014-12-10 21:34:54,2014-12-10 19:04:04
77f3100bc8753055224abb0c6439fc506eeb02de...35077bc84d0b3b76578aae2c7173c9fe8c3be7ce,1,2,0,2,1,2014-12-10 21:39:09,2014-12-05 20:27:59
35077bc84d0b3b76578aae2c7173c9fe8c3be7ce...d3ad0ad3cc1bcba0523860eedbd508d4d055309e,1,122,0,122,5,2014-12-10 21:44:14,2014-12-09 15:25:50
d3ad0ad3cc1bcba0523860eedbd508d4d055309e...8e3fe7f38c3d1ae8e072839bd4e2aaf78e19783c,17,81,66,147,47,2014-12-10 21:47:48,2014-12-10 21:47:48
8e3fe7f38c3d1ae8e072839bd4e2aaf78e19783c...98a7e7f9709413ce06f49b48dee98f7080505947,15,103,105,208,60,2014-12-10 23:33:41,2014-12-09 16:21:50
98a7e7f9709413ce06f49b48dee98f7080505947...ae6df7a0b10cb40c2730b10f4057454ca6733b13,1,28,78,106,10,2014-12-11 03:13:01,2014-12-11 03:12:58
ae6df7a0b10cb40c2730b10f4057454ca6733b13...5a754fb109c8506005e2393df61b8f126e1ec6ee,2,93,1,94,4,2014-12-11 15:21:31,2014-12-10 14:36:17
5a754fb109c8506005e2393df61b8f126e1ec6ee...0603b59fd896c20d57901398e2294a3962bc4090,2,79,27,106,11,2014-12-11 15:41:20,2014-12-11 15:41:20
0603b59fd896c20d57901398e2294a3962bc4090...899e9fab6b3a3d05d4774f8194fe6c322a0e1f1c,1,6,10,16,5,2014-12-11 16:29:13,2014-12-09 18:55:59
899e9fab6b3a3d05d4774f8194fe6c322a0e1f1c...13bf96e45da07f3c460b13dc27092364b71fddc3,1,10,9,19,4,2014-12-11 17:04:12,2014-12-11 14:20:44
13bf96e45da07f3c460b13dc27092364b71fddc3...14b0649f071bad25a725f1d58a66880fb9ea03b8,6,519,21,540,33,2014-12-11 17:16:47,2014-12-09 00:04:48
14b0649f071bad25a725f1d58a66880fb9ea03b8...9181dd85c12b3313f51f44fa7b3806bf92b37bbc,2,42,3,45,3,2014-12-11 18:39:09,2014-12-09 18:32:53
9181dd85c12b3313f51f44fa7b3806bf92b37bbc...c5cfff053584d58fe75d6e0bfbcb33bb6f46dbd8,2,7,7,14,7,2014-12-11 21:35:56,2014-12-10 01:06:41
c5cfff053584d58fe75d6e0bfbcb33bb6f46dbd8...8b3024fad3b474d0caf9a8aecb0f464f8138b564,2,601,0,601,2,2014-12-11 21:48:44,2014-12-11 19:04:34
8b3024fad3b474d0caf9a8aecb0f464f8138b564...43c2e08b0bac16217233be7a00f3ebad46909300,2,79,69,148,26,2014-12-11 21:58:15,2014-12-11 19:37:44
43c2e08b0bac16217233be7a00f3ebad46909300...581f911b61dd3a41e5048d6129015dbfbaa158f6,2,17,11,28,5,2014-12-11 17:50:24,2014-12-11 12:17:17
581f911b61dd3a41e5048d6129015dbfbaa158f6...42ee03e14b90b8ca0b77f8618742e4a86d2eb51c,1,0,37,37,1,2014-12-11 17:50:44,2014-12-11 14:01:04
42ee03e14b90b8ca0b77f8618742e4a86d2eb51c...ab066385f193b51e5ae6835ecbffffd78956d02f,1,2,0,2,2,2014-12-11 17:50:44,2014-12-11 14:40:10
ab066385f193b51e5ae6835ecbffffd78956d02f...d9c7a3b43f418d1390dbab4ef2b30503fce0bdba,1,7,0,7,2,2014-12-11 23:06:51,2014-12-10 19:04:04
d9c7a3b43f418d1390dbab4ef2b30503fce0bdba...0279923636be460e3027152d83ed1c790cd536fc,13,21,29,50,21,2014-12-11 23:06:52,2014-12-11 22:08:32
0279923636be460e3027152d83ed1c790cd536fc...a6ac4e68c240e99ada7dddb333bb2b5e5220c49c,4,43,18,61,8,2014-12-11 23:29:47,2014-12-11 19:35:13
a6ac4e68c240e99ada7dddb333bb2b5e5220c49c...f2f48b749ded0c5585c798c302f6162f19336670,1,21,18,39,5,2014-12-11 23:36:57,2014-12-11 23:36:57
f2f48b749ded0c5585c798c302f6162f19336670...ac80855c712ec88c207821bbc3262c575580d779,1,4,2,6,2,2014-12-12 12:24:03,2014-12-11 21:14:00
ac80855c712ec88c207821bbc3262c575580d779...1b88ce0b469d85cff0575a6b0a98daa31a3f44e0,1,9,2,11,1,2014-12-12 12:24:03,2014-12-11 21:16:26
1b88ce0b469d85cff0575a6b0a98daa31a3f44e0...f59a05c611d66a03c1fb8579b54569bfc2971374,2,31,1,32,5,2014-12-12 12:24:03,2014-12-05 16:15:41
f59a05c611d66a03c1fb8579b54569bfc2971374...5950976bb7c42acec51850614edcebe6ad8bb233,1,1,1,2,1,2014-12-12 12:33:58,2014-12-12 12:33:35
5950976bb7c42acec51850614edcebe6ad8bb233...ab7a8649faf5c21901c719bbc88840ba7382a5d0,18,104,119,223,70,2014-12-12 15:10:50,2014-12-12 15:10:50
ab7a8649faf5c21901c719bbc88840ba7382a5d0...dce15b7552cb68361bcc5e34a73deb78648c6067,2,0,16,16,3,2014-12-12 15:31:06,2014-12-12 12:34:40
dce15b7552cb68361bcc5e34a73deb78648c6067...892de37dddf29be7aff6dca3f068dfb3239808e3,1,1,0,1,1,2014-12-12 15:31:06,2014-12-12 14:11:11
892de37dddf29be7aff6dca3f068dfb3239808e3...6b6471ea34f384e747eeef83dfdfcaee1b332bd0,1,9,15,24,3,2014-12-12 15:51:12,2014-12-11 03:53:52
6b6471ea34f384e747eeef83dfdfcaee1b332bd0...d3877ceca348713dc4d4347249a3976ee466edd3,88,3656,2670,6326,674,2014-12-12 15:56:37,2014-12-12 15:56:37
d3877ceca348713dc4d4347249a3976ee466edd3...5120700460ef7a3240603a4307a0b1be2c358c3c,3,81,3,84,5,2014-12-12 16:55:26,2014-12-10 00:03:28
5120700460ef7a3240603a4307a0b1be2c358c3c...a3ec06066d1db2e593744089cf17d93e5225131e,2,7,5,12,7,2014-12-12 17:58:51,2014-12-12 16:39:33
a3ec06066d1db2e593744089cf17d93e5225131e...625a098b71e7217bad59ad483fa32d4abcc66436,1,1,1,2,1,2014-12-12 19:37:15,2014-12-12 19:37:15
625a098b71e7217bad59ad483fa32d4abcc66436...de3b0d465b342e3a5cef629b46f3cf00b742bfd9,1,1,1,2,1,2014-12-12 19:51:00,2014-12-12 19:34:11
de3b0d465b342e3a5cef629b46f3cf00b742bfd9...3f5b7737b18294c39aba78e84e45fb5e41bb706b,2,114,22,136,15,2014-12-12 20:24:57,2014-12-08 16:51:39
3f5b7737b18294c39aba78e84e45fb5e41bb706b...4ba02eb3dfd6fa3423ac812ce2f4902eb1193521,1,53,49,102,7,2014-12-12 15:29:42,2014-12-11 13:18:21
4ba02eb3dfd6fa3423ac812ce2f4902eb1193521...904562cd8d692fc483af6be29c6a8c1d23e0d884,3,9,4,13,6,2014-12-12 16:19:45,2014-12-12 12:58:00
904562cd8d692fc483af6be29c6a8c1d23e0d884...8d27279d6f9e1c55b6aef4b74b441a028aa6e79f,5,253,181,434,5,2014-12-12 22:05:20,2014-12-03 15:59:55
8d27279d6f9e1c55b6aef4b74b441a028aa6e79f...8fc0c842c03288c55a93db46241c5467ea17416e,1,2,2,4,2,2014-12-12 22:09:29,2014-12-11 22:50:23
8fc0c842c03288c55a93db46241c5467ea17416e...2a148f717998b77199c3dd3d7d4e4e47eb1141ef,4,36,6,42,12,2014-12-12 22:16:52,2014-12-11 23:06:06
2a148f717998b77199c3dd3d7d4e4e47eb1141ef...e067fff4e3f3079d070ec168f32c24db9a51a944,18,171,145,316,126,2014-12-12 23:05:34,2014-12-10 22:15:45
e067fff4e3f3079d070ec168f32c24db9a51a944...ab70613187b0f2c1488a4fe6750b2f51da278afb,1,261,176,437,64,2014-12-15 20:39:07,2014-12-11 16:01:41
ab70613187b0f2c1488a4fe6750b2f51da278afb...c052295f3eb8081db74be4f1e4ff48f02085a9f8,3,46,10,56,8,2014-12-15 22:20:39,2014-11-24 20:03:19
c052295f3eb8081db74be4f1e4ff48f02085a9f8...7d40e0f7ad1f0118998f0ec5a8cd37cef313678f,1,4,3,7,4,2014-12-15 23:48:13,2014-12-15 19:48:17
7d40e0f7ad1f0118998f0ec5a8cd37cef313678f...9eaafcaff45ac51a1f924e0562ad8e3f21318e34,4,11,11,22,10,2014-12-15 23:49:00,2014-12-11 02:20:02
9eaafcaff45ac51a1f924e0562ad8e3f21318e34...fd08ed58f4d3ffe284e1d28d9ebe44ab10ffbe6f,1,19,5,24,4,2014-12-16 14:54:59,2014-12-15 18:33:17
fd08ed58f4d3ffe284e1d28d9ebe44ab10ffbe6f...35d89db03ecb922e3b43a1b1f8f0aaab3794d87f,1,71,0,71,1,2014-12-16 16:22:00,2014-12-16 15:34:18
35d89db03ecb922e3b43a1b1f8f0aaab3794d87f...eae8db960e24e99bad026017a108df1b0e78ce04,1,14,12,26,9,2014-12-16 17:14:13,2014-12-10 23:16:54
eae8db960e24e99bad026017a108df1b0e78ce04...c4b9bb5e132b946c3b8a61ef165f6e90e1b84cd9,2,20,0,20,3,2014-12-16 17:14:13,2014-12-10 23:26:55
c4b9bb5e132b946c3b8a61ef165f6e90e1b84cd9...59fe5a2aa698d9b952196eca7e2cbf21545bbb67,1,2,2,4,2,2014-12-16 17:14:13,2014-12-15 14:02:50
59fe5a2aa698d9b952196eca7e2cbf21545bbb67...4c35dddf0fa0aca41436c100a0d7dadb495c2174,1,0,2,2,2,2014-12-16 17:14:13,2014-12-15 14:41:58
4c35dddf0fa0aca41436c100a0d7dadb495c2174...50745fafe0084ae35f68b69aff62e3ef5895fc30,3,28,1,29,6,2014-12-16 17:14:13,2014-12-15 14:42:38
50745fafe0084ae35f68b69aff62e3ef5895fc30...d061b19c0bfc48a5a7e16d328919945f952c3e9f,2,22,32,54,8,2014-12-16 17:14:13,2014-12-16 16:49:30
d061b19c0bfc48a5a7e16d328919945f952c3e9f...c084a108e440222f458880e816e3cd1091fccf1d,4,14,8,22,6,2014-12-16 17:14:13,2014-12-16 17:13:50
c084a108e440222f458880e816e3cd1091fccf1d...98a27c300434ce21c5a0c29d7bd3304964cf0063,1,4,0,4,1,2014-12-16 17:25:30,2014-12-16 16:32:58
98a27c300434ce21c5a0c29d7bd3304964cf0063...bc64649a70fe366c46ffab601fc378dbc4286e1c,16,19,19,38,19,2014-12-16 17:26:05,2014-12-08 20:57:58
bc64649a70fe366c46ffab601fc378dbc4286e1c...7917b37c07d67dfb0e4bc8336942526962dceef3,1,1,1,2,1,2014-12-16 18:30:57,2014-12-16 18:30:36
7917b37c07d67dfb0e4bc8336942526962dceef3...0aede468dc2ea475aa83bddd8be1e56a19ca6a3a,14,136,134,270,47,2014-12-16 19:31:58,2014-12-16 19:23:48
0aede468dc2ea475aa83bddd8be1e56a19ca6a3a...de16932890952898881673fdd76c5f45d6dc49e1,6,42,15,57,14,2014-12-16 19:36:30,2014-12-15 16:27:03
de16932890952898881673fdd76c5f45d6dc49e1...f984b532331e46298d52d4c786cb359fa208f3d9,3,128,25,153,13,2014-12-16 20:12:57,2014-12-16 20:12:57
f984b532331e46298d52d4c786cb359fa208f3d9...6478e5ced5b924bf1306807ca087f0cbb84fe01b,1,1,1,2,1,2014-12-17 14:06:58,2014-12-16 22:21:02
6478e5ced5b924bf1306807ca087f0cbb84fe01b...3077abf30145174c4cab2779de7a621c2dd42062,1,1,1,2,1,2014-12-17 14:09:32,2014-12-16 21:30:35
3077abf30145174c4cab2779de7a621c2dd42062...09a1b0ca18b5340f5383d541abe96beb186a515a,76,931,784,1715,441,2014-12-17 15:30:34,2014-12-17 15:30:34
09a1b0ca18b5340f5383d541abe96beb186a515a...6e655edcca786e7edc0c4b1c05832d50dcd3f760,2,6,9,15,6,2014-12-17 15:40:53,2014-12-16 16:33:43
6e655edcca786e7edc0c4b1c05832d50dcd3f760...26d1d8d654693540f690a70077e0f0141e1e4cce,4,103,57,160,36,2014-12-17 15:40:55,2014-12-11 19:58:33
26d1d8d654693540f690a70077e0f0141e1e4cce...f8331e15dfefff9bd4cfd23f197dcb535d0a2ea3,1,2,5,7,2,2014-12-17 15:51:23,2014-12-16 21:19:29
f8331e15dfefff9bd4cfd23f197dcb535d0a2ea3...0c0fd893733ee8b60aed993e1ddbabac468bc89f,1,14,4,18,2,2014-12-17 16:25:24,2014-12-17 16:25:12
0c0fd893733ee8b60aed993e1ddbabac468bc89f...1045c5a2c204632a453dc68e1abb870a31fdc25b,2,21,6,27,6,2014-12-17 16:24:57,2014-12-16 19:48:44
1045c5a2c204632a453dc68e1abb870a31fdc25b...f312681a62f15196d0638da50350dd6a9c693e36,3,19,42,61,8,2014-12-17 16:24:57,2014-12-17 16:10:51
f312681a62f15196d0638da50350dd6a9c693e36...c5ebc6be8e3a865655acbc5ecd1cb3b96fdf44ff,12,197,225,422,69,2014-12-17 16:27:15,2014-12-15 20:38:44
c5ebc6be8e3a865655acbc5ecd1cb3b96fdf44ff...4f329663c1908d90a73c69e8223520e5aecc8608,2,22,1,23,15,2014-12-17 13:34:13,2014-12-16 13:29:51
4f329663c1908d90a73c69e8223520e5aecc8608...c2bfcc3870ec2ff3b3dc6c7ee92ca8fafcd76fbb,1,1,0,1,1,2014-12-17 18:48:31,2014-12-17 15:39:54
c2bfcc3870ec2ff3b3dc6c7ee92ca8fafcd76fbb...9f6751d70c51cacc54a422bb6829c36738600f96,1,1,1,2,1,2014-12-17 19:21:05,2014-12-17 18:47:15
9f6751d70c51cacc54a422bb6829c36738600f96...77807b67089dfd7c1657051f1e674417ae8f3766,1,1,0,1,1,2014-12-17 19:21:05,2014-12-17 19:20:52
77807b67089dfd7c1657051f1e674417ae8f3766...31b4966485670b8351aed45227edf2ffacfa8444,1,12,1,13,1,2014-12-17 21:30:36,2014-12-17 17:37:25
31b4966485670b8351aed45227edf2ffacfa8444...d9c075230dd40567c2bf66180e200c47f15a35e7,3,93,18,111,28,2014-12-17 22:17:15,2014-12-12 22:37:04
d9c075230dd40567c2bf66180e200c47f15a35e7...f46ff140de92e43c34bace43be971fd903ac11d9,1,1,0,1,1,2014-12-17 22:51:16,2014-12-17 19:15:17
f46ff140de92e43c34bace43be971fd903ac11d9...8d90ce21ffb7fac21fd9f287ce3d66a4c6b576b8,12,225,197,422,70,2014-12-17 23:10:39,2014-12-17 23:10:39
8d90ce21ffb7fac21fd9f287ce3d66a4c6b576b8...d9a10c7f8bfd3f28b74bb1208188d1f1fb280c5f,10,244,61,305,44,2014-12-17 23:22:24,2014-12-15 22:09:03
d9a10c7f8bfd3f28b74bb1208188d1f1fb280c5f...a77d104ecf7ed76ba93b54bf167fae8bdc3ad6a2,1,1,1,2,2,2014-12-17 18:19:00,2014-12-17 14:04:42
a77d104ecf7ed76ba93b54bf167fae8bdc3ad6a2...46589450c11ce5cc8cfef2eaf47342d53b271a35,1,10,2,12,2,2014-12-18 02:11:19,2014-12-18 00:06:11
46589450c11ce5cc8cfef2eaf47342d53b271a35...ccb67f50ab49372b1ebe8dc027a47808ededf116,4,49,45,94,22,2014-12-18 02:24:46,2014-12-18 02:18:05
ccb67f50ab49372b1ebe8dc027a47808ededf116...1f5fd1a3a46f2895eac1707f4180f71878d7ca1b,1,18,13,31,2,2014-12-18 02:32:11,2014-12-18 02:32:11
1f5fd1a3a46f2895eac1707f4180f71878d7ca1b...bfaa98729f41d02a0aafe1efc44b2074e3d7ba14,7,7,7,14,7,2014-12-18 04:43:39,2014-12-18 04:43:39
bfaa98729f41d02a0aafe1efc44b2074e3d7ba14...723f3081a517ddfc3794c6ee4e8edd5946c86044,2,15,8,23,2,2014-12-18 15:10:34,2014-12-18 15:03:13
723f3081a517ddfc3794c6ee4e8edd5946c86044...2d679247f17dab05a492c8b6d2c250dab18e54f2,1,5,3,8,1,2014-12-18 15:37:31,2014-12-18 15:37:31
2d679247f17dab05a492c8b6d2c250dab18e54f2...e564f392667046506578582e9383f3f2a30c4db8,7,7,7,14,7,2014-12-18 18:36:09,2014-12-18 18:36:09
e564f392667046506578582e9383f3f2a30c4db8...50dc6dbe394c42d03659aa3410954f1e3ff46740,2,212,118,330,67,2014-12-18 19:04:09,2014-12-15 21:22:13
50dc6dbe394c42d03659aa3410954f1e3ff46740...26b6aa8dab1d265ad2c20f952ec862858a1fc9fb,4,62,0,62,4,2014-12-18 19:43:25,2014-12-17 17:50:17
26b6aa8dab1d265ad2c20f952ec862858a1fc9fb...cf0c561330c073bebf63f5246e815ec44f7180db,4,102,70,172,27,2014-12-18 20:03:48,2014-12-17 20:46:26
cf0c561330c073bebf63f5246e815ec44f7180db...eaad2ce5b976995b745907030410218191f82bde,1,2,2,4,2,2014-12-18 23:03:05,2014-12-18 23:02:53
eaad2ce5b976995b745907030410218191f82bde...00578e45d13fe73ff51c4ff482d53ce465552752,2,13,15,28,9,2014-12-18 23:03:06,2014-12-18 17:25:27
00578e45d13fe73ff51c4ff482d53ce465552752...e7b514171c2bfbd6029e9cfc5daf3ac2a699e293,1,2,0,2,2,2014-12-19 16:29:02,2014-12-18 12:11:40
e7b514171c2bfbd6029e9cfc5daf3ac2a699e293...42d0931156739f6543673a0a95accc982481b602,1,1,0,1,1,2014-12-19 17:06:38,2014-12-19 12:09:34
42d0931156739f6543673a0a95accc982481b602...53dbff5aa4407ada6b6f2416f6702be02ad26037,2,14,11,25,6,2014-12-19 17:06:45,2014-12-19 11:50:45
53dbff5aa4407ada6b6f2416f6702be02ad26037...434a0837fa81a501c0e1426506d0dcaba0be43c0,8,147,105,252,48,2014-12-19 18:59:29,2014-12-12 21:06:44
434a0837fa81a501c0e1426506d0dcaba0be43c0...d9579f3432925f1280e572bcaf80fd454f07a4fb,1,14,33,47,8,2014-12-19 19:57:08,2014-12-19 14:10:10
d9579f3432925f1280e572bcaf80fd454f07a4fb...ddd4ac7372ea4390b24b7bc3798d6c52351c8241,4,20,59,79,10,2014-12-19 20:10:17,2014-12-18 19:20:00
ddd4ac7372ea4390b24b7bc3798d6c52351c8241...35610538e5115e07a2eab0c45df52144b0045b3a,1,1,1,2,1,2014-12-19 20:36:32,2014-12-19 20:36:32
35610538e5115e07a2eab0c45df52144b0045b3a...a0c650616cd8abdd976c9ab5b114d3011e8e6428,1,1,1,2,1,2014-12-19 15:56:10,2014-12-19 15:50:00
a0c650616cd8abdd976c9ab5b114d3011e8e6428...0ae940b456ceafc3a0d473714c390f95d3a04823,1,1,1,2,1,2014-12-21 08:09:24,2014-12-21 08:09:24
0ae940b456ceafc3a0d473714c390f95d3a04823...1921c8c3f1cdaf0eebec76d328bc773018594bdf,1,4,0,4,2,2014-12-22 20:22:43,2014-12-22 18:01:12
1921c8c3f1cdaf0eebec76d328bc773018594bdf...bf0cdcee577aa5a05ba65506d8bd47f33eac30d2,1,8,0,8,1,2014-12-22 20:31:46,2014-12-19 18:22:41
bf0cdcee577aa5a05ba65506d8bd47f33eac30d2...bfdf9bce1f3091e8a6245d46a395ecdfc0bc0a1d,1,39,14,53,5,2014-12-22 20:35:11,2014-12-17 18:36:41
bfdf9bce1f3091e8a6245d46a395ecdfc0bc0a1d...0855e8c092879ba3a1e1b5bd812f72ecb21c6442,1,5,2,7,3,2014-12-22 20:52:40,2014-12-17 14:45:08
0855e8c092879ba3a1e1b5bd812f72ecb21c6442...eedfab2f783bcd1ee111cd36ece5ebfc0a5abf99,3,25,128,153,13,2014-12-22 20:54:35,2014-12-22 20:26:30
eedfab2f783bcd1ee111cd36ece5ebfc0a5abf99...92982e76c034f864f4499a0145ce7a75dc682812,1,7,18,25,2,2014-12-22 21:40:36,2014-12-22 20:38:24
92982e76c034f864f4499a0145ce7a75dc682812...e295dccc9f2251206b081ed1f2ad43c37751ae46,2,35,20,55,6,2014-12-22 22:43:36,2014-11-25 22:14:05
e295dccc9f2251206b081ed1f2ad43c37751ae46...fce93d8bb38fbc99b5bbd534572678d04706d5fd,1,4,1,5,2,2014-12-22 23:17:45,2014-12-22 20:23:45
fce93d8bb38fbc99b5bbd534572678d04706d5fd...0ba73576bbe465097c825ba946f561c267465a88,3,33,1,34,5,2014-12-22 23:26:34,2014-12-19 20:16:02
0ba73576bbe465097c825ba946f561c267465a88...67d7eadd2e0db8c66c9105903401646501aa0138,7,437,39,476,25,2014-12-23 14:13:14,2014-12-18 18:46:06
67d7eadd2e0db8c66c9105903401646501aa0138...eb9f2e8754c6f1ea9fe60a87ab2a6d9d72e214fc,1,1,1,2,1,2014-12-23 14:13:14,2014-12-18 19:19:44
eb9f2e8754c6f1ea9fe60a87ab2a6d9d72e214fc...8a88494748dce0aa09471f1b66e409cf6c2d7ff2,7,81,13,94,18,2014-12-23 14:13:14,2014-12-18 21:35:11
8a88494748dce0aa09471f1b66e409cf6c2d7ff2...8a0987a81b10c9b5559170bfc00a6292eefe3866,15,109,42,151,44,2014-12-23 14:13:15,2014-12-22 15:39:25
8a0987a81b10c9b5559170bfc00a6292eefe3866...e50c1c5e1e75f2da16f2b8c216b16afe93d83d8d,1,3,3,6,3,2014-12-23 14:13:15,2014-12-22 19:07:12
e50c1c5e1e75f2da16f2b8c216b16afe93d83d8d...55ae19200c7e17249420b4b34799e25b7d1ec92d,38,545,259,804,141,2014-12-23 17:03:28,2014-12-23 13:36:30
55ae19200c7e17249420b4b34799e25b7d1ec92d...c8775a7dc52299688fe58e29679de7ebf2375556,1,1,1,2,1,2014-12-23 17:04:22,2014-12-23 15:35:57
c8775a7dc52299688fe58e29679de7ebf2375556...4790d61d2151aac7f026a817a2ce17a2be890bc9,1,3,4,7,1,2014-12-23 17:23:49,2014-12-16 16:48:37
4790d61d2151aac7f026a817a2ce17a2be890bc9...c4691732d3a7cdcdff2a28c970f89c06d3c428b6,2,67,4,71,3,2014-12-23 17:28:20,2014-12-17 00:06:19
c4691732d3a7cdcdff2a28c970f89c06d3c428b6...94b1781bcdfb70156fb3b5f6978400007279cc0d,2,1185,0,1185,2,2014-12-23 17:31:57,2014-12-03 19:30:55
94b1781bcdfb70156fb3b5f6978400007279cc0d...0a06d53bdbf1b4ce882de8d49f25ed53a9b71352,1,3,1,4,1,2014-12-23 17:38:51,2014-12-23 16:08:30
0a06d53bdbf1b4ce882de8d49f25ed53a9b71352...0e9f78133f2bbff5b215a106eba64ec98cfecf98,15,37,22,59,19,2014-12-23 17:38:51,2014-12-23 16:45:58
0e9f78133f2bbff5b215a106eba64ec98cfecf98...6803608b4b7f0b0f783545da7bfba06ef82f24ee,1,2,2,4,1,2014-12-23 17:41:25,2014-12-23 17:40:35
6803608b4b7f0b0f783545da7bfba06ef82f24ee...fcd9920dc5f501bb2b9439b8d60722d5d3793307,1,1,1,2,1,2014-12-23 18:23:05,2014-12-23 18:23:02
fcd9920dc5f501bb2b9439b8d60722d5d3793307...3f7874101df5c3868f40584a6ac408df1248c4be,1,5,9,14,2,2014-12-23 18:34:28,2014-12-23 17:07:30
3f7874101df5c3868f40584a6ac408df1248c4be...b537713667249af6cf6c1fc289d5f1956ad78900,1,22,18,40,7,2014-12-23 18:51:16,2014-12-23 15:08:13
b537713667249af6cf6c1fc289d5f1956ad78900...b896f4ca68d45f43fb4c5509843c12a114843b07,2,3,3,6,3,2014-12-23 21:15:28,2014-12-18 20:22:27
b896f4ca68d45f43fb4c5509843c12a114843b07...784c8b1efa30da2cb1b445a153c0b6fd58703d7a,1,1,0,1,1,2014-12-23 21:40:12,2014-12-23 20:18:10
784c8b1efa30da2cb1b445a153c0b6fd58703d7a...6105f06402fe1e7578d41f3e4e583a1476ef2455,1,1,1,2,1,2014-12-23 22:34:46,2014-12-23 21:33:38
6105f06402fe1e7578d41f3e4e583a1476ef2455...7494d33c77932db60fb8cdcc1abb178e67d8c60a,10,48,40,88,36,2014-12-24 03:55:51,2014-12-23 17:06:46
7494d33c77932db60fb8cdcc1abb178e67d8c60a...1df9c58634def7beeee86fc4f4353a70940fcbbf,22,116,115,231,108,2014-12-24 03:56:43,2014-12-23 17:27:08
1df9c58634def7beeee86fc4f4353a70940fcbbf...4d14564d2f63e397cd392f1a7df27f9a2305dc23,4,76,20,96,20,2014-12-24 03:57:31,2014-12-23 21:08:36
4d14564d2f63e397cd392f1a7df27f9a2305dc23...49c92c4d0a629b8fbefd8dae44135d86415ea828,2,6,8,14,6,2014-12-24 03:59:32,2014-12-24 03:25:45
49c92c4d0a629b8fbefd8dae44135d86415ea828...d0152a54867f24761349a34cc7ef9e5f54984c84,4,78,34,112,16,2014-12-24 03:59:32,2014-12-23 23:17:28
d0152a54867f24761349a34cc7ef9e5f54984c84...24697d614ad09879c976325b6fd66b147b6bd2ff,2,79,16,95,9,2014-12-24 03:59:32,2014-12-23 23:17:55
24697d614ad09879c976325b6fd66b147b6bd2ff...1a3f9d1b0dae6c456f45aa094af972c9272787b7,7,7,7,14,7,2014-12-24 04:08:44,2014-12-24 03:16:01
1a3f9d1b0dae6c456f45aa094af972c9272787b7...3ad571742911f04b307f0071979425511c4f2570,1,4,0,4,2,2014-12-24 07:03:50,2014-12-24 07:02:12
3ad571742911f04b307f0071979425511c4f2570...8e8ecc54d3e63be0c2d19463031432f1308bcb7c,7,7,7,14,7,2014-12-24 16:45:26,2014-12-24 16:45:26
8e8ecc54d3e63be0c2d19463031432f1308bcb7c...be65a960b1a808ce244fcd4496dcfb20b53fcedd,1,3,4,7,4,2014-12-24 19:40:54,2014-12-24 13:36:41
be65a960b1a808ce244fcd4496dcfb20b53fcedd...67e4e21226149f91563f1f8c3c490b5306c60cf4,12,12,12,24,12,2014-12-24 21:48:21,2014-12-23 17:20:46
67e4e21226149f91563f1f8c3c490b5306c60cf4...4304aa3ecef45c2d03649151e5be706c6e67161e,3,180,1,181,7,2014-12-24 21:48:21,2014-12-23 03:19:31
4304aa3ecef45c2d03649151e5be706c6e67161e...9d5ec8f203268427c7e8c86dfc21b50455212c53,2,46,42,88,22,2014-12-24 21:58:23,2014-12-23 19:06:01
9d5ec8f203268427c7e8c86dfc21b50455212c53...b0014456ddefaccf02016c1a89c514e865a099d6,1,10,7,17,5,2014-12-24 21:58:23,2014-12-23 21:25:11
b0014456ddefaccf02016c1a89c514e865a099d6...6bc9cbce1147197d16bc049f3825091e465e389a,1,0,1,1,1,2014-12-29 14:15:50,2014-12-27 09:36:31
6bc9cbce1147197d16bc049f3825091e465e389a...d9ac3cfb459c5304f155effa0dc3b14f87868e7b,2,30,6,36,6,2014-12-29 18:28:26,2014-12-22 19:57:24
d9ac3cfb459c5304f155effa0dc3b14f87868e7b...8f83ff2335ea0e2dd0dc2fc79b6509c4f8f2d4fc,8,27,35,62,18,2014-12-29 18:52:06,2014-12-23 03:12:59
8f83ff2335ea0e2dd0dc2fc79b6509c4f8f2d4fc...acc0baca79b412794002ccdb6d37f9b2acf4f3c9,6,28,1,29,7,2014-12-29 20:56:10,2014-12-24 21:00:09
acc0baca79b412794002ccdb6d37f9b2acf4f3c9...cf2fc69b4ca25d8dc0b282db6556b8d50ffefc14,3,31,50,81,11,2014-12-29 20:56:34,2014-12-26 21:48:01
cf2fc69b4ca25d8dc0b282db6556b8d50ffefc14...3a06b24bc5b09d2a849b61a535a36214ed02bff1,3,3,30,33,3,2014-12-29 21:57:49,2014-12-29 16:44:51
3a06b24bc5b09d2a849b61a535a36214ed02bff1...4580fe1b3e01d8651fcec46522e506d82b0824c0,20,124,680,804,46,2014-12-30 16:52:20,2014-12-16 18:32:46
4580fe1b3e01d8651fcec46522e506d82b0824c0...0777616ff7ce85292e865c0340d92aadf7ba9867,3,41,2,43,5,2014-12-30 19:11:20,2014-12-12 20:01:07
0777616ff7ce85292e865c0340d92aadf7ba9867...7dc989123bc46ed26562b86699210aee17fc2009,28,41,4,45,30,2014-12-30 21:23:26,2014-12-30 21:23:14
7dc989123bc46ed26562b86699210aee17fc2009...20af9c79622fba6e53df9b2e6c7e00c6c85a79b5,1,1,0,1,1,2014-12-30 21:46:10,2014-12-30 21:45:42
20af9c79622fba6e53df9b2e6c7e00c6c85a79b5...55871360dad240de351600b3cab67f9fd07994bc,2,43,0,43,3,2014-12-30 22:14:42,2014-12-30 21:12:47
55871360dad240de351600b3cab67f9fd07994bc...2ec561b99947a121cc68172c0aecfef744ca3d2f,1,24,22,46,1,2014-12-31 04:45:45,2014-12-31 04:45:45
2ec561b99947a121cc68172c0aecfef744ca3d2f...2c3dea56d483ed0dca1413a69ef429f1429a7cad,4,23,4,27,12,2014-12-31 05:22:40,2014-12-31 05:15:45
2c3dea56d483ed0dca1413a69ef429f1429a7cad...c8c43855e1d3158385a68df12919d2ea97f45ecd,41,104,102,206,44,2014-12-31 15:11:12,2014-12-29 05:01:02
c8c43855e1d3158385a68df12919d2ea97f45ecd...24706753ff3682714abe6e3468b68379eed9a526,4,1548,0,1548,5,2014-12-31 18:43:05,2014-12-31 18:43:05
24706753ff3682714abe6e3468b68379eed9a526...23dc8ce626613cf9d92cb58dcf877407fd668d5b,7,155,183,338,52,2014-12-31 18:46:49,2014-12-31 18:46:49
23dc8ce626613cf9d92cb58dcf877407fd668d5b...d3e04458eb1d59e5e83be86cfaec288e7dda7139,1,2,2,4,2,2014-12-31 20:02:56,2014-12-31 20:02:56
d3e04458eb1d59e5e83be86cfaec288e7dda7139...1b522cf5745c40754f9d5aa4f4e35def4e8fee74,2,43,27,70,15,2015-01-02 04:24:19,2015-01-02 04:24:19
1b522cf5745c40754f9d5aa4f4e35def4e8fee74...2f6817253ebfef52f06c55f5a58a799997e014ad,1,8,6,14,1,2015-01-02 05:06:46,2015-01-02 05:06:46
2f6817253ebfef52f06c55f5a58a799997e014ad...0d93899c9031cfb776bad7e1b0f6ab9703fb2aea,10,401,433,834,111,2015-01-02 15:30:34,2014-12-22 22:58:33
0d93899c9031cfb776bad7e1b0f6ab9703fb2aea...e1c1f7d576e73b336bb7e418e42f529e5bb5f574,1,5,5,10,5,2015-01-02 19:02:12,2014-12-29 21:44:51
e1c1f7d576e73b336bb7e418e42f529e5bb5f574...f14589137087abb2787cdd2887b65ea857baaed4,1,5,1,6,1,2015-01-02 19:02:24,2014-12-23 22:08:50
f14589137087abb2787cdd2887b65ea857baaed4...7791afd96781d9ebac28969e582e64699e66c147,1,10,8,18,1,2015-01-02 19:21:07,2014-12-22 20:29:10
7791afd96781d9ebac28969e582e64699e66c147...f3557df19cde6d14b5af74621dc6d949825c695a,6,48,60,108,26,2015-01-02 19:21:07,2014-12-17 20:43:04
f3557df19cde6d14b5af74621dc6d949825c695a...33baf3ab68eff7679ec39a75cfcccf9e8d882ca5,1,14,12,26,7,2015-01-02 19:21:07,2014-12-22 18:51:51
33baf3ab68eff7679ec39a75cfcccf9e8d882ca5...8bedd077eed61a6f39a943a23df1db490974a359,6,49,43,92,12,2015-01-02 19:21:08,2014-12-22 21:20:58
8bedd077eed61a6f39a943a23df1db490974a359...430bafbd8643bd1d30513ad231850c6927e8553d,6,33,16,49,8,2015-01-02 19:21:08,2014-12-22 21:22:35
430bafbd8643bd1d30513ad231850c6927e8553d...8b37507dd51cdf058377a24ca0171e7fae6f2c6b,4,66,7,73,9,2015-01-02 19:21:08,2014-12-30 19:46:29
8b37507dd51cdf058377a24ca0171e7fae6f2c6b...8384c878b542352ba88ecade1e675b8412f2655f,64,203,212,415,188,2015-01-02 19:21:08,2014-12-22 22:32:27
8384c878b542352ba88ecade1e675b8412f2655f...bd22baf9adae1bda00e6b18c012c5db763aaee72,1,6,2,8,2,2015-01-02 19:21:09,2014-12-30 19:39:19
bd22baf9adae1bda00e6b18c012c5db763aaee72...68193a0bc55b4c08b20fdb8068fe6a27fda2edcf,28,394,125,519,126,2015-01-02 19:38:44,2015-01-02 18:33:42
68193a0bc55b4c08b20fdb8068fe6a27fda2edcf...132bf006d77d33fc4a13da108e2e977f871ae1c2,1,2,1,3,1,2015-01-02 20:05:25,2014-12-31 22:15:17
132bf006d77d33fc4a13da108e2e977f871ae1c2...3bc56205c727f7a85da6a3c0321abaa782318a38,1,112,133,245,27,2015-01-02 20:36:29,2015-01-02 18:23:34
3bc56205c727f7a85da6a3c0321abaa782318a38...53d7bce974d18fc4a92262de5ac6e604b79d8a04,1,10,6,16,6,2015-01-02 23:32:04,2015-01-02 23:32:04
53d7bce974d18fc4a92262de5ac6e604b79d8a04...20fa913b96326608f80cbd135f26c7c7e3487bb3,1,1,1,2,1,2015-01-05 09:56:59,2015-01-05 09:45:38
20fa913b96326608f80cbd135f26c7c7e3487bb3...f96a473723e8a478f7c3c1adf991ef795e9acebc,1,2,1,3,2,2015-01-05 16:09:52,2015-01-01 23:00:34
f96a473723e8a478f7c3c1adf991ef795e9acebc...89d03890991e173d0b773dfe98d7bfb944bc5205,1,9,8,17,5,2015-01-05 16:31:40,2015-01-04 02:32:22
89d03890991e173d0b773dfe98d7bfb944bc5205...3753b0810391b237b543fdc16705d7ba90add3ce,1,9,6,15,4,2015-01-05 16:31:40,2015-01-04 02:34:48
3753b0810391b237b543fdc16705d7ba90add3ce...d6aca8833cce3c7f23c6da5f170ee24b7ea5f24b,1,8,5,13,3,2015-01-05 16:31:40,2015-01-05 00:59:32
d6aca8833cce3c7f23c6da5f170ee24b7ea5f24b...57620924289aff41175c71d06ab27c0c7c8c7ead,2,0,14,14,3,2015-01-05 16:35:58,2015-01-05 14:31:33
57620924289aff41175c71d06ab27c0c7c8c7ead...780c6856b83168f17c2015fb8f8547e223eadf53,1,34,35,69,12,2015-01-05 18:42:57,2015-01-05 16:55:14
780c6856b83168f17c2015fb8f8547e223eadf53...b3d1c67e9b4cc4597f6575684db4d1b91ce160e7,1,3,6,9,2,2015-01-05 18:48:39,2015-01-05 03:28:27
b3d1c67e9b4cc4597f6575684db4d1b91ce160e7...e578d9ec131dd3332ae65beb9350b5ab18450194,1,3,6,9,2,2015-01-05 18:48:39,2015-01-05 14:50:16
e578d9ec131dd3332ae65beb9350b5ab18450194...f6abd4665a04ac54df8b0c92302d4a1b2f9579f1,1,35,0,35,1,2015-01-05 18:59:19,2015-01-05 16:56:27
f6abd4665a04ac54df8b0c92302d4a1b2f9579f1...a55a7b936ec2f4e935db4de4f4edb4696935a08d,7,168,179,347,67,2015-01-05 18:59:46,2015-01-02 22:31:40
a55a7b936ec2f4e935db4de4f4edb4696935a08d...12d82c741061da23a442086465322352f157d094,7,406,257,663,106,2015-01-05 18:59:47,2015-01-02 23:09:29
12d82c741061da23a442086465322352f157d094...5c3e3df015d8bdb8703accb4f24ee7657fa2ba50,1,3,0,3,1,2015-01-05 19:35:25,2015-01-05 18:53:42
5c3e3df015d8bdb8703accb4f24ee7657fa2ba50...e82c06607baf14a00751af681b808c3172bdeff0,1,2,2,4,1,2015-01-05 19:41:19,2015-01-05 15:06:59
e82c06607baf14a00751af681b808c3172bdeff0...f07504b53a284c7d4fa380c08b104c99a660a6bd,1,57,37,94,16,2015-01-05 19:53:51,2014-12-31 17:37:19
f07504b53a284c7d4fa380c08b104c99a660a6bd...9bfa0cc0f41dc8d425263cbf841f62b3e9d484da,1,78,78,156,18,2015-01-05 19:53:53,2015-01-02 21:03:55
9bfa0cc0f41dc8d425263cbf841f62b3e9d484da...d9ce31ea2237d4aa78656fed785e7e5b91c93843,5,668,0,668,5,2015-01-05 20:52:47,2014-12-29 21:47:59
d9ce31ea2237d4aa78656fed785e7e5b91c93843...2f881f7f2a00bb4b5f7af868033b89b1246e8bc8,15,62,12,74,22,2015-01-05 20:52:48,2014-12-30 16:45:26
2f881f7f2a00bb4b5f7af868033b89b1246e8bc8...d602ceb25e996962298ab45864aad4eb80262485,3,45,106,151,16,2015-01-05 20:52:48,2014-12-30 23:31:26
d602ceb25e996962298ab45864aad4eb80262485...f1e1714f0e7973ed92af202abd1bfc7ddad31506,1,2,2,4,2,2015-01-05 21:53:28,2015-01-05 21:46:05
f1e1714f0e7973ed92af202abd1bfc7ddad31506...01ebe59274ecc2f84f53a662663d043b15acc2e6,1,0,1,1,1,2015-01-05 23:26:58,2015-01-03 18:26:14
01ebe59274ecc2f84f53a662663d043b15acc2e6...e3d08996498463ba7827cff79783bc49f38f3469,4,3,1,4,4,2015-01-05 23:26:58,2015-01-03 18:32:18
e3d08996498463ba7827cff79783bc49f38f3469...eb8e7844901e3fe692c2879a6a3af1433eb87050,6,5,8,13,6,2015-01-05 23:26:58,2015-01-03 18:50:21
eb8e7844901e3fe692c2879a6a3af1433eb87050...60e074c4c123f559c126ea01877e7bdc33f1bbbd,3,10,7,17,5,2015-01-05 23:26:59,2015-01-03 18:57:25
60e074c4c123f559c126ea01877e7bdc33f1bbbd...939db8fd31790eff642abd446552294c66c5ff8a,5,78,38,116,5,2015-01-05 23:26:59,2015-01-03 19:11:49
939db8fd31790eff642abd446552294c66c5ff8a...e46896c23c4b411f4936fd41068d61a7922418a7,8,125,46,171,9,2015-01-05 23:26:59,2015-01-03 19:49:22
e46896c23c4b411f4936fd41068d61a7922418a7...ce14697bff987f49262f5da9f14e33f913ae9339,2,0,38,38,2,2015-01-05 23:26:59,2015-01-03 19:52:22
ce14697bff987f49262f5da9f14e33f913ae9339...d61eb5e43f1efe634be1a383ea451f8579dfb9fa,6,24,16,40,8,2015-01-05 23:26:59,2015-01-03 20:08:46
d61eb5e43f1efe634be1a383ea451f8579dfb9fa...21e1811a4e92c72b095d93e5cadb1d3428605d42,2,11,21,32,7,2015-01-05 23:26:59,2015-01-03 20:14:28
21e1811a4e92c72b095d93e5cadb1d3428605d42...7d0330733bf33779869dab27762dff30b0f7ad59,1,0,33,33,1,2015-01-05 23:27:00,2015-01-03 20:36:47
7d0330733bf33779869dab27762dff30b0f7ad59...d01e0bfbfb809ff4a7ad7d410840abeb5a392b77,1,0,4,4,1,2015-01-05 23:27:00,2015-01-03 20:42:53
d01e0bfbfb809ff4a7ad7d410840abeb5a392b77...7c134b66ea15ad39985800a43874413423653809,10,44,9,53,10,2015-01-05 23:27:00,2015-01-03 21:05:40
7c134b66ea15ad39985800a43874413423653809...8bff2b205a54d0616e4b3ec04e3c1c3435ff9d11,6,12,21,33,8,2015-01-05 23:27:00,2015-01-03 21:21:43
8bff2b205a54d0616e4b3ec04e3c1c3435ff9d11...32b4f794aafd9bd3fb8e5a8bdb858c3066d058ec,2,4,10,14,2,2015-01-05 23:27:00,2015-01-03 21:33:18
32b4f794aafd9bd3fb8e5a8bdb858c3066d058ec...89a50e9e2934b9b44462a3a81ac429596cb07fd8,12,0,53,53,12,2015-01-05 23:27:00,2015-01-03 21:44:17
89a50e9e2934b9b44462a3a81ac429596cb07fd8...3912341a289978c4b56d242b81aa9302d0f992f6,4,5,2,7,4,2015-01-05 23:27:00,2015-01-03 21:58:27
3912341a289978c4b56d242b81aa9302d0f992f6...a341230b5ebbff4d6c097d5f2bab91545ed97f93,2,5,4,9,2,2015-01-05 23:27:01,2015-01-03 22:12:51
a341230b5ebbff4d6c097d5f2bab91545ed97f93...997256fc799e815fbdb4c1b163afcb2aca6dc249,6,46,11,57,7,2015-01-05 23:27:01,2015-01-03 22:30:42
997256fc799e815fbdb4c1b163afcb2aca6dc249...fe1a1055a60eef0b37ca389a4c516f27a17d04d1,4,3,2,5,4,2015-01-05 23:27:01,2015-01-03 22:41:49
fe1a1055a60eef0b37ca389a4c516f27a17d04d1...c43d8e0aa47f868a8b3cd7367d2f21c717e2ca3c,149,451,8,459,292,2015-01-05 23:27:01,2015-01-03 22:54:10
c43d8e0aa47f868a8b3cd7367d2f21c717e2ca3c...8ef3942451da35353b7f164d190d7185799fa381,2,1,47,48,2,2015-01-05 23:27:01,2015-01-03 23:38:31
8ef3942451da35353b7f164d190d7185799fa381...22fab7c71ff006587b2561eae693c10424e27837,1,4,5,9,4,2015-01-05 23:27:01,2015-01-04 05:30:30
22fab7c71ff006587b2561eae693c10424e27837...b118aa80968dd9e585f8f34b4599bbabefdf6a99,2,3,2,5,3,2015-01-05 23:27:02,2015-01-04 05:31:41
b118aa80968dd9e585f8f34b4599bbabefdf6a99...99ce8f87a164d48fd899699bb678d456eaa1323a,63,76,17,93,64,2015-01-05 23:27:02,2015-01-04 06:12:26
99ce8f87a164d48fd899699bb678d456eaa1323a...e6216fcecb292789846125db28165029727555b9,19,20,6,26,19,2015-01-05 23:27:20,2015-01-04 15:32:42
e6216fcecb292789846125db28165029727555b9...0292094b0673177a24bcfe265b82a36dfb4da362,46,249,167,416,188,2015-01-05 23:52:20,2015-01-04 15:21:55
0292094b0673177a24bcfe265b82a36dfb4da362...0c4d932be42022627cd1e8a826fc69cd3edac23f,14,21,3,24,18,2015-01-05 23:52:20,2015-01-04 16:18:44
0c4d932be42022627cd1e8a826fc69cd3edac23f...e782819da4ce547272c653ec85984cacf5e60ff2,218,651,120,771,420,2015-01-05 23:52:20,2015-01-04 17:23:38
e782819da4ce547272c653ec85984cacf5e60ff2...738e17c6366b416b60dfcebaff99ee2a357c7fcf,45,58,4,62,46,2015-01-05 23:52:21,2015-01-04 17:45:38
738e17c6366b416b60dfcebaff99ee2a357c7fcf...3ec53687da4702d348f1b55eda5e01bd26f36c4b,98,247,44,291,181,2015-01-06 03:55:47,2015-01-04 18:28:20
3ec53687da4702d348f1b55eda5e01bd26f36c4b...f9bdad71e16409017df02058d2579cf659ef2e44,300,509,177,686,435,2015-01-06 13:58:01,2015-01-06 13:58:01
f9bdad71e16409017df02058d2579cf659ef2e44...9080534036974a91067cef0ace3aff60c65a123b,13,151,89,240,45,2015-01-06 18:10:17,2014-12-30 19:58:28
9080534036974a91067cef0ace3aff60c65a123b...9804789bbba304cb0649d7874ef0bb390f536b46,1,57,73,130,29,2015-01-06 18:46:05,2014-12-31 23:25:38
9804789bbba304cb0649d7874ef0bb390f536b46...3bc76a09671d08f0a0099e73c954d100e3cb2419,14,561,439,1000,172,2015-01-06 22:00:26,2014-12-05 20:09:30
3bc76a09671d08f0a0099e73c954d100e3cb2419...50c0c4491c856cf4217fd36057066d09281a96d8,7,141,93,234,64,2015-01-06 22:02:48,2015-01-06 16:29:05
50c0c4491c856cf4217fd36057066d09281a96d8...143765cfe3fa006c7109e409abd4a14eb6b36c2e,7,124,103,227,42,2015-01-06 22:02:49,2015-01-02 19:03:06
143765cfe3fa006c7109e409abd4a14eb6b36c2e...e35f2d62ccabee95075dd03d2eac85339e063e37,8,75,19,94,21,2015-01-06 22:27:06,2015-01-05 18:45:25
e35f2d62ccabee95075dd03d2eac85339e063e37...03cb0b023a4e833de44497ba076adf7c5190031c,2,7,8,15,4,2015-01-07 04:39:09,2015-01-06 16:17:51
03cb0b023a4e833de44497ba076adf7c5190031c...6fcf84b2716e5b883ee521113bf940546bfe1872,8,36,16,52,22,2015-01-07 04:39:09,2015-01-06 22:44:31
6fcf84b2716e5b883ee521113bf940546bfe1872...68da73df17d5a26bcc1151013ee5298b2c7df909,1,5,1,6,1,2015-01-07 13:53:35,2015-01-07 13:53:35
68da73df17d5a26bcc1151013ee5298b2c7df909...c11002f5f414b2b9f18b8abc69b4c69efc82f1fd,16,476,45,521,39,2015-01-07 14:07:20,2015-01-05 16:09:07
c11002f5f414b2b9f18b8abc69b4c69efc82f1fd...3a6620898c354d62829adc0009a5e65ef858594d,1,3,0,3,1,2015-01-07 15:04:45,2015-01-06 23:52:42
3a6620898c354d62829adc0009a5e65ef858594d...de54755e568481d1bdef37339d899403e3b04d86,21,170,209,379,70,2015-01-07 15:17:06,2014-12-24 17:40:47
de54755e568481d1bdef37339d899403e3b04d86...f58fa5f78a91ce36d8e31d6730ebfdaa6cc1d5ab,12,251,84,335,27,2015-01-07 16:56:33,2015-01-02 22:26:58
f58fa5f78a91ce36d8e31d6730ebfdaa6cc1d5ab...e136ca081381d7f0c52bd12f69552454771b497c,2,72,32,104,12,2015-01-07 16:56:33,2015-01-05 16:42:10
e136ca081381d7f0c52bd12f69552454771b497c...4075f40df4fcb86ce6c8c6ea9565a4699769e4ed,5,291,122,413,58,2015-01-07 16:56:33,2015-01-05 21:53:34
4075f40df4fcb86ce6c8c6ea9565a4699769e4ed...5d46a3a9f7b7f8b17ae1cbe73dd9f8d056350b81,4,276,137,413,58,2015-01-07 16:56:33,2015-01-06 19:47:30
5d46a3a9f7b7f8b17ae1cbe73dd9f8d056350b81...331911d3f31cf93c82bfaab3b6db0a77fdb80374,3,27,24,51,15,2015-01-07 16:56:33,2015-01-07 05:54:51
331911d3f31cf93c82bfaab3b6db0a77fdb80374...4f540d4ee48b426aab310d0d08260db6decf67a4,1,4,1,5,2,2015-01-07 18:49:35,2015-01-07 18:07:01
4f540d4ee48b426aab310d0d08260db6decf67a4...8197195ce0faee1df316b2b45649cbc61dcf3ec8,1,1,0,1,1,2015-01-07 18:49:35,2015-01-07 18:35:49
8197195ce0faee1df316b2b45649cbc61dcf3ec8...67c550459e416a9ec7eabe35e38c1fed9aeccb8f,8,618,623,1241,152,2015-01-07 20:04:36,2015-01-06 21:21:02
67c550459e416a9ec7eabe35e38c1fed9aeccb8f...47b931ab41098de23c967f0add30ef7b1a4bdda2,7,111,85,196,24,2015-01-07 20:04:37,2015-01-06 23:41:07
47b931ab41098de23c967f0add30ef7b1a4bdda2...2215b74a686290b97c90b27831f4d306b50f97da,1,27,52,79,7,2015-01-07 22:25:31,2015-01-07 22:12:31
2215b74a686290b97c90b27831f4d306b50f97da...e7922c24c8ac4ccfc65a005159197225fea1771e,4,110,85,195,30,2015-01-07 22:37:31,2015-01-02 19:38:28
e7922c24c8ac4ccfc65a005159197225fea1771e...1913b3148ce0a60b51c82f4f1fe5db7f6766a6c7,1,11,3,14,4,2015-01-07 23:26:44,2015-01-07 23:21:21
1913b3148ce0a60b51c82f4f1fe5db7f6766a6c7...174fe03770738005c08ed6ec61f1a95ce5542dbe,2,138,43,181,28,2015-01-08 03:04:47,2015-01-05 23:07:07
174fe03770738005c08ed6ec61f1a95ce5542dbe...6a7bf01c38aaea4bb4fe5121186a6030cff3ea3c,4,17,16,33,5,2015-01-08 12:33:12,2015-01-01 21:23:32
6a7bf01c38aaea4bb4fe5121186a6030cff3ea3c...2273aaeb351be36f0f3a6e398f4df2602c564449,1,5,8,13,1,2015-01-08 12:33:24,2015-01-01 21:26:39
2273aaeb351be36f0f3a6e398f4df2602c564449...10ca9ff64115ac020cb2301cc98c6d8ba9162dce,5,37,29,66,7,2015-01-08 12:33:30,2015-01-01 21:30:05
10ca9ff64115ac020cb2301cc98c6d8ba9162dce...f12f4f0e209d8a88b154e78ad17a00965cd465e4,17,109,69,178,37,2015-01-08 12:37:10,2014-12-31 22:24:09
f12f4f0e209d8a88b154e78ad17a00965cd465e4...0ab4bbc6ac0f299a7ebb5e0c156cdd127e52a349,1,7,1,8,3,2015-01-08 13:56:34,2015-01-08 13:56:34
0ab4bbc6ac0f299a7ebb5e0c156cdd127e52a349...a1cfc87572e26bcae1e337a608cc096b685662db,1,0,1,1,1,2015-01-08 14:47:58,2015-01-08 14:47:41
a1cfc87572e26bcae1e337a608cc096b685662db...463c8cdc37d0a0ed49066f9457e74f76b757118a,1,10,5,15,3,2015-01-08 18:48:24,2014-12-23 21:29:25
463c8cdc37d0a0ed49066f9457e74f76b757118a...8e68f8f8b2b42bcaea63e4aa70c4505c6711cbbe,1,0,1,1,1,2015-01-08 19:15:51,2015-01-08 19:15:51
8e68f8f8b2b42bcaea63e4aa70c4505c6711cbbe...0d3f90da143ade30ce876eeb104b104e20264e7f,1,6,1,7,2,2015-01-08 19:27:03,2015-01-08 15:31:43
0d3f90da143ade30ce876eeb104b104e20264e7f...a509c387938bb8aef9a0254fcb464e25e90cbd24,2,19,20,39,8,2015-01-08 19:55:13,2015-01-08 18:08:59
a509c387938bb8aef9a0254fcb464e25e90cbd24...c887b101db8d314d571f7c32ac79c5ca5dbec401,9,39,92,131,20,2015-01-08 19:55:28,2015-01-07 19:58:48
c887b101db8d314d571f7c32ac79c5ca5dbec401...f52a4ad8e5813f25bf60357978f8b08e16864bbb,1,8,8,16,2,2015-01-08 20:29:48,2015-01-08 19:34:55
f52a4ad8e5813f25bf60357978f8b08e16864bbb...2f816f16726fae730731a649971f256188acd2b0,12,190,62,252,26,2015-01-08 20:53:20,2014-12-02 15:40:19
2f816f16726fae730731a649971f256188acd2b0...b8f5d109f5aaaeff86fd13b42201ffa4d668921d,4,22,22,44,22,2015-01-08 21:21:20,2015-01-08 20:38:08
b8f5d109f5aaaeff86fd13b42201ffa4d668921d...faaf37eb10307322cd068c8b87e1aef3008ed4ee,1,7,5,12,5,2015-01-08 21:22:37,2015-01-08 21:22:25
faaf37eb10307322cd068c8b87e1aef3008ed4ee...49e92c75bd37f98f562603e5355fe117f35669f5,3,52,6,58,6,2015-01-09 04:57:38,2015-01-07 22:53:13
49e92c75bd37f98f562603e5355fe117f35669f5...3b07deccd9ab61e4f515677abf420aff01984a37,2,5,3,8,3,2015-01-09 14:09:18,2015-01-06 21:04:51
3b07deccd9ab61e4f515677abf420aff01984a37...243dac2abb695d4901623e19a37f9942b1088aa9,1,1,1,2,1,2015-01-09 14:10:10,2015-01-07 16:47:50
243dac2abb695d4901623e19a37f9942b1088aa9...a2046541eace4df755c671a9aaf91022088252f4,1,1,1,2,1,2015-01-09 14:11:38,2015-01-07 16:53:45
a2046541eace4df755c671a9aaf91022088252f4...2ca0b90c51864e5d71abd018242cdb3b64dda66b,8,55,29,84,26,2015-01-09 14:17:13,2015-01-08 14:20:52
2ca0b90c51864e5d71abd018242cdb3b64dda66b...5f3d618cc212c5d364568e56335e93e7e6ad4937,3,3,3,6,3,2015-01-09 14:17:13,2015-01-09 14:03:11
5f3d618cc212c5d364568e56335e93e7e6ad4937...4ddf32f72c81041c8de67c86bb0ca3b1a39b8e4d,45,1681,606,2287,154,2015-01-09 14:40:24,2015-01-07 22:24:23
4ddf32f72c81041c8de67c86bb0ca3b1a39b8e4d...ecd3babf05859b9fdd29ab09fd0222a265e014f4,68,3875,9,3884,76,2015-01-09 14:40:24,2015-01-07 22:30:40
ecd3babf05859b9fdd29ab09fd0222a265e014f4...666b3e19b10b3ac4c3de4c7a90a7070d33154240,2,58,3,61,4,2015-01-09 14:53:05,2015-01-06 04:10:40
666b3e19b10b3ac4c3de4c7a90a7070d33154240...bc274534b82eb2328d417dc5b256fb6d66287f74,4,260,1,261,6,2015-01-09 15:32:54,2015-01-08 15:38:22
bc274534b82eb2328d417dc5b256fb6d66287f74...aee446a97d7c3d7b6129348de6957d8e178864b2,3,136,3,139,7,2015-01-09 18:08:02,2014-12-29 01:34:43
aee446a97d7c3d7b6129348de6957d8e178864b2...354fcc2846cdef3666ed8aab7247193e2f665317,3,153,19,172,36,2015-01-09 19:17:31,2015-01-07 21:46:58
354fcc2846cdef3666ed8aab7247193e2f665317...95042383af1e5fa46bb79b7ed70e71eed4c8ae67,14,486,12,498,27,2015-01-09 19:17:31,2015-01-07 23:35:34
95042383af1e5fa46bb79b7ed70e71eed4c8ae67...94fafc43f893854a17d0a7c711e3c90cefce4660,3,0,63,63,3,2015-01-09 19:17:31,2015-01-07 23:12:12
94fafc43f893854a17d0a7c711e3c90cefce4660...c81a76de0b041f1df5bd309a03f13edaa7f5c599,3,22,0,22,4,2015-01-09 20:58:15,2015-01-07 22:34:52
c81a76de0b041f1df5bd309a03f13edaa7f5c599...75ca2609712b574be3b88cd40aec2ab0d8c59d0f,1,1,1,2,1,2015-01-09 21:34:10,2015-01-09 21:34:10
75ca2609712b574be3b88cd40aec2ab0d8c59d0f...8703aa6fe85e87dc12def2b82315034b82ad27d9,1,22,15,37,3,2015-01-09 22:24:20,2015-01-09 22:23:40
8703aa6fe85e87dc12def2b82315034b82ad27d9...d05d6c2c0057ef7d84f4b9ad707835a33b6f0ed9,2,5,5,10,5,2015-01-09 22:27:16,2015-01-09 19:40:31
d05d6c2c0057ef7d84f4b9ad707835a33b6f0ed9...dec50fa881896c0f4691df22d0017daab21e8de5,1,1,0,1,1,2015-01-09 23:20:36,2015-01-09 23:20:15
dec50fa881896c0f4691df22d0017daab21e8de5...81109be93d335a4a8a5bca64001c56c41640ba96,1,1,1,2,1,2015-01-09 23:31:55,2015-01-09 23:29:12
81109be93d335a4a8a5bca64001c56c41640ba96...f18c1a14b4aa78cce9ee6e7fa21448eb7b2da05f,12,59,42,101,34,2015-01-09 23:40:56,2014-12-18 19:50:28
f18c1a14b4aa78cce9ee6e7fa21448eb7b2da05f...225e5013566b23fec1f7068dc3efa72cc074c738,1,1,1,2,1,2015-01-10 15:59:36,2014-12-31 00:33:07
225e5013566b23fec1f7068dc3efa72cc074c738...8e2ca0cf7ea2899620ab74d3467092ab0b957078,1,1,2,3,2,2015-01-12 04:54:49,2015-01-12 04:54:49
8e2ca0cf7ea2899620ab74d3467092ab0b957078...f044f77243692cedebc1ee01ae8ae0a2470de6b0,3,3,2,5,4,2015-01-12 13:35:14,2015-01-11 17:22:01
f044f77243692cedebc1ee01ae8ae0a2470de6b0...d0802b350f70999f2d9e8d3b718f2cbed3163a31,4,91,42,133,7,2015-01-12 13:35:14,2015-01-12 13:35:02
d0802b350f70999f2d9e8d3b718f2cbed3163a31...c898c5ba48b780d6b5da8be3e1a5d3b9556a9694,1,2,1,3,1,2015-01-12 14:36:25,2015-01-12 14:36:25
c898c5ba48b780d6b5da8be3e1a5d3b9556a9694...9566e29b1dd85ada54d5a5924d8f3f38c517a74f,5,49,64,113,30,2015-01-12 15:36:22,2015-01-08 18:29:06
9566e29b1dd85ada54d5a5924d8f3f38c517a74f...77065ddd70015350e20a876f6174ebd45148cce6,16,156,195,351,47,2015-01-12 15:36:22,2015-01-08 22:07:57
77065ddd70015350e20a876f6174ebd45148cce6...4d73df94d51bc86a6a5b30dc3106cd7df6a3b7be,5,25,16,41,12,2015-01-12 16:25:08,2015-01-12 16:11:36
4d73df94d51bc86a6a5b30dc3106cd7df6a3b7be...aacb51ba4e1c96de41fc928e58a6341db82076c4,9,30,15,45,15,2015-01-12 16:25:48,2015-01-12 16:15:51
aacb51ba4e1c96de41fc928e58a6341db82076c4...8d60222b5fd085c7d264cbd8ab4bb0267d7822a5,1,7,4,11,3,2015-01-12 16:25:49,2015-01-12 16:17:09
8d60222b5fd085c7d264cbd8ab4bb0267d7822a5...cc1283f11b689850a66b935b9242a058d6d4ff2e,12,192,64,256,29,2015-01-12 16:25:49,2015-01-12 16:19:53
cc1283f11b689850a66b935b9242a058d6d4ff2e...c518ce7ff2255004e299c802625f2f7c65e048fd,24,238,237,475,214,2015-01-12 16:42:03,2015-01-07 20:01:58
c518ce7ff2255004e299c802625f2f7c65e048fd...76b2e3c90dc12229317722f60affaf4f11e9084e,80,117,116,233,107,2015-01-12 16:42:03,2015-01-07 20:48:00
76b2e3c90dc12229317722f60affaf4f11e9084e...11276bf2f804f35fcd2ecf8eee029aef2df26147,1,34,3,37,8,2015-01-12 16:44:59,2014-12-30 22:20:47
11276bf2f804f35fcd2ecf8eee029aef2df26147...078169dbca5b23adc03ef5b16a1327a0cfd55b91,1,21,0,21,1,2015-01-12 17:09:44,2015-01-02 18:36:19
078169dbca5b23adc03ef5b16a1327a0cfd55b91...fc2f13fc2e964f9079ffe7354840275db6b15983,1,17,0,17,1,2015-01-12 17:09:44,2015-01-08 19:16:37
fc2f13fc2e964f9079ffe7354840275db6b15983...ec121914ef8835861d046c1343f4768817c748a8,1,1,1,2,1,2015-01-12 17:12:59,2015-01-12 17:11:09
ec121914ef8835861d046c1343f4768817c748a8...ae7a1a999b9352948cb49dfaf80a4ad3c7eabd5d,1,8,0,8,1,2015-01-12 17:34:32,2015-01-12 17:34:07
ae7a1a999b9352948cb49dfaf80a4ad3c7eabd5d...2468153c690dbe8312a10829d3cd7565ed90c1e1,11,58,56,114,52,2015-01-12 17:40:45,2015-01-09 16:23:15
2468153c690dbe8312a10829d3cd7565ed90c1e1...9e1c94c0c9348f08bfa405896a28707afd62c899,14,41,38,79,36,2015-01-12 17:40:45,2015-01-12 17:32:13
9e1c94c0c9348f08bfa405896a28707afd62c899...95c60a44f94a2d8f090787a14dbdfbe96fdb97a3,6,142,89,231,20,2015-01-12 17:40:45,2015-01-12 17:35:28
95c60a44f94a2d8f090787a14dbdfbe96fdb97a3...e7c69c447f63564da9001ff59ce98d2cc82e87b9,4,57,19,76,11,2015-01-12 17:40:46,2015-01-12 17:39:33
e7c69c447f63564da9001ff59ce98d2cc82e87b9...4cc2ea575d1aff4f446796c1469f811583440866,1,1,1,2,1,2015-01-12 19:23:59,2015-01-12 19:23:59
4cc2ea575d1aff4f446796c1469f811583440866...1c1d4b059555164391c295a03595f0de48ea9e6c,1,1,1,2,1,2015-01-12 20:52:09,2015-01-12 20:51:56
1c1d4b059555164391c295a03595f0de48ea9e6c...0d54e7060d151a1585505ba09fddf78efff7ff10,1,1,1,2,1,2015-01-12 22:31:06,2015-01-12 22:15:05
0d54e7060d151a1585505ba09fddf78efff7ff10...7596d9d7cb2e0e53d4f4adb38f613dd35862eb0a,7,109,83,192,36,2015-01-12 22:44:54,2015-01-08 20:26:00
7596d9d7cb2e0e53d4f4adb38f613dd35862eb0a...249e4c59f4e6b98a6109225f953639de4743bf6c,14,529,55,584,50,2015-01-12 22:49:13,2015-01-08 18:02:32
249e4c59f4e6b98a6109225f953639de4743bf6c...ebe9daa834a1b1e59194a2c91d8a6962c62c7770,2,129,49,178,24,2015-01-12 23:49:05,2015-01-07 19:16:44
ebe9daa834a1b1e59194a2c91d8a6962c62c7770...f436133aa0460fd5fd6cd7f6b91b61208645f867,2,119,32,151,19,2015-01-12 23:49:05,2015-01-07 22:38:31
f436133aa0460fd5fd6cd7f6b91b61208645f867...2a84c1955e5f127c0befe9b8851ae7eeaba3f220,2,297,288,585,67,2015-01-12 23:49:05,2015-01-08 18:58:13
2a84c1955e5f127c0befe9b8851ae7eeaba3f220...743051d82afc04d9e236a6519c50f7b1526f991d,3,192,155,347,61,2015-01-12 23:49:05,2015-01-08 23:49:23
743051d82afc04d9e236a6519c50f7b1526f991d...a9cacdf8762ed197b1de1fd5d4ff2b47692e5a92,5,632,261,893,128,2015-01-12 23:49:05,2015-01-09 23:42:22
a9cacdf8762ed197b1de1fd5d4ff2b47692e5a92...60dc6bf36715570fbf0287d83c67e60b5f408baa,1,3,3,6,2,2015-01-13 15:44:51,2015-01-12 23:31:13
60dc6bf36715570fbf0287d83c67e60b5f408baa...69635e9248611036d5eeb415ec72314a69438604,1,0,4,4,1,2015-01-13 16:38:36,2015-01-12 21:44:27
69635e9248611036d5eeb415ec72314a69438604...72089efb044ad1851a8c3fb1912edcaee759ba00,3,30,7,37,5,2015-01-13 17:25:07,2015-01-13 00:45:20
72089efb044ad1851a8c3fb1912edcaee759ba00...17b2853a6741996d648a84aba1982c71134c96b8,2,31,2,33,3,2015-01-13 17:25:07,2015-01-12 22:20:44
17b2853a6741996d648a84aba1982c71134c96b8...1cfc884685ae4d35682fe7e2295d7635c3e07608,1,0,21,21,1,2015-01-13 17:52:24,2015-01-13 17:14:05
1cfc884685ae4d35682fe7e2295d7635c3e07608...c4ee0698c5c2055627ea149f44e4b4bef6fd5a12,3,7,1,8,3,2015-01-13 18:33:15,2015-01-13 18:33:15
c4ee0698c5c2055627ea149f44e4b4bef6fd5a12...48f0c43d138e98f5fddefe9f911fa3d89fb13c40,2,7,1,8,2,2015-01-13 19:08:50,2015-01-13 19:08:50
48f0c43d138e98f5fddefe9f911fa3d89fb13c40...08f3ea2da5c7a93ce5c7c926bd72f5b5da5686ca,1,13,4,17,7,2015-01-13 19:42:00,2015-01-13 16:45:40
08f3ea2da5c7a93ce5c7c926bd72f5b5da5686ca...639d69ecdf0febc91ba60118891adfedb0c0fc43,8,47,14,61,22,2015-01-13 19:42:01,2015-01-12 23:06:29
639d69ecdf0febc91ba60118891adfedb0c0fc43...fb20325176b25317525b0cd6118586a386048e91,1,1,1,2,1,2015-01-13 20:23:28,2015-01-13 20:16:23
fb20325176b25317525b0cd6118586a386048e91...2fe68fa71b2c4316c6d409cbb6d9f5af13a2342a,46,902,358,1260,257,2015-01-13 22:15:28,2015-01-13 22:15:28
2fe68fa71b2c4316c6d409cbb6d9f5af13a2342a...a6ca16f211fe01d2870593d9ab9bfaaa88097a14,3,148,7,155,7,2015-01-13 22:40:14,2015-01-13 20:29:13
a6ca16f211fe01d2870593d9ab9bfaaa88097a14...b9a65ff0c5cef00d73dfc36956a2a86aceaf969c,2,2,2,4,2,2015-01-13 23:38:32,2015-01-13 23:38:32
b9a65ff0c5cef00d73dfc36956a2a86aceaf969c...e9ea48278ef98f6c51a4722108026e2f31ca201e,1,29,18,47,2,2015-01-14 17:23:13,2015-01-14 17:23:13
e9ea48278ef98f6c51a4722108026e2f31ca201e...ec1736b050bff0dd5a4ef8037d951e58a8e21da3,2,4,0,4,2,2015-01-14 19:54:37,2015-01-14 16:34:43
ec1736b050bff0dd5a4ef8037d951e58a8e21da3...74b351de21c84438b12a83b28e155f5e69e3c1eb,4,63,14,77,10,2015-01-14 21:04:23,2015-01-14 21:04:23
74b351de21c84438b12a83b28e155f5e69e3c1eb...d29ab87db65a224b42f4a44d09bb330fb8dbf2f3,2,2,2,4,2,2015-01-15 05:28:23,2015-01-15 05:28:23
d29ab87db65a224b42f4a44d09bb330fb8dbf2f3...550f8d64315d9b1dc84ddfef44cc1735d680b60c,2,0,8,8,2,2015-01-15 10:41:10,2015-01-13 19:01:20
550f8d64315d9b1dc84ddfef44cc1735d680b60c...6e7546ef5f1450321550441e83c33f99d96722ea,2,5,14,19,3,2015-01-15 10:41:10,2015-01-12 23:15:02
6e7546ef5f1450321550441e83c33f99d96722ea...0aa409c0f7c1d65cf352e729e7b4787cfea20c23,9,16,18,34,16,2015-01-15 10:41:10,2015-01-12 23:13:52
0aa409c0f7c1d65cf352e729e7b4787cfea20c23...04237a169a4a8824fd6476617e237c5d69c156c7,4,94,12,106,18,2015-01-15 10:41:10,2015-01-12 22:24:21
04237a169a4a8824fd6476617e237c5d69c156c7...40f28cd947e8a5227c5a4f6961143ad1b041105f,4,20,7,27,9,2015-01-15 10:41:11,2015-01-13 22:29:43
40f28cd947e8a5227c5a4f6961143ad1b041105f...44cafa7dddde7510aa0a05efce807a2e294fdc6d,53,134,134,268,107,2015-01-15 12:04:25,2015-01-09 22:35:57
44cafa7dddde7510aa0a05efce807a2e294fdc6d...9f30e21c627e4c73ab0b44e45b7ce657b3e2619f,508,1644,38,1682,537,2015-01-15 12:04:26,2015-01-09 23:02:51
9f30e21c627e4c73ab0b44e45b7ce657b3e2619f...ca51fdc7bcf08b59bd61cde173fae42d6db81b1d,6,13,14,27,8,2015-01-15 12:04:27,2015-01-11 19:09:04
ca51fdc7bcf08b59bd61cde173fae42d6db81b1d...d03f92f7822e46bec820c3e0d3cd39f81fc6bf80,15,15,3,18,17,2015-01-15 12:04:27,2015-01-11 22:13:20
d03f92f7822e46bec820c3e0d3cd39f81fc6bf80...849e93f22089d2a2e0cdc5891037b116602cdd72,142,0,468,468,282,2015-01-15 12:04:27,2015-01-11 22:27:46
849e93f22089d2a2e0cdc5891037b116602cdd72...653169a891f612afef80ec149194f11197fbaa3b,5,16,19,35,17,2015-01-15 12:04:27,2015-01-11 22:42:31
653169a891f612afef80ec149194f11197fbaa3b...8a4251527bd8112c70c72738a9beacf7067e6b48,3,15,15,30,15,2015-01-15 13:05:02,2015-01-13 19:30:50
8a4251527bd8112c70c72738a9beacf7067e6b48...2238749896b7e3f7e371c75d47344ade4eb437e2,15,67,43,110,32,2015-01-15 13:05:02,2015-01-13 19:32:18
2238749896b7e3f7e371c75d47344ade4eb437e2...8820ec71f6a30caf20723524426650467bdf73e2,8,27,8,35,11,2015-01-15 13:26:01,2015-01-14 15:44:40
8820ec71f6a30caf20723524426650467bdf73e2...b19f1aa26afe5d8b8cbd62b067fc67a353eb48a9,2,3,0,3,2,2015-01-15 13:26:01,2015-01-14 20:55:45
b19f1aa26afe5d8b8cbd62b067fc67a353eb48a9...d28e5b9190ec12a6c70bee6d47eec605ea394862,1,1,0,1,1,2015-01-15 13:35:10,2015-01-13 18:03:32
d28e5b9190ec12a6c70bee6d47eec605ea394862...da73922df67d5e56b28e7f9287c6e6dc80f9ccde,1,0,7,7,1,2015-01-15 13:35:11,2015-01-13 18:03:38
da73922df67d5e56b28e7f9287c6e6dc80f9ccde...37732258bed872dc7c158965767d49e28899c471,1,2,2,4,2,2015-01-15 14:08:11,2015-01-15 13:57:37
37732258bed872dc7c158965767d49e28899c471...57806db0234321b9b88a74e013d952104e0c459a,2,50,11,61,8,2015-01-15 09:38:02,2015-01-09 15:10:05
57806db0234321b9b88a74e013d952104e0c459a...dbe1b1677a85721c6041903bc28411ca40682747,13,192,57,249,48,2015-01-15 14:51:01,2015-01-13 01:34:07
dbe1b1677a85721c6041903bc28411ca40682747...5e42956e1c816dad5ffd5334565ddc623eebe6d2,3,2,9,11,4,2015-01-15 14:53:04,2015-01-14 15:24:09
5e42956e1c816dad5ffd5334565ddc623eebe6d2...ea2209e6399ef285efc31700ac67388885d614b0,5,35,13,48,14,2015-01-15 14:54:09,2015-01-14 21:22:46
ea2209e6399ef285efc31700ac67388885d614b0...2e547413832ebd20bf25f1af4827d315867ee71c,5,92,12,104,12,2015-01-15 15:21:49,2015-01-14 21:26:21
2e547413832ebd20bf25f1af4827d315867ee71c...cdd91e98657c7f0ff792a6eeca7c8c80503d3b77,1,22,12,34,6,2015-01-15 15:28:30,2014-12-19 16:21:57
cdd91e98657c7f0ff792a6eeca7c8c80503d3b77...48453bc2cb2f8f15cd69305d7526917ecf213211,4,0,34,34,4,2015-01-15 15:29:00,2015-01-14 18:57:36
48453bc2cb2f8f15cd69305d7526917ecf213211...8efb43a8e1f5e9c025758a9322121223fd300892,2,18,0,18,14,2015-01-15 15:31:11,2015-01-13 17:20:35
8efb43a8e1f5e9c025758a9322121223fd300892...9c0417f6680b591cb89d0de55a8a42ab179698fd,7,14,18,32,9,2015-01-15 15:33:42,2015-01-12 14:32:50
9c0417f6680b591cb89d0de55a8a42ab179698fd...d3ed3fad57e35f2459660c05b37e3b0509e45e5c,1,1,1,2,1,2015-01-15 15:41:42,2015-01-14 20:21:09
d3ed3fad57e35f2459660c05b37e3b0509e45e5c...02a78a7f3d936813ea9e4195887b11d83448fcd6,12,242,247,489,89,2015-01-15 15:41:43,2015-01-13 19:58:50
02a78a7f3d936813ea9e4195887b11d83448fcd6...8d5d775b843d7566ca60a087ea17a512f67c3dc9,4,37,12,49,19,2015-01-15 15:41:44,2015-01-14 15:23:44
8d5d775b843d7566ca60a087ea17a512f67c3dc9...fb734fd9183e2929cc48d51988110c76d0d250a7,1,5,0,5,2,2015-01-15 15:41:45,2015-01-14 21:16:06
fb734fd9183e2929cc48d51988110c76d0d250a7...01b4c851c2392857bfb6ef1c47d704a0dbb3daa9,1,1,1,2,1,2015-01-15 15:58:29,2015-01-15 15:58:29
01b4c851c2392857bfb6ef1c47d704a0dbb3daa9...14424674ca204de09b8f9b37fc007cbde81d1bc9,3,37,25,62,6,2015-01-15 16:01:58,2015-01-09 21:51:06
14424674ca204de09b8f9b37fc007cbde81d1bc9...24daf1360e9bda29bf14eb209fa32d85e673a5a7,2,139,3,142,3,2015-01-15 16:01:58,2015-01-09 23:04:11
24daf1360e9bda29bf14eb209fa32d85e673a5a7...d26fcb64a7df86131e4951a31f07732d0d9b912f,4,8,1,9,5,2015-01-15 16:10:39,2015-01-11 01:57:38
d26fcb64a7df86131e4951a31f07732d0d9b912f...5ccc23d04e2662616c993d607a80666d021e1e5d,4,166,14,180,10,2015-01-15 16:10:39,2015-01-15 15:32:33
5ccc23d04e2662616c993d607a80666d021e1e5d...f0680bcb8478cf77682d3d202d123fc2be8cbef9,2,37,10,47,2,2015-01-15 17:03:15,2015-01-14 23:01:01
f0680bcb8478cf77682d3d202d123fc2be8cbef9...83f5fd0cbe18130238cf554e944c139a6f209134,1,46,19,65,6,2015-01-15 17:04:15,2015-01-14 15:34:17
83f5fd0cbe18130238cf554e944c139a6f209134...e5619ff7254d1baa0d43b32a7884d35443c94f4a,3,30,1,31,3,2015-01-15 17:18:53,2015-01-14 18:39:54
e5619ff7254d1baa0d43b32a7884d35443c94f4a...5c9eb2d631798f8ac913511ffccbd4a4bf8027a0,1,23,0,23,1,2015-01-15 17:18:53,2015-01-14 18:56:16
5c9eb2d631798f8ac913511ffccbd4a4bf8027a0...0f735109c47e9ead68c0290565cfc2a0a90ca3f5,1,4,2,6,1,2015-01-15 18:40:35,2015-01-15 16:15:40
0f735109c47e9ead68c0290565cfc2a0a90ca3f5...6437d63b9dbd5c80295f54a2b6b8af4638051991,6,319,53,372,20,2015-01-15 18:48:22,2015-01-13 14:58:45
6437d63b9dbd5c80295f54a2b6b8af4638051991...96dd1cbd431fad71104db62aaeb3704c04d9eeb3,2,139,0,139,2,2015-01-15 19:07:21,2014-12-31 00:33:39
96dd1cbd431fad71104db62aaeb3704c04d9eeb3...e9a439cdb3bfb9bc5cc9763199f3902114f01c82,1,15,12,27,7,2015-01-15 19:34:56,2015-01-15 19:12:19
e9a439cdb3bfb9bc5cc9763199f3902114f01c82...e5800d50ed4152a31630f25b5dffea106a93de07,1,14,0,14,1,2015-01-15 19:59:05,2015-01-15 19:26:48
e5800d50ed4152a31630f25b5dffea106a93de07...ef90d94b2d1ef4789b3e2ca3ce6b827986793160,2,148,41,189,10,2015-01-15 20:06:36,2014-12-19 20:37:22
ef90d94b2d1ef4789b3e2ca3ce6b827986793160...5603e3bf0fc5698356e69cb8dd83e567a9c037e4,1,1,1,2,1,2015-01-15 20:17:24,2015-01-15 20:17:20
5603e3bf0fc5698356e69cb8dd83e567a9c037e4...7a4cad9e256ece1cbd161472cbcebdac0f87da33,2,11,2,13,3,2015-01-15 21:26:27,2015-01-15 20:36:01
7a4cad9e256ece1cbd161472cbcebdac0f87da33...330ea5959f98cf44d10fca06a0f98a7542047889,1,1,1,2,1,2015-01-15 21:34:14,2015-01-15 21:19:20
330ea5959f98cf44d10fca06a0f98a7542047889...34cc34baff2345d6356b152e6aac4a8eed5b1d41,14,30,31,61,32,2015-01-15 21:35:34,2015-01-15 21:09:51
34cc34baff2345d6356b152e6aac4a8eed5b1d41...85fcc6daad585196ce69f1868f8283e0d92388be,6,15,23,38,14,2015-01-15 21:50:58,2015-01-15 20:06:22
85fcc6daad585196ce69f1868f8283e0d92388be...ab47afeb030b42097acede562760c3a2ca785086,1,7,2,9,4,2015-01-15 22:02:32,2015-01-15 21:55:36
ab47afeb030b42097acede562760c3a2ca785086...44c31ca911125b3b16e5279905a9516f4f05feee,1,16,9,25,4,2015-01-15 22:06:16,2015-01-12 23:30:08
44c31ca911125b3b16e5279905a9516f4f05feee...48deaff5bf31d21807c5dd7e7f5d313c7c96e8dc,19,131,76,207,44,2015-01-15 23:08:36,2015-01-13 23:03:26
48deaff5bf31d21807c5dd7e7f5d313c7c96e8dc...5efe0c6cae4a47c0ccafa8b17d7828283d77fbd6,2,27,8,35,6,2015-01-15 23:08:36,2015-01-14 17:39:07
5efe0c6cae4a47c0ccafa8b17d7828283d77fbd6...aa3247ba48f78f4423874f2a64f00b12bf0b27d6,5,118,99,217,8,2015-01-15 23:08:36,2015-01-14 18:43:32
aa3247ba48f78f4423874f2a64f00b12bf0b27d6...d1910c70e2e3eb6ce057a474dece00b737645631,5,147,110,257,19,2015-01-15 23:08:36,2015-01-14 19:38:01
d1910c70e2e3eb6ce057a474dece00b737645631...59fec904c441998dc6381b8e26bd4b90d8718a3e,12,67,54,121,20,2015-01-15 23:08:36,2015-01-14 21:45:39
59fec904c441998dc6381b8e26bd4b90d8718a3e...63bd5b5962dace5a96b3919538105e3ee2e18636,2,4,0,4,4,2015-01-15 23:08:36,2015-01-15 18:42:56
63bd5b5962dace5a96b3919538105e3ee2e18636...3c1347b07d678297aa1d136e780f461bf1e28c07,4,85,100,185,45,2015-01-15 23:08:36,2015-01-15 19:45:37
3c1347b07d678297aa1d136e780f461bf1e28c07...5be4f4f8308dc6504cd140a43b4402e7ef9380f2,1,1,1,2,1,2015-01-15 23:28:16,2015-01-15 23:21:04
5be4f4f8308dc6504cd140a43b4402e7ef9380f2...f01c8a0ee4ef882bcc0bc54fc2a23d26d5b2ea68,1,14,0,14,1,2015-01-15 23:51:21,2015-01-14 17:33:26
f01c8a0ee4ef882bcc0bc54fc2a23d26d5b2ea68...1e9f4211e895736973ed7ad1df296dd32f04052f,1,7,5,12,2,2015-01-16 01:29:07,2015-01-16 01:28:25
1e9f4211e895736973ed7ad1df296dd32f04052f...bcf19d4af076b5ce4f760b43cbb770c8a941e8c4,1,208,15,223,10,2015-01-16 01:29:07,2015-01-16 01:28:58
bcf19d4af076b5ce4f760b43cbb770c8a941e8c4...ec08d1f900830ecf629dc34a2381ed1c599d02db,6,249,277,526,94,2015-01-16 03:01:45,2015-01-15 16:58:35
ec08d1f900830ecf629dc34a2381ed1c599d02db...1ff892ae9306bec0a6dbbee1eac7edd3791f1eec,2,210,205,415,38,2015-01-16 03:01:46,2015-01-15 18:41:35
1ff892ae9306bec0a6dbbee1eac7edd3791f1eec...83056450de5203e8e14a16bf31856d82d84ebb87,1,23,17,40,8,2015-01-16 03:01:47,2015-01-15 15:59:29
83056450de5203e8e14a16bf31856d82d84ebb87...a01d6e0e4fadb79d5628e76558178c6e005f7a35,2,87,75,162,16,2015-01-16 03:01:49,2015-01-15 20:07:03
a01d6e0e4fadb79d5628e76558178c6e005f7a35...69fd73d3fe54eb695df25eac0e8e19a35f61dbf7,1,2,2,4,2,2015-01-16 15:15:17,2015-01-15 19:22:28
69fd73d3fe54eb695df25eac0e8e19a35f61dbf7...fadd8b58d8eb3500da77639d138789646f4cca96,3,128,25,153,13,2015-01-16 15:37:47,2015-01-14 19:26:41
fadd8b58d8eb3500da77639d138789646f4cca96...7adff440ba333fb0ffa554f2ed69d8f2906a00d2,3,216,13,229,11,2015-01-16 15:37:47,2015-01-14 19:40:40
7adff440ba333fb0ffa554f2ed69d8f2906a00d2...1aa110cc7fc83517a5a428feb7783cd37375226c,1,26,20,46,3,2015-01-16 19:37:06,2015-01-16 02:34:52
1aa110cc7fc83517a5a428feb7783cd37375226c...e0e780a5e3e4c717daa6a44ba19f3f2329ea7cee,2,79,3,82,5,2015-01-16 19:37:06,2015-01-16 03:06:33
e0e780a5e3e4c717daa6a44ba19f3f2329ea7cee...f1d696d46b65dd1f76727b37d85e0c08c291f533,2,61,73,134,18,2015-01-16 19:40:02,2012-04-27 08:25:46
f1d696d46b65dd1f76727b37d85e0c08c291f533...1ac9aae8f6cbf00f8a5d3039a687ea0793ff324f,1,8,1,9,2,2015-01-16 21:04:32,2015-01-15 15:22:41
1ac9aae8f6cbf00f8a5d3039a687ea0793ff324f...6bab2f390cfbae08bf0801668f54a5fd35db2bfc,1,1,0,1,1,2015-01-16 21:27:28,2015-01-16 21:27:28
6bab2f390cfbae08bf0801668f54a5fd35db2bfc...020cc851f48cca51ba2ac6c94ca93119a4563c4f,8,75,28,103,10,2015-01-16 22:01:57,2015-01-16 04:03:01
020cc851f48cca51ba2ac6c94ca93119a4563c4f...c3da2fc6642f143111d104c871f420d523f949b5,11,246,7,253,25,2015-01-16 22:13:32,2015-01-09 19:20:37
c3da2fc6642f143111d104c871f420d523f949b5...2d7050b6c3b9d35590e7e874e6285f0a1fcb5f3d,10,91,168,259,54,2015-01-17 01:18:53,2015-01-14 23:18:24
2d7050b6c3b9d35590e7e874e6285f0a1fcb5f3d...22ee5a4e87131a2b3791845c96edf4cde5028ba2,2,36,1,37,2,2015-01-17 18:35:28,2015-01-16 21:52:50
22ee5a4e87131a2b3791845c96edf4cde5028ba2...4bd88229e4e8ade32e289c3515d833b018e2306e,7,96,13,109,20,2015-01-19 00:04:35,2015-01-15 15:43:32
4bd88229e4e8ade32e289c3515d833b018e2306e...2e32dbb3ddc8aef4945e465795904c0f30d0f944,2,3,2,5,3,2015-01-19 00:41:19,2015-01-19 00:41:19
2e32dbb3ddc8aef4945e465795904c0f30d0f944...386398eb40626cf44d76f010a8d474b75b3f7adf,1,12,12,24,4,2015-01-19 01:00:05,2015-01-19 01:00:05
386398eb40626cf44d76f010a8d474b75b3f7adf...c50f274e1f232c498d411c98d6d0e4ff30df9ec3,2,12,0,12,2,2015-01-19 01:04:36,2015-01-18 21:13:43
c50f274e1f232c498d411c98d6d0e4ff30df9ec3...f5783c9e95fed63f7cbc589f463aa9cd09c00d0b,5,1605,1,1606,5,2015-01-19 06:51:07,2015-01-19 06:51:07
f5783c9e95fed63f7cbc589f463aa9cd09c00d0b...ed5a842a46625baab5a869fc2e445f9905e82fa6,1,1,1,2,1,2015-01-19 06:58:12,2015-01-19 06:58:12
ed5a842a46625baab5a869fc2e445f9905e82fa6...e5523460841583aac711c1120953cf757e9c2196,5,1,1605,1606,5,2015-01-19 16:50:32,2015-01-19 16:48:57
e5523460841583aac711c1120953cf757e9c2196...3cd12643d6941360e5b7b55a0caed75c82e541c5,2,182,35,217,8,2015-01-20 05:04:08,2015-01-20 05:02:56
3cd12643d6941360e5b7b55a0caed75c82e541c5...15867d511f3d6ae11a20899757de7e318e0acc05,1,14,0,14,1,2015-01-20 05:04:21,2015-01-20 05:04:21
15867d511f3d6ae11a20899757de7e318e0acc05...9cf04338af2dd4f9ac46e5d74345c7ea228d9e8f,3,15,2,17,4,2015-01-20 15:13:42,2015-01-15 21:56:28
9cf04338af2dd4f9ac46e5d74345c7ea228d9e8f...f8c0611e742c07a293da9cb49baac211fe1d8874,3,29,0,29,3,2015-01-20 16:17:26,2015-01-16 21:39:28
f8c0611e742c07a293da9cb49baac211fe1d8874...7221fd14ea822cf380e53ec89f5848fb5295163b,4,44,0,44,5,2015-01-20 16:17:35,2015-01-16 22:08:13
7221fd14ea822cf380e53ec89f5848fb5295163b...2b5bfa7e3799c9b4dffb38856b5d5f893a500731,1,56,0,56,1,2015-01-20 16:51:06,2015-01-12 22:18:28
2b5bfa7e3799c9b4dffb38856b5d5f893a500731...da1c93cc9fa8ac14e57335c46c0bad52d74a2981,1,13,11,24,5,2015-01-20 19:08:32,2015-01-16 18:54:41
da1c93cc9fa8ac14e57335c46c0bad52d74a2981...13de9e9c9f755de978df00bc8fd82bd9b526a67e,1,2,2,4,1,2015-01-20 19:08:32,2015-01-16 19:04:58
13de9e9c9f755de978df00bc8fd82bd9b526a67e...980e40d534ee21c5eb5108929be04a7f7026b5d5,1,4,0,4,1,2015-01-20 19:08:32,2015-01-16 20:09:57
980e40d534ee21c5eb5108929be04a7f7026b5d5...2d397b55c3207e875b6085944799b3c243ff4cf3,1,1,4,5,1,2015-01-20 20:15:01,2015-01-20 19:21:18
2d397b55c3207e875b6085944799b3c243ff4cf3...ee33a8fc2a840e05c7d3f5ea7d840b4ae23112f7,1,1,0,1,1,2015-01-20 20:24:54,2015-01-16 23:55:43
ee33a8fc2a840e05c7d3f5ea7d840b4ae23112f7...e422f31cd27565cdeb9f85b95f42b33852525c90,1,11,5,16,3,2015-01-20 21:47:11,2015-01-20 20:26:04
e422f31cd27565cdeb9f85b95f42b33852525c90...12e81d9cf5da7e01c1872c4dbf184c33ac73cc33,2,19,5,24,6,2015-01-20 21:56:35,2015-01-17 15:31:11
12e81d9cf5da7e01c1872c4dbf184c33ac73cc33...a334152814ef3b5015a256468c52d5cc5b25e29f,2,12,8,20,6,2015-01-20 16:52:47,2015-01-20 14:19:06
a334152814ef3b5015a256468c52d5cc5b25e29f...e66bf2f9895a8232ea0f578ee2eaa20e1bc65e65,1,6,0,6,1,2015-01-20 22:04:04,2015-01-20 19:25:08
e66bf2f9895a8232ea0f578ee2eaa20e1bc65e65...37398ff1063d8a42d075822ead009e761703fb9d,3,21,10,31,10,2015-01-20 22:05:19,2015-01-15 21:19:14
37398ff1063d8a42d075822ead009e761703fb9d...403a992daa205f2b43469ef45b5008d817a38fb6,2,11,7,18,4,2015-01-20 22:07:06,2015-01-20 16:40:42
403a992daa205f2b43469ef45b5008d817a38fb6...b6f25f8a9804e8c7efc995c8a40a3fa69da857e4,1,1,0,1,1,2015-01-20 23:23:10,2015-01-20 22:06:03
b6f25f8a9804e8c7efc995c8a40a3fa69da857e4...876f5f475bf9242c098e6de641aa7ee0982803c2,45,862,1117,1979,171,2015-01-20 23:23:10,2015-01-20 22:08:32
876f5f475bf9242c098e6de641aa7ee0982803c2...7d504b66098d1cfcafdb536ff0db3f7eb53f8c99,4,112,99,211,5,2015-01-21 14:16:04,2015-01-20 14:23:42
7d504b66098d1cfcafdb536ff0db3f7eb53f8c99...f346c4ad0c2d892014c79d7adbbca61031f50194,11,791,326,1117,45,2015-01-21 15:32:58,2015-01-16 20:08:37
f346c4ad0c2d892014c79d7adbbca61031f50194...cae09dfed0b4f785e3eacc0123ce3136b3484ef0,1,14,0,14,7,2015-01-21 16:29:28,2015-01-20 23:09:14
cae09dfed0b4f785e3eacc0123ce3136b3484ef0...fc0d56be2cc3ba75fecd7d9047942cf686815dfe,1,1,1,2,1,2015-01-21 16:57:18,2015-01-20 23:24:53
fc0d56be2cc3ba75fecd7d9047942cf686815dfe...e339dbf6fcee2d64b47c4d4eadf7d8c597f48f82,1,1,1,2,1,2015-01-21 18:45:09,2015-01-21 18:45:09
e339dbf6fcee2d64b47c4d4eadf7d8c597f48f82...0e4ef6acc797596f5d95f43f235d6110ad81ee10,2,67,6,73,7,2015-01-21 18:58:39,2015-01-20 13:01:23
0e4ef6acc797596f5d95f43f235d6110ad81ee10...91959b89ac64321955573c53298c566d4e69a3a1,1,30,4,34,4,2015-01-21 20:42:28,2015-01-20 20:30:47
91959b89ac64321955573c53298c566d4e69a3a1...1b72a40d26b43b64a6d08717e2a01a31e6e861a8,1,92,3,95,6,2015-01-21 20:51:32,2015-01-21 20:51:32
1b72a40d26b43b64a6d08717e2a01a31e6e861a8...6dccc57a81dccb9a1100b0314a3234486fda1b04,1,3,2,5,1,2015-01-21 20:59:42,2015-01-21 20:59:42
6dccc57a81dccb9a1100b0314a3234486fda1b04...399f07467a56ac2d7334c9b627815c8610c8a8ee,1,4,4,8,3,2015-01-21 21:27:42,2015-01-14 15:37:58
399f07467a56ac2d7334c9b627815c8610c8a8ee...871ed2eec7a1bf2bed5bc8fc5f04a3eaa99d3fbd,2,162,80,242,8,2015-01-22 00:17:49,2015-01-20 22:19:48
871ed2eec7a1bf2bed5bc8fc5f04a3eaa99d3fbd...34f4776efba9205b9969232bce905f681ac8bac3,16,128,31,159,35,2015-01-22 00:23:45,2015-01-21 19:58:16
34f4776efba9205b9969232bce905f681ac8bac3...612f66c61c12b705fe3c5ed251d63525f1bf650a,9,69,33,102,28,2015-01-22 14:38:32,2015-01-21 23:09:10
612f66c61c12b705fe3c5ed251d63525f1bf650a...44fd8e4e903d65dceb583c84cc5ec430c9350ad8,9,62,12,74,19,2015-01-22 16:59:22,2015-01-21 16:30:57
44fd8e4e903d65dceb583c84cc5ec430c9350ad8...dc0a3a6cbcc91a410b07ad0e10c6ecc4ae2c92dc,1,4,5,9,2,2015-01-22 17:11:05,2015-01-22 15:31:52
dc0a3a6cbcc91a410b07ad0e10c6ecc4ae2c92dc...ab9ac2126075fec83c579113bc0c81ec08b797de,2,55,27,82,7,2015-01-22 17:17:02,2015-01-22 17:01:32
ab9ac2126075fec83c579113bc0c81ec08b797de...4c83a604004c329ac114c53df38ac96421ebcf83,6,105,4,109,16,2015-01-22 17:21:50,2015-01-22 17:09:54
4c83a604004c329ac114c53df38ac96421ebcf83...78c3e1803f96d045e91bb2efb9163eee9f43d237,1,5,5,10,1,2015-01-22 19:06:04,2015-01-22 16:34:18
78c3e1803f96d045e91bb2efb9163eee9f43d237...816defcefba70ffe815639fa6bb157b69ef034ad,5,69,84,153,19,2015-01-22 19:28:02,2015-01-22 19:27:47
816defcefba70ffe815639fa6bb157b69ef034ad...89ddf2d90625a7738b8e48dce1a5776942603d27,1,6,7,13,2,2015-01-22 19:57:38,2015-01-22 15:48:35
89ddf2d90625a7738b8e48dce1a5776942603d27...97fadbd567304dc1b438f54e8cfe8e911b496b2b,1,5,0,5,1,2015-01-22 20:27:58,2015-01-22 18:36:44
612f66c61c12b705fe3c5ed251d63525f1bf650a...ec8661589ea5bc7e2ed65ccbc25321d4d23a15f1,1,1,1,2,1,2015-01-22 16:12:02,2015-01-22 16:12:02
d411d55cac9cb5dea88db7e9afe5c6fa4e831161...8e54b64c1d9b47579401411585ea1dfe209cddf9,1,29,10,39,13,2015-01-22 21:32:59,2015-01-22 18:47:59
8e54b64c1d9b47579401411585ea1dfe209cddf9...c2756268ceba90afbc05e26875899c6e468e854b,1,1,1,2,1,2015-01-22 21:33:00,2015-01-22 20:39:44
c2756268ceba90afbc05e26875899c6e468e854b...dadbe696a8dc603a5014068f8b63eee17e259ff0,22,36,36,72,33,2015-01-23 00:06:55,2015-01-23 00:06:55
dadbe696a8dc603a5014068f8b63eee17e259ff0...1e4e8de0866733c0fde8d481c4809633cc6c85cf,1,17,3,20,5,2015-01-23 16:44:06,2015-01-22 23:13:01
1e4e8de0866733c0fde8d481c4809633cc6c85cf...ef668908b15e9b0cf0e6c93ee1ef05135d4cbd81,1,3,1,4,1,2015-01-23 16:44:48,2015-01-23 15:57:08
ef668908b15e9b0cf0e6c93ee1ef05135d4cbd81...43e58e67caf92ac9c6c3da004f0a4f8deff24e69,1,80,51,131,11,2015-01-23 16:44:57,2015-01-22 23:50:17
43e58e67caf92ac9c6c3da004f0a4f8deff24e69...78e197585723e67558ab52d9c8b1720b62017a37,1,42,8,50,6,2015-01-23 16:45:04,2015-01-23 00:06:05
78e197585723e67558ab52d9c8b1720b62017a37...797afb0ef9d29611c7d5ec28ea479616a058f14c,4,64,60,124,46,2015-01-23 16:56:19,2015-01-23 15:32:09
797afb0ef9d29611c7d5ec28ea479616a058f14c...f8267b26894866eb9dc527445c7632a912d7816d,1,20,13,33,3,2015-01-23 17:00:29,2015-01-22 21:14:20
f8267b26894866eb9dc527445c7632a912d7816d...6fa02fef6668a84147224363c3818ad96c3ea8dc,1,8,3,11,4,2015-01-23 17:01:09,2015-01-22 21:14:52
6fa02fef6668a84147224363c3818ad96c3ea8dc...d1aaa562f793c7483ff9af9582ea2efbfe2b5c92,1,29,4,33,3,2015-01-23 19:03:28,2015-01-23 19:01:01
d1aaa562f793c7483ff9af9582ea2efbfe2b5c92...8dd41ae58040dfa09c633c05ce5752d46402f9c5,2,2,2,4,2,2015-01-23 19:05:15,2015-01-23 19:05:15
8dd41ae58040dfa09c633c05ce5752d46402f9c5...c8a25001d0641404b23b531a4813ccadcdff0881,2,2,2,4,2,2015-01-23 22:33:03,2015-01-23 22:33:03
c8a25001d0641404b23b531a4813ccadcdff0881...bf1998071a6c6650508e12d8b25cbf035d388dad,7,874,580,1454,25,2015-01-26 16:26:18,2015-01-17 00:20:59
bf1998071a6c6650508e12d8b25cbf035d388dad...197fbbd0f277d064ccd393c4d31c8ddca0582ef4,4,164,21,185,17,2015-01-26 16:26:53,2015-01-22 17:10:53
197fbbd0f277d064ccd393c4d31c8ddca0582ef4...f00a2d0db8d91606de64e29f4919ae5fdbadcf57,1,38,27,65,10,2015-01-26 16:27:07,2015-01-23 20:56:51
f00a2d0db8d91606de64e29f4919ae5fdbadcf57...31c67d70ba53a0a3637934bbf180a1810763270e,1,3,2,5,3,2015-01-26 16:27:13,2015-01-23 20:50:39
31c67d70ba53a0a3637934bbf180a1810763270e...04b4d5d82e51345c89a4fa53b7c864b4eeb4272b,1,3,0,3,3,2015-01-26 16:27:23,2015-01-23 20:53:07
04b4d5d82e51345c89a4fa53b7c864b4eeb4272b...b51b97381792ba3e02fe02204f02c87863d2f664,3,55,45,100,13,2015-01-26 16:27:29,2015-01-23 21:53:12
b51b97381792ba3e02fe02204f02c87863d2f664...021ea0a1a885d26e7c1010d71cf4152d40d5c04c,5,81,40,121,4,2015-01-26 16:27:36,2015-01-20 20:28:26
021ea0a1a885d26e7c1010d71cf4152d40d5c04c...67b0ca34a1f849832c6573300eda9bb60289b562,1,0,4,4,1,2015-01-26 16:27:42,2015-01-23 23:15:06
67b0ca34a1f849832c6573300eda9bb60289b562...3d3f37d10ce6ce2e0d55127e0351e0882662abc0,3,45,55,100,13,2015-01-26 16:27:48,2015-01-24 05:20:50
3d3f37d10ce6ce2e0d55127e0351e0882662abc0...a62207c8a2bed0f1679b2d1f6cbde120cb149106,1,2,4,6,4,2015-01-26 16:27:59,2015-01-26 15:54:48
a62207c8a2bed0f1679b2d1f6cbde120cb149106...3ef65d17fd8081cb65330bf90bffd093e7fd020b,6,44,22,66,13,2015-01-26 16:38:27,2015-01-26 15:58:07
3ef65d17fd8081cb65330bf90bffd093e7fd020b...e97479e149b169f1a92bf54cb2d77c228ca1d03c,3,123,1,124,12,2015-01-26 16:38:32,2015-01-22 20:51:11
e97479e149b169f1a92bf54cb2d77c228ca1d03c...0649555aa3fae26e6770a3186e2766c26fd0cfcf,13,216,269,485,110,2015-01-26 19:11:26,2015-01-21 20:03:02
0649555aa3fae26e6770a3186e2766c26fd0cfcf...8e7b584364fb9fc3f51d179adddc63c9ab62f1d9,1,35,24,59,11,2015-01-26 19:11:26,2015-01-23 21:17:06
8e7b584364fb9fc3f51d179adddc63c9ab62f1d9...0a66571b193c2e387d5dc376e68989526298394f,1,6,15,21,2,2015-01-26 19:11:26,2015-01-23 22:31:15
0a66571b193c2e387d5dc376e68989526298394f...ff290ab7ad9f0d66673b00c7aa3e825e417d4632,1,21,10,31,3,2015-01-26 19:11:26,2015-01-23 22:31:39
ff290ab7ad9f0d66673b00c7aa3e825e417d4632...4bbd77493be7cecc2160e60c6e38abf7c446ec69,3,48,52,100,16,2015-01-26 19:11:27,2015-01-23 23:12:42
4bbd77493be7cecc2160e60c6e38abf7c446ec69...5cd1ae2e84ad938070045064450537cd455fd1fa,1,4,4,8,3,2015-01-26 21:52:50,2015-01-26 15:21:46
5cd1ae2e84ad938070045064450537cd455fd1fa...fad1bc20807c77f33962d373b556c9173d0994f0,1,1,1,2,1,2015-01-26 21:52:50,2015-01-26 21:09:23
fad1bc20807c77f33962d373b556c9173d0994f0...0c3f6afee5c9246918584b1e2d93c03ebb04c6f1,6,249,14,263,29,2015-01-26 21:52:50,2015-01-26 21:39:34
0c3f6afee5c9246918584b1e2d93c03ebb04c6f1...a0ad9d0380bbe874460151cfa3901b52af28e7c6,1,1,1,2,1,2015-01-26 21:52:51,2015-01-26 21:01:16
a0ad9d0380bbe874460151cfa3901b52af28e7c6...88a63e39e7cecd7aa01b8ecf5bfa7f6028ca0520,1,64,62,126,9,2015-01-27 01:15:14,2015-01-26 22:31:22
88a63e39e7cecd7aa01b8ecf5bfa7f6028ca0520...64f8cf8dac852d1df58e9e63ec0dba6568b09a01,1,4,3,7,1,2015-01-27 01:15:14,2015-01-26 23:09:23
64f8cf8dac852d1df58e9e63ec0dba6568b09a01...248e24781ce255bc618f4af342e7ac6657547101,1,7,3,10,3,2015-01-27 01:15:14,2015-01-26 18:27:19
248e24781ce255bc618f4af342e7ac6657547101...7ae8300a5d7d443747702d6222f387d41db4c5f8,4,57,18,75,19,2015-01-27 01:15:14,2015-01-26 20:12:50
7ae8300a5d7d443747702d6222f387d41db4c5f8...3bb8921bd826439265be6f648880bf83da9ef2f1,1,0,7,7,1,2015-01-27 01:15:14,2015-01-26 22:57:33
3bb8921bd826439265be6f648880bf83da9ef2f1...ac7ccbf18ce072a4b8ace91cbb85d9bc2a6c6a23,1,1,1,2,2,2015-01-27 06:01:09,2015-01-27 03:42:56
ac7ccbf18ce072a4b8ace91cbb85d9bc2a6c6a23...a2e201f5c1defcba3f247fe84acf5b2f5ee01f23,1,1,0,1,1,2015-01-27 06:01:15,2015-01-27 05:57:56
a2e201f5c1defcba3f247fe84acf5b2f5ee01f23...68144f558d6ec69eeec8e21d4069d61f1bf4f9f1,39,509,317,826,203,2015-01-27 10:49:45,2015-01-27 10:48:08
68144f558d6ec69eeec8e21d4069d61f1bf4f9f1...90bbd525a01e710ec843bacebf82a62928c7458f,1,22,2,24,5,2015-01-27 19:45:50,2015-01-22 20:08:01
90bbd525a01e710ec843bacebf82a62928c7458f...8f61de3d91cff2f84f0e4ae81017ca98a96a7f02,6,147,124,271,29,2015-01-27 19:45:50,2015-01-27 15:10:22
8f61de3d91cff2f84f0e4ae81017ca98a96a7f02...a0986ff9cd64e935a37f4d0b254728712866c579,3,15,10,25,11,2015-01-27 19:45:50,2015-01-27 14:57:45
a0986ff9cd64e935a37f4d0b254728712866c579...ef2ab17fb0c0ab8ed8c3ac6fb963fff80dc21978,5,5,0,5,5,2015-01-27 19:45:50,2015-01-27 16:40:29
ef2ab17fb0c0ab8ed8c3ac6fb963fff80dc21978...b80657cccb4ef9db0ad8e920bd7957e3921d4a06,1,16,12,28,6,2015-01-27 19:45:51,2015-01-27 17:16:14
b80657cccb4ef9db0ad8e920bd7957e3921d4a06...aa2f9735f7703195b1ba0d8189c950be5ee40163,1,12,4,16,7,2015-01-27 19:45:51,2015-01-27 18:39:52
aa2f9735f7703195b1ba0d8189c950be5ee40163...486bc193e4d8714eb3da0bd4896427350cf9c6d5,4,11,15,26,10,2015-01-27 19:45:51,2015-01-27 19:09:22
486bc193e4d8714eb3da0bd4896427350cf9c6d5...faf90d4eebf9b7f37f9167d26710a6aad18e1aff,1,2,2,4,3,2015-01-27 22:30:28,2015-01-27 15:29:02
faf90d4eebf9b7f37f9167d26710a6aad18e1aff...579e0a971eaf1dc5de43b2ab08fbac05868bae19,1,1,1,2,1,2015-01-27 22:30:28,2015-01-27 16:06:03
579e0a971eaf1dc5de43b2ab08fbac05868bae19...e4f85032730be00e066da0bee0581372ef0915b3,1,4,4,8,2,2015-01-27 22:30:28,2015-01-27 19:55:02
e4f85032730be00e066da0bee0581372ef0915b3...1cdd9280d32112b2514635b0f7672eea5a6cbfe0,2,13,0,13,3,2015-01-27 22:40:59,2015-01-27 21:50:49
1cdd9280d32112b2514635b0f7672eea5a6cbfe0...9f3b84f9a1fa57d05725db1b6dc886bee43e8f80,7,37,10,47,16,2015-01-28 01:35:01,2015-01-27 22:57:01
9f3b84f9a1fa57d05725db1b6dc886bee43e8f80...7bdd9fd94db588c87fe1c3096dc113dbccc9a579,1,2,1,3,2,2015-01-28 01:35:01,2015-01-23 22:30:27
7bdd9fd94db588c87fe1c3096dc113dbccc9a579...b059fb303695a7ef90a1489d5d5a4cff3ead707d,2,6,6,12,3,2015-01-28 01:35:01,2015-01-27 21:09:24
b059fb303695a7ef90a1489d5d5a4cff3ead707d...2bec03aa00484ae15c9729d6611a679f629ae33e,2,3,4,7,3,2015-01-28 01:35:01,2015-01-23 22:34:01
2bec03aa00484ae15c9729d6611a679f629ae33e...9de555036b50926184a9ee707efa29b0dd92d7ff,6,13,45,58,14,2015-01-28 01:35:01,2015-01-27 23:57:31
9de555036b50926184a9ee707efa29b0dd92d7ff...cbe2315f1a511478d51968ca0f09aa7775540903,1,1,7,8,1,2015-01-28 01:35:02,2015-01-28 00:07:00
cbe2315f1a511478d51968ca0f09aa7775540903...124386bc6077c1a9e56578fe800b31d43e15a648,4,252,62,314,24,2015-01-28 04:44:14,2015-01-27 23:52:48
124386bc6077c1a9e56578fe800b31d43e15a648...81cb23e84653d66158bca6052e21cdae6eec64f4,23,222,75,297,74,2015-01-28 04:44:25,2015-01-28 02:17:02
81cb23e84653d66158bca6052e21cdae6eec64f4...39325518eeef09a7ac938d63f79b718a49a69535,4,32,8,40,8,2015-01-28 08:33:29,2015-01-28 08:30:51
39325518eeef09a7ac938d63f79b718a49a69535...778055f7fcce72a71ed5ab626fa6871a3f881abf,2,4,4,8,4,2015-01-28 16:57:42,2015-01-28 16:56:01
778055f7fcce72a71ed5ab626fa6871a3f881abf...955b8901664dc6b0889bd4e48a5f1de2cf2023c8,6,19,7,26,9,2015-01-28 17:01:41,2015-01-27 15:55:40
955b8901664dc6b0889bd4e48a5f1de2cf2023c8...5d71769398636406ef11f850ef6df163a47bb902,1,1,1,2,1,2015-01-28 17:22:41,2015-01-28 16:42:18
5d71769398636406ef11f850ef6df163a47bb902...52066525e913a9c95989f42d650dedb86c683b74,1,6,0,6,1,2015-01-28 17:22:47,2015-01-28 17:06:13
52066525e913a9c95989f42d650dedb86c683b74...e4c60053b2967e16f765fa25d16aa6d629faa196,2,2,2,4,2,2015-01-28 17:24:29,2015-01-28 17:24:29
e4c60053b2967e16f765fa25d16aa6d629faa196...6df78237bcaaa283cd6dbc67680f04f9152dfd4f,2,2,2,4,2,2015-01-28 21:44:56,2015-01-28 21:44:56
6df78237bcaaa283cd6dbc67680f04f9152dfd4f...09c3b4d5bc44410b9cf192ea062c39eba247f0b5,2,2,2,4,2,2015-01-29 16:46:51,2015-01-28 19:45:41
09c3b4d5bc44410b9cf192ea062c39eba247f0b5...5f9a67146a50a951c4c55115d9ccfea63642e5bd,2,7,2,9,3,2015-01-29 16:46:51,2015-01-29 15:01:11
5f9a67146a50a951c4c55115d9ccfea63642e5bd...96eb9c612305e626f1b014b2e6d57c59f32e047b,1,8,1,9,2,2015-01-29 16:46:51,2015-01-29 15:07:30
96eb9c612305e626f1b014b2e6d57c59f32e047b...b70d96e06c2c3fa86d95f6719ab1815a98db77a9,10,141,177,318,57,2015-01-29 16:46:51,2015-01-29 16:44:16
b70d96e06c2c3fa86d95f6719ab1815a98db77a9...f72cfa108021d1916edbeb554559c73f8766283d,1,4,0,4,1,2015-02-02 19:16:11,2015-01-30 15:06:35
f72cfa108021d1916edbeb554559c73f8766283d...acb58982e34cb33c4575e5e4a33ef37478f35f5d,14,2773,1562,4335,555,2015-02-02 19:16:22,2015-01-30 21:44:56
acb58982e34cb33c4575e5e4a33ef37478f35f5d...6f50ace8c8a57d34490965291cd5638ee4554c03,3,11,8,19,8,2015-02-02 19:16:28,2015-01-31 05:01:16
6f50ace8c8a57d34490965291cd5638ee4554c03...b4cb950bc48ad3bfe107befa1bc9fed665c98b45,2,10,0,10,2,2015-02-04 18:47:46,2015-02-02 18:45:53
b4cb950bc48ad3bfe107befa1bc9fed665c98b45...ff3078654ada4c8ff6d6e44660a9a25dd77753c5,57,302,217,519,155,2015-02-04 18:47:46,2015-02-02 20:39:22
ff3078654ada4c8ff6d6e44660a9a25dd77753c5...cd2e9dca7a9269d000406f1fdf7bb95993e3de91,1,1,0,1,1,2015-02-04 18:47:46,2015-02-02 21:09:27
cd2e9dca7a9269d000406f1fdf7bb95993e3de91...8211bb30f4a5720d3e37c79da140f512ab2f630d,1,1,1,2,1,2015-02-04 18:47:46,2015-02-02 21:56:56
8211bb30f4a5720d3e37c79da140f512ab2f630d...2e2a80f90857eb3d1bb3179fd67a37b0e107f102,1,66,0,66,1,2015-02-04 18:47:47,2015-02-02 21:07:52
2e2a80f90857eb3d1bb3179fd67a37b0e107f102...82da5f61063358399bfb05f605d762cc651fb160,3,19,4,23,7,2015-02-04 18:47:47,2015-02-02 21:32:36
82da5f61063358399bfb05f605d762cc651fb160...d38b4c11771badfeb047813998f3b83406c6ad87,1,4,4,8,2,2015-02-04 18:47:47,2015-02-03 15:03:21
d38b4c11771badfeb047813998f3b83406c6ad87...79fee94b8a9c330cb1d1a2e824e1407e9f83e5a1,1,2,0,2,2,2015-02-04 18:47:47,2015-02-03 17:16:34
79fee94b8a9c330cb1d1a2e824e1407e9f83e5a1...36df4768baea9b5d3aeb3a07371b0b2f1de01766,1,7,9,16,6,2015-02-04 18:47:47,2015-01-30 22:32:19
36df4768baea9b5d3aeb3a07371b0b2f1de01766...a1b36ea0a0c1db6ea55702caf0a0fa446dc495e5,1,47,0,47,1,2015-02-04 18:47:48,2015-01-30 22:33:03
a1b36ea0a0c1db6ea55702caf0a0fa446dc495e5...97591316b10a0c41c8449d15d23dc562401998b2,4,61,5,66,7,2015-02-04 18:47:48,2015-02-02 22:32:30
97591316b10a0c41c8449d15d23dc562401998b2...dbc52f024a2e679038f85bc818bb9b5c7c8c9acd,3,30,8,38,11,2015-02-04 18:47:48,2015-02-02 19:27:01
dbc52f024a2e679038f85bc818bb9b5c7c8c9acd...1c3f32bedac9a9277b7088f83848fe577526b6da,4,108,9,117,15,2015-02-04 18:47:48,2015-01-30 20:06:56
1c3f32bedac9a9277b7088f83848fe577526b6da...332c6160fe7326e15a92aa7397c2e0f0edc7efe3,1,29,1,30,4,2015-02-04 18:47:48,2015-01-30 18:08:26
332c6160fe7326e15a92aa7397c2e0f0edc7efe3...4f88b799c7b6829613907f3d5924071eb4ef9f45,7,28,56,84,17,2015-02-04 18:47:49,2015-01-29 23:58:11
4f88b799c7b6829613907f3d5924071eb4ef9f45...5785bd5af8277a2e543622fd7eaf7772965fdc24,5,46,15,61,21,2015-02-04 18:47:49,2015-02-03 16:02:54
5785bd5af8277a2e543622fd7eaf7772965fdc24...f2917a86e8eff7429f670e11fc5896f244d9c9bc,5,74,38,112,31,2015-02-04 18:47:49,2015-02-02 17:43:43
f2917a86e8eff7429f670e11fc5896f244d9c9bc...f0531d8229e9a3e2d663ba0612495ad2ba4aa1b7,1,4,1,5,1,2015-02-04 18:47:49,2015-02-03 23:50:51
f0531d8229e9a3e2d663ba0612495ad2ba4aa1b7...3f09e9dacbb34f9cdd45ac025ba0c8238eec5d31,2,73,61,134,18,2015-02-04 18:47:49,2015-02-03 23:53:13
3f09e9dacbb34f9cdd45ac025ba0c8238eec5d31...da68fbef39b7aebe70ae2d3ccfcc73d3f2942573,50,703,605,1308,246,2015-02-04 18:47:50,2015-02-04 11:48:51
da68fbef39b7aebe70ae2d3ccfcc73d3f2942573...245f53125f4eb18d881b4278fc7bd99c6cbca9d0,2,33,3,36,3,2015-02-04 18:47:50,2015-02-04 14:48:44
245f53125f4eb18d881b4278fc7bd99c6cbca9d0...02c6f0b6c12a0ecbb6d37fd2224f14deefe93ba2,4,39,2,41,10,2015-02-04 18:47:50,2015-02-03 20:35:51
02c6f0b6c12a0ecbb6d37fd2224f14deefe93ba2...6f37514e83c808470704f85a0375b7f240091af3,2,135,42,177,11,2015-02-05 15:54:22,2015-02-04 23:27:17
6f37514e83c808470704f85a0375b7f240091af3...7f9811077b131cd6bada0e174b9fda9211f8d247,4,50,36,86,18,2015-02-05 16:33:03,2015-02-03 13:10:52
7f9811077b131cd6bada0e174b9fda9211f8d247...105b43de0945351c379d4f6595d9423f4bb96521,2,4,2,6,2,2015-02-05 16:33:03,2015-02-04 21:29:56
105b43de0945351c379d4f6595d9423f4bb96521...25d7e2bde8969c3a2c6725c3663eb21e7df86d21,10,120,11,131,34,2015-02-05 16:33:03,2015-02-03 22:13:01
25d7e2bde8969c3a2c6725c3663eb21e7df86d21...f2372f36bd5390704be6ddf4a1556deff49f0d69,2,30,6,36,5,2015-02-05 16:33:03,2015-02-04 19:49:51
f2372f36bd5390704be6ddf4a1556deff49f0d69...3e9b48ff434a6ccda0890e752f2034845c042f21,4,141,9,150,11,2015-02-05 16:33:03,2015-02-04 15:22:40
3e9b48ff434a6ccda0890e752f2034845c042f21...2f57099361468e7ae85b19bc35259803ea9ddf04,1,4,12,16,2,2015-02-05 16:33:04,2015-01-29 16:53:45
2f57099361468e7ae85b19bc35259803ea9ddf04...0c06c7307aae2509e5d22835261b124427a8754b,1,32,0,32,7,2015-02-05 16:33:04,2015-02-04 22:29:57
0c06c7307aae2509e5d22835261b124427a8754b...9d0714cdcffadb203ff68730acedbc40875403da,2,2,2,4,2,2015-02-05 16:33:41,2015-02-05 16:33:41
9d0714cdcffadb203ff68730acedbc40875403da...19bce6df6b7367d5fb688d64035d9b42f2b7cac8,2,2,2,4,2,2015-02-05 21:19:57,2015-02-05 21:19:57
19bce6df6b7367d5fb688d64035d9b42f2b7cac8...bdcbc5d162480d43fff51a190f80224213a1a978,4,247,187,434,6,2015-02-06 17:52:35,2015-02-05 23:38:45
bdcbc5d162480d43fff51a190f80224213a1a978...dadc36a4cd0cc13e260c705ce3143ebe57d60c88,2,21,0,21,3,2015-02-06 22:16:06,2015-02-03 18:34:47
dadc36a4cd0cc13e260c705ce3143ebe57d60c88...008c344e13c048ab3415c70505d8815898143abc,2,34,0,34,2,2015-02-06 22:16:07,2015-02-05 15:50:29
008c344e13c048ab3415c70505d8815898143abc...2b1a0f4cd4564d52b6605d802f30fe8958eaa9f7,2,19,14,33,4,2015-02-06 22:16:07,2015-02-06 16:06:09
2b1a0f4cd4564d52b6605d802f30fe8958eaa9f7...104ef7f7bea6d9798921e6c1baa9281eaf204ad1,1,8,2,10,2,2015-02-06 22:16:07,2015-02-06 15:38:38
104ef7f7bea6d9798921e6c1baa9281eaf204ad1...216caf45f814fd99ce061210ef2ae78ab6bb8594,3,191,88,279,16,2015-02-06 22:16:07,2015-02-06 15:12:20
216caf45f814fd99ce061210ef2ae78ab6bb8594...2a7ba2c4b8e4d44220bb73b8f92274243fec0ff4,1,4,5,9,2,2015-02-06 22:16:07,2015-02-06 18:56:14
2a7ba2c4b8e4d44220bb73b8f92274243fec0ff4...7a1b95687187cea2ef5d8a09a459c77cfdebb51c,1,17,27,44,1,2015-02-06 22:16:08,2015-02-06 19:42:16
7a1b95687187cea2ef5d8a09a459c77cfdebb51c...9fbaab227e244d76dff996de5ab4f8d22d1135b8,1,0,1,1,1,2015-02-06 22:16:08,2015-02-06 15:30:31
9fbaab227e244d76dff996de5ab4f8d22d1135b8...066fe28f8c85b787fd3c5f9f3aca9026626a1434,1,10,6,16,5,2015-02-06 22:40:19,2015-02-06 22:30:36
066fe28f8c85b787fd3c5f9f3aca9026626a1434...47a114b9f105e420decacc3b44dfc49702397b51,1,3,5,8,1,2015-02-06 23:56:38,2015-02-06 21:18:28
47a114b9f105e420decacc3b44dfc49702397b51...9446e2d4fb6bc41883788f25e040bba426fdb56e,1,5,0,5,1,2015-02-07 14:34:08,2015-02-06 21:02:34
9446e2d4fb6bc41883788f25e040bba426fdb56e...e2e41c48d6d8f1793177abf3299066caf37cea52,1,13,0,13,3,2015-02-07 14:34:12,2015-02-06 21:45:15
e2e41c48d6d8f1793177abf3299066caf37cea52...656c47bc864f5fa2a1c95fbdd2cf671d7d6ab669,1,8,3,11,1,2015-02-09 21:50:52,2015-02-05 22:32:09
656c47bc864f5fa2a1c95fbdd2cf671d7d6ab669...5cc0caf2a09ee91c5e282df734bd2886c97edd58,1,125,125,250,1,2015-02-09 21:50:52,2015-01-23 22:07:52
5cc0caf2a09ee91c5e282df734bd2886c97edd58...b42f74998bd3d4aa3bfc940999d0d3d2648e0e6b,1,58,54,112,8,2015-02-09 21:50:53,2015-01-23 23:20:11
b42f74998bd3d4aa3bfc940999d0d3d2648e0e6b...7f5df52b3a48b1ab028e8453443de67f8fe46155,1,55,46,101,22,2015-02-09 21:50:53,2015-01-23 23:26:42
7f5df52b3a48b1ab028e8453443de67f8fe46155...43ea13bb5995ed1a1907ccb9f49b76daba2b27b2,1,1,1,2,1,2015-02-09 21:50:53,2015-02-09 21:38:56
43ea13bb5995ed1a1907ccb9f49b76daba2b27b2...f0e6b92744cbe03aa9d395169231774fd6d7ea06,8,68,30,98,19,2015-02-09 23:04:34,2015-02-06 15:37:48
f0e6b92744cbe03aa9d395169231774fd6d7ea06...425e072cc40c4389d1761f43f2900c117c96909c,1,4,1,5,1,2015-02-09 23:04:34,2015-02-09 21:53:28
425e072cc40c4389d1761f43f2900c117c96909c...57d8b8d5e0642ae73c20d2a23ad8af80ddf9e49e,1,9,2,11,1,2015-02-10 15:25:40,2015-02-09 15:31:59
57d8b8d5e0642ae73c20d2a23ad8af80ddf9e49e...f38a07c14339977a511ca3c2e0a3b2f8afd8fbdd,2,40,2,42,5,2015-02-10 20:56:35,2015-02-09 15:05:32
f38a07c14339977a511ca3c2e0a3b2f8afd8fbdd...2095cb5e361e64bed19d8be122e4da7eb9ee57b7,10,261,168,429,72,2015-02-11 18:43:42,2015-01-27 18:01:45
2095cb5e361e64bed19d8be122e4da7eb9ee57b7...93285b4b5c6d082de5e7a1d451be5aee2fa8e849,1,1,1,2,1,2015-02-11 18:43:47,2015-02-11 14:37:08
93285b4b5c6d082de5e7a1d451be5aee2fa8e849...b0a1d565182c9c496548ce5ac7a0d9d59910527d,107,495462,291,495753,298,2015-02-11 18:43:53,2015-02-11 14:38:54
b0a1d565182c9c496548ce5ac7a0d9d59910527d...dfccaaff651d1ba04d82c7c73f0e3157ea7be6a8,5,43,14,57,12,2015-02-11 19:00:38,2015-01-28 19:50:37
dfccaaff651d1ba04d82c7c73f0e3157ea7be6a8...afb85b67b4d664ffec933596fe5785ec29d2d70e,3,9,4,13,3,2015-02-11 21:00:52,2015-02-10 22:22:11
afb85b67b4d664ffec933596fe5785ec29d2d70e...3dd69dcf53681c19e4e755175b2f374816199883,1,1,1,2,1,2015-02-11 21:00:56,2015-02-11 19:28:30
3dd69dcf53681c19e4e755175b2f374816199883...f411d9d96ce7ff0c7802e99f0b28129ac16b1f70,2,26,0,26,3,2015-02-11 21:00:59,2015-02-11 17:22:10
f411d9d96ce7ff0c7802e99f0b28129ac16b1f70...81c466950cf39ac9b17e8cf41139123351a67302,1,3,3,6,3,2015-02-11 21:44:38,2015-02-11 00:50:42
81c466950cf39ac9b17e8cf41139123351a67302...c531604572ce408502dea9a3468b9a1c69639dd3,1,1,1,2,1,2015-02-11 21:44:46,2015-02-11 14:56:19
c531604572ce408502dea9a3468b9a1c69639dd3...5e579b03fb55259037d0f348ee0c7c1d702b69c9,2,9,0,9,2,2015-02-11 23:21:17,2015-02-10 22:37:56
5e579b03fb55259037d0f348ee0c7c1d702b69c9...6f925ef3c327be1806a9895053023d155148d964,1,8,0,8,1,2015-02-11 23:21:22,2015-02-10 17:29:46
6f925ef3c327be1806a9895053023d155148d964...762c8371fabd192bdb98717c4588858eab78d12c,1,5,1,6,1,2015-02-11 23:21:26,2015-02-11 21:38:59
762c8371fabd192bdb98717c4588858eab78d12c...5285225e71c5c0652520ef99d0ae4ca24655f72f,2,21,0,21,2,2015-02-12 15:50:09,2015-02-12 03:12:37
5285225e71c5c0652520ef99d0ae4ca24655f72f...c4744e05e97ec93b7fad925502946207fa02ef84,13,69,118,187,44,2015-02-12 15:50:16,2015-02-12 12:39:45
c4744e05e97ec93b7fad925502946207fa02ef84...af66c7f7ca777d81275ae1994ba6bfebbda17e39,1,3,2,5,1,2015-02-12 15:50:23,2015-02-12 04:55:43
af66c7f7ca777d81275ae1994ba6bfebbda17e39...3eeddde0149962a3e3ed3656da7f851d17028ec7,5,114,85,199,51,2015-02-12 19:33:14,2015-02-12 18:41:04
3eeddde0149962a3e3ed3656da7f851d17028ec7...79492d9cc1885d74b31b5fe24194dbc227096d6e,1,2,3,5,2,2015-02-12 20:32:08,2015-02-12 20:24:27
79492d9cc1885d74b31b5fe24194dbc227096d6e...e71db695221e39b3b6aa972d7503ca8c52c8fd55,6,36,12,48,8,2015-02-15 15:27:19,2015-02-04 19:40:58
e71db695221e39b3b6aa972d7503ca8c52c8fd55...5635d23c6749e73b8c367070fe8474884dcb0207,1,1,1,2,1,2015-02-15 15:27:20,2015-02-04 16:54:48
5635d23c6749e73b8c367070fe8474884dcb0207...466c3af5dd5fe379e2c7833783fbabeaa2662a03,1,7,5,12,1,2015-02-15 15:27:20,2015-02-10 23:52:33
466c3af5dd5fe379e2c7833783fbabeaa2662a03...fef75e46001b3c8cc6dd399476370fc99305b94e,1,6,6,12,2,2015-02-15 15:27:20,2015-02-10 23:58:16
fef75e46001b3c8cc6dd399476370fc99305b94e...ac7d4eac9eb895886086eb6f0b763147ec7f3b90,1,3,0,3,2,2015-02-15 15:27:20,2015-02-13 16:49:49
ac7d4eac9eb895886086eb6f0b763147ec7f3b90...5363aaf371338880c1f9518a6cc86817cc92d3b9,1,1,1,2,1,2015-02-17 16:36:07,2015-02-17 16:35:30
5363aaf371338880c1f9518a6cc86817cc92d3b9...5189c2d2e386c28b56ce8ae6ba630d98abee25bb,1,12,4,16,1,2015-02-17 17:23:04,2015-02-13 22:04:25
5189c2d2e386c28b56ce8ae6ba630d98abee25bb...ea5f871b550c1c3a8a5f0cd749fb47570557a067,2,2,2,4,2,2015-02-17 18:01:31,2015-02-17 18:01:31
ea5f871b550c1c3a8a5f0cd749fb47570557a067...ecffa7f73a4199848bffd276140781086c6a451d,2,2,2,4,2,2015-02-18 05:44:51,2015-02-18 05:44:51
ecffa7f73a4199848bffd276140781086c6a451d...1ca56b6ce0ddb7bb7b8a8c64b439469c763986a0,1,2,0,2,1,2015-02-19 00:04:56,2015-02-17 21:43:45
1ca56b6ce0ddb7bb7b8a8c64b439469c763986a0...3a83c24b254d79bf17b97b49092bee8fb6caa748,3,80,173,253,25,2015-02-19 00:05:19,2015-02-17 19:38:50
3a83c24b254d79bf17b97b49092bee8fb6caa748...443c1bbf2b0b48bf38aa385d672964fb14f6b758,3,72,14,86,3,2015-02-19 00:05:22,2015-01-29 15:57:42
443c1bbf2b0b48bf38aa385d672964fb14f6b758...77c54935ee0890fb2c00ef84727b0b5ca5a1e9a1,1,17,2,19,2,2015-02-19 00:38:26,2015-02-13 16:21:39
77c54935ee0890fb2c00ef84727b0b5ca5a1e9a1...eaed5ed84ced12f738264ca4645733a5c1db420b,11,379,481,860,165,2015-02-19 16:06:08,2015-02-19 00:55:23
eaed5ed84ced12f738264ca4645733a5c1db420b...74aabd913f3cafb2fd3adbafb2e7ec3d5aa8597e,1,2,2,4,2,2015-02-19 19:00:15,2015-02-19 12:24:08
74aabd913f3cafb2fd3adbafb2e7ec3d5aa8597e...ec116a4be6ca7347fe8688c14aeba3c4d4e40873,47,1103,676,1779,253,2015-02-19 19:00:18,2015-02-19 12:25:04
ec116a4be6ca7347fe8688c14aeba3c4d4e40873...48155657e23069536d15e45f41e734f7c1c87633,1,8,0,8,1,2015-02-19 19:00:28,2015-02-19 18:21:31
48155657e23069536d15e45f41e734f7c1c87633...2a59d43f714ac4b4464dab4158165ea818850f5d,1,23,5,28,2,2015-02-19 19:00:42,2015-02-18 23:26:42
2a59d43f714ac4b4464dab4158165ea818850f5d...adc9db6a803fbe0e2696d994f0eb8e0ae296484d,6,358,54,412,46,2015-02-19 19:55:33,2015-02-18 20:40:32
adc9db6a803fbe0e2696d994f0eb8e0ae296484d...3e03e174fdc6e40c5f69a411293b58387113a06e,3,169,61,230,22,2015-02-20 00:51:05,2015-02-19 17:04:38
3e03e174fdc6e40c5f69a411293b58387113a06e...a162b3564dbfcedc431addf6b543320c26755e6a,30,188,355,543,69,2015-02-20 01:31:23,2015-02-17 23:20:42
a162b3564dbfcedc431addf6b543320c26755e6a...e6577bc37a2edba81b99146934cf7bad00c6e1b2,2,2,2,4,2,2015-02-20 15:41:50,2015-02-20 15:41:50
e6577bc37a2edba81b99146934cf7bad00c6e1b2...c0ab0fb653ddb391d2781a0c4974dbe5787bb0f8,2,2,2,4,2,2015-02-20 21:54:52,2015-02-20 21:54:52
c0ab0fb653ddb391d2781a0c4974dbe5787bb0f8...96315ab194016300a663e61c8ba797d0416c23aa,2,10,10,20,3,2015-02-24 12:29:33,2015-02-24 04:19:20
96315ab194016300a663e61c8ba797d0416c23aa...5868e1f80a25c714973d68fd91471590b5f89e27,76,336,484139,484475,199,2015-02-24 12:37:51,2015-02-24 12:29:38
5868e1f80a25c714973d68fd91471590b5f89e27...b298ab8bf747c160636298f6143e221c6f7ee3fa,2,13,11,24,5,2015-02-24 18:34:48,2015-02-23 17:11:22
b298ab8bf747c160636298f6143e221c6f7ee3fa...54f2c659779bfde7f7891f624d74c1eb01668b39,15,77,79,156,62,2015-02-24 18:34:56,2015-02-23 22:58:21
54f2c659779bfde7f7891f624d74c1eb01668b39...4b61ce0647531fe08807b23f7ef995f002a2c80e,2,2,2,4,2,2015-02-24 18:36:12,2015-02-24 18:36:12
4b61ce0647531fe08807b23f7ef995f002a2c80e...46d1b5fe392bdc46b0c062fc25ac7ee1136ea729,2,2,2,4,2,2015-02-24 23:40:32,2015-02-24 23:40:32
46d1b5fe392bdc46b0c062fc25ac7ee1136ea729...a59debcd8eba42cb844373385cf41b9561b69ab9,15,79,77,156,62,2015-02-25 17:52:51,2015-02-25 17:52:51
a59debcd8eba42cb844373385cf41b9561b69ab9...73f6151ed1070ad0d45d732c2a7e2e2dcdba2592,5,64,0,64,11,2015-02-25 21:17:53,2015-02-24 22:52:24
73f6151ed1070ad0d45d732c2a7e2e2dcdba2592...f4951a12eba1e0cc75adf0422a3654f22eab72a4,5,85,10,95,16,2015-02-25 21:19:18,2015-02-25 20:24:34
f4951a12eba1e0cc75adf0422a3654f22eab72a4...ccb38b6a118809c8df47637d053835555f33d413,2,33,13,46,2,2015-02-25 21:24:07,2015-02-25 15:17:29
ccb38b6a118809c8df47637d053835555f33d413...709cafbbb86c994bc153df189ace58a9c2e4145b,2,2,2,4,2,2015-02-25 21:28:44,2015-02-25 21:28:44
709cafbbb86c994bc153df189ace58a9c2e4145b...7007e0e571b859f3aed79a61c6821cc552fb2685,2,2,2,4,2,2015-02-26 16:12:08,2015-02-26 16:12:08
7007e0e571b859f3aed79a61c6821cc552fb2685...d849d158c195d9f3e43090111306968cc3f435d8,1,14,7,21,5,2015-02-27 16:25:42,2015-02-27 15:14:27
d849d158c195d9f3e43090111306968cc3f435d8...a841fd6394365954886924a35076691b4d149168,2,2,2,4,2,2015-02-27 17:34:18,2015-02-27 17:34:18
a841fd6394365954886924a35076691b4d149168...4c660913fe49b3480b9bbdd3f4ca18937f8f8c99,2,2,2,4,2,2015-03-03 15:19:52,2015-03-03 15:19:52
4c660913fe49b3480b9bbdd3f4ca18937f8f8c99...760211f7b8ab5a1cf3c75994255653530cf12285,1,13,8,21,9,2015-03-03 23:05:55,2015-02-18 16:47:59
760211f7b8ab5a1cf3c75994255653530cf12285...33afe7adf2ea48d8e24489b48828d7a1de1def88,1,1,3,4,1,2015-03-03 23:24:50,2015-02-19 21:57:45
33afe7adf2ea48d8e24489b48828d7a1de1def88...0ebfe3044d7659bcca1fc8ffccb717944f8e02fa,6,112,23,135,25,2015-03-03 23:27:38,2015-02-17 14:11:00
0ebfe3044d7659bcca1fc8ffccb717944f8e02fa...2079db4e4e9f8dea3f84cd28359f4c12be3dd042,1,1,0,1,1,2015-03-03 23:43:42,2015-02-23 15:28:36
2079db4e4e9f8dea3f84cd28359f4c12be3dd042...95f9c37168148ea948072b886a849f9fed071ea6,1,25,3,28,3,2015-03-03 23:49:49,2015-02-23 19:51:24
95f9c37168148ea948072b886a849f9fed071ea6...afc23f0987033e10ddd91317a31ecdcce6febed9,1,4,0,4,2,2015-03-03 23:53:50,2015-02-24 18:22:41
afc23f0987033e10ddd91317a31ecdcce6febed9...ee7ed05f30de291f759540923d98d5c932710f63,1,1,1,2,1,2015-03-04 00:02:17,2015-02-26 20:58:44
ee7ed05f30de291f759540923d98d5c932710f63...0772a988f3562c9315883b8a439d815dd7bdb34d,2,11,1,12,2,2015-03-04 00:06:04,2015-02-27 14:28:45
0772a988f3562c9315883b8a439d815dd7bdb34d...3683face3a6a4b03c8d55aef421c91b23f035d49,1,2,2,4,2,2015-03-04 00:08:22,2015-02-13 16:34:59
3683face3a6a4b03c8d55aef421c91b23f035d49...7e911dbd1227ebfde692b680a498835798d6e88d,4,43,35,78,12,2015-03-04 15:56:39,2015-02-19 15:25:09
7e911dbd1227ebfde692b680a498835798d6e88d...3d2e6a86bbd884b1723b5dda1c8a1d2e32015174,8,87,40,127,26,2015-03-04 15:59:53,2015-02-27 21:05:25
3d2e6a86bbd884b1723b5dda1c8a1d2e32015174...286bb637c6056074ae6f84d21c4e4b779d15b1a8,2,11,11,22,3,2015-03-04 16:56:22,2015-02-24 20:47:11
286bb637c6056074ae6f84d21c4e4b779d15b1a8...19c0e49b420b5750186ceeabcaa1d0e6f1932106,3,12,5,17,5,2015-03-04 17:18:04,2015-03-02 21:23:27
19c0e49b420b5750186ceeabcaa1d0e6f1932106...d84943152aa80f3a968d2bd8c3ba600831d3ba8f,1,1,3,4,1,2015-03-04 17:22:46,2015-02-25 22:12:01
d84943152aa80f3a968d2bd8c3ba600831d3ba8f...99e380a56e6ad8072b7a4bed472845e675244ca0,12,408,15,423,23,2015-03-04 17:25:26,2015-02-19 22:26:39
99e380a56e6ad8072b7a4bed472845e675244ca0...691f4cdef6107e07a7b85813ef3344a8b84494c1,3,52,19,71,5,2015-03-04 17:25:36,2015-02-24 20:12:00
691f4cdef6107e07a7b85813ef3344a8b84494c1...8cdaf12395d0efeb6bb5ca6be903bcee33fda65c,1,3,2,5,3,2015-03-04 17:25:43,2015-02-25 20:48:45
8cdaf12395d0efeb6bb5ca6be903bcee33fda65c...4c5650f4ce2943693fcc7a939ba69679675116c4,3,29,5,34,7,2015-03-04 17:27:03,2015-03-03 20:07:06
4c5650f4ce2943693fcc7a939ba69679675116c4...8f6875ad4edca37187cf7febd4dc5fe7852f3812,1,1,1,2,1,2015-03-04 17:27:13,2015-03-04 14:31:32
8f6875ad4edca37187cf7febd4dc5fe7852f3812...7a079105cb1bf18359c1f4e87ad27e502db7b54f,1,17,1,18,2,2015-03-04 17:27:19,2015-02-23 21:31:40
7a079105cb1bf18359c1f4e87ad27e502db7b54f...e1adb14bb593e22203d82018f4ba78c77aa289b3,2,18,8,26,8,2015-03-04 17:43:52,2015-02-26 20:42:15
e1adb14bb593e22203d82018f4ba78c77aa289b3...da80f73c9d210b04ac0161758fa6e85f1e0613d5,2,11,0,11,3,2015-03-04 18:24:39,2015-03-03 20:19:45
da80f73c9d210b04ac0161758fa6e85f1e0613d5...52f14907a736383969a05df51808c93307255ef2,1,56,55,111,19,2015-03-04 21:21:53,2015-02-26 11:18:34
52f14907a736383969a05df51808c93307255ef2...9c338fb99a783fc9f359e1fd94a09eeae104514f,1,2,1,3,1,2015-03-04 21:22:00,2015-03-03 09:16:34
9c338fb99a783fc9f359e1fd94a09eeae104514f...a5fe81ada8f73b75fd53c12cecea375626a7bc0f,1,6,2,8,2,2015-03-04 21:22:05,2015-03-03 09:21:32
a5fe81ada8f73b75fd53c12cecea375626a7bc0f...63d223057c097a7324977adbb7a7d7e04ba4ac74,1,1,1,2,1,2015-03-05 20:11:34,2015-03-04 13:47:41
63d223057c097a7324977adbb7a7d7e04ba4ac74...1f27066186e908dbdcad34f857b0b115219e8c40,141,124610,0,124610,141,2015-03-05 20:18:02,2015-02-19 16:43:25
1f27066186e908dbdcad34f857b0b115219e8c40...d101f2d09375b594a3d6051271decd565d389a81,1,5,2,7,1,2015-03-05 20:18:03,2015-02-19 23:14:52
d101f2d09375b594a3d6051271decd565d389a81...168a9669cadf76e8ee7d0bb187c96a2efbad8bc9,5,825,1,826,6,2015-03-05 20:18:03,2015-02-20 15:56:24
168a9669cadf76e8ee7d0bb187c96a2efbad8bc9...0c40d5b4610a595274800ee4f34dc16e87ed3175,1,7,7,14,7,2015-03-05 20:18:03,2015-03-05 05:27:27
0c40d5b4610a595274800ee4f34dc16e87ed3175...8e0034e8260fbf82e0a63e8159ecb17b58b498d7,1,1,1,2,1,2015-03-05 22:40:33,2015-03-05 03:12:13
8e0034e8260fbf82e0a63e8159ecb17b58b498d7...0cbcdfd5b4cd4961b448f1a35fd0d4ea19629b93,3,76,7,83,19,2015-03-05 22:58:04,2015-02-17 17:40:39
0cbcdfd5b4cd4961b448f1a35fd0d4ea19629b93...7acc227640803a2ae3f391205bb448551db60837,2,23,7,30,11,2015-03-09 15:06:13,2015-03-06 14:16:49
7acc227640803a2ae3f391205bb448551db60837...fead7c0c8fd50fd0587506f6003a00376c1097d1,10,177,87,264,14,2015-03-09 15:06:25,2015-03-05 23:35:22
fead7c0c8fd50fd0587506f6003a00376c1097d1...c91ed2ab70207f293d8fffac1563a9dd1cd8eaa4,51,1380,474,1854,299,2015-03-09 15:06:35,2015-03-09 15:02:22
c91ed2ab70207f293d8fffac1563a9dd1cd8eaa4...5d6f18e12ce82f72478722f240af91fe624a87b9,20,691,8,699,24,2015-03-09 15:16:11,2015-01-22 18:21:02
5d6f18e12ce82f72478722f240af91fe624a87b9...5c5b5b0a794490314b0b01db27ade099a1f49fcd,2,6,24,30,3,2015-03-09 15:16:40,2015-02-26 20:18:29
5c5b5b0a794490314b0b01db27ade099a1f49fcd...618eb359064fe06ab11487ac5cc1394879c1216b,2,82,9,91,8,2015-03-09 17:38:22,2015-02-26 16:22:34
618eb359064fe06ab11487ac5cc1394879c1216b...773016d51c248efae78266a227383100b663cca1,1,3620,0,3620,1,2015-03-09 18:53:24,2015-03-06 18:57:30
773016d51c248efae78266a227383100b663cca1...5e19cde316e4493dc2548d239cdf7763683e7897,1,2,0,2,1,2015-03-09 19:17:40,2015-03-09 16:45:29
5e19cde316e4493dc2548d239cdf7763683e7897...a56f29e60d872bb6334a24dd732d500b3ae52b48,3,111,0,111,3,2015-03-09 20:20:22,2015-03-09 17:12:17
a56f29e60d872bb6334a24dd732d500b3ae52b48...568052f3aa85a803fbced9b848688892fdbe0290,15,40,67,107,37,2015-03-09 21:28:24,2015-03-09 17:24:07
568052f3aa85a803fbced9b848688892fdbe0290...d6b7c2351e47992bf350131c2b60e15644ce4b69,2,22,7,29,3,2015-03-09 21:28:25,2015-03-09 17:25:06
d6b7c2351e47992bf350131c2b60e15644ce4b69...747e066e97ec42cab358d9b0b328257e997b74b9,87,1783,149,1932,135,2015-03-09 22:30:32,2015-01-05 14:47:07
747e066e97ec42cab358d9b0b328257e997b74b9...dc05f6ef8412fa9fbfae09902a5e35eeaaa3ca14,1,1,1,2,1,2015-03-09 23:08:09,2015-03-09 23:07:24
dc05f6ef8412fa9fbfae09902a5e35eeaaa3ca14...95d9052efa2111bd1dc902122ff8d2817c08f0e8,1,12,0,12,6,2015-03-09 23:22:21,2015-03-09 21:30:21
95d9052efa2111bd1dc902122ff8d2817c08f0e8...aa0d74203b5fcc43425e08af12cf27542be7c10a,2,72,1,73,3,2015-03-10 03:58:33,2015-03-09 21:34:54
aa0d74203b5fcc43425e08af12cf27542be7c10a...cd340fc70c2885c35b6e56b11dbcf7aaca011085,2,9,0,9,2,2015-03-10 03:59:25,2015-03-10 03:34:35
cd340fc70c2885c35b6e56b11dbcf7aaca011085...37fd2853903bf26384a31a0d81e8d5a89546648e,1,0,0,0,0,2015-03-10 04:05:47,2015-03-10 04:03:10
37fd2853903bf26384a31a0d81e8d5a89546648e...a1da51e735e050a2a7cf4806d5e5e133a5d16d9d,1,6,5,11,5,2015-03-10 15:50:35,2015-03-10 15:49:12
a1da51e735e050a2a7cf4806d5e5e133a5d16d9d...887a25d0b9f37337971567d75a28f7284f49cf49,1,31,19,50,2,2015-03-10 16:35:36,2015-03-09 17:36:51
887a25d0b9f37337971567d75a28f7284f49cf49...085ad3aa18938262a6664ccda6b5fad509c1f68e,2,2,2,4,2,2015-03-10 19:21:11,2015-03-10 19:21:11
085ad3aa18938262a6664ccda6b5fad509c1f68e...729f6efc13969d3eef84ec080df4418c4b784645,2,2,2,4,2,2015-03-10 21:29:23,2015-03-10 21:29:23
729f6efc13969d3eef84ec080df4418c4b784645...3f999d764cdd307f779b27e3a28230b21bd43e25,2,2,2,4,2,2015-03-10 21:30:00,2015-03-10 21:30:00
3f999d764cdd307f779b27e3a28230b21bd43e25...c98d8fcb2f8c1bef9d278c27c7347da5ff0d5d13,2,2,2,4,2,2015-03-10 21:49:22,2015-03-10 21:49:22
c98d8fcb2f8c1bef9d278c27c7347da5ff0d5d13...51155cf3524b8faa5736cb16a29e54ac19bf045c,1,6,6,12,6,2015-03-11 17:01:03,2015-03-11 12:33:57
51155cf3524b8faa5736cb16a29e54ac19bf045c...4d4986d841968661f876a188d1fcca0b6134dda7,2,27,3,30,4,2015-03-13 15:57:25,2015-03-10 00:31:11
4d4986d841968661f876a188d1fcca0b6134dda7...534b5a3f9d10f00cd27737fbcd951032248b5952,2,2,2,4,2,2015-03-16 15:08:50,2015-03-16 15:08:50
534b5a3f9d10f00cd27737fbcd951032248b5952...c5942aac0e480f73a8de26b5c73760b87c934d51,2,2,2,4,2,2015-03-16 21:06:14,2015-03-16 21:06:14
dadbe696a8dc603a5014068f8b63eee17e259ff0...54edc490c9c44533717caefb5e8eea8661af2f45,1,17,3,20,5,2015-01-23 00:33:56,2015-01-22 23:13:01
54edc490c9c44533717caefb5e8eea8661af2f45...2455fe18001a96baf3bfca7dd600d80672b1f0ef,2,2,2,4,2,2015-01-23 00:39:08,2015-01-23 00:36:26
2455fe18001a96baf3bfca7dd600d80672b1f0ef...616bc35c6f7ca8b66b531e4086863697e01a0181,1,3,1,4,1,2015-01-23 16:01:19,2015-01-23 15:57:08
616bc35c6f7ca8b66b531e4086863697e01a0181...c3413d543ca676ffe55209507c83cebc6be841b1,1,80,51,131,11,2015-01-23 16:24:31,2015-01-22 23:50:17
c3413d543ca676ffe55209507c83cebc6be841b1...8e2052f745ffaa1cf15ff79e6661b5cf72633a0a,1,42,8,50,6,2015-01-23 16:24:31,2015-01-23 00:06:05
8e2052f745ffaa1cf15ff79e6661b5cf72633a0a...4f510d62cbf9201291910887ee733bde4d7877a1,4,64,60,124,46,2015-01-23 16:53:26,2015-01-23 15:32:09
4f510d62cbf9201291910887ee733bde4d7877a1...6741cd5a468657490a346366ba353fdc860445fe,1,20,13,33,3,2015-01-23 16:56:34,2015-01-22 21:14:20
6741cd5a468657490a346366ba353fdc860445fe...d96cd52a4818329f8e7199707a4574c04ba7ba58,1,8,3,11,4,2015-01-23 16:56:35,2015-01-22 21:14:52
d96cd52a4818329f8e7199707a4574c04ba7ba58...7cb3be1c8c35b6f3b7903a3a2efa64b1468fd514,7,874,580,1454,25,2015-01-23 17:09:16,2015-01-17 00:20:59
7cb3be1c8c35b6f3b7903a3a2efa64b1468fd514...0637e0ab83b0c18453f9024edb0dec34ae67f35a,1,29,4,33,3,2015-01-23 19:01:01,2015-01-23 19:01:01
0637e0ab83b0c18453f9024edb0dec34ae67f35a...d8628625507b7a6927f21b1f1f91d68201fe4030,4,164,21,185,17,2015-01-23 19:32:08,2015-01-22 17:10:53
d8628625507b7a6927f21b1f1f91d68201fe4030...030f3710a74295707c5a0a788035005cb5013ab7,1,38,27,65,10,2015-01-23 20:56:51,2015-01-23 20:56:51
030f3710a74295707c5a0a788035005cb5013ab7...2cc831c713e0f68a41dbf2a9024e0de948b37a6f,1,3,2,5,3,2015-01-23 20:59:32,2015-01-23 20:50:39
2cc831c713e0f68a41dbf2a9024e0de948b37a6f...3fbfd30b69d2cecbf5ba9125853ef74e728d9e7f,1,3,0,3,3,2015-01-23 21:19:21,2015-01-23 20:53:07
3fbfd30b69d2cecbf5ba9125853ef74e728d9e7f...dd22b3fdb2cbcc95595b49e95da83b0ff498f95b,3,55,45,100,13,2015-01-23 21:53:12,2015-01-23 21:53:12
dd22b3fdb2cbcc95595b49e95da83b0ff498f95b...5f3fa2e77537d1be650af981effa2e66dc86e10d,5,81,40,121,4,2015-01-23 22:03:07,2015-01-20 20:28:26
5f3fa2e77537d1be650af981effa2e66dc86e10d...9d2231e04c4076f62e41cbe5029bcd4a69bc7cf0,1,0,4,4,1,2015-01-23 23:15:06,2015-01-23 23:15:06
9d2231e04c4076f62e41cbe5029bcd4a69bc7cf0...106385c21ec92a7b98bd3be498b4f2ef02fd21fa,3,45,55,100,13,2015-01-24 05:20:50,2015-01-24 05:20:50
106385c21ec92a7b98bd3be498b4f2ef02fd21fa...8bb811a0ace89671c6011085706a1e3449409635,1,2,4,6,4,2015-01-26 15:57:46,2015-01-26 15:54:48
8bb811a0ace89671c6011085706a1e3449409635...c4ec7db6ce25e7147ae5f46ac0a7f6a52a0b4c3e,6,44,22,66,13,2015-01-26 16:35:07,2015-01-26 15:58:07
c4ec7db6ce25e7147ae5f46ac0a7f6a52a0b4c3e...78390e4da7e48532194cba623c55d566bc09cc70,3,123,1,124,12,2015-01-26 16:35:16,2015-01-22 20:51:11
78390e4da7e48532194cba623c55d566bc09cc70...fe3e92d4257b30f01b62d4ef941686b7e0138a8c,13,216,269,485,110,2015-01-26 17:34:07,2015-01-21 20:03:02
fe3e92d4257b30f01b62d4ef941686b7e0138a8c...ba5548fb1c0b78d34333af049a00ea4965362e3b,1,35,24,59,11,2015-01-26 17:40:21,2015-01-23 21:17:06
ba5548fb1c0b78d34333af049a00ea4965362e3b...5e6ab7e206e72e69603c8ac8a6b77c3e5f4637d3,1,6,15,21,2,2015-01-26 17:40:22,2015-01-23 22:31:15
5e6ab7e206e72e69603c8ac8a6b77c3e5f4637d3...86cbecf2dfe16d89fc50d54f1ac4c8655878be6c,1,21,10,31,3,2015-01-26 17:40:22,2015-01-23 22:31:39
86cbecf2dfe16d89fc50d54f1ac4c8655878be6c...cc75adbbc5da7ba8f5d6046102f8226bb9e3d96b,3,48,52,100,16,2015-01-26 17:40:22,2015-01-23 23:12:42
cc75adbbc5da7ba8f5d6046102f8226bb9e3d96b...a6ddf1762548e641930288d77d8910c30bb7cbb4,1,4,4,8,3,2015-01-26 20:32:38,2015-01-26 15:21:46
a6ddf1762548e641930288d77d8910c30bb7cbb4...50b8028f9d4c2092c76249c4f6e2c94f27b5b0c6,1,1,1,2,1,2015-01-26 21:10:27,2015-01-26 21:09:23
50b8028f9d4c2092c76249c4f6e2c94f27b5b0c6...1f394a5db22c782e88f24db8c0d5267f89f0efc8,6,249,14,263,29,2015-01-26 21:39:34,2015-01-26 21:39:34
1f394a5db22c782e88f24db8c0d5267f89f0efc8...c30688f704e3fbde4ee83aa2f45a6d79900f10c9,1,1,1,2,1,2015-01-26 21:42:13,2015-01-26 21:01:16
c30688f704e3fbde4ee83aa2f45a6d79900f10c9...3a6d045a2a1ab37223facb73378e9cbc02c5c6c9,1,64,62,126,9,2015-01-26 22:31:22,2015-01-26 22:31:22
3a6d045a2a1ab37223facb73378e9cbc02c5c6c9...bd4956d96e195e7a0072fd87e3793e4f442f92af,1,4,3,7,1,2015-01-26 23:09:23,2015-01-26 23:09:23
bd4956d96e195e7a0072fd87e3793e4f442f92af...084109075e885bb967addd0b7ed929791a4eaea6,1,7,3,10,3,2015-01-26 23:45:57,2015-01-26 18:27:19
084109075e885bb967addd0b7ed929791a4eaea6...dcfc58256d43a0b9be3c697c444d0ca36084cced,4,57,18,75,19,2015-01-26 23:45:58,2015-01-26 20:12:50
dcfc58256d43a0b9be3c697c444d0ca36084cced...9b1392162e0f7564cfc3b1634ab78ec1a7f7c871,1,0,7,7,1,2015-01-26 23:49:29,2015-01-26 22:57:33
9b1392162e0f7564cfc3b1634ab78ec1a7f7c871...2bde42b58c09c90aaf529f6bedea9c1bd76e91dd,1,1,1,2,2,2015-01-27 04:09:37,2015-01-27 03:42:56
2bde42b58c09c90aaf529f6bedea9c1bd76e91dd...ae258579edb7a9c6185a515bff5b57f8e80d0088,1,1,0,1,1,2015-01-27 05:57:56,2015-01-27 05:57:56
ae258579edb7a9c6185a515bff5b57f8e80d0088...e926b20df8bcb14985817d2b37c61e2f8889fb27,39,509,317,826,203,2015-01-27 10:48:08,2015-01-27 10:48:08
e926b20df8bcb14985817d2b37c61e2f8889fb27...373b844920028ac35815f99172ac95684e5e2be8,1,22,2,24,5,2015-01-27 14:29:55,2015-01-22 20:08:01
373b844920028ac35815f99172ac95684e5e2be8...476be2a540af944ba49532b5b517d5759e10fc64,6,147,124,271,29,2015-01-27 16:26:11,2015-01-27 15:10:22
476be2a540af944ba49532b5b517d5759e10fc64...107e3bfcd71936a876231517ee52aa6ca80b7e1d,3,15,10,25,11,2015-01-27 17:00:10,2015-01-27 14:57:45
107e3bfcd71936a876231517ee52aa6ca80b7e1d...6fdd15e3e68c53d555ddd40402aefd156507b6a8,5,5,0,5,5,2015-01-27 17:54:25,2015-01-27 16:40:29
6fdd15e3e68c53d555ddd40402aefd156507b6a8...84ce3fb4c2e1333a9f3876c1a65f275c631d5fcf,1,16,12,28,6,2015-01-27 18:33:17,2015-01-27 17:16:14
84ce3fb4c2e1333a9f3876c1a65f275c631d5fcf...d38932a62ee31f5febab67f37d8aaff323d1e30b,1,12,4,16,7,2015-01-27 19:03:16,2015-01-27 18:39:52
d38932a62ee31f5febab67f37d8aaff323d1e30b...c91e229849d0ccae92a51ebed6b7c2849ba2d03b,4,11,15,26,10,2015-01-27 19:22:25,2015-01-27 19:09:22
c91e229849d0ccae92a51ebed6b7c2849ba2d03b...8b28519a23a627dc06f335a81c79f972964e2ab7,1,2,2,4,3,2015-01-27 15:45:28,2015-01-27 15:29:02
8b28519a23a627dc06f335a81c79f972964e2ab7...a289b4ae72fadd951fb548efd0563c1ab7a95180,1,1,1,2,1,2015-01-27 16:17:47,2015-01-27 16:06:03
a289b4ae72fadd951fb548efd0563c1ab7a95180...48c92cdcf0847199b283ba9afbdd721a324eb73f,1,4,4,8,2,2015-01-27 22:28:00,2015-01-27 19:55:02
48c92cdcf0847199b283ba9afbdd721a324eb73f...52cb5849d531ba16d7fe6a102abb0e6da676a68f,2,13,0,13,3,2015-01-27 22:33:01,2015-01-27 21:50:49
52cb5849d531ba16d7fe6a102abb0e6da676a68f...0214774a1899a293efe0b3c682495886c24e9edd,7,37,10,47,16,2015-01-27 23:06:12,2015-01-27 22:57:01
0214774a1899a293efe0b3c682495886c24e9edd...70c51f2644cd56678748fbe877e987903f86f3ab,1,2,1,3,2,2015-01-27 23:31:52,2015-01-23 22:30:27
70c51f2644cd56678748fbe877e987903f86f3ab...d0e977f7310a1befaa48ffb9edee71e9fc004421,2,6,6,12,3,2015-01-27 23:31:52,2015-01-27 21:09:24
d0e977f7310a1befaa48ffb9edee71e9fc004421...0126c434740e1d659ec252685e57c90b98b4b54f,2,3,4,7,3,2015-01-28 00:12:40,2015-01-23 22:34:01
0126c434740e1d659ec252685e57c90b98b4b54f...9134f4c4f376dc60a389b0d7f385802a49867bbe,6,13,45,58,14,2015-01-28 00:12:40,2015-01-27 23:57:31
9134f4c4f376dc60a389b0d7f385802a49867bbe...82daa0725d7f26bd7ccaf7e4280932ad548f549c,1,1,7,8,1,2015-01-28 00:12:40,2015-01-28 00:07:00
82daa0725d7f26bd7ccaf7e4280932ad548f549c...8299d7435855820d16b25f4a66b572ddf6a11cf5,4,252,62,314,24,2015-01-28 00:24:34,2015-01-27 23:52:48
8299d7435855820d16b25f4a66b572ddf6a11cf5...bbd95ca6a8b538b4cffece0b9d9c3ed811a455a7,23,222,75,297,74,2015-01-28 03:51:22,2015-01-28 02:17:02
bbd95ca6a8b538b4cffece0b9d9c3ed811a455a7...746d9b99a8dc0301c1593bd4dc62fc8433435c7e,4,32,8,40,8,2015-01-28 08:30:51,2015-01-28 08:30:51
746d9b99a8dc0301c1593bd4dc62fc8433435c7e...091f56d3b73453197acfca1f074aa5eab0c49ab6,6,19,7,26,9,2015-01-28 10:47:07,2015-01-27 15:55:40
091f56d3b73453197acfca1f074aa5eab0c49ab6...83681b826fbe4da459924536f037dfa652eea543,2,4,4,8,4,2015-01-28 16:56:01,2015-01-28 16:56:01
83681b826fbe4da459924536f037dfa652eea543...9da40029fef37df8d33218101ffa2ff22d94a2da,1,1,1,2,1,2015-01-28 17:06:26,2015-01-28 16:42:18
9da40029fef37df8d33218101ffa2ff22d94a2da...ac9ee2fb80f2afc2737a0d9f346cff8117a82af2,1,6,0,6,1,2015-01-28 17:06:26,2015-01-28 17:06:13
ac9ee2fb80f2afc2737a0d9f346cff8117a82af2...f462f1d2441f503f5d0fb0e04ed4684a75452c87,2,2,2,4,2,2015-01-28 19:53:48,2015-01-28 19:45:41
f462f1d2441f503f5d0fb0e04ed4684a75452c87...11c4de9946fbf466a7c70d4a7f4fce2638fa2e86,2,7,2,9,3,2015-01-29 16:21:43,2015-01-29 15:01:11
11c4de9946fbf466a7c70d4a7f4fce2638fa2e86...7e1ae18a448334d4e348da3f0ecf426ec622b4f7,1,8,1,9,2,2015-01-29 16:21:43,2015-01-29 15:07:30
7e1ae18a448334d4e348da3f0ecf426ec622b4f7...94cb08d1d1a14733ebe875f941f4ec1eb8a44b91,10,141,177,318,57,2015-01-29 16:44:16,2015-01-29 16:44:16
94cb08d1d1a14733ebe875f941f4ec1eb8a44b91...8e11987b6f7f393bbf1c468f7626d2a4993ae0cb,1,4,0,4,1,2015-01-30 15:06:35,2015-01-30 15:06:35
8e11987b6f7f393bbf1c468f7626d2a4993ae0cb...ca12273ba6876c4239c824bbe83a27bd328b051f,14,2773,1562,4335,555,2015-01-30 23:18:58,2015-01-30 21:44:56
ca12273ba6876c4239c824bbe83a27bd328b051f...51ae76922e18a097e4ec89aa0a65a1d6a9a51cef,3,11,8,19,8,2015-01-31 05:01:16,2015-01-31 05:01:16
51ae76922e18a097e4ec89aa0a65a1d6a9a51cef...87f1334585928a2b86407f68ecb6b35c62855b24,2,10,0,10,2,2015-02-02 19:17:55,2015-02-02 18:45:53
87f1334585928a2b86407f68ecb6b35c62855b24...d46a5c78c0d046f1975aca2eaa7f055a713c720f,57,302,217,519,155,2015-02-02 20:40:16,2015-02-02 20:39:22
d46a5c78c0d046f1975aca2eaa7f055a713c720f...eb6c0e27804d81d326e8aa2f42569b82f027ed00,1,1,0,1,1,2015-02-02 21:09:27,2015-02-02 21:09:27
eb6c0e27804d81d326e8aa2f42569b82f027ed00...37c51fa184f5439bed7a3ce157ea11fad1303177,1,1,1,2,1,2015-02-02 21:56:56,2015-02-02 21:56:56
37c51fa184f5439bed7a3ce157ea11fad1303177...1e93bc47d0e9e4c75f0d64b507916767bbaee0b9,1,66,0,66,1,2015-02-03 14:58:13,2015-02-02 21:07:52
1e93bc47d0e9e4c75f0d64b507916767bbaee0b9...4b4c7bcc0880f079868209c58a2da86dad645c1b,3,19,4,23,7,2015-02-03 14:58:28,2015-02-02 21:32:36
4b4c7bcc0880f079868209c58a2da86dad645c1b...588770c7575f10cb1321aa616b4cc4d89f502c2f,1,4,4,8,2,2015-02-03 15:04:05,2015-02-03 15:03:21
588770c7575f10cb1321aa616b4cc4d89f502c2f...acb211cf14ec8ee524b450e5c914080d516b1c47,1,2,0,2,2,2015-02-03 17:16:34,2015-02-03 17:16:34
acb211cf14ec8ee524b450e5c914080d516b1c47...da92a96cecad44341d649dc8f893055b64f17c9d,1,7,9,16,6,2015-02-03 18:52:38,2015-01-30 22:32:19
da92a96cecad44341d649dc8f893055b64f17c9d...78a0cc02d5868ea3d03ae104dce6b2908fb63e59,1,47,0,47,1,2015-02-03 18:52:38,2015-01-30 22:33:03
78a0cc02d5868ea3d03ae104dce6b2908fb63e59...67b1c6da115b8809752a9b966eed2e9fbeb21db3,4,50,36,86,18,2015-02-03 18:52:38,2015-02-03 13:10:52
67b1c6da115b8809752a9b966eed2e9fbeb21db3...0e523eec39056da5b0dfb3826bbe27b4f376deb6,4,61,5,66,7,2015-02-03 19:03:48,2015-02-02 22:32:30
0e523eec39056da5b0dfb3826bbe27b4f376deb6...3e411144a9bfb4b08d98cd26a778453e04e92a0e,3,30,8,38,11,2015-02-03 22:11:30,2015-02-02 19:27:01
3e411144a9bfb4b08d98cd26a778453e04e92a0e...51fdd6114daa0cfb5c27a2d0116f05ceae8ad211,4,108,9,117,15,2015-02-03 23:26:38,2015-01-30 20:06:56
51fdd6114daa0cfb5c27a2d0116f05ceae8ad211...6015a7b55ce7216ed9d511cf3b363dc8af5d96be,1,29,1,30,4,2015-02-03 23:32:13,2015-01-30 18:08:26
6015a7b55ce7216ed9d511cf3b363dc8af5d96be...e54a9667115b91aab0b815abe7362f197a79a52d,7,28,56,84,17,2015-02-03 23:32:13,2015-01-29 23:58:11
e54a9667115b91aab0b815abe7362f197a79a52d...5e128ddad3f15639c1719008bb041c21b2600769,5,46,15,61,21,2015-02-03 23:32:13,2015-02-03 16:02:54
5e128ddad3f15639c1719008bb041c21b2600769...4afdce1f9b8e6a5b79fbb7e6c87f53802628e5c5,5,74,38,112,31,2015-02-03 23:44:23,2015-02-02 17:43:43
4afdce1f9b8e6a5b79fbb7e6c87f53802628e5c5...f67e39825ac93c0915db0192d7a35b3d73834388,1,4,1,5,1,2015-02-03 23:56:31,2015-02-03 23:50:51
f67e39825ac93c0915db0192d7a35b3d73834388...fc14926f9c8256edce8bbd15d439ca34667c6ebb,2,73,61,134,18,2015-02-03 23:56:32,2015-02-03 23:53:13
fc14926f9c8256edce8bbd15d439ca34667c6ebb...7d9ec251cf0e70bc0f9bb246aacfb6e62226ad37,50,703,605,1308,246,2015-02-04 11:55:52,2015-02-04 11:48:51
7d9ec251cf0e70bc0f9bb246aacfb6e62226ad37...7d3d0e5c6ae4f6054d63a208f74e58fe26b65cf9,2,33,3,36,3,2015-02-04 17:11:22,2015-02-04 14:48:44
7d3d0e5c6ae4f6054d63a208f74e58fe26b65cf9...30c0fd907f5279786c0eb6958bb61039697c5c29,4,39,2,41,10,2015-02-04 18:40:35,2015-02-03 20:35:51
30c0fd907f5279786c0eb6958bb61039697c5c29...5ee9c2eafe66f72c1f5d28a764bd729aa24be472,2,4,2,6,2,2015-02-04 21:33:35,2015-02-04 21:29:56
5ee9c2eafe66f72c1f5d28a764bd729aa24be472...1e58c0374677a37c09438aa8c21d745cd5b08468,10,120,11,131,34,2015-02-05 05:18:34,2015-02-03 22:13:01
1e58c0374677a37c09438aa8c21d745cd5b08468...a69a41ea75eed2614b8210ded8265fd28e2b872c,2,30,6,36,5,2015-02-05 05:23:48,2015-02-04 19:49:51
a69a41ea75eed2614b8210ded8265fd28e2b872c...5936e08901898c8c8cc3e31de96cfe4264c171c6,4,141,9,150,11,2015-02-05 15:24:24,2015-02-04 15:22:40
5936e08901898c8c8cc3e31de96cfe4264c171c6...9399c2c04c0fcfa3ab1b2150c62ff75682d116a2,1,4,12,16,2,2015-02-05 11:06:05,2015-01-29 16:53:45
9399c2c04c0fcfa3ab1b2150c62ff75682d116a2...d4ab26fcfb6d4dc64d7067fd0b5ba08090cf5c59,1,32,0,32,7,2015-02-05 16:29:31,2015-02-04 22:29:57
d4ab26fcfb6d4dc64d7067fd0b5ba08090cf5c59...5ed91cbddad7e9f1ee45220591257dc292432df8,1,0,66,66,1,2015-02-05 16:35:46,2015-02-05 16:34:20
5ed91cbddad7e9f1ee45220591257dc292432df8...5fb4ae8a91928f607a7edb2ce60e0396eefacf9d,1,0,7,7,1,2015-02-05 18:07:14,2015-01-27 22:40:22
5fb4ae8a91928f607a7edb2ce60e0396eefacf9d...0629650fd4ad37d3c1d4150914b4ed5704e8209d,1,0,13,13,1,2015-02-05 18:08:11,2015-01-27 22:58:37
0629650fd4ad37d3c1d4150914b4ed5704e8209d...00f28d5b4df029f37796313fb1296b3d2326deeb,1,71,0,71,1,2015-02-05 18:08:35,2015-02-02 19:32:08
00f28d5b4df029f37796313fb1296b3d2326deeb...68fe6570d19c744f84861b70d541e8b46ac24935,2,21,0,21,3,2015-02-05 18:43:54,2015-02-03 18:34:47
68fe6570d19c744f84861b70d541e8b46ac24935...93e72f29f5d58dff1229c8db9db62b4f02324117,14,46,101,147,41,2015-02-05 18:53:16,2015-02-03 23:40:35
93e72f29f5d58dff1229c8db9db62b4f02324117...5145903fc270db94e6a4cbfd5c956026a107e079,2,34,0,34,2,2015-02-05 20:17:07,2015-02-05 15:50:29
5145903fc270db94e6a4cbfd5c956026a107e079...c59a144b57d07d7310dc23ad9cc78a1618f37237,2,13,6,19,3,2015-02-05 21:05:44,2015-01-26 20:08:43
c59a144b57d07d7310dc23ad9cc78a1618f37237...aa352eab214771b8cb239a9056f8899e73cf9819,1,11,7,18,4,2015-02-05 21:09:29,2015-02-05 21:09:20
aa352eab214771b8cb239a9056f8899e73cf9819...f6a65290f22f126b8a2eb616f800582c5c43b6c8,88,1790,149,1939,138,2015-02-05 21:14:37,2015-01-05 14:47:07
f6a65290f22f126b8a2eb616f800582c5c43b6c8...7e56794200bbbe2494c21a2f594734cb94d90d64,1,2,1,3,2,2015-02-05 21:30:27,2015-02-03 22:07:56
7e56794200bbbe2494c21a2f594734cb94d90d64...8b6c594ca13a689c65c29a645ae6f4af97b1f9bd,2,19,14,33,4,2015-02-06 16:20:50,2015-02-06 16:06:09
8b6c594ca13a689c65c29a645ae6f4af97b1f9bd...8f706010430b4a12b99add9eb8c96152c64dd580,1,8,2,10,2,2015-02-06 16:56:45,2015-02-06 15:38:38
8f706010430b4a12b99add9eb8c96152c64dd580...7eb9c853416d123773e620cd16491856891d2ff0,1,180,38,218,25,2015-02-06 17:03:40,2015-02-03 18:54:31
7eb9c853416d123773e620cd16491856891d2ff0...8c72cdbea2a3c15e67c4f53cd54ec38510e7080c,1,296,63,359,25,2015-02-06 18:17:01,2015-02-02 14:40:25
8c72cdbea2a3c15e67c4f53cd54ec38510e7080c...c8e315735caa0b98179a5e6351cbcd0e16c134a6,3,191,88,279,16,2015-02-06 18:20:42,2015-02-06 15:12:20
c8e315735caa0b98179a5e6351cbcd0e16c134a6...dc1c7f5031ebd3b4419ec6463b03ce7698128a13,1,231,0,231,1,2015-02-06 18:44:58,2015-02-03 16:28:15
dc1c7f5031ebd3b4419ec6463b03ce7698128a13...6dff6041e21ca40a49a47827b90df2db6503e7fa,1,1,1,2,1,2015-02-06 18:59:07,2015-01-23 19:52:47
6dff6041e21ca40a49a47827b90df2db6503e7fa...ce248a28f94537e9b2089ae42d71c71aaa888358,1,73,18,91,3,2015-02-06 19:09:15,2015-01-27 18:12:21
ce248a28f94537e9b2089ae42d71c71aaa888358...7a26b37a5b616c78766d024607288bf3c23afe1d,1,4,5,9,2,2015-02-06 19:36:50,2015-02-06 18:56:14
7a26b37a5b616c78766d024607288bf3c23afe1d...4b76683b38843f8d9b9b860c15d21d0870069b5c,1,17,27,44,1,2015-02-06 19:42:16,2015-02-06 19:42:16
4b76683b38843f8d9b9b860c15d21d0870069b5c...3a7675bb6fa110a10be307db3201bfb348cf41cf,1,0,1,1,1,2015-02-06 15:30:31,2015-02-06 15:30:31
3a7675bb6fa110a10be307db3201bfb348cf41cf...aa9980b8c02de71c6918fba4aba9f22dd10eed01,370,1344,1344,2688,1224,2015-02-06 21:37:35,2015-02-06 19:29:45
aa9980b8c02de71c6918fba4aba9f22dd10eed01...d408142cdc981a005db4ae4969c85137a1e15e4a,1,10,6,16,5,2015-02-06 22:31:51,2015-02-06 22:30:36
d408142cdc981a005db4ae4969c85137a1e15e4a...4ca116443f019af8b7e8b7942940e04172ca1b43,1,3,5,8,1,2015-02-06 22:37:13,2015-02-06 21:18:28
4ca116443f019af8b7e8b7942940e04172ca1b43...7d392afddc79b48ffb69a63845f249a99375fcf8,1,5,0,5,1,2015-02-07 03:34:55,2015-02-06 21:02:34
7d392afddc79b48ffb69a63845f249a99375fcf8...8cf51d1d88c8301253ba42c44db0f2fcb0e9a62e,1,13,0,13,3,2015-02-07 03:34:56,2015-02-06 21:45:15
8cf51d1d88c8301253ba42c44db0f2fcb0e9a62e...74e5e2904304bef4b874c4ba68fe4e6671e1c12b,1,8,3,11,1,2015-02-08 17:41:03,2015-02-05 22:32:09
74e5e2904304bef4b874c4ba68fe4e6671e1c12b...da246198e44dc10d61c8fd2069f0cb0955be8c04,1,125,125,250,1,2015-02-09 15:57:45,2015-01-23 22:07:52
da246198e44dc10d61c8fd2069f0cb0955be8c04...56fa6f8021da4a3eba4f494643fe33cdafd5dc78,1,58,54,112,8,2015-02-09 15:57:48,2015-01-23 23:20:11
56fa6f8021da4a3eba4f494643fe33cdafd5dc78...8d3013163471f805fa68fbaa027d5686c4beb762,1,55,46,101,22,2015-02-09 15:59:25,2015-01-23 23:26:42
8d3013163471f805fa68fbaa027d5686c4beb762...5f0a3924f48911ae0efd71fdce85efc7fd11b887,3,144,119,263,14,2015-02-09 16:54:26,2015-01-28 18:45:57
5f0a3924f48911ae0efd71fdce85efc7fd11b887...ead3b9df094468ed85d1e93015328cee6ec11850,1,1,1,2,1,2015-02-09 20:45:28,2015-01-22 22:36:02
ead3b9df094468ed85d1e93015328cee6ec11850...e6e989f7fcf70d5bf5a5645b6927ac7a889dd5b7,1,1,1,2,1,2015-02-09 21:38:56,2015-02-09 21:38:56
e6e989f7fcf70d5bf5a5645b6927ac7a889dd5b7...570951951f752d1a31bb9e7f0d4276c1b533f25e,8,68,30,98,19,2015-02-09 21:48:21,2015-02-06 15:37:48
570951951f752d1a31bb9e7f0d4276c1b533f25e...978356d01c456f037efaaca9c7d2299705151e4d,1,4,1,5,1,2015-02-09 22:16:11,2015-02-09 21:53:28
978356d01c456f037efaaca9c7d2299705151e4d...b984d80226af9f1866fc2a16eb566d96ff61f6e2,1,9,2,11,1,2015-02-10 13:01:18,2015-02-09 15:31:59
b984d80226af9f1866fc2a16eb566d96ff61f6e2...2b23705cea9e721450cb94178a7b6511adcd61e4,2,40,2,42,5,2015-02-10 14:19:44,2015-02-09 15:05:32
2b23705cea9e721450cb94178a7b6511adcd61e4...a3aad22dfdef9ee9078d2fc3b54530adb73189a8,1,16,11,27,7,2015-02-10 14:19:44,2015-02-09 21:25:43
a3aad22dfdef9ee9078d2fc3b54530adb73189a8...40e5c7f39b967411bba4733c445f408f906a26b5,4,5,136,141,6,2015-02-10 14:47:24,2015-02-09 19:08:26
40e5c7f39b967411bba4733c445f408f906a26b5...e095f8979cd79c16c49cd20ffe8d46c494cf6891,18,147,148,295,121,2015-02-10 21:50:58,2015-02-06 21:02:47
e095f8979cd79c16c49cd20ffe8d46c494cf6891...c9e43db56a8f1a48c50097060aa9a8edc3621efc,1,2,34,36,2,2015-02-10 21:58:49,2015-02-09 00:12:49
c9e43db56a8f1a48c50097060aa9a8edc3621efc...a31cc114a89a3645e97645805ba77db32c433dce,11,378,450,828,163,2015-02-10 21:58:49,2015-01-30 20:12:20
a31cc114a89a3645e97645805ba77db32c433dce...1c478891a220758259eff7fd6bb1dc0a253a9aa5,2,7,7,14,7,2015-02-11 00:12:51,2015-02-10 23:19:44
1c478891a220758259eff7fd6bb1dc0a253a9aa5...6e2d6ae03be6592d95334c43a726cde10247bd24,10,261,168,429,72,2015-02-11 13:50:52,2015-01-27 18:01:45
6e2d6ae03be6592d95334c43a726cde10247bd24...47eafb2a05f902ffd9df5324a4c3490eaa581842,1,3,3,6,3,2015-02-11 14:33:33,2015-02-11 00:50:42
47eafb2a05f902ffd9df5324a4c3490eaa581842...0d4ce9adab40ded66dcce4f417ae4d3cf97a11f5,4,136,5,141,6,2015-02-11 14:36:43,2015-02-11 14:36:43
0d4ce9adab40ded66dcce4f417ae4d3cf97a11f5...b8784ae7e3c4264f1e64ee7d4850142aec5e1268,1,1,1,2,1,2015-02-11 15:11:57,2015-02-11 14:37:08
b8784ae7e3c4264f1e64ee7d4850142aec5e1268...7c9e31c723baf044ef35a297c6b40bfeba59174d,107,495462,291,495753,298,2015-02-11 15:11:58,2015-02-11 14:38:54
7c9e31c723baf044ef35a297c6b40bfeba59174d...4bfe853df14132d6403ed2358b008bade20bebec,1,1,1,2,1,2015-02-11 15:11:58,2015-02-11 14:56:19
4bfe853df14132d6403ed2358b008bade20bebec...a4ed524990f23821df57fbd4c8aafbcff574823e,5,43,14,57,12,2015-02-11 15:49:34,2015-01-28 19:50:37
a4ed524990f23821df57fbd4c8aafbcff574823e...ed49b537b9755d2acbf7e334238533412c7b0210,2,1,132,133,5,2015-02-11 18:18:47,2015-02-11 18:18:47
ed49b537b9755d2acbf7e334238533412c7b0210...439ecb677caceb79f2423ce7250e83534a06cc7b,1,20,1,21,2,2015-02-11 18:19:54,2015-02-10 22:54:43
439ecb677caceb79f2423ce7250e83534a06cc7b...e52add33972ce65d9341e79efb9191bf8d5141c8,9,9,9,18,9,2015-02-11 18:54:55,2015-02-11 17:32:00
e52add33972ce65d9341e79efb9191bf8d5141c8...eb09fb001f22257cca43ef4c846843e0a2c40a31,3,9,4,13,3,2015-02-11 19:18:35,2015-02-10 22:22:11
eb09fb001f22257cca43ef4c846843e0a2c40a31...7997065932af5c6af2b03613c9e2de0e11f8f518,1,1,1,2,1,2015-02-11 19:28:30,2015-02-11 19:28:30
7997065932af5c6af2b03613c9e2de0e11f8f518...d6ad41d4b7ef7bee4a28bc4c7e1013f1319d63c1,2,26,0,26,3,2015-02-11 19:49:13,2015-02-11 17:22:10
d6ad41d4b7ef7bee4a28bc4c7e1013f1319d63c1...871ce7691d0e1ebd87cf345f8355ad8bb04ba82e,1,3,2,5,1,2015-02-11 20:54:18,2015-02-06 22:55:52
871ce7691d0e1ebd87cf345f8355ad8bb04ba82e...76e7106f2577d9911bc6694bab0d1166b58cd977,2,9,0,9,2,2015-02-11 21:34:40,2015-02-10 22:37:56
76e7106f2577d9911bc6694bab0d1166b58cd977...739dd9bd371bf79f44c6ca2766a97b2f989b061d,1,0,95,95,1,2015-02-11 16:46:04,2015-02-11 15:31:38
739dd9bd371bf79f44c6ca2766a97b2f989b061d...5ff520902528d5fff857632e9d03534cf3761884,1,8,0,8,1,2015-02-11 16:48:36,2015-02-10 17:29:46
5ff520902528d5fff857632e9d03534cf3761884...d2230348a8064d8caa927fdbc33f34d9a1643c8f,2,0,9,9,4,2015-02-11 21:55:33,2015-02-09 23:04:55
d2230348a8064d8caa927fdbc33f34d9a1643c8f...49a07efe7e127603f4e9c90cbe13df2dd819b97a,4,430,2,432,4,2015-02-11 17:14:16,2015-02-03 14:41:03
49a07efe7e127603f4e9c90cbe13df2dd819b97a...9e670bc3b3039aba39db26066e44facb0851a5ed,3,5,5,10,5,2015-02-11 22:49:21,2015-02-05 22:07:27
9e670bc3b3039aba39db26066e44facb0851a5ed...295cb7943e21a22f9f3a95006de21b07b254afd2,7,105,25,130,33,2015-02-11 22:50:18,2015-02-09 21:32:02
295cb7943e21a22f9f3a95006de21b07b254afd2...c87f1eb7dff11169f037bb0bdd5b48e1b23d70b1,1,5,1,6,1,2015-02-11 23:04:14,2015-02-11 21:38:59
c87f1eb7dff11169f037bb0bdd5b48e1b23d70b1...bc6725d28dd9339dcb3e07e14cfbe868eb4cd563,7,25,105,130,33,2015-02-11 23:59:46,2015-02-11 23:59:46
bc6725d28dd9339dcb3e07e14cfbe868eb4cd563...394a8569ff14a215c0691aa34440227b2e62a4de,2,21,0,21,2,2015-02-12 03:13:06,2015-02-12 03:12:37
394a8569ff14a215c0691aa34440227b2e62a4de...a6c348aa16ee8676026be979fbf0a5c080c1a503,13,69,118,187,44,2015-02-12 12:39:45,2015-02-12 12:39:45
a6c348aa16ee8676026be979fbf0a5c080c1a503...5765560344674eec2327e43db7ff881d67b226ec,1,3,2,5,1,2015-02-12 14:38:10,2015-02-12 04:55:43
5765560344674eec2327e43db7ff881d67b226ec...347da921b66b57142fbec68f143132c35cfd3396,5,112,85,197,51,2015-02-12 18:51:20,2015-02-12 18:41:04
347da921b66b57142fbec68f143132c35cfd3396...6ca5a81e340f96502bc5f530a8a6fa0d44fea052,1,2,3,5,2,2015-02-12 20:24:27,2015-02-12 20:24:27
6ca5a81e340f96502bc5f530a8a6fa0d44fea052...01f5345e66331c2cfa215e07f70b569f90db1d44,1,0,1,1,1,2015-02-12 21:15:05,2015-02-12 21:15:05
01f5345e66331c2cfa215e07f70b569f90db1d44...00fe4ffaf00a68a91e8dd6232984d5b80a1ddacb,2,44,5,49,11,2015-02-13 14:15:28,2015-02-05 20:46:06
00fe4ffaf00a68a91e8dd6232984d5b80a1ddacb...45aba2114c18968422b285ce87709043a9455b3c,7,107,25,132,32,2015-02-13 16:27:07,2015-02-12 21:10:14
45aba2114c18968422b285ce87709043a9455b3c...c1b5595b5fdf93e0599bbdd4154f35bfa10fadd1,2,8,2,10,2,2015-02-13 17:07:09,2015-02-12 04:13:18
c1b5595b5fdf93e0599bbdd4154f35bfa10fadd1...05d73815c390e344842ac8870acfea53498279ea,28,248,1182,1430,73,2015-02-13 18:01:12,2015-01-03 15:55:42
05d73815c390e344842ac8870acfea53498279ea...511a2318599954ce6b58477dd7a1e8236fdb451b,9,97,12,109,15,2015-02-13 20:29:33,2014-12-08 17:22:05
511a2318599954ce6b58477dd7a1e8236fdb451b...75f2927bf28b64ad2221192c6efc724af63d17cd,1,12,28,40,3,2015-02-13 20:29:33,2015-01-29 18:15:54
75f2927bf28b64ad2221192c6efc724af63d17cd...88be59e3c014016f531fb0fd40017a5f280a025b,2,16,5,21,5,2015-02-13 20:29:33,2015-01-29 18:31:08
88be59e3c014016f531fb0fd40017a5f280a025b...67eb85c5fd2658c7ca53cc30dcd9007b5a8c7fa0,1,10,2,12,4,2015-02-13 20:29:33,2015-01-29 18:38:58
67eb85c5fd2658c7ca53cc30dcd9007b5a8c7fa0...fccb1246e8c36cb0b79889458c8f45f637e3603f,1,19,17,36,3,2015-02-13 20:29:33,2015-01-29 18:51:12
fccb1246e8c36cb0b79889458c8f45f637e3603f...7286fb36c36daaa8ee4941fa5f6c225b0a25dc61,6,36,12,48,8,2015-02-13 20:29:33,2015-02-04 19:40:58
7286fb36c36daaa8ee4941fa5f6c225b0a25dc61...2d359dfdd24629681742611f6120ffb504ac718f,1,17,8,25,8,2015-02-13 20:29:33,2015-02-03 18:56:13
2d359dfdd24629681742611f6120ffb504ac718f...4577311195bfab391d05c7e1862e0653771295e5,15,21,15,36,16,2015-02-13 20:29:33,2015-02-03 19:12:49
4577311195bfab391d05c7e1862e0653771295e5...1438dfd8fb21ea29ea2de273470b934f599269e5,1,1,1,2,1,2015-02-13 20:29:33,2015-02-04 16:54:48
1438dfd8fb21ea29ea2de273470b934f599269e5...3d5aee54e4f45cc516d64bfef0d682e93e264258,5,187,253,440,82,2015-02-13 20:29:33,2015-02-03 19:37:00
3d5aee54e4f45cc516d64bfef0d682e93e264258...5ffcf2f281d58aac6c27cbbf49407f18cb86eaf0,38,912,533,1445,228,2015-02-13 20:29:33,2015-01-24 01:02:43
5ffcf2f281d58aac6c27cbbf49407f18cb86eaf0...133c6fce830e9380f8fedf168de4a55b90904f52,1,7,5,12,1,2015-02-13 20:29:33,2015-02-10 23:52:33
133c6fce830e9380f8fedf168de4a55b90904f52...1c7d3ea807e2ba756384daef7bbb0de7c334b47d,1,6,6,12,2,2015-02-13 20:29:33,2015-02-10 23:58:16
1c7d3ea807e2ba756384daef7bbb0de7c334b47d...dbdb362027d61abbb396dcc091ddd8dd8e8ece22,2,92,43,135,4,2015-02-13 20:47:54,2015-02-13 14:38:10
dbdb362027d61abbb396dcc091ddd8dd8e8ece22...f5fc5c0ab87b4f0909387af9819fe87e5ed4758c,21,212,218,430,101,2015-02-13 21:13:43,2015-02-13 15:45:11
f5fc5c0ab87b4f0909387af9819fe87e5ed4758c...8ef2743189617343c5c4888aca34a9886d21e783,1,3,0,3,2,2015-02-13 21:23:10,2015-02-13 16:49:49
8ef2743189617343c5c4888aca34a9886d21e783...b98296681ffcbe3fc514c273941424a3ef6cfdbd,1,2,1,3,2,2015-02-13 22:01:28,2015-02-13 19:56:25
b98296681ffcbe3fc514c273941424a3ef6cfdbd...d47529bb1ad51e65f5262ace4efcaff96062e028,1,12,4,16,1,2015-02-13 22:39:21,2015-02-13 22:04:25
d47529bb1ad51e65f5262ace4efcaff96062e028...988703309558dca5a2a1a500d8e0c0dc8e8fc621,1,1,1,2,1,2015-02-15 17:46:36,2015-02-15 17:46:36
988703309558dca5a2a1a500d8e0c0dc8e8fc621...2a4111960fee25453ed0974ee9eae95ec25bd556,34,119,131,250,84,2015-02-17 01:46:18,2015-02-13 22:14:16
2a4111960fee25453ed0974ee9eae95ec25bd556...48e7b856f2b336537ca560ae9ab1740a293b53b9,1,1,1,2,1,2015-02-17 16:35:30,2015-02-17 16:35:30
48e7b856f2b336537ca560ae9ab1740a293b53b9...490b0b2b14fa14b463ef612b79386d20d95b4057,1,17,2,19,2,2015-02-17 16:57:22,2015-02-13 16:21:39
490b0b2b14fa14b463ef612b79386d20d95b4057...c678bbf6a492e79734a20f2ee768c67f026028cc,1,50,5,55,7,2015-02-17 21:57:53,2015-02-17 21:40:46
c678bbf6a492e79734a20f2ee768c67f026028cc...48c60e81c925c7b6824509a10cb215f968936cb2,1,2,0,2,1,2015-02-17 22:15:55,2015-02-17 21:43:45
48c60e81c925c7b6824509a10cb215f968936cb2...628c4fb2d19eab538f99ceb6c78981f20093fd20,2,20,116,136,5,2015-02-17 22:55:34,2015-02-12 02:56:50
628c4fb2d19eab538f99ceb6c78981f20093fd20...ffb3d64e1ae2f3dc84b3bbcb5d23ef85f87a9415,7,76,31,107,27,2015-02-18 05:05:25,2015-02-13 19:58:11
ffb3d64e1ae2f3dc84b3bbcb5d23ef85f87a9415...5ddbc9274d1550e5a26778a03439b67036b2aab4,3,80,173,253,25,2015-02-18 16:24:11,2015-02-17 19:38:50
5ddbc9274d1550e5a26778a03439b67036b2aab4...7281e7b7074bc647e756617e436150db3c9caf73,1,123,172,295,43,2015-02-18 18:16:52,2015-02-13 22:50:26
7281e7b7074bc647e756617e436150db3c9caf73...c56d5c791b95558acda08afdbca44d11bfea930e,1,2,25,27,4,2015-02-18 19:11:18,2015-02-13 19:58:11
c56d5c791b95558acda08afdbca44d11bfea930e...a6fc69010b65fc064cc529b2063fff83a167cedc,3,72,14,86,3,2015-02-18 22:52:22,2015-01-29 15:57:42
a6fc69010b65fc064cc529b2063fff83a167cedc...1cdc79db66bea34430da70c10b12ec61255da003,1,13,8,21,9,2015-02-18 23:32:08,2015-02-18 16:47:59
1cdc79db66bea34430da70c10b12ec61255da003...4ca4224dae91ec067a38cd552b3b8c50999d7707,1,2,2,4,2,2015-02-19 12:24:08,2015-02-19 12:24:08
4ca4224dae91ec067a38cd552b3b8c50999d7707...27e6efa8fee6a78ae549365093736934dc089eeb,47,1103,676,1779,253,2015-02-19 12:25:04,2015-02-19 12:25:04
27e6efa8fee6a78ae549365093736934dc089eeb...7d8adb6da8e9727c146acb33b717b57bc406481f,6,358,54,412,46,2015-02-19 17:14:29,2015-02-18 20:40:32
7d8adb6da8e9727c146acb33b717b57bc406481f...44a8c494fcb1259a00328ebf5cf29c1b7de2a075,1,8,0,8,1,2015-02-19 18:24:32,2015-02-19 18:21:31
44a8c494fcb1259a00328ebf5cf29c1b7de2a075...ae341c89d09b634047dd080af0f9e173e6d8b6e5,1,23,5,28,2,2015-02-19 18:44:17,2015-02-18 23:26:42
ae341c89d09b634047dd080af0f9e173e6d8b6e5...b0e50245a3cef4b22d0c4d60586bf843bb9c1861,7,1,247,248,13,2015-02-19 21:06:08,2015-02-19 20:48:15
b0e50245a3cef4b22d0c4d60586bf843bb9c1861...eb954e3aec7bc4a0e9e43e65741b101da30a8410,1,23,17,40,3,2015-02-19 21:40:24,2015-02-18 18:57:21
eb954e3aec7bc4a0e9e43e65741b101da30a8410...2b4f184b74703a776b87c08c516a28aa3e7ec28b,1,1,3,4,1,2015-02-19 21:58:07,2015-02-19 21:57:45
2b4f184b74703a776b87c08c516a28aa3e7ec28b...30d9e17410a3dec85ca2a148c745a6b8f9a8ecd0,3,169,61,230,22,2015-02-19 23:47:44,2015-02-19 17:04:38
30d9e17410a3dec85ca2a148c745a6b8f9a8ecd0...ae18bbec33db1c4bf57d328505474eb7bba517df,30,186,353,539,68,2015-02-20 00:55:44,2015-02-17 23:20:42
ae18bbec33db1c4bf57d328505474eb7bba517df...be2f8584a96d44a0c82b40b472dbc92ac10508f9,10,27,13,40,20,2015-02-20 15:26:12,2015-02-12 18:54:11
be2f8584a96d44a0c82b40b472dbc92ac10508f9...e93d4be469d665428d2e9bebd41c429732d3e8b4,2,45,0,45,3,2015-02-20 15:26:12,2015-02-05 20:06:25
e93d4be469d665428d2e9bebd41c429732d3e8b4...bae4fcce20e73929b219b52b856a20f47bbbf522,1,2,2,4,2,2015-02-20 10:59:15,2015-02-13 17:30:30
bae4fcce20e73929b219b52b856a20f47bbbf522...49fe3ce86ea1d9ac416de932b7d6a6f17248e27b,6,112,23,135,25,2015-02-20 11:04:00,2015-02-17 14:11:00
49fe3ce86ea1d9ac416de932b7d6a6f17248e27b...ed5feb226b966196ac307db57dbbd4b9ce98f4f3,1,109,117,226,2,2015-02-20 11:04:00,2015-02-18 14:25:40
ed5feb226b966196ac307db57dbbd4b9ce98f4f3...7ed5259ea72ad18e6b56450d7e23a269191b424a,16,183,683,866,139,2015-02-20 11:04:00,2015-02-06 11:28:21
7ed5259ea72ad18e6b56450d7e23a269191b424a...56202c537bfa6de56ca98d8caa04eaf095b7ef62,2,9,4,13,5,2015-02-20 13:55:54,2015-02-20 13:55:54
56202c537bfa6de56ca98d8caa04eaf095b7ef62...3211addd3426161d7ee1f5cc8d191418a013018d,13,75,138,213,29,2015-02-20 22:09:56,2015-02-04 23:11:20
3211addd3426161d7ee1f5cc8d191418a013018d...9fa0565f2b45cf1faebf3cb62c6777b7373dee08,4,40,34,74,10,2015-02-20 22:09:57,2015-02-19 15:25:09
9fa0565f2b45cf1faebf3cb62c6777b7373dee08...d1f28a215463d1ee2c8d2109bb55e2c891477e56,1,17,9,26,4,2015-02-20 22:50:02,2015-02-20 16:57:48
d1f28a215463d1ee2c8d2109bb55e2c891477e56...aff9fedac8a1f79db0a42ddae6ce80b5f6cb0805,1,1,1,2,1,2015-02-23 09:22:29,2015-02-23 09:22:11
aff9fedac8a1f79db0a42ddae6ce80b5f6cb0805...03f9a5bd9758a28bf48be06fe45bf201a978814e,1,1,0,1,1,2015-02-23 15:28:36,2015-02-23 15:28:36
03f9a5bd9758a28bf48be06fe45bf201a978814e...07420bdfb60fd6e976b0588d91afbfdc40685ec5,1,7,14,21,5,2015-02-23 16:32:26,2015-02-23 16:32:13
07420bdfb60fd6e976b0588d91afbfdc40685ec5...c614b21cc563dbb400f7258124fc5d2ed58b4dce,2,10,10,20,3,2015-02-24 04:19:20,2015-02-24 04:19:20
c614b21cc563dbb400f7258124fc5d2ed58b4dce...4a8b10a7bb9154c19b8a60cbda7b2f5d8f6b3d44,76,336,484139,484475,199,2015-02-24 12:37:03,2015-02-24 12:29:38
4a8b10a7bb9154c19b8a60cbda7b2f5d8f6b3d44...5bfcf828bf5de6d01fa7f8775b1b88c4924db1ef,2,13,11,24,5,2015-02-24 16:13:15,2015-02-23 17:11:22
5bfcf828bf5de6d01fa7f8775b1b88c4924db1ef...aa207c8f93ca264fd292980defca1cff315f2a47,15,77,79,156,62,2015-02-24 16:13:15,2015-02-23 22:58:21
aa207c8f93ca264fd292980defca1cff315f2a47...e8f7cf2c7cd209d1281eb67d2d19cf3518435bc9,1,59,67,126,23,2015-02-24 22:12:33,2015-02-20 19:19:58
e8f7cf2c7cd209d1281eb67d2d19cf3518435bc9...c51943618cfbf14e95582d369eb7f763b4a01628,2,14,21,35,7,2015-02-24 17:28:11,2015-02-23 13:12:29
c51943618cfbf14e95582d369eb7f763b4a01628...2d6aefaed7315d918fc558f65edc422eefb4cffa,5,106,53,159,20,2015-02-24 22:57:14,2015-02-18 22:56:56
2d6aefaed7315d918fc558f65edc422eefb4cffa...bfe2e9e40bd3cf78a80db7c9676d12d7a70b7022,1,25,3,28,3,2015-02-25 16:50:42,2015-02-23 19:51:24
bfe2e9e40bd3cf78a80db7c9676d12d7a70b7022...7eadd4fffebefcc1f640af08541377d9d5f1f610,15,79,77,156,62,2015-02-25 17:30:17,2015-02-25 17:30:17
7eadd4fffebefcc1f640af08541377d9d5f1f610...a5030efecd2cff00c0cf13f0ce023a8d2c0b6893,1,7,4,11,1,2015-02-25 18:17:21,2015-02-24 16:51:06
a5030efecd2cff00c0cf13f0ce023a8d2c0b6893...70b8b7097c9c3b9dbfcc273467fd41c3c290b7fe,1,1,17,18,3,2015-02-25 18:17:21,2015-02-25 18:17:10
70b8b7097c9c3b9dbfcc273467fd41c3c290b7fe...fe22feda7b5a02918906174d83c999af1a23ba75,5,62,0,62,11,2015-02-25 18:42:59,2015-02-24 22:52:24
fe22feda7b5a02918906174d83c999af1a23ba75...3c8a4340080524facb1666c632ec1655d53d59cc,2,33,13,46,2,2015-02-25 18:43:00,2015-02-25 15:17:29
3c8a4340080524facb1666c632ec1655d53d59cc...77dae5d4457c85e64fa92ebd19daa1ee8027dad6,5,87,10,97,16,2015-02-25 20:47:11,2015-02-25 20:24:34
77dae5d4457c85e64fa92ebd19daa1ee8027dad6...72b7023c275ed439af4c5834222c3ed780ee18d2,8,45,49,94,17,2015-02-25 21:25:27,2015-02-25 21:25:14
72b7023c275ed439af4c5834222c3ed780ee18d2...ac056b3d924d6e735620460457a4c83e36c3c13c,1,3,2,5,2,2015-02-25 21:36:51,2015-02-25 17:15:11
ac056b3d924d6e735620460457a4c83e36c3c13c...bc70a63cc538654f34b2707cb0f9060b1dd60072,7,0,818,818,7,2015-02-26 14:39:39,2015-02-25 19:33:19
bc70a63cc538654f34b2707cb0f9060b1dd60072...f57723cc8d0b2ad6da1bbf9abf333ee43a618956,3,5,2,7,4,2015-02-26 14:41:50,2015-02-25 22:54:19
f57723cc8d0b2ad6da1bbf9abf333ee43a618956...bf749ab727ce87628539550c445f8dae54d4fcb0,1,1,0,1,1,2015-02-26 15:20:47,2015-02-25 22:47:15
bf749ab727ce87628539550c445f8dae54d4fcb0...d6991bb3bdc0fb13d238f0b6c5327205ea0af898,1,4,0,4,2,2015-02-26 16:43:29,2015-02-24 18:22:41
d6991bb3bdc0fb13d238f0b6c5327205ea0af898...6769eca988fd96f68f15d54a37f135eea3298406,20,684,8,692,25,2015-02-26 19:56:08,2015-01-22 18:21:02
6769eca988fd96f68f15d54a37f135eea3298406...85d2238a163249f7d8e2c26933681b4374af19d0,2,34,4,38,4,2015-02-26 20:13:14,2015-02-25 22:31:08
85d2238a163249f7d8e2c26933681b4374af19d0...a0c4f1ffffb5fd6523ccc2feb3ffec6c2882e64f,2,6,24,30,3,2015-02-26 20:18:29,2015-02-26 20:18:29
a0c4f1ffffb5fd6523ccc2feb3ffec6c2882e64f...0524c8becac7d0824d618dbec8ed49322e596b2a,1,56,55,111,19,2015-02-26 15:29:19,2015-02-26 11:18:34
0524c8becac7d0824d618dbec8ed49322e596b2a...7423c26ab95464a9b8f620ab4a11c297dc0621d5,1,1,1,2,1,2015-02-26 21:00:00,2015-02-26 20:58:44
7423c26ab95464a9b8f620ab4a11c297dc0621d5...7d588bd39adc253e0b32df0049569888d392159b,1,14,7,21,5,2015-02-27 15:47:26,2015-02-27 15:14:27
7d588bd39adc253e0b32df0049569888d392159b...e75edbf8b668a7b2a48c8d495769ebaf83e91bba,2,11,11,22,3,2015-02-27 16:13:31,2015-02-24 20:47:11
e75edbf8b668a7b2a48c8d495769ebaf83e91bba...47bb531356b9ed6c007f0fb4f91104dea0de3a18,2,11,1,12,2,2015-02-27 16:50:19,2015-02-27 14:28:45
47bb531356b9ed6c007f0fb4f91104dea0de3a18...285dd66e220c2a10006744ec2bd98ed6abdb3b44,1,2,2,4,2,2015-02-27 17:15:50,2015-02-13 16:34:59
285dd66e220c2a10006744ec2bd98ed6abdb3b44...a9f240048fe27d925c0ad1798c1bf29ce59f0acc,2,18,8,26,8,2015-02-27 21:09:11,2015-02-26 20:42:15
a9f240048fe27d925c0ad1798c1bf29ce59f0acc...6efb8f83a8be7154f9df0de371f0c780a08758ee,7,19,12,31,14,2015-02-27 21:32:08,2015-02-27 16:44:47
6efb8f83a8be7154f9df0de371f0c780a08758ee...242980602d4a81a4542bc566d05cbc9f22634540,1,0,59,59,3,2015-02-27 21:32:08,2015-02-27 19:03:13
242980602d4a81a4542bc566d05cbc9f22634540...97d9f9ad89ced05eb44ef75746e6f959d8fa72f5,7,0,496,496,8,2015-02-27 21:32:08,2015-02-27 19:04:29
97d9f9ad89ced05eb44ef75746e6f959d8fa72f5...81e256d09a651a3ef22ee6eebff2156b32a785cf,10,8,413,421,12,2015-02-27 21:33:19,2015-02-27 18:41:30
81e256d09a651a3ef22ee6eebff2156b32a785cf...49c230b517af0b07277c793df9efbabe2684a089,1,2,13,15,2,2015-03-02 16:14:52,2015-02-27 21:52:40
49c230b517af0b07277c793df9efbabe2684a089...cae4fb798261586fa05f694e03c1dd75c3ef893f,5,7,12,19,10,2015-03-02 16:26:07,2015-03-02 14:29:48
cae4fb798261586fa05f694e03c1dd75c3ef893f...2f94f351b118bc1f5dc5f64d7bc78d3b5d341978,1,1,8,9,1,2015-03-02 16:45:09,2015-03-02 16:45:09
2f94f351b118bc1f5dc5f64d7bc78d3b5d341978...daf6c05ab22010bb74019189dd4bc4b4347aceb5,2,142,3,145,5,2015-03-02 21:58:25,2015-02-27 19:39:54
daf6c05ab22010bb74019189dd4bc4b4347aceb5...197cdebe7de9be23906c175b31f056c0351e9eb3,8,85,38,123,26,2015-03-02 22:27:52,2015-02-27 21:05:25
197cdebe7de9be23906c175b31f056c0351e9eb3...e590c12532de734da61ceb8324e1fd09de13fd7c,3,12,5,17,5,2015-03-02 22:27:53,2015-03-02 21:23:27
e590c12532de734da61ceb8324e1fd09de13fd7c...91806c6dd58640187180214c5f44f13421e9aa78,1,2,1,3,1,2015-03-03 10:03:36,2015-03-03 09:16:34
91806c6dd58640187180214c5f44f13421e9aa78...acea28520290e793c1ff9e6ed4117ff543c59a98,1,6,2,8,2,2015-03-03 10:03:37,2015-03-03 09:21:32
acea28520290e793c1ff9e6ed4117ff543c59a98...41986e669a4ef32b38c433a2cfd0b70e872e6899,32,409,853,1262,146,2015-03-03 15:53:07,2015-02-23 16:37:20
41986e669a4ef32b38c433a2cfd0b70e872e6899...c809c0fd4668334ce39737ec9ff7de8d550a699f,1,6,1,7,1,2015-03-03 16:38:04,2015-03-02 22:13:04
c809c0fd4668334ce39737ec9ff7de8d550a699f...65f0efbe658d288267bd9c1f9f2a77a22794aacd,4,58,3,61,6,2015-03-03 16:47:03,2015-02-26 20:43:58
65f0efbe658d288267bd9c1f9f2a77a22794aacd...95940768bcff61b59ed83dcc94c5afc001cef70f,2729,5,562357,562362,2730,2015-03-03 19:03:32,2015-03-02 18:41:22
95940768bcff61b59ed83dcc94c5afc001cef70f...3f3c9fd1f592d2a36f9799aefd16dcd23d5ae558,2,8,0,8,3,2015-03-03 19:28:00,2015-03-03 19:28:00
3f3c9fd1f592d2a36f9799aefd16dcd23d5ae558...e21b0f3c018198a81a4484cdb985a2211531d6ab,1,1,3,4,1,2015-03-03 19:50:03,2015-02-25 22:12:01
e21b0f3c018198a81a4484cdb985a2211531d6ab...a24c1bb35d4d919ed3c7724c4a3e2422673849f0,1,40,0,40,1,2015-03-03 21:17:33,2015-03-03 21:17:23
a24c1bb35d4d919ed3c7724c4a3e2422673849f0...064b52e376762882bb874f2768edee5e4e4a1eeb,12,410,17,427,24,2015-03-03 22:50:02,2015-02-19 22:26:39
064b52e376762882bb874f2768edee5e4e4a1eeb...99db24da095208e25ea3d2c7aeabf59ec2c28902,3,52,19,71,5,2015-03-03 22:50:02,2015-02-24 20:12:00
99db24da095208e25ea3d2c7aeabf59ec2c28902...0c46edb668123e0fb16b1cc2f56f0df68a21649a,1,3,2,5,3,2015-03-03 22:50:03,2015-02-25 20:48:45
0c46edb668123e0fb16b1cc2f56f0df68a21649a...69fbf40bdc14d2a0237749a3ad607cfe0f83bc8b,2,6,8,14,5,2015-03-03 23:01:19,2015-03-02 20:57:39
69fbf40bdc14d2a0237749a3ad607cfe0f83bc8b...965cbef869f8b864caaf3bf7705f8bd82c2b81ba,3,29,5,34,7,2015-03-03 23:06:02,2015-03-03 20:07:06
965cbef869f8b864caaf3bf7705f8bd82c2b81ba...0a82325a6852929b8817fdcd2659275889561925,1,1,1,2,1,2015-03-04 15:06:43,2015-03-04 14:31:32
0a82325a6852929b8817fdcd2659275889561925...3272a362429edbfa34fd6529e5925317f7b8a6e7,1,17,1,18,2,2015-03-04 16:16:12,2015-02-23 21:31:40
3272a362429edbfa34fd6529e5925317f7b8a6e7...95dc9c1cc55f83d33f9db1a61edf5e1d81f76916,2,11,0,11,3,2015-03-04 16:17:53,2015-03-03 20:19:45
95dc9c1cc55f83d33f9db1a61edf5e1d81f76916...c5fb91085d5083f70b87820a509989b57b521c8a,1,5,0,5,1,2015-03-04 18:42:40,2015-03-02 20:22:46
c5fb91085d5083f70b87820a509989b57b521c8a...21ab861effaa74362fc29fc7b20e3d413794f0ba,141,124610,0,124610,141,2015-03-04 19:29:16,2015-02-19 16:43:25
21ab861effaa74362fc29fc7b20e3d413794f0ba...558a019e51175b874de11f96c276f6be633fea91,1,5,2,7,1,2015-03-04 19:29:47,2015-02-19 23:14:52
558a019e51175b874de11f96c276f6be633fea91...b3085ab4f62cb80a5a2f63afe5a0be687c799a96,5,825,1,826,6,2015-03-04 20:11:40,2015-02-20 15:56:24
b3085ab4f62cb80a5a2f63afe5a0be687c799a96...69db0b402891afe1e91ce03cd82c0a3c15fca48e,1,7,7,14,7,2015-03-05 05:27:27,2015-03-05 05:27:27
69db0b402891afe1e91ce03cd82c0a3c15fca48e...10192c28b06fd69d3cc968df26f809b047a07a87,6,310,217,527,11,2015-03-05 18:22:18,2015-02-26 00:37:05
10192c28b06fd69d3cc968df26f809b047a07a87...a66cd57b62614a11ce02cce5e9b072cda6286762,1,6,6,12,1,2015-03-05 18:22:18,2015-02-26 21:02:02
a66cd57b62614a11ce02cce5e9b072cda6286762...b2944efee1cf3b70da1dff3de14f09ea329da728,4,11,15,26,8,2015-03-05 18:22:19,2015-03-04 02:33:15
b2944efee1cf3b70da1dff3de14f09ea329da728...a0db9321139e8da657638ddbe7e86d8bac9ea3cc,3,76,7,83,19,2015-03-05 18:22:19,2015-02-17 17:40:39
a0db9321139e8da657638ddbe7e86d8bac9ea3cc...45517f573d71e3e9fa592a721090e51f19b6bf61,2,25,0,25,5,2015-03-05 19:26:30,2015-01-07 17:08:27
45517f573d71e3e9fa592a721090e51f19b6bf61...1383eaef74396e40e124c91746180df926e46a6a,1,1,1,2,1,2015-03-05 20:12:03,2015-03-04 13:47:41
1383eaef74396e40e124c91746180df926e46a6a...ac525a4566a46b6b79a8465903b2ab0391eab506,1,1,1,2,1,2015-03-05 22:06:40,2015-03-05 03:12:13
ac525a4566a46b6b79a8465903b2ab0391eab506...59a9a04651486763b49ddb706a195bebccf76642,36,147,159,306,148,2015-03-05 22:35:14,2015-03-04 15:30:44
59a9a04651486763b49ddb706a195bebccf76642...8008352d239fa44cdbbdeda327e34eb011c341c8,1,3672,0,3672,1,2015-03-05 22:52:02,2015-03-05 20:26:09
8008352d239fa44cdbbdeda327e34eb011c341c8...d3d6506c0382172d53d4ac42b571a2cebbe2875a,1,0,0,0,0,2015-03-05 23:19:21,2015-03-05 23:19:21
d3d6506c0382172d53d4ac42b571a2cebbe2875a...bbe711f9199795db87660b2eaad4266875caa5bd,2,10,0,10,2,2015-03-05 23:30:53,2015-02-26 22:35:23
bbe711f9199795db87660b2eaad4266875caa5bd...eb9785c12b4b88d76e00321440c8d635f296448a,1,4,1,5,1,2015-03-06 14:34:18,2015-03-04 14:44:20
eb9785c12b4b88d76e00321440c8d635f296448a...a1ffa364553d6da05596e0bbea9d530b67e6a5cd,2,14,6,20,6,2015-03-06 16:08:45,2015-03-06 15:52:15
a1ffa364553d6da05596e0bbea9d530b67e6a5cd...c075fc27fcbc2ed17f8077b19a368c7c5cf0bfbc,1,1,1,2,1,2015-03-06 16:16:11,2015-03-06 16:16:03
c075fc27fcbc2ed17f8077b19a368c7c5cf0bfbc...4f4387d9b98c2da5eb5a4b070a1b28e856f8ecca,10,177,87,264,14,2015-03-06 19:31:50,2015-03-05 23:35:22
4f4387d9b98c2da5eb5a4b070a1b28e856f8ecca...af56dea51db8d96773ed541927522ee18ff96f31,2,23,7,30,11,2015-03-08 22:01:16,2015-03-06 14:16:49
af56dea51db8d96773ed541927522ee18ff96f31...c5b0ff8c1d063ced62da89446f675a05d1181816,51,1380,474,1854,299,2015-03-09 15:02:22,2015-03-09 15:02:22
c5b0ff8c1d063ced62da89446f675a05d1181816...5c2ec43c0a8d20283968165d2e004644b0f23390,26,496,410,906,128,2015-03-09 15:46:33,2015-03-05 19:16:21
5c2ec43c0a8d20283968165d2e004644b0f23390...df85a204a7d56cc3901f817e4bb7519103230abe,29,1704,1553,3257,158,2015-03-09 15:46:34,2015-03-05 23:06:22
df85a204a7d56cc3901f817e4bb7519103230abe...e8f722a0f2fa0b1550fc0bbdbd0aec1461a282ac,4,6,2,8,5,2015-03-09 15:51:58,2015-03-06 17:38:37
e8f722a0f2fa0b1550fc0bbdbd0aec1461a282ac...98276a11bdbd5ef863f0fead63c14f5a7a13440d,2,82,9,91,8,2015-03-09 16:48:29,2015-02-26 16:22:34
98276a11bdbd5ef863f0fead63c14f5a7a13440d...1755f3e99209c32d5e7bcc4aa18a58c24a69a8dc,1,1372,0,1372,1,2015-03-09 18:44:01,2015-03-06 21:54:19
1755f3e99209c32d5e7bcc4aa18a58c24a69a8dc...cb126b88afd72a2bcfa225e21870f7eaa4fffc9d,1,2,0,2,1,2015-03-09 19:08:55,2015-03-09 16:45:29
cb126b88afd72a2bcfa225e21870f7eaa4fffc9d...49434d723badd5686da242544bcad3dc83a1e1ef,6,280,369,649,68,2015-03-09 19:27:05,2015-03-09 19:12:13
49434d723badd5686da242544bcad3dc83a1e1ef...378f8dd985cb3c8d03b384d9671abff92693c7f5,3,111,0,111,3,2015-03-09 20:16:21,2015-03-09 17:12:17
378f8dd985cb3c8d03b384d9671abff92693c7f5...283187b470ba97a6197effb5f17f16b85dae1d47,1,7,16,23,4,2015-03-09 20:37:01,2015-02-23 13:48:33
283187b470ba97a6197effb5f17f16b85dae1d47...59e53003bda91156cf70db85f94a6274e012398c,1,3,0,3,1,2015-03-09 20:37:01,2015-02-25 09:02:59
59e53003bda91156cf70db85f94a6274e012398c...a4052b7cf11ac3ae0a67fc78275f4eaa5942e5cb,1,11,19,30,4,2015-03-09 20:37:01,2015-02-23 14:06:01
a4052b7cf11ac3ae0a67fc78275f4eaa5942e5cb...efd11b1106a9082908b6c098c397b509f66c75b4,1,1,1,2,1,2015-03-09 20:37:02,2015-02-23 14:09:11
efd11b1106a9082908b6c098c397b509f66c75b4...e6491d77039d58197aa3cf63323a0b6d47f6b859,2,25,0,25,4,2015-03-09 20:53:30,2015-03-09 18:22:27
e6491d77039d58197aa3cf63323a0b6d47f6b859...0c388e562f6b1549b583486b151164df17b37d94,15,40,67,107,37,2015-03-09 21:21:23,2015-03-09 17:24:07
0c388e562f6b1549b583486b151164df17b37d94...78ac7a453c78d429e0ef294ae350a61c3bb83b26,2,22,7,29,3,2015-03-09 21:21:23,2015-03-09 17:25:06
78ac7a453c78d429e0ef294ae350a61c3bb83b26...ff83bfcc085a777b7368a70b12bb874f0e24123d,1,12,0,12,6,2015-03-09 21:30:21,2015-03-09 21:30:21
ff83bfcc085a777b7368a70b12bb874f0e24123d...8e6d7dc39c51c58d0158071a717113314c26b0a0,2,72,1,73,3,2015-03-09 21:44:29,2015-03-09 21:34:54
8e6d7dc39c51c58d0158071a717113314c26b0a0...055d827ed7c144f26441441a75ea8dd5f797f9de,11,89,572,661,21,2015-03-09 21:51:06,2015-02-26 20:08:41
055d827ed7c144f26441441a75ea8dd5f797f9de...f6656c88c4beefb963798afbd6a40d59a6164952,1,17,11,28,6,2015-03-09 22:52:52,2015-03-06 20:22:24
f6656c88c4beefb963798afbd6a40d59a6164952...f68312003c8b1f28111bc95499b677a9c4c43e0e,3,14,4,18,5,2015-03-09 22:52:53,2015-03-06 19:49:22
f68312003c8b1f28111bc95499b677a9c4c43e0e...67caf3ffaeb0f1d363d6fd28b09feb2532a5880d,1,2,0,2,2,2015-03-09 22:52:53,2015-03-06 20:24:10
67caf3ffaeb0f1d363d6fd28b09feb2532a5880d...245ff2fcb2e01f549ae1b0e7aa0716dcdce8765d,2,9,0,9,2,2015-03-10 03:34:35,2015-03-10 03:34:35
245ff2fcb2e01f549ae1b0e7aa0716dcdce8765d...aed0e430605ea07f39ed1648c056f31351fb09f2,1,0,0,0,0,2015-03-10 04:05:18,2015-03-10 04:03:10
aed0e430605ea07f39ed1648c056f31351fb09f2...6712a2953eb85517753219f153a7efcf21dce13c,1,2,1,3,1,2015-03-10 08:27:43,2015-03-09 08:06:54
6712a2953eb85517753219f153a7efcf21dce13c...3a0a2fae791228ac0b883c6238bf095a608e4807,2,17,2,19,4,2015-03-10 13:50:26,2015-03-10 13:50:26
3a0a2fae791228ac0b883c6238bf095a608e4807...796369d27df571fb65c33d70714b90a2f732979a,5,48,42,90,21,2015-03-10 14:56:20,2015-03-02 19:18:35
796369d27df571fb65c33d70714b90a2f732979a...af18f1b35d092cefcab5cc9dc055a0fce4b04f19,1,33,39,72,4,2015-03-10 14:56:20,2015-03-03 15:13:33
af18f1b35d092cefcab5cc9dc055a0fce4b04f19...a52d13a43e40f6ff7e486cee943fe7feda87d59e,1,6,5,11,5,2015-03-10 15:49:12,2015-03-10 15:49:12
a52d13a43e40f6ff7e486cee943fe7feda87d59e...d36022a01c16cee954f76406001e9165213d42cd,4,9,2,11,5,2015-03-10 15:48:18,2015-03-09 19:42:16
d36022a01c16cee954f76406001e9165213d42cd...c6c136a7def8ab1f78ccd5d53034af510436e776,5,0,94,94,8,2015-03-10 15:48:18,2015-03-09 19:46:42
c6c136a7def8ab1f78ccd5d53034af510436e776...17762d0b22b816f863d11406f60d8d332687a943,8,9,4,13,9,2015-03-10 15:48:18,2015-03-09 19:47:51
17762d0b22b816f863d11406f60d8d332687a943...eaa338b6668e0d7e1a9e1b7f20f04c2f33815d3c,1,31,19,50,2,2015-03-10 16:29:10,2015-03-09 17:36:51
eaa338b6668e0d7e1a9e1b7f20f04c2f33815d3c...7083b5d3abeb7717c9c3c28a006b8f5544922c44,2,27,3,30,4,2015-03-10 19:18:26,2015-03-10 00:31:11
7083b5d3abeb7717c9c3c28a006b8f5544922c44...f974b0e9639199b3f41dfcb38358859290343c55,1,0,1,1,1,2015-03-10 19:36:20,2015-03-10 14:56:04
f974b0e9639199b3f41dfcb38358859290343c55...1b64013e01d1af85f9fb49daa565e8dded2c52a3,1,40,1,41,10,2015-03-10 14:32:53,2015-02-20 15:42:51
1b64013e01d1af85f9fb49daa565e8dded2c52a3...ddfef79e81a33de88ace541bdc705d1712fedbc2,21,2682,1616,4298,52,2015-03-10 20:07:36,2015-03-09 20:16:17
ddfef79e81a33de88ace541bdc705d1712fedbc2...03bcff8aea2824fa51a4cfc438d37a412fe902a6,14,49,32,81,31,2015-03-10 20:08:57,2015-03-09 22:30:53
03bcff8aea2824fa51a4cfc438d37a412fe902a6...300a825f5e59ac7bf9e6273caba3b59b603e9431,1,1,1,2,1,2015-03-10 16:22:22,2015-03-10 15:53:54
300a825f5e59ac7bf9e6273caba3b59b603e9431...816efed843cf368841ff1ef6bb2f549e91173e5e,5,5,7,12,6,2015-03-10 22:01:52,2015-03-10 18:45:55
816efed843cf368841ff1ef6bb2f549e91173e5e...665f406b79678fda71a66e2d4aed63dfeddbc648,1,6,6,12,6,2015-03-11 12:43:04,2015-03-11 12:33:57
665f406b79678fda71a66e2d4aed63dfeddbc648...8ca1f787738bdfe67a6662835f514b555b65af24,13,392,451,843,80,2015-03-11 17:05:47,2015-02-27 17:15:23
8ca1f787738bdfe67a6662835f514b555b65af24...ddc1a7f9c3303f8ef685792ec9e5d144fb1983eb,54,662,374,1036,200,2015-03-11 12:08:34,2015-02-23 18:39:17
ddc1a7f9c3303f8ef685792ec9e5d144fb1983eb...c8725b6def6c4cbc410763333f662684c315791a,1,2,1,3,1,2015-03-11 18:06:20,2015-03-10 19:06:43
c8725b6def6c4cbc410763333f662684c315791a...139ccb27bff55ee11cb204e80703241bc9288813,1,4,4,8,3,2015-03-11 19:13:26,2015-03-11 18:07:55
139ccb27bff55ee11cb204e80703241bc9288813...e9761e50b5bb00b8a35f96b2ce7698b5eecd6ff8,2,0,146,146,4,2015-03-11 19:22:51,2015-03-11 17:19:54
e9761e50b5bb00b8a35f96b2ce7698b5eecd6ff8...25feddadeef43fb0668350b40282fcdfbb1f2296,2,25,8,33,4,2015-03-11 20:22:41,2015-03-10 22:12:38
25feddadeef43fb0668350b40282fcdfbb1f2296...5fd3dfce18655932165ebadef0bbe5ed58f678de,2,17,10,27,6,2015-03-11 20:22:41,2015-03-11 20:18:42
5fd3dfce18655932165ebadef0bbe5ed58f678de...73986ce87913a552858cfd4c187a0f1059324a03,14,994,681,1675,62,2015-03-11 20:30:45,2015-03-11 14:38:01
73986ce87913a552858cfd4c187a0f1059324a03...ceb58fee5495ce2b45f6aaba7aa3da76b9cdf8d9,1,5,3,8,1,2015-03-11 20:44:00,2015-03-11 20:44:00
ceb58fee5495ce2b45f6aaba7aa3da76b9cdf8d9...5ad411b38b020b209218017448426e9dc72382b5,2,8,25,33,4,2015-03-11 21:29:05,2015-03-11 21:29:05
5ad411b38b020b209218017448426e9dc72382b5...346c9c7f9c802fb57931a62b2f2e402f07c8c805,1,1,0,1,1,2015-03-11 16:25:43,2015-03-11 15:55:59
346c9c7f9c802fb57931a62b2f2e402f07c8c805...f931ac5fa8d69d1b3e08267cd47ba14e5b3b30e2,4,35,17,52,8,2015-03-11 21:44:25,2015-03-11 18:44:09
f931ac5fa8d69d1b3e08267cd47ba14e5b3b30e2...f4d17dd81431f9724006c0837ccac44068971b1d,3,27,41,68,6,2015-03-11 21:46:44,2015-03-11 21:45:49
f4d17dd81431f9724006c0837ccac44068971b1d...b4f647796a0c37fbb95d71aa9ee9b63fcbfcb782,27,50,6166,6216,29,2015-03-11 22:03:04,2015-03-10 18:42:08
b4f647796a0c37fbb95d71aa9ee9b63fcbfcb782...17a7f0eedd286a19a5027c02efc358b39ccc8d84,24,53,56,109,56,2015-03-11 22:57:20,2015-03-11 20:23:24
17a7f0eedd286a19a5027c02efc358b39ccc8d84...9f7cc8a7029cbbdcc080d0f25aa6db35fda8f6b9,1,11,7,18,3,2015-03-12 13:41:57,2015-03-11 19:40:40
9f7cc8a7029cbbdcc080d0f25aa6db35fda8f6b9...bd489b1c2c76a7ee84105db758839c4d47ffcbcb,2,36,23,59,21,2015-03-12 16:34:28,2015-03-10 20:12:08
bd489b1c2c76a7ee84105db758839c4d47ffcbcb...d8f3c2e618f69662d20ee684c9d8fe26ff3bace5,1,1,1,2,1,2015-03-12 18:40:45,2015-03-12 17:08:14
d8f3c2e618f69662d20ee684c9d8fe26ff3bace5...64894f2b7394c4f46b9de40ffb6d6e95a74c7c41,4,63,166,229,8,2015-03-12 14:09:15,2015-03-09 08:41:32
64894f2b7394c4f46b9de40ffb6d6e95a74c7c41...5af44a739ae8ce061f65047d89586a75a0a51878,2,3,112,115,25,2015-03-12 19:23:34,2015-03-11 20:14:47
5af44a739ae8ce061f65047d89586a75a0a51878...3bb26d2bb96b65177019fb78297a94d50e4acc67,2,2,2,4,2,2015-03-12 21:11:20,2015-03-12 17:30:13
3bb26d2bb96b65177019fb78297a94d50e4acc67...7ee3d124070db157181bc1b24f2b84913957c388,1,7,1,8,1,2015-03-12 21:11:20,2015-03-12 17:26:30
7ee3d124070db157181bc1b24f2b84913957c388...7cd9cf303c824478f0f6d60cadfcc1a25bdb21f2,63,407,528,935,415,2015-03-12 21:11:20,2015-02-27 23:33:28
7cd9cf303c824478f0f6d60cadfcc1a25bdb21f2...86f3f05da7238cabb8d260677e81a07399a0906b,13,472,175,647,97,2015-03-12 22:55:39,2015-03-12 22:47:49
86f3f05da7238cabb8d260677e81a07399a0906b...0144f59236f507bf4a75a1e2b698100bcd75e4da,11,124,20,144,27,2015-03-12 22:55:39,2015-03-12 22:52:56
0144f59236f507bf4a75a1e2b698100bcd75e4da...8b1c4e3824fb63a70f9dbb9522176bbf4a4913df,1,6,4,10,1,2015-03-13 12:38:34,2015-03-12 22:49:41
8b1c4e3824fb63a70f9dbb9522176bbf4a4913df...3119f2a3271feafe52c9ee1255ff9df68a4d3b02,20,28,64,92,36,2015-03-13 13:42:09,2015-03-12 17:28:57
3119f2a3271feafe52c9ee1255ff9df68a4d3b02...5f64a1c4c3eb6698dfa2e721972a158202229bb0,1,1,1,2,1,2015-03-13 16:42:58,2015-03-13 16:38:52
5f64a1c4c3eb6698dfa2e721972a158202229bb0...9a94198ef9ef196077402f7bf4b7e0ab47df740a,1,2,2,4,2,2015-03-13 16:48:00,2015-03-12 23:00:11
9a94198ef9ef196077402f7bf4b7e0ab47df740a...77562fbd1b7c4503f1f2c07a49418080b6017efe,8,94,321,415,28,2015-03-13 17:31:52,2015-03-12 18:35:01
77562fbd1b7c4503f1f2c07a49418080b6017efe...40502abaac233ed0b27a9bf9612bd4df61811a68,1,57,15,72,2,2015-03-13 18:28:02,2015-03-11 20:34:25
40502abaac233ed0b27a9bf9612bd4df61811a68...7f73e3e38f9b606574a2b7599e0b0f491b962587,1,8,0,8,3,2015-03-13 18:37:04,2015-03-13 18:37:04
7f73e3e38f9b606574a2b7599e0b0f491b962587...ae97946ae529ea55ac610956d395c108fdea167b,23,85,239,324,104,2015-03-13 18:38:59,2015-03-13 14:59:13
ae97946ae529ea55ac610956d395c108fdea167b...4d7b131c5454bf56fd494b1a3537eeb5e221a027,3,17,2,19,6,2015-03-13 19:42:36,2015-03-13 12:48:48
4d7b131c5454bf56fd494b1a3537eeb5e221a027...83ae47b5780cddca30fd09b40fa4d897895a595f,3,24,1,25,9,2015-03-13 19:56:27,2015-03-11 18:09:55
83ae47b5780cddca30fd09b40fa4d897895a595f...629eb083a2094b7a096b29d66504a8f34e1a1d60,1,3,5,8,3,2015-03-14 01:47:54,2015-03-13 17:11:39
629eb083a2094b7a096b29d66504a8f34e1a1d60...d7563a168a8862e5c50f32829d17b628305a93ad,20,29,83,112,33,2015-03-16 13:08:06,2015-03-06 16:50:05
d7563a168a8862e5c50f32829d17b628305a93ad...e89ad4970c81ce122867e6af70d09cd164052022,1,2,2,4,2,2015-03-16 17:06:19,2015-03-16 15:06:24
e89ad4970c81ce122867e6af70d09cd164052022...bb9b4e27c8c31542af52d80f4c3751c435909d69,7,163,9,172,13,2015-03-16 17:27:16,2015-03-16 17:11:40
bb9b4e27c8c31542af52d80f4c3751c435909d69...9ac525aa529e825634004758fade4738c3c7b0a8,7,9,163,172,13,2015-03-16 18:58:13,2015-03-16 18:58:13
9ac525aa529e825634004758fade4738c3c7b0a8...ab11b0d3dd6084a312fb0136b3bbc1e49bb04f19,1,1,1,2,1,2015-03-16 21:12:28,2015-03-16 21:12:28
ab11b0d3dd6084a312fb0136b3bbc1e49bb04f19...7d15cd965ccb3ad684d8ae4e4f09d5b1e9394552,1,1,1,2,1,2015-03-17 14:42:50,2015-03-17 14:42:50
7d15cd965ccb3ad684d8ae4e4f09d5b1e9394552...c7a10982bc3325c52eee6b85c782347899d2bc87,1,1,1,2,1,2015-03-17 14:55:34,2015-03-17 14:55:34
c7a10982bc3325c52eee6b85c782347899d2bc87...6bc88dadc6adb4ef23505163c7e48484bc2f6908,6,4,84,88,7,2015-03-17 15:06:11,2015-03-13 20:27:18
6bc88dadc6adb4ef23505163c7e48484bc2f6908...51508504b737064060ac70a016eeef7ade8699d2,1,236,0,236,1,2015-03-17 15:09:13,2015-03-16 19:05:34
51508504b737064060ac70a016eeef7ade8699d2...0efa8d8855fa6c018ab3ce3cf68f14085650e3bb,1,1,1,2,1,2015-03-17 15:30:07,2015-03-13 15:31:03
0efa8d8855fa6c018ab3ce3cf68f14085650e3bb...196e937ddb5b7d4b2496c6fcb44b0d49d6a5a7c5,1,9,4,13,1,2015-03-17 15:30:08,2015-03-16 16:20:06
196e937ddb5b7d4b2496c6fcb44b0d49d6a5a7c5...21c4f06e356d42aa12442e3f6bca99e55266cd6d,7,163,9,172,13,2015-03-17 15:57:00,2015-03-16 17:11:40
21c4f06e356d42aa12442e3f6bca99e55266cd6d...e12ee3248d86f92f3b242ff8dd5215e26632f7a1,6,40,3,43,7,2015-03-17 16:13:44,2015-03-16 19:23:03
e12ee3248d86f92f3b242ff8dd5215e26632f7a1...010b40a018a909a4785fdd312bc49f8977f7e2ea,1,59,27,86,9,2015-03-17 17:37:53,2015-03-11 22:42:52
010b40a018a909a4785fdd312bc49f8977f7e2ea...db982c182c5c0acb2cd08ecdfc2a10c66712d7cd,15,80,283,363,61,2015-03-17 17:39:15,2015-02-23 15:55:06
db982c182c5c0acb2cd08ecdfc2a10c66712d7cd...bf52637fde15f15dac94b44b7adf3a03fa8b05fe,9,382,234,616,24,2015-03-17 18:46:30,2015-03-17 15:17:07
bf52637fde15f15dac94b44b7adf3a03fa8b05fe...63cdeb9c56203b9c5e7171b1d7faf9794c838bfd,2,3,3,6,2,2015-03-17 21:31:19,2015-03-16 02:12:41
63cdeb9c56203b9c5e7171b1d7faf9794c838bfd...465ca1774ddb7078566cb2edf0408f5881d6aae3,2,18,10,28,8,2015-03-18 13:33:32,2015-03-17 17:28:52
465ca1774ddb7078566cb2edf0408f5881d6aae3...4049c8328c98d8eb2b84fffca43ff4904e936909,5,492,254,746,36,2015-03-18 14:01:44,2015-03-14 22:49:43
4049c8328c98d8eb2b84fffca43ff4904e936909...a15dbb65cab3cc896f7dcda75cd471e3783b9bc4,4,28,0,28,6,2015-03-18 15:02:53,2015-03-12 22:08:26
a15dbb65cab3cc896f7dcda75cd471e3783b9bc4...78541981780b9d3608ce6d43167e230ed03c6444,1,13,0,13,1,2015-03-18 16:16:41,2015-03-16 22:35:22
78541981780b9d3608ce6d43167e230ed03c6444...0f6f2e9a199bff05c69ca5aace94a5ac8fe2cff3,16,143,22,165,32,2015-03-18 16:40:44,2015-03-16 15:48:45
0f6f2e9a199bff05c69ca5aace94a5ac8fe2cff3...c887c1e141b9d135a29e7f53dbb280a3406a87a2,2,10,18,28,8,2015-03-18 17:27:19,2015-03-18 17:27:19
c887c1e141b9d135a29e7f53dbb280a3406a87a2...b91ea550904b0863f6d6c96fc38150add8c1ec03,3,23,10,33,10,2015-03-18 19:34:24,2015-03-18 19:24:07
b91ea550904b0863f6d6c96fc38150add8c1ec03...eac8d16add28e197df59bf5fbfd45fa39b9737f7,3,19,11,30,10,2015-03-18 22:17:54,2015-03-18 19:24:09
