day,files_modified,hunks,lines_added,lines_removed,lines_modified,commits
2005-04-07,8,8,40,0,40,2
2005-04-08,18,37,216,30,246,8
2005-04-09,27,77,525,209,734,14
2005-04-10,13,71,208,85,293,4
2005-04-11,24,95,768,140,908,15
2005-04-12,17,63,471,45,516,13
2005-04-13,37,105,320,161,481,15
2005-04-14,6,15,243,179,422,3
2005-04-15,14,73,326,93,419,7
2005-04-16,18,68,223,205,428,13
2005-04-17,43,94,313,170,483,22
2005-04-18,56,216,1856,772,2628,29
2005-04-19,14,37,177,20,197,13
2005-04-20,21,72,537,116,653,13
2005-04-21,29,91,328,253,581,15
2005-04-22,4,10,67,62,129,2
2005-04-23,10,53,513,177,690,5
2005-04-24,38,95,773,95,868,21
2005-04-25,15,49,218,100,318,8
2005-04-26,33,92,743,376,1119,7
2005-04-27,18,103,267,137,404,17
2005-04-28,26,110,728,222,950,14
2005-04-29,17,50,380,377,757,8
2005-04-30,39,120,912,676,1588,20
2005-05-01,25,67,298,108,406,8
2005-05-02,30,95,433,173,606,19
2005-05-03,12,47,159,169,328,5
2005-05-04,16,76,218,67,285,8
2005-05-05,42,166,659,206,865,21
2005-05-06,47,406,1922,517,2439,23
2005-05-07,23,52,171,57,228,14
2005-05-08,17,344,1101,567,1668,11
2005-05-09,1,1,3,0,3,2
2005-05-10,74,163,2140,1439,3579,12
2005-05-11,79,207,2609,1114,3723,17
2005-05-12,2,16,91,6,97,2
2005-05-13,6,24,97,23,120,4
2005-05-14,35,52,1417,305,1722,14
2005-05-15,31,117,630,305,935,13
2005-05-16,1,15,62,10,72,1
2005-05-17,4,43,139,73,212,3
2005-05-18,33,130,418,160,578,18
2005-05-19,56,203,1244,353,1597,14
2005-05-20,61,177,1117,328,1445,13
2005-05-21,47,208,1220,508,1728,12
2005-05-22,69,369,1109,912,2021,16
2005-05-23,33,191,1290,545,1835,12
2005-05-24,28,146,769,392,1161,14
2005-05-25,23,82,333,93,426,15
2005-05-26,28,184,831,239,1070,16
2005-05-27,4,7,12,16,28,4
2005-05-29,56,185,577,328,905,19
2005-05-30,34,77,751,97,848,8
2005-05-31,31,132,615,348,963,13
2005-06-01,21,67,588,148,736,11
2005-06-02,21,46,348,98,446,8
2005-06-03,31,101,519,158,677,11
2005-06-04,1,11,21,22,43,1
2005-06-05,50,139,1169,353,1522,21
2005-06-06,29,138,1163,402,1565,15
2005-06-07,37,84,1463,91,1554,18
2005-06-08,39,174,860,308,1168,19
2005-06-09,7,34,189,61,250,5
2005-06-10,2,14,45,10,55,2
2005-06-12,1,1,1,1,2,1
2005-06-13,41,153,951,167,1118,25
2005-06-14,5,11,44,10,54,5
2005-06-15,8,10,25,9,34,3
2005-06-16,2,82,299,187,486,2
2005-06-17,6,35,166,35,201,5
2005-06-18,3,9,100,1,101,3
2005-06-19,8,32,112,90,202,7
2005-06-20,33,130,724,224,948,16
2005-06-21,24,84,240,91,331,16
2005-06-22,32,105,4110,96,4206,15
2005-06-23,15,41,168,90,258,11
2005-06-24,1,15,70,24,94,1
2005-06-25,26,168,1149,143,1292,18
2005-06-26,24,119,524,148,672,13
2005-06-27,53,160,865,1021,1886,14
2005-06-28,42,286,1653,677,2330,28
2005-06-29,39,171,641,424,1065,16
2005-06-30,35,115,958,250,1208,25
2005-07-01,13,47,280,103,383,3
2005-07-03,43,125,378,200,578,23
2005-07-04,26,86,662,166,828,17
2005-07-05,31,104,1846,793,2639,14
2005-07-06,39,75,617,155,772,25
2005-07-07,20,34,644,136,780,10
2005-07-08,36,76,394,152,546,14
2005-07-09,23,61,378,123,501,10
2005-07-10,10,27,88,41,129,7
2005-07-11,9,26,43,18,61,6
2005-07-12,18,34,222,117,339,11
2005-07-13,18,29,116,139,255,3
2005-07-14,48,111,835,141,976,26
2005-07-15,37,100,586,144,730,18
2005-07-16,41,132,1684,989,2673,15
2005-07-17,3,63,170,93,263,3
2005-07-18,3,77,431,75,506,3
2005-07-19,2,10,29,10,39,2
2005-07-20,2,32,151,57,208,2
2005-07-22,7,43,170,22,192,5
2005-07-23,32,90,268,150,418,21
2005-07-24,29,42,1324,135,1459,10
2005-07-25,2,12,32,10,42,2
2005-07-26,25,78,288,84,372,5
2005-07-27,15,22,126,23,149,9
2005-07-28,14,59,598,87,685,11
2005-07-29,9,89,740,122,862,9
2005-07-30,44,114,402,197,599,16
2005-07-31,15,46,364,56,420,9
2005-08-01,23,75,482,240,722,12
2005-08-03,40,131,795,155,950,23
2005-08-04,14,69,325,190,515,8
2005-08-05,15,70,401,263,664,9
2005-08-06,37,112,362,118,480,12
2005-08-07,94,1837,5245,3348,8593,90
2005-08-08,5,56,183,91,274,5
2005-08-09,24,59,120,42,162,14
2005-08-10,76,276,1138,302,1440,26
2005-08-11,2,2,4,1,5,1
2005-08-12,73,234,596,275,871,25
2005-08-13,16,62,169,121,290,2
2005-08-14,21,40,370,52,422,8
2005-08-15,70,177,1591,216,1807,14
2005-08-16,19,90,293,90,383,10
2005-08-17,83,310,1573,389,1962,32
2005-08-18,21,252,1394,580,1974,15
2005-08-19,26,139,653,210,863,15
2005-08-20,17,56,239,98,337,6
2005-08-21,9,68,312,87,399,5
2005-08-22,1,13,64,32,96,1
2005-08-23,97,295,3136,512,3648,12
2005-08-24,94,328,1662,682,2344,25
2005-08-25,15,20,92,11,103,10
2005-08-26,17,33,158,33,191,8
2005-08-27,57,218,793,306,1099,9
2005-08-28,12,27,306,38,344,9
2005-08-29,75,203,1356,418,1774,11
2005-08-30,89,802,3553,1124,4677,27
2005-08-31,10,388,1247,557,1804,8
2005-09-01,11,23,215,67,282,5
2005-09-02,17,54,242,73,315,6
2005-09-03,9,22,163,45,208,4
2005-09-04,27,71,473,62,535,10
2005-09-05,15,54,214,180,394,5
2005-09-06,19,37,100,48,148,7
2005-09-07,23,68,1243,1112,2355,9
2005-09-08,268,722,9640,9421,19061,7
2005-09-09,27,85,186,349,535,9
2005-09-10,7,29,255,11,266,6
2005-09-11,44,185,1731,866,2597,20
2005-09-12,21,76,169,89,258,11
2005-09-13,38,132,750,512,1262,19
2005-09-14,19,42,458,406,864,6
2005-09-15,36,95,267,582,849,13
2005-09-16,14,30,59,31,90,11
2005-09-17,13,46,208,47,255,9
2005-09-18,60,225,759,738,1497,11
2005-09-19,2,3,27,0,27,1
2005-09-20,125,279,1475,397,1872,17
2005-09-21,28,92,625,196,821,22
2005-09-22,24,34,27,662,689,5
2005-09-23,33,100,309,106,415,24
2005-09-24,31,100,208,142,350,16
2005-09-25,34,160,464,397,861,13
2005-09-26,2,6,22,5,27,2
2005-09-27,39,119,313,112,425,21
2005-09-28,28,91,265,90,355,13
2005-09-29,27,121,316,162,478,10
2005-09-30,17,45,78,76,154,11
2005-10-01,7,9,16,5,21,3
2005-10-02,53,205,1165,398,1563,24
2005-10-03,146,507,1791,684,2475,13
2005-10-04,13,30,92,77,169,9
2005-10-05,95,237,722,387,1109,18
2005-10-06,16,76,319,177,496,9
2005-10-07,16,58,695,78,773,7
2005-10-08,28,88,599,163,762,9
2005-10-09,4,12,26,12,38,4
2005-10-10,166,309,1196,350,1546,38
2005-10-11,28,203,859,347,1206,17
2005-10-12,20,48,240,96,336,9
2005-10-13,24,94,927,49,976,14
2005-10-14,1,8,57,31,88,1
2005-10-15,49,161,710,91,801,15
2005-10-16,42,123,1275,239,1514,20
2005-10-17,5,9,65,10,75,3
2005-10-18,46,206,900,285,1185,28
2005-10-19,23,130,482,147,629,20
2005-10-20,7,18,51,20,71,4
2005-10-21,28,80,263,118,381,14
2005-10-22,6,35,74,34,108,6
2005-10-23,13,45,449,243,692,8
2005-10-24,15,47,457,72,529,9
2005-10-25,3,30,65,163,228,1
2005-10-26,27,75,557,61,618,18
2005-10-27,5,20,64,22,86,4
2005-10-28,17,25,58,19,77,8
2005-10-29,29,119,537,162,699,22
2005-10-31,212,1008,7132,1692,8824,11
2005-11-01,14,58,75,128,203,8
2005-11-02,24,83,111,148,259,8
2005-11-03,52,91,371,66,437,14
2005-11-04,7,22,114,25,139,4
2005-11-05,31,103,427,153,580,10
2005-11-06,34,139,3610,169,3779,17
2005-11-07,62,153,2555,201,2756,15
2005-11-08,72,315,1005,309,1314,29
2005-11-09,8,34,46,35,81,7
2005-11-10,28,141,365,153,518,8
2005-11-11,44,166,586,165,751,20
2005-11-12,91,335,2599,913,3512,21
2005-11-13,14,39,213,148,361,7
2005-11-14,24,194,338,338,676,16
2005-11-15,75,208,684,511,1195,17
2005-11-16,21,59,431,189,620,15
2005-11-17,69,251,1479,500,1979,14
2005-11-18,30,141,463,242,705,21
2005-11-19,20,236,501,429,930,10
2005-11-20,51,353,2091,1573,3664,31
2005-11-21,29,118,334,178,512,18
2005-11-22,20,47,103,50,153,11
2005-11-23,7,35,52,46,98,7
2005-11-24,24,200,732,700,1432,15
2005-11-25,35,47,85,53,138,9
2005-11-26,81,484,2464,1638,4102,5
2005-11-27,15,92,182,123,305,11
2005-11-28,13,67,121,76,197,10
2005-11-29,76,223,594,443,1037,41
2005-11-30,63,162,407,345,752,9
2005-12-01,8,56,207,88,295,8
2005-12-02,10,15,86,16,102,10
2005-12-03,4,4,119,1,120,4
2005-12-04,100,427,1496,685,2181,7
2005-12-05,35,153,517,559,1076,21
2005-12-06,14,77,178,90,268,9
2005-12-07,24,126,1058,244,1302,17
2005-12-08,35,141,237,162,399,25
2005-12-09,5,10,45,22,67,4
2005-12-10,5,8,103,10,113,3
2005-12-11,20,154,684,231,915,16
2005-12-12,94,553,2289,1082,3371,4
2005-12-13,23,64,472,147,619,10
2005-12-14,74,199,499,381,880,25
2005-12-15,67,173,970,278,1248,9
2005-12-16,7,24,34,35,69,7
2005-12-17,12,18,73,16,89,5
2005-12-18,16,38,221,254,475,9
2005-12-19,5,8,28,8,36,4
2005-12-20,40,96,310,316,626,13
2005-12-21,87,213,742,572,1314,13
2005-12-22,23,70,198,126,324,13
2005-12-23,31,83,259,89,348,13
2005-12-24,22,59,225,36,261,6
2005-12-26,4,13,29,6,35,2
2005-12-27,35,66,337,45,382,9
2005-12-28,26,101,404,75,479,11
2005-12-29,25,30,33,27,60,3
2006-01-06,165,254,492,244,736,28
2006-01-07,29,38,23,325,348,5
2006-01-08,90,142,334,743,1077,17
2006-01-09,2,18,33,17,50,2
2006-01-10,4,9,44,4,48,3
2006-01-11,13,29,81,27,108,11
2006-01-13,5,9,41,12,53,5
2006-01-14,44,116,449,132,581,9
2006-01-15,22,150,522,321,843,7
2006-01-16,26,53,186,61,247,11
2006-01-17,2,4,5,4,9,2
2006-01-20,13,28,18,64,82,8
2006-01-21,2,3,6,13,19,2
2006-01-22,13,32,100,25,125,9
2006-01-23,6,113,1757,1441,3198,3
2006-01-25,33,90,250,65,315,16
2006-01-26,5,23,27,38,65,1
2006-01-27,11,19,27,34,61,9
2006-01-28,59,247,1897,325,2222,23
2006-01-29,4,9,19,6,25,3
2006-01-30,14,44,114,45,159,6
2006-01-31,8,59,331,499,830,5
2006-02-01,14,53,119,50,169,8
2006-02-02,11,30,137,77,214,10
2006-02-03,9,66,148,74,222,9
2006-02-04,6,19,24,45,69,4
2006-02-05,4,11,25,37,62,4
2006-02-06,41,199,545,682,1227,23
2006-02-07,38,191,1118,741,1859,17
2006-02-09,49,143,449,132,581,16
2006-02-10,45,178,725,434,1159,16
2006-02-11,14,60,181,88,269,5
2006-02-12,69,184,790,149,939,29
2006-02-13,17,49,355,45,400,10
2006-02-14,16,42,85,31,116,10
2006-02-15,27,115,435,85,520,13
2006-02-16,33,92,1524,79,1603,13
2006-02-17,25,133,3298,100,3398,10
2006-02-18,45,128,1391,111,1502,23
2006-02-19,52,197,1954,853,2807,14
2006-02-20,60,284,3556,1906,5462,32
2006-02-21,32,59,1295,47,1342,10
2006-02-22,104,480,5965,790,6755,40
2006-02-23,54,211,3281,251,3532,21
2006-02-24,38,178,598,215,813,22
2006-02-25,29,227,830,253,1083,11
2006-02-26,43,268,1504,859,2363,12
2006-02-27,50,266,857,354,1211,29
2006-02-28,28,236,808,594,1402,21
2006-03-01,74,243,1253,2666,3919,31
2006-03-02,154,903,6880,2748,9628,40
2006-03-03,65,338,1101,469,1570,37
2006-03-04,70,286,3640,3815,7455,30
2006-03-05,58,216,1032,192,1224,17
2006-03-06,49,102,527,251,778,16
2006-03-07,13,69,443,56,499,7
2006-03-08,12,214,1284,642,1926,4
2006-03-09,150,259,587,301,888,14
2006-03-10,5,6,12,4,16,4
2006-03-11,44,461,4365,643,5008,18
2006-03-12,19,48,306,55,361,8
2006-03-13,23,256,1051,395,1446,12
2006-03-15,6,34,60,52,112,6
2006-03-16,4,12,8,16,24,3
2006-03-17,16,58,204,41,245,10
2006-03-18,28,79,220,67,287,20
2006-03-19,4,14,38,26,64,4
2006-03-20,17,122,650,150,800,11
2006-03-21,24,98,406,93,499,12
2006-03-22,13,28,61,23,84,9
2006-03-24,30,37,66,12,78,7
2006-03-25,5,11,37,16,53,3
2006-03-26,87,649,5979,2779,8758,25
2006-03-27,15,44,90,34,124,7
2006-03-28,11,15,58,10,68,5
2006-03-29,4,13,52,8,60,2
2006-03-30,25,62,246,191,437,12
2006-03-31,2,30,92,47,139,2
2006-04-01,6,21,30,37,67,3
2006-04-02,16,132,218,154,372,13
2006-04-03,6,50,132,130,262,4
2006-04-04,137,560,1296,721,2017,24
2006-04-05,57,368,1835,639,2474,29
2006-04-06,8,64,212,48,260,8
2006-04-07,35,143,1644,213,1857,16
2006-04-08,15,119,878,309,1187,8
2006-04-09,19,88,525,410,935,9
2006-04-10,24,73,108,208,316,5
2006-04-11,50,245,523,298,821,19
2006-04-12,13,43,55,96,151,6
2006-04-13,27,84,616,52,668,10
2006-04-14,12,31,51,57,108,10
2006-04-15,77,376,2325,1119,3444,23
2006-04-16,58,276,839,535,1374,21
2006-04-17,46,160,350,263,613,19
2006-04-18,69,346,1070,687,1757,21
2006-04-19,42,78,3776,3279,7055,19
2006-04-20,19,49,396,294,690,11
2006-04-21,45,112,2684,2466,5150,12
2006-04-22,37,208,4322,3933,8255,13
2006-04-23,6,39,70,82,152,5
2006-04-24,27,106,1469,286,1755,15
2006-04-25,56,302,1266,509,1775,16
2006-04-26,58,472,5129,4160,9289,19
2006-04-27,72,240,849,736,1585,28
2006-04-28,40,187,543,171,714,14
2006-04-29,32,154,1179,167,1346,6
2006-04-30,54,295,3020,2099,5119,11
2006-05-01,24,126,1364,198,1562,14
2006-05-02,65,417,1450,822,2272,41
2006-05-03,54,594,3110,866,3976,24
2006-05-04,70,283,1888,732,2620,25
2006-05-05,97,255,1361,288,1649,23
2006-05-06,110,726,5927,2837,8764,12
2006-05-07,105,546,3379,944,4323,22
2006-05-08,60,172,409,252,661,14
2006-05-09,34,287,1467,357,1824,13
2006-05-10,15,35,78,29,107,9
2006-05-13,12,34,169,40,209,5
2006-05-14,50,144,529,196,725,18
2006-05-15,51,147,713,141,854,29
2006-05-16,41,137,1287,226,1513,19
2006-05-17,59,287,1644,1035,2679,26
2006-05-18,45,82,867,738,1605,19
2006-05-19,83,278,2088,1052,3140,31
2006-05-20,73,251,3371,1884,5255,14
2006-05-21,132,548,4466,2003,6469,13
2006-05-22,30,105,1293,166,1459,16
2006-05-23,145,430,11287,10587,21874,43
2006-05-24,243,753,22286,19084,41370,21
2006-05-25,16,53,229,49,278,10
2006-05-26,33,190,405,501,906,20
2006-05-28,25,127,277,119,396,15
2006-05-29,294,1639,16161,9041,25202,13
2006-05-30,76,345,844,520,1364,33
2006-05-31,41,177,411,297,708,14
2006-06-01,6,117,145,107,252,5
2006-06-02,13,47,113,26,139,8
2006-06-03,10,131,436,183,619,4
2006-06-04,124,479,2941,1664,4605,14
2006-06-05,5,8,30,3,33,5
2006-06-06,81,285,1773,547,2320,24
2006-06-07,32,203,1233,421,1654,14
2006-06-08,29,63,200,40,240,7
2006-06-09,10,21,38,15,53,4
2006-06-10,46,61,4868,136,5004,9
2006-06-11,1,1,16,0,16,1
2006-06-13,1,1,16,0,16,1
2006-06-16,33,315,2170,435,2605,25
2006-06-17,60,264,2842,293,3135,16
2006-06-18,142,667,3718,759,4477,20
2006-06-19,89,188,4307,3763,8070,27
2006-06-20,107,387,1184,528,1712,25
2006-06-21,80,251,1374,663,2037,24
2006-06-22,104,400,3310,2409,5719,23
2006-06-23,2,4,5,1,6,2
2006-06-24,34,103,548,213,761,14
2006-06-25,26,77,261,101,362,11
2006-06-26,125,261,3051,274,3325,18
2006-06-27,130,178,4771,57,4828,11
2006-06-28,39,155,611,189,800,18
2006-06-29,51,98,2620,277,2897,18
2006-06-30,13,21,44,31,75,5
2006-07-01,3,14,40,21,61,3
2006-07-02,41,142,802,198,1000,23
2006-07-03,92,303,2479,935,3414,43
2006-07-04,32,92,769,310,1079,17
2006-07-05,139,328,5738,620,6358,12
2006-07-06,4,23,48,14,62,4
2006-07-07,54,106,4690,4152,8842,20
2006-07-08,26,29,50,30,80,8
2006-07-09,72,221,848,473,1321,29
2006-07-10,92,188,4486,4131,8617,15
2006-07-11,22,50,88,35,123,14
2006-07-13,46,160,873,377,1250,11
2006-07-14,141,409,2308,489,2797,30
2006-07-15,10,32,77,16,93,6
2006-07-16,2,4,5,5,10,2
2006-07-17,15,49,186,38,224,10
2006-07-24,22,58,182,47,229,16
2006-07-25,38,129,634,149,783,24
2006-07-26,27,79,527,349,876,14
2006-07-27,5,6,13,5,18,2
2006-07-28,50,456,1021,967,1988,25
2006-07-29,110,353,703,472,1175,5
2006-07-30,59,160,860,455,1315,6
2006-07-31,151,919,4791,3786,8577,37
2006-08-01,29,87,2758,2503,5261,17
2006-08-02,33,83,370,256,626,17
2006-08-03,27,48,444,254,698,18
2006-08-04,59,118,2621,2541,5162,21
2006-08-05,7,10,16,43,59,5
2006-08-06,19,121,405,163,568,18
2006-08-07,5,34,166,28,194,5
2006-08-08,371,1357,14887,6560,21447,13
2006-08-09,21,76,289,165,454,17
2006-08-10,51,125,682,188,870,19
2006-08-11,11,20,19,49,68,4
2006-08-12,6,31,90,30,120,4
2006-08-13,160,573,8058,6726,14784,24
2006-08-14,5,116,203,154,357,5
2006-08-15,133,534,7696,6580,14276,35
2006-08-16,67,221,768,463,1231,16
2006-08-17,51,173,494,222,716,17
2006-08-18,5,29,137,49,186,3
2006-08-20,1,15,77,19,96,1
2006-08-21,9,81,215,182,397,7
2006-08-22,21,122,349,188,537,14
2006-08-23,159,634,6674,5923,12597,7
2006-08-24,13,25,28,32,60,8
2006-08-26,145,558,1325,754,2079,35
2006-08-27,37,89,515,206,721,18
2006-08-28,51,375,2836,663,3499,21
2006-08-29,6,7,19,9,28,5
2006-08-30,1,9,46,37,83,1
2006-08-31,28,66,374,158,532,11
2006-09-01,8,99,706,182,888,7
2006-09-02,44,87,275,136,411,2
2006-09-03,59,270,1056,453,1509,8
2006-09-04,12,48,140,75,215,6
2006-09-05,9,17,127,19,146,6
2006-09-06,7,23,112,72,184,5
2006-09-07,31,108,539,293,832,14
2006-09-08,14,21,484,215,699,2
2006-09-09,24,28,501,4,505,5
2006-09-10,22,62,225,108,333,9
2006-09-11,15,48,342,114,456,6
2006-09-13,28,82,316,132,448,15
2006-09-14,16,27,59,28,87,8
2006-09-15,4,8,55,31,86,4
2006-09-16,25,77,1220,80,1300,12
2006-09-17,34,119,1054,259,1313,14
2006-09-18,54,179,1312,563,1875,17
2006-09-20,43,155,1010,642,1652,25
2006-09-21,192,838,5080,1818,6898,13
2006-09-22,14,33,71,32,103,14
2006-09-23,23,113,425,699,1124,9
2006-09-24,18,70,504,88,592,10
2006-09-25,44,164,1956,1868,3824,12
2006-09-26,7,14,53,17,70,4
2006-09-27,70,297,2082,400,2482,32
2006-09-28,118,566,5495,3529,9024,23
2006-09-29,24,58,150,56,206,18
2006-09-30,14,39,219,88,307,11
2006-10-01,52,375,2804,514,3318,15
2006-10-02,47,251,2513,308,2821,8
2006-10-03,10,26,131,36,167,9
2006-10-04,11,33,87,127,214,9
2006-10-05,17,65,150,81,231,15
2006-10-06,23,126,500,197,697,10
2006-10-07,4,3,8,3,11,4
2006-10-08,15,48,146,56,202,10
2006-10-09,2,22,46,252,298,2
2006-10-10,11,23,82,578,660,5
2006-10-11,15,62,170,51,221,12
2006-10-12,19,38,238,604,842,8
2006-10-13,1,6,6,6,12,1
2006-10-14,16,36,92,61,153,6
2006-10-15,11,31,83,260,343,9
2006-10-16,3,5,13,4,17,2
2006-10-17,4,7,10,5,15,4
2006-10-18,2,6,16,4,20,2
2006-10-19,32,136,418,118,536,18
2006-10-20,22,98,1613,149,1762,10
2006-10-21,8,83,236,103,339,8
2006-10-22,8,13,20,10,30,6
2006-10-23,31,187,644,302,946,12
2006-10-24,112,577,2069,1164,3233,15
2006-10-25,44,214,1820,886,2706,17
2006-10-26,20,135,536,157,693,12
2006-10-27,31,71,203,283,486,15
2006-10-28,14,62,296,78,374,11
2006-10-29,19,150,775,436,1211,10
2006-10-30,6,14,24,7,31,5
2006-10-31,28,72,145,92,237,15
2006-11-01,64,261,1484,564,2048,11
2006-11-02,1,5,10,4,14,1
2006-11-03,119,503,2607,1163,3770,19
2006-11-04,12,28,78,9,87,10
2006-11-05,31,164,518,353,871,22
2006-11-06,7,54,280,68,348,7
2006-11-07,44,364,1934,666,2600,24
2006-11-08,40,199,2504,301,2805,25
2006-11-09,31,92,2065,2846,4911,16
2006-11-10,2,3,3,2,5,2
2006-11-11,2,2,2,2,4,2
2006-11-12,33,369,991,500,1491,33
2006-11-13,39,242,806,238,1044,28
2006-11-14,3,50,65,56,121,3
2006-11-15,10,74,197,102,299,10
2006-11-17,4,7,40,3,43,3
2006-11-18,26,100,405,96,501,22
2006-11-19,17,96,363,134,497,17
2006-11-20,17,46,473,273,746,7
2006-11-21,25,168,610,205,815,24
2006-11-22,30,123,274,2159,2433,12
2006-11-23,15,35,131,51,182,9
2006-11-24,61,287,1538,256,1794,39
2006-11-25,43,314,1150,327,1477,23
2006-11-26,8,44,124,46,170,8
2006-11-27,51,181,1127,2402,3529,24
2006-11-28,13,47,261,65,326,10
2006-11-29,16,70,226,93,319,12
2006-11-30,1,2,4,2,6,1
2006-12-02,4,8,18,20,38,3
2006-12-03,12,34,480,83,563,8
2006-12-04,14,30,108,23,131,9
2006-12-05,11,33,99,55,154,5
2006-12-06,37,90,567,81,648,18
2006-12-07,4,13,89,200,289,4
2006-12-08,6,12,54,19,73,5
2006-12-09,10,25,143,35,178,6
2006-12-10,2,14,136,76,212,2
2006-12-11,11,35,145,154,299,8
2006-12-12,7,25,208,25,233,7
2006-12-13,124,414,2632,977,3609,37
2006-12-14,12,36,185,56,241,9
2006-12-16,67,298,777,1183,1960,27
2006-12-17,21,41,124,26,150,11
2006-12-18,23,86,444,85,529,14
2006-12-19,76,230,1442,222,1664,16
2006-12-20,111,202,349,342,691,19
2006-12-21,27,180,476,1032,1508,9
2006-12-22,41,101,705,117,822,21
2006-12-23,26,65,226,103,329,20
2006-12-24,19,39,813,48,861,6
2006-12-25,29,119,1402,205,1607,18
2006-12-26,20,91,330,144,474,14
2006-12-27,263,1422,8863,5517,14380,14
2006-12-28,60,165,775,351,1126,23
2006-12-29,90,317,1139,379,1518,40
2006-12-30,15,18,105,8,113,6
2006-12-31,56,176,640,241,881,19
2007-01-01,23,76,167,190,357,18
2007-01-02,2,3,1,2,3,2
2007-01-03,27,66,182,78,260,18
2007-01-05,16,48,376,72,448,12
2007-01-06,10,21,42,30,72,9
2007-01-07,44,254,1425,485,1910,21
2007-01-08,102,255,2507,445,2952,33
2007-01-09,22,66,306,401,707,16
2007-01-10,61,148,499,458,957,27
2007-01-11,16,47,217,128,345,13
2007-01-12,70,184,382,286,668,16
2007-01-13,22,69,350,99,449,12
2007-01-14,473,4427,34760,14031,48791,51
2007-01-15,171,821,3507,2027,5534,27
2007-01-16,28,129,223,134,357,19
2007-01-17,55,131,814,581,1395,31
2007-01-18,111,227,827,496,1323,22
2007-01-19,12,20,199,259,458,4
2007-01-20,27,114,329,136,465,9
2007-01-21,89,343,4778,3861,8639,63
2007-01-22,55,252,693,389,1082,46
2007-01-23,16,46,94,40,134,16
2007-01-24,12,18,60,25,85,7
2007-01-25,38,132,524,204,728,24
2007-01-26,35,114,758,208,966,28
2007-01-27,11,39,784,171,955,8
2007-01-28,50,139,774,267,1041,24
2007-01-29,108,378,3031,2217,5248,30
2007-01-30,261,1092,5681,2974,8655,9
2007-01-31,35,110,2813,186,2999,30
2007-02-01,4,25,100,73,173,4
2007-02-02,18,67,159,66,225,15
2007-02-03,14,28,98,24,122,9
2007-02-04,174,675,5457,1865,7322,21
2007-02-05,53,158,1051,184,1235,28
2007-02-06,29,160,1125,308,1433,22
2007-02-07,40,166,3376,440,3816,27
2007-02-08,27,230,604,227,831,19
2007-02-09,27,170,662,360,1022,23
2007-02-10,6,21,54,21,75,6
2007-02-11,16,40,146,64,210,15
2007-02-12,36,107,5819,111,5930,22
2007-02-13,54,106,660,377,1037,21
2007-02-14,107,296,1687,916,2603,52
2007-02-15,2,7,36,0,36,2
2007-02-16,5,15,32,6,38,5
2007-02-17,24,58,211,58,269,8
2007-02-18,25,71,186,85,271,10
2007-02-19,7,18,39,18,57,3
2007-02-20,34,122,326,111,437,15
2007-02-21,114,536,1230,634,1864,29
2007-02-22,15,48,204,99,303,10
2007-02-23,215,1292,7532,3955,11487,132
2007-02-24,31,85,236,79,315,14
2007-02-25,19,43,234,58,292,11
2007-02-26,133,904,6206,2796,9002,16
2007-02-27,246,1630,7631,4052,11683,15
2007-02-28,112,476,1660,683,2343,32
2007-03-01,17,35,108,50,158,11
2007-03-02,18,39,260,30,290,6
2007-03-03,19,27,99,18,117,7
2007-03-04,70,197,833,392,1225,20
2007-03-05,128,262,1650,230,1880,23
2007-03-06,35,159,450,282,732,21
2007-03-07,80,328,713,381,1094,29
2007-03-08,12,59,279,148,427,6
2007-03-09,7,23,52,19,71,6
2007-03-10,10,36,167,49,216,9
2007-03-11,86,374,1468,557,2025,21
2007-03-12,51,224,730,761,1491,30
2007-03-13,39,175,563,598,1161,19
2007-03-14,83,224,2073,574,2647,32
2007-03-15,1,1,3,3,6,1
2007-03-16,11,27,153,25,178,5
2007-03-17,17,89,254,143,397,7
2007-03-18,23,85,354,63,417,8
2007-03-19,52,178,1095,747,1842,24
2007-03-20,23,62,1229,810,2039,19
2007-03-21,42,131,222,194,416,19
2007-03-22,32,88,1226,845,2071,25
2007-03-23,14,34,214,33,247,11
2007-03-24,29,127,498,221,719,15
2007-03-25,25,94,1029,985,2014,14
2007-03-26,12,28,131,24,155,9
2007-03-27,11,19,46,34,80,11
2007-03-28,26,46,235,50,285,19
2007-03-29,15,49,101,100,201,14
2007-03-30,9,59,114,101,215,7
2007-03-31,16,35,658,32,690,10
2007-04-01,22,112,322,85,407,16
2007-04-02,1,7,14,8,22,1
2007-04-04,72,275,1203,266,1469,33
2007-04-05,59,114,1399,1173,2572,22
2007-04-06,12,27,58,54,112,10
2007-04-07,52,153,827,200,1027,18
2007-04-08,19,57,428,44,472,12
2007-04-09,16,61,412,57,469,9
2007-04-10,57,222,1347,182,1529,31
2007-04-11,6,20,52,21,73,5
2007-04-12,42,122,1005,189,1194,20
2007-04-13,17,49,375,48,423,8
2007-04-14,31,75,678,102,780,19
2007-04-15,27,182,475,199,674,19
2007-04-16,61,160,731,326,1057,25
2007-04-17,45,200,1352,562,1914,24
2007-04-18,38,197,908,234,1142,18
2007-04-19,15,22,114,27,141,11
2007-04-20,23,193,950,229,1179,14
2007-04-21,15,67,89,81,170,8
2007-04-22,88,498,3382,768,4150,16
2007-04-23,33,198,569,360,929,13
2007-04-24,39,89,158,73,231,24
2007-04-25,30,188,724,198,922,13
2007-04-26,35,105,281,78,359,19
2007-04-27,21,45,202,32,234,12
2007-04-28,3,7,31,4,35,2
2007-04-29,75,174,901,187,1088,20
2007-04-30,11,15,31,20,51,9
2007-05-01,16,72,124,98,222,8
2007-05-02,22,199,284,386,670,17
2007-05-03,1,5,1,7,8,1
2007-05-04,26,73,133,93,226,14
2007-05-06,20,72,381,83,464,9
2007-05-07,27,297,611,253,864,22
2007-05-08,59,421,7773,7436,15209,20
2007-05-09,46,271,1149,505,1654,22
2007-05-10,65,255,740,519,1259,26
2007-05-11,1,7,9,7,16,1
2007-05-12,24,68,359,75,434,14
2007-05-13,26,63,212,102,314,12
2007-05-14,11,29,52,27,79,6
2007-05-15,27,86,200,112,312,16
2007-05-16,38,59,90,43,133,16
2007-05-17,19,50,316,71,387,15
2007-05-18,29,145,926,976,1902,21
2007-05-19,57,271,2094,1619,3713,24
2007-05-20,68,201,721,328,1049,25
2007-05-21,51,191,1467,584,2051,26
2007-05-22,53,140,488,95,583,23
2007-05-23,24,53,280,33,313,21
2007-05-24,32,85,346,145,491,25
2007-05-25,45,156,367,517,884,20
2007-05-26,28,128,280,203,483,12
2007-05-27,29,119,491,135,626,10
2007-05-28,31,196,787,236,1023,25
2007-05-29,55,250,1298,703,2001,25
2007-05-30,22,105,233,138,371,20
2007-05-31,19,89,265,138,403,13
2007-06-01,7,14,24,29,53,3
2007-06-02,48,171,822,549,1371,15
2007-06-03,31,68,1062,493,1555,12
2007-06-05,12,30,74,21,95,6
2007-06-06,114,690,2452,1154,3606,78
2007-06-07,269,212,44,23,67,14
2007-06-08,38,96,385,104,489,18
2007-06-09,32,97,469,120,589,20
2007-06-10,25,72,421,169,590,19
2007-06-11,33,288,2679,611,3290,15
2007-06-12,54,120,302,142,444,19
2007-06-13,51,180,739,375,1114,25
2007-06-16,65,155,814,176,990,31
2007-06-17,8,30,56,49,105,6
2007-06-20,5,9,44,14,58,5
2007-06-21,6,18,54,15,69,5
2007-06-22,6,6,1407,5,1412,3
2007-06-23,51,533,2980,1124,4104,26
2007-06-24,21,30,1617,12,1629,9
2007-06-25,12,33,556,65,621,6
2007-06-26,2,366,1931,833,2764,2
2007-06-27,45,109,738,110,848,23
2007-06-28,11,32,62,38,100,7
2007-06-29,13,43,725,52,777,7
2007-06-30,19,59,1013,73,1086,10
2007-07-01,59,145,1064,184,1248,20
2007-07-02,44,87,1339,97,1436,19
2007-07-03,174,1571,2330,2128,4458,16
2007-07-04,42,128,607,395,1002,29
2007-07-05,6,12,45,9,54,5
2007-07-06,40,112,536,152,688,19
2007-07-07,47,153,576,183,759,19
2007-07-08,7,19,85,26,111,7
2007-07-09,100,411,2496,1292,3788,47
2007-07-10,21,72,275,75,350,15
2007-07-11,16,82,409,165,574,8
2007-07-12,67,409,2874,1086,3960,28
2007-07-13,12,61,168,63,231,9
2007-07-14,23,45,165,46,211,11
2007-07-15,35,128,897,562,1459,11
2007-07-16,7,7,155,2,157,4
2007-07-17,8,13,32,31,63,5
2007-07-18,21,82,336,185,521,18
2007-07-19,21,102,545,183,728,14
2007-07-20,20,38,784,239,1023,4
2007-07-21,16,53,208,53,261,10
2007-07-22,14,59,208,127,335,12
2007-07-23,6,16,30,14,44,6
2007-07-24,12,100,321,174,495,8
2007-07-25,35,86,565,138,703,27
2007-07-26,8,35,58,36,94,6
2007-07-27,18,34,330,73,403,9
2007-07-28,4,94,231,115,346,4
2007-07-29,17,43,112,36,148,11
2007-07-30,28,191,1231,429,1660,11
2007-07-31,7,91,196,208,404,6
2007-08-01,34,112,568,245,813,16
2007-08-02,23,74,153,76,229,12
2007-08-03,9,16,27,18,45,8
2007-08-04,7,9,46,1,47,6
2007-08-05,9,15,91,50,141,9
2007-08-06,9,20,97,50,147,7
2007-08-07,7,15,39,19,58,7
2007-08-08,3,22,44,17,61,3
2007-08-09,1,2,2,0,2,1
2007-08-10,27,130,385,183,568,17
2007-08-11,37,99,1032,312,1344,11
2007-08-12,6,27,68,54,122,6
2007-08-13,19,89,251,103,354,14
2007-08-14,13,17,126,19,145,6
2007-08-15,33,113,498,131,629,17
2007-08-16,14,45,206,48,254,9
2007-08-17,8,13,22,24,46,7
2007-08-18,2,8,26,1,27,1
2007-08-19,29,94,546,48,594,18
2007-08-20,12,56,464,22,486,8
2007-08-21,4,28,221,21,242,4
2007-08-22,13,54,196,152,348,11
2007-08-23,15,98,262,94,356,13
2007-08-24,1,12,29,22,51,1
2007-08-25,30,50,149,83,232,9
2007-08-26,14,45,172,262,434,13
2007-08-27,6,20,96,71,167,4
2007-08-28,14,40,301,43,344,7
2007-08-29,19,109,364,251,615,16
2007-08-30,2,22,238,15,253,2
2007-08-31,12,55,98,46,144,11
2007-09-01,31,90,354,98,452,16
2007-09-02,43,376,8841,410,9251,20
2007-09-03,35,85,407,182,589,20
2007-09-04,7,47,102,58,160,6
2007-09-05,9,40,153,55,208,3
2007-09-06,23,85,488,163,651,13
2007-09-07,25,147,377,324,701,11
2007-09-08,7,13,26,8,34,5
2007-09-09,18,39,100,45,145,10
2007-09-10,95,396,1022,641,1663,25
2007-09-11,2,2,2,2,4,2
2007-09-12,28,55,865,139,1004,15
2007-09-13,3,4,162,10,172,3
2007-09-14,82,256,938,339,1277,30
2007-09-15,21,117,529,107,636,13
2007-09-16,19,121,975,1693,2668,13
2007-09-17,54,316,1067,1369,2436,13
2007-09-18,73,312,1850,571,2421,29
2007-09-19,258,885,7451,5276,12727,58
2007-09-20,4,9,8,7,15,4
2007-09-21,40,257,606,762,1368,13
2007-09-22,7,66,342,258,600,7
2007-09-23,24,48,983,63,1046,5
2007-09-24,54,104,1237,155,1392,17
2007-09-25,18,54,235,80,315,14
2007-09-26,70,203,906,538,1444,27
2007-09-27,46,357,878,897,1775,9
2007-09-28,11,50,162,29,191,5
2007-09-29,45,132,410,123,533,16
2007-09-30,40,138,354,203,557,22
2007-10-01,14,17,353,18,371,7
2007-10-02,5,10,11,8,19,5
2007-10-03,131,950,3081,2450,5531,25
2007-10-04,6,110,209,150,359,6
2007-10-06,4,29,195,40,235,4
2007-10-08,1,1,1,0,1,1
2007-10-10,32,1694,5205,2228,7433,17
2007-10-12,10,281,631,347,978,8
2007-10-13,10,32,129,43,172,7
2007-10-14,2,2,2,0,2,1
2007-10-16,249,1454,4913,3260,8173,48
2007-10-17,50,155,516,161,677,25
2007-10-18,24,67,310,107,417,16
2007-10-19,24,41,107,47,154,17
2007-10-20,10,13,76,6,82,9
2007-10-21,65,435,888,679,1567,32
2007-10-22,8,191,238,151,389,5
2007-10-23,10,285,458,331,789,10
2007-10-24,1,10,26,15,41,1
2007-10-25,69,189,4675,3474,8149,7
2007-10-26,3,6,12,8,20,3
2007-10-27,44,579,2459,1495,3954,28
2007-10-28,10,413,1659,1030,2689,7
2007-10-29,16,35,97,37,134,10
2007-10-30,81,405,1285,916,2201,46
2007-10-31,42,192,1901,1404,3305,16
2007-11-01,47,642,1112,1005,2117,23
2007-11-02,90,400,1383,867,2250,27
2007-11-03,35,93,968,615,1583,13
2007-11-04,56,202,762,296,1058,23
2007-11-05,31,106,1282,1004,2286,15
2007-11-06,68,204,857,441,1298,35
2007-11-07,5,7,43,4,47,4
2007-11-08,69,178,688,232,920,31
2007-11-09,41,130,482,359,841,19
2007-11-10,114,386,2215,1140,3355,15
2007-11-11,26,86,306,174,480,14
2007-11-12,49,206,593,287,880,22
2007-11-13,13,18,286,16,302,12
2007-11-14,144,465,2355,1201,3556,44
2007-11-16,21,39,95,43,138,11
2007-11-17,46,134,644,189,833,22
2007-11-18,65,307,1044,634,1678,15
2007-11-19,55,171,9003,8469,17472,21
2007-11-20,15,39,107,29,136,11
2007-11-21,61,551,13469,872,14341,7
2007-11-22,33,296,1416,322,1738,16
2007-11-23,62,232,2106,826,2932,35
2007-11-25,134,379,3846,1728,5574,26
2007-11-26,18,53,465,75,540,10
2007-11-27,2,292,371,318,689,2
2007-11-28,12,28,134,60,194,10
2007-11-29,31,88,266,130,396,12
2007-11-30,29,69,383,75,458,14
2007-12-01,37,117,8550,8196,16746,13
2007-12-02,21,269,1280,689,1969,12
2007-12-03,58,123,1644,110,1754,25
2007-12-04,41,98,245,120,365,21
2007-12-05,55,620,2879,1506,4385,16
2007-12-06,37,117,562,160,722,16
2007-12-07,38,1004,1665,1309,2974,13
2007-12-08,20,103,321,197,518,13
2007-12-09,44,169,941,207,1148,17
2007-12-10,129,1538,5378,2668,8046,11
2007-12-11,26,105,419,191,610,17
2007-12-12,24,88,218,92,310,14
2007-12-13,39,151,652,226,878,12
2007-12-14,43,105,528,294,822,16
2007-12-15,79,253,1310,863,2173,19
2007-12-16,27,61,301,206,507,18
2007-12-17,4,26,87,53,140,4
2007-12-18,36,93,130,105,235,16
2007-12-19,20,477,1909,614,2523,17
2007-12-20,13,46,184,65,249,9
2007-12-21,7,27,34,39,73,7
2007-12-22,12,26,122,24,146,8
2007-12-23,12,36,153,25,178,7
2007-12-24,1,1,1,0,1,1
2007-12-26,7,38,145,42,187,4
2007-12-27,16,47,366,43,409,8
2007-12-28,1,1,1,1,2,1
2007-12-29,3,8,48,22,70,3
2007-12-30,6,20,1586,27,1613,6
2007-12-31,6,56,58,58,116,5
2008-01-01,1,11,34,3,37,1
2008-01-02,14,39,127,32,159,9
2008-01-03,8,9,15,14,29,2
2008-01-04,8,15,23,13,36,3
2008-01-05,23,53,1610,111,1721,13
2008-01-06,3,92,110,129,239,3
2008-01-07,182,663,990,744,1734,25
2008-01-08,9,12,72,5,77,5
2008-01-09,17,311,1024,431,1455,13
2008-01-10,3,7,12,8,20,2
2008-01-11,11,409,700,403,1103,5
2008-01-12,8,18,31,21,52,7
2008-01-13,4,20,38,30,68,4
2008-01-14,4,18,23,21,44,4
2008-01-15,9,14,76,5,81,6
2008-01-16,46,145,1809,180,1989,21
2008-01-18,33,70,610,396,1006,15
2008-01-19,2,2,2,2,4,1
2008-01-20,7,27,62,16,78,6
2008-01-21,60,356,2593,581,3174,19
2008-01-22,7,10,32,12,44,5
2008-01-23,13,37,151,31,182,10
2008-01-24,5,8,31,5,36,2
2008-01-25,1,1,11,0,11,1
2008-01-26,10,14,61,11,72,6
2008-01-27,8,20,61,18,79,4
2008-01-28,2,3,17,4,21,2
2008-01-29,4,5,23,2,25,3
2008-01-30,11,20,65,20,85,7
2008-01-31,9,13,13,14,27,7
2008-02-02,52,271,503,432,935,4
2008-02-03,14,33,95,57,152,11
2008-02-04,14,64,157,88,245,8
2008-02-05,74,336,1687,728,2415,36
2008-02-06,36,74,623,114,737,13
2008-02-07,10,18,190,10,200,6
2008-02-08,5,37,135,27,162,5
2008-02-10,45,182,2018,1910,3928,21
2008-02-11,88,186,605,147,752,44
2008-02-12,58,318,1373,439,1812,13
2008-02-13,54,224,949,241,1190,22
2008-02-14,2,2,2,4,6,2
2008-02-15,3,4,12,3,15,3
2008-02-16,74,337,1651,707,2358,29
2008-02-17,69,171,1324,366,1690,19
2008-02-18,45,87,589,380,969,13
2008-02-19,35,100,336,223,559,21
2008-02-20,48,158,943,244,1187,24
2008-02-21,62,211,856,247,1103,28
2008-02-22,35,62,127,51,178,14
2008-02-23,759,5431,57155,22760,79915,22
2008-02-24,18,49,220,134,354,13
2008-02-25,36,191,1237,379,1616,17
2008-02-26,48,146,717,520,1237,16
2008-02-27,157,602,4598,2762,7360,47
2008-02-28,9,20,54,16,70,8
2008-02-29,26,86,452,71,523,14
2008-03-01,48,130,1437,667,2104,23
2008-03-02,75,252,1174,598,1772,29
2008-03-03,174,764,5894,3165,9059,30
2008-03-04,19,82,127,192,319,13
2008-03-05,61,205,980,230,1210,30
2008-03-06,8,539,712,557,1269,3
2008-03-07,17,35,101,52,153,12
2008-03-08,50,159,647,193,840,19
2008-03-09,93,364,1393,755,2148,26
2008-03-10,15,67,219,75,294,15
2008-03-11,21,82,560,371,931,12
2008-03-12,62,761,3215,1684,4899,22
2008-03-13,99,471,750,547,1297,26
2008-03-14,38,2051,3653,2288,5941,17
2008-03-15,120,986,2410,1066,3476,26
2008-03-16,26,2196,3453,2459,5912,12
2008-03-17,1,5,271,145,416,1
2008-03-19,13,36,172,36,208,10
2008-03-20,6,7,24,6,30,5
2008-03-21,2,2,27,1,28,1
2008-03-23,19,54,243,80,323,11
2008-03-24,2,3,7,0,7,1
2008-03-25,5,9,30,6,36,3
2008-03-26,150,188,1926,87,2013,10
2008-03-27,100,156,1331,103,1434,20
2008-03-28,7,16,20,27,47,4
2008-03-31,19,112,503,79,582,10
2008-04-01,2,22,70,31,101,1
2008-04-02,22,121,463,97,560,14
2008-04-04,1,2,4,4,8,1
2008-04-05,8,88,96,107,203,7
2008-04-06,1,3,3,3,6,1
2008-04-07,11,20,156,33,189,7
2008-04-08,4,7,8,10,18,2
2008-04-09,59,190,1162,243,1405,26
2008-04-10,34,63,137,73,210,10
2008-04-11,3,3,12,2,14,2
2008-04-12,35,57,135,62,197,14
2008-04-13,50,146,664,171,835,20
2008-04-14,1,1,2,2,4,1
2008-04-15,9,19,28,26,54,5
2008-04-16,23,101,226,109,335,11
2008-04-17,11,40,182,68,250,3
2008-04-18,5,11,26,6,32,2
2008-04-19,14,45,176,33,209,5
2008-04-20,33,70,691,52,743,11
2008-04-21,12,32,152,38,190,4
2008-04-22,14,56,97,80,177,10
2008-04-23,33,73,175,106,281,15
2008-04-24,2,8,14,2,16,2
2008-04-25,24,44,370,58,428,6
2008-04-26,11,86,335,122,457,7
2008-04-27,20,62,198,62,260,8
2008-04-28,12,16,68,11,79,9
2008-04-29,1,4,5,2,7,1
2008-04-30,30,44,153,37,190,18
2008-05-01,2,17,13,18,31,2
2008-05-02,3,3,1375,3,1378,3
2008-05-03,32,254,581,295,876,11
2008-05-04,15,67,124,111,235,11
2008-05-05,113,466,2133,1395,3528,31
2008-05-06,62,195,2102,193,2295,20
2008-05-07,4,13,102,59,161,2
2008-05-08,4,4,73,2,75,4
2008-05-09,44,167,824,185,1009,14
2008-05-10,1,10,21,7,28,1
2008-05-11,88,477,4006,644,4650,29
2008-05-12,5,18,76,19,95,3
2008-05-13,21,61,443,43,486,8
2008-05-14,173,595,1356,1031,2387,15
2008-05-15,30,544,3661,875,4536,9
2008-05-16,17,108,839,121,960,9
2008-05-17,8,23,113,46,159,7
2008-05-18,3,4,692,688,1380,2
2008-05-19,5,5,5,4,9,3
2008-05-20,8,56,119,49,168,6
2008-05-21,46,185,1751,170,1921,20
2008-05-22,3,7,5,11,16,3
2008-05-23,75,227,1158,311,1469,33
2008-05-24,64,438,1379,1405,2784,4
2008-05-25,188,627,4749,2163,6912,28
2008-05-26,21,69,225,56,281,17
2008-05-27,71,451,820,737,1557,8
2008-05-28,46,74,133,87,220,15
2008-05-29,6,14,36,8,44,4
2008-05-30,3,18,40,40,80,3
2008-05-31,27,42,565,316,881,10
2008-06-01,11,51,170,53,223,9
2008-06-02,39,122,2217,1945,4162,14
2008-06-03,12,28,59,26,85,9
2008-06-04,13,33,263,40,303,11
2008-06-06,162,182,680,569,1249,9
2008-06-07,7,9,20,4,24,3
2008-06-08,79,256,543,268,811,19
2008-06-09,35,56,368,117,485,13
2008-06-10,1,1,1,0,1,1
2008-06-11,16,67,228,130,358,11
2008-06-12,6,10,15,12,27,6
2008-06-13,9,26,168,48,216,6
2008-06-14,38,78,307,359,666,22
2008-06-15,11,12,40,14,54,7
2008-06-16,2,4,6,0,6,2
2008-06-17,13,22,113,85,198,12
2008-06-18,13,32,89,51,140,6
2008-06-19,33,68,515,142,657,18
2008-06-20,9,87,169,114,283,5
2008-06-21,5,5,26,3,29,5
2008-06-22,67,136,5763,358,6121,20
2008-06-23,49,166,1407,243,1650,26
2008-06-24,15,42,351,45,396,7
2008-06-25,77,221,1218,798,2016,23
2008-06-26,58,146,1045,119,1164,32
2008-06-27,34,80,366,119,485,16
2008-06-28,17,56,334,137,471,9
2008-06-29,13,39,141,56,197,9
2008-06-30,20,78,218,107,325,14
2008-07-01,58,222,1196,412,1608,25
2008-07-02,274,908,1444,1143,2587,20
2008-07-03,45,140,6709,189,6898,12
2008-07-04,13,36,67,57,124,5
2008-07-05,189,802,975,953,1928,20
2008-07-06,45,109,344,237,581,22
2008-07-07,66,177,885,294,1179,27
2008-07-08,40,202,2148,1051,3199,20
2008-07-09,41,127,618,192,810,24
2008-07-10,12,39,404,322,726,4
2008-07-12,15,35,90,29,119,11
2008-07-13,207,641,1955,1259,3214,31
2008-07-14,13,203,486,399,885,6
2008-07-15,82,332,1224,823,2047,34
2008-07-16,87,267,2680,933,3613,26
2008-07-17,189,719,1343,1155,2498,19
2008-07-18,5,43,123,65,188,5
2008-07-19,41,85,780,151,931,21
2008-07-20,13,34,188,61,249,11
2008-07-21,62,92,339,138,477,9
2008-07-22,67,319,779,693,1472,15
2008-07-23,34,83,178,96,274,24
2008-07-24,8,10,36,7,43,5
2008-07-25,24,53,273,74,347,16
2008-07-26,61,278,976,621,1597,32
2008-07-27,30,99,424,123,547,20
2008-07-28,4,4,31,2,33,3
2008-07-29,14,24,57,24,81,8
2008-07-30,50,151,508,180,688,25
2008-07-31,23,67,131,80,211,12
2008-08-02,88,555,1108,681,1789,29
2008-08-03,27,732,1434,1282,2716,16
2008-08-04,5,6,87,4,91,3
2008-08-05,19,29,85,25,110,12
2008-08-06,63,1246,1966,1419,3385,26
2008-08-07,8,35,200,46,246,4
2008-08-08,22,48,330,52,382,14
2008-08-09,17,28,94,31,125,7
2008-08-10,1,1,1,1,2,1
2008-08-11,24,54,195,56,251,16
2008-08-12,26,42,214,54,268,20
2008-08-13,28,442,1300,526,1826,18
2008-08-14,22,77,126,105,231,9
2008-08-15,7,12,37,11,48,7
2008-08-16,9,23,39,26,65,6
2008-08-17,78,187,397,201,598,18
2008-08-18,11,64,171,185,356,9
2008-08-19,16,48,52,65,117,7
2008-08-20,75,309,910,561,1471,25
2008-08-21,90,194,491,210,701,20
2008-08-22,13,35,76,33,109,11
2008-08-23,13,25,87,28,115,6
2008-08-24,46,102,350,200,550,16
2008-08-25,15,51,192,38,230,6
2008-08-26,16,42,205,129,334,9
2008-08-27,36,69,373,194,567,12
2008-08-28,13,59,771,469,1240,4
2008-08-29,42,94,255,83,338,18
2008-08-30,41,159,489,305,794,18
2008-08-31,105,445,2720,1615,4335,33
2008-09-01,16,38,294,80,374,6
2008-09-02,6,13,17,18,35,5
2008-09-03,340,1803,2743,1971,4714,26
2008-09-04,7,25,39,22,61,5
2008-09-05,63,283,1156,383,1539,36
2008-09-06,21,716,1036,755,1791,6
2008-09-07,32,207,1079,230,1309,16
2008-09-08,58,242,494,243,737,10
2008-09-09,33,66,604,513,1117,10
2008-09-10,81,276,10431,10081,20512,24
2008-09-11,2,2,4,0,4,2
2008-09-12,16,35,82,34,116,7
2008-09-13,7,19,150,24,174,2
2008-09-16,37,78,227,86,313,14
2008-09-18,2,2,13,2,15,1
2008-09-19,107,282,6331,5237,11568,26
2008-09-20,25,47,158,129,287,14
2008-09-21,4,18,25,16,41,4
2008-09-22,17,37,167,43,210,10
2008-09-23,10,29,51,27,78,5
2008-09-24,31,128,525,95,620,15
2008-09-25,62,291,2883,2007,4890,17
2008-09-26,10,15,49,19,68,7
2008-09-29,100,308,1386,501,1887,15
2008-09-30,61,116,606,175,781,31
2008-10-01,24,96,271,299,570,15
2008-10-03,103,376,1042,440,1482,31
2008-10-06,36,85,568,92,660,15
2008-10-07,1,4,4,4,8,1
2008-10-08,20,39,151,37,188,6
2008-10-09,52,181,838,384,1222,20
2008-10-10,20,57,281,39,320,10
2008-10-12,69,259,628,491,1119,15
2008-10-13,10,27,66,12,78,5
2008-10-14,7,51,153,19,172,7
2008-10-15,5,35,78,39,117,5
2008-10-16,17,35,424,52,476,14
2008-10-17,27,48,296,176,472,9
2008-10-18,61,1028,1822,1387,3209,21
2008-10-19,70,171,1672,315,1987,22
2008-10-20,3,29,81,40,121,3
2008-10-21,29,973,1592,1108,2700,13
2008-10-22,38,100,412,329,741,6
2008-10-23,9,27,89,35,124,4
2008-10-24,4,5,14,2,16,3
2008-10-25,18,58,240,159,399,10
2008-10-26,42,102,456,79,535,16
2008-10-27,12,58,218,32,250,8
2008-10-28,4,10,15,9,24,4
2008-10-30,3,9,8,10,18,2
2008-10-31,39,81,295,82,377,12
2008-11-01,13,17,183,9,192,5
2008-11-02,98,344,1765,494,2259,37
2008-11-03,27,110,671,182,853,12
2008-11-04,19,51,191,33,224,11
2008-11-05,35,82,421,128,549,8
2008-11-06,6,14,111,11,122,4
2008-11-07,7,50,111,27,138,6
2008-11-08,3,29,175,46,221,3
2008-11-09,67,215,696,434,1130,21
2008-11-11,40,70,179,62,241,16
2008-11-12,54,97,594,142,736,27
2008-11-13,72,402,2129,439,2568,23
2008-11-14,12,38,234,34,268,8
2008-11-15,36,106,374,100,474,11
2008-11-16,31,623,2521,664,3185,15
2008-11-17,9,12,29,13,42,7
2008-11-18,9,347,919,395,1314,9
2008-11-19,4,272,733,296,1029,4
2008-11-21,7,356,873,444,1317,7
2008-11-23,5,295,787,312,1099,5
2008-11-24,22,60,166,213,379,16
2008-11-25,3,25,59,50,109,3
2008-11-26,16,405,1113,642,1755,12
2008-11-27,13,15,15,15,30,5
2008-11-28,47,170,656,399,1055,17
2008-11-29,7,28,131,26,157,3
2008-12-01,32,1538,4091,1692,5783,19
2008-12-02,17,74,183,49,232,11
2008-12-03,37,98,441,97,538,19
2008-12-04,4,10,31,14,45,3
2008-12-05,23,43,342,33,375,10
2008-12-06,16,27,256,12,268,4
2008-12-07,14,53,128,73,201,8
2008-12-08,16,159,2309,151,2460,12
2008-12-09,6,195,272,196,468,5
2008-12-10,27,190,376,205,581,14
2008-12-11,13,35,141,16,157,6
2008-12-13,9,26,60,18,78,7
2008-12-14,1,1,3,0,3,1
2008-12-15,14,17,281,13,294,8
2008-12-16,9,68,159,73,232,6
2008-12-17,29,51,125,195,320,18
2008-12-18,25,454,2656,474,3130,7
2008-12-19,4,6,6,8,14,1
2008-12-20,54,111,301,119,420,9
2008-12-21,41,102,814,92,906,24
2008-12-22,10,53,216,70,286,7
2008-12-23,1,2,4,0,4,1
2008-12-24,4,12,64,14,78,2
2008-12-25,5,11,50,6,56,3
2008-12-26,1,1,5,0,5,1
2008-12-27,28,129,371,252,623,17
2008-12-28,1,1,3,2,5,1
2008-12-29,21,50,197,37,234,9
2008-12-30,2,14,141,127,268,1
2009-01-01,13,50,111,40,151,8
2009-01-02,3,4,57,4,61,2
2009-01-03,11,17,77,6,83,7
2009-01-05,37,68,241,94,335,15
2009-01-06,4,8,9,7,16,2
2009-01-07,43,104,912,85,997,22
2009-01-09,2,2,4,0,4,2
2009-01-10,5,13,52,18,70,3
2009-01-11,39,106,356,128,484,12
2009-01-12,20,74,585,58,643,12
2009-01-13,27,42,309,39,348,13
2009-01-14,34,80,340,78,418,21
2009-01-15,24,56,193,65,258,14
2009-01-16,2,3,32,0,32,1
2009-01-17,17,62,402,114,516,7
2009-01-18,139,385,2262,598,2860,62
2009-01-19,18,85,627,70,697,9
2009-01-20,19,53,125,48,173,15
2009-01-21,16,43,90,39,129,9
2009-01-22,69,165,642,287,929,16
2009-01-23,4,12,65,10,75,3
2009-01-24,31,69,717,78,795,14
2009-01-25,5,10,16,9,25,4
2009-01-26,79,223,1208,303,1511,28
2009-01-27,16,53,326,147,473,9
2009-01-28,47,106,807,117,924,23
2009-01-29,49,95,552,256,808,23
2009-01-30,2,2,5,5,10,1
2009-01-31,17,52,173,64,237,13
2009-02-01,87,223,926,341,1267,17
2009-02-02,6,27,99,49,148,6
2009-02-03,10,29,143,28,171,6
2009-02-04,72,138,957,312,1269,36
2009-02-05,9,26,71,19,90,7
2009-02-06,62,168,1035,225,1260,20
2009-02-07,44,127,488,449,937,25
2009-02-08,30,92,627,177,804,10
2009-02-09,11,25,72,17,89,8
2009-02-10,26,78,214,135,349,11
2009-02-11,83,216,1107,788,1895,33
2009-02-12,22,58,277,71,348,12
2009-02-13,6,10,69,6,75,4
2009-02-14,33,97,233,117,350,9
2009-02-15,68,236,1159,301,1460,21
2009-02-16,3,9,27,6,33,3
2009-02-17,2,6,25,8,33,1
2009-02-18,34,85,289,197,486,14
2009-02-19,6,7,103,5,108,4
2009-02-20,35,59,562,102,664,18
2009-02-21,8,37,111,32,143,5
2009-02-22,19,90,430,221,651,13
2009-02-23,8,12,191,9,200,5
2009-02-24,35,50,1280,43,1323,9
2009-02-25,38,87,314,113,427,21
2009-02-26,22,43,180,201,381,8
2009-02-27,35,158,770,197,967,22
2009-02-28,37,81,121,123,244,15
2009-03-01,2,8,8,5,13,2
2009-03-02,6,34,46,44,90,5
2009-03-03,15,59,262,50,312,8
2009-03-04,36,65,250,67,317,17
2009-03-05,54,258,1249,318,1567,24
2009-03-06,3,13,95,13,108,2
2009-03-07,29,92,314,120,434,17
2009-03-08,67,239,1098,558,1656,23
2009-03-09,14,67,342,104,446,7
2009-03-10,2,20,22,22,44,2
2009-03-11,69,271,1412,344,1756,27
2009-03-12,6,35,62,30,92,4
2009-03-13,82,184,1102,266,1368,26
2009-03-14,30,47,1092,1056,2148,4
2009-03-15,7,8,7,16,23,3
2009-03-16,8,19,17,30,47,4
2009-03-17,43,176,506,246,752,21
2009-03-18,56,288,1335,556,1891,12
2009-03-19,79,251,394,320,714,26
2009-03-20,48,217,934,612,1546,20
2009-03-21,10,29,229,16,245,3
2009-03-22,113,432,1081,639,1720,39
2009-03-23,58,213,615,309,924,25
2009-03-24,86,359,675,473,1148,19
2009-03-25,20,30,73,19,92,14
2009-03-26,42,280,888,367,1255,16
2009-03-27,26,93,307,191,498,17
2009-03-28,30,60,161,72,233,12
2009-03-29,2,7,12,9,21,2
2009-03-30,48,105,628,475,1103,31
2009-03-31,2,6,7,5,12,1
2009-04-01,22,43,145,51,196,16
2009-04-02,63,274,766,408,1174,25
2009-04-05,158,600,2194,983,3177,34
2009-04-06,48,245,642,307,949,10
2009-04-08,113,321,1802,1096,2898,47
2009-04-09,58,126,509,135,644,17
2009-04-11,4,5,7,6,13,3
2009-04-12,81,275,1633,841,2474,24
2009-04-13,391,2383,10275,5093,15368,16
2009-04-14,8,69,213,66,279,7
2009-04-16,7,32,86,53,139,5
2009-04-17,7,10,15,7,22,7
2009-04-18,109,347,1922,888,2810,40
2009-04-19,23,77,298,116,414,14
2009-04-20,34,74,235,81,316,20
2009-04-21,11,30,129,36,165,7
2009-04-23,56,113,297,157,454,22
2009-04-24,16,62,341,41,382,14
2009-04-25,31,90,307,97,404,22
2009-04-26,17,81,223,87,310,15
2009-04-27,7,7,8,5,13,6
2009-04-28,19,41,78,29,107,9
2009-04-29,20,409,1111,461,1572,10
2009-04-30,33,326,2581,358,2939,8
2009-05-01,31,54,1130,38,1168,5
2009-05-02,27,499,1122,621,1743,4
2009-05-03,41,121,450,163,613,12
2009-05-06,27,73,196,60,256,23
2009-05-07,4,5,5,8,13,2
2009-05-09,50,111,567,297,864,26
2009-05-10,47,148,761,457,1218,30
2009-05-11,6,30,49,34,83,5
2009-05-12,7,21,85,26,111,4
2009-05-13,12,18,81,29,110,9
2009-05-14,15,25,45,19,64,8
2009-05-16,17,354,555,358,913,14
2009-05-17,27,42,243,50,293,14
2009-05-18,51,137,607,247,854,15
2009-05-19,18,64,76,78,154,8
2009-05-20,7,20,55,15,70,4
2009-05-21,79,330,682,437,1119,14
2009-05-22,1,2,2,1,3,1
2009-05-23,75,252,1327,678,2005,33
2009-05-24,16,38,91,21,112,12
2009-05-25,547,3378,15874,7199,23073,18
2009-05-26,47,88,301,77,378,12
2009-05-27,6,51,185,134,319,4
2009-05-28,5,8,63,8,71,3
2009-05-29,23,49,434,52,486,13
2009-05-30,18,61,528,27,555,11
2009-05-31,120,357,988,684,1672,17
2009-06-01,66,113,7092,31,7123,27
2009-06-02,27,69,298,66,364,12
2009-06-03,31,96,381,84,465,8
2009-06-04,6,15,28,17,45,4
2009-06-06,65,324,1186,1162,2348,37
2009-06-07,6,16,19,10,29,3
2009-06-08,4,8,22,7,29,3
2009-06-09,19,40,74,81,155,12
2009-06-10,15,40,153,19,172,8
2009-06-11,4,4,4,4,8,4
2009-06-12,20,28,97,228,325,12
2009-06-13,64,319,7803,1052,8855,16
2009-06-14,14,89,241,157,398,10
2009-06-15,3,5,7,10,17,2
2009-06-18,51,176,505,191,696,24
2009-06-20,2,328,449,331,780,1
2009-06-21,84,211,566,452,1018,21
2009-06-22,29,74,162,75,237,12
2009-06-23,3,6,12,11,23,3
2009-06-25,12,41,354,29,383,7
2009-06-26,2,4,7,2,9,2
2009-06-27,98,250,625,368,993,20
2009-06-28,9,74,441,56,497,2
2009-06-29,2,3,5,0,5,1
2009-06-30,25,76,239,104,343,16
2009-07-01,2,4,5,4,9,2
2009-07-02,47,194,603,193,796,14
2009-07-03,2,5,6,10,16,1
2009-07-05,10,12,13,22,35,3
2009-07-06,88,267,544,415,959,16
2009-07-07,1,1,2,0,2,1
2009-07-08,11,126,176,118,294,9
2009-07-09,31,140,551,202,753,10
2009-07-10,6,35,102,51,153,5
2009-07-11,34,150,514,272,786,17
2009-07-12,2,6,25,18,43,1
2009-07-13,4,4,5,2,7,3
2009-07-14,3,3,4,3,7,3
2009-07-15,3,5,2,7,9,1
2009-07-16,3,4,7,3,10,3
2009-07-18,6,9,42,21,63,4
2009-07-19,9,23,66,41,107,6
2009-07-20,5,6,175,173,348,2
2009-07-22,5,12,152,16,168,3
2009-07-23,30,56,324,61,385,14
2009-07-24,19,48,132,61,193,10
2009-07-25,50,104,488,114,602,24
2009-07-26,13,44,355,19,374,7
2009-07-28,6,7,7,10,17,2
2009-07-29,74,130,2118,135,2253,16
2009-07-30,6,7,95,3,98,3
2009-07-31,14,62,163,70,233,8
2009-08-01,1,1,1,0,1,1
2009-08-02,1,1,2,0,2,1
2009-08-04,5,8,102,12,114,5
2009-08-05,76,186,1334,420,1754,26
2009-08-06,39,116,575,225,800,26
2009-08-07,11,30,167,8,175,7
2009-08-08,106,401,1674,707,2381,13
2009-08-09,18,23,92,17,109,10
2009-08-10,35,151,2155,258,2413,21
2009-08-11,40,105,456,151,607,12
2009-08-12,50,93,371,127,498,16
2009-08-13,16,274,642,299,941,9
2009-08-14,8,43,194,71,265,5
2009-08-15,31,83,559,46,605,15
2009-08-16,18,43,430,30,460,6
2009-08-17,3,4,33,3,36,2
2009-08-18,35,53,162,495,657,12
2009-08-19,20,48,377,25,402,12
2009-08-20,6,12,32,7,39,4
2009-08-21,14,26,205,73,278,7
2009-08-22,75,163,1287,141,1428,12
2009-08-23,9,63,177,71,248,7
2009-08-24,58,152,1293,159,1452,24
2009-08-25,23,50,204,48,252,8
2009-08-26,45,77,499,63,562,13
2009-08-27,47,124,1355,246,1601,18
2009-08-28,35,51,234,544,778,13
2009-08-29,49,178,903,280,1183,15
2009-08-30,1,2,2,2,4,1
2009-08-31,6,34,173,42,215,4
2009-09-01,37,147,1377,195,1572,11
2009-09-02,4,9,37,9,46,2
2009-09-03,23,115,516,107,623,12
2009-09-04,25,69,234,93,327,11
2009-09-05,4,574,982,583,1565,2
2009-09-06,17,49,154,63,217,13
2009-09-07,47,219,1414,218,1632,13
2009-09-08,7,28,131,16,147,3
2009-09-09,2,5,3,13,16,2
2009-09-10,4,23,85,39,124,4
2009-09-11,11,25,56,38,94,7
2009-09-12,15,21,79,6,85,5
2009-09-13,74,179,1294,387,1681,25
2009-09-14,11,11,12,10,22,6
2009-09-15,17,121,691,394,1085,9
2009-09-16,14,44,180,51,231,6
2009-09-17,1,1,1,0,1,1
2009-09-18,1,9,65,33,98,1
2009-09-19,60,84,1910,53,1963,17
2009-09-20,2,2,2,0,2,2
2009-09-21,4,228,542,260,802,3
2009-09-22,9,28,69,25,94,7
2009-09-23,2,4,7,2,9,2
2009-09-25,6,7,25,3,28,6
2009-09-26,1,8,15,9,24,1
2009-09-29,20,51,217,97,314,13
2009-09-30,1,1,1,0,1,1
2009-10-01,7,20,27,25,52,4
2009-10-02,11,15,20,13,33,8
2009-10-03,2,2,2,1,3,1
2009-10-04,6,9,54,9,63,3
2009-10-05,4,5,60,9,69,2
2009-10-07,2,4,7,4,11,2
2009-10-08,8,16,45,11,56,5
2009-10-09,40,62,159,75,234,29
2009-10-10,9,35,111,38,149,5
2009-10-11,3,5,13,13,26,3
2009-10-12,14,18,118,19,137,9
2009-10-13,7,11,51,6,57,4
2009-10-14,16,22,77,17,94,9
2009-10-15,1,1,2,2,4,1
2009-10-17,23,74,624,165,789,6
2009-10-18,7,20,134,18,152,3
2009-10-19,35,122,463,171,634,22
2009-10-20,77,230,1811,440,2251,30
2009-10-21,11,23,122,95,217,8
2009-10-22,13,35,105,86,191,9
2009-10-23,9,15,78,3,81,6
2009-10-24,11,32,333,30,363,7
2009-10-25,43,81,132,93,225,6
2009-10-26,21,57,171,40,211,11
2009-10-27,31,72,4387,28,4415,10
2009-10-28,28,62,406,223,629,16
2009-10-30,22,40,128,18,146,14
2009-10-31,80,271,1625,395,2020,26
2009-11-02,5,12,14,12,26,5
2009-11-03,5,14,1000,8,1008,5
2009-11-04,7,12,61,6,67,5
2009-11-05,48,183,1931,107,2038,21
2009-11-06,2,3,4,5,9,2
2009-11-07,10,67,202,98,300,7
2009-11-09,17,38,1252,48,1300,11
2009-11-10,104,275,1601,958,2559,55
2009-11-11,1,1,1,1,2,2
2009-11-13,39,80,814,145,959,13
2009-11-14,18,546,1180,723,1903,15
2009-11-15,8,10,317,6,323,7
2009-11-16,117,311,1252,438,1690,37
2009-11-17,20,82,582,82,664,7
2009-11-18,43,191,679,422,1101,17
2009-11-19,3,5,11,5,16,2
2009-11-20,16,39,104,43,147,8
2009-11-21,170,561,6051,1283,7334,29
2009-11-22,7,17,52,21,73,6
2009-11-23,92,237,1032,276,1308,33
2009-11-24,64,145,1537,140,1677,18
2009-11-25,16,42,85,44,129,6
2009-11-26,2,2,134,134,268,1
2009-11-27,12,22,204,11,215,9
2009-11-28,16,42,197,44,241,7
2009-11-29,2,5,59,2,61,1
2009-11-30,366,1547,15430,2892,18322,21
2009-12-01,21,75,1089,48,1137,12
2009-12-02,11,21,64,18,82,6
2009-12-03,94,195,886,214,1100,38
2009-12-04,15,35,77,18,95,4
2009-12-05,42,131,666,256,922,17
2009-12-06,1,2,21,1,22,1
2009-12-07,334,1483,13871,3040,16911,13
2009-12-08,9,13,56,12,68,6
2009-12-09,32,376,2030,422,2452,16
2009-12-10,11,20,42,161,203,4
2009-12-11,9,17,34,169,203,3
2009-12-12,8,21,28,13,41,4
2009-12-13,1,2,4,1,5,1
2009-12-14,12,29,85,23,108,5
2009-12-15,1,1,15,0,15,1
2009-12-16,24,38,142,25,167,7
2009-12-18,2,5,40,4,44,2
2009-12-19,2,7,54,9,63,1
2009-12-20,7,12,52,15,67,4
2009-12-21,12,120,868,224,1092,8
2009-12-22,5,17,44,7,51,3
2009-12-23,5,5,40,3,43,3
2009-12-26,79,238,1794,227,2021,20
2009-12-27,2,2,2,2,4,2
2009-12-28,21,111,762,92,854,5
2009-12-29,12,23,37,39,76,6
2009-12-30,29,97,460,76,536,16
2009-12-31,21,40,148,39,187,11
2010-01-02,3,7,42,1,43,2
2010-01-03,8,22,65,20,85,4
2010-01-04,25,59,370,91,461,7
2010-01-05,1,2,26,6,32,1
2010-01-06,35,86,491,360,851,20
2010-01-07,45,133,926,154,1080,20
2010-01-08,1,2,1,3,4,1
2010-01-09,8,34,186,79,265,6
2010-01-10,216,833,1730,970,2700,49
2010-01-11,5,15,207,33,240,2
2010-01-12,73,392,1832,424,2256,44
2010-01-13,66,280,2075,508,2583,10
2010-01-14,36,121,314,150,464,22
2010-01-15,13,37,129,26,155,7
2010-01-16,7,16,25,20,45,5
2010-01-17,99,287,1637,641,2278,32
2010-01-18,35,89,505,118,623,12
2010-01-19,83,301,1024,358,1382,28
2010-01-20,167,502,2721,1039,3760,37
2010-01-21,191,887,2663,1338,4001,20
2010-01-22,68,93,2656,2601,5257,22
2010-01-23,93,466,3269,506,3775,37
2010-01-24,33,103,419,301,720,19
2010-01-25,36,123,890,164,1054,14
2010-01-26,483,2744,16762,6560,23322,29
2010-01-27,28,93,342,73,415,13
2010-01-28,51,1271,2244,1464,3708,19
2010-01-29,15,1574,5537,1743,7280,10
2010-01-30,28,79,362,99,461,19
2010-01-31,1537,15348,198673,55133,253806,12
2010-02-01,20,84,564,79,643,8
2010-02-02,10,579,822,647,1469,7
2010-02-03,16,71,451,92,543,6
2010-02-04,33,58,129,108,237,9
2010-02-05,14,25,107,93,200,4
2010-02-06,44,213,634,196,830,20
2010-02-07,40,2086,3011,2417,5428,4
2010-02-08,10,18,51,28,79,8
2010-02-09,16,28,86,36,122,10
2010-02-10,38,156,601,154,755,18
2010-02-12,24,50,120,50,170,17
2010-02-13,26,78,391,67,458,12
2010-02-14,77,399,2251,549,2800,33
2010-02-15,12,17,40,18,58,8
2010-02-16,26,40,332,30,362,11
2010-02-17,96,328,770,656,1426,36
2010-02-18,20,62,78,72,150,2
2010-02-19,28,50,150,66,216,5
2010-02-20,17,47,211,70,281,12
2010-02-21,29,177,546,180,726,11
2010-02-22,195,222,37434,37348,74782,10
2010-02-23,23,47,341,56,397,9
2010-02-24,40,92,224,148,372,23
2010-02-25,17,38,111,55,166,11
2010-02-26,17,97,613,109,722,12
2010-02-28,29,65,269,52,321,15
2010-03-01,4,4,18,0,18,2
2010-03-02,89,298,1182,599,1781,34
2010-03-03,29,205,542,236,778,13
2010-03-04,3,6,9,5,14,3
2010-03-05,45,106,496,105,601,22
2010-03-07,119,415,1962,527,2489,51
2010-03-08,64,208,853,295,1148,23
2010-03-09,20,47,574,28,602,5
2010-03-10,200,232,37359,37178,74537,7
2010-03-12,2,15,15,15,30,2
2010-03-13,68,213,1682,248,1930,23
2010-03-14,20,49,228,28,256,9
2010-03-15,51,243,2386,440,2826,9
2010-03-16,2,8,9,7,16,1
2010-03-17,13,30,42,76,118,12
2010-03-20,86,309,1154,358,1512,36
2010-03-21,44,126,503,124,627,25
2010-03-22,16,40,24,47,71,3
2010-03-24,84,273,2679,179,2858,16
2010-03-25,13,82,238,149,387,9
2010-03-28,25,43,219,57,276,12
2010-03-29,26,127,612,212,824,11
2010-03-30,10,17,56,11,67,7
2010-03-31,25,48,79,35,114,12
2010-04-01,14,46,562,122,684,7
2010-04-02,28,55,754,122,876,12
2010-04-03,76,276,830,319,1149,31
2010-04-04,15,71,194,90,284,11
2010-04-05,1,2,0,2,2,1
2010-04-06,18,121,338,225,563,9
2010-04-07,13,43,132,68,200,8
2010-04-08,3,4,19,6,25,2
2010-04-09,16,46,107,45,152,7
2010-04-10,63,177,393,188,581,31
2010-04-11,30,118,329,197,526,16
2010-04-12,5,19,45,47,92,4
2010-04-13,9,27,90,28,118,7
2010-04-14,16,50,302,60,362,5
2010-04-15,9,55,117,42,159,5
2010-04-17,21,81,117,91,208,15
2010-04-18,12,56,195,76,271,11
2010-04-19,32,135,456,140,596,14
2010-04-20,25,103,451,112,563,16
2010-04-21,3,6,141,0,141,1
2010-04-22,2,4,12,4,16,2
2010-04-23,11,23,73,28,101,7
2010-04-24,4,7,36,15,51,2
2010-05-01,21,54,383,43,426,15
2010-05-02,11,15,16,13,29,4
2010-05-03,10,32,346,81,427,5
2010-05-04,25,68,262,75,337,12
2010-05-06,5,13,75,10,85,3
2010-05-07,12,23,83,22,105,5
2010-05-08,16,23,332,130,462,10
2010-05-09,92,313,1503,504,2007,36
2010-05-10,17,30,133,88,221,11
2010-05-11,2,2,13,1,14,1
2010-05-12,6,14,112,7,119,4
2010-05-19,18,26,50,17,67,11
2010-05-20,44,188,813,199,1012,20
2010-05-21,118,519,2821,577,3398,32
2010-05-24,23,55,282,140,422,10
2010-05-25,13,30,75,63,138,8
2010-05-27,1,1,3,1,4,1
2010-05-28,13,31,101,15,116,8
2010-05-29,1,1,6,0,6,1
2010-05-30,1,5,10,4,14,1
2010-05-31,69,136,191,149,340,6
2010-06-01,59,258,1906,1505,3411,30
2010-06-02,39,107,539,142,681,30
2010-06-03,10,30,206,31,237,6
2010-06-05,7,46,108,68,176,4
2010-06-06,8,23,148,9,157,5
2010-06-07,17,63,235,87,322,8
2010-06-08,3,4,4,4,8,1
2010-06-10,1,1,1,0,1,1
2010-06-11,24,51,549,356,905,14
2010-06-12,9,25,71,17,88,3
2010-06-13,86,236,1870,849,2719,32
2010-06-14,16,45,150,40,190,11
2010-06-15,1,1,1,1,2,1
2010-06-16,69,285,1049,292,1341,24
2010-06-17,5,12,63,19,82,3
2010-06-18,77,399,3033,1743,4776,29
2010-06-20,1,1,1,1,2,1
2010-06-21,170,547,2102,728,2830,43
2010-06-22,59,223,1127,267,1394,24
2010-06-23,2,20,34,20,54,2
2010-06-24,14,29,213,15,228,8
2010-06-25,75,159,528,151,679,15
2010-06-27,111,347,730,336,1066,18
2010-06-28,17,70,319,55,374,12
2010-06-29,18,51,96,52,148,9
2010-06-30,76,251,1905,1018,2923,14
2010-07-02,13,27,201,17,218,5
2010-07-05,66,130,553,343,896,22
2010-07-06,6,15,33,12,45,5
2010-07-07,83,243,1031,235,1266,20
2010-07-08,2,9,13,9,22,2
2010-07-09,1111,9281,104314,49118,153432,14
2010-07-10,3,3,5,1,6,3
2010-07-12,11,27,72,44,116,5
2010-07-13,10,26,86,33,119,7
2010-07-14,19,46,365,41,406,10
2010-07-15,47,104,757,278,1035,18
2010-07-16,15,43,228,89,317,9
2010-07-19,25,56,290,183,473,15
2010-07-20,30,58,97,50,147,9
2010-07-21,10,29,65,75,140,5
2010-07-23,21,120,289,137,426,15
2010-07-25,1,1,2,0,2,1
2010-07-26,36,90,652,252,904,25
2010-07-27,44,65,226,33,259,15
2010-07-28,8,12,70,35,105,7
2010-07-30,11,26,76,12,88,7
2010-08-02,39,113,344,104,448,21
2010-08-03,34,93,284,61,345,8
2010-08-04,6,15,35,36,71,5
2010-08-05,5,15,52,30,82,5
2010-08-06,44,196,739,243,982,21
2010-08-07,2,2,13,2,15,2
2010-08-09,72,186,781,142,923,23
2010-08-11,68,170,824,165,989,22
2010-08-12,18,29,175,19,194,9
2010-08-13,30,80,357,221,578,17
2010-08-15,62,133,2058,113,2171,19
2010-08-16,35,115,681,325,1006,16
2010-08-17,6,10,74,18,92,3
2010-08-18,227,1089,12794,5412,18206,95
2010-08-19,18,37,129,86,215,10
2010-08-20,65,207,558,339,897,31
2010-08-22,113,311,1954,426,2380,32
2010-08-23,20,34,37,36,73,4
2010-08-24,26,58,164,63,227,13
2010-08-25,8,17,43,15,58,6
2010-08-26,27,67,160,122,282,10
2010-08-27,17,32,271,28,299,7
2010-08-30,14,15,47,22,69,6
2010-08-31,129,338,3357,503,3860,37
2010-09-01,31,57,400,28,428,12
2010-09-03,127,536,11980,4889,16869,21
2010-09-04,71,522,1191,670,1861,7
2010-09-06,77,302,521,525,1046,10
2010-09-07,227,248,5243,5226,10469,7
2010-09-08,26,53,227,28,255,9
2010-09-09,42,174,457,207,664,13
2010-09-10,243,290,5418,5278,10696,20
2010-09-11,1,2,5,1,6,1
2010-09-12,10,52,114,92,206,6
2010-09-13,7,371,520,456,976,5
2010-09-14,2,3,3,2,5,2
2010-09-15,56,613,953,719,1672,11
2010-09-16,3,18,48,44,92,3
2010-09-17,2,2,2,2,4,2
2010-09-18,10,26,62,48,110,8
2010-09-24,8,14,183,9,192,6
2010-09-27,57,91,261,91,352,26
2010-09-28,3,26,53,29,82,2
2010-09-29,79,222,1063,199,1262,28
2010-09-30,78,196,1132,347,1479,64
2010-10-01,12,31,74,23,97,8
2010-10-03,11,17,46,16,62,9
2010-10-04,3,11,24,9,33,2
2010-10-05,7,18,84,16,100,5
2010-10-06,96,286,854,386,1240,40
2010-10-07,3,6,18,10,28,3
2010-10-08,66,118,159,159,318,8
2010-10-13,47,122,1050,125,1175,24
2010-10-14,53,87,170,105,275,9
2010-10-17,2,2,7,1,8,1
2010-10-18,25,71,309,153,462,14
2010-10-19,17,51,133,64,197,9
2010-10-20,9,24,164,57,221,7
2010-10-21,64,149,281,213,494,9
2010-10-22,78,143,352,164,516,12
2010-10-25,1,2,2,2,4,1
2010-10-26,3,6,13,3,16,2
2010-10-27,53,207,720,248,968,14
2010-10-28,6,19,44,33,77,3
2010-10-29,14,21,106,4,110,7
2010-11-03,56,144,235,151,386,18
2010-11-04,55,153,1192,263,1455,22
2010-11-05,16,45,218,41,259,10
2010-11-08,2,6,9,4,13,1
2010-11-09,119,243,507,463,970,17
2010-11-10,40,68,569,347,916,23
2010-11-11,4,11,43,14,57,4
2010-11-12,21,55,381,31,412,4
2010-11-13,2,2,3,1,4,2
2010-11-14,3,97,107,52,159,2
2010-11-15,74,100,143,117,260,11
2010-11-16,3,5,46,15,61,3
2010-11-17,149,439,4447,491,4938,61
2010-11-18,1,8,35,2,37,1
2010-11-19,8,24,54,27,81,3
2010-11-22,1,1,1,1,2,1
2010-11-23,5,7,31,0,31,2
2010-11-24,297,825,3544,1619,5163,61
2010-11-26,16,26,48,37,85,11
2010-11-29,56,104,4305,70,4375,42
2010-11-30,58,252,1649,392,2041,21
2010-12-01,29,82,726,84,810,13
2010-12-02,54,105,457,68,525,17
2010-12-03,15,28,59,27,86,10
2010-12-04,43,137,794,299,1093,8
2010-12-05,2,6,37,8,45,1
2010-12-06,3,12,12,11,23,2
2010-12-07,28,87,421,280,701,18
2010-12-08,61,174,4390,211,4601,16
2010-12-09,49,129,369,95,464,23
2010-12-10,18,38,85,37,122,10
2010-12-11,15,333,506,331,837,8
2010-12-12,2,2,2,0,2,2
2010-12-13,82,207,1478,1019,2497,24
2010-12-14,50,480,2747,491,3238,25
2010-12-15,744,3474,27931,13340,41271,12
2010-12-16,55,192,1173,212,1385,17
2010-12-17,8,27,52,13,65,5
2010-12-19,8,19,81,80,161,8
2010-12-20,11,14,75,51,126,4
2010-12-21,19,116,300,79,379,13
2010-12-22,54,437,1186,538,1724,21
2010-12-23,6,11,28,13,41,5
2010-12-26,2,4,6,2,8,2
2010-12-27,9,9,53,2,55,3
2010-12-28,45,133,4688,190,4878,13
2010-12-29,1,2,2,2,4,1
2011-01-04,25,55,150,69,219,12
2011-01-05,14,35,138,30,168,7
2011-01-06,5,43,46,41,87,3
2011-01-07,3,7,23,16,39,3
2011-01-09,7,6,12,3,15,6
2011-01-10,13,18,90,33,123,9
2011-01-11,7,610,1233,1177,2410,5
2011-01-12,1,2,2,2,4,1
2011-01-13,20,62,210,94,304,14
2011-01-16,1,2,3,6,9,1
2011-01-18,48,122,885,120,1005,7
2011-01-19,24,153,866,4224,5090,19
2011-01-20,1,1,1,1,2,1
2011-01-21,3,29,131,99,230,2
2011-01-24,15,342,1017,4417,5434,9
2011-01-27,19,31,2344,16,2360,11
2011-01-28,13,34,54,32,86,11
2011-01-31,5,6,10,5,15,3
2011-02-03,62,220,733,503,1236,24
2011-02-06,3,6,7,11,18,3
2011-02-07,33,60,351,70,421,19
2011-02-08,5,31,236,108,344,3
2011-02-09,1,1,1,1,2,1
2011-02-10,139,619,2169,1206,3375,47
2011-02-11,7,19,47,13,60,4
2011-02-12,4,5,24,2,26,1
2011-02-13,8,11,24,5,29,4
2011-02-14,14,46,173,62,235,7
2011-02-15,48,113,286,244,530,20
2011-02-16,21,47,204,79,283,10
2011-02-17,13,31,160,32,192,7
2011-02-18,2,2,12,1,13,1
2011-02-19,11,21,43,42,85,3
2011-02-21,33,147,212,115,327,20
2011-02-22,44,238,659,359,1018,17
2011-02-23,7,16,115,12,127,4
2011-02-24,4,13,98,22,120,4
2011-02-25,5,8,16,8,24,3
2011-02-26,51,199,1472,329,1801,17
2011-02-27,8,29,167,52,219,8
2011-02-28,109,479,2233,890,3123,28
2011-03-01,21,110,1391,211,1602,4
2011-03-02,17,36,154,75,229,11
2011-03-03,1,2,0,2,2,1
2011-03-04,23,47,122,67,189,11
2011-03-05,1,15,56,45,101,1
2011-03-06,1,4,13,2,15,1
2011-03-07,31,137,451,408,859,12
2011-03-08,49,191,518,203,721,21
2011-03-09,79,203,1205,405,1610,27
2011-03-10,112,797,1011,867,1878,73
2011-03-11,160,170,66,856,922,8
2011-03-13,5,7,36,4,40,4
2011-03-14,7,10,34,9,43,6
2011-03-15,183,289,442,1003,1445,27
2011-03-16,103,219,654,474,1128,27
2011-03-17,30,90,210,177,387,9
2011-03-18,4,16,35,18,53,4
2011-03-20,69,256,1019,444,1463,19
2011-03-21,35,79,322,72,394,20
2011-03-22,108,368,770,1315,2085,25
2011-03-23,73,312,1117,504,1621,23
2011-03-24,7,17,123,15,138,4
2011-03-25,24,96,294,208,502,11
2011-03-26,46,456,3074,605,3679,9
2011-03-27,32,64,489,74,563,11
2011-03-28,36,106,699,80,779,17
2011-03-29,33,86,169,130,299,20
2011-03-30,34,72,295,248,543,17
2011-03-31,7,13,80,11,91,4
2011-04-01,32,127,529,162,691,20
2011-04-02,79,829,1232,902,2134,7
2011-04-03,59,115,553,134,687,23
2011-04-04,25,105,677,99,776,8
2011-04-05,9,15,36,40,76,2
2011-04-06,35,124,599,355,954,17
2011-04-07,8,13,149,9,158,5
2011-04-08,5,16,48,14,62,2
2011-04-09,4,11,29,4,33,3
2011-04-11,31,89,163,65,228,14
2011-04-12,18,56,106,87,193,15
2011-04-13,44,155,511,161,672,20
2011-04-14,18,138,196,167,363,10
2011-04-15,446,2567,11158,4376,15534,9
2011-04-18,1,3,6,11,17,1
2011-04-19,11,18,43,23,66,6
2011-04-20,3,6,29,6,35,2
2011-04-21,5,11,104,67,171,3
2011-04-22,3,17,28,19,47,2
2011-04-24,23,46,146,76,222,6
2011-04-25,2,4,8,0,8,2
2011-04-26,15,42,369,58,427,9
2011-04-27,60,144,495,229,724,23
2011-04-28,44,378,1177,988,2165,12
2011-04-29,53,188,1857,279,2136,27
2011-05-01,5,13,55,30,85,5
2011-05-02,64,330,655,452,1107,9
2011-05-03,435,2587,9831,4430,14261,1
2011-05-04,63,186,1010,399,1409,28
2011-05-05,17,32,51,36,87,15
2011-05-06,70,273,894,450,1344,24
2011-05-08,8,12,101,101,202,5
2011-05-09,40,131,496,185,681,20
2011-05-10,29,93,295,138,433,19
2011-05-11,38,214,825,556,1381,16
2011-05-13,59,152,1979,332,2311,24
2011-05-14,3,12,111,8,119,2
2011-05-15,57,189,1325,226,1551,21
2011-05-16,44,152,514,282,796,27
2011-05-17,5,13,24,19,43,3
2011-05-18,20,46,206,30,236,10
2011-05-19,16,52,200,45,245,5
2011-05-20,56,179,1737,301,2038,25
2011-05-21,76,186,725,209,934,59
2011-05-22,10,39,124,42,166,7
2011-05-23,44,117,1336,140,1476,15
2011-05-24,40,107,1757,951,2708,19
2011-05-25,44,217,447,208,655,10
2011-05-26,158,518,4383,2833,7216,56
2011-05-27,24,70,153,69,222,16
2011-05-28,3,5,28,2,30,2
2011-05-29,6,14,28,12,40,5
2011-05-30,47,123,660,162,822,12
2011-05-31,1733,14730,159165,66042,225207,27
2011-06-01,17,40,74,69,143,8
2011-06-02,7,11,268,119,387,5
2011-06-03,3,6,22,11,33,2
2011-06-05,1,1,1,1,2,1
2011-06-06,45,89,503,338,841,20
2011-06-07,7,13,24,26,50,5
2011-06-08,2,11,22,16,38,2
2011-06-09,8,21,95,43,138,6
2011-06-10,39,137,343,170,513,7
2011-06-12,3,10,68,5,73,3
2011-06-13,4,13,198,14,212,3
2011-06-15,30,75,1025,75,1100,11
2011-06-16,12,43,65,49,114,5
2011-06-17,4,4,8,5,13,4
2011-06-19,13,22,44,21,65,4
2011-06-20,16,34,81,31,112,9
2011-06-21,4,10,4,22,26,4
2011-06-22,59,157,813,391,1204,27
2011-06-23,8,22,40,36,76,8
2011-06-24,2,2,2,2,4,2
2011-06-26,11,38,225,20,245,5
2011-06-27,5,13,37,16,53,4
2011-06-28,4,6,38,3,41,3
2011-06-29,25,47,113,44,157,9
2011-06-30,76,346,2218,464,2682,20
2011-07-01,3,7,9,6,15,2
2011-07-06,3832,38882,306096,124870,430966,9
2011-07-07,14,31,262,219,481,6
2011-07-08,2,10,129,1,130,2
2011-07-11,14,38,153,43,196,6
2011-07-12,14,23,371,13,384,4
2011-07-13,36,115,455,155,610,15
2011-07-14,14,37,58,143,201,6
2011-07-19,118,413,1770,696,2466,37
2011-07-20,9,29,111,47,158,6
2011-07-21,2,2,82,2,84,2
2011-07-22,121,182,659,280,939,18
2011-07-24,17,44,126,42,168,14
2011-07-25,2,2,2,3,5,1
2011-07-28,2,5,11,4,15,1
2011-08-01,82,259,927,396,1323,32
2011-08-02,4,5,35,34,69,1
2011-08-03,14,37,53,63,116,10
2011-08-04,100,372,1188,456,1644,53
2011-08-05,16,37,238,23,261,8
2011-08-08,45,154,688,248,936,30
2011-08-09,5,8,39,3,42,2
2011-08-11,69,132,767,279,1046,21
2011-08-14,97,382,2261,698,2959,72
2011-08-16,167,317,1173,378,1551,28
2011-08-17,3,4,43,35,78,2
2011-08-18,112,400,2372,897,3269,25
2011-08-19,56,193,677,486,1163,16
2011-08-21,21,62,1914,57,1971,7
2011-08-22,32,48,359,86,445,16
2011-08-23,66,135,830,125,955,21
2011-08-24,9,18,43,34,77,6
2011-08-25,54,148,764,553,1317,15
2011-08-26,12,43,131,33,164,8
2011-08-27,7,27,44,21,65,5
2011-08-28,1,2,5,5,10,1
2011-08-29,100,336,1407,422,1829,37
2011-08-30,8,21,146,73,219,8
2011-08-31,2,2,2,1,3,2
2011-09-01,23,61,1122,75,1197,10
2011-09-02,44,276,3796,531,4327,18
2011-09-04,5,15,44,7,51,2
2011-09-05,1,1,91,0,91,1
2011-09-06,33,72,112,153,265,11
2011-09-07,3,32,48,49,97,3
2011-09-08,21,50,203,71,274,6
2011-09-09,9,29,206,123,329,5
2011-09-11,5,12,11,12,23,5
2011-09-12,77,139,703,207,910,29
2011-09-13,7,30,656,27,683,4
2011-09-14,12,44,215,95,310,7
2011-09-15,9,19,38,27,65,6
2011-09-16,7,8,411,395,806,4
2011-09-17,10,22,66,16,82,2
2011-09-18,11,57,88,61,149,4
2011-09-19,6,14,17,13,30,3
2011-09-20,4,4,4,4,8,2
2011-09-21,12,32,51,34,85,7
2011-09-22,16,68,188,25,213,9
2011-09-23,34,72,312,84,396,11
2011-09-26,9,47,78,62,140,7
2011-09-27,8,21,46,32,78,7
2011-09-28,13,25,49,22,71,6
2011-09-29,3,4,10,4,14,3
2011-09-30,12,93,399,203,602,6
2011-10-03,28,73,264,161,425,19
2011-10-04,7,19,64,21,85,5
2011-10-05,200,727,3891,994,4885,73
2011-10-06,23,45,78,51,129,12
2011-10-07,18,85,246,172,418,13
2011-10-08,3,7,11,9,20,2
2011-10-09,6,6,6,7,13,5
2011-10-10,73,355,1281,668,1949,24
2011-10-11,3,7,55,5,60,2
2011-10-12,35,104,461,256,717,16
2011-10-13,12,33,198,84,282,6
2011-10-14,49,179,543,191,734,23
2011-10-15,8,23,43,21,64,8
2011-10-16,77,208,2149,603,2752,36
2011-10-17,13,39,102,49,151,10
2011-10-18,68,359,1687,567,2254,39
2011-10-19,61,197,2189,632,2821,24
2011-10-20,3,1,4,0,4,2
2011-10-21,88,411,1595,672,2267,46
2011-10-24,10,12,18,12,30,8
2011-10-26,89,324,947,520,1467,36
2011-10-27,27,80,202,86,288,13
2011-10-28,11,22,75,36,111,5
2011-10-31,29,88,1181,681,1862,15
2011-11-01,60,148,964,787,1751,23
2011-11-02,4,7,22,6,28,3
2011-11-03,1,4,9,4,13,1
2011-11-04,10,26,25,31,56,7
2011-11-05,71,191,326,264,590,5
2011-11-06,9,18,76,17,93,7
2011-11-07,33,91,227,90,317,15
2011-11-08,24,91,267,126,393,11
2011-11-09,22,58,252,95,347,13
2011-11-10,2435,23895,255547,98385,353932,5
2011-11-12,1,1,1,0,1,1
2011-11-13,30,87,377,51,428,7
2011-11-15,5,22,50,29,79,2
2011-11-16,12,18,48,18,66,6
2011-11-17,12,50,100,49,149,6
2011-11-18,22,115,252,147,399,13
2011-11-21,18,42,73,51,124,10
2011-11-22,13,37,112,40,152,4
2011-11-23,2399,9312,381746,51378,433124,11
2011-11-28,16,39,86,29,115,7
2011-11-29,7,26,101,20,121,4
2011-11-30,6,16,56,29,85,4
2011-12-01,12,23,352,74,426,2
2011-12-02,3,4,6,10,16,1
2011-12-05,77,238,575,234,809,24
2011-12-06,62,154,1242,93,1335,11
2011-12-07,1,1,3,1,4,1
2011-12-08,7,43,159,143,302,7
2011-12-09,149,559,1489,826,2315,18
2011-12-10,1,19,47,36,83,1
2011-12-12,92,375,2473,554,3027,48
2011-12-13,74,143,808,190,998,23
2011-12-14,103,404,1318,457,1775,30
2011-12-15,25,75,137,80,217,13
2011-12-16,13,39,155,59,214,6
2011-12-17,28,163,788,366,1154,8
2011-12-18,1425,15320,150018,63576,213594,7
2011-12-19,11,30,95,30,125,9
2011-12-20,154,586,4172,840,5012,24
2011-12-21,29,68,157,77,234,17
2011-12-22,66,227,786,341,1127,23
2011-12-27,31,35,1266,789,2055,12
2011-12-28,62,191,893,350,1243,27
2011-12-29,1,1,1,0,1,1
2012-01-01,5,28,81,35,116,2
2012-01-03,37,74,1841,918,2759,12
2012-01-04,31,62,63,43,106,6
2012-01-05,26,79,457,55,512,9
2012-01-06,70,211,1156,234,1390,17
2012-01-08,23,67,434,34,468,10
2012-01-09,7,21,36,34,70,6
2012-01-10,31,67,248,35,283,15
2012-01-11,5,6,6,6,12,3
2012-01-12,25,65,1307,877,2184,17
2012-01-13,22,31,108,29,137,14
2012-01-15,2,2,6,0,6,1
2012-01-16,6,36,147,60,207,4
2012-01-17,34,87,322,173,495,19
2012-01-18,28,53,493,38,531,12
2012-01-20,10,23,199,36,235,7
2012-01-22,2,2,4,3,7,2
2012-01-23,13,47,147,51,198,7
2012-01-24,6,14,24,12,36,3
2012-01-26,6,23,144,18,162,6
2012-01-27,33,154,1282,1202,2484,5
2012-01-29,53,167,1178,140,1318,17
2012-01-30,1,1,1,1,2,1
2012-01-31,1,3,9,0,9,1
2012-02-01,53,212,1812,1314,3126,28
2012-02-02,30,148,369,244,613,16
2012-02-03,8,26,119,22,141,4
2012-02-04,77,132,226,126,352,6
2012-02-06,46,118,437,249,686,24
2012-02-07,47,215,1455,1286,2741,10
2012-02-08,5,18,19,19,38,1
2012-02-09,9,24,122,15,137,5
2012-02-10,28,62,248,58,306,16
2012-02-11,5,81,871,725,1596,3
2012-02-13,166,358,947,698,1645,48
2012-02-14,43,180,679,501,1180,16
2012-02-15,7,8,5636,15,5651,3
2012-02-16,20,57,156,54,210,13
2012-02-17,42,126,1661,595,2256,15
2012-02-19,9,18,20,21,41,2
2012-02-20,32,81,333,100,433,14
2012-02-21,119,344,1030,559,1589,26
2012-02-22,13,73,120,97,217,10
2012-02-23,64,205,2829,704,3533,26
2012-02-24,5,12,106,9,115,3
2012-02-25,4,10,48,23,71,1
2012-02-26,6,20,79,18,97,3
2012-02-27,89,222,1365,254,1619,45
2012-02-28,230,1144,5021,2213,7234,15
2012-02-29,7,25,184,26,210,3
2012-03-01,45,136,499,163,662,21
2012-03-02,36,142,6374,243,6617,18
2012-03-03,4,27,33,6,39,3
2012-03-05,55,160,539,209,748,29
2012-03-06,33,139,649,269,918,18
2012-03-07,26,67,401,85,486,11
2012-03-08,93,1418,6529,2183,8712,16
2012-03-09,3,5,40,14,54,3
2012-03-10,15,15,60,12,72,5
2012-03-11,6,20,127,43,170,3
2012-03-12,23,416,3686,448,4134,12
2012-03-13,28,109,371,228,599,12
2012-03-14,14,50,254,92,346,11
2012-03-15,13,60,148,67,215,9
2012-03-16,34,125,385,164,549,12
2012-03-18,6,18,198,110,308,6
2012-03-19,2,10,34,3,37,2
2012-03-20,23,48,485,48,533,11
2012-03-21,1,2,2,1,3,1
2012-03-23,24,60,158,111,269,16
2012-03-24,2,38,265,124,389,2
2012-03-25,1,1,1,0,1,1
2012-03-26,23,70,247,143,390,14
2012-03-27,18,589,636,587,1223,11
2012-03-28,18,23,32,27,59,6
2012-03-29,1,4,14,8,22,1
2012-03-30,35,79,481,88,569,12
2012-03-31,2,3,7,3,10,2
2012-04-01,1,1,5,5,10,1
2012-04-02,23,46,11400,28,11428,10
2012-04-03,14,42,221,102,323,10
2012-04-04,6,24,74,10,84,3
2012-04-05,10,23,178,22,200,4
2012-04-06,4,6,17,11,28,2
2012-04-09,50,272,2795,2591,5386,14
2012-04-10,66,403,3438,837,4275,39
2012-04-11,58,203,971,218,1189,23
2012-04-12,4,4,2784,2,2786,3
2012-04-14,8,17,23,16,39,7
2012-04-15,15,43,262,37,299,9
2012-04-16,89,327,1384,607,1991,28
2012-04-17,8,12,58,8,66,4
2012-04-18,21,157,299,204,503,12
2012-04-19,5,18,146,16,162,4
2012-04-20,27,76,426,72,498,10
2012-04-22,10,19,130,10,140,7
2012-04-23,79,456,3681,2743,6424,21
2012-04-24,84,606,2756,948,3704,36
2012-04-25,15,27,61,72,133,9
2012-04-26,131,369,1161,507,1668,27
2012-04-27,65,202,1372,177,1549,24
2012-04-28,254,1823,13363,4777,18140,7
2012-04-29,1,266,342,304,646,1
2012-04-30,148,236,1222,278,1500,24
2012-05-01,16,1940,2469,1806,4275,13
2012-05-02,237,2145,15997,2378,18375,29
2012-05-03,82,366,1991,450,2441,37
2012-05-04,16,60,137,41,178,10
2012-05-07,41,150,876,240,1116,23
2012-05-08,38,1322,3085,1988,5073,25
2012-05-09,16,239,728,357,1085,9
2012-05-10,45,283,1003,398,1401,22
2012-05-11,75,211,516,268,784,21
2012-05-12,1,87,96,93,189,2
2012-05-14,99,2965,7532,3826,11358,23
2012-05-15,4,264,353,322,675,3
2012-05-16,4,9,41,22,63,3
2012-05-17,21,888,2245,1154,3399,7
2012-05-18,7,20,80,67,147,6
2012-05-20,19,33,99,38,137,10
2012-05-21,3,8,132,6,138,3
2012-05-22,91,439,1492,994,2486,35
2012-05-23,17,55,184,52,236,11
2012-05-24,6,15,86,10,96,5
2012-05-25,56,146,407,232,639,28
2012-05-29,51,707,2664,2115,4779,22
2012-05-30,23,38,4949,71,5020,9
2012-05-31,5,1925,7751,2213,9964,4
2012-06-01,37,1593,11727,1705,13432,21
2012-06-02,5,792,2204,891,3095,5
2012-06-03,27,50,328,27,355,11
2012-06-04,10,623,2085,723,2808,9
2012-06-05,7,1024,2466,1160,3626,2
2012-06-06,17,58,139,56,195,8
2012-06-07,22,51,889,76,965,12
2012-06-08,15,62,349,41,390,7
2012-06-09,1,18,177,8,185,1
2012-06-10,13,23,1170,999,2169,5
2012-06-11,2,18,183,11,194,2
2012-06-12,38,149,944,114,1058,10
2012-06-13,13,46,220,35,255,8
2012-06-14,16,736,1821,719,2540,9
2012-06-15,16,729,990,731,1721,11
2012-06-17,11,13,30,13,43,5
2012-06-18,10,14,44,11,55,3
2012-06-19,20,65,183,61,244,10
2012-06-20,2,24,20,33,53,2
2012-06-21,32,69,257,47,304,12
2012-06-22,20,30,131,43,174,7
2012-06-25,83,178,693,248,941,26
2012-06-26,17,40,132,39,171,8
2012-06-27,6,35,378,61,439,6
2012-06-28,68,215,3045,822,3867,28
2012-06-29,1,1,1,1,2,1
2012-07-01,1,439,2037,660,2697,1
2012-07-02,5,887,4106,1337,5443,4
2012-07-03,20,493,841,588,1429,14
2012-07-04,1,204,304,210,514,1
2012-07-05,18,278,563,345,908,10
2012-07-06,51,315,2520,334,2854,27
2012-07-09,169,1452,4230,1915,6145,62
2012-07-10,6,10,66,6,72,5
2012-07-11,56,148,603,215,818,22
2012-07-12,7,19,57,16,73,4
2012-07-13,61,176,2939,209,3148,12
2012-07-14,5,12,196,21,217,2
2012-07-15,5,8,10,10,20,1
2012-07-16,44,199,955,297,1252,27
2012-07-17,8,20,72,16,88,5
2012-07-18,7,14,42,35,77,5
2012-07-19,11,47,106,50,156,10
2012-07-22,85,217,1086,361,1447,24
2012-07-23,16,54,155,77,232,13
2012-07-24,51,164,499,190,689,24
2012-07-25,21,82,265,96,361,12
2012-07-26,10,65,135,76,211,10
2012-07-27,60,188,3183,3043,6226,26
2012-07-28,25,70,3082,2877,5959,7
2012-07-29,20,56,171,37,208,5
2012-07-30,39,996,1430,1055,2485,24
2012-07-31,17,1043,1209,1173,2382,6
2012-08-01,5,1861,2207,1971,4178,2
2012-08-02,44,192,742,239,981,21
2012-08-03,28,94,649,154,803,7
2012-08-04,5,64,401,285,686,3
2012-08-05,4,4,29,2,31,3
2012-08-06,41,208,1247,447,1694,21
2012-08-07,15,107,811,128,939,12
2012-08-08,17,23,29,35,64,11
2012-08-09,7,1003,2053,1076,3129,3
2012-08-10,14,31,393,31,424,8
2012-08-12,5,21,99,31,130,4
2012-08-14,6,25,102,18,120,4
2012-08-15,14,27,138,29,167,9
2012-08-16,1,6,6,6,12,1
2012-08-17,13,35,393,45,438,10
2012-08-18,2,2,2,2,4,2
2012-08-20,60,404,834,807,1641,57
2012-08-21,17,29,121,41,162,9
2012-08-22,91,439,1260,844,2104,36
2012-08-23,9,20,82,7,89,3
2012-08-24,60,158,1034,177,1211,19
2012-08-25,2,29,63,36,99,1
2012-08-26,1,3,3,3,6,1
2012-08-27,79,269,998,331,1329,25
2012-08-28,12,23,37,29,66,5
2012-08-29,23,120,572,108,680,13
2012-08-30,15,27,145,14,159,5
2012-08-31,9,37,169,93,262,7
2012-09-03,42,161,488,149,637,24
2012-09-04,14,646,958,864,1822,9
2012-09-06,22,35,132,60,192,13
2012-09-07,128,1296,2329,1863,4192,18
2012-09-08,1,368,416,387,803,1
2012-09-09,12,23,73,19,92,7
2012-09-10,80,180,1231,135,1366,21
2012-09-11,134,560,1481,909,2390,40
2012-09-12,115,2918,4472,3402,7874,43
2012-09-14,48,188,674,325,999,18
2012-09-15,55,1539,8206,2662,10868,20
2012-09-16,37,69,146,115,261,21
2012-09-17,84,210,2028,850,2878,34
2012-09-18,82,216,1282,352,1634,22
2012-09-19,7,14,22,11,33,7
2012-09-20,36,65,371,87,458,16
2012-09-21,12,471,3140,525,3665,10
2012-09-23,4,32,68,20,88,4
2012-09-24,16,59,231,64,295,7
2012-09-25,44,75,908,651,1559,15
2012-09-26,1,3,6,5,11,1
2012-09-27,8,499,3300,607,3907,6
2012-09-28,4,5,55,5,60,3
2012-09-29,20,43,592,17,609,5
2012-09-30,49,1973,11229,3040,14269,17
2012-10-01,21,66,471,88,559,11
2012-10-02,16,48,85,59,144,10
2012-10-03,9,25,100,19,119,4
2012-10-04,2,10,12,7,19,2
2012-10-05,24,58,400,291,691,15
2012-10-07,35,98,604,54,658,17
2012-10-08,21,47,271,54,325,12
2012-10-09,7,24,203,154,357,5
2012-10-10,26,45,211,49,260,16
2012-10-11,6,22,130,10,140,6
2012-10-12,14,42,81,42,123,7
2012-10-14,10,13,30,9,39,6
2012-10-15,45,761,4395,1181,5576,20
2012-10-16,46,1769,6671,2157,8828,33
2012-10-17,69,2208,2859,2427,5286,26
2012-10-18,56,178,493,265,758,23
2012-10-19,4,8,30,7,37,4
2012-10-21,15,330,446,346,792,10
2012-10-24,11,89,238,195,433,8
2012-10-25,53,142,872,167,1039,22
2012-10-26,5,5,19,9,28,5
2012-10-28,7,16,60,23,83,5
2012-10-29,89,342,2775,1840,4615,33
2012-10-30,1,1,4,0,4,1
2012-10-31,4,11,35,8,43,2
2012-11-02,5,9,19,6,25,3
2012-11-04,44,135,1442,92,1534,33
2012-11-08,14,37,101,77,178,11
2012-11-09,47,275,2350,1781,4131,11
2012-11-12,8,10,39,1,40,6
2012-11-13,4,11,38,14,52,3
2012-11-14,2,3,14,14,28,2
2012-11-15,46,121,776,141,917,14
2012-11-16,22,73,233,122,355,15
2012-11-19,44,121,654,264,918,20
2012-11-20,58,182,558,244,802,24
2012-11-21,12,93,327,190,517,8
2012-11-23,3,1825,2060,1954,4014,3
2012-11-24,3,752,903,824,1727,2
2012-11-25,1,1,1,1,2,1
2012-11-26,70,149,712,167,879,41
2012-11-27,18,41,116,49,165,14
2012-11-28,31,79,916,94,1010,22
2012-11-29,65,3567,6468,4277,10745,33
2012-11-30,3,47,95,47,142,3
2012-12-02,36,171,278,172,450,16
2012-12-03,19,46,121,54,175,8
2012-12-04,10,33,150,62,212,8
2012-12-05,4,7,78,6,84,4
2012-12-06,2,1228,4082,1358,5440,2
2012-12-07,28,1506,7494,1898,9392,16
2012-12-09,9,55,89,97,186,9
2012-12-10,19,27,138,140,278,8
2012-12-11,13,49,246,75,321,8
2012-12-12,18,54,306,70,376,14
2012-12-13,12,39,172,112,284,8
2012-12-14,1,1,5,8,13,1
2012-12-15,19,32,85,18,103,9
2012-12-16,12,33,71,29,100,9
2012-12-17,6,6,16,11,27,3
2012-12-18,26,66,289,94,383,16
2012-12-19,26,58,223,45,268,13
2012-12-20,14,41,203,59,262,10
2012-12-21,22,52,387,224,611,14
2012-12-22,15,37,70,46,116,8
2012-12-23,44,98,271,135,406,15
2012-12-25,2,4,4,4,8,2
2012-12-26,7,46,118,52,170,5
2012-12-27,23,44,243,572,815,16
2012-12-28,38,111,251,97,348,15
2012-12-31,3,7,15,12,27,1
2013-01-01,29,102,289,97,386,17
2013-01-02,49,165,769,350,1119,24
2013-01-03,38,168,1307,755,2062,25
2013-01-04,4,11,21,4,25,2
2013-01-05,9,19,19,16,35,9
2013-01-06,128,343,2783,703,3486,35
2013-01-07,27,285,507,450,957,14
2013-01-08,28,53,86,576,662,21
2013-01-09,26,248,1215,398,1613,14
2013-01-10,91,317,1984,1426,3410,38
2013-01-11,14,43,284,30,314,7
2013-01-12,50,153,761,445,1206,22
2013-01-14,46,144,619,165,784,27
2013-01-15,68,237,635,504,1139,53
2013-01-16,40,100,388,176,564,9
2013-01-17,7,13,60,9,69,5
2013-01-18,22,39,299,54,353,15
2013-01-19,3,4,16,16,32,2
2013-01-21,34,145,564,305,869,11
2013-01-22,32,158,693,260,953,19
2013-01-23,15,492,688,546,1234,10
2013-01-24,66,393,3582,765,4347,17
2013-01-25,31,1268,1853,1484,3337,20
2013-01-26,8,23,81,54,135,3
2013-01-27,40,600,930,653,1583,28
2013-01-28,36,158,541,266,807,21
2013-01-29,14,47,118,141,259,8
2013-01-30,23,62,110,38,148,14
2013-01-31,3,6,7,5,12,3
2013-02-01,198,1010,1673,1415,3088,25
2013-02-02,2,4,11,2,13,2
2013-02-03,10,27,135,69,204,6
2013-02-04,100,402,1546,671,2217,23
2013-02-05,14,136,225,104,329,10
2013-02-06,146,917,1067,974,2041,8
2013-02-07,77,237,1218,771,1989,28
2013-02-08,19,2534,4299,4042,8341,14
2013-02-09,11,4099,4633,4507,9140,4
2013-02-10,3,3,3,3,6,3
2013-02-11,23,68,206,53,259,11
2013-02-12,38,168,736,380,1116,24
2013-02-13,5,14,86,15,101,5
2013-02-14,44,809,2355,2095,4450,20
2013-02-15,17,37,162,24,186,10
2013-02-17,23,666,1193,716,1909,8
2013-02-18,13,2307,3048,2551,5599,11
2013-02-19,20,912,1241,1001,2242,17
2013-02-20,64,287,519,337,856,21
2013-02-21,4,48,184,169,353,4
2013-02-22,7,22,58,26,84,5
2013-02-23,7,20,93,9,102,5
2013-02-24,39,77,180,173,353,24
2013-02-25,87,1180,2623,1677,4300,44
2013-02-26,14,771,1057,1038,2095,10
2013-02-27,15,33,243,52,295,10
2013-02-28,5,39,160,76,236,2
2013-03-01,12,33,102,63,165,5
2013-03-03,3,5,46,5,51,2
2013-03-04,11,606,1021,677,1698,5
2013-03-05,17,32,215,23,238,9
2013-03-06,3,14,68,17,85,3
2013-03-07,15,44,99,59,158,9
2013-03-08,22,52,238,119,357,13
2013-03-09,10,22,132,44,176,5
2013-03-10,4,8,70,14,84,3
2013-03-11,17,27,179,44,223,12
2013-03-13,12,31,145,71,216,5
2013-03-14,13,40,267,54,321,9
2013-03-15,1,3,10,4,14,1
2013-03-17,52,157,471,233,704,24
2013-03-18,6,11,102,8,110,2
2013-03-19,58,219,428,333,761,21
2013-03-20,4,66,162,148,310,4
2013-03-21,83,310,1566,454,2020,34
2013-03-22,7,17,54,15,69,3
2013-03-24,5,5,5,5,10,2
2013-03-25,109,328,1706,524,2230,51
2013-03-26,32,215,529,305,834,21
2013-03-27,41,94,546,148,694,24
2013-03-28,72,208,2575,335,2910,19
2013-03-29,16,50,266,73,339,14
2013-03-30,2,2,2,1,3,2
2013-03-31,3,4,10,1,11,2
2013-04-01,137,593,2119,1110,3229,41
2013-04-02,43,214,532,227,759,24
2013-04-03,129,400,1914,517,2431,51
2013-04-04,21,43,108,44,152,16
2013-04-05,44,151,833,269,1102,22
2013-04-07,94,341,1025,402,1427,46
2013-04-08,8,35,49,60,109,5
2013-04-09,4,6,26,4,30,3
2013-04-10,11,809,1091,846,1937,5
2013-04-11,49,1716,2458,1767,4225,35
2013-04-12,154,1981,3233,2277,5510,45
2013-04-14,6,33,144,37,181,3
2013-04-15,121,326,950,618,1568,44
2013-04-16,9,34,57,30,87,8
2013-04-17,16,43,135,158,293,8
2013-04-18,89,300,1269,496,1765,39
2013-04-19,22,80,293,98,391,10
2013-04-20,1,788,1016,825,1841,1
2013-04-21,13,27,199,43,242,9
2013-04-22,156,431,1383,589,1972,59
2013-04-23,37,197,1060,483,1543,9
2013-04-24,29,3977,5239,4212,9451,12
2013-04-25,12,36,61,42,103,7
2013-04-26,65,222,529,372,901,34
2013-04-27,12,34,109,117,226,12
2013-04-28,40,50,181,209,390,21
2013-04-29,17,41,371,50,421,13
2013-04-30,3,922,1326,1035,2361,3
2013-05-01,76,1336,2557,1759,4316,60
2013-05-02,3,5,27,4,31,3
2013-05-03,9,9,28,12,40,6
2013-05-05,4,4,28,0,28,2
2013-05-06,2,3,3,3,6,2
2013-05-07,18,573,1137,647,1784,11
2013-05-08,44,2862,4356,3279,7635,24
2013-05-09,30,47,237,31,268,14
2013-05-10,24,57,220,51,271,10
2013-05-11,16,33,247,22,269,8
2013-05-12,8,30,79,24,103,5
2013-05-13,17,87,264,81,345,15
2013-05-14,1,1,7,0,7,1
2013-05-15,15,29,95,45,140,11
2013-05-16,39,448,1125,461,1586,23
2013-05-17,55,359,514,413,927,13
2013-05-20,23,51,285,90,375,15
2013-05-21,12,18,33,15,48,9
2013-05-22,4,10,15,18,33,3
2013-05-23,1,2,5,1,6,1
2013-05-24,2,8,12,12,24,2
2013-05-26,5,15,22,18,40,5
2013-05-28,126,472,1434,627,2061,83
2013-05-29,99,331,1654,672,2326,26
2013-05-30,1,2,1,1,2,1
2013-06-02,114,297,3775,1037,4812,47
2013-06-03,15,21,119,39,158,13
2013-06-04,12,15,39,4,43,9
2013-06-05,24,71,236,201,437,19
2013-06-06,37,100,278,103,381,12
2013-06-07,64,273,1230,648,1878,25
2013-06-09,19,64,90,65,155,7
2013-06-10,25,38,108,29,137,8
2013-06-11,91,461,2046,589,2635,32
2013-06-12,24,44,367,335,702,8
2013-06-13,9,15,47,30,77,5
2013-06-14,80,469,1455,1282,2737,49
2013-06-15,2,3,5,3,8,2
2013-06-16,4,6,42,0,42,2
2013-06-17,50,216,761,231,992,29
2013-06-18,26,82,141,118,259,11
2013-06-19,21,39,521,49,570,8
2013-06-20,85,391,957,553,1510,29
2013-06-21,17,47,211,150,361,11
2013-06-23,61,419,1672,659,2331,35
2013-06-24,71,173,963,586,1549,39
2013-06-25,3,4,14,1,15,2
2013-06-26,80,388,2066,652,2718,38
2013-06-27,55,110,704,108,812,25
2013-06-28,13,27,104,40,144,4
2013-06-30,46,241,1481,264,1745,15
2013-07-01,58,328,1445,603,2048,19
2013-07-02,10,47,96,48,144,7
2013-07-03,51,103,488,98,586,25
2013-07-04,2,2,0,17,17,1
2013-07-05,26,140,440,184,624,12
2013-07-06,1,1,1,1,2,1
2013-07-07,12,29,85,42,127,10
2013-07-08,36,76,561,153,714,14
2013-07-09,39,117,309,127,436,8
2013-07-10,9,11,14,5,19,3
2013-07-11,30,143,560,184,744,14
2013-07-12,75,365,1194,419,1613,39
2013-07-13,9,10,127,0,127,2
2013-07-15,246,709,4695,1090,5785,80
2013-07-17,13,27,103,49,152,9
2013-07-18,87,304,1860,570,2430,40
2013-07-19,85,290,567,444,1011,29
2013-07-20,1,1,9,0,9,1
2013-07-21,7,15,269,10,279,7
2013-07-22,165,475,2694,644,3338,45
2013-07-23,39,77,661,41,702,17
2013-07-24,7,11,31,7,38,7
2013-07-25,58,125,3212,175,3387,17
2013-07-26,4,1332,1650,1421,3071,4
2013-07-27,1,1374,1803,1497,3300,1
2013-07-29,28,44,67,42,109,7
2013-07-30,30,94,406,97,503,14
2013-07-31,13,32,602,28,630,10
2013-08-01,40,62,241,87,328,10
2013-08-02,24,49,121,260,381,7
2013-08-03,1,1333,1765,1440,3205,1
2013-08-05,119,4289,6098,4644,10742,40
2013-08-06,50,1946,2803,2093,4896,23
2013-08-07,16,37,161,86,247,11
2013-08-08,4,829,915,922,1837,3
2013-08-09,23,5603,7218,6221,13439,16
2013-08-11,2,2,7591,0,7591,2
2013-08-12,4,7,22,6,28,4
2013-08-13,19,49,7725,80,7805,13
2013-08-14,8,14,2,58,60,2
2013-08-15,5,19,43,12,55,3
2013-08-18,6,9,75,49,124,4
2013-08-19,4,6,14,8,22,2
2013-08-20,14,22,50,52,102,9
2013-08-21,6,10,392,5,397,5
2013-08-22,4,9,28,4,32,3
2013-08-23,5,7,26,12,38,3
2013-08-25,12,55,344,45,389,8
2013-08-26,15,119,308,61,369,8
2013-08-27,23,64,110,108,218,18
2013-08-28,18,35,107,107,214,10
2013-08-29,15,48,114,63,177,10
2013-08-30,40,793,1564,853,2417,17
2013-08-31,4,4,4,6,10,4
2013-09-03,40,1547,2025,1713,3738,25
2013-09-04,132,423,1269,560,1829,37
2013-09-05,12,26,48,42,90,9
2013-09-06,35,168,776,802,1578,16
2013-09-08,3,27,34,26,60,3
2013-09-09,218,767,4814,2569,7383,36
2013-09-10,1,1,1,1,2,1
2013-09-11,40,167,1006,90,1096,21
2013-09-12,41,139,329,125,454,20
2013-09-13,6,12,29,30,59,5
2013-09-17,108,271,1019,1948,2967,27
2013-09-18,74,249,1133,406,1539,35
2013-09-19,4,6,12,8,20,4
2013-09-20,78,321,2441,1079,3520,18
2013-09-23,2,3,0,19,19,2
2013-09-24,5,7,29,5,34,4
2013-09-25,27,67,212,62,274,11
2013-09-26,15,27,98,513,611,8
2013-09-27,6,11,59,8,67,4
2013-09-28,1,1,3,0,3,1
2013-09-30,3,4,14,9,23,3
2013-10-01,4,25,41,28,69,1
2013-10-03,1,2,2,1,3,1
2013-10-08,2,2,6,2,8,2
2013-10-09,1,2,6,4,10,1
2013-10-10,7,16,48,18,66,6
2013-10-11,4,14,17,11,28,2
2013-10-12,4,12,104,12,116,2
2013-10-13,4,4,20,3,23,2
2013-10-14,48,97,357,101,458,32
2013-10-15,17,49,114,55,169,10
2013-10-16,32,83,319,131,450,25
2013-10-17,35,147,396,113,509,19
2013-10-18,25,4712,6968,4936,11904,12
2013-10-22,14,53,119,122,241,9
2013-10-23,49,198,662,346,1008,15
2013-10-24,43,110,287,213,500,22
2013-10-25,6,12,218,16,234,3
2013-10-28,53,91,413,124,537,26
2013-10-29,37,66,212,61,273,4
2013-10-30,86,294,1066,574,1640,42
2013-10-31,32,87,182,75,257,23
2013-11-01,33,83,476,91,567,15
2013-11-02,2,2333,2879,2452,5331,2
2013-11-03,1,1162,1436,1248,2684,1
2013-11-04,43,72,138,84,222,13
2013-11-06,20,42,83,60,143,4
2013-11-07,18,44,216,80,296,12
2013-11-08,21,1254,1762,1310,3072,7
2013-11-09,1,1141,1427,1207,2634,1
2013-11-10,1,1141,1427,1207,2634,1
2013-11-11,7,15,26,17,43,6
2013-11-12,61,8143,10113,8866,18979,15
2013-11-13,9,42,50,66,116,5
2013-11-15,4,5,5,5,10,1
2013-11-18,69,382,1470,735,2205,37
2013-11-19,8,26,103,11,114,3
2013-11-20,10,77,120,99,219,6
2013-11-21,20,8,3,129,132,2
2013-11-22,1,1,1,1,2,1
2013-11-25,22,5,23,10,33,5
2013-11-26,36,39,86,507,593,4
2013-11-27,7,19,129,36,165,7
2013-12-01,5,22,94,31,125,5
2013-12-02,11,15,81,11,92,4
2013-12-03,26,174,211,177,388,12
2013-12-04,14,39,261,24,285,8
2013-12-05,183,7625,9837,8079,17916,24
2013-12-06,53,133,723,250,973,13
2013-12-09,45,178,606,232,838,24
2013-12-10,3,8,30,2,32,1
2013-12-11,97,238,1435,184,1619,28
2013-12-12,125,303,1208,1307,2515,28
2013-12-16,8,43,61,56,117,6
2013-12-17,153,793,1441,847,2288,31
2013-12-18,3,19,77,21,98,3
2013-12-19,7,13,104,15,119,3
2013-12-20,3,4,18,2,20,2
2013-12-26,14,23,125,15,140,6
2013-12-27,35,102,476,141,617,11
2013-12-28,4,12,42,10,52,1
2013-12-30,50,129,3582,62,3644,20
2014-01-02,13,29,43,33,76,6
2014-01-03,7,26,66,25,91,5
2014-01-06,36,91,151,108,259,22
2014-01-07,16,25,118,18,136,9
2014-01-09,6,16,29,32,61,5
2014-01-10,75,258,1159,254,1413,28
2014-01-13,42,90,333,85,418,24
2014-01-14,7,15,25,16,41,5
2014-01-15,14,42,153,61,214,8
2014-01-16,9,9,43,15,58,5
2014-01-17,54,979,2306,1003,3309,15
2014-01-18,10,2647,5493,2813,8306,9
2014-01-21,28,828,4514,872,5386,21
2014-01-22,19,52,337,55,392,13
2014-01-23,20,58,1254,100,1354,14
2014-01-24,4,788,942,6385,7327,2
2014-01-27,83,337,998,476,1474,33
2014-01-28,4,10,19,8,27,4
2014-01-29,1,1,8194,0,8194,1
2014-01-31,20,4226,13095,10012,23107,12
2014-02-01,1,12,16,12,28,1
2014-02-02,2,30,51,36,87,2
2014-02-03,16,134,170,151,321,9
2014-02-04,13,16,188,107,295,8
2014-02-05,48,135,576,204,780,21
2014-02-06,9,51,89,40,129,4
2014-02-07,10,11,13,12,25,4
2014-02-10,34,47,964,857,1821,11
2014-02-11,17,175,262,194,456,9
2014-02-12,4,1597,1873,1677,3550,4
2014-02-13,23,59,368,134,502,10
2014-02-14,9,30,349,317,666,3
2014-02-18,15,23,81,30,111,10
2014-02-19,12,68,133,74,207,5
2014-02-20,45,65,83,679,762,8
2014-02-24,132,311,1069,402,1471,61
2014-02-25,12,65,185,115,300,8
2014-02-26,1,2,7,1,8,1
2014-02-27,183,602,6787,2057,8844,25
2014-02-28,15,29,139,10,149,8
2014-03-03,28,54,105,120,225,22
2014-03-04,3,7,9,36,45,3
2014-03-05,34,91,471,150,621,17
2014-03-06,9,16,26,17,43,4
2014-03-07,24,72,173,268,441,10
2014-03-10,9,34,28,52,80,1
2014-03-11,16,46,112,55,167,11
2014-03-12,7,22,74,56,130,5
2014-03-13,7,29,74,41,115,7
2014-03-14,119,294,934,896,1830,33
2014-03-17,12,25,57,21,78,10
2014-03-18,151,358,1943,1302,3245,41
2014-03-19,18,55,78,167,245,6
2014-03-20,10,38,123,83,206,9
2014-03-21,98,269,890,508,1398,34
2014-03-23,1,2,2,2,4,1
2014-03-24,33,90,317,272,589,16
2014-03-25,41,104,332,108,440,19
2014-03-26,9,27,67,34,101,5
2014-03-27,11,47,78,55,133,7
2014-03-28,21,65,209,71,280,10
2014-03-31,146,276,637,628,1265,26
2014-04-01,7,9,42,6,48,4
2014-04-02,11,45,210,274,484,5
2014-04-03,48,133,438,192,630,18
2014-04-04,7,12,48,5,53,3
2014-04-07,69,408,1448,549,1997,33
2014-04-08,109,176,403,192,595,13
2014-04-09,87,111,267,116,383,16
2014-04-10,7,11,75,5,80,2
2014-04-11,2,3,4,4,8,2
2014-04-14,8,29,75,43,118,7
2014-04-15,2,9,28,7,35,2
2014-04-16,14,78,240,83,323,8
2014-04-17,25,59,100,77,177,22
2014-04-18,12,20,57,13,70,6
2014-04-19,21,1183,1364,1401,2765,2
2014-04-20,1,1153,1412,1367,2779,1
2014-04-21,69,200,410,296,706,21
2014-04-22,12,2257,2794,2662,5456,8
2014-04-23,24,2248,2802,2663,5465,21
2014-04-24,6,32,94,48,142,5
2014-04-25,4,11,96,14,110,2
2014-04-28,7,146,593,301,894,6
2014-04-29,24,1231,1645,1484,3129,24
2014-04-30,23,6733,8140,7951,16091,18
2014-05-02,27,75,281,71,352,19
2014-05-06,18,32,62,33,95,12
2014-05-07,15,40,102,43,145,10
2014-05-08,27,66,179,73,252,15
2014-05-09,7,9,6,277,283,5
2014-05-11,1,2238,2723,2264,4987,1
2014-05-12,10,2260,3101,2359,5460,6
2014-05-13,4,13,21,18,39,4
2014-05-14,2,4,8,3,11,2
2014-05-15,19,60,94,116,210,11
2014-05-16,2,2,11,1,12,1
2014-05-17,1,20,21,21,42,1
2014-05-19,29,72,274,90,364,19
2014-05-20,29,120,249,3705,3954,10
2014-05-21,31,116,314,133,447,7
2014-05-23,22,28,80,39,119,9
2014-05-27,43,99,327,78,405,27
2014-05-28,11,21,325,49,374,5
2014-05-30,11,14,126,84,210,6
2014-06-02,6,8,46,21,67,5
2014-06-03,121,469,1949,870,2819,29
2014-06-04,9,27,37,22,59,3
2014-06-05,3,9,41,29,70,2
2014-06-06,97,337,2172,823,2995,39
2014-06-09,12,18,169,75,244,8
2014-06-10,11,34,199,41,240,5
2014-06-12,4,6,5,4,9,3
2014-06-16,118,401,2156,563,2719,37
